gene_name,gene_id,exon_intron_flag,sequence_length,start_position,end_position,sequence
>TTN-201,ENSE00003809141,1,91,0,90,ATGACAACTCAAGCACCGACGTTTACGCAGCCGTTACAAAGCGTTGTGGTACTGGAGGGTAGTACCGCAACCTTTGAGGCTCACATTAGTG
>TTN-201,ENSE00003807606,1,204,91,294,GTTTTCCAGTTCCTGAGGTGAGCTGGTTTAGGGATGGCCAGGTGATTTCCACTTCCACTCTGCCCGGCGTGCAGATCTCCTTTAGCGATGGCCGCGCTAAACTGACGATCCCCGCCGTGACTAAAGCCAACAGTGGACGATATTCCCTGAAAGCCACCAATGGATCTGGACAAGCGACTAGTACTGCTGAGCTTCTCGTGAAAG
>TTN-201,ENSE00003810976,1,288,295,582,CTGAGACAGCACCACCCAACTTCGTTCAACGACTGCAGAGCATGACCGTGAGACAAGGAAGCCAAGTGAGACTCCAAGTGAGAGTGACTGGAATCCCTACACCTGTGGTGAAGTTCTACCGGGATGGAGCCGAAATCCAGAGCTCCCTTGATTTCCAAATTTCACAAGAAGGCGACCTCTACAGCTTACTGATTGCAGAAGCATACCCTGAGGACTCAGGGACCTATTCAGTAAATGCCACCAATAGCGTTGGAAGAGCTACTTCGACTGCTGAATTACTGGTTCAAG
>TTN-201,ENSE00003809662,1,86,583,668,GTGAAGAAGAAGTACCTGCTAAAAAGACAAAGACAATTGTTTCGACTGCTCAGATCTCAGAATCAAGACAAACCCGAATTGAAAAG
>TTN-201,ENSE00003809782,1,245,669,913,AAGATTGAAGCCCACTTTGATGCCAGATCAATTGCAACAGTTGAGATGGTCATAGATGGTGCCGCTGGGCAACAGCTGCCACATAAAACACCTCCCAGGATTCCTCCGAAGCCAAAGTCAAGATCCCCAACACCACCGTCTATTGCTGCCAAAGCACAGCTGGCTCGGCAGCAGTCCCCATCGCCCATAAGACACTCCCCTTCCCCGGTCAGACACGTGCGGGCACCGACCCCATCTCCGGTCAG
>TTN-201,ENSE00003805863,1,331,914,1244,GTCCGTGTCTCCAGCAGCAAGAATCTCCACATCCCCCATCAGGTCTGTTAGGTCTCCATTGCTCATGCGTAAGACTCAGGCATCCACCGTGGCCACAGGTCCTGAAGTGCCTCCCCCTTGGAAGCAAGAGGGCTACGTGGCCTCCTCATCTGAGGCTGAGATGAGAGAGACAACGCTGACAACCTCTACTCAGATCAGGACAGAAGAGAGATGGGAAGGGAGATACGGTGTCCAGGAGCAAGTGACCATCAGTGGTGCTGCGGGTGCTGCCGCCAGTGTGTCGGCCAGTGCTAGCTACGCAGCAGAGGCTGTTGCCACTGGTGCTAAAGAG
>TTN-201,ENSE00003803639,1,153,1245,1397,GTGAAACAAGATGCTGACAAAAGTGCAGCTGTTGCGACTGTTGTTGCTGCCGTTGATATGGCCAGAGTGAGAGAACCAGTGATCAGCGCTGTAGAGCAGACTGCTCAGAGGACAACCACGACTGCTGTGCACATCCAACCTGCTCAAGAACAG
>TTN-201,ENSE00003810843,1,138,1398,1535,GTAAGAAAGGAAGCGGAGAAGACTGCTGTAACTAAGGTAGTAGTGGCCGCCGATAAAGCCAAGGAACAAGAATTAAAATCAAGAACCAAAGAAGTAATTACCACAAAGCAAGAGCAGATGCACGTAACTCATGAGCAG
>TTN-201,ENSE00003803899,1,126,1536,1661,ATAAGAAAAGAAACTGAAAAAACATTTGTACCAAAGGTAGTAATTTCCGCAGCTAAAGCCAAAGAACAAGAAACTAGAATTTCTGAAGAAATTACTAAGAAACAGAAACAAGTAACTCAAGAAGCA
>TTN-201,ENSE00003809802,1,138,1662,1799,ATAATGAAGGAAACTAGGAAAACAGTTGTACCTAAAGTCATAGTTGCCACACCCAAAGTCAAAGAACAAGATTTAGTATCAAGAGGTAGAGAAGGCATTACTACCAAAAGAGAACAAGTGCAAATAACTCAGGAGAAG
>TTN-201,ENSE00003805623,1,138,1800,1937,ATGAGAAAGGAAGCCGAGAAAACTGCCTTGTCTACAATAGCAGTTGCTACTGCTAAAGCCAAAGAACAAGAAACAATACTGAGAACTAGAGAAACTATGGCTACTAGACAAGAACAAATCCAAGTTACCCATGGAAAG
>TTN-201,ENSE00003801659,1,294,1938,2231,GTGGACGTTGGAAAAAAGGCTGAAGCTGTAGCAACAGTTGTTGCTGCAGTAGACCAGGCCCGAGTCAGAGAGCCCAGAGAGCCTGGGCATCTTGAAGAATCCTATGCTCAGCAGACCACTTTGGAGTACGGATATAAGGAACGCATTTCCGCCGCAAAGGTAGCTGAGCCTCCCCAACGTCCAGCCTCAGAACCCCACGTTGTCCCTAAAGCAGTCAAGCCTAGAGTAATCCAGGCTCCTTCTGAGACTCATATCAAAACTACTGATCAAAAGGGAATGCACATATCATCACAG
>TTN-201,ENSE00003804455,1,123,2232,2354,ATCAAGAAAACTACAGATCTAACAACGGAAAGATTAGTCCATGTGGATAAACGCCCCCGCACAGCTAGCCCTCACTTTACTGTTTCAAAAATTTCTGTTCCTAAGACAGAACATGGATATGAG
>TTN-201,ENSE00003810306,1,282,2355,2636,GCATCAATAGCCGGTAGTGCTATTGCCACATTACAAAAAGAGTTGTCAGCCACATCTTCTGCTCAGAAGATCACCAAATCGGTGAAGGCTCCTACTGTGAAGCCCAGTGAGACTAGAGTAAGGGCAGAGCCCACACCCTTGCCACAGTTCCCCTTCGCTGACACACCAGATACTTACAAGAGTGAAGCTGGCGTTGAGGTGAAAAAGGAAGTAGGGGTGAGCATCACTGGCACCACCGTCCGTGAAGAGCGCTTTGAAGTACTGCACGGACGCGAAGCCAAG
>TTN-201,ENSE00003805296,1,66,2637,2702,GTAACAGAAACAGCAAGAGTACCAGCACCTGTTGAAATTCCTGTTACTCCACCAACTTTGGTCTCG
>TTN-201,ENSE00003806123,1,259,2703,2961,GGCTTAAAAAATGTGACTGTCATAGAAGGTGAATCTGTCACCTTGGAGTGCCACATCTCTGGATACCCATCCCCGACAGTGACATGGTACAGGGAAGACTACCAAATCGAAAGTTCCATTGACTTCCAGATAACCTTCCAGAGTGGAATTGCTCGTCTTATGATTCGCGAAGCATTTGCGGAAGACAGCGGGCGATTTACTTGCAGTGCTGTAAATGAGGCTGGAACCGTCAGCACATCCTGCTATCTGGCTGTGCAGG
>TTN-201,ENSE00003808554,1,64,2962,3025,TGTCAGAAGAATTTGAAAAGGAAACCACAGCCGTGACTGAGAAATTTACTACAGAAGAGAAACG
>TTN-201,ENSE00003804962,1,216,3026,3241,CTTTGTTGAGTCAAGAGATGTGGTTATGACTGATACTAGCCTCACAGAGGAACAAGCAGGGCCTGGAGAACCTGCCGCGCCTTACTTTATTACAAAACCAGTGGTCCAGAAACTGGTGGAAGGTGGGAGCGTGGTGTTTGGATGCCAAGTTGGCGGCAACCCAAAGCCCCATGTATACTGGAAAAAATCTGGTGTTCCTCTAACCACTGGATACAG
>TTN-201,ENSE00003804165,1,143,3242,3384,ATACAAAGTGAGTTACAACAAACAAACCGGTGAATGCAAGCTGGTGATTTCTATGACTTTTGCTGATGATGCTGGAGAATACACTATTGTTGTTCGCAATAAGCATGGAGAAACTTCTGCATCTGCTTCCTTGCTTGAAGAAG
>TTN-201,ENSE00003802603,1,206,3385,3590,CTGATTATGAGTTACTGATGAAGTCCCAGCAAGAAATGCTTTATCAGACACAAGTGACTGCATTTGTTCAAGAACCTAAAGTTGGAGAAACAGCACCTGGATTTGTATACTCTGAGTATGAAAAAGAGTATGAAAAAGAACAAGCCTTAATTAGGAAGAAAATGGCCAAAGATACTGTAGTGGTCAGAACTTATGTAGAAGATCAG
>TTN-201,ENSE00003807963,1,234,3591,3824,GAATTCCATATTTCTTCCTTTGAAGAGAGACTTATTAAAGAAATTGAATATAGAATAATAAAGACTACATTAGAAGAACTTCTTGAAGAAGATGGAGAAGAAAAGATGGCAGTTGACATTTCTGAATCTGAAGCTGTTGAATCAGGATTTGATTCAAGAATCAAGAATTATAGAATTCTTGAGGGGATGGGTGTCACTTTTCATTGCAAGATGTCTGGATATCCATTACCAAAG
>TTN-201,ENSE00003808968,1,245,3825,4069,ATTGCTTGGTACAAAGATGGCAAGCGCATCAAACATGGAGAAAGATACCAAATGGACTTTCTACAAGATGGCAGAGCTAGTCTGCGTATACCTGTTGTTCTTCCAGAAGATGAAGGAATCTACACTGCATTTGCCAGCAATATTAAAGGAAATGCAATTTGCTCAGGGAAATTGTATGTGGAGCCTGCTGCACCACTTGGAGCTCCGACTTACATTCCCACACTAGAGCCAGTGAGCAGAATCAG
>TTN-201,ENSE00003802614,1,272,4070,4341,ATCTCTCTCTCCACGTTCAGTGAGCAGGTCTCCTATACGCATGTCTCCTGCACGGATGTCACCTGCAAGGATGTCTCCTGCACGGATGTCCCCTGCAAGAATGTCCCCTGGACGTAGGCTGGAGGAGACAGATGAGTCACAACTTGAGAGACTATATAAACCAGTCTTTGTGTTAAAACCTGTTTCTTTCAAATGTTTAGAAGGGCAAACTGCCAGATTTGACTTAAAGGTTGTTGGTAGACCTATGCCAGAGACGTTCTGGTTTCATGATG
>TTN-201,ENSE00003811446,1,165,4342,4506,GCCAGCAAATTGTCAATGACTATACCCATAAAGTAGTCATTAAAGAAGATGGTACTCAATCACTAATTATTGTCCCTGCCACACCCAGTGATTCTGGGGAATGGACTGTGGTTGCCCAAAACAGGGCAGGCAGATCTTCAATTTCAGTGATTTTAACTGTGGAAG
>TTN-201,ENSE00003805710,1,169,4507,4675,CTGTGGAACATCAGGTAAAACCGATGTTTGTAGAAAAACTGAAAAATGTCAATATAAAGGAAGGTTCCCGACTTGAAATGAAAGTCAGAGCTACGGGTAACCCCAACCCTGACATTGTATGGTTGAAAAACAGTGACATCATTGTGCCTCATAAATATCCCAAAATCAG
>TTN-201,ENSE00003809358,1,1694,4676,6369,AATTGAAGGAACCAAGGGAGAAGCTGCCCTTAAAATCGATTCCACTGTCAGCCAAGATTCTGCCTGGTATACTGCGACTGCTATTAATAAAGCTGGCAGAGACACTACAAGATGCAAAGTAAATGTTGAAGTTGAGTTTGCAGAGCCTGAGCCAGAGAGAAAGTTAATCATCCCACGGGGGACATATAGAGCAAAGGAGATTGCAGCCCCAGAACTGGAGCCCCTCCATTTGCGATATGGCCAAGAGCAATGGGAAGAAGGTGATCTCTATGACAAAGAGAAACAACAGAAACCATTTTTCAAGAAAAAACTCACTTCCTTAAGACTTAAGCGCTTTGGGCCTGCCCACTTTGAATGCAGGCTAACACCCATTGGTGACCCAACGATGGTGGTGGAGTGGCTCCATGATGGAAAGCCACTTGAAGCAGCCAACAGGCTCCGTATGATCAATGAATTTGGGTACTGCAGCCTTGATTATGGCGTTGCATATTCTAGAGACAGTGGTATCATTACTTGCAGAGCCACTAACAAATATGGAACAGATCACACATCTGCTACCCTTATTGTTAAAGATGAGAAAAGTCTTGTGGAAGAATCCCAATTGCCTGAGGGGAGGAAAGGCTTACAGAGAATTGAAGAATTAGAGAGAATGGCTCATGAAGGTGCACTTACAGGTGTAACAACAGATCAGAAAGAAAAGCAAAAGCCAGACATTGTCTTGTACCCAGAGCCAGTTAGAGTACTTGAAGGGGAGACTGCAAGGTTCCGCTGCAGGGTAACAGGCTACCCTCAGCCCAAAGTCAACTGGTACCTCAATGGACAGCTCATCCGCAAAAGCAAAAGGTTCAGAGTTCGCTATGATGGTATCCATTACCTGGACATCGTGGACTGCAAATCATATGACACAGGTGAAGTGAAGGTCACCGCGGAAAATCCTGAAGGTGTGATAGAGCATAAAGTGAAGCTTGAGATTCAACAGAGGGAAGATTTTAGGTCTGTCCTTAGGAGAGCTCCTGAACCAAGGCCTGAGTTTCACGTACATGAACCAGGAAAGCTTCAGTTTGAAGTACAAAAAGTGGATAGACCTGTTGACACCACTGAAACCAAAGAAGTTGTGAAGTTGAAAAGGGCTGAAAGAATTACCCATGAAAAAGTGCCTGAAGAGTCGGAAGAGCTGCGCAGTAAATTCAAGCGCAGAACAGAAGAGGGCTATTATGAAGCCATTACCGCTGTGGAGCTCAAGTCTCGAAAGAAGGATGAATCCTATGAGGAACTCCTCAGGAAGACAAAAGATGAACTTCTCCACTGGACCAAAGAGTTAACTGAAGAGGAAAAGAAAGCTCTTGCCGAAGAAGGCAAAATCACGATTCCAACTTTTAAACCTGACAAGATTGAACTAAGTCCTAGTATGGAGGCTCCAAAAATCTTCGAAAGAATCCAGAGCCAAACAGTGGGCCAAGGATCTGATGCACACTTCCGGGTCAGAGTCGTGGGGAAACCAGACCCCGAATGTGAATGGTACAAAAATGGTGTCAAAATTGAACGGTCTGACCGGATCTACTGGTACTGGCCCGAAGACAATGTTTGTGAATTGGTCATAAGAGATGTGACTGCTGAGGACTCTGCCAGCATCATGGTAAAAGCCATCAACATAGCTGGAGAAACCTCCAGTCACGCATTCTTACTTGTCCAAG
>TTN-201,ENSE00003809440,1,282,6370,6651,CCAAGCAATTGATCACTTTCACACAGGAATTACAAGATGTTGTTGCTAAGGAAAAAGACACTATGGCAACCTTTGAATGTGAAACTTCAGAACCATTTGTCAAAGTGAAATGGTATAAAGATGGTATGGAGGTTCATGAGGGAGATAAATACAGGATGCACTCTGACAGAAAGGTTCACTTCCTCTCCATACTGACCATTGATACGTCTGATGCTGAAGATTACAGCTGTGTACTTGTGGAAGATGAAAATGTCAAAACGACTGCTAAACTTATTGTTGAAG
>TTN-201,ENSE00003802960,1,267,6652,6918,GTGCAGTTGTTGAGTTTGTGAAAGAACTTCAGGACATAGAAGTTCCAGAATCATATTCAGGAGAATTAGAGTGCATTGTATCCCCAGAAAATATAGAAGGAAAATGGTATCATAATGATGTGGAGCTTAAATCCAATGGCAAATATACAATTACATCTCGTCGTGGACGTCAGAACCTCACGGTCAAGGATGTAACCAAGGAGGACCAGGGAGAATACAGCTTTGTCATCGACGGGAAAAAGACAACCTGTAAATTAAAGATGAAAC
>TTN-201,ENSE00003804241,1,273,6919,7191,CCCGCCCCATTGCTATCCTACAAGGACTTAGTGACCAAAAAGTCTGTGAGGGTGACATTGTTCAGCTTGAAGTTAAAGTCTCCTTGGAAAGTGTGGAAGGCGTCTGGATGAAAGACGGCCAAGAAGTGCAGCCCAGTGACAGGGTTCACATTGTGATAGACAAACAATCTCATATGCTGCTCATTGAAGACATGACTAAGGAAGATGCTGGAAATTACTCTTTCACCATTCCAGCCCTTGGCCTCTCCACCAGTGGGCGTGTCTCTGTCTATA
>TTN-201,ENSE00003806988,1,264,7192,7455,GTGTGGACGTGATAACACCTCTAAAAGATGTTAATGTGATTGAAGGCACCAAGGCTGTGCTTGAATGTAAGGTGTCAGTCCCTGATGTGACTTCTGTTAAGTGGTACTTAAATGATGAACAAATCAAGCCTGATGACCGTGTACAGGCCATTGTGAAAGGTACTAAACAGCGACTAGTCATTAACCGAACTCATGCTTCAGACGAAGGACCTTACAAGCTGATAGTTGGCAGAGTTGAAACCAACTGTAATCTCTCTGTAGAAA
>TTN-201,ENSE00003804968,1,261,7456,7716,AAATTAAAATTATCAGAGGTCTTCGTGACCTTACCTGTACAGAAACTCAAAATGTGGTGTTTGAGGTTGAGCTGTCCCACTCTGGAATTGATGTCCTGTGGAATTTTAAGGACAAGGAAATCAAGCCCAGTTCTAAATATAAAATTGAAGCACATGGAAAAATATATAAATTGACAGTTCTAAATATGATGAAAGATGATGAAGGAAAATACACATTTTACGCGGGAGAAAATATGACATCTGGAAAACTTACTGTGGCAG
>TTN-201,ENSE00003809850,1,261,7717,7977,GTGGGGCCATCTCCAAGCCACTCACAGATCAGACCGTAGCTGAATCCCAGGAAGCTGTGTTTGAATGTGAAGTTGCCAACCCAGATTCCAAAGGCGAATGGTTGAGGGATGGCAAACACCTACCACTGACTAACAACATCAGAAGTGAGTCTGATGGCCACAAAAGGAGACTTATCATTGCTGCCACCAAATTAGATGACATTGGAGAATATACCTACAAGGTGGCCACCTCCAAAACATCTGCCAAACTCAAAGTTGAAG
>TTN-201,ENSE00003806479,1,264,7978,8241,CTGTCAAAATTAAGAAGACTCTGAAGAACCTCACAGTGACAGAAACACAGGATGCTGTTTTCACTGTCGAGCTTACACACCCTAATGTCAAAGGTGTCCAGTGGATCAAAAATGGAGTTGTGCTGGAATCCAATGAAAAGTATGCTATCTCTGTCAAAGGAACAATTTACTCTCTGAGGATTAAAAACTGTGCCATCGTGGATGAGTCTGTTTATGGCTTCAGGCTTGGAAGGCTTGGAGCCAGTGCCAGACTGCACGTGGAGA
>TTN-201,ENSE00003804523,1,261,8242,8502,CTGTCAAGATCATTAAAAAGCCAAAGGATGTGACAGCCTTGGAAAATGCCACTGTTGCCTTTGAAGTTAGTGTTTCCCATGACACTGTTCCAGTAAAATGGTTCCATAAGAGTGTGGAAATTAAGCCAAGTGACAAACACAGACTGGTCTCAGAAAGGAAAGTCCACAAGCTGATGCTGCAGAACATCTCCCCCTCAGATGCTGGGGAATACACAGCTGTGGTCGGGCAATTGGAATGCAAAGCAAAACTGTTTGTGGAGA
>TTN-201,ENSE00003807378,1,261,8503,8763,CATTACATATTACAAAAACCATGAAAAATATCGAGGTGCCTGAGACCAAAACTGCCTCTTTTGAGTGTGAGGTGTCCCACTTCAATGTCCCTTCCATGTGGCTGAAGAATGGTGTGGAAATTGAGATGAGTGAAAAGTTCAAGATAGTTGTGCAGGGAAAACTCCATCAGCTGATCATCATGAACACCAGCACAGAGGACTCGGCAGAATACACATTTGTCTGTGGCAATGACCAAGTCAGTGCCACCCTGACAGTCACCC
>TTN-201,ENSE00003807271,1,261,8764,9024,CAATCATGATTACTTCCATGCTGAAAGACATCAACGCTGAAGAAAAAGACACTATTACTTTTGAGGTGACAGTGAACTATGAAGGCATCTCTTACAAATGGTTAAAGAATGGTGTGGAAATCAAATCAACTGACAAGTGCCAGATGAGAACCAAAAAGCTCACACACTCACTGAACATCAGGAATGTTCACTTTGGGGATGCTGCTGACTACACCTTTGTGGCTGGAAAAGCAACATCAACAGCCACACTTTATGTGGAAG
>TTN-201,ENSE00003808172,1,142,9025,9166,CTCGTCATATAGAATTTAGGAAACACATTAAGGACATTAAGGTACTGGAGAAGAAGCGAGCCATGTTTGAATGTGAAGTTTCTGAACCTGACATCACTGTACAGTGGATGAAAGATGACCAGGAACTGCAGATCACAGACAG
>TTN-201,ENSE00003808223,1,166,9167,9332,AATAAAGATTCAGAAGGAGAAATATGTCCACCGCCTTCTGATCCCATCCACCCGGATGTCTGATGCTGGGAAGTACACAGTGGTGGCAGGAGGCAACGTGTCAACTGCAAAACTCTTTGTAGAAGGCAGAGATGTTCGCATCCGAAGTATTAAAAAGGAGGTTCAG
>TTN-201,ENSE00003810851,1,232,9333,9564,GTCATTGAGAAACAGCGTGCTGTTGTTGAATTTGAGGTCAATGAAGACGATGTTGATGCCCACTGGTATAAAGATGGCATTGAAATCAATTTCCAAGTTCAAGAACGACACAAATATGTAGTGGAAAGAAGAATCCACCGAATGTTTATCTCTGAGACCAGACAGAGCGATGCAGGAGAATACACCTTTGTGGCAGGAAGGAACAGGAGTTCTGTCACTCTCTATGTCAATG
>TTN-201,ENSE00003802092,1,285,9565,9849,CTCCTGAACCGCCCCAAGTTCTGCAGGAGCTCCAGCCTGTCACTGTGCAGTCTGGCAAGCCTGCCCGCTTCTGTGCCGTGATATCCGGAAGACCACAGCCCAAAATTTCCTGGTACAAGGAAGAGCAGCTGCTTTCCACTGGCTTCAAGTGCAAATTTCTTCATGATGGGCAAGAATACACGCTTTTGCTAATTGAAGCCTTCCCAGAGGATGCGGCAGTCTATACCTGTGAAGCCAAGAATGACTATGGTGTTGCCACAACATCAGCTTCACTCTCAGTGGAAG
>TTN-201,ENSE00003807103,1,126,9850,9975,TTCCAGAAGTTGTGTCTCCTGATCAGGAAATGCCTGTTTATCCACCTGCCATCATCACCCCGCTTCAGGACACTGTCACTTCTGAAGGGCAGCCAGCCCGTTTTCAATGCCGGGTTTCTGGAACAG
>TTN-201,ENSE00003801355,1,189,9976,10164,ATCTAAAAGTGTCGTGGTACAGCAAAGACAAGAAAATCAAGCCATCTCGGTTCTTTAGAATGACTCAATTTGAAGACACTTATCAACTGGAAATTGCCGAAGCTTATCCAGAAGATGAAGGAACTTACACGTTTGTTGCTAGTAATGCTGTAGGCCAAGTATCAAGCACAGCCAACCTGAGTCTGGAAG
>TTN-201,ENSE00004024285,1,576,10165,10740,TGCAAGCCCTAGATAGGCAAAGTTCTGGGAAAGATGTAAGAGAGTCCACCAAGTCCCAGGCAGTGGCAGATTCCTCTTTCACAAAGGAGGAGAGCAAAATATCTCAAAAGGAAATTAAGTCATTTCAAGGATCATCATATGAATATGAAGTGCAGGTTTTTGAAAGTGTATCTCAAAGTTCCATCCACACAGCTGCATCTGTTCAAGATACACAGTTGTGCCATACTGCATCCCTTTCACAAATTGCAGAAAGCACTGAGCTATCTAAGGAATGTGCTAAAGAGTCCACGGGTGAGGCGCCCAAGATTTTCCTGCATCTTCAGGACGTCACTGTAAAGTGCGGTGACACGGCTCAATTCCTCTGTGTTTTAAAAGATGATTCTTTCATTGATGTAACCTGGACTCACGAAGGTGCAAAGATAGAGGAATCCGAGAGACTGAAACAATCACAAAATGGAAATATTCAGTTTCTTACCATATGTAATGTTCAGCTGGTAGACCAAGGACTATACAGCTGCATTGTACACAATGACTGTGGAGAGAGGACAACGTCAGCAGTACTAAGTGTAGAAGGTG
>TTN-201,ENSE00003810791,1,57,10741,10797,CTCCTGAATCAATTTTGCATGAGAGGATTGAACAAGAGATTGAGATGGAAATGAAAG
>TTN-201,ENSE00004024265,1,2781,10798,13578,AGTTTTCTAGTTCTTTTCTGTCTGCCGAGGAAGAAGGACTTCATAGCGCCGAACTTCAATTATCTAAAATAAATGAAACACTTGAACTTTTGTCTGAATCTCCAGTTTACCCAACTAAATTTGATTCCGAAAAGGAAGGCACTGGCCCAATTTTCATCAAAGAAGTGTCAAATGCTGATATAAGCATGGGGGATGTGGCTACACTGTCTGTAACTGTCATTGGCATCCCCAAACCTAAAATTCAGTGGTTCTTTAATGGAGTGCTATTAACCCCTTCTGCTGACTACAAATTTGTTTTTGACGGTGATGATCATAGCCTGATCATTCTGTTCACCAAATTGGAGGATGAGGGAGAGTATACATGTATGGCCAGTAATGACTATGGAAAGACAATATGTAGTGCCTATCTAAAAATTAATTCCAAAGGAGAGGGTCACAAAGACACTGAAACAGAATCAGCAGTGGCAAAATCTCTGGAAAAGCTGGGAGGTCCTTGTCCTCCTCACTTCCTTAAGGAGTTAAAACCAATTCGCTGTGCTCAAGGGCTTCCTGCCATCTTTGAGTACACAGTGGTTGGAGAGCCTGCCCCTACTGTTACATGGTTCAAAGAAAACAAGCAGCTTTGCACCAGTGTTTATTACACTATCATTCATAACCCTAATGGCTCTGGAACTTTCATTGTCAATGACCCTCAGAGGGAAGACAGTGGCCTCTATATCTGTAAAGCAGAGAATATGTTGGGTGAGTCCACCTGTGCAGCAGAGCTGCTTGTGCTTCTGGAAGACACAGACATGACTGATACCCCCTGCAAAGCAAAGTCCACACCAGAGGCTCCTGAGGATTTTCCACAGACACCCTTAAAGGGTCCCGCAGTTGAAGCACTTGACTCAGAGCAGGAAATTGCAACGTTTGTAAAAGACACCATTTTGAAAGCTGCTTTAATTACAGAAGAAAACCAGCAACTATCTTATGAGCATATTGCTAAAGCCAATGAATTGAGCAGTCAGCTTCCTTTGGGAGCTCAGGAATTGCAATCCATTTTGGAGCAAGACAAGCTCACTCCTGAAAGCACCAGGGAATTTCTTTGCATCAATGGCAGTATTCACTTTCAGCCTCTCAAGGAACCATCTCCCAACCTACAGCTGCAGATTGTACAGTCCCAGAAAACCTTCTCCAAAGAAGGTATTCTAATGCCTGAAGAGCCTGAGACACAGGCAGTTCTATCAGATACCGAGAAAATCTTCCCAAGTGCCATGTCCATAGAACAAATTAATTCATTAACAGTTGAGCCTCTGAAAACTTTATTAGCTGAACCTGAAGGGAATTATCCACAGTCTTCAATAGAACCTCCAATGCATTCTTATCTAACCTCTGTGGCTGAGGAAGTACTTTCACCAAAAGAAAAGACAGTATCTGACACCAACAGAGAGCAAAGAGTGACTCTTCAAAAGCAAGAGGCACAAAGTGCGCTCATCTTGAGTCAGAGCTTAGCTGAGGGACACGTGGAGAGTCTCCAGAGTCCTGATGTCATGATCTCTCAGGTAAACTATGAGCCCCTAGTCCCTTCAGAACACTCATGCACAGAAGGAGGTAAAATTTTGATAGAAAGTGCAAATCCACTGGAAAATGCAGGGCAAGATTCTGCGGTCAGAATTGAGGAAGGCAAGTCCTTAAGATTTCCACTAGCACTTGAAGAAAAGCAGGTACTGCTCAAAGAAGAGCATTCTGACAACGTGGTGATGCCCCCAGACCAAATCATTGAGTCTAAAAGAGAGCCCGTGGCAATAAAGAAAGTGCAGGAGGTACAGGGAAGGGACCTTCTTTCTAAGGAAAGCTTGCTTTCTGGTATTCCAGAAGAGCAGAGATTAAACCTGAAAATTCAAATCTGCCGGGCTTTGCAAGCAGCCGTGGCCAGCGAGCAGCCAGGTCTTTTCTCTGAGTGGCTAAGAAATATTGAAAAGGTGGAGGTCGAGGCTGTAAACATCACCCAAGAGCCCAGACACATCATGTGCATGTACCTTGTTACTTCGGCAAAGTCTGTAACAGAAGAAGTAACCATCATTATTGAAGATGTTGATCCTCAAATGGCTAACCTGAAAATGGAACTTAGGGATGCTTTGTGTGCTATTATATATGAGGAAATAGACATCCTAACAGCTGAGGGTCCTAGAATTCAGCAAGGAGCCAAAACAAGTTTGCAAGAAGAAATGGATTCTTTTTCAGGTTCACAGAAGGTTGAACCCATTACTGAACCAGAAGTTGAATCTAAATATCTGATCTCAACTGAAGAGGTCAGTTATTTTAACGTGCAAAGTAGGGTTAAATATTTGGATGCCACACCTGTCACTAAAGGGGTTGCTTCAGCTGTTGTCTCTGACGAAAAACAAGATGAGAGTCTGAAACCATCAGAGGAAAAAGAGGAGTCTTCCTCTGAAAGTGGTACTGAGGAGGTTGCTACAGTAAAGATACAGGAAGCTGAGGGTGGCTTAATCAAAGAGGATGGCCCCATGATACATACACCTTTAGTGGACACTGTTTCTGAGGAAGGTGATATTGTACACCTCACAACATCCATAACAAATGCTAAAGAGGTGAATTGGTATTTTGAGAATAAACTGGTGCCTTCAGATGAAAAGTTCAAGTGTTTACAAGATCAAAATACATATACGCTAGTCATCGACAAAGTAAATACCGAAGACCATCAAGGAGAGTATGTCTGTGAGGCCTTGAATGACAGCGGAAAAACAGCAACTTCAGCCAAACTCACTGTAGTAAAAAGAG
>TTN-201,ENSE00003805227,1,279,13579,13857,CTGCCCCAGTGATCAAGAGGAAAATCGAACCCCTGGAAGTAGCACTGGGCCACCTAGCCAAATTCACCTGTGAGATCCAAAGTGCTCCCAATGTCCGGTTCCAGTGGTTTAAAGCTGGCCGAGAAATTTATGAGAGTGACAAGTGTTCTATTCGATCTTCAAAGTATATCTCCAGCCTTGAAATCCTGAGAACCCAGGTGGTTGACTGCGGCGAGTATACATGCAAAGCTTCCAATGAGTATGGCAGTGTCAGCTGTACAGCCACACTAACTGTGACAG
>TTN-201,ENSE00003804802,1,81,13858,13938,TGCCTGGAGGTGAAAAGAAAGTTCGCAAATTACTTCCGGAACGTAAACCTGAACCAAAGGAAGAAGTTGTTCTGAAAAGCG
>TTN-201,ENSE00003811452,1,75,13939,14013,TTCTAAGAAAAAGACCTGAAGAAGAAGAACCTAAAGTAGAACCTAAAAAACTAGAAAAAGTTAAAAAACCTGCAG
>TTN-201,ENSE00003807205,1,90,14014,14103,TACCAGAACCACCACCTCCAAAACCTGTTGAAGAGGTTGAAGTACCTACTGTTACAAAAAGGGAAAGGAAGATTCCTGAACCAACAAAAG
>TTN-201,ENSE00003806747,1,63,14104,14166,TGCCTGAAATCAAGCCAGCAATACCTCTCCCTGCACCTGAACCGAAACCAAAGCCCGAAGCAG
>TTN-201,ENSE00003810755,1,90,14167,14256,AAGTGAAAACAATCAAACCACCTCCTGTGGAACCTGAACCAACCCCCATCGCTGCCCCAGTAACAGTGCCAGTGGTTGGAAAGAAAGCAG
>TTN-201,ENSE00003806122,1,51,14257,14307,AAGCCAAAGCACCTAAGGAAGAGGCTGCCAAGCCAAAAGGTCCTATCAAAG
>TTN-201,ENSE00003804858,1,402,14308,14709,GTGTACCCAAAAAGACTCCTTCACCAATAGAAGCCGAAAGGAGAAAGTTAAGGCCAGGAAGTGGTGGAGAGAAACCTCCTGATGAAGCCCCGTTCACCTACCAGCTAAAGGCTGTGCCACTGAAGTTTGTGAAAGAAATCAAAGACATCATCTTGACAGAATCAGAGTTCGTTGGCTCTTCAGCAATCTTTGAATGTTTGGTCTCCCCTTCCACTGCAATTACAACCTGGATGAAAGACGGTAGCAATATCCGTGAGAGTCCCAAGCACAGGTTTATTGCAGATGGTAAAGACAGAAAGCTGCACATCATTGATGTTCAACTTTCCGATGCTGGTGAATACACCTGTGTTTTACGTTTGGGAAACAAAGAAAAGACCTCCACGGCTAAACTTGTTGTAGAAG
>TTN-201,ENSE00003803996,1,279,14710,14988,AACTTCCTGTGCGTTTTGTAAAAACACTGGAAGAGGAAGTCACAGTGGTCAAAGGACAGCCATTGTACTTGAGCTGCGAGTTAAACAAAGAGCGTGACGTGGTCTGGAGGAAGGATGGCAAGATTGTGGTGGAGAAACCTGGCCGAATTGTGCCAGGCGTCATTGGCTTGATGCGGGCTCTGACCATCAACGATGCAGATGACACAGATGCTGGAACATACACAGTTACTGTGGAAAACGCCAACAACCTGGAGTGTTCATCTTGCGTAAAAGTAGTAG
>TTN-201,ENSE00003807976,1,276,14989,15264,AAGTCATTAGAGATTGGCTGGTGAAACCTATACGAGACCAGCATGTGAAACCCAAGGGGACAGCTATTTTTGCCTGTGATATAGCAAAAGATACTCCAAACATTAAGTGGTTCAAAGGATATGATGAAATCCCTGCGGAACCAAATGATAAGACTGAAATACTGAGAGATGGAAATCATCTGTACCTCAAAATTAAGAATGCTATGCCAGAAGATATTGCTGAGTATGCAGTGGAAATTGAAGGAAAAAGATACCCTGCAAAGCTGACACTTGGAG
>TTN-201,ENSE00003804328,1,140,15265,15404,AGCGTGAAGTTGAACTGCTTAAACCAATAGAGGACGTTACCATTTATGAGAAAGAAAGTGCAAGCTTTGATGCAGAAATCTCAGAGGCAGACATTCCTGGACAATGGAAACTGAAAGGAGAACTTCTAAGGCCCTCACCT
>TTN-201,ENSE00003802254,1,127,15405,15531,ACTTGTGAAATCAAAGCAGAAGGTGGAAAACGCTTCTTAACTTTGCACAAAGTCAAACTGGACCAAGCTGGTGAAGTCCTCTACCAGGCCCTTAATGCAATTACAACTGCCATTTTGACAGTAAAAG
>TTN-201,ENSE00003811410,1,264,15532,15795,AAATCGAACTTGACTTTGCTGTGCCCCTGAAGGATGTCACTGTTCCAGAAAGGCGACAGGCTCGATTCGAATGTGTCCTCACCCGAGAGGCAAATGTTATATGGTCCAAAGGACCTGATATAATTAAGTCATCTGACAAATTTGATATCATCGCTGATGGAAAGAAACATATTCTTGTTATTAATGATTCTCAATTTGATGATGAAGGGGTCTATACTGCTGAGGTGGAGGGCAAGAAGACCTCAGCTCGGTTGTTTGTCACAG
>TTN-201,ENSE00003805150,1,267,15796,16062,GTATAAGACTGAAATTCATGTCACCTCTTGAAGATCAAACAGTAAAAGAAGGTGAAACAGCAACTTTTGTTTGTGAACTTTCTCATGAAAAAATGCATGTAGTCTGGTTCAAAAATGATGCCAAACTCCATACAAGCAGAACAGTACTCATCTCTTCTGAGGGCAAGACTCACAAATTGGAAATGAAAGAAGTGACATTGGATGATATATCTCAGATAAAAGCTCAAGTCAAGGAGCTGAGCTCCACAGCACAGCTGAAGGTCTTAG
>TTN-201,ENSE00003801907,1,264,16063,16326,AGGCCGATCCCTACTTCACTGTGAAATTACATGACAAAACTGCAGTGGAGAAGGATGAGATTACTTTGAAGTGTGAAGTGAGCAAAGATGTACCAGTGAAATGGTTCAAAGATGGTGAAGAGATTGTCCCTTCACCCAAATATTCTATCAAGGCAGATGGCCTGCGCCGCATCTTAAAAATCAAAAAGGCGGACCTTAAAGATAAAGGCGAATATGTGTGTGACTGTGGCACAGACAAGACCAAGGCAAATGTTACTGTTGAGG
>TTN-201,ENSE00003802031,1,140,16327,16466,CTCGACTAATAAAAGTGGAAAAGCCTCTGTACGGAGTAGAGGTGTTTGTTGGTGAAACAGCCCACTTTGAAATTGAACTTTCTGAACCTGATGTTCACGGCCAGTGGAAGCTGAAAGGACAGCCTTTGACAGCTTCCCCT
>TTN-201,ENSE00003811443,1,127,16467,16593,GACTGTGAAATCATTGAGGATGGAAAGAAGCATATTCTGATCCTTCATAACTGTCAGCTGGGTATGACAGGAGAGGTTTCCTTCCAGGCTGCTAATGCCAAATCTGCAGCCAATCTGAAAGTGAAAG
>TTN-201,ENSE00003811384,1,267,16594,16860,AATTGCCTCTTATCTTCATCACACCTCTCAGTGATGTTAAAGTCTTCGAGAAAGATGAGGCTAAGTTTGAGTGTGAAGTATCCAGGGAGCCCAAAACATTCCGTTGGCTAAAAGGAACCCAGGAAATCACAGGTGATGACAGATTTGAGCTTATAAAGGATGGCACTAAGCATTCAATGGTGATCAAGTCAGCTGCTTTTGAAGATGAAGCAAAATACATGTTTGAAGCTGAAGATAAGCACACAAGTGGCAAACTGATCATTGAAG
>TTN-201,ENSE00003801954,1,267,16861,17127,GAATCCGGCTCAAATTCCTCACCCCTCTCAAAGATGTAACTGCCAAAGAGAAGGAAAGTGCTGTATTTACTGTGGAGTTATCTCATGATAACATCCGAGTTAAATGGTTCAAGAATGACCAGCGCCTACACACCACCAGGTCGGTCTCAATGCAAGACGAAGGGAAAACTCATTCGATCACATTCAAAGACCTGTCTATTGATGACACCTCCCAAATTAGAGTAGAAGCTATGGGGATGAGTTCAGAAGCTAAACTCACTGTGCTTG
>TTN-201,ENSE00003809996,1,267,17128,17394,AGGGAGACCCATATTTTACAGGAAAACTTCAAGATTATACTGGTGTAGAGAAAGATGAAGTTATTCTACAGTGTGAAATTAGCAAAGCAGATGCACCAGTGAAATGGTTTAAGGATGGGAAGGAAATAAAGCCATCCAAAAATGCTGTTATTAAGGCAGATGGCAAGAAACGCATGCTAATCCTAAAGAAAGCCTTGAAATCAGATATTGGACAGTACACCTGTGACTGTGGGACAGATAAGACCTCAGGAAAACTTGACATTGAGG
>TTN-201,ENSE00003804589,1,140,17395,17534,ATCGGGAAATTAAACTGGTGCGACCCCTGCACAGTGTGGAGGTGATGGAGACTGAGACAGCACGCTTTGAAACCGAAATCTCTGAAGATGATATCCACGCCAACTGGAAACTCAAGGGAGAGGCCCTACTCCAAACACCT
>TTN-201,ENSE00003805931,1,127,17535,17661,GATTGTGAAATTAAGGAAGAAGGCAAAATACACTCCCTTGTTTTGCACAACTGTCGCCTGGACCAGACGGGTGGGGTGGATTTCCAAGCTGCCAATGTTAAATCTAGTGCCCACCTCCGAGTTAAGC
>TTN-201,ENSE00003811344,1,143,17662,17804,CACGAGTAATTGGTCTTCTGAGGCCTTTAAAGGATGTCACCGTGACTGCAGGGGAAACAGCCACCTTCGACTGCGAGCTCTCCTACGAAGATATCCCAGTGGAATGGTATCTCAAAGGGAAGAAACTAGAGCCCAGCGATAAG
>TTN-201,ENSE00003802375,1,124,17805,17928,GTGGTCCCACGTTCAGAAGGAAAAGTTCATACACTTACTCTGAGGGATGTAAAGTTAGAAGATGCTGGGGAAGTCCAACTAACAGCAAAAGATTTCAAAACTCACGCCAACCTCTTTGTGAAAG
>TTN-201,ENSE00003806733,1,267,17929,18195,AACCCCCAGTTGAATTCACTAAGCCTCTTGAGGACCAGACGGTCGAAGAGGGAGCCACTGCAGTGCTGGAGTGTGAAGTCTCCAGAGAAAATGCTAAGGTGAAATGGTTCAAAAATGGGACAGAAATCCTCAAAAGCAAGAAGTATGAAATTGTTGCTGATGGCAGGGTCAGAAAACTTGTTATACATGACTGTACCCCAGAGGATATTAAAACATACACTTGTGATGCTAAGGATTTTAAGACTTCCTGTAACCTGAATGTCGTGC
>TTN-201,ENSE00003807497,1,98,18196,18293,CTCCTCATGTGGAATTCTTAAGACCACTCACCGACCTTCAAGTTAGAGAAAAAGAAATGGCTCGATTTGAGTGTGAACTTTCCCGAGAAAATGCTAAG
>TTN-201,ENSE00003802530,1,169,18294,18462,GTTAAGTGGTTTAAAGATGGTGCTGAAATTAAAAAGGGCAAAAAATATGACATCATATCCAAGGGAGCAGTGCGCATTCTTGTCATCAACAAATGTCTACTGGATGATGAAGCTGAATATTCCTGTGAAGTAAGGACAGCGAGAACTTCTGGCATGCTGACAGTTCTGG
>TTN-201,ENSE00003811387,1,267,18463,18729,AAGAAGAAGCTGTCTTTACCAAAAATCTTGCCAACATTGAAGTTAGTGAAACAGACACTATAAAACTGGTTTGTGAAGTCTCCAAACCTGGCGCAGAAGTGATTTGGTATAAAGGGGATGAGGAGATCATTGAAACAGGAAGATATGAAATACTGACTGAAGGACGGAAGAGAATCCTGGTCATTCAGAACGCTCACCTTGAGGATGCTGGCAACTACAACTGTCGACTCCCAAGCTCTCGAACCGATGGCAAAGTCAAAGTACATG
>TTN-201,ENSE00003802653,1,267,18730,18996,AACTGGCTGCTGAATTTATCTCAAAGCCTCAAAACCTTGAAATACTTGAAGGAGAAAAGGCTGAATTTGTCTGCTCTATATCAAAAGAAAGCTTTCCAGTCCAGTGGAAGAGGGATGATAAGACACTTGAATCTGGAGATAAATATGACGTTATTGCTGATGGTAAAAAGAGGGTCCTAGTTGTGAAAGATGCCACATTACAAGATATGGGCACTTACGTTGTCATGGTAGGGGCCGCCAGAGCAGCAGCTCACTTGACAGTCATTG
>TTN-201,ENSE00003802540,1,279,18997,19275,AAAAACTCAGGATCGTAGTTCCTCTTAAGGACACCCGGGTGAAGGAACAACAGGAAGTTGTCTTCAACTGTGAAGTCAATACTGAAGGTGCCAAAGCCAAATGGTTCAGAAATGAAGAAGCTATATTTGATAGTTCAAAATACATCATTCTCCAAAAAGACCTAGTCTACACCCTCAGAATTAGAGATGCACACTTAGATGACCAAGCCAACTATAATGTGTCTTTGACCAATCACAGAGGTGAAAATGTTAAAAGTGCAGCCAATCTAATAGTAGAAG
>TTN-201,ENSE00003802874,1,409,19276,19684,AGGAAGACCTTAGGATTGTTGAGCCTCTTAAAGATATTGAAACAATGGAGAAGAAATCTGTCACATTCTGGTGCAAGGTGAATCGTCTCAATGTAACACTGAAGTGGACCAAAAATGGTGAAGAAGTGCCTTTTGACAACCGTGTCTCATACAGAGTTGATAAGTACAAGCACATGTTAACCATTAAAGACTGTGGCTTCCCAGATGAAGGTGAATACATTGTCACTGCTGGACAAGATAAATCTGTTGCTGAGCTTCTCATCATAGAAGCCCCGACAGAATTTGTGGAACACTTGGAAGATCAGACAGTCACTGAGTTCGATGACGCTGTCTTCTCCTGCCAGCTCTCCAGAGAGAAAGCCAATGTAAAATGGTACAGAAATGGGAGAGAAATCAAAGAAGGCAAAAA
>TTN-201,ENSE00003804130,1,125,19685,19809,ATACAAATTTGAAAAAGATGGAAGTATACACAGACTCATTATAAAAGATTGCAGGCTGGATGATGAGTGTGAATATGCTTGCGGGGTAGAAGACAGGAAGTCTCGTGCTAGACTTTTTGTGGAAG
>TTN-201,ENSE00003807647,1,267,19810,20076,AAATTCCTGTTGAGATCATCAGGCCTCCACAAGATATTCTTGAAGCCCCTGGTGCTGATGTTGTCTTTTTAGCAGAACTCAATAAAGATAAGGTGGAAGTCCAATGGCTAAGAAATAACATGGTTGTTGTCCAGGGTGATAAACACCAGATGATGAGTGAAGGAAAGATACATCGACTACAGATTTGTGATATTAAGCCCCGTGACCAGGGTGAATACAGATTTATTGCCAAAGACAAAGAAGCCAGAGCTAAGCTTGAACTGGCAG
>TTN-201,ENSE00003802353,1,270,20077,20346,CTGCACCAAAAATCAAGACAGCTGACCAAGACCTTGTGGTTGATGTTGGCAAGCCTCTGACAATGGTGGTGCCATATGATGCCTACCCCAAAGCAGAAGCTGAATGGTTTAAAGAAAATGAACCTTTATCTACAAAAACCATTGATACTACGGCTGAACAAACTTCTTTCAGAATTTTAGAAGCCAAGAAAGGAGACAAAGGGAGGTATAAAATTGTGCTTCAGAACAAACATGGAAAAGCAGAAGGATTCATCAATTTAAAAGTTATTG
>TTN-201,ENSE00003809195,1,303,20347,20649,ATGTTCCTGGGCCAGTACGTAACTTAGAAGTGACAGAAACATTTGATGGTGAAGTGAGCCTTGCTTGGGAAGAACCTTTAACTGATGGTGGAAGCAAAATCATAGGTTACGTTGTTGAAAGACGTGACATTAAGAGAAAGACCTGGGTTCTGGCCACAGACCGTGCAGAGAGTTGTGAGTTTACTGTCACTGGTCTACAGAAAGGAGGAGTTGAGTACCTATTCCGTGTGAGTGCAAGAAACAGAGTTGGCACTGGTGAGCCAGTAGAAACTGACAATCCTGTAGAAGCAAGGAGTAAATATG
>TTN-201,ENSE00003803170,1,303,20650,20952,ATGTTCCAGGCCCTCCTTTGAATGTAACCATCACTGATGTGAATCGATTTGGTGTCTCACTGACATGGGAACCACCAGAGTATGATGGAGGTGCTGAGATCACAAACTACGTCATTGAATTAAGAGACAAGACTTCTATCAGGTGGGATACTGCCATGACTGTGAGAGCTGAAGACCTGTCTGCAACTGTTACTGATGTGGTAGAAGGACAGGAGTACAGTTTCCGAGTGAGAGCCCAAAATCGAATTGGAGTTGGAAAACCAAGTGCAGCCACACCCTTCGTCAAAGTTGCTGATCCAATTG
>TTN-201,ENSE00003806295,1,188,20953,21140,AGAGACCAAGTCCTCCTGTAAACCTAACTTCCTCAGATCAGACTCAGTCATCAGTTCAGCTCAAATGGGAACCTCCTCTGAAAGATGGAGGAAGCCCAATATTAGGCTATATAATTGAGCGATGCGAAGAAGGAAAAGATAATTGGATTCGTTGCAATATGAAACTTGTCCCTGAACTGACTTACAAG
>TTN-201,ENSE00003810732,1,115,21141,21255,GTTACCGGATTGGAAAAAGGAAATAAATATTTATATAGAGTATCTGCAGAAAATAAAGCTGGTGTTTCAGATCCATCTGAAATTCTTGGTCCTCTCACCGCTGACGATGCATTTG
>TTN-201,ENSE00003809985,1,285,21256,21540,TTGAACCAACAATGGATTTAAGTGCATTTAAAGATGGTCTGGAAGTTATTGTCCCAAATCCTATCACGATCCTGGTTCCAAGTACAGGCTATCCAAGGCCAACTGCAACCTGGTGTTTTGGAGATAAAGTACTAGAAACAGGGGACCGGGTGAAAATGAAGACCTTGTCTGCCTATGCCGAACTTGTCATTTCTCCAAGTGAACGTTCAGACAAGGGCATTTATACACTGAAATTAGAAAACCGTGTGAAAACAATTTCTGGGGAAATTGATGTCAATGTAATTG
>TTN-201,ENSE00003808828,1,152,21541,21692,CTCGCCCAAGTGCACCCAAAGAATTGAAATTTGGTGATATAACCAAGGACTCAGTACATTTGACTTGGGAACCACCTGATGATGATGGAGGAAGTCCGTTAACTGGATACGTTGTTGAAAAACGAGAAGTCAGCCGGAAAACATGGACTAAA
>TTN-201,ENSE00003803811,1,148,21693,21840,GTTATGGACTTTGTGACTGATCTAGAATTCACAGTTCCTGATCTTGTTCAAGGAAAAGAGTACTTATTTAAAGTTTGTGCTCGTAACAAATGTGGCCCTGGAGAACCTGCATATGTTGATGAACCTGTAAATATGTCAACTCCTGCAA
>TTN-201,ENSE00003803944,1,178,21841,22018,CGGTACCTGACCCACCAGAGAATGTTAAATGGAGAGATCGAACAGCCAATAGCATCTTCTTAACATGGGATCCACCTAAAAATGATGGTGGTTCACGCATCAAAGGATATATAGTTGAAAGATGTCCACGTGGTTCTGATAAATGGGTTGCCTGTGGAGAACCTGTTGCAGAAACAAA
>TTN-201,ENSE00003802090,1,122,22019,22140,AATGGAAGTGACAGGTCTTGAGGAAGGCAAATGGTATGCCTACCGCGTGAAGGCCTTAAACAGGCAGGGTGCTAGCAAACCAAGCAGACCCACAGAGGAAATCCAGGCTGTGGACACACAAG
>TTN-201,ENSE00003809522,1,288,22141,22428,AGGCCCCAGAAATCTTCCTCGATGTGAAGCTCCTTGCTGGTCTCACTGTAAAAGCTGGGACCAAGATTGAACTTCCTGCCACCGTAACCGGAAAACCTGAACCTAAAATAACTTGGACAAAGGCTGATATGATTCTGAAGCAGGACAAAAGAATTACCATTGAAAATGTCCCTAAGAAATCCACAGTGACTATTGTTGATAGTAAGAGAAGTGACACTGGCACATATATCATTGAGGCTGTGAATGTGTGTGGCCGGGCCACTGCTGTGGTGGAAGTGAACGTCTTAG
>TTN-201,ENSE00003804879,1,297,22429,22725,ATAAACCCGGACCACCAGCTGCCTTTGACATCACAGATGTAACCAATGAGTCATGTCTTCTAACATGGAACCCACCACGCGATGATGGTGGATCTAAGATCACAAACTATGTTGTGGAGAGACGAGCAACTGATAGTGAAGTGTGGCACAAGCTCTCATCCACCGTCAAGGATACAAACTTCAAGGCCACCAAATTAATCCCCAATAAAGAGTACATCTTCAGAGTTGCTGCAGAAAACATGTATGGTGTTGGTGAACCAGTTCAGGCCTCTCCAATAACAGCCAAATATCAGTTTG
>TTN-201,ENSE00003809410,1,187,22726,22912,ATCCACCTGGTCCTCCAACTCGCCTAGAACCTTCTGATATCACTAAAGACGCAGTGACTCTCACATGGTGTGAGCCAGATGATGATGGTGGCAGCCCAATCACAGGATACTGGGTTGAAAGACTGGATCCTGATACAGATAAATGGGTTAGATGCAATAAGATGCCAGTAAAGGACACAACATACAG
>TTN-201,ENSE00003808827,1,116,22913,23028,AGTGAAAGGTCTCACTAATAAGAAAAAATACAGATTCCGTGTGTTGGCTGAAAATCTTGCTGGACCTGGAAAACCAAGCAAATCAACTGAACCAATCTTAATAAAGGATCCCATAG
>TTN-201,ENSE00003806136,1,300,23029,23328,ATCCTCCATGGCCCCCTGGAAAACCAACTGTAAAAGATGTAGGCAAAACATCAGTAAGGTTGAATTGGACAAAACCAGAACATGATGGAGGTGCAAAGATTGAGTCTTATGTCATTGAAATGCTGAAGACTGGAACAGATGAGTGGGTCAGAGTGGCGGAAGGGGTTCCCACCACTCAGCACTTGCTCCCAGGGCTCATGGAAGGACAGGAATACTCATTCCGAGTTAGAGCTGTGAATAAGGCTGGGGAAAGTGAACCCAGTGAACCCAGTGACCCTGTGCTTTGCCGGGAGAAGCTAT
>TTN-201,ENSE00003804290,1,300,23329,23628,ATCCTCCATCACCACCACGCTGGCTTGAAGTTATTAATATCACAAAAAATACAGCAGACCTAAAATGGACAGTTCCTGAGAAAGATGGAGGGTCCCCCATCACCAACTACATTGTGGAAAAGAGAGACGTCAGGCGAAAAGGCTGGCAAACAGTGGATACCACTGTCAAGGACACCAAGTGCACAGTCACCCCACTGACTGAGGGCTCTTTATATGTGTTCCGAGTTGCTGCAGAAAATGCTATAGGACAAAGCGACTACACCGAAATTGAGGACTCTGTGCTGGCCAAAGACACCTTTA
>TTN-201,ENSE00003803723,1,106,23629,23734,CCACTCCTGGACCACCCTACGCCCTGGCAGTGGTTGATGTGACAAAACGACATGTTGACCTAAAGTGGGAGCCACCTAAAAATGATGGTGGAAGACCAATACAGAG
>TTN-201,ENSE00003805819,1,197,23735,23931,ATATGTCATTGAGAAGAAAGAAAGGTTAGGTACCCGTTGGGTGAAAGCTGGAAAGACTGCAGGACCTGACTGTAACTTCAGAGTAACTGATGTCATCGAAGGAACAGAGGTCCAGTTTCAGGTTCGGGCTGAAAATGAAGCTGGAGTTGGCCACCCAAGTGAACCCACAGAAATCCTATCCATTGAAGATCCAACAA
>TTN-201,ENSE00003806467,1,306,23932,24237,GTCCTCCCTCACCACCCCTTGACCTACATGTGACTGATGCTGGGAGAAAACACATTGCCATTGCTTGGAAGCCTCCAGAGAAAAATGGTGGAAGTCCTATCATAGGATACCATGTTGAAATGTGTCCAGTAGGCACTGAGAAATGGATGAGAGTTAATTCTCGCCCAATAAAGGACTTGAAATTCAAGGTTGAAGAAGGTGTTGTTCCTGACAAAGAATATGTCCTGAGAGTGAGAGCAGTCAATGCTATTGGTGTCAGCGAGCCATCTGAAATCTCTGAAAATGTGGTTGCCAAAGACCCAGACT
>TTN-201,ENSE00003808061,1,279,24238,24516,GCAAGCCAACAATTGACCTGGAGACTCATGACATTATTGTTATTGAAGGTGAAAAGTTAAGCATTCCTGTTCCCTTCAGAGCTGTCCCAGTTCCAACTGTTAGTTGGCATAAAGATGGCAAAGAAGTTAAAGCAAGTGATAGATTAACAATGAAGAATGATCACATCTCTGCACACCTTGAAGTTCCCAAGAGTGTCCGTGCAGATGCCGGAATTTATACCATTACACTGGAGAATAAGCTCGGCTCAGCAACAGCCTCAATCAATGTCAAAGTCATAG
>TTN-201,ENSE00003811164,1,300,24517,24816,GCCTACCTGGACCATGCAAAGATATTAAAGCAAGTGACATTACCAAGAGTTCTTGTAAGTTAACTTGGGAACCTCCAGAATTTGATGGTGGAACCCCAATTCTTCATTATGTCCTGGAGCGCAGAGAAGCTGGGAGGAGAACATATATACCAGTCATGTCTGGTGAGAACAAACTGTCATGGACTGTGAAGGATCTCATACCAAATGGTGAATACTTCTTCCGTGTTAAAGCAGTCAACAAGGTTGGTGGAGGAGAATATATTGAACTGAAAAATCCAGTCATTGCTCAAGATCCAAAGC
>TTN-201,ENSE00003805132,1,303,24817,25119,AACCCCCTGATCCACCTGTAGATGTAGAGGTTCATAATCCTACAGCGGAGGCAATGACTATTACATGGAAGCCACCTTTGTATGATGGAGGGAGCAAGATAATGGGCTACATCATAGAGAAGATTGCTAAGGGTGAAGAAAGGTGGAAGAGATGCAATGAACACCTGGTACCAATCCTGACCTATACAGCAAAAGGACTTGAAGAGGGGAAAGAGTACCAATTCCGTGTGCGAGCAGAGAACGCCGCGGGTATTAGTGAACCTTCTCGGGCTACTCCTCCAACCAAAGCTGTAGATCCCATTG
>TTN-201,ENSE00003805056,1,363,25120,25482,ATGCCCCCAAAGTCATTCTGAGAACAAGCCTAGAAGTGAAACGAGGTGATGAAATAGCACTTGATGCAAGTATTTCTGGATCACCTTACCCAACTATTACATGGATAAAGGATGAAAATGTTATTGTACCAGAGGAAATTAAGAAGCGTGCAGCACCCTTGGTTAGGAGAAGGAAGGGTGAAGTTCAAGAAGAAGAACCATTTGTCCTGCCTCTGACACAGCGTTTGAGTATTGACAACAGCAAAAAGGGAGAATCTCAGCTACGCGTCCGAGATTCTCTCCGACCTGACCATGGTCTGTATATGATCAAAGTTGAAAATGACCACGGTATTGCAAAAGCTCCTTGTACTGTCAGTGTGTTAG
>TTN-201,ENSE00003811138,1,303,25483,25785,ATACACCGGGACCACCAATCAACTTTGTATTTGAAGATATCAGAAAGACCTCAGTCCTTTGTAAATGGGAACCACCCCTTGATGATGGTGGCAGTGAAATCATAAACTACACTTTGGAAAAGAAAGACAAGACAAAACCCGACTCAGAATGGATTGTTGTCACTTCAACACTTAGACATTGCAAATATTCAGTAACAAAACTGATTGAAGGAAAAGAGTACCTCTTCCGTGTAAGAGCTGAAAACAGATTTGGGCCAGGTCCACCATGTGTTTCAAAGCCACTTGTGGCTAAAGATCCATTTG
>TTN-201,ENSE00003809346,1,300,25786,26085,GACCACCTGATGCACCAGATAAGCCCATTGTGGAAGATGTTACCAGCAACAGTATGCTAGTGAAATGGAATGAACCAAAAGATAATGGAAGCCCCATTTTGGGTTACTGGCTTGAAAAACGTGAAGTTAACAGTACACATTGGTCTCGTGTCAACAAAAGCCTTCTGAATGCCTTGAAAGCCAATGTAGATGGCTTATTAGAAGGACTCACCTATGTCTTCAGAGTATGTGCTGAAAATGCAGCTGGACCTGGAAAGTTCAGTCCACCTTCAGATCCCAAAACAGCACATGATCCAATCT
>TTN-201,ENSE00003806782,1,297,26086,26382,CTCCTCCTGGGCCACCTATCCCAAGAGTCACTGACACAAGCTCTACAACTATTGAACTAGAATGGGAACCCCCAGCTTTCAATGGTGGTGGGGAAATTGTTGGCTATTTTGTTGATAAGCAGTTGGTTGGCACAAATGAATGGTCACGCTGCACAGAGAAGATGATCAAGGTCCGTCAGTACACCGTCAAAGAAATCCGAGAGGGTGCTGATTACAAACTTCGGGTGAGTGCTGTCAATGCCGCAGGGGAAGGACCGCCTGGAGAAACACAACCTGTTACTGTGGCTGAACCACAAG
>TTN-201,ENSE00003804121,1,285,26383,26667,AGCCTCCAGCTGTGGAACTGGATGTTTCTGTCAAGGGTGGAATACAAATAATGGCTGGGAAGACTCTTAGAATTCCAGCTGTGGTGACTGGTCGCCCTGTACCTACAAAAGTATGGACCAAAGAAGAAGGGGAGCTGGATAAAGACCGTGTTGTAATAGACAACGTTGGAACCAAATCTGAACTAATTATCAAGGATGCACTGCGAAAAGACCATGGCAGATATGTGATTACAGCTACAAATAGCTGTGGTTCCAAATTTGCAGCAGCCAGGGTAGAAGTTTTTG
>TTN-201,ENSE00003804454,1,294,26668,26961,ATGTCCCTGGTCCAGTTCTTGACTTAAAACCTGTTGTAACAAACAGAAAAATGTGTCTACTTAACTGGTCTGATCCAGAAGATGATGGAGGAAGTGAAATAACAGGCTTTATCATTGAAAGAAAAGATGCCAAGATGCATACTTGGAGACAACCAATAGAGACTGAGAGATCTAAATGTGACATCACAGGTCTGCTTGAGGGACAAGAATATAAGTTCCGTGTTATTGCCAAGAACAAGTTTGGCTGTGGCCCTCCTGTTGAAATAGGACCAATTCTTGCAGTTGATCCACTAG
>TTN-201,ENSE00003803420,1,300,26962,27261,GTCCTCCAACATCTCCAGAGAGGCTCACATACACTGAAAGGACAAAGTCCACTATCACACTTGACTGGAAAGAGCCCCGCAGTAATGGTGGCAGTCCCATCCAAGGATATATCATTGAAAAACGGCGTCATGACAAACCTGACTTTGAAAGAGTTAACAAGCGACTCTGCCCAACCACATCTTTTCTGGTTGAAAATCTTGATGAACACCAAATGTATGAGTTCCGTGTCAAAGCTGTCAATGAAATTGGTGAAAGTGAACCATCCCTACCTCTTAATGTAGTCATACAAGATGATGAAG
>TTN-201,ENSE00003809028,1,309,27262,27570,TGCCTCCAACTATTAAGTTGCGTCTGAGTGTTCGAGGAGACACTATCAAAGTTAAGGCAGGAGAGCCTGTCCACATCCCTGCAGATGTGACAGGCCTTCCAATGCCTAAGATTGAATGGTCCAAAAATGAAACTGTAATTGAAAAACCCACTGATGCACTTCAGATAACCAAGGAAGAGGTATCCCGAAGTGAGGCAAAAACTGAGCTTAGCATTCCCAAAGCGGTCCGGGAGGACAAAGGCACTTACACAGTTACTGCTTCCAATCGCCTTGGCTCAGTGTTCCGAAATGTTCACGTTGAAGTATATG
>TTN-201,ENSE00003801894,1,191,27571,27761,ACCGCCCATCCCCACCAAGAAATCTTGCTGTTACTGACATTAAAGCTGAATCTTGCTACTTGACATGGGATGCCCCTCTTGATAATGGTGGCAGTGAAATCACCCATTATGTTATTGACAAACGTGATGCAAGTAGGAAGAAAGCAGAATGGGAGGAAGTCACCAACACTGCTGTAGAGAAAAGATATGGG
>TTN-201,ENSE00003809851,1,430,27762,28191,ATCTGGAAACTTATCCCCAATGGTCAGTATGAGTTCCGAGTCAGGGCAGTGAATAAATATGGAATCAGTGATGAGTGCAAATCAGATAAAGTAGTCATTCAAGATCCTTATCGCCTTCCTGGACCTCCAGGAAAACCAAAAGTTTTGGCACGCACCAAAGGATCAATGCTAGTGAGCTGGACTCCTCCTTTGGACAATGGTGGCTCTCCAATTACTGGCTACTGGCTGGAGAAAAGAGAAGAGGGAAGTCCTTATTGGTCACGTGTTAGCCGAGCACCAATAACCAAAGTGGGATTGAAAGGCGTGGAATTTAATGTTCCTCGTTTGCTTGAAGGCGTTAAATACCAGTTCAGAGCCATGGCAATAAATGCTGCAGGAATTGGTCCTCCCAGTGAACCATCAGATCCAGAGGTTGCAGGAGATCCCATAT
>TTN-201,ENSE00003808594,1,309,28192,28500,TTCCACCGGGGCCACCTTCTTGCCCAGAAGTTAAAGATAAAACGAAGTCAAGCATCTCACTAGGATGGAAACCTCCAGCCAAAGATGGTGGCAGCCCAATCAAAGGATACATTGTAGAAATGCAAGAAGAAGGTACTACTGACTGGAAAAGAGTAAATGAACCAGACAAACTTATAACTACCTGTGAATGTGTGGTGCCTAATCTGAAAGAGCTCAGGAAGTACAGATTCAGAGTGAAAGCTGTCAATGAAGCTGGTGAATCTGAACCAAGTGATACAACTGGGGAGATCCCTGCCACTGATATTCAAG
>TTN-201,ENSE00003810473,1,149,28501,28649,AGGAACCAGAAGTTTTCATTGACATTGGAGCACAGGACTGTCTGGTTTGTAAAGCTGGCTCACAGATTAGGATTCCTGCTGTCATCAAGGGACGCCCAACACCAAAATCATCTTGGGAATTTGATGGAAAGGCAAAGAAAGCAATGAAG
>TTN-201,ENSE00003801625,1,33,28650,28682,GATGGAGTTCATGACATACCCGAAGATGCACAG
>TTN-201,ENSE00003802643,1,130,28683,28812,CTGGAGACTGCTGAAAACTCCTCAGTAATTATTATTCCGGAGTGTAAACGATCTCATACAGGCAAATACAGCATCACAGCCAAGAATAAAGCAGGACAAAAGACTGCAAATTGCAGAGTTAAAGTCATGG
>TTN-201,ENSE00003804239,1,300,28813,29112,ATGTACCAGGCCCACCCAAAGATCTGAAAGTCAGTGATATCACAAGGGGTAGTTGCAGACTTTCATGGAAGATGCCAGACGACGATGGAGGAGACAGGATCAAAGGCTATGTTATTGAGAAGAGGACTATTGATGGAAAAGCCTGGACCAAAGTCAATCCAGACTGTGGAAGCACCACATTTGTAGTGCCTGATCTCCTCTCTGAACAGCAATATTTCTTCCGTGTGCGAGCAGAAAACCGTTTTGGTATTGGCCCACCTGTGGAAACCATTCAGAGGACCACTGCCAGAGATCCGATAT
>TTN-201,ENSE00003806278,1,318,29113,29430,ATCCTCCTGATCCTCCTATTAAACTCAAGATTGGCCTCATCACAAAGAACACAGTGCATCTGTCATGGAAACCCCCGAAGAATGATGGGGGCTCCCCTGTTACCCACTATATTGTTGAGTGCCTTGCATGGGACCCTACTGGGACAAAGAAAGAAGCCTGGAGGCAGTGCAATAAGCGTGATGTGGAAGAACTGCAATTTACTGTTGAAGACCTAGTAGAGGGTGGGGAATATGAATTCCGAGTCAAAGCTGTCAATGCTGCAGGAGTCAGCAAGCCTTCAGCCACTGTTGGCCCTGTGACTGTCAAAGACCAGACAT
>TTN-201,ENSE00003801391,1,297,29431,29727,GCCCACCATCAATTGATCTAAAAGAATTCATGGAGGTTGAAGAAGGAACCAATGTTAACATTGTGGCCAAAATTAAAGGTGTGCCATTCCCGACACTAACCTGGTTTAAAGCTCCTCCAAAGAAGCCTGATAACAAAGAACCTGTTCTCTATGACACCCATGTCAACAAACTGGTGGTAGATGATACTTGCACTTTAGTTATTCCGCAGTCTCGCAGGAGTGACACTGGCTTATATACCATCACAGCTGTAAATAATCTGGGAACAGCATCAAAGGAGATGAGACTGAATGTCCTGG
>TTN-201,ENSE00003806021,1,300,29728,30027,GTCGTCCTGGCCCTCCAGTGGGACCCATAAAATTTGAATCTGTTTCAGCAGATCAAATGACACTATCTTGGTTTCCACCTAAAGATGATGGTGGGTCTAAGATTACAAACTATGTAATTGAGAAAAGAGAAGCTAACAGGAAGACATGGGTCCATGTCTCCAGTGAACCTAAGGAGTGCACGTACACGATTCCCAAATTGCTAGAAGGCCATGAATATGTATTCCGAATCATGGCCCAGAATAAATATGGCATTGGAGAACCTCTTGACAGTGAACCTGAAACAGCAAGAAACCTCTTCT
>TTN-201,ENSE00003803442,1,315,30028,30342,CTGTCCCTGGAGCACCAGATAAACCAACAGTTAGCAGCGTGACTCGTAACTCCATGACTGTCAACTGGGAAGAGCCAGAATATGATGGAGGCTCTCCTGTGACAGGGTACTGGCTGGAAATGAAAGACACCACTTCAAAGAGATGGAAGAGAGTTAACCGAGATCCTATCAAAGCCATGACTTTGGGTGTTTCTTATAAAGTGACTGGTCTTATTGAAGGTTCCGACTATCAATTCCGGGTATATGCAATCAATGCTGCTGGCGTGGGTCCAGCAAGTCTGCCATCAGACCCAGCGACTGCTAGAGATCCAATTG
>TTN-201,ENSE00003801787,1,149,30343,30491,CCCCTCCTGGTCCTCCATTTCCCAAAGTGACAGATTGGACTAAATCATCTGCAGATCTGGAGTGGTCTCCCCCACTAAAAGATGGTGGATCCAAAGTAACTGGATACATCGTTGAATATAAAGAAGAAGGAAAAGAAGAATGGGAAAAG
>TTN-201,ENSE00003802004,1,151,30492,30642,GGTAAAGATAAAGAAGTGAGAGGAACAAAGCTTGTTGTGACAGGATTAAAGGAAGGAGCATTCTACAAATTTAGAGTTAGAGCAGTCAACATTGCTGGCATTGGAGAACCTGGAGAGGTCACAGATGTCATTGAAATGAAGGACAGACTTG
>TTN-201,ENSE00003808790,1,282,30643,30924,TTTCACCTGACCTTCAGCTAGATGCCAGTGTCAGAGATAGAATTGTTGTCCATGCTGGAGGGGTGATCCGAATCATTGCCTATGTGTCTGGAAAGCCTCCTCCAACCGTCACCTGGAACATGAATGAAAGAACCTTACCTCAAGAAGCCACCATTGAGACCACAGCCATTAGCTCATCCATGGTCATCAAGAACTGCCAGAGGAGCCATCAAGGCGTCTATTCTCTTCTTGCCAAAAATGAAGCCGGAGAAAGAAAGAAGACAATTATTGTTGATGTATTAG
>TTN-201,ENSE00003807896,1,303,30925,31227,ATGTTCCAGGTCCCGTTGGAACACCATTCCTAGCTCACAACCTAACCAATGAGTCCTGCAAACTGACATGGTTTTCTCCAGAAGATGATGGAGGCTCTCCAATCACCAATTATGTCATTGAAAAGCGTGAATCTGACCGCAGAGCATGGACCCCAGTGACATATACAGTTACCCGACAAAATGCTACTGTCCAGGGTCTCATTCAAGGAAAAGCCTACTTTTTCCGAATTGCGGCTGAAAATAGTATTGGCATGGGTCCATTTGTTGAGACATCAGAGGCACTTGTTATCAGAGAGCCAATAA
>TTN-201,ENSE00003801753,1,303,31228,31530,CTGTACCAGAGCGTCCTGAAGACCTGGAAGTCAAAGAAGTTACTAAAAATACTGTAACTTTGACTTGGAATCCTCCTAAGTATGATGGTGGGTCAGAAATTATTAACTATGTCCTAGAAAGTCGGCTCATTGGGACTGAGAAGTTCCACAAAGTTACAAATGACAACTTGCTTAGCAGAAAATACACTGTTAAAGGCTTAAAAGAAGGTGATACCTATGAGTACCGTGTCAGTGCTGTCAACATTGTTGGACAAGGCAAACCATCATTTTGCACCAAACCAATTACTTGCAAGGATGAGCTGG
>TTN-201,ENSE00003807039,1,282,31531,31812,CACCCCCAACGCTTCACCTCGACTTCAGAGATAAGCTCACGATTCGAGTTGGTGAAGCTTTTGCCCTCACTGGCCGTTACTCAGGCAAACCAAAGCCTAAGGTTTCCTGGTTCAAAGATGAAGCTGATGTGCTGGAAGATGATCGCACTCATATAAAGACTACACCAGCAACACTTGCTTTAGAGAAGATCAAGGCCAAACGTTCAGATTCCGGCAAATACTGTGTGGTTGTGGAGAACAGTACAGGCTCTAGGAAAGGTTTCTGTCAAGTTAATGTTGTTG
>TTN-201,ENSE00003804106,1,300,31813,32112,ACCGTCCTGGACCACCAGTAGGACCAGTTAGTTTTGATGAGGTGACCAAAGATTACATGGTTATCTCTTGGAAGCCTCCTTTAGATGATGGAGGCAGTAAAATCACCAATTATATTATTGAGAAGAAGGAAGTGGGTAAAGACGTCTGGATGCCAGTGACATCTGCAAGTGCTAAAACAACATGCAAAGTTTCTAAACTACTTGAAGGAAAAGATTATATTTTCCGGATACATGCTGAAAATCTGTATGGAATAAGTGATCCTCTGGTGTCTGATTCAATGAAAGCCAAAGATCGTTTCA
>TTN-201,ENSE00003801817,1,303,32113,32415,GGGTTCCTGATGCACCTGATCAGCCAATTGTTACAGAAGTTACCAAAGACTCTGCATTAGTAACCTGGAATAAGCCACATGATGGAGGAAAACCCATCACAAACTACATCCTGGAAAAGAGAGAAACTATGTCTAAACGATGGGCTAGAGTTACCAAAGATCCTATTCATCCATACACTAAATTTAGGGTTCCTGATCTTCTAGAAGGATGTCAGTATGAATTCCGGGTTTCTGCAGAAAATGAAATTGGTATTGGAGATCCAAGCCCACCATCCAAACCAGTCTTTGCTAAAGATCCAATTG
>TTN-201,ENSE00003810564,1,309,32416,32724,CTAAACCAAGTCCACCTGTTAATCCTGAAGCAATAGATACAACATGCAATTCAGTCGATCTAACTTGGCAGCCACCACGTCATGATGGTGGGAGCAAGATTCTGGGTTATATTGTTGAGTACCAGAAAGTTGGAGATGAAGAGTGGAGAAGAGCCAATCACACCCCTGAGTCATGTCCTGAAACTAAATATAAAGTCACCGGTCTTCGGGACGGTCAAACCTATAAGTTTAGAGTGTTAGCAGTCAATGCAGCTGGTGAATCAGATCCAGCTCATGTTCCGGAGCCAGTCCTAGTAAAAGACAGGCTTG
>TTN-201,ENSE00003807476,1,282,32725,33006,AACCCCCTGAGTTGATTCTTGATGCCAACATGGCAAGAGAACAACACATTAAAGTTGGTGATACTCTAAGACTTAGTGCCATCATCAAAGGAGTGCCATTCCCAAAAGTAACTTGGAAAAAAGAAGACAGAGATGCTCCAACTAAAGCAAGAATTGATGTGACTCCAGTTGGTAGCAAGCTTGAAATTCGTAATGCTGCCCATGAAGATGGTGGAATTTATTCTTTAACAGTGGAGAATCCAGCTGGTTCAAAAACTGTCTCAGTAAAAGTACTTGTATTAG
>TTN-201,ENSE00003807363,1,300,33007,33306,ATAAACCTGGGCCACCTAGAGATCTGGAAGTCAGTGAAATTAGGAAAGATTCATGTTACCTTACTTGGAAAGAACCACTGGATGATGGTGGTTCTGTTATTACCAATTATGTGGTTGAGAGGAGAGATGTTGCCAGCGCCCAGTGGTCACCTCTCTCAGCTACATCAAAGAAAAAGAGTCACTTCGCTAAGCATCTGAATGAAGGCAACCAGTACCTCTTCCGAGTAGCTGCGGAGAACCAGTATGGACGTGGTCCTTTTGTTGAAACACCAAAACCAATCAAGGCTTTGGATCCTCTCC
>TTN-201,ENSE00003808994,1,294,33307,33600,ATCCCCCAGGGCCACCCAAGGACCTGCACCATGTAGATGTTGACAAGACTGAAGTCTCCCTAGTCTGGAATAAGCCGGATCGTGATGGTGGTTCTCCAATCACTGGATATTTGGTAGAATATCAAGAAGAAGGCACCCAGGACTGGATTAAATTTAAGACTGTGACAAACTTAGAGTGTGTGGTTACTGGACTACAACAAGGAAAGACCTATAGATTCCGTGTAAAAGCTGAAAACATTGTGGGTCTTGGTCTCCCTGACACAACTATCCCGATAGAATGTCAAGAAAAACTAG
>TTN-201,ENSE00003810188,1,2967,33601,36567,TGCCTCCATCCGTGGAGCTAGATGTGAAATTAATTGAAGGTCTTGTGGTAAAGGCTGGAACCACAGTCAGATTCCCTGCTATTATAAGAGGTGTGCCTGTTCCTACTGCAAAGTGGACAACCGATGGGAGTGAGATTAAAACCGATGAGCACTACACAGTTGAAACAGACAACTTCTCATCAGTACTTACCATTAAGAACTGCTTAAGGAGAGACACTGGGGAATATCAAATCACAGTTTCCAATGCAGCCGGTAGCAAAACAGTAGCCGTACATCTTACTGTTCTTGATGTTCCTGGGCCACCAACAGGTCCTATTAATATTCTGGATGTTACTCCTGAACACATGACTATCTCATGGCAGCCACCTAAGGATGATGGAGGAAGCCCTGTGATAAATTATATTGTTGAGAAACAAGATACAAGGAAAGACACGTGGGGTGTTGTCTCTTCCGGAAGCAGTAAGACAAAGCTGAAAATCCCACATCTGCAGAAGGGCTGTGAATATGTTTTCCGAGTTAGAGCAGAGAATAAGATAGGTGTTGGTCCTCCCCTTGACTCCACACCTACTGTTGCTAAGCATAAATTTAGTCCTCCGTCTCCTCCTGGTAAACCAGTGGTTACTGACATTACTGAAAATGCAGCAACAGTGTCTTGGACCCTGCCAAAATCTGATGGTGGCAGTCCAATAACTGGCTACTATATGGAACGTCGAGAAGTAACTGGCAAATGGGTGAGGGTCAACAAAACACCTATCGCTGACCTGAAGTTCAGAGTGACTGGACTCTATGAAGGAAATACATATGAGTTTAGAGTTTTTGCTGAAAATCTTGCAGGACTAAGCAAACCATCCCCAAGTTCTGATCCAATAAAAGCTTGCCGGCCCATCAAACCACCTGGACCACCTATTAATCCTAAACTGAAAGACAAGAGCAGAGAAACAGCTGATTTGGTGTGGACAAAGCCTCTCAGTGATGGTGGTAGCCCCATTCTAGGATATGTAGTGGAATGTCAGAAACCTGGCACAGCACAATGGAACAGGATTAATAAAGATGAACTCATTAGGCAATGTGCCTTTAGGGTACCTGGACTAATTGAAGGAAATGAGTACAGATTCCGTATAAAGGCAGCTAATATTGTAGGAGAGGGTGAGCCAAGAGAACTAGCAGAATCTGTGATTGCAAAAGATATCCTTCATCCTCCAGAAGTAGAACTTGATGTTACTTGTCGTGATGTTATTACCGTGAGAGTAGGCCAAACTATCCGCATTCTAGCTCGAGTCAAAGGCAGACCTGAACCAGACATAACTTGGACTAAGGAAGGCAAAGTATTGGTCCGAGAAAAGAGGGTGGACCTTATTCAGGATCTACCTCGTGTTGAGTTACAAATTAAAGAAGCTGTTAGAGCTGATCATGGCAAGTATATCATCTCAGCTAAGAACAGCAGTGGACATGCCCAAGGTTCAGCCATCGTTAACGTCCTTGACAGACCTGGGCCTTGCCAGAATTTGAAGGTTACCAATGTAACCAAAGAGAACTGTACAATTTCTTGGGAAAACCCACTAGATAATGGTGGCTCAGAAATAACAAACTTCATAGTAGAATATCGCAAACCAAACCAGAAAGGCTGGTCAATTGTTGCATCAGATGTCACTAAACGATTAATCAAGGCCAACCTTTTAGCCAACAATGAATACTATTTCCGAGTTTGTGCAGAGAATAAAGTAGGTGTTGGGCCAACCATCGAAACAAAAACTCCCATTCTGGCTATTAACCCTATTGACAGACCAGGTGAGCCTGAAAACCTTCACATTGCAGATAAAGGAAAGACATTTGTCTATCTAAAGTGGCGGAGGCCTGACTATGATGGTGGCAGTCCAAATCTGTCATATCATGTTGAGAGAAGGCTTAAGGGCTCCGATGACTGGGAAAGAGTGCATAAAGGAAGCATTAAAGAAACTCACTACATGGTTGACAGATGTGTTGAAAACCAGATTTATGAGTTCAGAGTGCAAACAAAGAATGAAGGTGGGGAAAGTGACTGGGTGAAGACAGAGGAAGTTGTTGTGAAAGAAGACTTACAAAAACCAGTACTTGATCTGAAATTAAGTGGGGTCCTAACTGTCAAAGCAGGGGACACCATTAGGCTTGAGGCAGGGGTTAGAGGCAAACCATTCCCAGAAGTTGCATGGACCAAGGACAAAGACGCTACAGACTTAACAAGATCACCAAGGGTCAAGATTGATACCCGTGCTGATTCATCTAAATTTTCTCTTACTAAAGCAAAGCGAAGTGATGGGGGTAAATATGTAGTTACGGCAACTAACACGGCTGGCAGTTTTGTGGCCTATGCCACTGTCAATGTTTTAGATAAGCCTGGTCCTGTGAGAAATCTGAAAATTGTTGATGTGTCCAGTGATAGGTGTACTGTTTGCTGGGATCCACCAGAAGATGATGGTGGCTGTGAAATCCAAAATTATATTCTAGAAAAATGTGAGACAAAGCGAATGGTTTGGTCTACCTATTCTGCTACTGTCTTGACACCTGGTACTACAGTAACACGTCTCATAGAAGGAAATGAATATATTTTCAGAGTCCGTGCAGAAAATAAAATAGGCACAGGGCCTCCAACAGAAAGTAAACCAGTCATAGCCAAAACCAAGTATGATAAACCTGGTCGCCCTGATCCCCCAGAAGTCACTAAAGTAAGCAAAGAAGAGATGACTGTGGTTTGGAATCCACCTGAATATGATGGTGGAAAGTCTATAACTGGATACTTTTTGGAGAAAAAGGAAAAGCATTCAACACGATGGGTCCCTGTCAACAAGAGTGCAATCCCTGAGAGACGTATGAAAGTACAGAATCTCCTCCCAGACCATGAATATCAGTTCCGTGTCAAGGCAGAAAATGAAATTGGAATTGGAGAACCAAGCTTGCCTTCAAGACCGGTGGTGGCAAAAGACCCCATAG
>TTN-201,ENSE00003811401,1,321,36568,36888,AGCCACCTGGTCCACCAACCAATTTCAGAGTGGTTGATACAACCAAACATTCCATAACTCTTGGGTGGGGAAAACCAGTCTATGATGGTGGTGCACCGATCATTGGATATGTTGTGGAAATGAGACCAAAAATAGCAGATGCGTCTCCTGATGAAGGCTGGAAACGGTGTAATGCTGCAGCACAGCTTGTACGCAAGGAATTCACTGTTACCAGCTTGGATGAAAACCAGGAATATGAGTTCAGGGTGTGTGCCCAAAACCAAGTTGGTATTGGGCGCCCTGCAGAGCTAAAGGAAGCTATCAAACCTAAAGAAATACTAG
>TTN-201,ENSE00003805661,1,285,36889,37173,AACCTCCGGAGATTGATTTGGATGCCAGCATGAGGAAACTGGTCATAGTGAGAGCAGGATGCCCTATTCGTCTCTTTGCTATAGTGAGAGGACGACCAGCCCCTAAAGTCACTTGGCGAAAAGTTGGCATTGATAATGTGGTCAGAAAAGGACAAGTTGATCTGGTTGACACTATGGCCTTCCTTGTCATCCCCAATTCTACCCGTGATGACTCAGGAAAATATTCCTTAACACTTGTGAACCCAGCAGGAGAAAAGGCTGTATTCGTAAATGTCAGAGTATTAG
>TTN-201,ENSE00003804742,1,300,37174,37473,ACACTCCTGGGCCTGTGTCTGATTTAAAAGTTTCAGATGTCACTAAAACATCATGCCATGTGTCCTGGGCCCCTCCTGAAAACGACGGTGGGAGCCAAGTGACACATTATATCGTGGAGAAACGTGAGGCAGACAGAAAGACATGGTCGACCGTTACCCCAGAAGTTAAGAAAACAAGCTTCCATGTAACCAATCTTGTCCCTGGGAATGAGTATTACTTCAGAGTAACTGCTGTCAACGAATATGGCCCTGGCGTCCCAACAGATGTCCCAAAACCAGTGCTTGCATCAGATCCTCTAA
>TTN-201,ENSE00003810357,1,303,37474,37776,GTGAGCCGGATCCCCCAAGGAAATTAGAAGTGACTGAAATGACCAAGAACAGTGCCACCTTAGCCTGGTTACCTCCCCTACGTGATGGAGGTGCTAAAATCGATGGCTACATCACTAGTTACAGAGAAGAAGAGCAGCCTGCAGATCGCTGGACAGAGTACTCAGTGGTAAAAGATCTGAGCCTTGTTGTCACTGGCCTAAAGGAAGGAAAGAAATACAAATTTAGAGTAGCGGCCAGAAATGCTGTTGGAGTCAGTTTGCCAAGAGAAGCTGAAGGAGTGTATGAAGCCAAAGAACAACTGT
>TTN-201,ENSE00003801707,1,276,37777,38052,TGCCACCAAAGATCCTTATGCCAGAGCAAATAACTATCAAAGCTGGGAAAAAACTCCGAATTGAAGCCCATGTGTATGGAAAGCCTCATCCCACCTGTAAATGGAAAAAAGGAGAAGATGAAGTTGTCACATCCAGCCACCTGGCAGTGCATAAAGCAGACAGCTCTTCAATTCTGATCATAAAAGATGTGACTAGGAAAGACAGTGGTTACTACAGCCTCACAGCAGAGAACAGTTCTGGGACAGACACTCAGAAAATCAAAGTTGTAGTCATGG
>TTN-201,ENSE00003810399,1,300,38053,38352,ATGCCCCCGGCCCCCCTCAGCCTCCATTTGACATTTCTGATATAGACGCTGATGCTTGCTCCCTGTCATGGCACATCCCTCTGGAGGACGGAGGCAGTAACATCACCAATTATATAGTGGAGAAGTGTGATGTAAGCCGAGGTGACTGGGTCACGGCTCTAGCTTCAGTCACAAAAACTTCCTGCAGGGTTGGAAAGCTGATCCCAGGCCAGGAGTACATCTTCCGGGTCCGTGCTGAAAACCGATTTGGCATTTCAGAGCCTCTCACATCTCCAAAGATGGTTGCGCAGTTCCCATTTG
>TTN-201,ENSE00003810448,1,303,38353,38655,GTGTTCCTAGTGAACCAAAGAATGCACGAGTCACCAAAGTCAACAAGGACTGTATTTTTGTTGCTTGGGACAGACCAGATAGTGATGGAGGGAGCCCCATTATTGGTTATCTGATTGAACGCAAGGAAAGAAACAGTTTGCTGTGGGTGAAAGCCAATGATACTCTTGTCCGGTCAACTGAATATCCTTGTGCTGGCCTTGTAGAAGGTCTTGAGTATTCATTCAGAATCTATGCCCTAAACAAAGCTGGATCCAGCCCACCCAGCAAACCCACAGAATATGTAACTGCAAGAATGCCAGTTG
>TTN-201,ENSE00003802505,1,300,38656,38955,ATCCTCCTGGGAAACCTGAGGTTATTGATGTCACCAAGAGTACTGTATCTCTGATCTGGGCTCGTCCAAAGCATGATGGAGGCAGTAAAATTATTGGCTATTTCGTAGAAGCTTGCAAACTTCCTGGTGATAAATGGGTACGGTGCAATACTGCACCTCACCAGATTCCCCAGGAAGAGTACACAGCTACTGGCCTAGAAGAGAAAGCTCAGTATCAATTTAGAGCTATTGCCAGGACCGCGGTAAACATTAGCCCACCTTCTGAACCTTCTGATCCAGTGACTATCCTCGCAGAAAATG
>TTN-201,ENSE00003806397,1,288,38956,39243,TCCCTCCCAGGATAGACCTGAGTGTGGCTATGAAATCTTTGCTTACTGTGAAAGCTGGAACTAATGTCTGCTTGGATGCTACTGTTTTTGGTAAACCGATGCCAACAGTTTCTTGGAAAAAAGATGGCACACTGCTAAAACCAGCAGAAGGCATAAAGATGGCCATGCAGCGGAATCTGTGCACCTTGGAGCTATTCAGCGTGAACCGGAAGGACTCAGGAGACTATACCATTACTGCTGAAAATTCAAGTGGTTCTAAATCAGCCACCATTAAGCTTAAAGTGTTAG
>TTN-201,ENSE00003807889,1,297,39244,39540,ATAAACCGGGTCCTCCAGCATCTGTTAAAATCAACAAAATGTATTCAGATCGTGCTATGCTTTCTTGGGAACCGCCTCTTGAAGATGGAGGCTCAGAAATCACCAACTATATTGTTGACAAACGTGAAACAAGCAGGCCCAACTGGGCTCAAGTCTCTGCAACTGTGCCTATCACCAGCTGCAGCGTGGAGAAACTTATAGAGGGCCATGAGTATCAGTTCCGTATTTGTGCTGAAAATAAATATGGAGTAGGCGATCCAGTCTTCACTGAACCAGCAATTGCCAAAAACCCATATG
>TTN-201,ENSE00003811290,1,303,39541,39843,ACCCACCAGGACGCTGTGATCCTCCTGTTATTAGCAACATAACCAAAGATCACATGACAGTCAGCTGGAAGCCACCAGCAGATGATGGGGGCTCACCCATCACTGGCTATTTGCTTGAAAAGCGGGAAACCCAGGCTGTTAACTGGACTAAGGTCAACAGAAAACCTATTATAGAAAGAACATTAAAAGCAACAGGTCTTCAAGAAGGTACCGAATATGAGTTCCGTGTTACAGCTATAAATAAAGCTGGACCAGGCAAACCCAGTGACGCATCCAAGGCCGCTTATGCTCGGGACCCTCAGT
>TTN-201,ENSE00003808853,1,306,39844,40149,ATCCTCCTGGCCCACCGGCTTTCCCTAAAGTATATGATACAACTCGCAGCTCTGTGAGTCTATCTTGGGGCAAGCCAGCCTATGACGGCGGCAGCCCTATCATTGGTTATCTCGTTGAAGTAAAACGGGCTGACTCCGATAACTGGGTGAGGTGCAACTTACCACAGAATCTACAGAAAACCCGCTTTGAGGTTACTGGCCTGATGGAAGACACACAATATCAATTCCGTGTGTATGCCGTTAATAAGATTGGATACAGTGACCCCAGTGATGTGCCAGATAAACACTATCCCAAGGACATCTTAA
>TTN-201,ENSE00003807542,1,288,40150,40437,TTCCACCTGAGGGAGAACTTGATGCGGACTTAAGGAAGACACTCATATTACGTGCTGGAGTTACTATGAGACTATATGTACCAGTAAAAGGACGCCCACCTCCAAAGATTACTTGGTCTAAACCAAATGTCAATCTAAGAGACAGGATTGGACTGGACATAAAGTCAACTGACTTTGACACTTTCTTGCGCTGTGAAAATGTGAACAAATATGATGCAGGAAAATATATCTTAACCCTGGAGAACAGCTGTGGTAAAAAGGAATATACCATTGTTGTGAAAGTGCTTG
>TTN-201,ENSE00003810775,1,291,40438,40728,ATACTCCTGGGCCACCTGTCAATGTGACTGTTAAGGAAATATCCAAAGACTCTGCTTATGTTACCTGGGAGCCTCCCATTATTGATGGCGGAAGCCCCATCATAAACTATGTGGTACAAAAACGTGATGCAGAGAGGAAATCCTGGTCTACAGTGACAACTGAGTGCTCCAAAACAAGCTTCAGAGTAGCTAATTTGGAGGAGGGAAAATCCTACTTCTTCCGAGTGTTTGCTGAAAATGAGTATGGCATTGGTGATCCCGGTGAAACTCGTGATGCTGTCAAAGCTTCCC
>TTN-201,ENSE00003811210,1,288,40729,41016,AAACTCCTGGACCAGTTGTGGACCTGAAAGTGAGGTCTGTATCTAAGTCATCCTGTAGCATTGGCTGGAAAAAGCCTCACAGTGATGGTGGAAGTCGGATTATTGGATATGTAGTTGATTTCCTGACTGAAGAAAATAAGTGGCAACGAGTTATGAAATCCTTAAGCCTACAGTACTCTGCAAAAGATTTGACTGAAGGGAAGGAATATACCTTCAGAGTGAGTGCTGAGAATGAAAATGGAGAAGGAACCCCAAGCGAAATCACTGTTGTGGCAAGGGATGATGTTG
>TTN-201,ENSE00003805436,1,588,41017,41604,TGGCTCCTGATCTTGACTTAAAGGGTCTACCTGATTTGTGCTACTTGGCTAAAGAAAACAGCAACTTCCGGCTTAAGATCCCCATAAAAGGCAAGCCAGCTCCATCAGTCTCCTGGAAGAAAGGGGAAGATCCTCTAGCAACTGACACTAGAGTCAGTGTTGAGTCATCTGCGGTTAACACAACTCTTATAGTGTACGATTGCCAAAAATCTGATGCTGGAAAATACACAATCACACTTAAGAATGTTGCTGGCACCAAGGAAGGAACTATCTCCATAAAGGTTGTTGGCAAGCCTGGCATCCCCACTGGACCAATCAAATTTGATGAAGTCACAGCAGAAGCCATGACCTTAAAGTGGGCTCCTCCAAAGGATGATGGAGGTTCTGAAATCACCAACTATATCCTAGAGAAGAGGGATTCTGTGAACAACAAGTGGGTGACGTGCGCCTCAGCTGTCCAGAAAACCACCTTTAGAGTAACCAGACTTCATGAGGGCATGGAATATACCTTCAGGGTCAGTGCCGAAAATAAATATGGTGTAGGGGAAGGCCTGAAATCGGAGCCAATTGTTGCGAGACATCCATTTG
>TTN-201,ENSE00003808777,1,105,41605,41709,ATGTGCCTGATGCTCCCCCACCTCCCAATATTGTGGATGTCAGACACGATTCAGTATCTCTAACTTGGACTGACCCCAAGAAAACTGGTGGTTCTCCAATTACAG
>TTN-201,ENSE00003806939,1,198,41710,41907,GGTATCATCTCGAGTTCAAGGAAAGAAACAGCCTTTTGTGGAAGAGAGCTAACAAGACTCCGATAAGGATGAGAGACTTTAAAGTGACAGGATTAACTGAAGGTCTTGAATATGAATTCCGAGTTATGGCAATCAATTTAGCAGGTGTGGGCAAGCCAAGCCTACCATCAGAGCCTGTTGTGGCACTGGACCCAATTG
>TTN-201,ENSE00003811024,1,297,41908,42204,ATCCTCCTGGAAAACCTGAGGTTATTAACATAACAAGGAATTCAGTGACTCTCATTTGGACTGAACCTAAATATGACGGTGGTCATAAGTTAACTGGATATATAGTGGAGAAGCGAGATCTACCTTCGAAGTCTTGGATGAAAGCCAACCATGTTAATGTCCCAGAATGTGCCTTTACTGTAACTGACCTTGTTGAGGGTGGAAAATATGAATTCAGAATTAGAGCAAAGAATACAGCAGGTGCTATCAGTGCTCCATCAGAAAGTACAGAAACCATTATTTGCAAGGATGAATACG
>TTN-201,ENSE00003803896,1,588,42205,42792,AGGCACCAACAATTGTCCTTGATCCCACAATAAAAGATGGGCTAACAATTAAAGCAGGGGATACCATTGTTTTGAATGCCATTAGCATTCTTGGCAAACCCCTTCCAAAATCAAGTTGGTCCAAGGCAGGAAAAGACATTAGACCATCAGATATCACTCAGATAACTTCAACCCCAACATCTTCCATGCTTACTATCAAGTATGCCACTAGAAAAGATGCGGGTGAATATACCATCACTGCTACCAATCCTTTTGGCACGAAGGTGGAACATGTGAAGGTAACAGTCCTTGATGTACCTGGTCCCCCAGGTCCTGTTGAAATCAGTAATGTTTCTGCTGAAAAAGCAACACTTACATGGACACCTCCCTTGGAAGATGGCGGCTCACCAATTAAGTCCTATATACTTGAAAAGAGAGAAACCAGCCGACTTTTGTGGACAGTGGTTTCTGAAGATATTCAGTCTTGCAGGCATGTGGCAACCAAACTTATCCAAGGAAATGAGTACATCTTCCGGGTCTCAGCTGTAAACCACTATGGCAAAGGAGAACCTGTACAGTCTGAACCTGTCAAAATGGTAGACAGATTTG
>TTN-201,ENSE00003807419,1,303,42793,43095,GTCCCCCTGGCCCTCCTGAAAAACCAGAGGTATCAAATGTCACTAAGAACACTGCCACTGTCAGCTGGAAAAGGCCAGTGGATGATGGTGGCAGCGAAATTACAGGATATCATGTAGAAAGGAGAGAAAAGAAAAGCCTGCGATGGGTGAGAGCAATAAAAACACCAGTTTCCGATCTCAGGTGCAAAGTAACAGGACTGCAAGAAGGAAGCACCTACGAATTCCGTGTCAGTGCAGAAAACAGAGCAGGAATTGGTCCACCCAGTGAGGCTTCAGATTCTGTTCTGATGAAAGATGCAGCAT
>TTN-201,ENSE00003811193,1,17106,43096,60201,ATCCTCCAGGACCACCTTCAAATCCGCATGTCACTGATACTACCAAGAAATCTGCTTCTTTGGCATGGGGCAAGCCTCATTATGATGGTGGACTTGAAATCACTGGCTATGTCGTGGAGCATCAAAAAGTAGGAGACGAGGCCTGGATAAAAGATACCACAGGAACCGCCCTCAGAATCACTCAGTTCGTTGTTCCTGATCTTCAGACTAAAGAAAAATACAACTTCAGAATCAGTGCCATCAACGATGCAGGTGTTGGGGAGCCAGCGGTGATTCCAGATGTTGAAATCGTAGAACGGGAGATGGCTCCTGATTTTGAACTAGATGCCGAGCTTCGAAGAACACTTGTTGTTAGAGCAGGACTCAGTATTAGGATATTTGTGCCAATTAAAGGTCGTCCTGCTCCTGAAGTGACATGGACCAAAGATAACATCAACCTGAAAAACCGAGCCAACATTGAAAATACGGAATCATTTACTCTTCTGATTATCCCAGAATGTAACAGATATGATACCGGTAAATTTGTCATGACCATTGAAAACCCGGCTGGGAAGAAAAGTGGCTTTGTGAACGTCAGAGTCTTGGACACGCCAGGCCCAGTCCTCAACCTGCGGCCTACAGACATCACAAAGGACAGTGTCACCCTGCACTGGGACCTCCCTCTGATAGATGGAGGCTCACGTATAACAAACTACATTGTAGAGAAACGTGAAGCAACACGGAAATCTTATTCCACAGCCACCACTAAGTGCCATAAATGCACATATAAAGTTACCGGCTTGTCTGAAGGGTGTGAATATTTCTTCAGAGTGATGGCAGAGAATGAATATGGAATTGGTGAGCCAACAGAAACTACAGAGCCCGTAAAAGCCTCTGAAGCACCATCTCCACCAGACAGCCTTAACATCATGGACATAACTAAGAGCACCGTCAGCCTGGCATGGCCTAAGCCCAAACACGATGGTGGCAGCAAGATCACTGGCTATGTGATTGAAGCCCAAAGAAAAGGCTCTGACCAGTGGACCCACATCACAACCGTGAAAGGGTTAGAATGTGTTGTGAGGAATCTAACTGAAGGAGAGGAATATACCTTCCAAGTGATGGCAGTGAACAGCGCGGGGAGAAGTGCCCCTAGAGAAAGCAGACCCGTCATTGTCAAGGAGCAGACAATGCTTCCAGAGCTGGATCTCCGTGGCATCTATCAGAAACTGGTCATTGCCAAAGCTGGTGACAACATCAAAGTTGAAATTCCAGTGCTCGGTCGACCGAAGCCCACAGTGACATGGAAAAAAGGAGACCAAATTCTTAAACAGACACAGAGAGTTAATTTTGAAACCACAGCGACTTCAACCATTTTAAATATCAATGAGTGTGTCAGAAGTGATAGTGGGCCCTATCCATTAACAGCAAGGAACATTGTAGGAGAGGTTGGTGATGTCATCACCATTCAAGTCCATGATATCCCAGGGCCACCTACTGGACCAATCAAATTTGATGAAGTTTCATCTGATTTTGTAACCTTCTCTTGGGACCCACCTGAGAACGATGGTGGTGTACCAATAAGCAACTATGTAGTGGAAATGCGGCAGACTGACAGTACTACCTGGGTTGAGTTAGCAACCACCGTTATACGTACTACCTATAAAGCCACCCGCCTTACTACTGGATTAGAGTATCAGTTCCGTGTAAAAGCTCAGAATAGATATGGAGTTGGACCAGGCATCACATCAGCATGCATAGTTGCCAACTATCCATTTAAGGTTCCTGGACCTCCTGGTACCCCTCAGGTAACTGCAGTTACCAAGGATTCAATGACAATTAGCTGGCATGAGCCACTTTCTGATGGTGGAAGCCCCATTTTAGGATATCATGTTGAAAGAAAAGAACGAAATGGTATTCTCTGGCAGACTGTGAGCAAAGCTTTAGTACCAGGCAACATTTTCAAATCAAGTGGACTTACAGATGGTATTGCTTATGAGTTCCGGGTGATTGCAGAAAACATGGCAGGCAAAAGTAAGCCAAGCAAGCCATCAGAACCTATGTTGGCTCTGGATCCCATTGACCCACCTGGAAAACCAGTACCTCTAAATATTACAAGACACACAGTAACACTTAAATGGGCTAAGCCTGAATATACTGGGGGCTTTAAAATTACCAGTTATATCGTTGAAAAGAGAGACCTTCCTAATGGACGGTGGCTGAAGGCCAACTTCAGCAACATTTTGGAGAATGAATTTACAGTCAGTGGCCTAACAGAAGATGCTGCATATGAATTCCGTGTGATCGCCAAAAATGCTGCAGGTGCCATCAGTCCACCATCTGAGCCATCTGATGCTATCACTTGCAGGGATGATGTTGAGGCACCAAAGATAAAGGTGGATGTTAAATTTAAGGACACGGTTATATTAAAAGCAGGTGAAGCATTCAGACTGGAAGCTGATGTTTCAGGCCGCCCACCTCCAACAATGGAATGGAGCAAAGATGGAAAAGAGCTGGAAGGCACAGCAAAGTTAGAAATAAAAATTGCAGATTTCTCTACTAATCTGGTAAACAAAGATTCAACAAGAAGGGATAGTGGTGCCTATACCCTTACAGCGACTAATCCTGGTGGCTTTGCTAAACACATTTTCAATGTCAAAGTTCTTGACAGACCAGGCCCACCTGAAGGACCTTTGGCTGTAACTGAAGTGACATCAGAAAAGTGTGTACTATCATGGTTCCCTCCACTGGATGATGGAGGTGCCAAAATTGATCATTACATAGTACAGAAACGTGAAACCAGCAGATTGGCATGGACAAATGTAGCCTCAGAAGTCCAAGTAACAAAGCTAAAGGTCACTAAACTCTTGAAAGGCAATGAATACATATTCCGTGTCATGGCTGTAAATAAATATGGAGTGGGAGAGCCACTGGAATCAGAGCCTGTGCTTGCAGTGAATCCTTATGGACCCCCTGATCCGCCCAAAAACCCTGAAGTGACAACTATTACTAAAGATTCGATGGTTGTCTGCTGGGGACATCCTGATTCTGATGGTGGAAGTGAAATCATCAATTATATTGTGGAACGGCGTGATAAAGCTGGCCAACGCTGGATTAAATGCAACAAAAAAACTCTTACTGATTTAAGATATAAAGTGTCTGGACTGACAGAAGGACATGAATATGAGTTCAGGATTATGGCTGAAAATGCTGCTGGAATTAGTGCACCAAGTCCTACCAGTCCATTTTACAAGGCTTGTGACACTGTGTTTAAACCTGGACCACCAGGTAACCCACGTGTTCTGGATACAAGCAGATCATCCATTTCAATCGCTTGGAATAAACCTATCTATGATGGTGGTTCAGAAATCACTGGGTATATGGTTGAGATTGCCCTGCCAGAGGAAGATGAATGGCAGATTGTCACTCCACCAGCAGGACTCAAGGCAACTTCGTATACTATCACTGGCCTCACAGAGAATCAGGAATATAAGATCCGCATCTATGCCATGAATTCCGAAGGACTTGGGGAACCTGCCCTTGTTCCTGGAACTCCAAAGGCTGAAGACAGAATGCTGCCTCCAGAAATTGAACTGGATGCTGACCTGCGCAAAGTTGTTACTATAAGGGCCTGCTGCACCCTGAGACTTTTTGTTCCCATCAAAGGAAGGCCTGCACCTGAGGTGAAGTGGGCCCGGGACCATGGAGAATCTTTAGATAAAGCTAGCATCGAATCCACAAGCTCTTACACCCTGCTTATTGTTGGAAATGTAAACAGATTTGACAGTGGCAAATATATACTAACTGTAGAAAATAGTTCAGGCAGCAAGTCTGCATTTGTCAATGTTAGAGTTCTCGATACACCAGGCCCCCCACAGGATCTGAAGGTAAAAGAGGTCACTAAGACATCTGTCACACTCACATGGGACCCACCTCTCCTTGATGGAGGTTCAAAAATCAAGAACTATATTGTTGAAAAGCGGGAATCAACAAGAAAAGCATATTCAACTGTTGCAACAAACTGCCACAAGACTTCCTGGAAGGTAGACCAGCTTCAAGAAGGCTGTAGCTACTATTTCAGGGTTCTCGCAGAAAATGAATATGGCATTGGGCTGCCTGCTGAAACCGCAGAATCTGTGAAAGCATCAGAACGACCTCTTCCTCCAGGAAAAATAACTTTGATGGATGTCACAAGAAATAGTGTGTCACTCTCTTGGGAGAAACCAGAGCATGATGGAGGCAGCCGAATTCTAGGCTACATTGTGGAGATGCAGACCAAAGGCAGTGACAAATGGGCCACGTGTGCCACAGTCAAGGTCACTGAAGCCACTATCACTGGATTAATTCAGGGTGAAGAATACTCTTTCCGTGTTTCAGCTCAGAATGAAAAGGGCATCAGTGATCCTAGACAACTGAGTGTGCCAGTGATCGCCAAAGATCTTGTCATTCCACCAGCCTTCAAACTCCTGTTCAATACTTTCACTGTACTGGCAGGTGAAGACCTAAAAGTTGATGTTCCATTCATTGGCCGCCCTACCCCAGCTGTAACCTGGCATAAAGATAATGTACCACTGAAGCAGACAACTAGAGTAAATGCAGAGAGCACAGAAAATAATTCACTACTGACAATAAAGGACGCCTGCCGAGAAGATGTTGGCCATTATGTGGTTAAACTGACTAACTCAGCTGGTGAAGCTATTGAAACCCTTAATGTTATCGTTCTTGACAAACCAGGGCCTCCAACTGGACCAGTTAAAATGGATGAAGTGACAGCTGATAGTATTACTCTTTCCTGGGGCCCACCCAAGTATGATGGTGGAAGTTCTATCAATAATTACATTGTTGAGAAACGGGACACTTCCACAACCACCTGGCAAATTGTATCAGCTACAGTTGCAAGGACAACAATAAAGGCTTGCAGACTGAAGACTGGATGTGAATATCAGTTTAGAATTGCAGCTGAAAACAGATATGGGAAGAGTACCTACCTCAATTCAGAGCCTACTGTAGCCCAATATCCATTCAAAGTTCCTGGTCCTCCTGGCACTCCAGTTGTCACACTGTCCTCCAGGGACAGCATGGAAGTACAATGGAATGAGCCAATCAGTGATGGAGGAAGTAGAGTCATTGGCTATCATCTAGAACGCAAGGAAAGAAATAGCATCCTCTGGGTTAAGTTGAATAAAACACCTATTCCTCAAACCAAGTTTAAGACAACTGGCCTTGAAGAAGGTGTTGAATATGAATTTAGAGTCTCTGCAGAGAACATCGTGGGCATTGGCAAGCCGAGTAAAGTATCAGAATGTTATGTGGCTCGTGACCCATGTGATCCACCAGGACGGCCAGAGGCAATCATTGTCACAAGGAATTCTGTGACTCTTCAGTGGAAGAAACCCACCTATGACGGTGGAAGCAAGATCACTGGTTATATTGTTGAGAAGAAAGAATTACCTGAGGGCCGTTGGATGAAAGCCAGTTTTACAAATATTATTGACACTCATTTTGAAGTAACTGGCCTAGTTGAAGATCACAGATATGAGTTCCGGGTTATAGCCCGAAATGCCGCAGGAGTGTTTAGTGAGCCTTCAGAAAGCACAGGAGCAATAACAGCTAGAGATGAGGTAGATCCACCACGAATAAGTATGGATCCAAAATACAAAGACACAATCGTGGTTCATGCTGGTGAATCATTCAAGGTTGATGCAGATATTTATGGCAAACCAATACCAACCATTCAGTGGATAAAAGGTGATCAGGAGCTTTCAAACACAGCTCGATTAGAAATAAAGAGCACCGACTTTGCCACCAGTCTCAGTGTAAAAGATGCAGTACGTGTCGACAGTGGAAATTACATACTGAAGGCCAAAAATGTTGCAGGAGAAAGATCAGTTACTGTGAATGTCAAGGTTCTTGACAGACCAGGGCCACCTGAAGGACCTGTTGTTATCTCAGGAGTTACAGCAGAAAAATGCACACTAGCTTGGAAACCCCCACTTCAGGATGGTGGGAGTGACATCATAAATTATATTGTGGAAAGGAGAGAAACCAGCCGCTTAGTTTGGACTGTGGTTGATGCCAATGTGCAGACTCTCAGCTGCAAGGTTACTAAGCTTCTTGAAGGCAATGAATATACTTTCCGTATAATGGCAGTAAACAAATATGGTGTTGGTGAACCTCTTGAATCTGAGCCAGTAGTTGCCAAGAATCCATTTGTAGTACCAGATGCACCAAAAGCTCCAGAAGTCACAACAGTGACCAAGGACTCAATGATTGTTGTATGGGAAAGACCAGCATCTGATGGTGGTAGTGAAATTCTTGGATATGTTCTTGAGAAACGGGATAAAGAAGGCATTAGATGGACAAGATGCCATAAGCGTCTGATTGGAGAGTTGCGCCTGAGAGTAACTGGACTCATAGAAAATCACGATTATGAGTTCAGAGTTTCTGCTGAGAATGCTGCTGGACTTAGTGAACCAAGCCCTCCTTCTGCTTACCAAAAGGCTTGTGATCCTATTTATAAACCAGGACCCCCAAACAACCCCAAAGTCATAGACATAACCAGATCTTCAGTATTCCTTTCTTGGAGCAAACCAATATATGATGGTGGCTGTGAAATTCAAGGATACATTGTTGAAAAATGTGATGTGAGTGTTGGTGAATGGACAATGTGCACTCCACCAACAGGAATTAATAAAACAAACATAGAAGTAGAGAAGCTGTTGGAAAAGCATGAATACAACTTCCGTATCTGTGCTATTAATAAAGCTGGAGTTGGAGAACATGCTGACGTCCCTGGACCTATTATAGTTGAAGAAAAATTAGAAGCACCAGACATTGATCTTGACCTAGAACTAAGGAAAATCATAAATATAAGGGCAGGTGGCTCCTTAAGGTTATTTGTTCCTATAAAAGGTCGTCCTACACCAGAAGTTAAATGGGGAAAGGTGGATGGTGAAATCCGAGATGCAGCTATAATTGATGTCACTAGCAGTTTCACCTCTCTTGTTCTTGACAATGTCAACCGATATGATAGTGGAAAATATACGCTTACATTAGAAAACAGCAGTGGAACAAAGTCTGCCTTTGTTACTGTGAGAGTTCTGGACACGCCAAGTCCACCTGTTAACCTGAAAGTCACAGAAATCACCAAAGACTCAGTATCAATTACATGGGAACCTCCTTTGTTGGATGGGGGATCCAAAATAAAAAATTACATTGTTGAGAAACGTGAAGCCACAAGAAAATCATATGCTGCTGTTGTAACTAACTGCCATAAGAATTCTTGGAAAATCGATCAGCTCCAAGAAGGTTGCAGTTATTACTTTAGAGTCACAGCTGAGAATGAGTATGGTATTGGCCTTCCTGCCCAGACTGCTGATCCAATTAAGGTTGCAGAAGTGCCACAACCTCCTGGAAAAATAACTGTGGATGATGTCACCAGAAACAGTGTCTCTCTGAGTTGGACAAAACCTGAACATGATGGTGGCAGTAAAATCATTCAGTATATTGTGGAAATGCAAGCTAAACACAGTGAGAAATGGTCAGAGTGTGCTCGAGTAAAGTCTCTTCAGGCAGTAATTACCAACCTAACTCAAGGGGAAGAATATCTTTTTAGAGTTGTTGCTGTAAATGAAAAGGGGAGAAGTGATCCTCGGTCCCTTGCAGTTCCAATAGTTGCCAAAGATCTGGTAATTGAGCCAGATGTAAAACCTGCATTCAGTAGTTACAGTGTACAGGTTGGCCAAGATTTGAAAATAGAAGTGCCAATTTCTGGACGTCCTAAGCCAACCATTACCTGGACTAAAGATGGTCTCCCACTGAAGCAGACCACAAGAATCAATGTTACCGATTCACTGGATCTCACCACACTCAGTATTAAAGAAACTCATAAGGATGATGGTGGACAATATGGAATCACAGTTGCCAATGTTGTTGGTCAGAAGACAGCATCCATCGAAATTGTAACTCTAGATAAACCTGATCCTCCAAAAGGACCTGTTAAATTTGATGACGTCAGTGCTGAAAGTATTACATTATCTTGGAACCCTCCATTATATACAGGGGGCTGCCAAATCACCAACTACATTGTTCAGAAAAGAGATACAACCACCACAGTATGGGATGTTGTTTCTGCTACTGTTGCTAGAACTACACTCAAAGTGACCAAACTGAAAACTGGTACAGAATACCAATTTAGAATATTTGCCGAAAACAGATATGGACAAAGCTTTGCCTTAGAGTCTGATCCAATTGTAGCTCAATATCCCTACAAAGAACCAGGCCCTCCAGGTACACCATTTGCCACAGCCATTTCCAAAGACTCCATGGTCATACAGTGGCATGAACCAGTCAACAATGGTGGAAGCCCCGTCATAGGTTACCACCTGGAGAGAAAAGAAAGAAACAGTATTTTGTGGACAAAGGTCAACAAAACTATTATTCATGACACCCAATTCAAAGCACAGAATCTTGAAGAAGGCATTGAATATGAATTCAGAGTGTATGCTGAAAATATTGTTGGTGTAGGCAAAGCAAGCAAGAATTCTGAATGCTATGTAGCCAGAGATCCCTGTGACCCACCAGGAACCCCAGAACCAATAATGGTTAAAAGAAATGAAATCACTTTACAGTGGACCAAACCTGTGTATGATGGTGGAAGTATGATTACAGGCTACATTGTAGAGAAACGTGATTTGCCTGATGGTCGTTGGATGAAAGCTAGCTTTACAAATGTCATTGAAACTCAATTTACTGTGTCAGGTCTTACTGAAGATCAAAGATATGAATTCAGAGTCATTGCAAAGAATGCAGCTGGTGCAATAAGTAAACCCTCTGACAGTACTGGACCAATAACTGCCAAGGATGAGGTTGAACTCCCAAGAATTTCAATGGATCCAAAATTCAGAGACACAATTGTGGTAAATGCTGGAGAAACATTCAGACTTGAGGCTGATGTCCATGGAAAGCCCCTACCTACCATTGAGTGGTTAAGAGGAGATAAGGAAATTGAAGAATCTGCTAGATGTGAAATAAAGAACACAGATTTCAAGGCTTTACTTATTGTAAAAGATGCAATTAGAATTGATGGTGGGCAGTATATTTTAAGAGCTTCCAATGTTGCAGGTTCTAAGTCATTCCCAGTAAATGTAAAAGTATTAGATAGACCAGGACCTCCAGAAGGGCCAGTCCAGGTTACTGGAGTCACTTCTGAAAAATGCTCTTTAACATGGTCTCCACCACTTCAAGATGGTGGCAGTGACATTTCTCACTATGTTGTTGAAAAGCGAGAAACCAGTCGACTTGCCTGGACTGTTGTTGCTTCAGAAGTTGTGACCAATTCTCTGAAAGTTACCAAACTCTTAGAAGGTAATGAATATGTTTTCCGTATAATGGCTGTCAACAAATATGGTGTTGGAGAGCCTTTGGAATCTGCACCAGTACTAATGAAAAATCCATTTGTGCTTCCTGGACCACCAAAAAGCTTGGAAGTCACAAATATTGCCAAAGACTCCATGACCGTCTGTTGGAACCGTCCAGATAGTGATGGTGGAAGTGAGATTATTGGTTACATTGTAGAGAAAAGAGACAGAAGTGGCATTCGATGGATAAAATGTAATAAACGCCGCATTACAGATTTGCGTCTAAGAGTGACAGGATTAACAGAAGATCATGAGTATGAATTCAGGGTCTCTGCAGAAAATGCTGCTGGAGTTGGGGAACCAAGTCCAGCTACAGTTTATTATAAAGCCTGTGATCCTGTGTTCAAACCTGGCCCACCTACCAATGCACACATTGTAGACACCACTAAAAATTCAATCACACTTGCCTGGGGTAAACCCATCTATGATGGCGGCAGTGAGATCTTGGGATATGTAGTAGAAATCTGTAAAGCAGATGAAGAAGAATGGCAAATAGTTACTCCACAGACTGGCCTGAGAGTCACTCGATTTGAAATTTCAAAACTCACTGAACACCAAGAGTATAAAATACGAGTCTGTGCCCTCAACAAAGTTGGTTTAGGTGAGGCTACATCAGTTCCTGGTACTGTGAAACCAGAAGATAAACTTGAAGCACCTGAACTTGACCTTGACTCCGAATTAAGAAAAGGAATTGTTGTAAGAGCTGGTGGATCTGCCAGAATTCACATTCCATTCAAAGGTCGTCCAACGCCTGAGATCACTTGGTCTCGAGAGGAAGGTGAATTCACAGATAAGGTCCAAATTGAAAAGGGAGTAAACTATACCCAACTATCAATAGATAACTGTGATAGAAATGATGCTGGAAAATACATTCTTAAGTTGGAAAACAGCAGTGGATCAAAGTCTGCTTTTGTAACTGTGAAAGTTCTTGACACTCCAGGACCACCACAGAATTTGGCAGTCAAAGAAGTGAGAAAAGATTCTGCCTTCCTGGTATGGGAGCCACCCATCATTGATGGAGGGGCAAAGGTCAAGAACTATGTGATTGACAAACGTGAGTCAACCAGAAAAGCGTATGCTAATGTGAGTAGTAAATGCAGCAAAACAAGTTTTAAAGTGGAAAACCTTACAGAAGGAGCCATTTATTACTTCAGAGTCATGGCTGAAAATGAATTTGGAGTTGGTGTTCCAGTGGAAACTGTTGATGCCGTGAAAGCTGCTGAACCTCCTTCCCCACCAGGAAAGGTTACACTCACTGATGTGTCCCAGACCAGTGCATCACTTATGTGGGAGAAACCTGAACATGATGGCGGTAGCAGAGTCCTGGGGTACGTTGTTGAAATGCAGCCCAAAGGAACTGAAAAATGGAGCATTGTGGCTGAATCCAAAGTCTGTAATGCAGTTGTTACTGGTTTGAGTTCTGGACAAGAATATCAGTTCCGTGTCAAGGCTTATAATGAGAAAGGAAAAAGCGATCCAAGAGTGTTGGGTGTTCCTGTCATAGCCAAGGACTTGACTATACAGCCTAGTTTAAAGTTACCATTTAACACATATAGTATCCAAGCTGGAGAAGATCTTAAAATAGAAATTCCAGTTATAGGCCGACCAAGACCTAACATTTCTTGGGTCAAAGATGGTGAGCCTCTTAAACAGACAACAAGAGTAAACGTTGAAGAAACAGCTACCTCAACTGTTTTGCACATTAAAGAAGGTAACAAAGATGACTTTGGAAAATACACCGTAACGGCAACAAATAGTGCAGGCACAGCAACAGAAAATCTCAGTGTTATCGTTTTAGAAAAGCCTGGACCTCCAGTTGGCCCAGTTCGGTTTGATGAAGTTAGTGCAGACTTTGTAGTCATATCTTGGGAACCTCCAGCCTATACTGGTGGCTGCCAAATAAGCAACTACATTGTAGAGAAGCGAGATACAACCACCACCACTTGGCACATGGTATCAGCAACAGTTGCAAGAACAACAATTAAAATAACCAAACTGAAAACAGGCACGGAGTACCAGTTTAGAATTTTTGCTGAAAACAGGTATGGAAAAAGTGCCCCACTGGATTCTAAGGCAGTTATTGTACAATATCCATTTAAAGAACCTGGACCACCTGGAACTCCTTTTGTGACATCAATCTCAAAAGATCAGATGCTTGTGCAATGGCATGAGCCAGTGAATGATGGAGGCACCAAAATTATTGGCTACCATCTTGAACAGAAAGAAAAGAACAGTATTTTATGGGTCAAGTTAAATAAGACCCCCATTCAGGACACCAAATTCAAAACAACTGGGCTTGATGAGGGCCTTGAGTATGAGTTCAAAGTTTCTGCTGAAAATATTGTTGGCATTGGCAAGCCTAGCAAAGTGTCAGAATGCTTTGTTGCTCGTGATCCATGTGACCCACCTGGTCGCCCTGAAGCCATTGTTATTACAAGAAACAATGTCACACTGAAATGGAAGAAACCTGCCTATGATGGTGGTAGCAAAATAACAGGTTATATTGTAGAAAAGAAAGATCTACCTGATGGCCGCTGGATGAAAGCCAGCTTTACCAACGTATTAGAAACTGAATTTACAGTGAGTGGACTTGTAGAAGACCAAAGATATGAATTTAGAGTAATTGCAAGAAATGCAGCTGGAAACTTTAGTGAACCATCTGATAGTAGTGGTGCCATTACTGCAAGAGATGAAATTGATGCACCAAATGCCTCTCTGGATCCAAAATATAAAGATGTCATCGTTGTTCATGCAGGAGAGACTTTTGTTCTTGAAGCCGACATCCGTGGCAAACCTATACCTGATGTTGTTTGGTCAAAAGATGGAAAAGAACTTGAAGAAACAGCTGCTAGAATGGAAATTAAATCTACTATTCAGAAAACAACTCTTGTTGTCAAAGACTGTATACGGACTGATGGAGGACAATATATTCTGAAACTCAGCAATGTTGGTGGTACAAAGTCTATACCCATCACTGTAAAGGTACTTGACAGGCCAGGGCCTCCTGAAGGGCCTCTGAAAGTTACTGGAGTTACTGCGGAAAAATGTTACCTGGCATGGAACCCACCTTTGCAAGATGGTGGTGCTAATATTTCACATTACATCATTGAAAAGAGGGAGACAAGCCGACTCTCTTGGACCCAGGTTTCAACTGAGGTACAGGCCCTTAACTACAAAGTTACTAAACTTCTTCCTGGTAATGAGTACATTTTCCGTGTCATGGCTGTGAATAAATATGGAATTGGAGAGCCCTTGGAATCTGGGCCTGTTACGGCCTGTAATCCTTATAAGCCACCAGGTCCTCCCTCAACACCTGAAGTCTCAGCAATCACCAAAGATTCTATGGTAGTAACATGGGCACGCCCAGTAGACGACGGAGGTACCGAAATTGAGGGCTACATTCTTGAAAAACGAGATAAGGAAGGCGTTAGATGGACCAAGTGCAACAAGAAAACATTAACGGATCTGCGGCTCAGGGTAACTGGTCTTACCGAAGGCCATTCCTATGAATTCAGAGTTGCTGCTGAAAATGCAGCTGGTGTGGGAGAACCTAGTGAGCCATCTGTTTTCTACCGTGCGTGTGATGCCTTGTATCCACCAGGTCCCCCAAGCAATCCAAAAGTGACGGACACTTCCAGATCTTCTGTCTCCCTGGCATGGAGTAAGCCAATTTATGATGGTGGCGCACCTGTTAAAGGCTATGTTGTAGAGGTCAAAGAAGCTGCTGCGGATGAATGGACAACCTGCACTCCACCAACAGGATTACAAGGAAAGCAGTTCACAGTGACCAAGCTTAAAGAAAACACTGAATATAACTTCCGTATTTGTGCCATCAATTCTGAAGGTGTAGGTGAACCTGCAACTCTACCTGGCTCAGTGGTTGCTCAGGAGAGGATAGAGCCACCAGAAATAGAACTCGATGCTGATCTCAGAAAGGTGGTCGTTCTGCGTGCAAGTGCTACTTTACGCTTATTTGTCACTATCAAAGGTCGACCAGAACCCGAAGTTAAATGGGAAAAGGCAGAAGGCATTCTCACTGACAGGGCTCAGATAGAGGTGACCAGCTCATTTACAATGTTGGTGATTGATAATGTTACCAGATTTGACAGTGGTCGGTATAATCTGACATTAGAAAATAATAGTGGCTCCAAAACAGCTTTTGTTAACGTCAGAGTTCTTGACTCACCAAGTGCCCCTGTGAATTTGACCATAAGAGAAGTGAAGAAAGACTCAGTGACGTTGTCCTGGGAACCACCACTTATTGATGGTGGAGCTAAGATTACAAACTACATTGTCGAAAAACGAGAAACTACAAGAAAAGCCTATGCTACCATTACAAATAATTGCACTAAAACTACTTTCAGAATTGAAAATCTACAAGAAGGATGTTCTTACTACTTCCGAGTCTTGGCTTCCAATGAATATGGGATTGGTTTGCCAGCTGAAACAACAGAACCCGTTAAAGTGTCTGAACCACCCCTCCCACCTGGAAGAGTAACTCTTGTTGATGTGACCCGTAATACAGCTACAATTAAGTGGGAGAAACCAGAAAGTGATGGTGGCAGCAAAATTACTGGTTATGTGGTTGAAATGCAGACTAAAGGGAGTGAAAAGTGGAGCACCTGCACACAAGTTAAGACTCTAGAAGCAACTATATCTGGCTTAACTGCAGGAGAAGAGTATGTCTTCAGGGTAGCTGCAGTTAACGAAAAGGGAAGAAGTGATCCAAGACAACTTGGAGTGCCAGTAATTGCAAGGGATATTGAAATAAAGCCTTCAGTTGAGCTTCCTTTCCATACTTTCAATGTAAAGGCTAGAGAACAACTTAAGATTGATGTGCCATTCAAAGGAAGACCTCAAGCTACTGTGAACTGGAGAAAAGATGGTCAGACTCTTAAAGAGACAACTAGAGTCAATGTTTCTTCTTCAAAGACTGTAACATCACTATCTATTAAGGAAGCTTCAAAGGAAGATGTTGGAACTTATGAATTATGTGTTTCAAACAGTGCTGGATCCATAACAGTTCCTATTACTATAATTGTCCTTGACAGACCAGGACCTCCAGGTCCTATACGTATTGATGAGGTTAGTTGTGACAGCATAACCATTTCTTGGAATCCTCCAGAATATGATGGTGGCTGCCAAATTAGCAATTACATTGTTGAAAAGAAAGAAACCACCTCTACAACATGGCACATAGTTTCACAAGCAGTTGCAAGAACATCCATTAAAATAGTTCGCCTGACAACAGGAAGTGAGTATCAGTTCCGTGTTTGTGCAGAAAACCGCTATGGAAAGAGCTCCTACAGTGAATCTTCAGCTGTTGTTGCAGAGTATCCATTCAGTCCCCCAGGTCCTCCTGGTACTCCTAAAGTTGTGCATGCCACAAAATCTACCATGCTTGTAACCTGGCAAGTGCCAGTTAATGATGGAGGAAGTCGAGTAATTGGCTATCATCTTGAGTATAAAGAAAGAAGCAGCATTCTTTGGTCAAAAGCAAATAAAATCCTCATTGCTGATACTCAAATGAAAGTCTCCGGCCTTGATGAAGGACTGATGTATGAGTATCGTGTATATGCTGAAAATATTGCTGGAATTGGTAAATGCAGTAAATCTTGTGAACCAGTCCCTGCAAGAGATCCTTGTGACCCTCCTGGACAACCTGAAGTCACAAATATCACAAGAAAATCAGTGTCACTTAAATGGTCTAAACCACATTATGATGGTGGAGCTAAGATCACAGGATACATTGTTGAACGCAGAGAACTACCAGATGGCCGGTGGCTGAAGTGCAATTATACTAATATACAAGAAACATACTTTGAAGTAACTGAACTTACTGAAGATCAGCGTTATGAATTCCGGGTTTTTGCAAGGAATGCTGCTGACTCAGTTAGTGAGCCATCTGAATCCACTGGGCCTATTATAGTTAAAGATGATGTTGAGCCTCCAAGAGTTATGATGGATGTCAAGTTCCGAGACGTTATTGTTGTCAAAGCTGGAGAGGTCCTTAAGATAAATGCAGACATTGCAGGGCGACCTCTGCCAGTAATTTCCTGGGCCAAGGATGGTATAGAAATTGAAGAAAGAGCAAGAACAGAAATCATCTCAACAGACAATCATACTTTGTTAACAGTTAAAGACTGTATAAGACGAGACACTGGGCAATATGTACTAACACTGAAGAATGTTGCCGGCACTCGGTCTGTGGCCGTTAATTGCAAAGTACTTGATAAGCCTGGTCCACCAGCAGGACCACTTGAAATAAATGGCCTCACTGCTGAGAAATGCTCTCTTTCCTGGGGACGTCCCCAAGAAGATGGTGGTGCAGATATCGACTATTACATCGTAGAAAAACGTGAAACAAGCCACCTTGCATGGACAATATGTGAAGGAGAGTTACAGATGACATCCTGTAAAGTAACCAAGTTACTCAAAGGCAATGAATATATATTTAGAGTAACTGGTGTTAATAAATATGGTGTTGGTGAGCCCCTAGAGAGTGTAGCTATAAAGGCACTAGATCCATTTACAGTTCCAAGTCCACCCACGTCTTTGGAAATTACTTCTGTGACCAAAGAATCTATGACACTTTGCTGGTCAAGACCCGAGAGTGATGGAGGTAGTGAAATATCTGGATATATAATTGAAAGGCGAGAGAAAAATAGCCTAAGATGGGTGCGTGTAAACAAAAAACCAGTTTATGATCTAAGAGTGAAATCAACAGGACTTCGGGAAGGATGTGAATATGAATATCGTGTTTATGCAGAAAATGCTGCTGGCCTAAGTCTTCCAAGTGAAACCTCTCCCTTAATTAGGGCAGAAGATCCAGTGTTCCTACCATCTCCTCCATCCAAACCCAAAATTGTGGACTCAGGCAAGACAACTATAACTATTGCCTGGGTTAAGCCGCTGTTTGATGGTGGGGCCCCGATAACTGGATATACTGTAGAATACAAAAAATCTGATGACACTGACTGGAAAACTTCCATTCAGAGCTTACGAGGGACAGAATATACAATAAGCGGACTAACAACAGGAGCTGAATATGTTTTCAGAGTAAAATCTGTCAATAAGGTTGGTGCTAGTGACCCCAGTGATAGCTCTGACCCTCAGATAGCAAAGGAAAGAGAAGAAGAACCTTTATTTGATATTGACAGTGAAATGAGGAAGACCTTGATTGTCAAGGCTGGTGCCTCATTTACCATGACTGTGCCTTTCCGAGGAAGACCAGTACCCAATGTCTTGTGGAGTAAGCCAGACACTGACCTCCGTACTAGAGCTTATGTTGATACCACAGACTCTCGTACATCACTGACCATTGAAAATGCCAACAGAAATGACTCTGGAAAGTACACATTAACAATTCAGAATGTTTTGAGTGCTGCTTCACTGACCTTAGTTGTCAAAGTTTTAGATACCCCAGGTCCTCCAACCAACATTACTGTGCAAGATGTAACCAAAGAGTCTGCAGTGTTATCCTGGGATGTTCCTGAAAACGATGGTGGAGCACCAGTGAAGAATTACCACATAGAAAAACGTGAGGCCAGCAAGAAAGCATGGGTCTCTGTGACCAACAACTGTAACCGCCTCTCCTACAAAGTTACCAATTTACAAGAAGGAGCTATCTATTACTTCAGAGTCTCTGGAGAAAATGAGTTTGGTGTTGGTATACCAGCTGAAACAAAGGAAGGAGTAAAAATAACAG
>TTN-201,ENSE00003802597,1,297,60202,60498,AAAAACCAAGCCCACCTGAAAAACTTGGAGTAACAAGTATATCCAAAGACAGTGTTTCCCTGACCTGGCTGAAGCCTGAACATGATGGCGGAAGCAGAATTGTACACTATGTCGTTGAAGCACTAGAAAAAGGACAGAAAAACTGGGTTAAATGTGCAGTGGCAAAGTCAACCCATCACGTTGTTTCCGGTCTGAGAGAGAATTCTGAATACTTTTTCCGAGTGTTTGCTGAAAATCAAGCTGGCCTGAGTGACCCGAGAGAGCTTCTGCTTCCTGTTCTTATTAAGGAGCAACTAG
>TTN-201,ENSE00003802941,1,588,60499,61086,AACCACCTGAAATTGATATGAAGAATTTCCCAAGTCACACTGTATATGTTAGAGCTGGTTCAAACCTTAAAGTTGACATTCCAATCTCTGGAAAACCACTTCCCAAAGTGACCTTATCAAGAGATGGTGTCCCCCTTAAGGCAACCATGAGATTTAATACCGAAATTACTGCTGAGAACCTGACCATCAATCTCAAAGAAAGTGTTACAGCTGACGCTGGGAGATATGAAATCACTGCTGCCAACTCCAGTGGTACAACCAAAGCTTTCATTAACATTGTTGTGCTAGACAGGCCTGGTCCTCCAACTGGCCCTGTTGTTATTAGTGATATAACTGAAGAAAGTGTGACTCTCAAATGGGAGCCACCTAAGTATGACGGTGGAAGTCAAGTTACCAACTACATTCTACTCAAAAGAGAAACAAGTACTGCAGTGTGGACTGAAGTGTCTGCAACAGTTGCAAGAACCATGATGAAAGTCATGAAACTGACCACAGGAGAAGAATACCAATTCCGCATCAAGGCAGAAAACCGCTTTGGCATCAGTGATCATATAGATTCAGCTTGTGTGACTGTCAAACTACCATACA
>TTN-201,ENSE00003808789,1,303,61087,61389,CAACACCTGGACCACCATCTACACCATGGGTCACTAATGTTACTCGAGAAAGCATCACTGTGGGCTGGCATGAACCAGTGTCAAATGGAGGCAGTGCAGTCGTAGGCTATCACCTGGAAATGAAAGACAGAAACAGTATTTTATGGCAAAAAGCCAACAAACTGGTCATCCGCACAACTCACTTCAAAGTCACAACAATCAGTGCTGGACTTATTTATGAATTCAGGGTGTATGCAGAAAATGCTGCTGGAGTTGGAAAACCTAGCCATCCTTCTGAACCAGTCTTGGCAATTGATGCTTGTG
>TTN-201,ENSE00003806587,1,297,61390,61686,AACCCCCAAGAAATGTTCGTATCACTGATATTTCAAAGAACTCTGTCAGCCTTTCATGGCAACAACCAGCTTTCGATGGAGGTAGCAAGATTACAGGCTACATTGTTGAGAGACGTGACCTTCCAGATGGCAGATGGACCAAGGCCAGCTTCACCAATGTTACTGAAACTCAATTCATCATCTCTGGCTTGACTCAGAATTCCCAGTATGAATTCCGTGTCTTTGCTAGGAATGCTGTTGGTTCCATTAGCAATCCATCTGAGGTTGTAGGGCCCATTACTTGCATCGATTCTTATG
>TTN-201,ENSE00003807681,1,288,61687,61974,GTGGTCCTGTAATTGATTTGCCTCTAGAATATACAGAAGTTGTCAAATACAGAGCAGGTACATCTGTGAAGCTCAGAGCTGGCATTTCTGGCAAACCTGCGCCTACTATTGAGTGGTATAAAGATGATAAAGAATTACAAACCAATGCACTGGTGTGTGTTGAAAATACCACGGACCTCGCATCTATACTCATCAAAGATGCCGATCGCCTTAATAGTGGATGCTATGAATTAAAACTAAGGAATGCCATGGGCTCAGCCTCAGCCACCATCAGAGTACAGATCCTTG
>TTN-201,ENSE00003811102,1,300,61975,62274,ACAAACCAGGCCCACCTGGTGGACCAATTGAATTTAAGACTGTAACTGCTGAGAAGATCACCCTTCTCTGGCGGCCTCCAGCTGATGATGGTGGTGCAAAAATCACTCACTACATTGTGGAAAAGCGTGAGACAAGCCGCGTTGTGTGGTCTATGGTGTCTGAACATTTGGAAGAGTGCATCATTACAACCACCAAAATTATCAAAGGAAATGAATACATCTTCCGGGTCCGAGCCGTGAACAAATATGGAATTGGCGAGCCACTGGAATCTGATTCCGTTGTAGCCAAGAACGCATTTG
>TTN-201,ENSE00003802386,1,303,62275,62577,TTACACCTGGGCCACCAGGCATACCAGAAGTGACAAAGATTACCAAGAATTCGATGACTGTTGTATGGAGCAGGCCAATTGCAGATGGCGGTAGTGATATAAGTGGCTATTTCCTTGAAAAACGAGACAAGAAGAGCCTAGGATGGTTTAAAGTACTAAAAGAGACTATCCGTGACACCAGACAAAAAGTAACAGGACTCACAGAAAACAGTGACTATCAATACAGAGTTTGTGCTGTAAACGCTGCTGGACAGGGTCCATTTTCTGAACCATCTGAATTCTACAAAGCTGCTGATCCTATTG
>TTN-201,ENSE00003809908,1,306,62578,62883,ATCCTCCAGGTCCACCTGCTAAGATAAGAATCGCAGATTCAACCAAGTCATCCATCACCCTTGGCTGGAGTAAGCCTGTCTATGATGGGGGCAGTGCTGTTACTGGGTATGTTGTCGAGATAAGACAAGGAGAGGAAGAGGAATGGACTACTGTCTCTACCAAAGGAGAGGTCAGAACTACAGAATATGTGGTATCCAACCTGAAACCTGGAGTCAATTACTACTTCCGGGTATCTGCTGTAAACTGTGCTGGACAAGGAGAACCTATAGAAATGAATGAACCTGTACAAGCTAAAGATATACTTG
>TTN-201,ENSE00003808993,1,1767,62884,64650,AGGCACCAGAGATTGACCTGGATGTGGCTCTCAGAACTTCTGTTATTGCCAAAGCTGGTGAAGATGTACAAGTGTTGATTCCCTTTAAAGGCAGACCTCCACCTACTGTCACATGGAGAAAAGATGAGAAGAATCTTGGCAGTGATGCCAGATACAGCATTGAAAACACTGATTCATCCTCATTACTCACCATTCCTCAAGTTACTCGCAATGATACAGGAAAATATATTCTCACAATAGAAAATGGAGTTGGTGAACCTAAGTCTTCAACTGTGAGTGTTAAAGTGCTTGACACACCAGCTGCCTGCCAGAAACTACAGGTTAAACATGTTTCTCGAGGCACAGTCACTTTGCTCTGGGATCCTCCTCTCATTGATGGAGGATCTCCAATAATTAATTATGTCATTGAAAAGAGAGATGCCACCAAGAGAACATGGTCTGTCGTGTCACACAAATGTTCTAGCACATCCTTCAAGCTAATAGATTTGTCGGAGAAGACTCCATTCTTCTTCAGAGTTCTTGCAGAAAATGAAATTGGAATTGGGGAACCCTGTGAAACTACAGAGCCAGTGAAGGCTGCTGAAGTACCAGCTCCTATACGTGATCTCTCAATGAAAGACTCAACAAAGACATCTGTCATCCTCAGCTGGACCAAACCTGACTTTGATGGTGGTAGCGTCATCACAGAATATGTTGTAGAAAGGAAAGGTAAAGGTGAACAGACGTGGTCCCACGCTGGCATAAGTAAGACATGTGAAATTGAGGTTAGCCAACTTAAGGAGCAGTCAGTCCTGGAGTTCAGAGTGTTTGCCAAAAATGAGAAAGGACTGAGTGATCCTGTCACTATTGGGCCAATTACAGTGAAAGAACTTATTATTACACCTGAAGTTGACCTGTCAGATATCCCTGGGGCACAAGTCACTGTGAGAATTGGGCACAATGTGCACCTTGAATTACCTTATAAGGGAAAACCCAAACCATCCATCAGTTGGCTGAAAGATGGCTTGCCACTGAAAGAAAGTGAATTTGTTCGCTTCAGTAAAACTGAAAACAAAATTACTTTGAGTATTAAGAATGCCAAGAAGGAGCATGGAGGAAAATACACTGTTATTCTTGATAATGCAGTGTGTAGAATTGCAGTCCCCATTACAGTCATCACCCTTGGCCCACCATCAAAGCCCAAAGGACCCATTCGATTTGATGAAATCAAGGCTGATAGTGTCATCCTGTCATGGGATGTACCTGAAGATAATGGAGGAGGAGAAATTACTTGTTACAGCATCGAGAAGCGGGAAACTTCACAAACTAACTGGAAGATGGTGTGTTCAAGTGTTGCCAGAACGACTTTCAAAGTTCCTAATCTAGTCAAAGATGCTGAGTACCAGTTTAGAGTGAGAGCAGAAAACAGATACGGAGTCAGCCAACCACTTGTCTCAAGCATTATTGTGGCAAAACACCAGTTCAGGATTCCTGGTCCCCCAGGAAAGCCAGTTATATACAATGTGACTTCTGATGGCATGTCACTAACTTGGGATGCTCCAGTTTATGATGGTGGTTCAGAAGTTACTGGATTCCATGTTGAAAAGAAAGAAAGAAATAGCATCCTCTGGCAAAAAGTTAATACATCACCAATCTCTGGAAGAGAATATAGAGCCACTGGACTGGTAGAAGGTCTGGATTACCAATTCCGTGTATATGCTGAAAATTCTGCTGGCCTAAGCTCACCTAGTGACCCAAGCAAATTTACCTTAGCTGTTTCTCCAGTAG
>TTN-201,ENSE00003811205,1,294,64651,64944,ACCCACCTGGCACTCCTGACTACATTGATGTCACCCGGGAAACCATCACACTTAAATGGAACCCACCATTGCGTGATGGAGGCAGTAAGATTGTGGGCTATAGCATTGAGAAACGGCAAGGAAATGAACGCTGGGTGAGATGCAACTTTACTGACGTCAGTGAATGTCAGTACACAGTTACAGGACTCAGTCCTGGGGATCGCTATGAGTTCAGAATAATTGCAAGAAATGCTGTTGGAACTATAAGCCCGCCCTCACAGTCTTCTGGCATTATTATGACAAGAGATGAAAATG
>TTN-201,ENSE00003808021,1,288,64945,65232,TTCCACCAATAGTAGAGTTTGGCCCTGAATACTTTGATGGTCTCATTATTAAGTCCGGAGAGAGCCTTAGAATTAAAGCTTTGGTACAAGGAAGACCAGTGCCTCGAGTAACTTGGTTCAAAGATGGAGTGGAAATCGAAAAGAGGATGAATATGGAAATAACCGACGTACTTGGATCCACCAGCCTATTTGTTAGAGATGCTACTCGGGACCATCGTGGTGTATACACAGTGGAAGCCAAAAATGCATCTGGTTCTGCAAAAGCAGAAATTAAAGTGAAAGTACAAG
>TTN-201,ENSE00003804355,1,300,65233,65532,ATACACCAGGAAAAGTAGTTGGGCCAATAAGATTCACCAATATTACTGGGGAGAAGATGACTCTGTGGTGGGATGCCCCACTCAATGACGGTTGTGCTCCCATAACCCACTACATCATTGAAAAACGGGAAACCAGCAGACTTGCCTGGGCACTAATTGAGGATAAATGTGAAGCCCAAAGTTACACTGCCATTAAACTAATAAACGGCAATGAATACCAATTCCGTGTTTCTGCAGTTAACAAGTTTGGTGTTGGCAGGCCACTTGATTCTGATCCAGTGGTTGCTCAAATACAATATA
>TTN-201,ENSE00003807046,1,2067,65533,67599,CTGTTCCTGATGCCCCTGGCATTCCAGAACCTAGCAACATAACAGGCAACAGCATTACCCTGACATGGGCAAGGCCAGAATCAGATGGTGGCAGTGAAATTCAACAGTATATCCTTGAAAGAAGAGAAAAGAAAAGCACAAGATGGGTAAAAGTGATCAGCAAACGACCAATCTCTGAAACAAGATTCAAAGTCACTGGTCTGACAGAAGGCAATGAGTATGAATTCCATGTCATGGCTGAAAATGCTGCAGGAGTTGGACCTGCAAGTGGCATCTCAAGACTCATTAAATGTAGAGAGCCCGTCAACCCACCAGGTCCTCCCACAGTGGTCAAAGTAACAGACACATCAAAGACAACTGTGAGCTTAGAATGGTCCAAACCAGTGTTTGATGGTGGCATGGAAATAATTGGGTATATTATTGAAATGTGTAAGGCCGACTTAGGAGACTGGCACAAGGTGAATGCAGAGGCATGTGTGAAAACAAGATATACAGTCACTGATCTACAAGCAGGTGAAGAATACAAATTCCGAGTTAGTGCTATCAATGGTGCTGGAAAAGGCGACAGCTGTGAAGTGACTGGCACAATTAAAGCAGTTGACCGGTTAACAGCTCCTGAGTTAGACATAGATGCAAACTTCAAACAGACTCATGTTGTTAGAGCTGGGGCCAGTATTCGCCTCTTCATTGCCTACCAAGGTAGACCTACTCCTACAGCTGTGTGGAGCAAACCAGACTCTAACCTTAGCCTTCGGGCTGATATCCATACAACAGATTCCTTCAGCACCCTCACTGTGGAAAACTGCAACAGAAATGATGCAGGGAAATATACCCTTACTGTGGAAAACAACAGTGGTAGTAAGTCAATCACATTCACCGTGAAAGTGCTAGACACTCCAGGCCCACCTGGCCCAATTACCTTCAAAGATGTGACCCGGGGATCTGCTACATTGATGTGGGATGCCCCTCTTCTTGACGGTGGTGCCCGAATCCATCATTATGTGGTAGAGAAACGAGAGGCAAGTCGCCGTAGTTGGCAGGTTATCAGTGAAAAATGCACTCGTCAGATCTTCAAGGTCAATGACCTGGCCGAAGGTGTTCCGTACTATTTCCGTGTTTCTGCAGTAAATGAGTATGGTGTTGGTGAGCCCTATGAAATGCCAGAACCAATTGTAGCCACAGAACAGCCTGCTCCACCTAGGAGACTTGATGTTGTTGATACTAGCAAATCCTCCGCAGTCTTAGCTTGGCTTAAACCTGACCACGATGGAGGCAGCCGGATCACTGGCTACCTGCTTGAAATGAGACAAAAGGGATCTGACTTCTGGGTTGAAGCTGGTCACACCAAACAGCTAACTTTCACAGTAGAGCGTCTTGTTGAGAAAACTGAATATGAATTCCGTGTGAAGGCCAAGAATGATGCTGGCTATAGTGAACCCAGAGAAGCCTTCTCTTCTGTCATCATTAAGGAGCCTCAAATCGAGCCCACTGCTGACCTCACTGGAATTACCAATCAGCTTATAACTTGCAAAGCAGGAAGCCCATTTACCATTGACGTACCAATCAGTGGTCGTCCTGCCCCCAAAGTAACATGGAAACTGGAAGAAATGAGACTTAAAGAGACAGATCGAGTGAGCATTACAACAACAAAAGACAGAACCACACTGACTGTAAAGGACAGCATGAGAGGTGACTCTGGAAGATACTTCTTGACCCTGGAAAATACAGCTGGTGTTAAAACATTTAGCGTCACAGTTGTGGTCATTGGAAGGCCAGGTCCAGTAACCGGCCCCATTGAGGTCTCATCTGTCTCAGCTGAATCGTGTGTCCTGTCATGGGGAGAACCTAAAGATGGAGGAGGCACTGAAATTACTAATTACATAGTTGAAAAGCGTGAATCGGGTACAACAGCTTGGCAGCTTGTCAATTCCAGTGTCAAGCGCACTCAAATTAAAGTCACTCATCTCACAAAATACATGGAATATTCTTTCCGTGTCAGTTCAGAGAACAGATTTGGTGTCAGCAAACCTCTAGAATCAGCACCAATAATTGCTGAACATCCATTTG
>TTN-201,ENSE00003810611,1,303,67600,67902,TCCCACCAAGCGCTCCTACCAGACCTGAGGTCTACCATGTGTCTGCCAATGCCATGTCTATTCGTTGGGAAGAACCCTACCACGATGGTGGCAGTAAAATCATTGGCTACTGGGTTGAGAAGAAAGAACGTAATACAATTCTTTGGGTGAAAGAAAACAAAGTGCCATGCTTAGAGTGCAACTACAAAGTAACTGGTTTAGTAGAAGGACTGGAATATCAGTTCAGAACTTATGCACTCAATGCTGCAGGTGTTAGCAAGGCCAGCGAAGCTTCAAGACCTATAATGGCTCAAAATCCAGTTG
>TTN-201,ENSE00003803222,1,306,67903,68208,ATGCACCAGGCAGACCAGAGGTGACAGATGTCACAAGATCAACAGTATCACTGATTTGGTCTGCCCCAGCGTATGATGGAGGCAGCAAGGTTGTGGGCTACATCATAGAGCGTAAGCCAGTCAGTGAGGTAGGAGATGGTCGCTGGCTGAAGTGCAACTACACCATTGTATCTGACAATTTCTTCACCGTGACTGCTCTCAGTGAAGGAGACACTTATGAGTTCCGTGTGTTAGCCAAGAATGCAGCAGGCGTAATTAGCAAAGGGTCTGAATCTACAGGCCCTGTCACTTGCCGAGATGAATACG
>TTN-201,ENSE00003801213,1,291,68209,68499,CTCCACCCAAAGCCGAACTGGATGCCCGATTACACGGTGATCTGGTTACCATCAGAGCAGGTTCTGATCTTGTTCTGGATGCTGCAGTTGGTGGCAAACCTGAACCCAAAATTATCTGGACCAAAGGAGACAAGGAGCTAGATCTCTGTGAAAAAGTCTCTTTGCAGTATACTGGCAAACGAGCAACTGCTGTGATCAAGTTCTGTGACAGAAGTGACAGTGGAAAATACACTTTAACAGTGAAAAATGCCAGCGGGACCAAGGCCGTGTCTGTCATGGTCAAAGTGCTTG
>TTN-201,ENSE00003809128,1,297,68500,68796,ATTCCCCTGGCCCATGTGGAAAGCTCACCGTCAGCAGAGTAACACAGGAGAAGTGCACTTTAGCCTGGAGCCTTCCGCAGGAAGACGGAGGAGCAGAAATCACTCACTACATCGTGGAAAGACGCGAGACTAGCAGGCTCAACTGGGTGATTGTTGAAGGCGAATGCCCAACCCTATCCTATGTCGTTACCAGGCTCATCAAGAACAATGAGTACATATTCCGAGTGAGGGCAGTAAACAAATATGGCCCTGGTGTGCCTGTTGAATCAGAGCCAATTGTAGCCAGAAACTCATTCA
>TTN-201,ENSE00003803385,1,306,68797,69102,CTATTCCATCACCACCCGGCATACCTGAAGAAGTTGGGACTGGCAAAGAGCATATCATCATTCAGTGGACAAAACCTGAATCTGATGGTGGCAATGAAATCAGCAACTACCTAGTAGACAAACGTGAGAAGAAGAGCCTGCGCTGGACACGTGTCAACAAAGACTATGTGGTGTATGATACCAGGCTGAAGGTGACCAGCCTGATGGAGGGTTGTGATTACCAGTTCCGGGTGACCGCAGTGAATGCAGCTGGTAACAGTGAGCCCAGCGAAGCTTCCAACTTCATCTCATGCAGAGAACCATCAT
>TTN-201,ENSE00003807140,1,306,69103,69408,ATACCCCTGGACCACCTTCTGCTCCAAGAGTTGTGGATACCACCAAACACAGCATTAGTTTGGCATGGACCAAACCCATGTACGATGGTGGTACTGACATTGTAGGATATGTTCTGGAAATGCAAGAGAAGGACACTGATCAGTGGTACCGAGTGCATACCAATGCCACAATAAGAAATACTGAATTCACTGTGCCAGACCTTAAAATGGGCCAGAAATATTCCTTCAGAGTTGCTGCCGTGAACGTGAAGGGTATGAGCGAATACAGCGAATCAATTGCTGAAATTGAGCCCGTGGAAAGAATAG
>TTN-201,ENSE00003809946,1,282,69409,69690,AAATACCAGATCTTGAGCTTGCAGATGATCTAAAGAAGACTGTGACCATCAGGGCTGGGGCCTCCTTGCGCTTGATGGTGTCTGTATCTGGAAGACCACCTCCTGTCATAACGTGGAGCAAGCAGGGCATTGACCTTGCAAGCCGGGCAATTATTGACACCACTGAGAGCTACTCATTGCTAATAGTGGACAAAGTTAATCGGTACGATGCTGGAAAATACACAATTGAAGCTGAAAACCAATCTGGCAAGAAATCAGCAACAGTCCTTGTTAAAGTCTATG
>TTN-201,ENSE00003810384,1,594,69691,70284,ATACTCCTGGTCCCTGTCCTTCAGTGAAAGTTAAGGAAGTATCAAGAGATTCTGTGACTATAACTTGGGAAATTCCCACGATTGATGGTGGAGCTCCAGTCAACAATTACATCGTTGAGAAGCGTGAAGCTGCTATGAGAGCATTCAAAACAGTAACTACCAAATGCAGCAAGACACTTTACAGAATTTCTGGACTTGTAGAAGGAACCATGTACTATTTCAGAGTGCTGCCAGAAAATATTTATGGCATTGGAGAACCTTGTGAAACATCTGATGCAGTACTGGTCTCAGAAGTGCCTTTGGTGCCTGCAAAGCTAGAAGTGGTCGATGTCACCAAATCCACTGTTACCCTTGCCTGGGAAAAACCACTCTACGATGGTGGTAGCCGACTCACTGGATATGTTCTCGAGGCCTGCAAAGCTGGCACAGAGAGATGGATGAAGGTTGTCACCTTAAAACCCACAGTCCTAGAGCACACTGTTACTTCCTTAAATGAAGGTGAACAATACTTATTTAGAATAAGGGCACAAAATGAGAAAGGTGTGTCAGAACCAAGAGAGACTGTCACAGCCGTGACTGTACAAGACCTCAGAG
>TTN-201,ENSE00003802641,1,288,70285,70572,TGTTGCCAACAATCGATCTTTCTACAATGCCTCAGAAGACCATCCATGTCCCAGCTGGCAGACCAGTAGAGCTGGTGATACCTATTGCTGGCCGTCCACCTCCTGCTGCTTCCTGGTTCTTTGCTGGTTCTAAACTGAGAGAATCAGAGCGTGTCACAGTTGAAACTCACACTAAAGTAGCTAAATTAACCATCCGTGAAACCACTATCAGAGATACTGGAGAATACACACTTGAATTGAAGAATGTTACCGGAACTACTTCAGAAACCATTAAAGTTATCATTCTTG
>TTN-201,ENSE00003806194,1,300,70573,70872,ACAAGCCTGGTCCACCAACAGGACCTATTAAGATTGATGAAATTGATGCTACATCAATTACCATTTCCTGGGAACCACCTGAATTGGACGGTGGTGCTCCACTGAGTGGTTATGTGGTAGAACAACGTGACGCTCATCGTCCAGGATGGCTGCCCGTTTCTGAATCAGTGACTAGGTCCACGTTTAAGTTTACCAGACTCACCGAAGGAAATGAGTATGTGTTCCGTGTGGCTGCAACAAACCGCTTCGGGATTGGCTCTTACTTGCAGTCTGAGGTCATAGAGTGTCGCAGCAGCATCC
>TTN-201,ENSE00003805894,1,303,70873,71175,GTATTCCTGGACCCCCAGAAACATTACAGATATTTGATGTTTCCCGTGATGGCATGACACTTACTTGGTACCCACCAGAGGATGACGGTGGCTCCCAAGTGACTGGATATATTGTGGAGCGCAAAGAAGTGAGAGCAGATCGATGGGTCCGTGTAAATAAAGTACCTGTGACAATGACACGGTACCGCTCCACTGGCCTTACTGAAGGCTTAGAATATGAACACCGTGTCACAGCCATTAATGCAAGAGGGTCTGGGAAACCAAGTCGTCCTTCCAAACCCATCGTTGCCATGGATCCAATTG
>TTN-201,ENSE00003808643,1,303,71176,71478,CTCCTCCAGGAAAGCCACAAAACCCAAGAGTTACTGATACAACAAGGACATCAGTCTCCCTGGCCTGGAGTGTTCCAGAAGATGAAGGAGGATCTAAAGTCACAGGCTACTTGATTGAAATGCAAAAAGTAGATCAACATGAATGGACCAAGTGTAACACCACTCCAACCAAGATTCGAGAGTATACTCTAACACACCTACCTCAGGGTGCAGAATACAGGTTCCGCGTCCTAGCTTGTAATGCTGGTGGACCTGGTGAGCCTGCTGAGGTACCAGGAACAGTCAAAGTCACTGAAATGCTTG
>TTN-201,ENSE00003805779,1,585,71479,72063,AATATCCTGATTATGAACTTGATGAAAGATACCAAGAAGGTATCTTTGTAAGGCAAGGTGGCGTCATCAGACTTACCATACCAATCAAAGGAAAACCATTCCCAATATGTAAATGGACCAAGGAAGGCCAGGATATTAGTAAGCGTGCCATGATTGCAACATCTGAAACACACACTGAGCTTGTGATCAAAGAAGCAGACAGGGGTGATTCTGGCACTTATGACCTGGTTCTGGAAAATAAATGTGGCAAGAAGGCTGTCTACATCAAGGTCAGGGTGATAGGAAGTCCCAACAGTCCAGAAGGGCCACTGGAATATGATGACATCCAAGTCCGCTCTGTGAGGGTCAGCTGGAGACCTCCTGCTGATGATGGTGGTGCTGACATCTTAGGCTACATCCTCGAGAGACGAGAAGTGCCTAAAGCCGCCTGGTATACCATTGATTCCAGAGTCCGAGGTACATCTCTGGTGGTAAAAGGCCTCAAAGAGAATGTAGAATACCATTTCCGTGTTTCAGCAGAAAACCAGTTTGGCATAAGCAAACCCTTGAAATCTGAGGAACCAGTCACACCAAAAACACCATTGA
>TTN-201,ENSE00003806836,1,306,72064,72369,ATCCTCCAGAACCTCCAAGCAATCCTCCAGAAGTACTCGATGTAACCAAGAGTTCTGTTAGCTTGTCCTGGTCCCGGCCCAAAGATGATGGTGGTTCTAGAGTCACAGGCTACTACATCGAACGCAAAGAGACATCCACTGACAAGTGGGTCAGACACAACAAGACTCAGATCACCACCACAATGTACACTGTCACAGGGCTTGTTCCCGATGCTGAGTATCAGTTCCGCATCATCGCACAGAATGATGTTGGCCTGAGTGAGACCAGCCCTGCTTCTGAACCAGTTGTTTGCAAAGATCCATTTG
>TTN-201,ENSE00003810204,1,300,72370,72669,ATAAACCAAGCCAACCAGGAGAACTTGAGATTCTTTCAATATCCAAAGATAGTGTCACTCTACAGTGGGAGAAACCTGAATGTGATGGTGGTAAAGAAATTCTTGGATACTGGGTTGAATATAGACAGTCTGGAGACAGTGCCTGGAAGAAGAGCAATAAGGAACGTATTAAGGACAAGCAATTCACAATAGGAGGTTTGCTGGAAGCTACTGAGTATGAATTCAGGGTTTTTGCTGAGAATGAGACTGGGCTGAGCAGACCTCGCAGAACTGCTATGTCTATAAAGACTAAACTCACAT
>TTN-201,ENSE00003805486,1,576,72670,73245,CTGGAGAGGCCCCAGGAATACGCAAAGAAATGAAGGATGTTACCACAAAATTGGGTGAAGCTGCTCAACTCTCATGCCAGATTGTTGGAAGGCCTCTTCCTGACATTAAATGGTACAGATTTGGTAAAGAGCTCATACAAAGCCGGAAATACAAAATGTCTTCAGATGGACGCACACACACTCTTACAGTAATGACAGAGGAACAGGAAGATGAAGGTGTTTATACCTGCATAGCCACCAATGAGGTTGGAGAAGTAGAAACCAGTAGTAAGCTTCTCCTGCAAGCAACACCGCAGTTCCATCCTGGTTACCCACTGAAAGAGAAATATTATGGAGCTGTGGGTTCCACACTTCGGCTTCATGTTATGTACATTGGTCGTCCAGTACCTGCCATGACTTGGTTCCATGGTCAGAAACTTTTGCAAAACTCAGAAAACATTACTATTGAAAACACTGAGCACTATACTCATCTTGTCATGAAGAATGTCCAACGTAAGACTCATGCTGGGAAATACAAAGTCCAGCTCAGCAATGTTTTTGGAACAGTTGATGCCATCCTTGATGTGGAAATACAAG
>TTN-201,ENSE00003801306,1,306,73246,73551,ATAAACCAGACAAACCTACAGGACCAATTGTGATCGAAGCTCTATTGAAGAACTCCGCAGTGATCAGCTGGAAACCACCCGCAGATGACGGAGGCTCCTGGATCACCAACTATGTGGTGGAAAAATGTGAGGCCAAGGAGGGGGCTGAATGGCAATTGGTGTCTTCAGCCATCTCAGTGACAACCTGTAGAATTGTGAACCTCACAGAAAATGCTGGCTATTACTTCCGGGTTTCAGCTCAGAACACTTTCGGCATCAGTGACCCTCTAGAAGTGTCCTCAGTTGTGATCATTAAGAGTCCATTTG
>TTN-201,ENSE00003808123,1,594,73552,74145,AAAAGCCAGGTGCTCCTGGCAAACCAACTATTACTGCTGTCACAAAAGATTCTTGTGTTGTGGCCTGGAAGCCACCTGCCAGTGATGGAGGTGCAAAGATTAGAAATTACTACCTTGAGAAGCGTGAGAAGAAGCAGAATAAATGGATTTCTGTGACAACAGAAGAAATTCGAGAAACTGTCTTTTCAGTGAAAAACCTTATTGAAGGTCTTGAATACGAGTTTCGTGTGAAATGTGAAAATCTAGGTGGGGAAAGTGAATGGAGTGAAATATCAGAACCCATCACTCCCAAATCTGATGTCCCAATTCAGGCACCACACTTTAAAGAGGAACTGAGAAATCTAAATGTCAGATATCAGAGCAATGCTACCTTGGTCTGCAAAGTGACTGGTCATCCAAAACCTATCGTCAAATGGTACAGACAAGGCAAAGAAATCATTGCAGATGGATTAAAATATAGGATTCAAGAATTTAAGGGTGGCTACCACCAGCTCATCATTGCAAGTGTCACAGATGATGATGCCACAGTTTACCAAGTCAGAGCTACCAACCAAGGGGGATCTGTGTCTGGCACTGCCTCCTTGGAAGTGGAAG
>TTN-201,ENSE00003808212,1,5609,74146,79754,TTCCAGCTAAGATACACTTACCTAAAACTCTTGAAGGCATGGGAGCAGTTCATGCTCTCCGAGGTGAAGTGGTCAGCATCAAGATTCCTTTCAGTGGCAAACCAGATCCTGTGATCACCTGGCAGAAAGGACAAGATCTCATTGACAATAATGGCCACTACCAAGTTATTGTCACAAGATCCTTCACATCACTTGTTTTCCCCAATGGGGTAGAGAGAAAAGATGCTGGTTTCTATGTGGTCTGTGCTAAAAACAGATTTGGAATTGATCAGAAGACAGTTGAACTGGATGTGGCTGATGTTCCTGACCCACCCAGAGGAGTCAAAGTTAGTGATGTCTCACGAGATTCTGTCAACTTAACATGGACTGAGCCAGCCTCTGATGGTGGCAGCAAAATCACCAACTACATTGTTGAAAAATGTGCAACTACTGCAGAAAGATGGCTCCGTGTAGGACAGGCCCGAGAAACACGTTATACCGTGATCAACTTATTTGGAAAAACAAGTTACCAGTTCCGGGTAATAGCTGAAAATAAATTTGGTCTGAGCAAGCCTTCAGAGCCTTCAGAACCAACCATAACCAAAGAAGATAAGACCAGAGCTATGAACTATGATGAAGAGGTAGATGAAACCAGGGAAGTCTCCATGACTAAAGCATCTCACTCTTCAACCAAGGAACTCTATGAGAAATATATGATTGCTGAAGATCTTGGGCGTGGTGAGTTTGGAATTGTCCATCGTTGTGTTGAAACATCCTCAAAGAAGACATACATGGCCAAATTTGTTAAAGTCAAAGGGACTGATCAGGTTTTGGTAAAGAAGGAAATTTCCATTCTGAATATTGCTAGGCATAGAAACATCTTACACCTCCATGAATCATTTGAAAGCATGGAAGAATTAGTTATGATCTTTGAGTTTATATCAGGACTTGACATATTTGAGCGCATTAACACAAGTGCTTTTGAACTTAATGAAAGAGAAATTGTAAGTTATGTTCACCAGGTCTGTGAAGCACTTCAGTTTTTACACAGTCATAATATTGGACACTTTGACATTAGACCAGAAAATATCATTTACCAAACCAGAAGAAGCTCTACCATTAAAATCATAGAATTTGGTCAAGCCCGTCAGCTGAAACCAGGGGACAACTTCAGGCTTCTATTCACTGCCCCAGAATACTATGCACCTGAAGTCCACCAGCATGATGTTGTCAGCACAGCCACAGACATGTGGTCACTTGGAACACTGGTATATGTGCTATTGAGTGGTATCAACCCATTCCTGGCTGAAACTAACCAACAGATCATTGAGAATATCATGAATGCTGAATATACTTTCGATGAGGAAGCATTCAAAGAGATTAGCATTGAAGCCATGGATTTTGTTGACCGGTTGTTAGTGAAAGAGAGGAAATCTCGCATGACAGCATCGGAGGCTCTCCAGCACCCATGGTTGAAGCAGAAGATAGAAAGAGTCAGTACTAAAGTTATCAGAACATTAAAACACCGGCGTTATTACCACACCCTGATCAAGAAAGACCTCAACATGGTTGTGTCAGCAGCCCGGATCTCCTGTGGTGGTGCAATTCGATCTCAGAAGGGAGTGAGTGTTGCTAAAGTTAAAGTGGCATCCATTGAAATTGGCCCAGTTTCTGGGCAGATAATGCATGCAGTTGGTGAAGAAGGAGGACATGTCAAATATGTATGCAAAATTGAAAATTATGATCAGTCTACCCAAGTGACTTGGTACTTTGGCGTCCGACAGCTGGAGAACAGTGAGAAATACGAAATCACCTACGAAGATGGAGTGGCCATCCTCTATGTCAAAGACATTACCAAATTAGATGATGGTACCTACAGATGCAAAGTAGTCAATGACTATGGTGAAGACAGTTCTTATGCAGAGCTATTTGTTAAAGGTGTGAGAGAAGTCTATGACTATTACTGCCGTAGAACCATGAAGAAAATTAAGCGCAGAACAGACACAATGAGACTCCTGGAAAGGCCACCAGAATTTACCCTGCCTCTCTATAATAAGACAGCTTATGTAGGTGAAAATGTCCGGTTTGGAGTAACTATAACTGTCCACCCAGAGCCTCATGTAACATGGTATAAATCAGGTCAGAAAATCAAACCAGGTGACAATGACAAGAAGTACACATTTGAGTCAGACAAGGGTCTTTACCAATTAACAATCAACAGTGTCACTACAGATGATGACGCTGAATATACTGTTGTGGCAAGGAACAAATATGGTGAAGACAGCTGTAAAGCAAAGCTGACAGTAACCCTACACCCACCTCCAACAGATAGTACCTTAAGACCCATGTTCAAAAGGTTACTGGCAAATGCAGAATGCCAAGAAGGCCAAAGTGTCTGCTTTGAGATCAGAGTGTCTGGCATCCCCCCACCAACATTAAAATGGGAGAAAGATGGTCAGCCACTGTCCCTCGGGCCTAACATTGAAATTATCCATGAAGGCTTGGATTATTATGCTCTGCACATCAGGGACACTTTGCCTGAAGACACGGGTTATTATAGAGTCACAGCCACTAACACAGCTGGGTCCACCAGCTGCCAGGCTCACCTACAAGTGGAACGCCTGAGGTACAAGAAACAGGAATTCAAGAGTAAGGAGGAGCATGAGCGACACGTACAAAAACAAATTGACAAAACCCTCAGAATGGCTGAAATTCTTTCTGGAACTGAAAGTGTACCACTGACACAGGTAGCTAAAGAGGCTCTGAGAGAAGCTGCTGTCCTTTATAAACCGGCTGTAAGCACCAAGACTGTAAAAGGGGAATTCAGACTTGAGATAGAAGAAAAGAAGGAGGAGAGAAAACTCCGGATGCCTTATGATGTACCAGAGCCACGCAAGTATAAGCAGACTACCATAGAAGAAGACCAACGCATCAAGCAGTTCGTGCCCATGTCTGACATGAAGTGGTATAAAAAGATACGTGATCAGTATGAAATGCCTGGGAAACTTGACAGAGTTGTACAGAAACGACCCAAGCGCATCCGCCTTTCAAGATGGGAACAGTTCTATGTGATGCCTCTTCCACGCATTACAGATCAATACAGACCTAAATGGCGTATTCCTAAACTGTCCCAAGATGATCTTGAGATAGTGAGACCAGCCCGCCGGCGTACACCTTCTCCTGATTATGACTTTTACTACCGACCTAGAAGACGTTCTCTTGGGGACATCTCTGATGAAGAATTACTCCTCCCCATTGATGACTACTTAGCAATGAAAAGAACAGAGGAAGAGAGGCTGCGTCTTGAAGAAGAGCTTGAGTTAGGTTTTTCAGCTTCACCCCCAAGTCGAAGCCCTCCACACTTTGAGCTTTCTAGCCTACGTTACTCTTCACCACAAGCTCATGTCAAGGTGGAGGAAACAAGAAAAGACTTCAGGTATTCAACCTATCACATCCCAACGAAGGCTGAAGCTAGTACAAGTTATGCAGAACTGAGGGAACGGCATGCCCAGGCTGCGTACAGACAGCCAAAGCAACGGCAAAGAATCATGGCTGAGAGGGAGGATGAAGAGTTGCTTCGCCCAGTTACGACCACCCAGCATCTCTCAGAATACAAAAGCGAACTTGACTTCATGTCAAAGGAGGAAAAGTCTAGAAAGAAATCAAGGCGACAAAGAGAAGTGACAGAAATAACAGAAATTGAGGAAGAATACGAAATCTCAAAACATGCTCAAAGAGAATCATCCTCATCTGCGTCTAGACTACTGAGACGACGGCGCTCCCTGTCTCCAACTTATATTGAGTTAATGAGGCCAGTGTCTGAGCTGATCCGGTCACGTCCACAACCGGCTGAGGAATACGAAGATGACACAGAAAGAAGGTCACCTACTCCAGAGAGAACTCGCCCACGATCCCCCAGCCCTGTGTCTAGTGAGAGATCACTCTCGAGATTTGAGAGGTCTGCAAGATTTGATATCTTTTCCAGGTATGAGTCCATGAAAGCTGCTTTAAAAACTCAGAAGACATCAGAAAGGAAGTATGAAGTTTTGAGTCAGCAGCCTTTCACACTGGACCATGCCCCTCGAATCACACTGAGAATGCGCTCGCACAGGGTACCATGTGGCCAAAATACACGTTTTATTTTAAATGTTCAGTCTAAGCCAACTGCCGAGGTTAAATGGTACCACAATGGTGTGGAACTCCAAGAAAGCAGTAAGATTCATTACACCAACACGAGTGGAGTCCTCACCCTGGAAATTCTGGACTGTCATACTGATGACAGTGGAACCTACCGTGCTGTGTGCACCAACTACAAGGGCGAAGCTTCTGACTATGCAACGTTGGACGTGACAGGAGGGGATTATACCACCTATGCTTCCCAACGCAGAGATGAAGAGGTCCCCAGATCTGTTTTCCCTGAGCTGACAAGAACAGAGGCGTATGCTGTTTCATCATTTAAGAAAACATCTGAGATGGAAGCTTCGTCTTCTGTCAGGGAAGTGAAATCACAGATGACGGAGACAAGGGAAAGTCTCTCCTCATATGAACACTCTGCATCTGCAGAAATGAAAAGTGCTGCATTAGAAGAAAAGTCACTGGAAGAAAAATCCACAACCAGAAAGATCAAGACGACTTTGGCAGCAAGAATTCTAACAAAGCCACGGTCCATGACCGTCTACGAGGGCGAGTCTGCAAGGTTTTCTTGTGACACCGATGGTGAGCCGGTACCAACTGTGACCTGGCTGCGTAAAGGACAAGTGCTAAGTACTTCTGCCCGCCACCAAGTGACCACCACAAAGTACAAATCAACCTTTGAGATCTCTTCAGTCCAGGCTTCCGATGAGGGCAATTACAGCGTGGTGGTAGAAAACAGTGAAGGGAAACAAGAAGCAGAGTTCACTCTGACTATTCAAAAGGCCAGGGTAACTGAAAAGGCTGTGACATCACCACCAAGAGTCAAATCCCCAGAGCCTCGGGTGAAATCCCCAGAAGCAGTTAAGTCTCCAAAACGAGTGAAATCTCCAGAACCTTCTCACCCGAAAGCCGTATCACCCACAGAGACAAAACCAACACCAACAGAGAAAGTTCAGCACCTCCCAGTCTCTGCCCCACCAAAGATTACTCAGTTCCTGAAAGCAGAAGCTTCTAAAGAGATTGCAAAACTGACCTGTGTGGTTGAAAGCAGTGTATTAAGGGCAAAAGAGGTCACCTGGTATAAAGATGGCAAGAAACTGAAGGAAAATGGGCATTTCCAGTTTCATTATTCAGCAGATGGTACCTATGAGCTCAAAATCAATAACCTCACTGAATCTGATCAAGGAGAATATGTTTGTGAGATTTCTGGTGAAGGTGGAACGTCTAAAACCAACTTACAATTTATGGGGCAAGCCTTTAAGAGTATCCATGAGAAGGTATCAAAAATATCAGAAACTAAGAAATCAGATCAGAAAACCACTGAGTCAACAGTAACCAGAAAAACTGAACCAAAAGCTCCTGAACCAATTTCCTCAAAACCAGTAATTGTTACTGGGTTGCAGGATACAACTGTTTCTTCAGACAGTGTTGCTAAATTTGCAGTTAAGGCTACTGGAGAACCCCGGCCAACTGCCATCTGGACAAAAGATGGAAAG
>TTN-201,ENSE00003811220,1,157,79755,79911,GCCATTACACAAGGAGGTAAATATAAACTCTCTGAAGACAAGGGAGGGTTCTTCTTAGAAATTCATAAGACTGATACTTCTGACAGTGGACTTTATACTTGTACAGTAAAAAATTCAGCTGGATCTGTGTCCTCTAGCTGCAAATTAACAATAAAAG
>TTN-201,ENSE00003801641,1,692,79912,80603,CTATAAAAGATACTGAGGCACAGAAAGTCTCTACACAAAAGACTTCTGAAATTACACCTCAGAAGAAAGCTGTTGTCCAAGAGGAAATTTCCCAAAAAGCCCTAAGGTCTGAAGAAATTAAGATGTCAGAGGCAAAATCTCAAGAAAAGTTAGCCCTCAAAGAGGAAGCTTCAAAGGTTCTGATTTCTGAAGAAGTCAAGAAATCAGCAGCAACCTCCCTGGAAAAATCCATTGTCCATGAGGAAATCACTAAAACATCACAGGCATCAGAAGAAGTCAGAACTCATGCTGAGATTAAAGCATTTTCTACTCAGATGAGCATAAACGAAGGTCAAAGACTGGTTTTAAAAGCCAACATTGCTGGTGCCACTGATGTGAAATGGGTACTGAATGGCGTAGAGCTTACCAACTCTGAGGAGTACCGATATGGTGTCTCAGGCAGCGATCAGACCCTAACCATCAAGCAAGCCAGTCACAGAGATGAAGGAATCCTCACCTGCATAAGCAAAACCAAGGAAGGAATCGTCAAGTGTCAGTATGATTTGACACTGAGCAAAGAACTCTCAGATGCTCCAGCCTTCATCTCACAGCCTAGATCTCAAAATATTAATGAAGGACAAAATGTTCTCTTTACTTGTGAAATCAGTGGCGAGCCATCCCCTGAAATCGAATGGTTTAAAAACAACCTGCCA
>TTN-201,ENSE00003801638,1,154,80604,80757,ATTTCTATTTCTTCAAATGTCAGCATAAGCCGCTCCAGAAATGTATACTCCCTTGAAATCCGAAATGCATCAGTCAGCGACAGTGGAAAGTACACAATTAAGGCCAAAAATTTCCGTGGCCAGTGTTCAGCTACAGCTTCCTTAATGGTCCTTC
>TTN-201,ENSE00003805382,1,303,80758,81060,CTCTAGTTGAAGAACCTTCCAGAGAGGTAGTATTGAGAACAAGTGGTGACACAAGCTTGCAAGGAAGCTTCTCGTCTCAGTCAGTCCAAATGTCTGCCTCCAAGCAGGAGGCCTCCTTCAGCAGTTTCAGCAGCAGCAGTGCTAGCAGCATGACTGAGATGAAATTTGCAAGCATGTCTGCCCAAAGCATGTCCTCCATGCAAGAGTCCTTTGTAGAAATGAGTTCCAGCAGCTTTATGGGAATATCTAATATGACACAACTGGAAAGCTCAACTAGTAAAATGCTTAAAGCAGGCATAAGAG
>TTN-201,ENSE00003809884,1,1319,81061,82379,GAATTCCGCCTAAAATTGAAGCTCTTCCATCTGATATCAGCATTGATGAAGGCAAAGTTCTAACAGTAGCCTGTGCTTTCACGGGTGAGCCTACCCCAGAAGTAACATGGTCCTGTGGTGGAAGAAAAATCCACAGTCAAGAACAGGGGAGGTTCCACATTGAAAACACAGATGACCTGACAACCCTGATCATCATGGACGTACAGAAACAAGATGGTGGACTTTATACCCTGAGTTTAGGGAATGAATTTGGATCTGACTCTGCCACTGTGAATATACATATTCGATCCATTTAAGAGGGCCTGTGCCCTTATACTCTACACTCATTCTTAACTTTTCGCAAACGTTTCACACGGACTAATCTTTCTGAACTGTAAATATTTAAAGAAAAAAAAGTAGTTTTGTATCAACCTAAATGAGTCAAAGTTCAAAAATATTCATTTCAATCTTTTCATAATTGTTGACCTAAGAATATAATACATTTGCTAGTGACATGTACATACTGTATATAGCCGGATTAACGGTTATAAAGTTTTGTACCATTTATTTTATGACATTTTACAATGTAAGTTTTGAAACTAACTGTTGGTAGGAGAAAGTTTCTTATGGAACGAATACCCTGCTCAACATTTAATCAATCTTTGTGCCTCAACATACTGTTGATGTCTAAGTATGCCTCAGTGGGTTGAGAAAATCCCCATTGAAGATGTCCTGTCCACCTAAAAGAGAATGATGCTGTGCATATCACTTGATATGTGCACCAATACCTACTGAATCAGAAATGTAAGGCATTGGTGATGTTTGCATTTACCCTCCTGTAAGCAACACTTTAACGTCTTACATTTTCTCTGATGATGTCACACAAAATTATCATGACAAATATTACCAGAGCAAAGTGTAACGGCCAACACTTTGTTCGCTCATTTTACGCTGTCTCTGACATAAGGAGTGCCTGAATAGCTTGGAAAAGTAACATCTCCTGGCCATCCCTTCATTTAACCAAGCTATTCAAGTATTCCTATGCCAGAGCAGTGCCAACTCTTGGAGGTCCCAGAGTGCAGCCAATGCCTTTGTGTGGTAGTTCTAAATTTTAATTGCACCTGAAAAACCTGGGCACCTAAGCAATGAGCCACAGCAAAAAGTAAAGAACAACAACAAAATAAAGCTGTTGTTAAATTTTAAACAATATTACTAATTGCCCAAAATGTCAATTTGATGTAGTTCTTTTCATGCAAGTATAAATTCAATTGTTAGTTATAATTGTTGGACCTCCTTGAGATAGTAACAACAAAATAAAGCAAGCTATCTGCACCTCAAAA
>TTN-201,,0,2210,82380,84589,GTAAGCTCACACATTCACACTTTTGTTTTTTTTTCCTTTGCCTCCTCTCCAGTAAGTTAACGTTGCTGCAGGACTTGACGCCAAGTTTAAGCCCTGCTTTCACTTCGGAAAATTAGTCCAACACTATGGAAAGGTCATTTTAAGGGTATACCATTCACAGAGTACTGACAAAATCTGACAATATAATGGCTTGAAATGTTTTATTCATATTTATTATTCCACAAAGCAAAAATAATTAGTGTTGGATTAAAATTGCCGTTAGAATCCAGCAACTAAATAGGACCAAATTTAGTCATTCTATATTTGGGCTCAGCTGCAGAGCCAGACTGGAAGCCAAGAACTCAAGCCCAATAGAAGCCAGCCACAGAGCCATGGGGTAGGCAGTCTGGGCTGCCTGCTCTGGACACCTGAACTTCAGTTGGTTCACACGCAAAATAACAGTGCATCTAATTTTCCTCAGAGGCAGAGCTGTTCAGTAATTAACCAACTCCTCATTATTTTATTATTTTATTTTCAATCTTTATTGAGTGATTCTAATGAATTAAAAGACTTTCCAATCGTTTTGAAATGACAGAAAATAATATGCTTCTCGGGTGTCTCTATTTAAAAGGAAGCAAACACTAACCCTAGAATTTTATCTGAAAGGAAGTTCATCTCTTTTTTGCCTTCTTTTTCTTCCTCATAACTCAGTTTATGGATGGTTCAAAAAAATGCATGGTATCATCTTATGAAAAAATGGAGAGTAGTGTATGAACTATATTGTAAATAATTTTAAAATTAATCAATATTTTCTCTTTCTGTAGTATTGTAACGAGCCATGTAAGATGGATACGGATTAAAAAAAATCATGCTTAATTCTTAATTTAGTGCACTTCCATGGTTCATTGCCCACTTCTTTTTTAAAATTTTATGGCTTATAATAAAGATATAAAATAAAATTTCTTTTTTTCTCTTTTTTTCTATTATATGCACCAATCTTATTCATAACTGGATAATACTTTCTTTTACATTGTACAAATATCATATAATCATTGCTTATTTTCTATTGTACATATATAGACCAATGAAATTCCCTTTTCATTGGTCTATATATGTACAATAGAAAATAAGTCTTACCGACTTCCAAATAATTTACCTATTTATCTGGTAACACTCAGTAACTTCTGAACTGAGCAGAACACATATGACTTCAGTGGGAATTTGCCTCCTTGAGAAGTAGTGGAATCTGGCTACTTCATATCTTCTTGTTCCTTCAAACTATATGCAAATAAATTATTACAAAGACACTACTGAAAATATCCAATACCCATAAATCAGTCCAATAAACTATTTAATTGGCCATAGTGGGAGATGGGCTAATGTATAAACAACAAAATAGACTTTCTCTAGATTATCTTTACCTACCAGCGTAAGTAGATAGAGCATCAACCTTTATGCCAAGTGTGAAATAAATCATGCCCTGAATGTGCCTCGTACATTCTCAATGTACAGAGTTTTAATATATTTAAAACATCAAACCATGGACATGTAGTTCTTGGCTCTACAATTTATGGCAGATAAAGAGAATTTGGCTTTCTACCTGCAATTCCAATGATCCATGTTGTTCTGGAAGACTAGGTTTGGATTAGTCTCTTATGAGAAATTGCTTGTCCATGTTACAATGTTTTTACTGATTGCACTTGTGAAAGCAGAAGAGTCCAAGAAGACAGTGTCCCTGTAACCACAGAGGAGGGAGGAGGGCATGCCTCCTGGGCTTGTCAGGCAGAAACTGGAGATCAGTTTGCTGCTTTTGTTCTTCACTTGCTCTCAAAGAGGACAACAATCACTCTTTATTTCAAATTTTCCTTGGTTCTTCATTTTTATAAGTCCCTTTCATGATTTTAATGTTGTCTATTAAATTGCATCAGATAGAGCCCTAGGCAGGCAGGCAGGAGATGGAAATTCTAGTCCCCTCTGTGTCACTGCTAGCTGAAGGACCTTGGAAAAATCATTAGGCCTCTTTTGGTCTCAGTTTCCTCCCTTCCTGCCTTCCTAATGGTCTGCAGGTTTACACACTGATCATGCAACTGTAGGGTTTTCCCTATCATTAAGTGGCATTCCATGCTGGAAAGCTTTTACAGATTCGGACAAGGCAGTGAACATGATGGGACAGAGCAGAGGACTTTGTGGTGCCCATTCAAACATAAAGGTGAATTGTTCTTGCTCTTCAG
>TTN-201,,0,1455,84590,86044,GTAGGCTGCTGGGGACCTGCCAATCCTCTGCTCCCCCAGAGGACATCTCCAGCAAATTGGGAAAGGAGTCCAGAAAAAGCTATGGGCAGAGGTAGATGCAGCTCTTAAACTACAGAAGGGTCTACTGGAGGCTGAATTATTTATAACCAAGTTGTTTGCCTTTTGGAATTTAATTTTCCTCTAGAGTACATCGTAAAAGTGACTGAGAATCAGTTTCTCAATACACATATTAAACACTCAAAAGTATGTTAAGGAAATATTAAAAATCATGTTTCTCAGCAAGTAGAAAAGCTTGGAGCCTTGTTTATAAGTCCTTTAAGGAATAAGACATATTCTCCAGGGAAGTGTGAATCTCCAGGAATTCACACTTTAACAAGCATCCAGATAATTCTGATGCCGGTAGTCTACAGACCACCCATTTAAGAGGCATGTAAACATACCCAGAAGAAAATAAATGCTTGTTTATTATTCAAATGCATGACACTGTTTCCCCAGAAAACTTATCACCAATCTTAGTGGCCTCTGTTGTTTTTCTCTATCCTTTACTACCTAGTGAGACATTAGTATACAGAATATTGCATGCCTTTACATGTTTTATAACAATATCTTACATGAGCTACGTAAAGTTACATATGCTTATCCAATAAACTTTACCTTCAATGATGTTCAATTATAGGGCTATAATTGACCTAAGCAGAAACCACATCAAGTAACATCAGGTAGAACTTTAGCATGCACCCAGAAAATTCACAAATGGAAAATGCACAGGGTTGGCAGCACCTGCTGTTGTTTATTACTCAAAATCATGTCAAAGTTAATTCCACTCACTCCTCACACTTATAAAAAATTTCCTTCAACATAACCAAAAAAATCCCCTTTCTGTAACACAATTAAAATGAAGTAATGTTATTATTGGGATTAACGTTTTAAATGCAAGTAAATATTTGGGTTATTTGAATACCTATCAAGTTGGAGAAGGTTTAGAATTTTAAAAATTAAATTAAAAATGTAATGATTCTTTAAGTAACAGGTACACCCATCGTAGCAACCACTGGAATTCATTTTAATGCAACTTACTGGAATATGCAACATGGCTTTCACATATTAATAGAGCGCTAGATGTGAGGTAGAGGGGGAAGTACCAGAAAGATTCTCAAGAAATGTTATAACAAAATCTAGAGCTTTTATTTAAAACAAAGAAACAAAAGGTGGTGGCCTAAACTGCTCAGCAAAACAAAGCAAATAAAATAAAATATGGTGGTGAGAAAGCCTTCTGTAATCTCCTGGCTCCCATTCTTGCTGTCATTGCTGGGTGAGCTGGGTTCAAGGACATTCAAGGATGTTTAGATTGGCGAGTCATCACCTGGTTTTGGAATTGGAGCTGTGATTATTTAAAAATACCTTGTAGGGAGCACCCTGGCTCTCACTCTTGACTTTGTTCTCTTGTCCCCGCAG
>TTN-201,,0,484,86045,86528,GTACGTGCTGGAGGTTGAGGAACAGAGAGAAGGGGAGAGAGCTGGTTTGTGTCTAAATGGGGCCAAGCGTCCACTTGCCACCTCTCACAGCCCTGGGAAGAATGCTGTGAGCTGATATAAAAGCTGGCTTTTCGACACCCATGAAAAGTCCCTGAGATTCTAGTCAGGAGCGCAGAATAGAAGCAATCTGTGCTTATGAATCTCATTATAAACTGGAAAGGGTTTCAATTAAGTGATCTACATTTCCAAATTATTGGCAAATAATGAAATTTTAAAAAATCATTCTAAGTAAATTTTTATCTTGTAATGAACATTTTCTATTTTTAAACCTAATTTATATTCATGCAAAATCCAAAACTTTCTGCAATTTTCTCCATTGGGATATCCAGAAAATCTTTTTGACTTTGTAGTCAGAATTAACAGAATCTCTTTTAAAATGGGTCATTGTGCCCCCTCCCAAACATTCATCTTTCCCTTCCCACAG
>TTN-201,,0,93,86529,86621,GTATTTTTCTATACTGTTGGTTTTCAAGCCTTTCAGGCTGTTGCGTCCCCAGCTATTCCTCCTCAACGTGGGCTTTGTTTTAATCTTTTACAG
>TTN-201,,0,4234,86622,90855,GTAAAGCTGCCATAGAGAGAGCAGATTATTGCACATTTTGGAACTAGGTTTTGAAACGAGAAAGATTCCCTTGTCCCCCTCGCAGGGCATGCGACGCGGAGAGTGGTTCGCTTCTTCAGTGTCCCGCTGCTCAAACCTCTAGGGGAGCATACAAACGGGCAGGTTGTGGGGCTCCGTGTTCCTCTGGACATCCAGCCGCTTGTGTGTCTGCCTACTAGGGTCTCAGGGGTTTTTATAGGCATAGGGTGTGGGCGTGGCAGGTCAGGGTGATCTTGGGAAATGCAACATTTGGGCGGGAAGGCAGGAGTGTTTGTCCTCACCTAGGTCCATGGGCACAGGCCTCGCTAGGGACCACGCACTTCTCTTCCCAGCACTTCCCTGCCCTCCTCCCGTGTAAGTTTCATGCACTCAAAAATGTAGCAGGTGACAAAGGAGGTAAACCAAGAAGTTACTGAATATGATTTTCACAAATCCTCACTGTCCACAGGTAAATTGAAGACCCTTATAAACTTCTGAATTCTTATTTATATTTCATGTAATAAATATCTACTTTAGGGGCCAAAATATGGCACAGTGAAAGGAGAAGAGCACAGAAGTTAGAGTTCAAAGCCCTAAGGACAAATCAGCCTGATCACTTAACAGTTTGATTTAGGGCAATAAGTATAAATAATAAAATAATTGTTATTATATATGGATCACTTCCTCTATCAGATTGGAACTATACATACATTATCTCATTAAATGTTCACAACCTGTAAGAATTATTATCCTCAATGTTATTGATAGGTAACTGGAATTAAAGAAGTTAAGCAGTTTATTTAAGGTTTCAGTTGTGTCATCTGTAAATTAAAGAGAGTCACAATAAGAATGATCTCAAGCTGCATTTTGGGGCTTCAATGAGATAATTAGTTGAAAGTGCCTTGTAAATAGAAAATAATTATGCCAATATTCTTATATTCAGATGGTAAGTAAAACCTTTTAAATATTTTGCATATGCTTGTGTTATTTTATCTAGAAAATAAAATGGACTTCTATGCTTACTTAATATGGAAGTATTTTAGAAGGTGATCATGTATCATGATCAGGGCTCAGAAATTATATAATCAAGTGTAAATTGTCCACAACAGTTTTGAAAGTTTGGGATTTAGTTTATCATGATGAAACTTTTAATATGATGAAATGAAAAATGTACAAAATTTGAGCAAAGAAGTGTTTATTGATCAATTTAAATGAAATAAAAAACACATGGATGTTCCCTGCCAAGAAAATTTTTTATAAAAGAATAATAAGGAGATAGTTGACCTAAATAATATTCAAACATACTGTAAAGTTACTATAATCAGAACAGTATGGTATTGGTAAATGAATAGAAAAATACACCAGGGGAACAAAACAGAGAGTCCAGAAAGAGATCCAAGTATAATAGATCCAAGTATATAGGGAATTCAAAAAGCAAAGTGGCCTTTCAATTCAGGGGAGGGAGAGGTATTTTAATAAAGAATGCTGGTCCAATTAGCTATCCATCTGGAAGCAAACAAACATAAACCTCTGCCTCTCACTATTTACAGAATAAATTTCAGCTTGATTAAATAGTTAAAAAATGAAAAAAAAAGAGAAGACAATCTGCAAAAGCATTTATGGGTGAAAGCTTTTAAAAAGACAGTTACAGATTCAACTACATAAAAATCAACATGTATGTATGGCAAAAGCAAAAAGTCATTTCTAAACCAAACAGCACTTGTGAAAAAATTTTAAGACCTTTCTCCTCCTCAAGGTACTTCATTGCCTCTGCCATAAAAGTATCACAATAAACATAAAATGGCTACAAGGTAGACAACACCAGCCTAGAAACAGTATATAACATACAAAATTACGTAAGCTTATGCTGGATAAGACCCATAAACAAGCAAAATATTGAAATGGATTAAAAGAAATGGATCTGGGGGAATGTTTGCAACACTTACGACAAATAACCAATAAATGCACTAAATGCATTAAAAATCATCCACAAATTAATTTTTAAAGGAAAAAAATGCAACACAAAAAAAGACAAAAGATACAAAAAAGTATTTAACATAAGAGGCAATGTAAAAGTCCAATAAACATGTGAAAAAAAATGCTAGATGTTTTCCAATTTTTATTGTTTTAGCCACAAAAATGTAAAGATATTGGCAAACACTAACATGAAACCTTGAACAAAAAGCTTACTTTAAAAAACATGTCTAGCAGTCGAATAAAAAAAAATGTTCAGTCTCAGGCTAAATCCAAGTTTGCACACCATGAAATCACAACACAAGCCAAATGCAATTTCTTGAGGAGATAACAACCTAACTATATTTTAAAACCCAAGCCTAAGGGTCATTTAGAATCATGGAGTGTCCCTGATCCCATGGAGCATTTTGACCATCTTAGCAGTTTTGAAAGTTCATTAATAACCATCCAAATTGCCCCAAAATTTTGCTTTCCAATAATTAAGAAATAAAATGCCAATTTGCAGAGAAAATAATGGTTATCAAAGATAGACTGCTTCCTAAATATCTCATAGTTTAATCTTGATTTTTGTTGTAGAGTAAGGCAAACATATTTCATTGAATAAGGTGCATTGTATCTCGCTGTGACCAGGTGATTATTTTTTGTTGTAAGTACAGAAATAAGCACTCTCCTATAATGACCAAAATTACAATGATTTTCACAGTTATGGGCTTACCTGTGTCCTGCTGTTAATCAGTCATGTCATGCTAATCATGTCTTTAACTCTTTTTGAATTAAACCCATTTACTAAGTACAGCAAGAACAAGGCACAGGGTGAAACTTAAAAGCACATGTCTCTTTGCTTTTCTTCAGTTAGTGGAAACCACACATTATTCTAACTTGGTTTTTGTTATATTTCAAAGGCAGTCATGTTCAGAAAAGAGGCTTATTCCCTAGATTTCCCTTTAGTTTGATTACAACTTCATTTACAAAATGTAAATGGATTTTCACACAAAAAAAGCCATTCTTCGAGAAAATAAACATTTCTTCGTGAAACTGGTTAATGTTGTAATGTACTGTTAGGGTACTCTGTAAGTTAGAGAAAATATCAACTGTACCTTGAGCTTAATTAGAATAATCATTTCATGTATGATCAGTGTAAGCTAAATATCCTAGATAGTGACAAGATGCATTTATAAACATTTTCTTATATGCAGAATTAATAAAATGCAATGATAGGGCAATACTGCCACCTAGAGAGGAAAATGTAATAAGCCTTATTAAGAATTAAATCAGTTCTGAAAAAAATTTTACCTTACAATAGTTGGCCAATCCCCAGAATTATTGCTATAGATCAGAAATAGTCTTTTTTGGCCATCAGTGCTGGGATTTAGCACCCAAATTCTTCAACTGATGCTACTTGCACTTTGGATACACCTAAAAAGCAAACAATGAAAACTATTCTGGAAGAAGCAACTTTATCAATTTACCCAAAAATCACAGAATCATTAGTTTTTAAGTTAGTCAATTCCCACAATAACTCTAAAGATATTTAAAATAAGTCCAGAGTGCAATACAAGGGGGGCGAGTGTAAACAAATATGGAGGAAATTAAAAGTAGCTGTCCACAAACACTTCGGCTAAAGCAGCAATTTGCAAAGTGCACTGCACAACCTGTACCCAGCAACATGCTGCAGAAAGCTTCCTGAGGATGTGTCCCCCTGTCCTGGAAATTCACAAGGCATACTGACATAGTAAAGGCTGTGGGAAGTCCTGCAGGGGAAAAAAAAAAATGGCTTAAGCTGCTTAGTCAAGAGTGGCACAAGCATTTTGATTACAGAAACCTTTCTTCTTATAACACCTATTTGACATCCTCTAACCCCCCCAGAATTGGAATACAGAGATGAATTTGGAATACAGAGGTTGCTGGATTTGACATGTCTTTCCTTTGGCTGCATATTAAAGAAGTAGCTTTTTCTGTTGTGATTTTTTTTTTTTTTTAATGTGAGAAGGTGCAAGGCACAAAATCTCCAGCTTATTTGGAATTAAAGCTGATTCTCTTACAGGGTTACAGCAGATAAGAATAGGTTTATTGAGATTTAAAACAAATTACTTCCAAGTACATTATTTACCCTCTGAATGGGTTATGGAGGCACACATTTTAAAACTCTGCCTTAAAGCACTTCCAGCTTTTCATCTCATGATTCACATCCAGTTACCCCTCCTTGCTTTGACATTCTTGACCTCTGCCTTTTGGTTTTCAG
>TTN-201,,0,370,90856,91225,GTACTGTCAGAATGGTTTTGTTTTTCCTTATTTCACATTCTAGTTTCTCCAACTGGATTTCTGCCATGAAACTCAGTCTGTATAAATTGGAGGAAAAATGCATATGAACATAAAAATATAGCAGCAACTGAAGACCAAATTCAGTAGTCATGCTTTGTAAAACCATTTTTAATTAGGACAAAAGCTCCAATCTGTGAAGTTTCCATAATATACAGGTTTTAATGATACAGTCTCTGTATTTCTTGGCAATAATAAATGCTTATGTATGAGTGTATTTTGCTCTAGGTGGCTCAGTTTTCCAGTATGCTTTTTTATTTTCTACTGGGCATGTCATTTAAAAAAGTAATCTACTTGGTCATTTCTAATCTAG
>TTN-201,,0,857,91226,92082,GTACGTGCGAGGCTGCCATGGGGCACCCGCAGAGCCACGTCCTTCAGTGCACATTAACTCAACCACCATCCACTGAGCTTGGCATGCAGCTGTGCTCAATTCATTCTGAAGACAGCCTTGAGCCCAGCAGGGCCCAGACTTTTAGAACTTTCTGAGCAAAAGGTGGTCGGAGATGTCAAAGGTGTTGACAATGTGAGTATCACAAGAGCAGAGTAGGCCAGAAATACCTGGGCTATATGAGCAGGCAAAAGTCAACTATGGTATTCAAGGTAGGAAGGCAAAGAGTGGCCAGAGAAACAGAGACCAGTCAATTCCAGAGCTCAGTCACTGCACACACTGGATGTGGAAACTACTATTTCAGGGAAGGCATTACATTTCTCTAAGTTTCCCCAAAGGACTTTTGTTTTTACTTTTCTCAAAACAAACATGACACTTGATTCATAGCTGGAACAGTGTCATAAATCCAGGATAATGTCCCACCTCGCATTTGAATAGATTTTCTGTTACAGTTTAAAATCATTCCAGCTTTCCTCCTTATCCTCTTGTGTGACATTTATGTCTAAATCCTGACAGATTATTGTAACTTTTTTTTCTTTTCTGAGACAGAGTCTCGCTCTGTCACCCAGGCTAGAGTGCAGTGGCATGACCTCCGCTCACTGCAGCCTCCGCCTCCTGGGTTTAAGTGATTCTTGTGCCTCAGTCTCGTGAGTAGCTGGGATTACAGGTGTGCGCCACCACACCCAGCTAATTTTTGTATTTTTTAGTAGAGGATTTCACCATGTTGGCGAGGCTGGTCTTGAACTAATTTTTATGTAAGATGCATTAAGGTGTTTTCTTCCTTTCTCTATGAAAAGCAG
>TTN-201,,0,1206,92083,93288,GTGAAAATGGGTTTGTATTTTAAATTCACTGAGGTTCTTACAGGGGTCAACACAGATAATCACCTTTACCATGAAGAGTGTTGTTCCTTGGGCCACATGGTTGTTAGCATACTAATAAGATCCCCTTGTTGTATGTGTAAATTTCTGGGTACTGGATACCAAAGTTTGGTAGTGTCCCTGAATGCTCCCCTTGTGAGTATGAAAAAGAACTCTGTGAACATACACCAGGAGTAGAAACAGGGGTCTCATCACATTGATCTGGGGATGCACTAAGTATAAGACTATAGGGAGAGGACAGATGGCTAAAACCAGGAGGAAGAAATAGATGCTGAGGCAGGAATGGGGAAAAGTGGAGGAGACACTGAACTCACTTTGCTTTAGAAATCTTAGCAACTGCTTCCTGGCTCCTTCGGAAGACATTTGCACATGAGTTTGAAGTGGAATGGACAGCATGGCTTTAACAAGCCAAATGACCAGAAAAGGTGAAAAGGACAGCCCCATGGTTGGCGGCATTTGGGGACAGATTGGAAAATGCCAGTTAGTAGAGCTCTTGGCCAGTGGAACCAGTTGGCAGTTGGGTGGTTTGAGAAGATGAATTTCAAGTCCCTTTCAGCCTTGAGATCCTGTGTTTCAGTGATGAGATATTTGAGAATGGCAAAGAGGCAAATAGAGAAAACTGTCCCCCTACATACGCATATACCTTAGGTGCCCAGATGGAAACAGCATTCTTCACAGTATTTAGGAAAACTGACAAAACAAAAATATTGTATAAATGCAGATTATAAATTATCCATGCTTGATTTCTCACATGTAAAATAAAAAGATCAGACAAAATTACTTCTAAAGTCTTCCATTCTGATATATATTCTAAGATTACCTTTAGATGACAGAATTAGTACAGAATAATATTGCCATAGATCTATTTGTAAACATTGGAAGTCATTTTAAAGAAGACTACAATTCTGCTGTTCAAAACAAAGTGTTGAATTCAACTTTGTTTTCTCTAAGCAGCCTACATAATTTACAGTTTAAGGAGAGAAAGAGCATGATCTTATTTATGAACATGGGATTATTTATTTTATTTAGTGACATCTGCAGAAAAGGGATTTTACATCTTCAAATTCCTATGTTGTTATATTTAATAAACACCATATTATTTCATTGGGCATCAGGAAATAAAGTTTTTTCTTAAATCATTCTTTGCAG
>TTN-201,,0,1956,93289,95244,GTAAGTCTGATTTTCTAAATATTTTGTAGTTTGTTGACAATATCACATTACAGCCAGCTGCAGGTAGCTTATAGTCAAAACCCTTAAATGGAGAAGTCTTTGGTTGTATATTTTTTGTTATTGTTCCTCTATGTCTAGTATTGAAACTCAGGATGGAAATTATGTTCACATTGCACTATTTTCCACTCACTTGATCAGTTTTCAGGAGATTGTCTACAGAACAGTTTAGGGCACATCTATGAACTTTCTAGAACATACATAAATGGATGATAGATATCATGCCAGTCCAGTTACCCACCGGGACAGTTGGTTTCTTCGTGCATAGCCTAAGCCCTCAGTCACTTAGATTGTAATGCACAAACTTTACATGCACACACACATGCACACACACACACACACACACACACATATACACATACATCAGCCATAAACACCCCGAATAAATAGCAAGGGAAAGTGAGGATATGCCAGACATCGGAGAAAGCAAATACTTCCTCAAAAAAAAAAATTCCTTCAATTCACGGTTGATAAACAGTGACCTAGAAGCATTTGCTGCTGTTGTGCCGTAGAGCTGTGTGAGGACAATCTCAGTGTCACTAAAATCCACATCTCTCCCGTATGTGAAATCAAACCTTTAAGTGTCAGGAGAGAGGCATTTATCTTGAATTCTTCCATGTCAAAGAGGGCGCCTGTGCTCATCCTCCTTGAACTCAAGCTCTTTGCTGATCTTAGAGCTACTTTCTTTAAAGGTCCAGTTGAGAACCTTGTACACTTAAAAGGCTGACCAGAGGCTGCTGACTGAATTTCCCTCTCCTTACTGTGAGTGAGACATTTTGAAAGCAGCAAGAACCCTACTTAGGATAATCAAAGGCATAGAAATCCCCATTGCCATTGCAATGCTGGTGACTGGCAAGTTCAGCTGGCCTATGGTTTTCCAGCCACTTGTCAGCAGCCACCCACCGGGTTCCCTAACACGTTGACATGTCTCAAGATGAGATATGTTCAGTTCTAGGACAATTTGCTAAGGCGCATGTGGGCAGAAAAGAAGCCCATTCCTCAGGAAAGCAGTCTATGTATTAAGCACAAGTGTAGGCCCCTGAAATGGAAATCTGACATTTTATCGTTCACCACTAAGCATCCTGTATTTTCCTGAGTGTTTCAAGGATGTCTTCCCATTGCTTTTGTATCTTTTGAAACTCAAATCTTTATTTTACTCTAAACATCAGATAAGACAGGAAACTGAGATAACTGCTGCATCCATGGTGGTAGTTGCCACTGCAAAGTCCACAAAACTAGAAACAGTCCCGGGAGCTCAAGAAGAAACTACCACACAACAAGATCAAATGCACCTAAGTTATGAAAAGGTGATGACTTCCTGCCAATGTGAAAGTCACTCTTGCACCATTTCATTTGCAAATCACCTACATTTTCATCATGGATCTTAATCATCACTTCTTCACTTCCACCTCTTCTTATAATGCAAATAGAAAATTTCTTTTCCCACACAGCTACCTTTCACTGTCAATTCATTCCTAACTTTCAGACTTTCTTTGGCTTGTTACTAATATAATATAATAATTCACTTTAATATCTTCCTATTGAAGCAGATGTCCGTAAACAAGTCAATTCATAATACAAAAAATTATGTGCTATTTACAGTGCTACTGAAATGTCTCAGAGATTGCAGTTTTAAAAAATGTGAAAAGTACAAAATAGCACTCATTAGTCTTTTATTGCTAATCACATTTTTTTCTTTTAAACTGGACTTATTGTTTTGATATTTTTGCCAGTGAAACAGTATGGATGATCAAAGTAACTCAAATGATATATTTTAGTGCAATTAAAATTTCCTTGAATAGGAAGAAATTTTGCCTCCTTTCTTTTTGACTTACGTTTCTTTTATTAAAGATTTATGGAATTTAATGACTATTTTCTTACTTTCTTTTGTATGATCAG
>TTN-201,,0,480,95245,95724,GTGAATACAGATATTTGAGCTGTGAAAAGTTCATCTTTAAACTAATTTCTAGTAAACTATTAACTACAATATGGTATGAATTATTAATCTGTATTTGCCTTTTAAAATCCCTAACTAAAAACAAAATGGTAAATATGAGACTGATTATCATTAATTTTATCTGCACATTTGATTTTCATCCATCTGTAACATTTATAATTCATTTTATTCACCATTATTCTTTGCATGAAGATTAGCATTTTTTAGCTTAATTTTTAAAAAGTGACACAGGGACTCATCTAGAGGTTTTTTAATAGCTAACATTTCTAAGTTTTGTGATTCTCAGTCAGTATATGTAGACATTGCCGGTGAAAGTTTATTTCTCTTGTGTATTTAACCCTGAATAACCATCTTGCATCCCCATGAGGAAGGGGGAAGGGTCATACTATGTGTGTTTGAAGCCCTGTTCAACTTAAATCTTGATTTTACTGTAATAATCAG
>TTN-201,,0,3218,95725,98942,GTGACTATTGTTGTTCCAAGTGTGAAATCCCCTATTATAATACATTAATACCACATATCATGTGAAATTCCTTATTGTAATACATTAATATCAAGTCTCTGAATTTCTTATGTATGAGTCACTATTAACCAAATTTATTTTTTAGACAATTAAATAATTGGAAACTAAAAAAATTTATTATTGTTAATATTACTACATATCCCTTTCTCCACTTATCTCTTCACCATTATTGTCAACATTTTATTAACATCTGGGAATCTTCCAGAAGTTGATTAAAATTGCATGCAGGCTAATTTTAAGAGGCCCATGAACATTTTTTAAAAACACGGAAGATGTATAAGTAAATGATGACTCTTACTCACTGTCAAGAAGATGTGTGTTTTGAAGGGTCATAAATTCAGTATATTATGTTATGGAGTATGACTTATTTCAGTAAATTACCCATAATTTTCTTTGTATGAAACTTTATCTTTTTTCCCTCCTGTAAATATCAGAGGAGAAGATAAGCTGAAAAAATTATAATGCATGCTGTAGCAGCTCCCACTAAAGCTAAACAAGATGCATATTAAAATCTAGAGAAGGAAGTATCCAAACAGAACAATTACACATAAGCCATGAAAAGATTACCGTATCTATTTGTAGCTATGAAATATCCATGAATTAAACTGTTTCCCATGACTCTGTCATTTACTCCAAATGAGCCATTTACCTAATTGTATTCTTTATTGCTAATATACCACTTGAAAATTAGCAACTAAAGTTTTTCCATTTCATTAGCAGGATGGCCTGAATCCTATTTGTATTTCCCTCAGTGTCATTTTCTGACTCTACATCTTTTTTTTCTAAGATATGATTTAAGATAAACTTTTTAAACCTTTACTCAAATCTAACATTTAATGGCATATCAGCCTTTCAGAAGTCTCATAAATGACAGAAATTCCACTATGCAACATACTTCATGAGTGATTAACTTTTTACTTTTGTTTCCATTCAAATTTTGTCATGAATTGACTATCTTGTTTTTGTTAAAAATTAGCTAAGGATGGAAGCTGAGAAAATGTTTATACCTGAAGTAGTAGTTACCACTGCAAAATCTGCTGAACCAGCCACACCGCCAATGACTAGAGAAGGATTCACTATTAAACAAAAACAAATACATCTTTTTCGAGAAGAGATGAAAACTGATGCTATGGAGGTGAAAAGTATTGTTTCATCCCATTTCATCATCAACTCTCATAACTTTTCATCCGTCGTGAATTGTGCTTCTAGTGTTCCATCTAATTGTTTAACTGATCAATAAAACAATAGAGATGGTTAGATTCAGTCCATCCTCCAGTTGAACAGTGAGCATTTCTAGTAGTGAAAAGTCAGACCAAATAATACTCTTCTTTATGTCTCCTAAATTTATTCTCAGCATTTAACTCGTATGAATTGGAGTATTCTAGTCCAATTTGTCTTCCTGCTTCTCTAGGTTACAAACATGTGAGAGATATCAAAGTCCACTAAGAAATAAAAGCGGTTACCAGCATACTCATTTGTAGTCCACCAATAAGTGTGTGTATATAAATCTGATATACAATAATTCAAGGAAAAAACAGACAGATGCTTCCTCAATTTAAAATATTTTACCATGATTAAGATTTTTCCATATGTTTAAAATCAAGAACAAAATTTAAATATTTCAGTTGTGTGATATTTAGTCATATGACAGTTTCTTTGACAGTTTCTTTTATCATTGTTAAAATAAAATTAAGACTTAAGCTGACTACTTCATAGCAGACTGGCTAAAAGGTTCAAATGAGATATAGTGGAAATGTGATCACACTACAATCAAAATAATATTTATTTATTTAGTGTTATCTGTCGAAGATGTTAACATTTTAAAATGTCTATACAATTAAAGTCAGCTCATTGCCAATATAGTTTTTAAAAAAGAAAAAAATAAATGGACAAACTTAACTCACCTAAGCCTCATGTGTATTTTATGTTTTTTTCTGAGATGATGCAATCTAAAGTGAAGATGGTATTTGCAGTCCTTCGAGGCAGATGAAATTGTTTGTGTCTTCCTAAAAGGAAGCCCTGGATAAAGCCCATGATCACTAAAGACCCAATTCCATCTCAGAAAAATCTCATTTATATCTTGAATGGTTCAGAGAATAATTTTTAAAGATATGCAGGTAGCATAGTTGAAGAATGTTTCTGATGCATTCTAGATTCTATTCACAGGTATAGAAAACTGAATATTAATAAAATTTTCCAATCTTACTTTTAAAATGCACTTTTAAAATGTACTTTTAAAATGAACATGGCTATGTGATTTTTGAGGTATGCTGTTTCCAAGTATCACATAGAATCATAATATCTAAGCCACATCAGCTAGTTTGCCTTCTTTAAAAGAGAACCTCCTCTGCAAATTGTATTTCCATTAATGTTCATCAGACTCAGAAACGAGAAAATAATATTTGTTTCATTCTTTGCTTTAACTCTCCATAATAATGAAAGTAAATTAAACTTCAATGTGAAAGGTTGTTCTCTTGAATCCAAACATGATAACACTTTCATTTTAATCACAATATTTTTATTTGCACGGGGTTCTCTTTGTCATCTGTGTGTTTTAAGAAAGGTATTTTCTGATAGATTAAACAATCTTACCCTTAGGGAATCATAAGTAAATTCATATGCTCACTCTGTGTTTGTGAGCTTTCATGTTATGTCCGATTTGCATGCAACCATATAACTCTGTAGTCACTGATTTTTCTGGACAGGATGATGACGGTATTTGAGTGCACTTATATCATCACTGTCACTGCATTAATACCAGACTAAATGGTCAACAAGATAATAAAAATAATCAGTGAAAAGAACCAGCTCCAAAATTCTGATTTTCCAATTGCTGATTGATTGTCTGCCTGGAAAAATTCTAGAAAATTTCAAAATCTTCTTGTGATTTTATGTTCATATTGTGATTGTCCTATGTTGTGTATATGTGATTTAATGTCTAGTATAATTAAGTAGGTGTACAGAGAGTATATCTAAATAGATGTCTGTACAATATAATAATCAATGAAATAGTCCCTAAAAGTGTTTCTGAGATACATTTCTAGACACGTTAACACTGCTGTATAATGTGGACGCCATCTGCCTGTCCTGATGCCCAGGAGATATTCCAGCCTGATCTCGATATTCCTATGTATTAATTCTGGAAACCTTGTCTCCAG
>TTN-201,,0,105,98943,99047,GTGAGTCTATACCTGCTGATTTTTCACCTTGTTCATGGTAAAGCAAGCCTCACTGCTGTGGTCATCTGGTGATCAATGGTATCACTGAGTTTCATTTCAATGCAG
>TTN-201,,0,1268,99048,100315,GTAAGAAGTTACAGAGCATGATACAGAAATGTTTAAAGGAAATAAGTATCTAACCTGTGAAACAGAGCATCTCTGGGGTAGGCCAATGGAGGATTCTTTTTTGGTGATGTGTGTGTGCGTGTGTTTGCATTCACAGTGGGCCCAGACACCCTAAAGATTTGGTTTCTGAAACTCGCCCAGGGGAGTGAGCCTAGAGTCACAAGTGGTTATCTTATACCTCTGAGGAGAGACAAATCCACACAGGCTTCTCTCTAGTTCACATTTCAGGGACAGCTCAAACTCAATTGTTTTGATTACTATTGTTCTAATGATTTTGTGAAAGGTAGTGTGTTACACAGCATAGTTTTACTTATGCTGTGAGACATTTCAGAGTAACTTAACTGTGAATGTGTTTCAATAATAAAGACAGACATTGAGAAATCATATATTTATATACTCAATATAGCAAGATGGAGAGGTGGTACTGTATGGTGGTCGGGTTGGATTGTGGAATCAAATAGCTCTGGATTAGTGCCCTATCTTCTCCCTTATAATCTCTGTCATCAGGAGAAAGTAAGCATACATGTAAAATGCAAGTAAAAAGGACATAAAAACCTGCAGTTGTCAGCATGTAATAAATCCTTGATATTAGTCACTATTGTTATTATACACATCCAAGAAATAGAACCCAAACCTTCTATGCCTTCAAAGAACTGTAAGTTACATATAATGCCTATATTTGATTTAGTCCCAAATTACAAAACAAATAACCATAGACCACAACAGAATAAAAGCAGTAAGGAAACCTTTAAAATATTTTTTCTGAATGTCTTCATGTTTACCTTTCACATAGATTTGTGGCTAAAACCCAAATGTACTATTGCAAAGTAGTTCTTAGGCATTTACCAACAATTTCAATAATTTCTTAATTTTGAATCTCCCACTGTGGTATTTTCAAAAGTGGCATTCATCGGAATGGTTAAGTGAAAATTCGTGACTAAGCTTTAGAAGATCCTGTCCTTTTATGATAAAAGCTGTAAAATAAGGAGTTCTGAATACAACTCTTTAAAAAAGATATTTTAAAATTTGTTTTACAAACTAACAGGCATGACAAGGAGCTTTATAATTGGCTTATCTCTAAATGACTTTTCATTAACTGTGTGATAATGAGTGCTAATGAGAACATTAAAGAACAGACCTTATAGAAAATAGGCTCAGACTCAGTCCAAGAGGGCTAGCCATCGGAGGATGGTTAAATGACTTTATTTTCTGACTCTGTTTCCATGTAG
>TTN-201,,0,284,100316,100599,GTTGGTCACTGGTTACCCGCTGTTACATGGTCCACTCCCATTGAGCAGGGCCAGGTGGTTGGCTAGTTTGTACTGAAAAGTAGCCAGTGGAGTCTTGCCTTTCTCCTTTGCCATACTAAGACTTGATTTTTATGGAGCATAGTATGGGTCAGAGATCATTTTCTCAAATTATTTTTATAATTATTTTTATATTTTTATAATTATATAATGTTGCATGAGCTAAGAGTTTATGAGATTTCCCTTAATTTCATGAGCATTTTGTAATATAATTTGTAAAAATCTAG
>TTN-201,,0,655,100600,101254,GTGAGTAAAGAAGTTGATAATGCTGGACCCTATTCATATCTCCTCAAATCATTTTAATACACGTTTGCAAAGATCAGTTTCTCAAATTAATACAAAAATGACATTAGTGAGCTTACAGATGCTCATTTTAAGACCGTATTTGGTCTGGAAGACCATATTTGACCATATTTGGCAAGGAAGAAGGGAATTCTATGTGGTACATCATTCATGGATTCAAAAGATTTAATGAGCTTCTAATATGCAGAAGGCATTATTGCAGGAGCTGTGCAGACATAAAGACCAATCCATCCCTCTTTGAAATATTTTCTTTGCCATCAGAGAAAATGTACACAAACAAGCATAATAAAATATATAAGGTGATAAACATCACAACAGAAGGAGAATCCATGGGAGGCATAGATTCATTCCAGTTGGTGATACCATGGCAAAGCTTTGTTGAATAGGTAGCATTTGCTATTGAGCCTTACAGCTCTTTACTAATATATTAGTATATTATATAAATATTAGTTTCTCTACTACTATTTCTGGAGTCCTGATTAAAAGGCCATTTTGTGGCAGTTGAAATGCATAAGTTCAAACTCTACATTTGTTACAAAACAGAAGTGATTAATGAATATGCACACGTATCATTATTTATTTTTTCTCCTCTCTTCAG
>TTN-201,,0,203,101255,101457,GTTAGTGGCCACCCTCCCACAGTCCTAATGCACATGCCATCACTTTCATCTGACACTCTTTTCCACAATATGGTTTCTGTGCACCTTGAAATGATGTCCCTTTTTGGAACTTGGGGGGAGATTATATGGTCAATTTAACTGTCAGTGCTAAGCAGGGGTCACTAAACATCTCATCTCAATGAGAAACTTTTGTCTTCTTTTAG
>TTN-201,,0,111,101458,101568,GTAAAATATTTTGCTAATTAGTAGCTGTTCTAGTACCATTTTGACTTTCAGCCCCACCAGTATTGGCAAATTGCAACCCGGAAGCTAATATGAGGGGAATTCTCTTTCCAG
>TTN-201,,0,948,101569,102516,GTATTTTGATGGCTGAATATAGAGTTCTCTGTGACTTGTATAATACGTGCATGAAGCCTAGAGTAGAATTTACTCACCCCACCGACCCTGAGCATAGGCTCTTTCATTGTGGAGCCTTCTTAGTTTGTTTTGAGGTATTTTTACATTTTTTTTGTGCAAAGTCTTCCTAAGAAATAAAGCTATGTGACAAAAGTGGATGGAAGATATATTTCTTTACATTATAGTTTAATTCATTGAGTTTGTGAAAGTAGAGAAAATATGGATTTTCACACAAACACACCCACACACACACACACACACACACACTTCCAGAAAAGATTTGAGACAATTTTCAATAAAAACATGTAATAACTAAGTGACTAAAAGATAGAAGAATAGCCATGTAATGAAGAAGAAAGCTAGTTATGCACAAAAATCTATGCTAGTAATTTTTCTTCAATTCAATATAAAATTTAGCTCTGAATATTTTGCAATTTAAGATAAAAAGAGCAACCTGGTAATCTAAAAATGTAGGTGCCGTACCTTCATAATAATAAATATAATGTACCAGAGAGTTAATACTGAAATATTTGAAGGAATTTATTGTTTTAATTATTCATTTGATCTCTGAATGAAATAATGAGAAAAATAACGAACAAAGAGAAAATACCTGTTGTTTAAGTGACCTGATCATTTGCTAACATAAACACTGAAAACCACTTAATTTCATGACTGATTCTAGCAATAAATATTCTTTAAAATGAATATTTTAACTTATTTGGCCCTAATTACTCATGTTCTTGCATTTTTCTCAATTTTCAGCAATCTTATAATCTATTGTGGAGCTTAGTCATATGTTTAGGGTCATTGAATTTTATACCACAGATCCACTCACAGATAAGTCCAATTATTTTACCCACAGAAGAGTTGTTGATAACTGATTTTTAAATTTTGTACATTTACATAAAG
>TTN-201,,0,915,102517,103431,GTAAGTGCAACTCCAGTTTCTATGTGCATGATAAGAACTGAAATACAAGGAGATAGCAGTGCTGTCCGTTTGCTGAAAAACCTGTTGCCACTTACTGGTTCTGATACTTTGCCCCAGTGTCTTTGCCTCAGTTGTATGGAAAATGTTTTAGACCACATGGCCTCAAAAACTATACTGTCATTAAACTTCTGAGGTTCTAGCAATAGTTTCTTTTTGTTGTATTTGTTTCTAGGCATATCATGCCTCTGAAAATGCAGAGATTCTAAATCCGGTTGCCTTCCAGGCCCAGGCAGGTAACAGTGAGCTCAATGAAAACAGTAGCAAACTGGAGAGTAGGTGCCCTGCCTCAAAGAGACAGTAGCTGTGTTGTTGCCAGGCATGCACCAGGCTGTTACCAGGCTCAGTGTTGCTAGAGCTCCTGATATCTTAAAGAAAACCTGGAAGTCAGGATTTTCAATGTTTATAACTTGAAAACAAATGTAACAGCTTTCATGCTAGACTGTTCACATTTACAGTGAACTGGCTCACACTCTGTTTCACTTGACCTACACAGTATCCCTTAGAGGAAATTACAATATTATCTTCATTTAGCAGATAAAGCACTCAATATTCAGGAAGGTAAATGAATTGTTAAAAGACACACAGCAAATTAGGAAGTCCTCCGTGGTAGATCCCCCCAAAACTGACTGCTAATATAAAATTCTTTCTACAATTGTAATGGCTGGTTGGATTTGTTAGTGTTAGTTTGGTTTCCAAATTCCATCTAGAAAATATTGAGCACTTCAATAGTAGATATTTGGAAAATTTGGTTTTTGGTTATCAACTTTCCCCAGTGTAGAGTTTACCTGAATGCATAGTGGTATGACTGTTTTCTAATAAGAGCATTAAAAATTAACTGATGTTCTTAACTCTTAG
>TTN-201,,0,537,103432,103968,GTGAGTATAAAAGTAATGACCAACCAAACAATTTCATAAATTATACTTTCCTTTTTTTATTTGATATTTTCATTTTCAAGTGATGAGCTCGGGGTTAGACAGCTATTAGAAGGTCCAAGTTCACTGTTGCTAAGTTTCCTTAATCTTCATGGTATGTTGCACCTGTGAGTTTAGAAATAGAGATTACATATAGGCCATAAATGTGACTTTAAAAATAGGGCTTATAATATATTAAGGAAAACACCAATATTAGCACAGCTGAGTTCATTCATGCCAAGATCTCTTCATCTGTGTGATAAGCTAATGTAACCTCTAACCCAAATCTAACTCCTGCTTTTGGAATACCTTTCTACCCAAGATGCCACAACATTCACTGGGAAAGATGACCATAATGCAGATTAAAACAAACAAACCAAAAAGTCCTCTAGATTCTTCTCCCAGCTAAAAACTTCAACAGTCTAGCTCAGATACATCTCCTTAAATAATTTATATCAGTAAGGATATGTATTTTTAACAGACCATAATCTTTTTGCATAG
>TTN-201,,0,110,103969,104078,GTAAAATATAAACATTTATCATAGCTCCTTGCCACAGTAAAGATACAAATTGGTTAAAATATAACTATTTGATGTAAATTTTATTCATACATGCATGGTATTCTTTGCAG
>TTN-201,,0,898,104079,104976,GTAAGACTTGTAATAATTTGGGTTATTTAGTATGTAAATTGTTTTCAAAACATCAAATAGTAGCAAATTGCTATTGTGTAAGAAGAAAATCGAGGGCTAAAATGGCACAGAAACTTACCATTGGCAACACCAACAATTGCCAGAAGTTTTTATTTCTTGCCCCTGTGTAAGATGAGCAAAGAATTTTCATCAGTGTAACATACTGTTTATTTTCCTAGTGCTATAGCTAATATCACAATAGCTCTTATTTGACACCTGATTTTTACATATGTAAATTTATACAACAGCCCTGCAATAAAAAGATGACTATTATTGGTTTGGAAATAGGAACACTGAGGCCCTGGGAATCTATGAAAATTGTCTTAATTCATCCAGCCTGTAAGCGGTGGTGCCAGCATTCAAACTCCAAGTCAGTCTGGCTGCAATGTGTAGATGGAGTCTTGTTTTGCTTTGTTTTGTTTCCAAATTCATTTCTATGTTTTCCTCCTCTGAGATAAAGAATGTGTATTTTTTATTTTTCCATAAATGTATTCATTGGTTTACTTATCCAACCAACATTTATTAGGATGTTTTAGTAGTTAAATCAAAAAAGTCTAGTGACTGATTAAATCCAAGTGGTAAGGAAAAGAGAGTATTGAGGATTATTCCAAGATTTTTGAGCCTGGGTACCTGGATATACTGAATGACTACCAGCTAAAATTGAGAATATAGGAAAAACATAGTTGTGGGGGCAACAATAATATATTCTATTTTAGATCTGAATGAGTTTGAGGTGCCTTCTAATACGTGCAAGAAGTAAATTCTAAAATAACATGAATAATGAATAAGACAAAATGAAGTTTGTTTTGCTGAGTTTTCTTTATGCCTCACGAAAGTATTGTGTGTCTTTGTTTTGCAG
>TTN-201,,0,119,104977,105095,GTAAGCGTGATAAGTTTTTGCTCATGAATCATAAAAACACAAAAACAAGCTTATGTATGCATCTAACAATTTTTAAAAACTATTTTAAAATCTACTTTCTTTTAAACATATTTTCACAG
>TTN-201,,0,102,105096,105197,GTAAAATGAGATAAAATAAAAATAAATGAATTTTCTTATCACTTGGGTTATAAACAGGTATTTCAGCCTTACTCCCTCTAAATCATGACCTTTCTCTTTCAG
>TTN-201,,0,99,105198,105296,GTAAGTATGGAAATAATAAAGCTAAGCTCATTATACAAATCCAATAACCAGGGAAGCTATACCACTATATTGATTATTCCCTCCCCCAACTTTTTATAG
>TTN-201,,0,153,105297,105449,GTAATTTGCATGTCTTTCCTTTGATGGACCTGTCTTTGTATTCAAGAATATCCATGAGTGTGTTTACTTTTATTTTCTTTCCCCATTCCTCAGGTTGAGAATTTAATTTAATATAATGTGCTCTCCCCTTTTTCCCCCACCTTTTTCTTGTAG
>TTN-201,,0,447,105450,105896,GTATTCAACAACGAAGGATTTCATTGTTTACCTAAGCTCTAAAGTCACCCTTAGCATGTGGTAAAATTAGCTATGCAATTTTTCTTTCATGAAACAATTATTTGGAAATTGACTATAAGTTTCATAGCCAGAATCATAAATTTATGTTCGTAATTAAGAATGTTAACAATTTGACCATTTGGATTTTTTAAAGTAGTATTATCTTGATTTTTAGCTTTTAAGTTTTTTATTGAAGCATAATTCTTTACTTTCAAAAATATTTAAAAATTAAAATAAAATAACTGCTTCTTATTGAAAATTTATCTCTCAGCCCATCAGCGGGTAGATATTAAGAATACACCTGATAGTATGGGGGAGATAAAAGACATACAAGACATCATCTCTATCCTAAGTCTAGATGCATACCTCTCCAAAAAAATTGATTTATCTTTCTGTTATACACTTCAG
>TTN-201,,0,96,105897,105992,GTAAGTCCTCCCATTCCTGTCAGCCTGCAGTGAGCATCATTATGGTTTATTGATAAAAAATGATCATAACATTCTTTTTCTCCCCATATTTCACAG
>TTN-201,,0,112,105993,106104,GTGAGTCCTAATTATAAAATTTTATGTTTACACTATTAAGCAACATAAAGAACTTCAAGGAGCAGACAATTTCAACAAAATTCATTCATCTTGTGTGTGTATGATTTTGCAG
>TTN-201,,0,92,106105,106196,GTAAGGATTATTCTACCTATCTAATAATTACTTTAAGCATTCTACTTTCCCAGTGTAACAATAACCAAGAGATTATTTTATTTTTTCCCCAG
>TTN-201,,0,1637,106197,107833,GTTGGTATATTTATTAACCTAAATTCTTACGAGGAGTGATTGTTATTTTAAGAAATTATTATTCATTTCCCCCAAAATTCCTTTCAGTTTCCCACTTCCATGCCTCTGCTTATGCTGTTCCCAAAGCCAATAGTACTTGCAACACCATTCCCACCAGCCTAAATTACAAATGTTCTTCTAGGCCTACCTCAAACGTCACCTTCTCCATTAAACCTTCCTTAATCTCTCCATTTGTATATGATCTCTTCCTCATCCAACCCCAGGATCACTTTATATGTGCCTCTTTCCTAGTGTTTATTATGCACTTGTCTTATTCCCCATTTCCTCTTTCAATATCAGTGTATAAACTCCTGAAATCTGGAATTCTATTTGTATATTCCAATATATTGCAAATGACAGATAATCAATTGGTGTTTGCTGTATTGAGCTTTATTTAAACTTCCTTACTCTAAAGAATTATTTCCTTTTTTAGCCATTCTTGCTTCTTTAGCCTTTGTGCCTTTTATTTTCTTCCTACTTTTTAATGAAATCAATAAATATTTTCAAAATACAGCTTAATGTAACTGTATTTCTTATGATATCATGTAGAAATAAGACCATCATTCAGTAGAATTTCTTAGCTTTACAATGAAGAATAAAAAATGTAAATCAATTGCCAGAAAAAACTAGAAGTCATCATTAATTTGTTTGGTTCATTACAGTTTAAATTTTGAGGAGTTGAGATGTTACATTCAGATCGTGTTGTCCATTACATCTAGTATTGAAGCAAGTCATATGGTAATGATTTGTCTTATTTGGTATGAAAGTTTCATGGTTTATACTTACTTACGTTATAAGATTTCTTCAGAGATCGGACCATGAAAAGACTTGTAAAACAAAATTTCAGATTCAGCATTTTTATACATTTAATATAAATTACATGTTTTAAATGTGTGGAAACAGGAATAAACTATGAACTCCTCTGTGATTTCACCCAGTGTTTTTAAAGTACCTACCATTGGTCAGACACTTGTAGAAACTCAGGACACAAAACTAAATAAGAAATGATTTTTTTCTTGAGAAATTCATAATTTAGAGAGGACAGATACATAAGCAACTAGCTTGTTAAAGCAGTAATTATTTCTGCTAATGGATGATAAGAGTGGAGGCAATGGGGTGAAACTTCATAGAATGGGCGACATTTGCCAACACAGTGATTTTTAATATATAGAAATCCTCAATGTAGTAGAAACATTGATGACTCGTACATTTTGTTTAGCAAATTTTTATGTAGTCAAAATATCAGATTCCCAGGAAATAATCATTAAAAGACCAAGTAAAATGCTTTTGAAGAAGAAGGAATTGGGTTAGAGACTATCCTGGTGGTATACTGTTCTAAGAATTTCCTATTAATTCAACAGTTATTTTTTCTTCACAAAACTTTTCTGATTCCAGTATTTCTCCTAATTATCAGTTATGCATACTTAGAATAAGGGATTTCTTTGGTACCTTCTCAATATGGGTAAAAACAATCATAGACATTTCATGATTTCAAAATCATGTTCTTAAATTTGATATTTTATATTTACTTCTGCAAAGATTTTCCCATTGTGTGAATATGTTTAAAGGACTCATACTGTACATCTCTTGTTCCAAAG
>TTN-201,,0,535,107834,108368,GCAAGTAACATAGGATTTGTCCTTTTCAAATCATATTACAATCTTGATCGTTATCGTTTTAAAAGACAAACGATATGGCCATTTTGGATACCATAAATTTTCATTTCATAAAGTCATTCTAGATCCTCTAAACCTTCCTGAGACACATTCCACAAGGTACAAAATTGCTTATCAAATGCGTTTATGCAAAAAAGCCATTTCTTAGGTTAAAGCTCTGTGAAACAGCTAAATCAGACACTGATTCTCCATTCGTCTTTCACCCTTCTCCAATCAGTCTATTATGCTGCTAATACATAGCTATGCAAACTTCATACTACTAAAGCATAGAAAAATCATTTCACGATGTACATGTCCAGTTGGATCCCAGGTTCCCCTAAATAATCTCAGGTGTTTTTTAAAACAGAGGTGCTGCATAACTGTAAAATGTTTGGTAGCCATTCTTTTGCAGGGTGAGTAAGCAATGATCTTGTTCAGGACTTCTTTTCCTTGATGATGTCATCTATATTTTCTAACCCAATCATAAATTTGTCTTTAG
>TTN-201,,0,91,108369,108459,GTAAGTTGATTTAGAAACACTTTTCAAGCAGTCAGCCCATGGTTACCATTAAGTTAACCCTATCACTGAATTGCTCCAATTTTCCTCTTAG
>TTN-201,,0,120,108460,108579,GTAAGTATCAGGCAGCCCCCTACAGCCCTTTCCTTAATGAACCCCATGTATCTATTTGTTTGGTTTCATCTACTTTTTAAACAAATTGTATTAACTGAAGTGCTCTTTGATTTTACCAAG
>TTN-201,,0,745,108580,109324,GTAAGTTAAAAAATATATATATATATATACACATATATATAAAATATCAAATATTCAGTAGATTCATTGATATTCTATATCCTACACTTTGCTGACCACTCAAAAATCCTTGATTGGGTGGGCAGGGTGGCTCAAGCCTGTAATCCCAGCACTTTGGGAGGCCAAGGCAGGAGAATCACTTGAGATCAAGATTTTGAGACCAGGCTGGGAAATACAATGAGATCCTGCCTCTAGCAAAGACAAAAGGAAAAAAAAAAATTAGCTGGGCATGGTGGCACACACTTGTAGTCCCAGCTACTCAGGAGGCTGAGGTGGGAAGATCGCTTGGGCCCAGAAGGCCAAGGCTGCAGTGAGCCACAATCACGGCACTGCACTGCAGCCTGGGCGACAAAGTGAGAACCTGCCTCAAAAAATAAAGAAAAAAAATTGTTAATTGAAACATCTAGTATGTGGTTACACTGAGTAAAGCACTAGTATCTCCACCTGGATAAAATGTTCCAGTTAGAGTAGCATTGAAAGGCTACCTGGAAAGATGCCTCAGTGTCTATCACTTGATCTTTCTGTTCCTCTGTGAGTTGGCACTGTCCTGTATAGTACATGGAAGGTATCAAAGCTTATATCTCTAAACTGTAATCTCCTCAACAGACGCACTAAAAACATTCCAAATTTTTATTCTGCACCTGTTATAACCCACATCATATTTACGTAAAGTCTCCTTGGGTGTTTTTTCTTTTCTCCTTTGCAG
>TTN-201,,0,517,109325,109841,GTATGGTTTCATACATATTAGATCCATAGAAAAAATGTCATACATGCTTTATAAAATTTAGTGTATCAATTAATGAATGGATAAATAAAATGTGGGATAGCCATACGATGGGATATCATTCAGCAATAAAAAGGAAGCACTACGATATGCTACAACATGGATGAACCTTTAAAACTTTATGCTAAGTGAAAGAAGCCAGAGACCATACAAAGACCACATATTGTATGATTCCATTTATATGAAATGTCCAAGATACACAAATCTATAGAGATGTAGATTGGTGGTTGCTTAGGTCTACAGGGGAGACAATAGAAAAGTCCTTGGGGTGATGGCTAAGGGTTACATGATTTCTTCTTGGGGAATGAGAATGTTCTAAAATTATGGTGATGGCTACACAATGATGAATACATGGAAATTCATTGAATTGTATACTTTAAATTGGTGGATTGTACAGTATGTGAATTATATCTCAATAAAGCTGTTAAAAATGTTAATTTTTCTACATGCTATTTTCCAG
>TTN-201,,0,89,109842,109930,GTCAGTTGTTTTGTCTTGCTACATTCCAGTAATTCCCAGTTTCCTCTGAATCACCATACGGTAAACTCGAATTTCCATTTCATCCATAG
>TTN-201,,0,1146,109931,111076,GTATTGTCTACATACTAAATGTTTTGAAAAATCATCAGTAGTCCATAATCTATCATTTTATATTTTAATGTTTCCCTTTTACATTTTCTAACCACCATCCTTTAAAGAATTAAATCAGCTCATTCTTACTTGGCTTAGACTCTCTTATGCTGACCTCAATTTAGTCACAGTTTCCACTCAGGGAATAAGGGTGTCCCTAGCAGCTGTCTAAATACGTTAATTAAAGCAGCTGTAGAAATTTCACTGTCTAATAAATGGCTGCTTGCCAAGCAGCACCAACCAGAAAAGAATTAAAATGTAAATCGTGAGGTTCACACATCAATTAGAATTAAGGAAATTTAGAACAAGGTGATATTTTCTCAGAAGGTTTCTATCTGTGGAGAGGCAAGTGTCAAGGAACTTAGTGGCTAGAAATACTTTCTGTGAAGTCTAAGAGAAAGCCCTGTCCAAGCCGTGCTGGGTTCCTGGCAAGGATGCTGGGCACTCTTGCTGTCGGCTGCATTTACAGAGCTTGTCCTCATAAGTGTCCACCATCCCAAATGATATAATGGAGGAAACATGTCTAGAGAAATACCAGTTGAGTTCAGCTTTATCATATTGCTCATCCAAAGAAAACCAGGCTTTACAGACTGTGGACTATAATGAAAAAGGCTTCAATGAGGACTCAGATAACCTGGAGATGTCTTCCATCATTTATTTGCCAATTCTGAACCTCAGTGTTCTCACTCTTAAAATGAGGATAATAATTCCTACCTAGCCCACAAAGTTATTATTCATATAAAATGAAATCAAATTAAGTAATAACTTTTTAGACAATAAAAAGCCCCCAAAGGTAAAGCATCATTATATCCCTTATTAGTAAATAAGAAGCAAACATTTAAGGATGAAATAATTGTCTCTTTGGGGCAGCTCCTTTCCTCCATGCAGCTGTAAACACAATTCTCTACAAGAGAAGTTTATGTACCATTTGTCCAATACTAGGCAGGAAAAATTAGAGAGTGCTATAATCAGCCAACTTATTACATTATAATATATTGGTTTCACATGCCATTCATTGACCAGTTTTAGAAATTGATTAACTGGGAGGAAACCAGAGCTTCAAGTTTTTGTTGTTGTTGTTGTTTTTTTATGTTGTTCCATCAACAG
>TTN-201,,0,1569,111077,112645,GTATGTAGGGACAGATTTCAGCATATTTTGTGGATCCATCAGAAATAATCCTCCTGTTTAAGTCACTAAATTCTTGTAACTTGAAGGAAATTTCTAAAGAACCTATGGTATTCATGTGGTTCCAGCTACATTTTTTTTCACATTATATCTATGGAAAAGGGAGGGCAGCTGTTAAAAGACCTATTGAGAAGTTATTTTCAGAAAGCACCTGATGGCCAGATCCTCATCTGGTTGCTCAAAACTATTGAACACCCATTGGGTGTCCATTTTCATATACCCCAGATGAGCTTCTAGATTCGCTGTTAAACTATTTTAGTTCTCTGCCCTCTGCCTGAACTGCTCAAGTCCTAGCAGCACTACCAAGTGAAAGGGGTGTTTCCAGCCTCTGATATGGAGTGCCTGGGAGAACTCAAAAGTCCTCTTTGAGACCCTGGAAGGCCTAGAGAGCCTCAGGCAATGTGGAACTCGATCCTCTCTACCCCAAGCTCTAAGAACAGGGGCTCTTACTTTGGACAGGGAATTCCACATGCTACCAAGCACTCCTGAGGAGCCTCTGAGCAGTCCCCAGGGAAGTGCTGTTAAACCTCTGCTCTCCTCATTAGAAATCTTAAGGCTGAATCTCAAGCTGACCTTGTTTTGAGTCTAACCTAGATGCAAGAGAAAAATGGAACCTCCCTTCCTATTCTCATCCTAGGCCATATCTCTTTGAATAAAATACCCCTGAGGCAGATGCAGGAACTCCAGGGGTAATCTCAAGATTCACAAAGATGAACCATATCGCCAGCATTCCCTAGGTTCCTAGAAGACCAAATGGTCATGGCATCCAGTTCTTATTATCTCTGTATTAGTAGTGGAGAAACTGAGGCACAGAAAAGTAAAGATCTTTTCTATGATAGTGTCAGAAACCAGCCTCACAGAAGTCATTTCTTCTAATTTCTGGGTTCCATGAACTAACCAGGTCCCCTCACTCATCACAGCACTGAGAATATGCTTTAGTTAGCAAAACAGGAAAGCTGAATTTGTTAAGTCTACCTAATGGCATTTAACTAGATCTGAAATAGTGTTAATTCAGTCATTCATTCAATACTTACTGATTGCATTTTACTGGCACTGGTACATAACAAAATGACTATGACATAAACACAAATACTTGCAAAACAAACAAACTGGAATGATATGAGCCTCTTCACCACATGATTTGTCCAAATGAATTTTAAAAATAGGTAGCACACGGAAGTTATTGTATAATTCATTCAGGTGTCCATCGCTAAGCCCCCACCACAAACAGAAACTGGGATAATCAGGTTAACTCGGCACTCTCAGCATGCCCCCCAAATATCAAAAATATCTTTCTGAAGCTATTCCCTCTGCATGTGGACAAATTCCAAGTGCTTTCTTCATTCTTAGCACAAAGAATGTTCTAATATTCTGAGGCAAGTAAAAATACCACAATTCCAAAATTTTGTCTCTGGATGTATAACTAGCCAGCAACAAATTAATGTAGAGTTTTGCATGCTCTCTTGTGTTTTTACACTTTTTCATGGGCTATTTGTCAACATTTACTCCTAG
>TTN-201,,0,224,112646,112869,GTAGGAATGCCTCGCTACTTCCAGCTGAAAATAAAACCTAAGAAGCAGGCTTTTGTCCTTTCCCAGTGCATTTAAAAATACAATTTGGAGCTCATAAAAGTAGATTGCTACCCAACTTTGAAAGCACTCTGCAGTGAAATAAATTAAGATAAACCTACATGCTCCCTTCTGTGAGGTCTCTATGGTGACTTAATCATGACAAATCTTGTGGTTTCTTTCTTTAG
>TTN-201,,0,5004,112870,117873,GTAGGTTTAAGAACAAAAGGTGTCATTGCCAATACTTACAAATAATTACATGGGAAAAACATTCTGTCAGCTTCTCCTCCATCACAAACATCTCTCATGCATAATTTGAAGCTTAATGGAAATCTAACAGAAAACTTATTTCAATTATTAAATTAAGAATTAGATAAGTGTTTTTCACTATTTTGTGCCCTTAATAATGGTTGTTTATGTTATGTTATGTGTTCTTTATCACAATAAAAAAATTAGTGTTTTTCACTAATATTAAAAAAGGTCATGTTCCCTTTATGATTGTAGCTGCACTTTAATTTCTTCATTGATAAAATACAATGACAAAACTAAAATTATTAGATTATAATAGCATCTACATATAATTCAAAAGAATAATACATTTATATAAGACATTATTCAGTCTATGGACAATGCTTGTGTGAAAGGTATCCTTTGGAAGACAATATCCTATAGTGGTCAAAAGTCGGGGCTTCATTGTCAAAGATGCTGAATTTGAATCTTGCCTTCAATATATATCATGTCTCTCGTTCTCCTTCTGTCATGAATACATTGAGTATATGATTGCATTCAATCCTAGAAAATATATTTTATGAGGCTAGGAATTCCGTTTTAGTGCCTAGAATTTGGCATCTGAAAAATAGTACCTGCTAGAAGGTAAGCTCTATGAAAACAAGAGTGGATGGTTGCCCCAGAATATCACCTGATACATAGTAGATACTCCATAAGTAATTGTTGACTGGACTAATTAATGATGGTTAAATGACTGTTACCAAACACTTAAGATTATTATCAAGATTAAGTTAGGTAACTCAAGTCAGCACATAGCACAGTGCTCATCATACAGTAATCAATCAGAGTTAGCTGCTACCATTTTTAATTGGGGCATGCTTCTCAAGTACCACCAGCCAATTTCCTCATCCCAGGAATCTGATCTTGGTAGAATGAGACAATATATGTGGAACCACTTCAAGTCATAACTGATTGTCTATAATCACAATTATTTGAGAGTTTCCCAGCCAAAGGGAAACTCTCAAAGCTTGGGCATCTCCCAGCCCTCTTATTAGGCTGATGCAAAAGTAATTGCAAAGTTGTATTGTTTTGTTTATTATGCTTCTCCCATTAGTTTATAATCCAATCTCTACCTTGTCAAGATTTATTTTTCTCAACAGGTTAGTACTTCAGTTGGTCTTCTGACCCAATTATTTCCTCCTCAGGAATGGAGATGGTGATCTAGAAATCTAATAGACCTATTTGATTTTATGAGCATAATTAAAAGATATAATGTATGTAAAGCACCTATAGGCATGGCTGCCAGGTAACTGGGGCTCAATACATTCATTTTATTATAGCCATAGAGAGGAATTATATAAACATCAATGTTTAGTATTGTATGGCCAGTATGGACAAATACCATAGACTGTATATTTGAGGGATAGTGTTCAAGAAATGCTAAATATTAATAAATGAGGACTGATTTGATAATATCCTACTAACACAATAATACAAAATATATTTTAAAAGCAAGTTCATTAAAGCTACACTAAATAATTTATCCATTTATTTAATTTTTAGAGGAATTTTTTAATATAAACATATATGTACATCATTCAAAGTAGTAATATTTGTCTTAACTATATTGGTATAGTGCTTTTAAGTCTATAACATATTAACATATGGTAGTATTGCCTTTAAAGTGTTGTAGAAATACACCTGAAGCACTCTACAAGACACCAATTGGGGTAGAAAGAGAAAAATTTCACTATCTTTTCTGCATAACCAATGTCTTTAAAAAGGTTTGAATAGGCTTTGTAAACTGAGAAGATCATTAACTTCCTATGTGTGGTAATATCTGTACACATATAGTGGTTTTAGCATCCTCTTATAAATTTGTTTTCTATATGAAAGAAATTAAATTCATTAAATAGAATGACCCTTCAAAAACTTGCCAACTCACATAGTTTCATACCACTGGGACTAAAAATATTTACAGAACTTCCTCTGGCCAGGTATTGCCTTAAGTAAGTGTAGCCCTGCTTTCCACAAATTGGAAAGAAATTGGGAGTCTTCAGAAGCTCCCATGTTCTTGGGGGTTGTAATACTTTCTGAAGCATGAAACGTGGCCCTGAGCAACCAGGTGCTGTTTCTAACAGCGAAAATGTTACCTATTGAAGGTCTCCAGTGCCACCTACTGGTAGAGGAGTAATTTGGAAAAGCAGAATCTTAAAATGTAAAAAAGCTATTTTTTTGCTGTTTATTCTACAGATGATGAGTCAGTGTCATTTGGAGGCTTACAGAGTGACAGCTAGCTAAACAGAAATGATGAATAATTAGTTTAACAATGATATTGTCTGTTATTCATTTAAGCATCTGTGCAATTTTAATTCTACCATTTATTGTTTCCCTGCTATTGAGATATTACCCTAGGTGCTGGGGTGCAGATCTTGCTCTTGCCTTTAAGGAGCTTGACATGTAGGTGAGGAGATGCATGCACACAACTATATCCCAAGGTTGTAAGTGCTATTAACAGGCCCACGTACTCATCATTCTCTGTCTGGGAGAGAGCCAGAGAAAGATGTGTGAACTGAGCATTGAAAAATATGTAGGATCATTGAACACAGTGGCATCCTATGATGAGAAAACAACATCTCCAAGTCATCAAAACTTGCAATAATGCTTCATGTGCTAGAAGCAAGTGGTTTAAGTACAGTTGGAAAGTGATATCATGAGTGGGTAAGAAGGCTGGATAATACAGCAAAGGCCGTGCTAAAGTTTTTGGTATTCTATGCTGAAGATTTTGGAATTGATCTTGTTTACATTTAGGAGACACTGCAGGATTTTTAAGCCCCTGGGTACCATGATCAGGTTTACTTTTTAGAAGTGATACTGTGATAGGGAAAGAAGGGATGGACAGATGTGGGAGGCAAGACTGGCAGTCAGGAACTGGAGAGAGATTATTACAATAGGCCTGGAGAGCGTGGATGAGGCCCTCAGCCAGGGCAGTCAGGAGAGACAAGTGGGGTATTGCAGAAGTAGTAATATGGGAGAAGAATGGCCTCAAAGAAGACACGAGAGGCTAATGAGTAACGCAGATCATGGCATCACAGCCACAAGCACCAAGTCCACTACCAAGAAAAGTTTTACCTGTTAACTCACTTATTGTGTGCAGTTCATGTCCAGTGGCAGTTCATGTGTATCCTGGTGCCTCATTCAGTTCACCAAAGGAAGAAGCTGTCAGTAGAAATAAGCAGAGAACCTTGTAAGAGGATGTACCATTGATGATCTCACACACACACACACACACACACACACACACACACACCCCTTCACACAAACTAAATAGGGGTGGTGTTTCATGTTATATCACATGGCACTGTCTTTTGGCGTGTTATTGAAGACAACGTTGCTTCCATCTGTGATGTTAGATATTCTTGCTATAATGACTGACTTGTGCCAGTGGCTTATAAAGCCCTTCCATGTGTGTTATATCATTTAATTCTCACAGCAATTATATGCAACGAATAGCCCATAAATTATTACGCATGCCATTTTACAAATGAAAAGACTAATCCAGAAAGCTTAAATGACATTTCCAAGGCCACACAGCTGACAAGTTGTAGTGTCAAGATTTCATTTTCTTTATATGTATATATTTTGATGGAGTCTTGCTCTGTCACCAGGCTGGAGATCTCGGCTCACTGCAACCTCCCCCTCCCGGGTTCAAGCTATTCTCCTGCCTGAGCCTCCTGAATAGCTGGGATTATAGGTGTGTGCCACCACACCTGGCTAATTTTTGTATTTTCAGGAGAGACTAGGTTTCACCACGTTCGTCAGGCTGTTCTCGAACTCCTGACCTCGTGATCTGCCCGCCTCAGCCTCCCAAAGTGCTGGGATTACAGGTGTGAAGCACCGCGCCTGGCCAGGATTTCATCTTCTACTTTACCTTACTATCTAAGGAACTGAACAGATTTGTTACTCTAAGAGGAGAACCTGCCATTTATACACATCTACCATCATGGGCAGGAGAGTAACTTTTATAGACAAGTATTGGCATTAAAATGCAGACAAATGCTAGATGATTGGACTATTAGAAGATCATCTTGGATGGTTTTGAGACCAAGAAGTGGTATAGTGACTGTGCTCCAAAAACAAGATGGCTTTGATTTTGGCTATTCAAACAGTTAACTAAAATTAAAGTGCATATCACCTACAATTATTACAACACAATAACCTGCTACTTTACTGTAATTTGGGTTTTTACTTTCTATTATTTTAAGATGGTTCAAATCCTTATATAGAAATAGCTAGCTTTATTATAATGTCTTATAACTGCCACTCTGAAAAGAGTCAAATGTATCTAAGATGCTCAAATACCATAATAAATCACCCTCTTTATTTAAAAAATTATTTTCTCTACAATTATTTGTGCCATATATACTGCGTACTGAAACCTTTTGCTCATTAGTAACAAAGATAGAGATTTTTTTTCTACAGCCTTCAAAGGTATCTATTTTAGACTTTTCATATCTTGATCTTCTCAGCTCTCTTTTTGATTGATTTTTCTGCAAACCAAAAGTGGAGATTTTTCTCATTTCCTGTCCCAGAAGGCAACTACAAGCCCAGATCAAACCTTTCCTGATGACTCTTCTTAGGACTGTCTTTTTCTCAAAGTCACTGAATATGTCAAAATCTTGTCTCTGCTTCCACTGCATGACATGCAAATGTCTAAAGAGAATGTAACTGAAGTTCTATCATTTTAAACATTACAACCAGTTCAACCTTAGGACAAGCTATATTTTTCTATCATTACATTTCCTTCTTGAAGATGAAAGGAAATCATTTAACAATAGTAGATATGGCATGCCCAGAGAAAAGTATCATGTTATTAAGTCAAATATGAAATGTAGGCACTAGTATTATTAACATTGTGTTTGCAGGTAAATTGTAAAAATCCACTCATTTTTGTGGTTGAAGTATCTCTTTTCTTTTGTGTCGCAG
>TTN-201,,0,2186,117874,120059,GTAAAGTAAAACAACTTTCAGAACCCCATTTAAATATAGATCGAATCTTAACAATGTCTGTAACAATTACTCAAGAGTTCATGTAAATCATTGTTGTTCCTACCATTCTCTTCTAATTCAACTAATTATTTCCCTGTTATATGCCATGGTCTCGCCTCTCCTTTACCACTTTTCATTGTGAATCATAGACCATCACGTTTCATTTGGCCCCGCTTTTTCTCTGTAACAATTTGTAATGTATTGCTGCTGTCACCAGCTGTCATGCTTCCTAATCAGCATGAATCAGAAGGGGGCGAAATATGCTGCATAAATAGGTAGATTTGTTTTCTCAATTGGCTAAGATAAAAATTAAATTTTAAAAACATCTAAGAGTGTTATCATCCTCCTATCATGCTGACACAATTTTGATTTCACAAAAGCTAGACCGTTTCAGGTCTGTACACCAGCGAGCTATATTCATCCTCCTCTCAAGAATGTCTTAGTGTTAAGAAGTCCAGTCCTAAAGTGGTTTAACATTTCTGTTAGTTGGGGCTCTTAAATTGTAATCAGAAACACTTCCTCAGTAACATGGGGAATTTGATTCAAACAAGGATAGCATTTTTATATAGTGGTACTATTTTTCCTGAGCAAATATAGTCTATGTAGTATTAAGTACATACAAATACATAAGGATTTAGAGAAACTATTTTTTTCTTAACCTTATGCATTAACTGTAACTAGATGTTTTTTTAAATAATGAATTTAAAGTGGTTTAAAATTAAAAAGTTGACTTTACAACAAGAGGAAGAAAGAAAAGAATATCCAAAACCCTGTTGGGTACTCCACTATTGCCTTCATGAACAATGTAGTGAAGTTCCTTAGCCCATTCATGTCTCAGCTTGCTTCTCTGGGAAATGGAAGTGAACTTGTGTGACTTCGAGTCAATAGTGACATACAAGGACAAGGCAGTAGGAGTGGACTGAATTCTAGTCCATTATTGAAATTTGTGACAAATCTGTAGACAACTCCAAATGAGTTCTGGTTTCAGTGCAAGGTAAGACATTAAAAATTGGTATGCTTCTTTTCAGGATTTAGCAAATTTGAAGAAAATACATCAAACTCCCAATGGCATGTCTCTTTATCAGTTTCATTTAAGAAGGAGCCCCTTGGCCAAAAGCCCAGCTTCATCCAGCCTCTGTCAAGCCTCAGGGTGCACAACGGGGAGACAGTCAGATTTCATGCGAGGGTTTCTGGCATTCCCAAGCCAGAAATCCAATGGTTTCATAACCAGCAGCTAATTCTACCAACAAAAGATGTAGTTTTCCATTTTGAGGAGTCCACAGGCATGGCTTTAATGCTTATAGTTGATGCTTACTCAGAGCATGCTGGGCAGTACTCTTGCAAAGCAGCCAATAGTGCTGGGGAAGCCACTTGTGCAGCTACACTCACAGTGACTCCAAAAGGTAAAGCCCATCTTGCTTCAAGGACTTTGATTTGCTGTATACCTCTCAGTCCCACTGTTACTAATGAGAGTCTCTGCTGTTTGTTTTATTGCATACTGTGGTCAGTCCATAACTTACTAATAAAATAACATGCAATAACTCCCGCTAGGTCCTCAATTATGGGTTAACCTACATACTTTAAATTTCACTGAAGTATGTGTTCTATGCACTAGAGAACCAATAATTATTTTATTAGGCACCACCTTTGCTTGGCTTCTTTACTCTTCTAAGCAATATTGTATCATTGCATCATTAAATGATCTATTTGCTGATTATTACTTACTGTACTTAAAGTAAGTACAGTATTACTTACTGTACTTAAAGTAAGTACAGTATTACTTACTGTACTTAAAGCATACAGTGGACGGAGAGCAAATGCTAACCCAAATACAGTCAGCTAGAGGGAGAGAGAGAAAGACAGACTGGGTCACTTTGGATAGCTGAAATGACAACAGAAAGAAGGAACCAGATACTGCATGGCATCTGCATGAGTCTTCATCAACCACTCAGCACTGAATCACCAGGAATGAATTTTCTTTTGTGTGATCCTGACATCTAGATCATATTGCATCTGGCATGCTGCTTTCAAGTGACAACTACGTCTTTCATCTTCATCTTCCATGCCATTTTGTGTTACTAACATGGGCAAGTGACAAAGCTTAGATCTTAATATTCTTTTCTTTTTCTTGTCACTTGATTATACAG
>TTN-201,,0,3041,120060,123100,GTTAATTGATTTTTAGCTATGACTTGCTTCATTTCATCCTCATCGCTTTATGCAGCTTTTCTGCCATGCAAATTCAATCGACGAATATATTAATTAGAATATCTCTAAATTAGCACCCTATTCATAAGTGACTTCTGAAAGTCAGCCAAGTCATTGGCCATGATTATCCTGAAAATTTAACTTACCAGTCTAGATTCAGAAAGTTTAATTTTTAAACGTAGGTTCGGGAAGCAAAGGTTTATTTCCTATGTGCTGCATTTTCTAATATTTACCAACGCACTACCAAGAAAGTGTAGCAAAGTTAAAATGTTGTATTCTGAGAAGTACTTATTGGGTATTTATTATTGTGCCAGATACTGTGGTAAATTTCAGTTTAATTGTTTTAATAGCAAGAGGTTCAACAATTCTTATCTCCTCTTTATTTTCACATCTGGAGGTTCTAGTTGTTTACAAAGGGGCCATGAAAATAGAAAATTGGGACCAAGTACAGTGACTCATGCCTGTAATCCCAGCACTTTGGGAGGCCGAGGCAGCCAGATCACTTGAGGTCAGGAGTTTGAGACCAGCCTGGCTAATATGGTGAAACCCCATCTCTACTAAAAATACAAAAATTAGCCAGGCATGTTGGATGTTGGTGCATGCCTGTAATCCCAACTACTCAGGAGGCTGAGGCCAGGAGAATCGCTTGAACCCAGGAGGCAGAGGTTGCAGTGAGCCGAAATAGGGTCACTGTACTCCAGCCTGGGCAACAGAACTAGACTCCATCTCCAAAAAAGAAAAATAGAAAATTGAAAATTGGGCACTGAAAATAACAAAGCTCTCTCTGGACCAAAATTAGAAGTCTCTAGATATTTCTCCATAAATGATGCTGCTTTTACAGGCTTAAAATCCTCCTGGAATTGTATAATTTTCTCATGGCAAGATCACAATTTTTGTCGTTATTGGGCTTGATTCTCCATTATGTCTGGAAGAGCAGGAATAAACTTGTCTGGGCAAGTAATAACTTCTTCCTCTTATCCATGGACTTTCCTTTTGGATATTAATGAAATGAGAAAAATATTTTTCAGGTGCCATAAGCCTGTGTTGTGTGCCCGTAGTCAAAACAGCTTCACTGAGTCTCATGGAAGGAAGCTGGTGGAATAAATTCAGGCATCTCCAGGGGTCTGTGGAAAGCTCTGGCCTCAAGTTCCTCCCTGATCCTGGCCATAGTGGTGTTAGGGATGAAAAGGGGGCAATGCAGTGCTATGTAGGTGCACAGCCATCTCTGCACAGAATTTTGAAACAGTGGCCTTTCTTCCTACCCAGTACAGAGAATACAGTTTATTGATTCATATAATGTATCCGCAACACCTACTCACCAAAAAGAGGTCTTATTCTTTCTTAATGAGATTTTGTTCTATAGCTATCTCTCATTCTGTCACCGTAGCCTACAAAGGCAATATCTCAAGAACTGAGGTCTAGTTATGTAAATTAGATAGAAAATTCCACCAGCCAGAGAGTTGACCCTCAATTTCACTACAGCTGCTGGCTAGCACAGTAATCACACAGAGTCACTATTTATTTGGAGGTGTTGTCTACAAGTCCTGTAGGTGACAGTGTGACAATTTTTTCAGTAATGTAATTGGGAGTTGGCTGTGTTGTGAAGGTGGGAGAAATGTAGATCTCTTAACTCACTTCCTAAAGAATCTAGTGCTATAGTGCGGTGTTTGACTGTCATATTCCCAGAATTGATTTGAACTCGGCTCTTTTGCCCTAGGATCTCCAGTTCATTCAGTTCCAATTGATAATATTATTAAAGTGTTCTTGAAGCAAAAGAATTTTTTTGAACATCCAACTGCCTTACTTGTACCTAAGAAAGTTGAAAGATAAGACATTTTTAGATGTTTGAAGAGTGAAAGATCAGGCACAGTTGTCTAATTATTTGACATAGGCCAGTCTTTATATGTTCCTTTTTTATTTTGGCTTAATAAGTTCATATAGGCTACAGAGTTATCCACCAAGATCAAGTAGGAATGTCAAACCCCTGGAAGTCTTTTTGAATACAGTTATTATGTGCATAATAAACATAAACATATCATATATAAGTTTCATGACTAACATGCTGCCTTTCCTTCTCATCCTAATGACATTCCATCTTCTCCACATTCAGCATGTTTTTCATTCTTACAAACACAGCTAATTTATGCCTTTCCCTAACTTTATTCTTACCTAGCAAAAGAATCGCAAGCCAGAGCACTTACAAAAATTACTCTGGGTTCTGACACTAAAAGTATTAAAACACTCAGAGAGTCACAAATTAAAACAACCCGTGAAGTAAAAAGAGAATCGTCAAAGAAAACATCAAGTTTGTCATTAACTTCATGCCAAAAACCGTAAGAAACTGAGAACAAGGGAATAAAGTCTACTGACAGGATACCACGTGGACTGAAGACTGAGAGTGATACGAGAGCCCCAGCCTTTCCCAAGGAGCTGCCCTAGATATGACTGTGTCTAAAAGCTGTGCATATTCCTTGTGGAATAAAAACAGTTTTGATAAGTCTTTGTTTTGTTTCTTAATATGTAATTTGGACTTCATGTAGTTCAAAGTTTGAAAGGTGATTCAAATCAAAGGAGTGTTTACTAGCAGGAAAAACTGAGAATAGCCCTCTGCTAAAGTAGCAATTTAGAAAATGCATGTTCTTTCTAAATGTGATTTCATCTCTTAGCAAGTGTTTAGTCAATAGGACATTTTTTAGAAAATAATATTCCTTCGGTTTGTAGATTGCTTTCTGCATGCATGTAAAGGCATGGGGAATTATAGAACTAAAAGTGGAAATTTCATGAAGAACCTAAAATAAAAATGTTTTAAATCTTTCTGTCAACATTGTCATGTGTTTTATCAGCTCAATAGTTTGTTTGGCATGGACTTTTTGGTAAATTTGGGGAATGTAGTTTTCTGTTGTTATAATAAAAAGAAAACTTTAATCATACAAGTCATGAATTGATGCAGAAAATATATGCAATTAATCACTAAAATCTCTTTATATGTTTTTCTATTTTAG
>TTN-201,,0,11202,123101,134302,GTATTGTTATAATGGATGTGAGATTTAAGTAGAAATTCTAAAGGATTAATAGGATCCTTGAGTTGCCTTCTTTCTCTTAGTATTATTGAGAAAAAAATGACATAGATATACAAATATATCTCTTAGAGTATATATTACTATGTCGCATGCTTGGTTTAGAATTTTGATGGTTACATGCATTTCACAGTAATTTATTGTAAGTTAATTTAAAATTTTGTATTTAAAATTTATCAGCCAAATTCAACTTTATGTTTGCAGTCATTTCCAAAAGTGTATATTAGGAGAAGTTGTCATCTTAATGCATGAAATCATGAAGTAGAAGTTTGTTTTCAAAATCACGGTGAATTACATTGAAAATAGACAATAACCTAGCTGTCATTCTCAGAATGCAATGTCATGAATGAATTATGATTGAAATGCTACTTTACTGAGGTTGTGTGAAAACATTACATTCCCATCTGGTTTACACTTCATTCACATATATCATTTTAACATTGATATGTCTCTTACACTGGCTTGCAGATAGCTGCCTTATGTGATCCTTATTGCCTGCTTTTCTTTGCATAACATTGTGACTTTATGGCTGTATTAGTTCGAATAAACGCCTTCTCATTTTATTTTAGCTAATTATTTATGGTTATAGTTCTTGTATATACTCTTTAAATAGTTGATTCTCAAAAATATAATAATTTAATCTACAATCAAAAGAATCAGAAAGGGCGTTTATTCCACTCTCTGCAAGTCAGGTAAGATTTTCCACTTAGCCATCAAAAGAACAAAGTTTTCCTGCTCTCAAAACAAATATGCACAGGAACATGTTATTTTGAAATGCATTTTTGCTTGTTCAAGAAGAAATTTCAACAGTTTGAAGAAAAGACCAGACAACGAACGATTTTCGTGTCAGAATCTTTTAAACAGAGCATGGTGTTGCGTTTATTCGAACAAATATGGTGAGTGAATTTTTCTATGGATTTGTGAGATCTGTAGCATGCAATTTATTTCATTTCCTATTTTGCAATTTTATTTACTTTCAACTTTTTCAAGTTCTATGGAAAATAGTAAAGGTTTTTTTTTTTTTTTCCAGAATTATTCTCTGAGGGGGAATCTGAACATTCAGAAAGGGATACACGTGACGCCTTTTCAGATTCTGAAGACATAGACCACAAATCCATGGCTGCTAAAAGATATGCAAGTAGAATATCATCTACAAGCTCCTGGCCTGAATATTTTAAGCCTTCTTTTACCCAGAAACTTACATTTAAATATGTTTTAGAGGGTGAACCGGTTGTTTTTACATGTAGATTAATTGCCTGTCCAACTCCAGAAATGACTTGGTTTCATAACAATCGGCCCATCCCAACAGGTCTTCGTCGGATTATAAAAGCTGAGAGTGATTTACACCATCACTCTTCCAGCTTAGAGATTAAAAGGGTCCAAGACAGAGATTCTGGAAGTTATAGGTTACTAGCAATTAATAGTGAAGGGTCTGCAGAATCAACTGCATCATTGCTTGTTATCCAAAAAGGGCAAGATGAGAAATATTTAGAATTTCTGAAAAGAGCAGAACGGACACATGAAAATGTGGAGGCTTTAGTTGAAAGGGGAGAAGATAGGATAAAGGTTGACCTGAGGTTTACTGGCTCTCCCTTTAACAAAAAACAAGATGTGGAACAAAAGGGAATGATGAGAACTATACATTTTAAGACAATGAGTTCTGCCAAGAAAACAGATTACATGTATGATGAAGAATATTTAGAAAGTAAATCTGACATAAGAGGTTGGCTTAATGTAGGTGAAAGTTTCCTGGACAAGGAGACCAAAGTGAAGTTGCAACGTTTAAGGGAGGCTAGAAAAACATTAATGGAGAAAAAGAAATTATCTCTTTTAGATACGTCTTCTGAAATAAGCTCAAGAACTTTGAGAAGTGAAGCTAGTGATAAAGATATTCTGTTCTCTAGAGAGGACATGAAAATCAGATCTATGTCTGATCTAGCTGAAAGTTATAAGGTAGATCATTCAGCTGAGAGTATTGTGCAAAATCCACATGCCCTTTCTAATCAAATGGATCAAAATATAGAATCTGAGGAACTTCCCACAAGCTTTCAAACTATTGTTGATGAAGAAATTTTCCAGACTGAAATAAGAATGAGCCAAGAAGCACTGGTAAAGGAAAGTCTACCAAAAGACCATTTATATGGTGAAATTCTAGTAAATGAAAATACCCAAGCAAGAGGACAGCTGGAAGAAATTATGGCCAATACTACAATTGGAGAGTCATCCACATATATCACTAATGTATGTGAGAAGGAGGAAGTATATGAGACTCCTGAAAATGTGTCTCAAGCTATTACACCACATGCCAGCGAATCTTTTGGTACACTTGTAAATGTTGAAGAAAGTGAAGAAATAGCTAGTGAAAGAATAAAAAAGGATGATTTGAGAGAATTACAACTCTCTGCTTCTACACGAATTGATGAATTCAAAACCGAACAGAAGGAAGAAAACATGAGATTTTTTGAAAATTCTTTTCGAAAACGCCCACAACGTTGCCCACCTTCATTTCTTCAAGAAATTGAATCTCAAGAAGTTTATGAAGGTGACAGTTGTAATTTTGTGTGTCATTTTCAAGGATATCCTCAACCTATAGTGACGTGGTATAACAATGACATGCCAATCCCACGTAATCAAAACTTTATCATTCATTCGTTGGAAAACTATTCAATATTAACTCTTTCATCTGTTCATCATCAGAATGAAGGTTCTATTACTTGTGTGCTATTTAACCAATATGGAACAGTAAAAACAACCAGTATGCTTAAAGTGAAAGCAAAACAAAAACATGATGTCAAAGCACATAAAGTCCCAGTGTTCCATGACTACTTGGATGAGGAAGAAGAGTTAGCATTGGTGTTTGACCAAGCAAAAGGCGCCCATCCATCTATGAGTCAAGAGGGCCAAACAAATCTTCATTTGTTAAAAACTAACCCACCAGTTCCTCCCTCTGGAGACACAGAATTGCTTTCCTTTCCTGTAGAAATTCAGGTAACAGCAGCTACTCCTATCCCAGAACAGGATAAAGAGTCTAAAGAAGTGTTTCAAACTGAGGAGCTGGAACCTAAAGCAATGCCTCAAGATCAAGTTACTCAATCACCAAAACACAGATTTGTATTTTTGTCTGATATTACTAATGAACCACCAAAAATGTTACAAGAAATGCCAAAGCATGCCAGGTGTAGAGAAGGGGATTCCATCATTCTTGAATGTTTAATATCTGGTGAGCCCCAGCCAGTTGTAACATGGTTTCAAAATGGAGTCCTTTTAAAGCAGAACCAGAAGTTTCAGTTTGAAGAAGTTAATTGTAGCCACCAATTATATATTAAGGATGTTAATTCTCAAGATTCTGGAAAATATAAATGTGTTGCTGAAAACAATTCAGGGGCAGTTGAAAGTGTTTCAGATCTAACAGTGGAGCCTGTCACTTATAGAGAAAATAGTCAATTCGAAAATATTGGTGAAATTTATGGAAAATATTCCAGAGATCAGCAACTGCAAGACCAGGGAGAATCTGTAAGGGCACATTTTTATGATTATCCAGCTGGTCCCTTTACTCCCTGGACAAATGTAAAAGAATATTCAGTAAGGGACTATTTTCAAAGCCTTGAGACTATTGAGCAAATAGACCAGAAAGAGCAGGTGCGTTGCATACCTTCTAGAGAAAAAATTCCCAGATTTGTGCATGGTGCTTCAAGAACCATAAAAATCAGCAAGCCCATCAGGGCTGAATTCATACAATGTCAGGCTGAAGGGAAAGAGAGACATGTAAGTGAAAAATCAAAGCTGCACCAAGCAGAGGGTACTGTTTATCCATTTGTTGATGATTTCAGTGATGTCACTATTAAGAAAGAAATAAGAAATAATTTTGGAAAACTTGGTAGATCAGAAAAGGAAAATGTACAAGAATGTGCCCAAAGTGACTATTTACCAAATATTCACTCTGAGAGAATTTCTGACAGTTACAATACAAAAGATTCATCTGCCATTGTATATGAAGAATCCCTTGGTGAAGAGATACACTACCCGGGGAAAAAGGTGAAGCATAGAATTATCGAATTTGAAAAATTACATGTAGAAAAAGGAGTTCTAGAAAAAAGACCTACCAGAACATCAATTGTTAATCCTCCTCAAAAGAAGATTGATGACAAAGCCTTTTCATTAAAGCAAAGAGAATCAAGATCAAGCAATCTAAATGCAAATATGTATCAGGCAGAGAAAATGTCTCCAAATACTGAATCAGATTCATCTAACATTGCAATAAATTTAAAGCTGCTTTCCTCTCAAACTCATAAAGAATTTGACGCACAAGAAAGGGAACAACAGGAAAAAATAAGTCTTATAGATAAACCTGCAATTTCTAAAAGAGCTGAACATGAATCACCTATTACATTTGACTTAAAGCAGTTTCACACTCAAATAAAACACACAGATGTGAAATTCCAAGAATTAGATAGTGGTCAACCAGAAGAAGCTTATTTTAAAATCCAACATCCTGCTGACACTGAGAACATTGTATTTGATCTAAAACAAATGTATTCTCATATAGGAGATCCAGCTCTGGAGTTCCAAGGGCAAGAAACTAGGGAACAGCAGGAAATACATTATAAAGAAAAAATTCCTAGCCCTGAAACGTTACAACCTGACACACACAATATCTCTAAAAGTGTGCAAAATAATGTATTTGCCAGTCAAGAAATTTCTTCCAGTCAAGAGCTTTCAAATAGAACTATGGTGGAGAAAAGTAGTATTGATGAAAATTCCATTTCTTTAGAAAAAGAAGTCCGACATGTACAGGAACAAAACTTAGACATTTTAAAAACTGATCTTTCTCTTAAATCCTTTTCTGAAGAAATCTATAGTGAATCATGTGCCCTACTTCCAACCTCATCTGCAGATATAGAAGAAACTGATCTTTCTGAGAAAAGTTGTCCTCTAGAAAATGGAGGCAGAAGTTCCATCTCACATTTGAAAAAAGCAGCAAGTGAGGAAAAGCCTTTAGGGGTTGGTGAAATGGAAGAAGAATGCACTCTAGAACCAGAGTTGGCAGCATTTCCAAAGCAGGATGGTGGGACACAGGAATATACAGATGCCACTTTGGAAGACCACAGAGGTGATGTTCAGGAAGCTGACACACTCCATAGACAGCTCTCCCTGAGTCAGTGCTTCCCACTCTTGATGACTGAAGAACAACAGAATCCAGGTGAACAAATAAGTACAAACATTCATGCCTCTGGAGAAGAAAAATGTTATGAAGAAGTTCAAGTTCAGAATGAAGCTTCTTTCTCCACTTTAGAAGGAGAAATGATAGAAACTAGTTTTTCTCAAAATATTCCTAAATTAGATGAGGCACATACCACTGAGGCAGCAGAATCTGAGACCTCCCTAACACAATATTTACTTGCTGCTGGAAAGCGTGAGGTTCCTGAAACTAAAGACACCAGAGACCAGGCAAAGCTTGTCCAGAGTGAATCAATCACTTCAATGGAGGTGGAAGAAGTAACTTTCAACACTGTGTATGAATACTACAACCAGAAACAGGAATCACTAGGTCGTCCACTTTCTCCTGAGTCTGACATTTCCATTGGTGTGGGAAGTACAACCAGTGAAGAAATATCTGAGTTAGATCAGTTTTATACCCCACCATCATCTGTTGAATATTTTGAATCTCCAAAGTCCCCTGACTTATATTTTAATCCTTCAGATATAACTAAACAATCCTCAATACATTCAGGAGGTGAGACAGTTGAAAGATATTCCACACCTTTAGGGGAAGTTGCTGAAAGATATTCAACACCTTCCGAAGGTGAGGTAGGAGAAAGATACTCCACACCCCCAGGGGAGACACTAGAGAGATACTCCACACCTCCAGGAGAGACTCTAGAGAGATACTCCACACCCCCAGGAGAGACTCTAGAGAGATATTCCACACCCCCAGGAGAGACTCTGGAGAGATACTCCACACCCCCAGGAGAGACTCTAGAGCGATATTCCACACCCCCAGGGGAGGCACTAGAGAGATATTCTATTCCTACTGGAGGACCAAACCCCACTGGTACTTTTAAAACATATCCATCAAAAATAGAAAGGGAAGACGGTACACCAAATGAGCATTTCTACACACCTACAGAAGAGAGGGGTTCAGCTTATGAAATATGGCGTTCCGATTCATTTGGTACACCCAATGAAGCCATTGAGCCAAAAGACAATGAAATGCCTCCATCTTTTATTGAACCTCTGACCAAAAGGAAGGTATATGAAAACACAACACTAGGCTTCATTGTTGAAGTTGAAGGTCTTCCAGTTCCTGGTGTGAAATGGTATCGAAATAAATCTTTACTAGAGCCAGATGAAAGAATCAAAATGGAAAGAGTGGGTAATGTGTGTTCACTGGAAATTTCTAACATTCAAAAAGGAGAAGGGGGAGAGTACATGTGTCATGCTGTAAACATCATAGGGGAAGCAAAGAGCTTTGCAAATGTAGACATAATGCCCCAGGAAGAAAGAGTGGTGGCACTACCACCTCCAGTAACACATCAGCATGTCATGGAGTTTGATTTGGAACACACCACATCATCAAGAACACCTTCTCCTCAAGAAATTGTCCTGGAAGTTGAATTAAGTGAAAAAGACGTTAAAGAATTTGAGAAGCAGGTGAAAATAGTGACAGTTCCCGAATTTACTCCTGACCATAAAAGTATGATTGTGAGTCTAGATGTTCTTCCATTTAATTTTGTAGATCCAAATATGGATTCAAGGGAGGGAGAAGACAAAGAACTAAAAATTGATTTAGAAGTATTTGAAATGCCTCCTCGCTTTATAATGCCTATTTGTGATTTTAAAATTCCAGAAAATTCAGATGCTGTATTCAAATGTTCAGTCATAGGGATCCCGACTCCCGAAGTTAAGTGGTATAAAGAATATATGTGTATTGAGCCAGATAATATTAAATACGTGATTAGCGAGGAGAAGGGAAGTCACACTCTTAAAATTCGAAATGTCTGTCTTTCTGATAGTGCAACATACAGGTGCAGAGCTGTGAATTGTGTAGGAGAGGCTATCTGTCGGGGATTCCTCACCATGGGAGATTCTGAAATATTTGCTGTGATAGCAAAGAAAAGCAAAGTGACTTTAAGCAGTTTAATGGAAGAATTGGTCTTAAAGAGCAACTACACAGACAGTTTTTTTGAATTTCAGGTGGTGGAAGGGCCTCCCAGGTTTATCAAAGGTATTTCTGACTGTTATGCACCAATAGGTACAGCAGCATATTTTCAGTGCTTAGTTCGTGGCTCTCCAAGACCCACGGTTTACTGGTACAAAGATGGAAAATTAGTCCAAGGAAGAAGGTTCACTGTTGAGGAAAGTGGCACAGGGTTCCATAACCTGTTTATAACAAGCTTAGTAAAGAGTGATGAAGGAGAGTATAGGTGTGTAGCTACAAACAAATCAGGAATGGCTGAGAGCTTTGCAGCACTCACCTTAACTTAAAATGTAATGTTTTAGTGCCTCAGTAATTATTAGCATTGATCTGAGTGCTTTCATATTTTCCAAATTATGTGGATCTAATAAACTTCCAAACAGGTCCACCATATTTGAATTCATTACCTTGGAGACCCCTAAAGAAATAATCTCTATGTAGAAATCTCATCTTTGTAATACATGTAAATATTTTGTTATCTGAACTGTGGAATCATCACTTGTGTCAATCATGCTGTGTAATATCAAACACAATTAAATCTCTCCTTGGCTACCTAATTGTTTGTACTTCTATTTACCCTCATGCCTCCTCCACAAAGTGTTTCAGTGGAATGGACTCTCTTTTAGCAGATAAACCATATATGCAAAAGTACAATGTAAAAGTGGAGACCATATCAGATGACCACGCAGACAAATTGGTAAGGGCAAATCTCTCTGCTCCCATTCTAAGTTATTTTTGGAATTTTAACCCCTTTGCATCCAAACTCATGTTTATTTACTTTGACTTAGAATAGGCAAAACAAACAACAAAAACCAGCTTCTCCCAATTGGCAACTAACTCTATAATCTGTTTGACATTTCAATCTTAATATATTAACTTCATCTCTTTTAAAAATGTTTTCGTTATTAATATTCCTCTTCATAAGTGCTTTAATTCTCACTGGCTTCAAGGGACCAATTGTGCTCTTTGTGGGCAGGGTTCACCTAGACATTTGCAAAATAAGCAAATAGATCTTTCCACTTTTGGAGATACCTTATTTTTCTCCATTTTTGAGATGACATCAAGTGTAAAATGCAGCAATAATTTAGTATTGGCCTGGGGAAAAAAGGGAAACTATCATATTGTGTTTACATATAGATTTTAAAACTGTATTCTGATTTCAGAATCTTTAAAATTTAAAAAAAGGTGGGATATTTTTAGAATTGAGACAATATGGTAATTTGTATTTCAGATTATATATAAATAACAAGATAACAAGCTTTCCTATCAGTTTCACTGAATTTCATCTTTAAAACGAATATAGCTTAATAAGCATTCAATTTTTATTGTGATGTTTATGTTTCTAAAGTAACTCTTTAATTTTGTCTTTTAAAATTAAAATAACAGTAAATTAACATACTCCTTAATATCTTACCTATATACTAATGTGGACCCAAGTCTTCTCATATAAGACTCGACAAATATAAAAAATTCTGAAAATGAAGGGTAGGACCAAAAGACCTTAGAGGTGATCATTCAACAATACAATTCTGTGTTAAGCTAATAGTAATTATTCTTAATACAATTTAGAATAAACTTTAATTTTGTAACAAAGGACGAGAGAAATAATATTACAATGAAAGATAAATTTTATCTCCCTCCACCTCTTAAATTACTTATTGTTACTTAATGGCTACATTTGTCACCTGCATTTAGCAATATTTAAGTACCATTATCATATTTAAAATGCTAATTTTAATTAGAAATGTAAACAATTTAAATTTAATTTTCAAAAGAATTCATATCCAATTATGTTTATTATGTTTCTTTCATCTATCAGTCTTTATTCTCAACATGGGAATTCTCTAACAGCTATCCAAATTAAAGAAGCAATAGAGACAATGTACAGAAAATAGGCAGAGCAGCCAGGCCTCCCCTGCCTCCCTCACAAAAAAAATTTTGAATTATCTGTTTGAGCCACCATAACTCATCAGCATAGATACACTATTGTAGAACAATCATTCCTGTTCCAACCAGTGAGCACACAATATCTGTGATAATAATTATAGACATAATGTAATATATCACATCACAAATTCCTGAAATAAAACTAATTCTATAGATTAGGAACTTAGAGATTTATTCTGCACTTAGTCACATAATGGATGTTAAAATTAACGAGAAACTCAGATTGAGGCAAACATGACAAGCATGCTTTACTCAAACATCATACAGCACAGCAACAGTTCAAACCTTGTTTCTTAAAAAAAGAGAAAGAGAGAAATAGAAAAATGTTTTTATGTCCTACTGGATTTCAGGAAGAGCTGAAAAACACTCTTATTCATATAGTAAAGAGGGCTTTGTTTGGTTTTGCTCATTAGAATTCTGTAATTCTGTTAGTTTCAAGTATGGTGAGCTTGAGTATACGCAGAATAACAGTGACTGAATAAAGAAAAGTAAGCCTTGGCTTACTTTAATTGTCATAGATAATGAAATGGAATTTTTTATTTTCTGACTCAATGGCACGTAACATAAAACCCCAAAATATTAATTTCTCTGATTCTGGATAAAGAATTTATTGTATTGCACATAGTTGAGTTTAGACAATTAATAGCTGCTACCACAACATGTAATTTTTTAAACTATGCCTTTCAAGTTTCAGCACATTTGAATTTCATTTACTATCCTTTTTATGGCTAATAATACCATGGCTTGAAGTAAAATATTTGCAAATAGTTCAACATAGTAGTGAGTAAGGGTATTTTAACTGTATTCACATTCACTCCCTTTACAGATATTTTGTGAGTTCAAGTGAAGGGAAAGGTAACGCGAATTATGTATTGTAGATTAAATGCGAAGTTAAGTGATCACCATTAATATGTAAAATTATCAATGGTTTTATGGTTTACTTAAAATAATAAATACCTGAATATGTATTCTGCATGCTATAGATGAGTTTCTCCAGTATTTTTACAGCCAGCAGACACTTGAGTCCTGTCTTCTAATGCTTATATGCTAGAACAGAAAGGAATTAAGGTGTAAGTCTATTTCATGTGATGCAAGTGAAGTCACCAAATAAAATCATAAAACTGCCTTTTGCTAAGGCAATAAAACTACTAATAACAGGCCTGTTCTACATAGCTAAGAGGTTTAATAAAAAATCGAATTCCTTGTTTAAAATTACATGTCTTTCATCCTGTCATCCAGGATACTGTTTAAAGAGTCTCTGTTATGCACTGCTTTGTTTCTTGCTCAGTGGTTCTGTATAGGTTTTCTTATACAATAAAATACAATGAACTTTTAATATTGGAGTTGTTTTCTCTTATTTTTGATTATCTTATTTTCTTGGCTAATGCCTTATTACAAAGGCTTTGTTCAAGTAATATGGTGATTTACATAGATGAAAGAAGGCCTGCATTTCTAGAAACTGAAAACAGTGGTTCTCTTACAAATCCAAATTAAACATTTCCTGTAGCCTCTTATTTTTAATAATGACTTTAGAGGCAGTAATTAGAACATCAATGGTTTATTTTGGAAATAATCAGTCTTTAACAAAGAAGATTATTCTTAACCTCAAGAAAACTCTAAATATAAATAACAATTCTGGATCTTTTTAGAAGTTGATTTAAATAATGCTGGATTATTATAACTATTTAATTAGCAGTTTTTCAAACTTTAAAATTGGAATTATATCTCAAGAAAAACTCATGAGAGCATTTTTAAAACATGAACTCTATCACAGATGAAGTGGATCAAAAATTGCTTTTGTACAGTATCTATAATTTTGCATAATTTTATATGTTAAGCTAAGAAAAATTTAGAAATGTGCTTTTTGATACATTAATCTTGGAATAATCTAATCATTCCAGGAATAAAGCAGAAGAAGGCCATCAACTGGTGTCTAATTCTTTGATTTCTATTTTTATATTAAATAAAATTTTATAGTAAAATAATAATCATTTTTCCCCATACAG
>TTN-201,,0,780,134303,135082,GTTGGATTTTAAGGATAAAATAGATCAAATGCTAACATTCACTGGATTGTAATGATTTAGCTTGCATCACTTAAATTTTCACTTATCTGCCACTTCCAGAATGTAATTTATTTAGAGTAAGAATGAAATCACAGACATAATCATGGTTATGAACTCACCTTTTCCCTTACTGCCCTGTTGGGTGCTATGCTATCATATCCATGGTACTATTTATTTTAAAAATAAAACATATTTTCATATGTTTCATAATACCAATAGATAAGCTTTTAGTTAATTTTCATATGAAGATAACTTTCATAATATGTAATAAAAAGTATCAGTGAACACCTAGCCACTCTGAAATCACTGGTCTCACCCTTAGATTTAAAATAACCATGATTAGTTGTCTGTTTCTTTTTTCTGTTTATTTTTTGTTGTTGTTTCACTTCATCACTTTATTTAGTATATCATGTTTCTTCACATTATTTTCAGTGTTCCCATTCAGCATGGTATATTTAAAGAATATATCATGTTGTTATGCATATAATCCAATAGCATCACATTTTTTCACAATTCACTGCAAAGCAATGATTGAATAGGTTTTTTTTAAAAAAAGCTTATTGTCTTCTTTTGCCTTCAATGATCTTTCTCATTTTCCAGTCACTTGCCTTAAACTGCTGTAATCCATCTCACCAATTTCAACTGTTTTACTCCATTAACAGCAACAAAAGTTAGAAGAAAAACAAAAATGTCATATGCCTGATAAGGAGGCATGTTAATGGACTCTACTTCCCTTTGCAG
>TTN-201,,0,95764,135083,230846,GTAAATGCCATACATTGGCACAGATGTTGTCACTTCATTTCATATTGTTGTCCTTTTTGCTTTCTGTACATGTGTGGGAAATGCTTGTATTACCAACTGGAGAGACCAACAACCAAGACAGTAACATGGTAGGTAGGTACTGCAGAGCCTATATGGGATAAGAAATCATTATTTACAGTCACATTTCTACTACTGACCAAAGAAAAAATAATTTATTATTTGAGAACAAAGTTAAGTAATCAAATGAGCTCAGCTTGGCCCTTCATATAAAACATATCAGGACAGTTTGGTGCCACTAAAAAAAAATAATGTCTCAATGTATTTAAAAATTTTAAATCAAATAACCAATTAAGAACAGAATTACAAACTTAAAAAAGTCAGTGTCTAAGTCTAAAATTAAATCCTAATGTAAGACAGGGAGCTAGTATAGGACTGAAAACTAGGATTCTCTCTAGGCATTTTTACTAATTTAAAAATAAGACGGCTGGGCACGGTGGCTCACGCTTGTAATCCCAGCACTTTGGGAGGCCAAGGCAGGCGGATCACAAGGTCAGGAGATCGAGACCATCCTGGCTAACACAGTGAAACCCGATCTCTACTAAAAATATAAAAAATTAGCCAGGCGTGGTGTCACGCACCTGTAGTCCCAGCTACTTGGGAGGCTGAGGCAGGAGAATTGCTTGAAGCCAGGAGGCAGAGGTTGCAGTAAGCCAGGATTGCACCACTGCTCTCCAGCCTGGGCAACATAGCGAGACTCCACCTAAAAAAAAAAAAAGAAAGAAAGAAAATAAGACAACTACACAAATATCCTATTCCCAATTTTCTAATTGATATGTAGGGTGACTTTCAAATAGTTAACACTCATCAAATACTTGAATGCCTTCATTAACCAAAATATTAGTAGCAAGCTTTTCTTCCTTTCTTCCTACCTTCTTTCCTTCCTTCCTTCCTTCCCTCCTTCCCTCCCTCCTCTCTATCTTTCTTTCTTTCTTTTCTTTCTTTCCCTCTTCCCAAGAGAAAGTGTGAGTATGAACTGTGGTTTGAGGACAGGGGTAGAGGTACAGTCAAGCCATACTTGGACTGTTGGGGAAGGCTGTCCCTTGGTCTTCTTTGTCAATGAGAATATCAAGGGGAAGGGCAAATGCAGCACATCTCTTGAATGTGAAAACGATGAGGTTCCCTATAGCTTCCTCTTCTCTACAATCCTTTTACGTGATCCTAAGAAAAACCCAGGCCCATGATGACCCAACCAGTGCTTTTCACTCTGGTCAAAATGTCTCCATAAAACCAAGTACATGATATTATTCATACTGACGCGTTTGGAAGTTTCTTTACTCAAATTAGGTCAATTTAGGAATGCGACTAATATTGAAGCTTCAGATAATAAGAGGAAAGGATAAGGAGGATGACTTAAAAAAATTAAAAAGAGAGGTTCTGAAAGTCTGGCTTCAAGATGCAGAATGGAAAGGGGAAGTTGCTGCTATTAAATATTTTTACAAGTTTGAGTTGGCCTAGAGGATGCATTCATAGTTAAGCCATATAAGAATTTCCAGGCAGTTGACATGAGGGTTAGAAAGACATTACAAAACTACTTCAATCTTCTTATCACTTAATATCCCTACTCTTCAGAAGAGTCAAATACATTTTCTTTATCTTCCTTACATAATCTTCTAATTTGCAGAATTAAAGTATCAGCTCAATAGCTTATCAAATAATTAAACAAGCAGCCACTAAAATGGACAAATCTTTAGTAATGTTACTTAATAAAGGAACGCTTGTCTTTTCTTTGATAGAGACAAGTAAAGTGATGTCTTGCTCCCTTATAAAGAACACTCTCATCCCTTTCCTTTGACAATCTTTTGTTCTTATTAACACATTACTCCATTTTAAATTATGGCTCATGTCTATCTAAAGACTTAACTCATCTTTTCTCTGTCTTGGAATATATAATTACAGCAAGTGCTTTGGTGGGGACTAAATGTAATGCTGGAAAAATTTCTTTTGCAGAGGCATATCCACCAACCTTTCTCTCCAGACCTAAGTCCCTTACAACTTTTGTGGGTAAGGCAGCCAAGTTCATCTGCACAGTGACAGGGACTCCTGTGATAGAAACCATTTGGCAGAAAGATGGTGCTGCACTCTCACCTTCACCTAACTGGAGGATTTCCGACGCAGAAAACAAACACATTTTAGAACTCTCAAACCTTACCATTCAAGATAGAGGAGTTTATTCTTGTAAGGCTTCCAACAAGTTTGGAGCAGACATCTGCCAAGCAGAGTTGATCATCATTGATAAGCCACATTTCATTAAAGAATTAGAGCCTGTGCAGTCCGCTATCAATAAGAAGGTCCACCTTGAGTGCCAAGTAGATGAAGACAGAAAAGTCACAGTTACGTGGAGCAAAGATGGGCAAAAACTCCCCCCAGGGAAAGATTATAAGATCTGTTTTGAAGATAAAATAGCAACACTTGAGATTCCTTTGGCCAAACTGAAAGATTCAGGAACCTATGTCTGTACAGCTTCAAATGAGGCTGGAAGCAGCTCCTGCTCAGCCACAGTCACTGTCAGAGGTAAGAAACGTGTGAATGTATTTTCTAGTCCCTTCTCTGCAAGGAATCCTCAGTAGAAAAACTGTTGGCAAACAATTCAGTCAGTACACTTTGTTATTAAAATAATGTCATTCAGCAAACATTATGGTTTGGGAAAGTCCTGGCATTGTTTGATTTTATTTTTTTAATCCTCTTCAAAGTTCACTTAACTTTTGTTCTTTTAAATTGTCTGCTATTAACAAAGCTTGCTTAAAATTTCTTCTAAGAAAAAACTCCAAGTGTCTGAGCAATTCTTAACTATCTTCTTTTATAAAATTCTTCTTTGTGTAGGTAGTCTGTTTATTGTTGTTTTATTTTAAATCAAGAGACTGGGAAAGTGTCTTAGAATGATAGGAACCTATTAAATGCACCACAGCTTTTACAGAAATTTTGTGGAGATATTTTATGTGTGTTGGGTCTCTTTGTTGTATATGTCTACTTTTCTTTTGCGGAGTTTATGTTTCAGATATCTTCTCCTTTTTCTTTTTTGTAAACTTCATGTAGAGCCACCATCCTTCGTGAAGAAGGTGGATCCCTCTTATTTAATGCTCCCAGGTGAATCAGCACGCCTCCATTGCAAGCTGAAAGGCTCACCTGTGATCCAGGTTACTTGGTTTAAAAATAACAAAGAACTCAGTGAAAGTAACACAGTCCGAATGTATTTTGTCAATTCTGAGGCTATACTTGATATTACGGATGTAAAAGTTGAAGACAGTGGGAGTTACTCATGTGAAGCAGTGAATGACGTCGGCAGTGATAGCTGCAGTACTGAAATAGTTATCAAAGGTTTGTTTACTGAGTTTCCATCCAGTATTTTTCTGAGAAAAGATTTCCCTTTTAATTACTTATTACCCATTACTTACACAATGCTTTCATGCTTTTGTAGAACCTCCTTCTTTCATCAAAACTCTTGAGCCTGCAGACATAGTGAGAGGAACAAATGCTCTACTTCAGTGTGAAGTCTCAGGCACTGGACCATTTGAAATTAGCTGGTTCAAAGACAAGAAACAAATTCGAAGTAGTAAAAAATACAGATTGTTTTCTCAGAAGTCTCTTGTGTGTCTGGAGATCTTTTCGTTTAATAGTGCAGATGTTGGTGAATATGAATGTGTTGTTGCTAATGAAGTCGGCAAGTGTGGCTGCATGGCAACCCACTTACTCAAAGGTTAGTGCTTGAAAAACTAATGTCTCTTTAATAAATTGTCAAACTAGCTTTCTTACCCCATGGAAGAAAAACTGGTACTTTCTTCTCTTGTCCTATCCTTTAAATTTGTTTTGTCTTGGTTTGACCTGGGACCTTGGGAACAAAGTCAGTAACTTTCACCTGGTCTTTTTCCCGAGACTAGTGTAAATATCTATTATCTGATAACAAAAGGGAATAATAAGCCATTTTGTCAGCTGACAAACATGTATCATCTATGCCTCTGTCTCTTGGATGGAATTATAATTATTCTTAACTTTTATTTCTTCTTCTAATTAACACTATGAAATAGTAGTATTGGGACAAGATAAATATAATCTTGAAAAAACTCTTAAATATAGATGGTGTTGAAAGTGTTTGGGAATTGATATGTTTTATATGCTCTCTTTCCTTAACTAGAACCTCCAACCTTTGTAAAGAAAGTAGATGATTTGATTGCACTAGGAGGACAAACCGTTACCCTGCAAGCTGCTGTGAGAGGGTCAGAGCCCATTTCTGTCACATGGATGAAAGGTCAAGAGGTCATCAGAGAAGACGGAAAAATCAAAATGAGCTTTTCCAATGGTGTTGCAGTCTTGATAATCCCTGATGTTCAGATTAGTTTTGGAGGCAAATACACGTGCCTGGCTGAAAATGAAGCTGGAAGCCAAACATCTGTTGGGGAATTAATAGTTAAAGGTTTGTGTAGGAACATTTAAACCTCAAATTGCTATTTAGAATTAAAGTGAAACCCTAACAAGCATTTAGGGTGCTAACTATTTCATACCATTGTAGAACCTGCCAAAATCATTGAGCGAGCAGAACTGATCCAGGTGACAGCAGGAGATCCCGCCACACTGGAGTACACAGTGGCAGGCACGCCAGAACTGAAGCCCAAATGGTACAAAGATGGGAGACCCTTGGTCGCCAGTAAAAAATACCGAATAAGTTTTAAAAACAATGTTGCCCAGCTCAAATTTTATTCAGCTGAGCTGCACGACAGTGGCCAATACACATTTGAGATTTCCAATGAAGTGGGCAGCAGCTCCTGTGAGACTACATTCACTGTATTAGGTTAGTATTTTTAGAAAATGATGCTACATATGCATTTGAAACCCAACAAATGGCCTAAAGTCAATCACTGAGCACTCTTCTATATTGACCTTTTCTCCCTTCTTGTGCAACACACAGATCGAGACATTGCTCCATTTTTTACCAAACCCTTGCGCAACGTGGATAGTGTTGTTAATGGTACCTGCAGACTGGACTGCAAAATTGCAGGCTCCCTCCCCATGAGGGTGTCCTGGTTTAAGGATGGCAAAGAAATAGCTGCTTCTGACAGATACAGGATAGCATTTGTGGAAGGCACAGCCTCTTTGGAGATCATCAGAGTAGACATGAATGATGCAGGGAATTTCACTTGTCGAGCCACAAATTCCGTGGGAAGCAAAGACAGCAGTGGAGCCCTGATTGTGCAAGGTTGGCTGGAGACTTTGCATTTTATCCTTATTAAAGATTATGTTCAAATTAAGTCATCTTCCCTTAGATCAACCCTCTTAACTCTTTGAAATTCTTTCTTATACCCCTTCTTCAGAACCACCCAGTTTTGTAACTAAACCCGGCTCAAAGGATGTTCTGCCTGGCTCAGCAGTCTGCCTGAAGAGCACTTTCCAAGGATCTACTCCTCTCACAATCAGATGGTTTAAGGGCAACAAAGAGCTGGTTTCTGGTGGAAGCTGCTATATTACCAAAGAAGCTTTAGAGAGTTCCCTGGAACTCTATTTAGTAAAAACCTCTGATTCGGGCACGTACACATGTAAAGTCAGCAATGTCGCTGGAGGGGTGGAATGCAGTGCAAACTTGTTTGTAAAAGGTTTGCATTGTTTTCTTGACATCTTTGTGCTAACCTTGTTATAAATTCTTTCCTCTTTCTCACATTTCTTAATAACTTCCTTCCTTCCACAGAACCTGCCACATTTGTTGAAAAGTTAGAGCCATCACAGCTGTTAAAGAAGGGAGATGCCACCCAGCTAGCCTGCAAAGTAACTGGTACCCCTCCAATTAAAATAACATGGTTTGCAAATGATAGAGAAATTAAGGAGAGCAGCAAACACAGAATGTCTTTTGTGGAGTCTACTGCAGTTCTAAGACTGACAGATGTTGGCATCGAAGACAGTGGTGAATATATGTGTGAGGCCCAAAATGAGGCTGGCAGTGACCACTGCAGTAGCATTGTAATAGTCAAAGGTTTGTGTTCACTTTGCCTCTTGTGTTGCCAAAGTTATGGCCCATGGCACAGACCCCTCCTCCCTTAATGCAAATCATTCCTTTTTTACTGTAGAGTCACCTTATTTTACCAAGGAATTTAAGCCAATTGAAGTCTTAAAGGAGTACGATGTCATGTTGCTGGCTGAGGTGGCAGGCACTCCTCCCTTTGAGATCACTTGGTTCAAAGATAACACAATCCTGCGAAGTGGTAGAAAGTATAAGACTTTCATTCAGGATCATCTGGTTAGCCTGCAGATCCTCAAGTTTGTAGCTGCAGATGCTGGCGAATACCAGTGTCGGGTGACCAATGAGGTGGGCAGCAGCATCTGCAGTGCCAGGGTGACTTTAAGAGGTTAGTGTTGGTTCCAGTGAGGGACTGGCTTTTCTGAAGAGTCAATTCTTTTTTTTAAGCCACTTTTGCTATAGGGATAATATTGATTGAGAATTCATTCTTCTGTTAGAACCCCCATCCTTCATAAAGAAGATCGAGAGTACCAGCTCCCTCCGGGGAGGCACAGCTGCCTTCCAGGCCACTCTGAAGGGCTCCTTGCCAATTACGGTGACTTGGCTAAAAGACAGCGATGAAATCACTGAAGACGATAATATAAGAATGACCTTTGAGAACAATGTGGCCAGTTTGTACCTCAGTGGCATTGAAGTCAAGCATGATGGGAAATATGTCTGTCAGGCCAAAAATGATGCAGGAATACAAAGATGTTCTGCATTACTCTCAGTAAAAGGTTGGTTCAGAACGTTTGCCTTGGGTTTGAGGAAGAAATGCAGATGTAAGCCTTTCAGCAGGGTAATGCACAACCCACATCTATCCCTTTGTTTTCTACAGAACCTGCAACAATCACCGAGGAAGCTGTGTCTATAGATGTCACCCAAGGAGACCCAGCCACTTTGCAGGTTAAATTTTCAGGGACTAAGGAGATTACAGCCAAATGGTTTAAAGATGGCCAAGAACTGACCCTGGGCTCAAAATATAAAATCAGTGTCACTGATACAGTCTCAATACTGAAGATTATTTCTACAGAAAAGAAAGATAGTGGAGAATATACTTTCGAGGTCCAAAATGATGTTGGGAGGAGCAGCTGCAAGGCTAGAATTAATGTATTAGGTTGGTATTGTTCTTCTACAGAGAGGATTGGGCATTTCCATGCTCCTTCTTCCCTTAAAATTTAAAAAAAAAAACAAAAACAAATTAGTAGATTGACCTTTTTTTGTTGTTGTTTGCTTTTTCATTGAATAGATCTTATCATACCTCCTTCATTCACCAAAAAGCTGAAGAAAATGGACAGCATTAAAGGTTCTTTCATTGATTTAGAATGTATAGTGGCTGGGTCACATCCCATAAGCATCCAGTGGTTCAAAGATGACCAAGAAATATCAGCTAGTGAAAAGTACAAATTCTCTTTTCATGACAATACTGCCTTCTTGGAAATCAGCCAGCTGGAAGGTACAGACAGTGGGACATACACTTGTTCTGCCACAAATAAGGCAGGGCACAACCAATGCAGTGGGCATCTGACAGTCAAAGGTTGGCAAATTTTATTTCCACTTATCAAGAACTTACAAAATATTTTTGTTTCATTTCTAAATTTTCACCTTTATTGCTAAGTTATAAAATAAAACTTCCTATTTTCTTTTGCTTGTTTTTTCTTTCACCTCAGAACCCCCTTACTTTGTGGAAAAGCCACAGTCACAAGATGTCAATCCCAACACAAGGGTACAGTTAAAGGCTCTTGTGGGTGGCACTGCACCCATGACAATAAAGTGGTTTAAAGATAACAAAGAGTTACACTCAGGAGCAGCCCGCTCAGTTTGGAAGGATGACACCTCTACCAGTCTAGAGCTCTTTGCAGCCAAAGCTACCGATTCTGGAACCTACATTTGCCAACTAAGCAATGATGTTGGCACAGCAACCAGCAAAGCCACTCTCTTTGTAAAAGGTCTGGTCTCTACATCTCCTCACTTTCTTGCTTGTCTAGATTTTCTTGCCTGGGGTGGGCCGGGGCGGGGGACGCTTAAGACAGCAGTTTTGCCCAGTGACCTGTTTTTAAAAATATTCAACATCACAATTCTTTTTCCATCTTTAGAACCTCCTCAATTCATTAAGAAGCCCAGTCCAGTCTTAGTGCTGAGGAATGGACAGTCAACAACATTTGAATGCCAAATAACAGGCACTCCTAAAATCCGAGTGTCTTGGTATCTAGACGGGAATGAAATAACAGCCATTCAGAAACATGGCATTTCCTTCATTGATGGTTTAGCCACTTTCCAGATTTCTGGTGCCAGGGTAGAAAATAGTGGGACTTATGTGTGTGAAGCTCGAAATGACGCAGGCACGGCGAGCTGCAGCATTGAACTCAAAGTGAAAGGTTCGTGAATGGAATCTATTCTCCATTTTGGCTGTGCTGCCTGATAAGTTTGGGGTCTTCCCTTGAGTAAGCTACTGTCTTCCTTTTGAATCTTTAGAACCCCCCACCTTTATCAGAGAGCTGAAGCCTGTGGAGGTAGTAAAATATAGTGACGTGGAGCTGGAGTGTGAAGTTACGGGAACACCTCCGTTTGAAGTCACTTGGCTGAAGAATAACAGGGAAATTCGAAGCAGCAAAAAATACACATTGACCGACAGAGTGTCTGTGTTTAACCTCCATATAACCAAGTGTGACCCTTCAGACACTGGGGAATACCAGTGCATTGTATCCAATGAAGGCGGCAGCTGCTCATGCAGTACTAGAGTTGCCCTGAAAGGTCAGTTATACAAGAAGCAGCCTATCAAATAAAAATTCTGTAACGCTTTTAAATCTTATCATTATGGGTAGGAGTTACAATATGTTTCTTCTTTTCACACTCTCTTATTTAATCACAGAACCACCATCATTCATTAAGAAGATAGAAAATACCACTACTGTTTTGAAAAGTTCTGCCACCTTTCAGAGTACCGTGGCAGGTTCTCCTCCTATTTCTATAACCTGGCTAAAGGATGATCAGATTCTTGATGAAGATGATAATGTCTATATTTCATTTGTGGACAGTGTGGCCACACTTCAAATCAGAAGTGTGGATAATGGACACAGTGGGAGATATACCTGTCAAGCCAAGAATGAGTCAGGAGTTGAGAGGTGTTATGCTTTCCTTTTAGTACAAGGTTTGTAAGCTATTCTCTTTCAAAGATAGTCTATAGCGACAGTTTCATTAGCAGACATTATTTCTAGTGGAGTTACCAATGTAACTCATCCACATTTTCATTTTTACTACAGAACCAGCTCAAATCGTAGAGAAAGCTAAATCAGTTGATGTTACGGAGAAAGATCCCATGACCTTGGAATGTGTTGTGGCTGGAACACCAGAACTCAAAGTGAAATGGCTTAAAGACGGGAAACAAATAGTTCCCAGTAGATACTTTTCAATGAGTTTTGAAAATAACGTGGCCAGTTTTAGAATTCAGTCAGTAATGAAGCAGGACAGCGGTCAGTACACTTTCAAGGTGGAAAATGACTTCGGAAGCAGTAGCTGTGATGCCTACTTAAGAGTGCTAGGTTTGTATCTTCACCCCAGTCAGCTTCCCTTATTTATAGTATGTCCTTTGTAAACAAATAGCAAGAGATTAATGGATGTGTTTTGCTGTTTGCATTGGACAGATCAAAATATTCCTCCATCATTCACCAAAAAATTAACCAAAATGGATAAAGTTCTGGGCTCTTCTATTCATATGGAGTGCAAGGTGTCTGGTTCACTTCCCATTAGTGCTCAGTGGTTTAAGGATGGAAAAGAAATATCTACAAGTGCAAAATACAGACTTGTGTGCCATGAGAGATCTGTGTCTCTGGAAGTTAATAATCTGGAATTAGAAGATACTGCAAATTACACATGCAAAGTGTCAAATGTAGCAGGAGATGATGCATGCAGTGGCATCTTAACTGTGAAAGGTTAGAATTTCTTTACCTCTTCTTGATTCTTCCTTGCGAATGCTTCTTAAATGTATCACTCTTGCCTTTGTATCCTTTAGAGCTAAAATCTCTATGATTCTGGTTCTTTAGATACATATTCATTGTGTTCAAGAAATATTCAGCCATTGCCTCTTTCCAAGAGTGTTTTCTTAAATGTCCATAAAACTGTCACAATAATTCAACTGCAAGCAATTTAATTAAATATATCTCTCTTAAAATCTATAGAACCACCAAGCTTCCTAGTGAAACCTGGGCGACAGCAAGCCATACCTGATTCTACAGTGGAATTTAAGGCAATACTAAAAGGAACACCACCATTTAAAATAAAATGGTTTAAGGATGATGTGGAACTTGTCTCAGGTCCTAAATGTTTCATTGGCTTGGAAGGGTCGACTAGCTTCTTAAATCTCTACTCAGTGGATGCTTCTAAGACTGGACAGTATACTTGCCATGTTACCAATGATGTTGGTAGCGACTCTTGTACTACGATGTTGCTTGTGACAGGTGTGCAAATTTGATTCCTTTATGTTTCTGTCTGACTGTGTCTTTGGTTCTCTGTATTCAGTTACAATGTCTCTAAACAATCAAGAAAGTAGTATTCTTTCTAACATAGTAAACAGTATTTGCTCATGTTTTTCTCTTGCCTGTATACTATCTAATTTAACTATTGTTATTTATTTCTGTTCCCTGATACTCTCCTCTTTCCTGACTCTTTAGAACCACCAAAGTTTGTAAAGAAATTAGAAGCCTCCAAAATTGTGAAAGCAGGTGACTCTTCACGACTTGAATGCAAGATAGCTGGATCCCCAGAAATCAGAGTTGTGTGGTTCCGAAATGAACATGAACTTCCAGCCAGTGATAAGTACAGAATGACTTTCATTGACTCAGTGGCCGTCATACAGATGAACAATCTCAGTACTGAGGACAGTGGAGATTTCATTTGTGAGGCTCAGAATCCCGCTGGCAGCACAAGCTGCAGTACCAAGGTTATAGTAAAAGGTAGACATCTTGTTCTTGTGTTTCTCATTAAATGAAAACCACCTTCTCCCCTGGGTATTATAGCTCTTTATTCATTTACTATCATTTTAGTTTCCATTTGAGATCATAGAATATTTTTCTGAGCTAGTATTATTTCCCTTTTTAGATGGTTTCCTTCTTGAATTTTGCTTACATGTAACTAGTCATTATGAAATATTTTTGTTATTCCAGTGTCATAATTCTGATTACCTCAACACATTTGCCAAACATCAAACGTGATGTTTCAAAACTGCACAAAAAAATGAAGTAGGCATTTTAAAATTAGTCTTTTGCTTTCAATCAACTTACAGATATATCATTCTCACTATAATCTATATCATTAATAACAAGCACTTTTACTATATCTATGCAAAGTGAAAGCAATACAGGTTTTAAACTTATGTTTAAAACAGGACAATAATATTTTTTCCTTCTCTCTCAAGGATCACTTCCTATCCTTTAAAAATTATATGACTATACCTTGGTACAAATAGTATCTGTGTTTTTTTGCTGCAATTTTCCAGTGCTTTTTTTTTTTGTCACAAAGGCCAAGTTTGTCTTGTTTTAAGACAATTATTGCAGTAATCATTTGCTGAAATGGAAGACTTAGATCACGGATGTTGTGATGACTTCCAAGTGTCTGTTATAGAACATATACAAAAAAAATCATCCTTGAAATTAGAATTCCATACTTCATGCAAATCATTATTTATTGCTATACTTGCTTGTTTGCAATTTTTGTATCAATCTTTGTAGCCTAAGATACATCAGTAAGGTGTAGTAGATAGAATGTTGAACTGTTCAGTAACGACATCTAGGATCTATCTGGGTTCTCTGCCCATCTAGCTGGTTATCTTGTGAAGGCAAATGGCTTCTGAGGCTGTTATCCCATGAGAGTGTTAGTGCTGGACTCTACTTACCCATTAGAATATCTTAAACCTTTCTTCCAATTTAAAGACAAATAAAAAATTTTCATTTTGTGAAATTCAGTAGCCCAATTCATGAGAAATTCTTGTTTTTTGCAGAGCCACCTGTTTTTAGCAGCTTCCCTCCTATAGTAGAAACCCTTAAAAATGCTGAAGTCAGTCTTGAATGTGAACTTTCGGGAACACCACCGTTTGAGGTGGTATGGTACAAAGACAAGCGGCAACTCAGAAGCAGCAAGAAATACAAGATTGCATCCAAAAACTTCCACACAAGTATTCACATTCTCAATGTGGACACTTCAGACATCGGTGAATACCACTGCAAAGCACAGAATGAAGTGGGAAGTGATACTTGTGTTTGTACTGTAAAATTGAAAGGTAAATATAGTTCATCCACATGGCAGAAATGTCATAAATGTGCAAAATCCTACTTTTTTCACTCTCGCATGATCTGGACAATCTTTTCAACAATTTCCATCCATCTTTTCCTGTTCAGAACCACCAAGATTTGTCTCCAAACTGAACAGCCTCACTGTTGTAGCCGGAGAGCCTGCTGAATTACAAGCATCCATAGAAGGCGCCCAGCCTATTTTTGTCCAGTGGCTTAAAGAGAAGGAAGAAGTGATTAGAGAAAGTGAAAACATCAGGATTACATTTGTGGAAAATGTTGCAACTCTACAGTTTGCAAAAGCAGAGCCAGCTAATGCTGGAAAGTATATCTGCCAAATCAAGAATGATGGTGGAATGAGGGAGAACATGGCCACACTGATGGTCTTAGGTTGGTACAATAGCCCACGATAGAAACTGGTGCCAAATGCTGGAATGAATTACTAAGAGTTACTGGCAGATTCTTTTTCTGAGTTTCTTCTAGAACTATATTTATCCTCATCTATTTGAAAGGTCTAGAGGAAAGACATAGTTGATCTTTCAAACACTCTTTTCTGTTTCTGTGATTCTAACAAAAATTAGACATCTGTTTTATTGTTTAATAACTACCTGTCTATATCAATTAGCAGATACAATCATGACTCTCTTTGATTAAGCATGAAAGAATACAGAGCCCAGCATGTGCTACAAGAGTAATTGTTAAAACTAACAAGAACTCCAAAGGTTGGCATTTGATAGCAAAGCTTCCACATAAAATTAATGACAATTAAACAATTGTTTGAATAACAACTTTCAAAGAATTGTCTTTAGCACCTTAAGGTAGAGCAAAAATACCAAGTAATTCACAATAACCTGTAGACTTTGATCTACAGAGGGTCAAGTGGAAATCAATATATACTATCTAATGCACATTGTTTAAATTGTTTTGAAGTTGAGTCATGCACGAACATATATTTCTTAAGAATAATTGCTACATAAGACGACAGCAAGAGTGGTGGGAAAAACAAAAAATAAAGAAAAAACTGAAAAGAAAAAATATTAAAATAAAAAATAGCTATAATTCTATGACTGCATGTAATTATGGAATCACACTTTAAAGTCGAGAGAGAGAGCACCCTAACATAACCATCTCACTGGGAGAAACAATCTTAGTGAATGTGATAGTAGAGACAGAGTAAAGATCCCAGACTTTGACAGATGGATATCACGTTTTATTTCAGAGCCCGCAGTCATTGTTGAGAAGGCAGGACCGATGACGGTGACTGTAGGAGAAACGTGCACTCTGGAGTGTAAGGTGGCTGGCACTCCGGAACTCTCTGTTGAATGGTACAAGGATGGAAAGCTGTTGACCAGCAGCCAAAAACACAAATTTAGCTTCTACAACAAAATCTCTTCCTTAAGGATTCTCTCAGTTGAAAGGCAAGATGCAGGCACATACACTTTCCAGGTTCAAAATAATGTTGGGAAAAGCAGCTGCACAGCTGTGGTTGATGTTTCAGGTTAGTTCTGCTGTTTTCTTCTGGTTGCTTATGCAAATTCCTTTTACAAGTTTCCTTCTTTCAAGTCTCTTCTATTCTTTCAAATCATGATGAGTCTCTTACCTTTCCTCACACAGACCGAGCAGTTCCTCCCTCTTTCACACGAAGACTGAAAAATACTGGTGGGGTGTTAGGTGCTTCTTGCATCTTGGAATGCAAAGTAGCTGGATCATCACCTATTTCAGTTGCCTGGTTTCATGAGAAAACCAAGATTGTCAGTGGAGCAAAGTACCAAACCACATTTTCAGATAATGTCTGCACATTGCAGTTGAATTCTCTGGATTCCTCAGATATGGGCAATTACACATGCGTGGCTGCTAATGTCGCTGGGTCTGATGAATGTCGTGCAGTGCTAACTGTACAAGGTCAGTAGACAGTCAAACTTGTAAGGAATTTCTTACAAATTCCTCTTCAGGTGCACATCTATGTTGACAAACATTTGAAAGTGCTCTAATGTTTTATTCAAAATTGCAACTCCATCTGAAGCTTACAGGATCTTTTAATTGTTCTCCATGTCTATATAGAACCACCCTCTTTTGTGAAAGAACCTGAACCTTTGGAAGTACTACCAGGCAAAAATGTAACCTTCACAAGCGTTATTAGAGGAACCCCTCCATTCAAAGTCAACTGGTTCAGAGGTGCCAGAGAACTAGTGAAAGGAGACCGGTGCAACATCTATTTTGAAGACACTGTGGCAGAACTGGAATTATTTAATATTGACATATCTCAGAGTGGGGAATACACCTGTGTGGTTTCTAACAACGCTGGCCAAGCATCTTGCACTACCCGTCTCTTTGTGAAAGGTTTGCTCAAGTGGATTCACTTTTTCTGTTTTCTGTATACCGACATCCTTGTGTTTTTCTTGTGTTTAACTGCTGTGCTTTGTCACTTACTAGAACCAGCTGCATTTTTGAAGAGATTAAGTGATCATTCTGTAGAACCAGGGAAGTCCATAATTCTGGAGAGCACCTACACTGGAACACTTCCAATTTCTGTCACTTGGAAAAAGGATGGTTTTAACATAACTACCTCTGAAAAATGTAACATAGTCACAACAGAGAAAACTTGTATCCTGGAAATTCTGAATAGCACAAAAAGAGATGCAGGGCAGTATTCCTGCGAGATTGAAAATGAGGCAGGAAGGGATGTTTGTGGAGCTCTGGTATCTACATTAGGTGTGTTGTCTTATTGTCTCTTAAATCATTTGCATTCTTCTAACATGTAGCATAGTTTCTTTGATATTCATTAATTCCAGTTGCTAACTGTGAGCCTTTCTTCCTTAGAACCGCCTTATTTTGTTACGGAACTGGAACCTCTGGAGGCAGCAGTTGGAGATTCGGTTTCTTTACAATGCCAAGTTGCTGGGACACCAGAAATTACAGTGTCTTGGTACAAAGGAGATACCAAATTACGGCCAACTCCTGAATACAGGACCTACTTTACAAACAATGTGGCCACACTTGTTTTTAATAAAGTGAACATCAATGACAGTGGAGAGTACACATGCAAAGCAGAAAATAGTATAGGAACTGCTTCTTCTAAGACTGTGTTCAGAATTCAAGGTGATGATATTTTACAAATTAAAAAAATTCTTTTTTCCTTAACTCTTGTATCTTTATGGTGAACTTCTCATTTCATCTCCTAACACCTTAAGTATTACATGTCTCCCTACAGAGCGCCAACTCCCACCTTCTTTTGCAAGACAATTAAAGGACATTGAACAAACTGTGGGGTTACCTGTTACACTCACTTGTCGATTAAATGGCTCTGCACCCATCCAAGTGTGCTGGTATAGAGATGGAGTACTTTTAAGAGACGATGAAAATCTACAGACTTCATTTGTAGATAATGTGGCAACTTTAAAAATTTTGCAAACTGACTTGAGTCACTCTGGCCAGTACTCTTGCTCAGCTTCCAACCCACTTGGAACAGCATCTTCTAGTGCTAGACTCACAGCAAGAGGTTTGTTCACACGTCACTCTTTTTCTTTGCAAACTGTGGCTTCATATTTCATTGTCAAAGTAGAAACGACCAATGGCAAAAAAACAAACAAAAAATACACATTGCCTTTCTTCTCATCCTCCAGAACCCAAGAAATCTCCCTTCTTTGACATCAAGCCTGTATCTATAGATGTTATTGCTGGAGAAAGTGCTGATTTTGAGTGTCATGTTACTGGTGCTCAACCGATGCGAATCACTTGGTCAAAAGATAACAAGGAGATCCGTCCTGGAGGAAACTATACAATCACATGTGTGGGAAACACTCCTCATTTGAGAATTCTTAAAGTAGGCAAAGGAGACTCTGGTCAATATACTTGCCAAGCAACCAATGATGTTGGCAAAGACATGTGCTCAGCTCAGCTCAGTGTAAAAGGTATCATTCCATGACTTTTGACAATATTTGTTCCTTACCATATTTGCATAATTGTCTTATAAAAGTTTCTTTGGTTTTTAAATGTTTGAGAGAAACTAACTGGACATGTTAGAATTTGTGTATTAGTGTTGGAGGCAACATTAATCAAAGTTGTGTTTTCTCTTTATATTGTTCTTTACATTAGTGTAACTCTAAGTGTAATCTTATCAAAAAGTATTGTTTAATTGAAATTTGTTAAATGTTGTTTTAACTATCTAGTCCATTTTTTAATGCTTTCTTGTTATATGGCATTCTGATTTATCATTACTAAATGTTGATCAAATACATCTATAATACATTAACTTTTATGTTTTAACTTACATAGTCAAACTAAAAAAAAGAATCAACTAAATTCTCTATTAAAAATGCACATGTACCCTAAAACTTAAAGTATAATAATAATAAATTTTAAAAAACTAAAAAAAAAATGTTATGAGATTATTTAACTTAAAAGATAACTTATTTTACTGTAAAATCCTCAGAAAGTATATTCTTAATAACAAACCAGTTTAAATATAAATTTATGGGATCTTCAGCTACAAAAACAAGCTCTTTTAACATGTATAATAAATATCCCTTACTGACTGTTTTGTTTGGTTTACTAGAACCTCCAAAGTTTGTTAAGAAATTAGAAGCTTCAAAAGTTGCAAAGCAGGGAGAATCCATTCAACTGGAATGTAAAATAAGTGGCTCCCCAGAAATCAAAGTTTCATGGTTCCGAAATGACAGCGAACTTCATGAAAGTTGGAAATACAACATGTCATTCATTAATTCTGTGGCATTGCTTACGATCAATGAAGCTAGTGCTGAAGACAGCGGGGACTACATTTGTGAGGCTCATAATGGTGTTGGTGACGCCAGCTGCAGCACAGCGTTGACAGTGAAAGGTTAGACACACTAAGCTTCTTTGTTTCTTTATTCTCCTCTGATTTGGGCTCTTAGCAAAGTTATGAGTTCCAAAATAAAAGGATAATTAAGGTTATTTGGTTGCAATTCTTCAACAAGTTTTAATGAATTGTCATTTCTTGTGTCAGCATGTATTGTCATATGATCACACCAGTCACTCTTCAAGGTTCTAGATTTAATTTTTTTTTCCTTTATAGTAAGCAAGTGTTCTCATTGTTTATCTCCTTTTTTCTGGTAGCACCTCCTGTTTTCACCCAGAAGCCTTCTCCAGTAGGAGCTCTTAAAGGTTCTGATGTGATTCTCCAATGTGAAATTTCGGGAACTCCCCCATTTGAAGTAGTATGGGTTAAAGATCGAAAGCAGGTTAGAAACAGCAAGAAATTTAAAATCACTTCAAAACATTTTGATACAAGTCTTCATATCCTTAATCTTGAAGCCTCCGATGTCGGGGAATATCACTGCAAAGCTACTAATGAGGTGGGAAGTGACACGTGTTCTTGCTCTGTCAAGTTCAAAGGTTTGTATACATGGACACAAAAATATATGCCCCTTCCTCCTATCTGTTCTTGCCTAACTAATAACTTGTGTGGCCATGATTCTCACATTTTTTCCTCTAACCACAAATTTCTTTCATCAGAACCTCCACGATTCGTGAAAAAGCTAAGTGACACCTCAACCCTTATTGGGGATGCTGTTGAGTTACGGGCCATAGTGGAGGGCTTCCAGCCAATTTCTGTTGTCTGGCTGAAAGATAGAGGTGAAGTCATCAGAGAGAGTGAAAATACCAGGATTTCATTCATTGATAACATTGCAACCCTCCAGCTGGGGAGTCCAGAAGCATCTAATTCTGGAAAATATATATGCCAAATCAAAAACGATGCTGGAATGAGAGAATGCTCTGCAGTCTTGACTGTACTAGGTTAGTAGCAAAGCACAGCCAGAGAAAAAATCAATTTACTTGATCCATGATCATTTTCCTCAAATATTCCTCTTATCCAGTAATTCAGTGATTGCACTCTTGAGTTTGAAAGGTTACTTTGTTTTCAATGCAAAATACTTCTTCTTTTAGAACCAGCAAGAATCATAGAGAAGCCCGAACCCATGACTGTCACTACTGGAAATCCTTTTGCATTAGAGTGTGTAGTGACTGGAACACCAGAACTCTCAGCCAAGTGGTTCAAAGATGGAAGAGAATTGTCTGCAGACAGCAAACATCACATTACATTCATCAATAAAGTGGCTTCCCTTAAAATCCCCTGTGCCGAAATGAGTGACAAAGGATTATATAGCTTTGAAGTGAAAAACAGTGTTGGCAAAAGTAACTGCACTGTATCCGTCCATGTTTCTGGTGAGTAGAATGAGATTTTTATGAATATACAATATTTCCAGGGGGTGGAGGGGCACAGAATAAAACTTCTCTTTAAACGCAAAACTACCCTTCCCCACATAGATCGGATTGTGCCTCCTTCCTTCATCCGCAAGCTGAAAGACGTGAATGCCATCCTGGGGGCCTCAGTTGTTTTGGAGTGCCGAGTCTCTGGCTCAGCCCCGATTTCAGTTGGCTGGTTTCAGGATGGAAATGAGATTGTTAGTGGGCCCAAATGTCAGTCCAGCTTTTCGGAAAACGTCTGTACTTTGAATCTGAGCTTGTTGGAGCCCTCCGACACAGGCATATACACGTGTGTGGCTGCCAATGTAGCTGGTTCCGATGAGTGCTCAGCAGTCCTGACTGTGCAAGGTCAGTGTGCAAGGATAAAGCTGCTGCTTCTCTAACACCTCTTTCATGTGGACGTGGTGCCTGCCTTCCCTGGAGTTTCTTTATTTTGTCTTCATGTTTAGTCTTAGCTCCCTTTTTTTAAGGAGCAAAAGCACTTCTCACTTGGATTTCTTTCTTCTCTTTATCTCCCCTTCCGCCTTGCAATATCTAGAACCACCATCTTTTGAACAAACCCCTGATTCTGTGGAAGTTTTGCCTGGAATGAGCCTCACATTCACCAGTGTCATCAGAGGCACCCCTCCTTTCAAGGTCAAGTGGTTTAAAGGCAGCAGGGAACTGGTGCCTGGGGAGTCATGCAACATCTCTCTGGAAGATTTTGTCACAGAACTGGAGTTGTTTGAGGTGCAGCCATTAGAAAGTGGAGACTATTCTTGCCTCGTTACAAATGATGCTGGCAGTGCTTCCTGTACCACACATCTTTTTGTGAAAGGTTTGCTCTTTCCCCCAATATATACATCTTTTAAAATTTCTCTTAAGTCTTCATTAGAAGGCAAGAATTTTACCCACATGTTTTCTCCTTATAGAACCAGCCACCTTTGTGAAAAGATTGGCTGATTTCAGTGTTGAGACAGGAAGCCCCATAGTTCTCGAGGCCACATACACTGGCACACCTCCAATCTCAGTGAGCTGGATAAAGGACGAGTATCTTATTTCACAATCTGAGAGATGCAGTATTACTATGACAGAAAAATCTACCATACTGGAAATTCTTGAGAGCACAATAGAGGATTATGCACAGTACAGCTGCCTGATAGAAAATGAGGCTGGTCAAGATATCTGTGAAGCTCTGGTGTCTGTCTTAGGTGTGTTGACAGCTACCTCTTTTTATTGCTCTCTTTCTTTTCAAACATCCTCTTTTACATGGCATGACTGACTTGCTGACTACCATCCTTTGTACCATAGAACCACCGTACTTTATTGAACCTCTGGAACATGTGGAAGCAGTCATTGGAGAACCTGCAACTTTACAGTGTAAAGTGGATGGAACTCCAGAAATTAGAATTTCTTGGTATAAAGAACACACAAAGCTACGATCAGCTCCTGCATATAAAATGCAATTCAAAAATAACGTTGCTTCCTTAGTAATCAACAAAGTGGATCACAGTGATGTGGGAGAGTATTCATGCAAGGCAGACAACAGTGTGGGGGCAGTCGCTTCTTCAGCTGTGCTTGTTATCAAAGGTGATGGTGTTGTTTAACCTAGTGTGTGTGAACAGATTCATTTTCTTAAAAACGTTAAAACTTTTATGAATTGAAATATGTTGTGGATGCCTTCTCACCTGTAAATAAGGATTATCTGTAACTTCTTTACAGCGCGCAAACTTCCACCTTTCTTTGCAAGAAAACTGAAAGACGTTCATGAGACTCTAGGCTTCCCAGTTGCATTTGAATGCCGCATCAATGGCTCAGAACCTCTTCAAGTGTCTTGGTACAAGGATGGGGTTCTTTTGAAAGATGATGCTAATTTGCAGACATCTTTTGTTCATAATGTAGCAACTCTTCAGATTTTACAAACTGACCAGAGCCACATAGGGCAGTATAATTGCTCTGCTTCTAATCCTCTTGGGACTGCTTCATCCAGTGCCAAGCTCATTCTCTCAGGTGAGTAACTCACAGTACCCTCTTCATTGTAAAGCAGCTTCACTGCTCCAGGCCACCAAAAGGCTGGTGCCATTTAGTTTCTGCTCTGTATGTGAGAGCATGGAAATAAAAATCACCATGTTGGTCTTCATTCTTTTCAGAGCATGAAGTGCCTCCTTTCTTTGATCTAAAGCCTGTATCAGTAGATCTTGCTCTTGGAGAAAGTGGTACTTTTAAATGTCATGTAACTGGGACTGCACCAATCAAAATCACTTGGGCCAAAGATAACCGAGAGATTCGCCCTGGAGGCAACTACAAGATGACTTTGGTAGAAAATACTGCCACTCTGACAGTTCTCAAAGTAGGCAAAGGCGATGCCGGGCAGTACACCTGCTATGCAAGCAACATCGCTGGAAAAGACTCTTGTTCTGCTCAGCTGGGTGTACAAGGTACTTGTTAGAGTGAAGGAGCAAGATCTCTTTTACATTTTCAGTATCTTAAAATATAGGAGGGTGGGTGTGCTTGAGAGAGAGCTATGTTTAGGACCAGGGTCTAGTGATGAAAATGGATCAAGTGGATCAAGGACCTTCCAAATGGAGACAAGTATTTTTTAATTACTTTAAAAAAAAAATTTAAAACTAGGAAAACATGGACCAAAAGTCCATTTTAAGAGACTAAAAATAGAGACTAGAGAGAGATAACCGAAACTCTACAAAATTGCAAGAAAATCCTAGTTTGAAAGACGGTATCATAGGACAAAAGCGAAGTTATTGCAAATGACTTTTTTCCCACAGTACTTAGTAAATGAATGGATTTTGTCCCTCTAAGGCATAGCAAAGAGCCAAACTATCAAGCCCTTCAAGGAGAATTCAGATGAGAATGATAAGTTCAACTTACTTTCCTCCACTAGCCCCACTTAAATAATAGTGGAGGTCAGGGGCTGGGGAGTAAGTAGATCAGTATCTGCTATTATGGAAGGCAGTCATGTGTTTCTGCCACATGTTTATCGCTGCTACTGTCAGAAATTAAATAGTTCACTCAATGGACTGCTAGTCTAGTCCATTAGAGTATTTTTAAGGGTTTTTGTAGTGGTGGTTTATAAATATCTTGAAATTAAAATATAATTAGATTTAGCAGCCCATTTGCTCTATGACATATAGCTAATCACTTTTACTTCCCTATGCCTGAATTTTTTGCTTCAGTTAATGAGGAAATCATTACTCTCACACACTTCAAAGGAAAATTATGAAGGTTGAGGAAATACCCATTTAACACCTAAAAGAGGAAAATGGCATTTTAAAAATATTAAGATATCTGACCCACTTTGCCATTCCGGCTCTTCATGCTATGTAACTGATAGCATTGCAGCCTTAGGAAATAGTTCTCCACTGGTTCATATACAAGACAGTAATCAAATTCTCATTCCCCGTGGACCTCAGAGGGCTTCCACTGACAGATACATGCTATTATCTCTGATCTTGGCACTAGAGAAGGGACTCTTTTGCTGGGGAGAGGATGGCACAATAAAGAGTAATGTCTTTTTCTCCTTCTTTTAGTAATAATACTTGATGTGGATGCTTACAAAAACAAGCATATTTTATTTTAGAAATTTTCTATTTAGGTTTCATTTAACTCTTCTTCCTTGAACTGCATAAATTTGTTTTCCAGAGCTAAAGACCTCTCTAGCAAAGATTATTTTTTCCACCTCATCTTGAATTATATGCATCTGTTCCATCCCTTACCCTGTGTTTTTCCTCTTGGTTCCATAGAACCACCCAGGTTCATTAAGAAGCTAGAACCTTCAAGAATTGTGAAACAGGATGAATTCACAAGGTATGAATGCAAAATCGGTGGGTCTCCAGAAATCAAAGTTTTATGGTATAAGGACGAGACTGAAATTCAAGAGAGCAGTAAATTCAGAATGTCATTCGTTGACTCGGTGGCTGTGCTGGAAATGCACAATCTCAGTGTTGAAGACAGTGGAGACTACACCTGTGAGGCCCACAATGCAGCAGGCAGTGCCAGCAGCAGCACATCCTTAAAAGTTAAAGGTCAGCGCTCTCCCCACCTGTGTGTTTTTCACATTAGCCTCCTCTTTAATTGTCCTCTTAACTTCCTGTTTGACTCTTCAACGATGTTTTAAAATAGGGAAAGGACACAACAAAGAATTGAAAGTGTTTTTTTCACTCTCTATCTCTCTGATGGAGTGGAAGATTGATTCTTACTTTTAACTATATACTTACAGAATACATCCGTATTTTCCTTTTTTCCAATTTTAGAACCACCCATTTTCCGCAAAAAGCCTCATCCTATAGAGACACTGAAAGGAGCTGATGTTCACCTTGAATGTGAGCTTCAGGGCACTCCCCCATTTCACGTTTCTTGGTATAAAGACAAGAGAGAACTTAGGAGCGGCAAGAAGTACAAGATAATGTCTGAGAACTTCCTAACCAGTATCCACATCCTGAATGTCGATGCTGCAGACATTGGGGAATATCAGTGTAAAGCCACAAATGATGTGGGAAGCGACACTTGCGTTGGTTCCATCGCTCTCAAAGGTTAGATGGACTGCATTCACTTCTGCTCACTACTTCCCTTCTAATTGTAATACTCTGTTGCCCCCTCCACCCCAGCCCAGTCTTATCACTAGCAGCCTATTCCACTTTCCCTTTGTTTCCTCTCCAAGTCCTTTTCTGTTTAGTCTGCTTCCCTTTTCCAAATCCTACTGAATATCCTTTTAGATAATGTTGTAATTAGGTTTTGATTGGATTAAGAAAGCTGGAGTAGATGAGATATTCAACTTTCCTACTGAATACAAACTTTAATGTGTCCCTGCTCGCATCCACCAAAAATGCCTCTTAAATGGAAATAACACATTATCACTAGTTTGATTCCCGGCATTCACGATTTGAGCAAAATGCTGTCAGTCTCACAAATTTTAAAACCCAGGCTTTCCTCCTTTTTCATCAGCACCACCAAGATTTGTGAAGAAGCTCAGTGACATATCTACTGTCGTTGGTAAAGAAGTTCAGCTGCAGACTACCATTGAAGGCGCTGAACCCATTTCAGTGGTGTGGTTCAAAGATAAGGGAGAAATCGTTAGAGAAAGTGACAACATATGGATTTCTTATTCAGAAAACATTGCAACCTTACAGTTTTCAAGAGTGGAACCAGCCAATGCTGGAAAATACACTTGTCAGATCAAAAACGATGCTGGGATGCAAGAGTGCTTCGCCACGCTATCCGTTCTCGGTTAGTAAAAAGATGATGTTATCACAGATACAAGGCACACACTCACCAGGATCTGTATTTTCTTTAGTTTTTCAATTTGAGTTTAAAATATGGATATCTTTTACATTTCATTCCAGAGCCTGCAACAATTGTAGAAAAGCCAGAATCCATAAAAGTTACCACGGGAGACACCTGTACCTTGGAGTGTACAGTAGCTGGCACCCCTGAACTCAGTACTAAGTGGTTTAAGGATGGAAAAGAGCTAACAAGTGACAACAAATACAAAATAAGCTTCTTCAACAAAGTATCCGGCCTTAAGATCATCAATGTAGCACCGAGTGACAGTGGGGTATACAGTTTTGAGGTGCAGAACCCTGTTGGCAAAGACAGCTGCACAGCTTCATTGCAGGTTTCAGGTTGGTTGATTTCTTGGGCTTTTCCTTCATCATTATAATAATGTAGTTCCTGATTTTCATAAATGTATATGGGTTGTTACATCTTCTATAGGATAACATGAGTCCGACATCTTCTGAATCAGCAAATTCAGAGGCAATACCATCTGTAGAATTAGAAGAAAACCATGTTCAAAAGTTATATCCCTTTCTTTTTGAGGAATTTCCAAAATGATGATAGGAATGAAAAATAGTCCCTGGATAAGGTTAAAGCAGTCTTCATTTATGCTGAAATAATTCACCACATAATTCTTCACGGCAAAGAGAGAACAAAATCCCTAGCAAGTCAACCATCACATTCTGCCCACTGATTCTCCAAGCTTTTGATAGTGTGAACCCATAGAGGAGTTTTTAATACCGTCACAAAAGAGCCAAATGGATCTAGGGATAGTCCATCAAAAAGACAGTTCTCTCTTCAAGTCATTTTATAATTGTTGTCCTTTGTTTTTTTTGTTTTGTTTTGTTTTGTTTTGTTTTGTATCATTCAGACCGAACCGTTCCTCCTTCATTCACAAGAAAATTGAAAGAGACAAATGGTCTATCCGGCTCCTCAGTTGTAATGGAGTGTAAAGTCTATGGGTCACCTCCAATCTCTGTCTCCTGGTTCCATGAAGGAAATGAGATCAGTAGTGGAAGGAAATACCAGACCACCCTGACAGATAATACTTGTGCTTTAACTGTGAACATGCTGGAAGAATCAGACAGTGGTGACTACACATGTATAGCTACTAATATGGCTGGTTCTGATGAATGTAGTGCTCCTTTGACTGTGAGAGGTCAGTTTACAAAACAGTAAAATGAATTGCATTTCATAGTTTATTAAGCATGTTTGTCATAACAATTCACAAATACTAAACCTTTTCTGATATGTGCTTTTGTGTTTAGAACCACCATCTTTTGTTCAGAAACCTGATCCCATGGATGTTTTAACTGGGACCAATGTAACTTTCACAAGTATCGTAAAAGGAACACCTCCTTTCAGTGTTAGCTGGTTCAAAGGTAGCAGTGAACTAGTACCAGGTGACAGATGCAACGTGTCTTTGGAGGATTCAGTTGCTGAACTGGAGTTGTTCGATGTAGATACATCACAAAGTGGAGAATATACTTGCATAGTTAGCAATGAAGCTGGCAAGGCTTCTTGTACAACACATCTCTACATAAAAGGTTTGTCAGACTGCTCTTCTAGATTTATACGATTAGTAATTAGATGTGTCTTTGTCTGTATGTATATGTGTTTGATTTTATATTTTCAATTTGGTCACTTTAGCCCCAGCCAAATTTGTGAAGAGGCTGAATGATTACAGCATAGAGAAAGGAAAACCCCTGATCCTAGAGGGTACATTCACTGGAACTCCTCCCATTTCGGTTACCTGGAAGAAAAATGGCATAAATGTAACTCCTTCTCAGAGGTGTAATATAACTACGACTGAAAAATCGGCAATCCTGGAAATTCCAAGTAGCACAGTAGAGGATGCAGGACAATACAACTGCTACATTGAAAATGCCTCTGGAAAAGATTCCTGTTCAGCACAAATACTCATACTAGGTTTGTCATGATTGCACATTTTTATCTTTGTATACAATCGATGATCTGGCATGTCTCCTTCATGACTGATTGATTATCTCTCTTGGCTGCAGAACCACCGTATTTTGTCAAGCAGTTGGAGCCGGTTAAGGTGTCTGTTGGAGATTCTGCCTCTCTACAATGCCAGCTTGCTGGAACCCCTGAAATTGGGGTATCCTGGTATAAAGGAGATACAAAATTGAGACCCACTACGACTTACAAAATGCATTTTAGGAATAATGTTGCTACACTGGTTTTCAACCAGGTTGATATTAATGATAGTGGAGAATATATCTGCAAAGCTGAAAACAGCGTGGGAGAAGTTTCTGCATCAACTTTCCTTACCGTTCAAGGTGATTGCAATATTTTTAAAGTGAACGAATTTGTGTTTCTTTTGAACAAGATTTAAAATGTCTGGGGAGGCCTATTTTTTAGGAAAATCTTTCCAAAGGCTTAAAATTCTGCTTAAGTAATCCTATTTACAGTTAGTGGCTTATCTTTTTCTATGGATTCTACAGAGAGATAATATGACTAAATCTTTAATTGGAAGGATTATGCAATCATTTGCTTCTATAATTAAATCTTTTTTAAAAAGTGACCATATATTTTTAAATTCCACCCCGTAAGTATCTCATGCAAATTGCTAGAAGGCAGTCTTTAAAATTACAGGAATCTGCTGCTTGCCCAGAGACATGCCTTCAGCCAACCAATTGCTTTATTGGTTTTCATACTGTTTTGCACCTACTGTGCATTAGGGTTGGTCTCAGAGTGATACTTTTGCTCCAGAAATCTATATGCTTTTCTTTATCTCCAAGTTAATTCAAGAGACATTAATAATTCCTGATTTTTAATAGAAATTGCATATATACGTGCGTTTGTATATATATAATTGTGAGAAGAGCATTTAGTAAATTAAAGTATTTGTTACTTTTATTCTGTTCCTACAGAGCAAAAACTTCCACCATCATTTTCTCGACAATTGAGAGATGTTCAAGAAACAGTTGGACTGCCAGTTGTTTTTGATTGTGCCATAAGTGGATCAGAACCTATCTCCGTGTCTTGGTATAAAGACGGCAAGCCATTGAAAGACAGCCCAAATGTACAAACATCATTTTTAGACAATACAGCCACACTCAATATTTTTAAAACTGACCGGAGCCTTGCAGGCCAGTATTCCTGCACAGCTACAAACCCTATAGGCTCTGCTTCTTCCAGTGCCAGGCTCATTCTCACAGGTTTGTGGATTCTTAAACTTTCATTTCTAGAATTAAAGTATTATAATCAAATATGAACTTAGGGAGAAATTTCTATTTCAGTAAACTGACATGGTCCAGATATTGAGCCTGAAACCTTGTCTTTCTGCTCTACTATTAGAGGGGAAGAACCCACCCTTCTTTGACATCCGTCTTGCCCCTGTGGATGCTGTGGTGGGAGAAAGTGCTGACTTTGAGTGCCACGTCACGGGCACACAACCGATAAAGGTCAGCTGGGCCAAAGACAGCAGAGAAATACGAAGTGGCGGAAAGTACCAGATTAGTTATCTGGAAAACAGCGCCCACCTGACAGTCCTCAAAGTAGACAAAGGAGATTCTGGACAATATACCTGCTATGCTGTGAATGAAGTGGGAAAAGACTCTTGCACAGCTCAGCTGAATATAAAAGGTATCGTTTATTTTGCAAGTGGTCCAACAAAAGTGTAATCATTTTGTAGTATAGCCTGAAGGTGTCGTTTTTATGATGATGAATGCAATTTAGGACATTTTTAAACAAATGAAAAGAAAATGTTTAAGAGGAAATAAGTTTATCTAGAGAAGAAGTCATTTTTTAAATCTGTATTTCTTTCTTTCCTCGAGACAGGATCTCATTCTGTCGCACAGGCTGGAGTACAGTGGCGTGATCTCAGTTCACTGCAACCTCTGCCTCCTGGGTTCAAGTGATTCTTGTGCCTCAGCCTCCTGAGTAGCTGGGATTACAGGCGCCTGCCACCATGACCAACTAATTTTTGTATTTTTTGGTAGAAACGGGGTTTCACCATGTTGGCCAGGTTGGTCTGGAGCTCCTGACCTCAAGTGATCCACCCGCCTTGGCCTCCCAAAGTGCTGGGATTACAGGCATGAGCCACCACACCCAGCTTATAATCTATATTTCTAAAACTTTATATATTCCCTATGATACTGAGACTACCCCTTCTTTTTACAAATTTGTGATTCTCTAAATGGCCATGAGTTACTTCTTATCATCCACCTTGTAAGTCAAAGAACAGTTTAGAATAAGCTCGTAGAAGGAGGCTGAAATGTTTAGGAACATATTCTGATATAGTGTATTTAGTTGGTTAGCCTTGATTTTTAACTAAAAATATGAGGGTTTTTTTTCTTGAAAAGCTTCATATTAGTAATCTGCTTCTAGCTTCTACTTCATATATCCTTGCAATTTCTTATAGAGCGGCTCATCCCACCAAGTTTCACTAAAAGACTCTCAGAGACAGTAGAAGAAACAGAAGGGAATTCTTTCAAACTTGAGGGACGTGTGGCTGGTTCCCAACCTATAACTGTTGCCTGGTACAAAAATAATATAGAGATACAACCAACTTCTAACTGTGAAATAACATTCAAGAACAACACGTTAGTGCTGCAAGTCAGGAAAGCAGGCATGAACGACGCTGGTTTGTACACATGCAAAGTGTCCAATGATGCAGGCTCTGCTCTGTGCACGTCTTCAATCGTCATCAAAGGTGAGTTATCCTCACAGCCCCAACCTGTTGTGTTTTTCTTCACTGCCTGTTATATATCCATGAGCATTTCTTATGATATCTTGACCAAGTAAGTTATAACAAATATAAATACACATTATTTAACTGTGTATTTATCACTCCATATGTTTACTAAAAATATAAATTATTGTAATTTAATTATGTGGCTTCCCGAAGGAGGTGTCATTTAACGGACTAATATCTTAGGTTTCTAAATCATATCCTAAAATTCCTTTAGGTAGTTAGAAGTTTCAGCGTACTCTGAAATGTGTGCATATGTGACATATATTTTTATGAAGCACATTTGTTTTGAAATTTTTTTAATGTTCATCACCAAATATCACATTAACTTGACTATTATTGAGTTATATATTATATCACAGTCTGAAACTTTCTCCTTTCCAAGTGTATTTCTAAAGGATTATTGTTTAATGTATATTGCCCAAAGCGTTTGACCTGCAAACAAATATTAATCCCAGACAAAAGGGTAACATTTGCCCAAAAAGAAAAATAATGGGTAGAAAACATTGCATATCATTATGGAAGACATATTTAAATACACAATCATCGCTTGAGAAAATGAAATAGACCATGTTGTTTAAGGATATCTTTATCTGTTTCTCTTCACTGTAATGGCTTCCAGTAATTACAACATAGCTTCATCAAAATCACATTAAAAACTAACCTCCTAGAGCAGCCTGGAATTAATTACCAACTCTTATGATCTGGTTAGTTATCTCACAGTGCACAGGTAGTAAGTTATTATTAATAGGCTGATATCACTAATAAGTAAATATCACTGAGTTGTCTTAAAATTCCAGTTTCACCACTCATTTTGTGGAATTTAGATGCATTTAGTTTTAAAACACATTTTATAAAATGAAAAATATATACTTAGCAGTGGCTTATCTTCATGATTTACACTCATGATGGTTTTACCATGGGCAGATAAATGCTTTCTATAGAATTCTGAAGCTATTTATAAAATGTTTTTAAAGGATAGACATCAGAAGTTTTAATCTTTGCAATAACAAAAAAAATGGCCTTATTCTTTCTAGGTACAGGTCTCAGAACCATTGAACAAAATCATTACATAATACTGAGTTGTACATTGCCTTCCTATCATGTTACTCATCAATGTCTTCATCATTGGTCTTCAGTTAAACACTGAGCCTCAACTCCTAATTCCCTTGGGCTAAGATTGGATTTTAAATGCTACTGTGGCTGCATTTAATAGCTAAAGATGAACATCAGAGAAAATCACATATAAATATGTGGGCTCATGTATTACTCAAATGCTAGCTTTCTTTCCTAGAGGGTAGCAATCATTGCCGCTGGAGATAAGCAGAATTCCCAAATAAGCCCTTCATTTTCAGGGTTCAGCAAAAACACCGCTGTACACAGGTTTGAGAGAATTAATAGTGTGCTATATGGCAAAGAAGTTCATAGTAACTGCCAATGTCTGCAGTGCTTAGTAAGGACACAGAGGCTGGGGCAATTTGTGGGCAGCATGTGATGTGTTCTTTGCTTGTTTTTAAACCTTTATCTTTTTAAAAAATCCAACAAATTTAAACTATTGTCTTTAGAGAGGAATAAACCAGGCACATAATTCTGTCCTACTACAGCAACAGTGTTACCTGTTAGAGGCCAGTTTTTCTCTTTATTTGTTTCTCTTGTGGAATTTAATACTTTTTTGCCTTTATGTTCCTCATGAAAATACCTTTTCAATTCCAGAACCTAAGAAGCCACCTGTATTTGATCAGCACCTTACTCCAGTAACAGTGAGTGAAGGAGAATACGTGCAGCTCAGCTGCCATGTCCAGGGATCTGAGCCAATTAGGATCCAGTGGTTGAAGGCTGGCAGGGAAATAAAGCCTTCAGACAGATGCAGCTTCAGCTTTGCTAGTGGGACAGCTGTACTGGAACTCAGAGATGTGGCTAAAGCAGATTCGGGAGATTATGTGTGTAAAGCTTCAAATGTGGCTGGAAGTGACACTACCAAATCAAAAGTGACCATTAAAGGTACAGACACCTCAAAAGTATTATGCAGCTCAAGCCAGCAACCACTCATGTTTATTTGCTTATTATGATTTCCCTAGAAATGGAATTAGATTTTTAGAAATATCAGTTGTTGCTCATCTGCAATTTGTAGGCTCCTTATTATAATTGAAATATTAGGTAATTTAACAGAAATAATGTCAATACAAAGTATCTGAAATTACTACAAGTTTACCACCCTATTTCTTGAACTTCTTTTCACCATATCCATTAAGATGTAATTAACGCAGTTCCAAAAATGATGCTATAATAATGCGATAGAAAGTAGGCTGTTGTGATACACCTGGAAAAAATAAAACCAAGTCTAAAAATATTGACACTACTAATATGATTATAGTTCAACCTTTGATAGCTATCATTAGCATAAATGTCTGAGAAGCTGCTTTATCTTCTGTAACCCACCCTTACATAGAAAGAGAATTCTGCAGTACTTACTTATCAAACTGCCAACCTCCTAAGGCTTATTTTACAAAGGGGGATATGTATTGTAATTCTGAGGTGATTGTAGTAACAAAACATGTAAATGTTTTTTCAGACAAACCAGCTGTGGCCCCAGCAACCAAGAAAGCTGCGGTAGATGGAAGACTCTTTTTTGTGTCAGAACCTCAGAGTATCAGAGTCGTAGAAAGTAAGTGCACTTCATGAGAAGTACATCTTCATCTATCTTATACCTTTTACTTATGATTTAATTTTGGAAGAACTGATTTTAGAAAATTAAATTTTTATTCACTTGTTTTCATTATTCCTTAGAAACCACTGCGACCTTCATTGCAAAAGTTGGAGGTGACCCAATCCCAAATGTTAAATGGACAAAAGGGAAGTGGAGACAGCTGAACCAAGGAGGTCGTGTTTTCATCCACCAAAAAGGCGATGAAGCAAAACTGGAGATTAGGGACACCACAAAAACTGATTCTGGGTTATACCGATGCGTGGCATTTAACGAACATGGTGAAATTGAAAGTAATGTTAACTTACAGGTGGATGAAAGGAAGAAACAAGAGAAAATTGAAGGCGATCTTAGAGCAATGCTGAAAAAGTGAGTTCAATAAAAACCACAAATCGTACAATCAGCCCTCCATATAAGTGGGTTCCGCATCCACAGTCAACCAGCCCCAGTGGAAAGTATTAAAGAACAAAAAATTTAAAAATACAAATAAACAATACAGCATAACAACCATTTACACAGCACTTACATTGTATTAGATATTATAAGTAATCTAGAGATGAAGCATATGGGAGGATGTGCATAGGTTACATGCAAATACTATGCCATTTTGCATCAGGGACTTGAGCATCTGGCCACAGGCCTCCTGAAGCCAATCTCCCAGGCATAGAGAGGGATGACTGTAATGTCCCATTCACAAAAAGAATCTCTCAAGAGTCATGGGCCATCCATCTCAAGATTCAGATTGTTAAAGAACATAGGCATATAGACATTTTCACAGAAGCAGATAAGCAAATACACAACATCTGGGTGTTCTTGTTTCATTAGAATCAATTTCCGAATTTAAGAGAAAGTTTTAAGAATGAGGTGAATGTCTATTAAGATTTTTAAACAAAAAGAAATGGCCTATAAAGAAACCCCAGTATTGTCTGTGCCTAGGTATGAAACTTTTTTTCTATATATGATTTCTTATGTTATGAATGGTTCTCTAAAACAACTGTTTTAAACATTTTCCATAATTATCATTCATTTCAATATGGTTCATTTTTCAACATAATTATTAAATTAAATCCACACTCAATTTCCACACATCGTTTCCGTGATATGTATACTATTCTATTATTAAAGTTTTCCATTGCTATTATTATTTTTTCTGATATTATAATTCATTAGCTAGGCTCTTTGGTTATAAAGTTTACAGAAATACTTCTATTATCCTTTCCCTTCTTAAAATTTTCATTCCTACATCTATATTTTATTACAATGGTCCTAATCCATCTGATCTTAATCGACTCCATCTCCAAACCCACATTTTTAAATTGTTTCACAGCTAACATGGTAAAATTAATATTTATTGAATAAAGAACATAGAAAACCTTAATGAAGTATATAATCTTTGAATGATGATAGACAATTAAAAATAAGTAGAAGACAGGTGTTTTATCCTTACTTTTTAAATTTTATTTAGGACTCCAATCTTAAAGAAAGGAGCTGGAGAAGAAGAGGAAATTGATATCATGGAACTTCTCAAAAATGTTGATCCTAAAGAATATGAAAAATATGCCCGCATGTATGGAATCACTGACTTCCGAGGTCTTCTTCAAGCATTTGAACTGCTCAAGCAAAGCCAAGAAGAAGAGACACATAGACTGGTATGCTCCTTCATATATAGCATCATGCTAAAAAAGTCACATTTAAAACATCTCACATATTCCCTTTGAATTACCAGAATCCTATAGTTATATGACGTCATTTAATATGACCTAACCAGCATCCAGAATGGAAGCTGAATATAGTCATGCGTCCTCTAAATCAAATTTTGTTTCATCTGTAATGCCTATCATTTTTGTTCTTCTCAGGAAATTGAGGAAATAGAGAGGTCAGAGAGGGACGAAAAGGAATTTGAGGAACTTGTATCATTTATTCAGCAAAGACTGTCACAGACAGAGGTAAAAAGAATTATGTTGATAATAAAATGAACAAGTTATTATTGAGTATTATTATAAGGGAAGGAGTAACAAATGTGTTTTAATTCTTTATTCTCCTAGCCTGTCACTCTGATCAAGGACATTGAAAATCAGACAGTTTTGAAAGATAATGATGCTGTCTTTGAAATTGACATTAAAATTAATTATCCAGAAATCAAGCTTTCGTGGTACAAAGGAACTGAAAAACTGGAACCCAGTGATAAATTTGAAATAAGCATTGATGGTGACCGACATACACTCAGAGTCAAAAACTGTCAACTTAAAGACCAGGGCAATTATCGATTGGTTTGTGGTCCACACATCGCTAGCGCTAAACTAACTGTAATTGGTAAGTTAGAAAAGGCTTATGAAATACTTGTGAGATTTAAATTACTGTTGAGCACATCTGCGTGTGATATTGAACAAAATGCGTGTTGTATCACATGAACAGAGCCTGCATGGGAACGGCATCTTCAGGATGTGACTCTGAAAGAAGGCCAGACTTGCACCATGACATGCCAATTTTCTGTACCAAATGTAAAATCTGAATGGTTCAGAAATGGCAGAATCCTTAAACCCCAAGGTAGACATAAAACAGAAGTGGAACACAAAGTCCATAAATTGACCATTGCAGATGTTCGAGCAGAAGACCAGGGTCAGTACACCTGCAAATATGAAGACCTTGAAACTTCAGCAGAACTCAGAATCGAAGGTGCGTGAAACACTATGGAGTCCTTGTGGGTACAGCATAGGTCAATGGCAAATGTTGTGCAGGACCCCTGCAACCCTACCTGTAGACACACACCAAAGTGGTCATGTGTTCTTATTTCCCAACACACGTTCTCATAGTATTCATCTCAAAGTTCATACAAAAGCACAAGGGAAATATTCAAATGAGTGTCAGTTCTTTTGCATCGTTCTTTTAGATTTTAATCTAGTCTAAGACATAATCTTTAACAGTTATTTCTGTCTAAAGTCTAAATTTCATGATTCTCATATCTAGGATTGTAGAAAGAAAGCTAGGAAAGGACAAGATCTCATAGATGTAAATCTGGAGGATCTTGGCTAGGAATTGATATTTTGTTTATAGGACTTAGTCTGACTTTCTCTGTACAAAATTATATAGATAACATAAACATGTCATGTGCAATTAGCAACTATTTTTCAAAAATATTTATTTCATTTTCAGATCATGTTTCAACCTTCTGAATCTCTGAAATTAAGTGAAATCTCAGAATTTAGGAGTAACAACATTCATTTCCTAATTGATTATACACATTTTCCAAAGACACCCTCAAACTGTATTGAGAAAAATTTTGGCTATGATAATAGCATCTGCTTTCAGCTATTGGTGCCCATTCGTAGTTGCTGAAACACAAATATATGACATTGGATTTACATAAGCATGTCAACTTTTCTGACTTACCTTACAATGAATATCAGTGACTGGTTGTATTTTAAATGGTTTTCAAATTAAAGGGCCAGCTGCAAGTACTAATTATTTTTTAAATAATTGATATTTTTAATATAATTCTTTAGTAAATAGAGCTCACCAGAGTACTGTGATTTCTAAGACTTTATGGTACTGTTATACATATAAGACCCTCCCCTCCAGCCTCTTCTAGAAAGCACTCCTGCCATCCACACACATACTTTGTTTGTGCCCATATGTACTTAGCAGATTTCTGAACTCTAAAATTTTTCTTTTTGAAATTTAGAAGTGCAGATTTCCGATTGCGTTTGAAATTATTTTACAGGAAAAGTTATACATATTAGATAAACAATTATAGATCCTGAATAGCAAAAATTATTTTACTGAGGCAAGAAAGAATTTCACAGAGGAATAAGTTGTAGAGTACAATCAAGTTTGTGTTCCCTAACACTTTTAAAATTTAATTTGACTTTGGGTCATTAGCTCTCTTTAGTATGTTCTTTATATAAATATTTTAAGAACTCACAATAATTTCTTTACACTTTGCTACATTCGACCAGCATGAATACACTTAAGAATTGGGATACTTTTTTGTTAGTGATGCAAAGAAGAGTGCATTTCTTCTCATTTTGGATTTTTGAACTTTTCTTGCTATTTTATAACTGGGTACAAAGATGGAGATTTTAAGTATCTGAGGTAAAAGCAAGTAAAAGAAATTCCTCTCTATATAATCTAACTTTGAACCCTCTTTGTACTTAAACAGCTGAACCAATTCAGTTTACAAAGCGCATACAGAACATCGTGGTGAGTGAGCATCAGTCTGCCACCTTTGAGTGTGAAGTGTCCTTTGATGATGCCATTGTAACATGGTACAAAGGACCAACAGAACTGACAGAGAGCCAGAAATACAACTTCAGGAATGATGGCCGCTGCCATTATATGACCATCCACAATGTGACCCCAGACGATGAAGGTGATTTCATTGACAGTTTTCCAGTGAATGTATAATTTAAGCCTCGTCTGTTTTCTGTATTTCTACCCTGTATGCGCTCATGCTCTCATTCTATCTAGAATGCTTTTTTAGAAAAGACAAGTGTAAATAAACACATACGTATATTGAAGTAAAGAAGTGTTATTTGCAACATATCAGAAAACAAAAGTTGGATGATTTTTCACCCTAGGTGTCTACTCGGTCATCGCTCGGCTGGAGCCAAGAGGTGAAGCAAGAAGCACGGCAGAGCTGTACCTAACGACGAAAGGTGAGGTAGCGCCATCAGAAAGCCACCCTGCCATCTTCGAAACACGTAGCCTACCTATACCATTCTGAACACAAAAATATCATTTTTTTTTTATTTTGCAGAAATCAAACTTGAGCTGAAGCCTCCTGGTAAGTTGTTTTGTAAAAATCAATCCTTGCTTACAATAAATTTGGCATAATTTTGTAAATCACAGAAGCCAAACTAAAATGTATAAGATATCTTTCTCTTTTGGGTAAAATATTTTTCAATAAAACTGTTATGCAGTAGAATTACTTTCAGTCAAATAATAAAATGTTAAACCTTGTGAGTCTGGCAAATTAGAGATAATAAGGTCTCACTCAGCTGATGCTAGAATCATGTTAAATAGAATAGCCACAGAATGAAACAAATTTTGACAGTGAACAAAACTTACCTGCGTGGTTGCATACAAAAGAATACTAATATTATTTTGTCTGTATATTAGATTCTGCCATTAGATATGCCTGACATATCTCAGGATCTAATAAATCAAACACACCTTAGTTTTCTAATAAATAGCTTGTTCTCAGTCTCTCTATGCTTATTACATGTCCCTTTCCAGATATTCCTGACTCCAGAGTTCCAATCCCAACCATGCCTATCAGAGCAGTGCCACCAGAAGGTAAGACCCAGAACCTCAACATCTGAGCTTGGAGCAGCAATATTCTAGCACTAGGAATCTGTACGAAATTTTATACCAGCGACCAAACTGCAGCAGAGTCAGAACAAAACCTTCCATGTCATATTCTTCAGTGAGCAATTAGAAATTAAAGTAAAAAAAAAAAGTAGTTCCAGTTATAAATAAATGCTACTTTTATTTGTTCCGACTGATGAATTCGTACTATAATACCTATGAAGTACTGAAAGAAATGCATGAGACTTTTCATTATATTTTACGCAAAATAAGAAACTAAAACATGTTACTAACGGCATTTATTTTCTTCAGAAATCCCTCCTGTGGTTGCTCCTCCTATCCCCCTTTTGCTACCAACACCCGAAGAAAAGAAACCACCACCAAAACGTATTGAAGGTATTATACCTCATCTACCTAGATGTCGAAATAAGAATTTCACTCTGCTGACCCGAAAAATGTTGCTTAATACAACGCATTGGCCCTCTAGTGGTCAAGAGGTGGAATTGCCTTTCAAAATGTAAATTACTTTCTCAAAGTATTAGCTAACTAAATGTGTAAGTTATGTGCTTAAAACTCTGAAAATCATCAAACAAAATACTATTTTGGTATTAAAATATTTTATTTTAATGAAATTACTGAAACATTAATAGAGAACTAATTTAATGTTTCATATTTTCCTAACTACTATGTATAACAAAAAGAATAATGGAACCAATTTCTAGTGCAGCTTATAGAAATAAACCATAGTAGTTTACAGCCAAATTGCAAATTATAGCTTGTGGCTTTTCTCAATTTATAGTATTAACTACTCTTAAAAATTTACTATTTTGTCACATAAAATATGATTTAGAATACTTATGAAATATTTGACTTCTTTTGTACCTAAGGCATGATCTCACCAATAAAGAGATCTTAAGTGTTCCAAGGAATTGCTCCTCTCAAATACTCAGTAGAGAAGTTGTAGTATTTGTGTCCCAAAGCTTCTCAACTAAATTAGACAACAGATTTCCTGGGACTTTCTGGAGTTATAGGGAGTTCAGAAATGCTGTCAGAATTCTCCCAGCATGGTCAGAAAAAATTCTGTATGTCAAAATCACATTTTTCTATAGCTAAGTCACTACTACTGTATTAGATTCAAGGGGTGGAAATGGTAGGCCCTTAACACCCGCTATAATTGGCATTAAACGCTTGACCTATTTTTCAGCCAGCCTTAGAGGAAATTCAATTAGAAACTTCCAATTTTGTGACTAATGCAACCTCATTAACAAAGAGAAGCATTTTTATGATTCATACGAACATAAGCATTTTATCTAGCTGTGAGAACAGAGAGGAACAAGAATCAACAATCATAAATTGGATTTCCATTTCTATTTCTGTTGTCAAAAATAATAACTTATGTTAATGAATGATTTGTTCTTTGACTGGTAGTATCAACATGGCTAAGTTTGGTACTCACTGTGAAACTTGAGAAGTTAAATAATGTTTTAAAAATTAAAAAAGAGGCCTGGCGCGGTGGCTCACGCTTGTAATCCCAGCACTTTGGGAGGCCGAGGTGGGCGGATCACGAGGTCAGGAGATCGAGACCACGATGAAACCGCGTCTCTACTAAAAATACAAAAAATTAGCCGGGCGTGGTGGTGGGCACCTGTAGTCCCAGCTACTCAGAGAGGCTGAGGCAGGAGAATGGCGTGAACCCGGGAGGCGGAGCTTGCAATGAGCCGAGATCGAGCCACTGCACTCCAGCCTGGGTGACAGAGTGAGACTCCGTCTCAAAAAAAAAAAAAAAAAAAAATTAAAAAAGAGTGGGCTGGGCGCGGTGGCTCACGCCTGTAATCCCAGCACTTTGGGAGGCCGAGGCGGGCGGATCACAAGGTCAGGAGATCGAGACCATCTTGGCTAACACGGTGAAACCCCGTCTCTACTAAAAATACAAAAAATTAGCCGGGCGCGGTGGCGGGCGCCTGTAGTCCCAGCTACTCGGGAGGCTGAGGCAGGAGAATGGTGTGGACCTGGGAGGCGGAGCTTGCAGTGAGCCGAGATTGCGCCACTGCAATCCGGCCTGGGCTAAACAGCGGGACTCCGTCTCAAAAAAAAAAAAAAAAAAAAAAAAAAAAAAAAAAAAAAAAAAAAAAGAGTGTTATTTATTCATGAATACAAAAGGCCATAATCAAGTATGATTAGGAACCGTGGTTAAGGTATAACAGCTGCACAACAAAGGACTTTAAACCCACTTGTTACTCTTCCTCCTAACATATTTGTGTTCGTCCCTAAGGATGAAGCAAAGATGAAAATGTGTACTTTACTATTTATGATATCACTTAGATTCACACTCCATGTTCTGAAAACTTTAACTCTCAGCAGACATAAAATCAGTGAAGATGTAAGATCACAGTACATTTTCTATATCCCTCCAAAACAATTTTTTTGCATCTAGTCCTAGATCTTTCCAAAACAAATATCTTGTAGTAATATGCAGAATCTCGCTACTATCAACATATGGAAAAATAAAATATTTCAATAAAATTCCTAGTTTCCTGAAAGCATTTTAGTTACTTACACCAGAAATATTTTTTCTTTTTTTTTCTTTTTTTTTTTTTTTAGTTACCAAAAAGGCTGTGAAGAAAGATGCCAAAAAAGTTGTTGCAAAGCCCAAAGAGATGACACCACGTGAAGGTATTATAATTAATCAAAAAGCAGTCTTAACACTTTTTTCTTGGCCAAAACTTTTAAATTCTAAACAGTGGAGGGTGAAGGAAGGGTAAGAGTTTGCAATCACAAAATGGTACCTCTCCCTTCACTCACTTTCGCCCTCGTCTTTGACTCAGTCCTCACTCTCTCAACTCCTTTTTTCCCCCTTTTCTCTTTCCTGTCCTCCTGAGCCCCTGGGAACCAATGACAACACCAGTGTATTCTGGTTATTTCTGGATGAAAATTTAAAGAAGGTCTTGCCCAGAAATCCAACAGCTATTCTTTTTTTTTCTTTTTTATTTTATTGTAAATTGACTATTTACTATTGTGTATATATTTATGGGGTACAAAGTGATGTTATGATCTGTGAATACAATATGGAATAATTAAATCAAGCCAATTAACATATCCATCACCTCAAATACTTAACATTTTTGTGGTGAGAATATTTGAAATTTACTCTTAGCGATTTTGAAATGTACAGTACACTATTATTAACTATATTCACCACTCTGTGCAACAGATCTCAAGAAAAGCCATGTTTCTTCTGTCTAAGATTTTGTACCCTTTGACCAACATTTCCCCATTCCCTCAAATCCCCAGCCTCTGTAACCATCATTCTACTCTTTATGAATTCAACTTTTTTAGTTCCACATCTAAGTGAGAACTTACAGTCTTTGTCTTTCTGTGCCTGGCTTATTTCACTTAGCATAATCTCCAGTTCTATCCATGTTGTCACAAATGACAAAATTCCCTTTTTTTATAAGGCTGAATAGTATTCCATTGTGTATTTATATACCACCTTTTCCTTATGTATTCATCCATTGATGGACACTTAGGGTGTTTCCATAACTTGGTCTTTGTGAATAATGCTGCAATGAACATGGAAGTACCCAACAGCTGGTCTTGATAAAGTCACATCAATGTAAGATCAAGGGTTGCTGCTAATTTTAAGAGGTTGCTGCAACCCACCTCAGTATCTTTCCTGATTTAGGTGATCTAAATATCAATATTTGAAGAAAAAATACTTTATGAAGGAGGATCAATTCAAATCACTTTAACTTTCAATATATCCTCGAAGATTTTTAGGAAAACAGTTGGATAACTAAATTTAAACAAATAGTTTTAACTCATTTGACTAAGATTAGAGTACAGCAACCTCCATAAAGAAGGAAAATATGGAAACACAAGGCATCATTCATCATTCAGACTTTTCTGAGTGGTCATTTGTGAAACATCATGGAATAAGAGGACACTCAAAAAGCATGGATATTTCATGAACTTCATAGTTAATAATTGAAAAAGTCTAATGTGTTATTTTTAGCATTGGACATATTAAACATTCTCTTCATGCTTAATGTTAACTTATTAGAAATCAATCTAAACTAGAACCAATTTAAATGATCTTAAATCAATCTAAACTAGAATCAAACTTTGGCCTTTTGCATGTTTGATTTTTGTTAATATGGCCTTGCATAGCATTTCTAATGAGCTAGATTTGGAAATTATAGAAGCATTATTATGATTCCTGGAAGGGCTGGTGTATGAGTAGTAGTCATAGCTCCTACAAACAACTAACAATGATGTGGAGGATTAGTAAACATTAATAATAATGTAATCTAAAAATAAACACACATTTTTATGTTTTTAAACTCCCAGAGATTGTCAAGAAGCCTCCACCTCCTACTACCTTAATTCCAGCAAAAGGTAAATAAAGATAAATTATTTTTATTCTGTTTATTCCTGAGATTTGCACTTCTGCTAACTATTCTTATTTTAAATATTAGGCTTCCAACTTATTGAAAGTTGTGGAGTCTCCTCTGCTGTGTTAAATTTAGCATTAGAAATGATGGCTATTTCATATTGCCCCTTTCCCAGGAAAACAAACCCAGGCAGATGTTTATGCTGCCTCTGTGCAATGGTCTCAGAGAAAGAAGAAGTGAGGGCTAGAAAGGAAGGGCCATTCCTTATTTTTTTATTGTAGTTAACACAAATGTTAAGAGTCATATAAATAATGAGAGCCCTTAAGAACTTTAAAAATCTGTTATCTAAAAGTACCTAATTAACTTGGTTACATAATTTTAAATGTTGTTTTTATGAAACTGACTAAGGGATCATATGCAATAGTCAAAAACCTAGGTTTAAAATTAGAAATGTTTTTGAAATAATAATCAGAACTTTTTAAAAAGGTTAACTGTATAAATATGAAATATAAATTCCATGAACTTATCGAATATTAAAACTATTCCACTGGAAGAAACTAGGGGTTCTGCAAACTGGAGCTCTCATGGAATAATAGAAGGTGTGTCCATTTGATAATATTTATTGAATCCATTTTTTCATACTGGAAAAATCCTCAAATCAAGAGTAGAATGCATCTTGATACTCTACTATGTTCCATAGTCAAAAATTTAAATGGAACCAATACAAAAAAAAAAAACAAATTATCAATAAAATAGATCTGAAATACTGATGTTGTTTAACTAGGTAGATTTTTGTTTAGTGAAGCAGTTGGATGGATAGAATTAATATGCTAATAGTATCTTTATCTATTTTAGCTCCTGAAATCATTGATGTATCCTCTAAAGCTGAAGAAGTAAAAATAATGACTATAACCAGAAAGAAAGAGGTTCAGAAAGAAAAAGAAGCTGTGTATGAGAAAAAGCAAGCAGTCCACAAGGAGAAGAGAGTCTTCATTGAATCTTTCGAAGAACCTTATGACGAACTGGAGGTAGAACCATACACAGAGCCATTTGAACAACCTTATTATGAAGAACCAGATGAAGACTATGAAGAGATTAAGGTAGAAGCTAAAAAAGAAGTTCACGAGGAATGGGAAGAAGATTTTGAAGAAGGGCAAGAATACTATGAAAGGGAAGAAGGCTATGACGAAGGGGAGGAAGAGTGGGAAGAGGCTTACCAAGAAAGGGAAGTAATTCAAGTTCAAAAGGAGGTCTATGAAGGTATGTATAAACTGAATGACTTGTTTCCCTCTTTTCTTCATTTTTGCTCAGTTCATTAAATTTTCAATGCTATGAACCTGATTTGCAGTTTATGTGAAATAGTTAAAATGATCTTAGATTTTTTTAAGGTTAGAAATCTTTTAAAAGTTATTTTCCTCAGAGTTACTTTCATGCTTTGACATTACAAGCTAAATCATTTAGTCTTATTACTAACACTAAATTCCAAGTGCTAATTTCTAATGCAGAAGTTCAAGTTTTACTTTTACTGCCTTGTTGCATCTCTGCTTGATCCTGCTTCAAATCCTAGCACTAAGAATTGTGTTGGTAATAACGATCCCAAATATAATACTTCACACGATTATATATTATCCTTACCTTATCTCATTTGCAATTAACAACCTAAGAGAACTTACCTATTTAAGCATCCCTTCTTATTCCTGTGTTTTTATTTCAGAATCACATGAGAGAAAAGTTCCAGCCAAAGTACCTGAAAAGAAAGCACCACCACCTCCTAAAGGTAAGTAATTAGAAATATTTAAATAGACTAGAGCATCAACATCATTATCATGGCTTGTTTGGCAGCAATGTATAAATCAGCAGTTCAATCCAATAGGCACAACTTCTTCTCTAAGCTTTATTGTGAATGATTTTTTTTTCTTAAAATTTCTATCTAATTGATTTCATTAAAAAATCAAAAGATGATAAAAATTGTAATGGTAAACTTAAATATAACCAAAATATGTTAAGTACAGAAACTTGTACCCAGAGTTCAAAGTTGTGCGTAAAGGTCAAAGAAAAAAAAACCGAACTCATCTCTCTCTTTAAAAAATGATACATGTATCTGCATATACACTTATAGGTGTGTATAAACACATATACACAGAGAGAGAGAGATAGAGAGAGAGAGAATTTTAATAGGAATTCTAAAAGTACTGCAATTTCTCTAAAATGCTTGCAGTTATAAAGAAGCCAGTAATTGAAAAAATTGAAAAGACTTCTCGAAGAATGGAGGAAGAAAAAGTTCAAGTCACCAAAGGTATTATTTAAAACATTCCTAGCACCCATGTACACAAGTAATATGTTTACTGATCTATACTCACATTAGTTATTTATATAATCAAATACTTTTAAATTTTGTGCAAAGCAATATTCTTCAAAATACAAATATATTTGTACATATTTTTAAAGTACCTGAAGTTTCAAAGAAGATTGTTCCACAAAAACCTTCCCGGACTCCAGTACAGGAAGAAGTTATTGAAGTGAAAGGTATACATCTTTGTGTTTCAGCTACAAGTTCAAAATTTTTTTATTTATGTGTATGGACATGTGTACATATATTGCTAAGTAACTCACAAATCTGAAACGACCAAAAACAGCACATTTTTACATAATACAAATTTTATGTTGAGTTGCACATATGTTTAATTTAAATAGTAACATTATCTACTTTGTTTCTAGTTCTGCTTAAAAATTACATTTTTTTATTATAAAGAAGGTTTGTGTTTAATTAGTAGTTTGCTAACTTCACTATGCAATGCATTCCATTGCATATAATATTCCCTGTCCTCTTATTTATAGAAATAGACCCTAACAGATTTGGAAAAGCACAACATTGTGTGTGAAGAAGTTGTGTCTATTTGATTCTCATTTAAGAATGTTTGATGAAGGCTGCATGCATTGTTTGTCCCTATAGATCAAAACATGATTTGTTTTCTTGTCAATACTGAATTTGTTCTCAAGCTACCATATTAACCCACTCATTCTGTGTCTAAATACTTGAGTATAAAATCCATGTGTTTGATCTGATGTCTTGTACTAAAAAAAAGGAATACTAATGTGAAATACTCTCTTTAAAGTACCAGCTGTGCATACAAAGAAGATGGTTATTTCAGAAGAAAAGATGTTCTTTGCTTCTCACACAGAGGAGGAGGTGTCAGTCACAGGTATAAGGCAAACTGGAATGTGGGGGCTCAAATGGAAGGGTTTTAGGCAGATTTTTATCCCTCTTGTTGTCTAATTTGTGATCGTGTAGACATTTCTGTCTCCTTGTAAATTCTGTCATCTTTTTCATTTCATGTTTGTCTCTGTTTTCATTTTTATTTTAATGTTCTTTGTAAATTACAATTACCACCCACAACATGGCATATCAGTAATTAAAATGTACATTTTTTTAAGTCCCCGAGGTACAAAAGGAAATTGTTACTGAAGAGAAAATTCACGTTGCCATTTCCAAAAGGGTTGAACCACCACCTAAAGGTATTAGTAATTCATTCTAAGTTTAAACTCTTTTAATAAAAATTAGTACAAATACCATAGTAAAACATTTATGTTAGTATTAAATAATAGATTTAGTCACAGTGTGCATACCTATAGCCACTATGTACAAAGGATGTGATGGGGGACGGGAAGAACCATGAGGAAGGCACAGGGGGAAAAAAGTGAAAATTATGGGAGGCTCCATTCCCTGCTTCAGAGAGTTTGCAATCTCGTAACCTGTTACTTGGAAATACAGTGTCCTGGAGCCAGTTCATGCTAGCTCACCAGAGCCTATGGTTACATTTTCAGGAATTTTGCCAGTCAGTAGTTTAACACCACCATTATTAAAAATTAGATTATGTAAATTTACAGTCCAATAAAGTATATTTTTAAATATTAATAAATACTCAAAACTCCTATTTTACTGCATTTTGTTCTTATCTGTGTTTCTGAGATTGTTTCCATCTTTGTGTCTGTGTGGTGGAAATGCCATATAATGTACTACTGCACATCTCTTTCCAACTCCAGGACAATGACATCACCTTGACAGCCAGGGTGGGAGGGAGTGTTTATACCACCTTGGAAATCGGAAATCTGCAAGCACTATAGATCAAGGCTCCACCCCCTCCATCCCACCCAAATTGTTAAACATTTAAGACACAAAAAAATCTAATGCAATTGTATTTATGAAACTGCTTTATAAAAGTAAAGGTTACAAAAAAAAAAACTAACTTCATAGTTATCGATGTTCATAAAAAGCTGGTTTCTGAGGAACTGACACAGGCACCTCCGAGGGAGGATTGCTCCTACCTGTTCCTGACAAAGTAGAGGCTTCTGCAGTTAAAGGTGACAGCAGTCACATTTTCTAATTAGCCATTCAGCCATCTTCATTTACTCTCATTTCTAAAGCATAATTTTCTTGCATTCAGTTGGTATAAAAAGGGAATCTCTATTTAATTCTAAGTCTTACAACAACATATGCCTTGTCAAATGCACACTTTCTCAAAAATGGCACTTTTCTTTTAAAGTCCCTGAGCTACCTGAGAAACCAGCTCCAGAAGAAGTGGCCCCTGTTCCTATCCCTAAAAAAGTGGAGCCCCCAGCACCAAAAGGTAGAATAATATTTGTGAAAAAAATAATTCTTAGCATCCATCTTGTATCTTTTTCTATAAGATCTGTGTATTAACAAAATAGCATCTGTAAACCATCTATAATATATTTAATTCTGTGTATATTGATTTCATTTATTTGTGGTGATGTGTTATACAAGTATTGGTAACATTTCTAAACTCCAGATCACGCTAACTGGGTCTTTGTCTGCTTGTGTAATGTATGTAATGTCTATATGGTGTTGAGGTATTTAGCTTTCATTTCTACCACAAGTAGGCATATTTAAATTACTTCCTAATTCTCACACTGTTAGTGAAGATTTATGCTTTAATGTAATCTTAGATGTCTCAGAAGGTGACTAGAATATTCCACATTATTTCAACAATTGTATCTTTAAAGTTCCTGAGGTTCCCAAGAAACCCGTGCCAGAGGAGAAAAAGCCAGTTCCTGTGCCTAAGAAGGAACCTGCTGCTCCCCCAAAAGGTACGCCAGAGCCAATGATGGGGAGACTCTTTGCTCCAAGTGCCAGCCTTTTGCTTTCTACGATCTTCATATGTACTATGCTGCCTTTGTCTTTTGTCTCTTTTACATTCTTCTTGTGTTTTTACTGTTTGTCAGCTTCCGTGCCATGCTCTTGACATACTTTATTTATTATACTGAATATTCCTAAGACATCACCAAAAAGTATTGTTAAAGGAAGTAACTATGTCAAACTGCTATCTTACATTTTTAATATCTTCCCTCTTTTAGAGAAAGAGGAAATGTTTGTGAAACTTGTTTTCTACTGACATGTTTCTAGGAAAAAACCTTTCATCCTTCATAAATGTAACTTTTTCTTAATAAAAGCAGTTTCATGCATTATGAAGAGGTGGAGACAGGCAATGACAACTGGAGAGTGTCTGGCAGAACTGAATGTTAATTACATAAAGACGTACATAGTACCACGCTTCTTAAAAGTCAATAGTGGCGAGTCTTCAATAGTGGGGAACATACAGATTTTTTGAAGTTTACTTTCACCATTTTCTTGAGACCTTAACTGAGCTTCAGTATTTGCCATAAATGTTTCCGTTATCTAATTAGCTAGTCAAAGTACCTTTCACAGAGGTATGTTTGAATGAAAATGTGCTGCTGTGGTATATCACAAATCCCTTGCTTTGGTTTGTTTGGGATTTTTTTGGCGATAAAAGGCACTATCTTATTGAAGCACTGAAGCTACAATTGCACGCATCCATTCAGTTATAGAGAGACTCAGCAAGAATTCAACATTATCCAATTTAGGAGAAACCAGACCTAACTAAAATAGTACATTTTGAATAGTGTTCCCTTGGCCTGACTTTGCAATGTTTCTATTTTCTTCCTGAATCAAATATGCTTCTCTCTTTCTCAAACTCTTGGCTCTTTCAAAATTCTTTTGATTATCTAACCATTAAATACAAAGGTCATGTTAGTAAAACCAATACTAATACTAAAGCTACTTGAGACAGATCGTCTTAGATAAATTAAATCCATTGTTATTATGTACTACATTTCCCCATACAAAGCATAAAGAACCTTTTCTATATACTATCTGAACATTCTTGACTGTTTGTGTAATCACTAATTCGTTTTCAGCAAAGTCATATATGTCTTCTAAAGGAGACACAGAGGCATCTCTCATTTACTCATAAAAACAAATACACATAGTATAATAGCACGTATATATATATAAATACTGCATGTATATATAGCATAACATATACATATATAAATTAACAGCTATATAATTGCACCAAAATATTACAAATGCACGTGCAGAGGTGCAGGGATTCACAAAAGCTGCCAATATTGTATTTAAAATGAGAACAATTATTGCCAATAATGCATGCTGTTAAAATTCATCTTCCAATTAAAAAGTCAACATTATCCATTCTTAGAATAGATAAATCAAATACACTGTAAACATTTTTTAGGTTGAAAACCCTGTTCAAAACTCTAGAGCCCCTTAGAAAAAAAAAGCACAAATACACATACCCACAAAATTCTGCACACAAAGCTCTGTAAAGTCATTAACACATGGGTATCAGATTGAGAGACCTACTCTAGAGTGTTTCCTGAGTTTTGAATTCACTACAGGCACACCCCCCAAAAATGAGAGGAGAAATGTGGGGAAGAGAAGTAAGTTACACATATTCAACTATTCTAAGACTTCTTAGTCTTAGTCTAAAATAGTCTTAGATAAACTAAAGCCATTGTTATTAAGTACTCCATTTCTCAATACAAAGCGTAAAGAAGTTTTCTATATACCATATCCACATTCTTGATTGTTTGTGTCATCACTAATTTGTTTTTAGCAAGGTCATACAATATATAAAGGATGAATTCTGTGCACAACTTTGTTACATAACTCATTTTTGCCTAAATGCCTCTAAAACATTATTTGTGATATTTATCACATTGTGATCCTTGGAATAGTATAGTTAGTTTAATTTTCTGGATAATTTTGCTGATGCATAGATAATCCATAACAACATTAATGTACTACATAAAGATTTGTGCATGTGCCTATGTTCTTTCATAAAAGTGATATATGTCTGAACTAACATTGTGTTTCAAAAACTTTAAGTCCCAGAGGTGCCAAAGAAACCTGTCCCTGAAGAAAAGATTCCCGTTCCTGTTGCAAAGAAAAAGGAAGCTCCCCCAGCTAAAGGTACAGTGGCTTTCGACGTAAAGCCCTATCTTTTATCTTTGATACAAAATATGTTGTGTTTAATTATCTGTTCATTGAGTTAGTTTAATTCTAAATGAATGTTTTGTGGTGAGAACTGAACAAAAGTGTCTGTCCACCCGTCTGCTTTCTTAAAAAAAATAACTGTGCATAGCTACTTTAGAAAATATAAAGTCAATTCTAAAAATGTCTCTTCAAGTTCCTGAAGTACAGAAGGGAGTTGTGACAGAAGAAAAAATAACCATTGTAACTCAAAGAGAGGAATCTCCACCACCAGCAGGTACTTAATCCCATCTCCATGAAATAACCTTGTCTTTCCTTCAAGCCTCTTTAATTGCATGTCTTCTTTAATTGCCACTTCTATGTTGCTCATTTATTTGGCCTTTTTGACAAATTTTAAAATTCAATACTATCCTTTAAGTGCCAGAAATACCAAAGAAGAAAGTTCCTGAAGAAAGGAAACCTGTTCCTCGGAAGGAGGAAGAAGTTCCACCACCACCAAAAGGTATTGTTTCTCCATCTTCCCAAGAACTGTCTTTATGTTCCAGTGATTTTGTTAGTTTTGTGATATGAGTGCACTGTGGGTGTATTTCTTTGTTTTGCACTGGGCTTCAATGAGATCACATTAAATTTCTAAAAGTGCATAATGTCTCTAAAGTGCCAGCTCTGCCTAAGAAACCCGTCCCAGAGGAGAAAGTTGCAGTGCCAGTTCCTGTCGCTAAGAAAGCTCCTCCTCCCCGAGGTAGGATTTGCCTCAATCCTCTGACAAAAAAAAAAAAAAAAAAAAAAAATCTTCGAGTGTGTTAAATTCTTGCTTTTTCCATCTGGTCTGTGCTTATACTGATCCATTGTCTCACTTGCAGTGAAACTTTTGTGTTTATGTCCTTGTGATATGTAACTTGTTTTCCCATTTTGCTAGTCAAAGTGGTGTACTGTGCAACTCTTCCCCAAATTCTAGAAAGTGAGAATTGTTAAAATTCTTGATTTTAAACTTCAACTTTAACACTTTCTTAAAGCTGAAGTCTCTAAGAAAACTGTTGTAGAAGAAAAGAGATTTGTTGCTGAAGAAAAACTATCCTTCGCAGTTCCTCAAAGAGTGGAAGTCACGCGGCACGAAGGTATATAATCGGAAGTCAGGGGATAAATGAGTTTGTGTGTGTTTCCTCAAAGTCTCTTCTTCTTCCACATGTGATTGTTTACTTTAGAACATGTCCTCATCAGTTATTTCTCCTTATGTTGGTATTAGAATGTGTCTACCTTTTGTAGCCTTCTGGGACTGAGTCTTTTGTGTCTATGTTGGCCTTGAATCATTCGAAGGAAGTGGATGAGTCCCGAAAATGTTATAATTTTGAAAGTGGCCACACTTGGACATAACTCAAGTATCATTCTCAGTCTTGGGCTGTACTTGCCCTCATCTTAAATTAGCTTCCTCCTTCTTATAGTGAGGAAGTACCATGAAGCTATGTCCTAAGCAGATAGAAGAACAGTTATCCATCTGTAGTGACCACATGGCTGTATATACATCTGTATCTCAGCAGGCTGAATTTAAATGAAACCTTATCTTTTAAAGTATCTGCAGAGGAGGAATGGAGTTACTCAGAAGAGGAGGAAGGTGTGTCCATTTCAGTTTATAGAGAAGAAGAAAGAGAGGAGGAGGAAGAAGCAGAGGTTACAGAATATGAAGGTAAACAATGCAAATAAGCTAGAGATGATCTGGGGTTTTGATGAGGTGTTTTCTTTCACAAATTGTCTACAGACCAATGAAAAGAGACAGAAAAAAGTGACACAAATTCAGTGAACATCTACCAGTCTCATTAAATGAATATTTTGATCAAAACACAAGATTCAGGAGGATTATACTAGATTAGAGAAATCCAGTGTATTTCTTCTGCATCCCTTCTTACTTGCCTACATAGAATAAAAGAGGCTTCATATTTATATATAATTAATCAGGGCAGGTATCTCCATATACATATATCCTTTCATTAAACAGGACTTGGCTTCAGCATGGTGGGCTGGCATAAGCTTTACCTTAGTAGCCTAATGCCTAATTGGTGTTTCTCAAACATTGCTTGTACCACAATCCACAGACAGAAATATATTTTATATTATAATCCTTTAATTTTTTTATTCTAGGCATTTAAAAAATACAAGTTATAATCCATTAAGTCAATTGCAGAAGTCACTATAATGTCTTAAAATGTTTTAAAATGAGCAAGAAAATATATTACCTCATTACATTCCAGGAGTCAATGCCATATTTGTGAGTCTGAAGCCCTGAACACATAAGGCTTTCCTGTATTTTACATATGGAGAAAACCATTGTGTTATATATGGGATCAGACTGACTTGTTACTCAGATCTTTTCATACCTATAATGCTAATTATCTATAGTTTCTTAAGGACAGAACCAACAAACTATTCCATTGGGATATTTTTTCAATGAATTAAGGCAGCACCAGGTTTCCAACTAAAATCCAGCATTCTGGCTAGAGCCATGTGGCCAAAAGAACTTTCCTAAGAAAGTTCCTAAGGTCTGCTTTTAAAGAGAAATCAATAAGCTCCTTAACCAAACTAACTCTCTCCCCAGTGAGAAGATGAGTAGAATTGAAGTACATTTAGATGTCCCAAGTATCTGTTTTTATCTGTCTAATAAAAGATGGCACACCATGCCCCTTTTTTCACTTGGAACAAAAGCCCATGTAAAAATCCAAGGTGCCATAGTCTTAGTGGAATGCCTTGGAATAGGCCAAGATGGGACATGACTCCCAGGAGGAAATCCATTAACTCTGTTGTGCTTCCTGGAAGAGGCCATGATGGTGGACATAAGTCAGGAAGCTGGTAGATTTGAAGACGACTCCATCTTTTCTAAAAGTGTTTGTAAAACCAAACATAGTCTGATTTCAACTTTTGACACTATAAACTTCCTGTAGTACTCCAGACTCTAGTTAAAAGGAGAAACACTGTGATTATTTTTATGTTCTCATTATGCCCCAAAGATGGGTGGCTTGTTAGGTTTACTTTCAGCGTAAGGAGCAGATATGTTTTTAACCAGACACTTCTATTCCTTATTTAACTTTGACCAGGCATGGTGGCTCATGCCTATAATCCCAGTGCTTTGGGAGGCTGAGAAGGGAGGATTGCTTGAGCACAGGAGTTCAAGACCAGCCTATGCAACATAGCAAGCCCCATTCTACAAAAATTAAAAAAACAGCTAGGCATGGTGGCATGCACCTCTAGTCCCAGCTACTCAGGAGGCTGATGCAGGAGGATCATTTGAACCCAGGAGTTCGAGGTTACAGTGAGCTGTGATTACACCACTGCATTTTAGCCTGGGCAACAAAGCAAGACATTGTCTTAAAAAAAATTAAAACTGGCCGGGCGCGGTGGCTCACGCCTGTAATCCCAGCACTTTGGGAGGCCGAGGCGGGTGGATCACGAGGTCAGGAGATCGAGACCATCCCGGCTAAAACGGTGAAACCCCGTCTCTACTAAAAATACAAAAAATTAGCCGGGCGTAGTGGCGGGCGCCTGTAGTCCCAGCTACTTGGGAGGCTGAGGCAGGAGAATGGCGTGAACCCGGGAGGCGGAGCTTGCAGTGAGCCGAGATCCCGCCACTGCACTCCAGCCTGGGCGACAGAGCGAGACTCCGTCTCAAAAAAAAAAAAAAAAAAAAAAAAATTAAAACTGTATACACTTAGGCTCAAAAATCATGTGAAGCCTCCTGCCTCTTCTACCATACCTGCCCCACAAAACTGGCGGGGAAAACAATATGGAATATTATCTTACAATTCACTTAAATCCTCAAGTATGTTTCTGCCCTGTGGCCTTCAAATCTACAGTGCTCTGCTATTTGTGAAACTCATCTTCAAATTCTTCTGTTCTTATTAACTCAGCTATTATAATCGTTTCTTGTCCCGTACTTGTCCTGTCGTTGCTGTGGATATAAGCATTATTATCTGTATGACACATTTGAAAATTAAGTTAATGAAACCTATTTCCCATTTCCCATACTCTTCATTAACGCATGTGCTTTGATTAAAATGCTCTTTGAGTATTTTAAATAGGAACAAGCAGGGGTTTGGCAAGGGTTAAACTTTTGCTATTTTGATTACTCTTTGAAGTGATAAATTAAAGCTAAAAATAAACATGAAAAACACTGTAATTTATCTTCTTTAAAACTGCTGTCTTTAAAGTGATGGAAGAGCCTGAGGAATATGTTGTGGAAGAAAAGCTGCACATTATTTCTAAGAGAGTGGAAGCTGAGCCAGCTGAAGGTATGCTGACTCTTTAATTAGTTTTATCCCTATGTTAGCTTGTCTCCTTCTTTATGTTTCCTTATAGCTAATTTGTCATCCATATTGCAAATATTGATAAATATCATGTCTAATAAAAAGATCCCTTACACTTTTATCGAAAAGAAATCTAGACATTTCTACAAACATATTTTATAATCTTTTCAAGTGACAGAGAGGCAGGAGAAGAAAATTGTACTGAAACCAAAAATTCCTGCTAAAATAGAGGAGCCTCCACCGGCTAAAGGTATGATTTCTTTCAAAGAAATGCAACACTATTTATTTTAATGTATATAATAATACCTTCACATTTGCATAACTGTCTTATGCATAACAATTTGCATAACTGTCTACGTTTTGTCAGAACACATGTATGAACGTATTTACTGAGTATAGTCATTAACGTTTGTATATATGTGCAATCTTTTCAAAAAGTGAATGCTAAGCCCCACAACTGTGTCACTTCATATGTAAGGCAAACTCATATTCTTAAACCTAATCTTTCTAAAGTTCCTGAAGCACCTAAGAAAATTGTGCCAGAAAAGAAAGTTCCTGCTCCAGTTCCTAAAAAGGAAAAGGTGCCCCCACCTAAAGGTATATTGGATTTTATTTTATTCTCAAGACTGTCTTTTTTTAATCTTAAATTGATACATTCTTCAGATTTTTTAAACATTAACCAGAAAATAAGTGTGCCTGTGTTTAGTGTTTTCCATATCGTATGTTTGATGGTATTGCCTGGTATCTTTTAAGTGCCAGAAGAGCCAAAGAAACCAGTTCCAGAAAAAAAGGTTCCTCCAAAAGTCATTAAGATGGAAGAACCTCTCCCAGCCAAAGGTAAACAAACCTCCCCAGCAGAAAAACTAGGAACATATGGCTTGTCTTTCTTTCTCTCTGCTGCTGTTCTTTGGGTCATACTGTTTATATGTTGGTGGGTGACAATGGTGTCTTTGGGTAGAGTATTACTTGTGATGTTTTTGTGTGTGTGCCTTGTAAATTCTTCTATTCTAAAATCACAGTACTTTCTGGCTAGTATATTTTTTACGTCCACTTTGATATAACTCCCTAATCCTAAAATTATCTTTTAAGTGACTGAGAGGCACATGCAAATTACCCAGGAAGAAAAAGTTCTTGTTGCTGTAACTAAAAAAGAGGCGCCTCCAAAAGCAAGAGGTACATCCGCCCTTCCATTATGCACAATATTGTACTTGCCCTACTCTCTTTACCAAATACACTGGTTATGGGGGCTGGTTTTTGTTGTTGTTGTTGTTGTTGATGTTGTTGTTGTTGTTACAGTTGTTGTTTTATGTTTGAAATAATGAAAATGTCAAGTGTTTATGTTTGGGCTACTACTTTATGGCTGCCTTTTTGTGGTTTGAAAGAGGGAAACAATACTTTAAAGTGAAATCTCTCTTTAAAGTGCCAGAGGAACCGAAGAGAGCTGTCCCAGAAGAAAAAGTTCTGAAACTCAAACCTAAAAGAGAGGAGGAACCACCAGCTAAAGGTATACTGACTCTTAAAAAAAAAAAAAAAATCAAAATAAGCATCCAGACACTAAAACTAATCTAGTGGAATAGGTTCCATTAGAAAAAAAAAGACATAGTATAAAGTAAGCAATATAAGTTTGTTAATGCATATCACTTCAAAACTAAACATTTTTGATAACAGAAAGTACTTTTTTCTTAAAAAAAAGTGAGGCTTCTTCTAAACGTATGTGAATAATTTTCCTTAATCTGTATTTGTCTTCTAATGTCTTTTCCATATACTAAACTCATCTGCCTAGATGCTTGCTTTATGTGGCAATCTCTGATGAAATTTTTAATTTTTTCAATTCTGAATTTTCTACATTGTACCAATAGAGCTAAGGAAAATGTCTTAGAAGTGAGGTGAAGAAACTATTCATGTAACATAGGTTTCTGTCTAATGCTTCTACTTAGTTTGATAGTCATTATTTATGCTGTTTAGTTGTCTTTTTAAACTTTTATAAATACTACTTGATTTTCCTAAAATTATTCAATGTCTTTGACGTACTTCATATGTATATTAGAGTAAGTTTATTTCCAAGTCTATTGATTTTCTTGCTTTTTAAATGAAAGTTTAATCAGGCACTGTTATGGTTGTCTTTGTCCTTGAATTGTTTGAACAAAATTTCTCTTCACACACACATTTTCAGAATCTTGCAATTCACTTTTAATAATTACTCCTTTAAAGTGACTGAATTCAGAAAAAGAGTGGTTAAAGAAGAAAAAGTATCAATTGAAGCTCCAAAAAGAGAACCTCAACCCATCAAAGGTATATTGAACTTTGATTAAGTAATGTGAGGCATGAAACTATCTGGCTCTTTGCCTTCTAGTTCCCAATCTGACTCCTATACTTTATTAGCTTATTGTTGATTAAGGGCAGGGTATATAACATTTGAAATCACAATTGCTAAATATACTCTATGATACCTTGACTGGCCAAAAAAGAACAGTCAGGGTCTCCCATAATCAGTGCATGAAACAAACGCAAAAGAATAAAATCAAAGCACATTGTTACTATCAGTCATCCTTAAAAGTGCTTTAAAGTAAAGTGCTGCCTGTTGTTAATATTGTTTCAGAAGTAACTATAATGGAAGAGAAAGAAAGGGCTTATACCCTAGAAGAAGAAGCTGTTTCAGTACAACGGGAAGAAGAATATGAGGAATATGAAGAATATGATTATAAAGAATTTGAGGAGTATGAACCAACAGAAGAATATGACCAATATGAAGAATACGAGGAGCGGGAGTATGAACGATATGAAGAGCATGAAGAATACATCACAGGTATGAGCAAAACTGCAAACTCAAAACCACACTAAATATGTGCACACTCAAACAAGATAAAACAAGATAAATCATAACAAGATAAAAATTTGGATACCCAAAGAAATTTGGAAAGAACTTTGTTTCATTTCGCAAATGCGGAATTTTCTTCTTTGATAACTTCTAGAAAAAATTTTAAAAACCCTCTATAAATCTTAAGGTTATTGTTAGACTTTTGTTCCGGGAATAATCTAATACCCCCCTCATTTTTGCTCGTATGCAAAATAGCAAATGTCCCTAAGTTTCTTTTTCAAAAAGGTTACAAGTTTATCTTCAAGTGCCCGTGATCATTCTAGTACATGGTTAAAAATTTCTGAACATCCTTTATTCTAAAACTTGCTATTACGGAGTATGATAGGCTATTGAGAAAATGTATTTACCCACAGGGTTCCCATTATCAAAACTTGACAATGACTGCTTCAAAAGTTAAGATAGAGATGTAAGCTAACACAAGCTGTTGTGTTTTACCTAATGAAGGTCAAATTTGTTGGCATATAGTTTGGGCTTCAAATTGTTTATTTTACTCAAAGAATAAATCTCTATTGAAATTTTGAAATGAATCAATCTTATTTCACTTATTCAGTCTCTGATGTTTCATAGCCCAACTTTGAGAACATTCTACATAGTCTTACTGATAGCTTTAAAAAAACCATATTATAGGGGAGTTTCAGCCAGGAATTTATCTACCTGAAATGAAATGAGAATTTTAATATGTAAGAATTACCTAATTAAAGAAAATAGCAAGAAGGAAAGGGCAATATGAGCTTGTTCTGCTTGGATCTCTGATTCTTGCCTACTTCAATAGGCTATGGCTATACTGTAGATAAAAGATATTATTTCAATTATTTGATTCCTTTTAAGAAATGTTTAAACTTATATTCTAAGTCTAACATGAAATACCTTGTATGTACTTTTAAAGAACCAGAGAAGCCTATCCCTGTAAAGCCTGTCCCAGAAGAACCAGTTCCCACAAAACCAAAGGCCCCACCGGCTAAAGGTAGAGTGAAAAAAACATTATTACCTGTAAGAGATCTTTGTTTCCTCCATGTCTGTCCTACTATAAAAATATATGTAAAAGTGGCAGTGTACAAATTATGTGTGTGTTTGGGAATATTATGTTGTATTTGTCTTTCTTAACTTTTTGTTCTTGCTAGCCTTGAGAAACCTGTTTCAATTTTTAAAATCTCTTAATATTGATATTTTGAAGTGCTGAAGAAAGCTGTCCCTGAAGAAAAAGTACCAGTGCCCATTCCTAAGAAACTCAAACCTCCACCACCCAAAGGTACATTACTGAGTAATAATCACCAAAAACAACTTTGTTATGTATGTTCTAAAATCATGTCTTCCTAGCCCGTCTGATGGTCTGTGTTTTTGCTGAGTAGGATGTTCTTGTCCTGATTCTTACATTTCAGTTTTTTATGTGTATTTATTACATAGTATTCAAGGAGTTGGTTTTAATGCTCTTTAATAATTAATATCTTTAAAGTGCCTGAAGAACCAAAGAAAGTTTTTGAGGAAAAAATACGTATTTCAATTACCAAACGTGAAAAAGAGCAGGTGACTGAACCCGCTGCTAAAGGTATAATGATTTCCTTCCTCGATTGTGATCTTTTCTGATGCCTCTTTTGAAATTAATGTAACTATGATTCATTTCATTTTGTTGTTTCATGTCTTTTAAATTAGTTGTCAGCAGAATGTTGGATGTAAAAATGTGTAAATACAGGATAAGAAGATAATGCCTTTAAAAGGAAAAATTATTTCTAAATACATCCATAGCCTGTTAGCCAGTGGCTGTGTCCTGCCACATGGCTACAATACATATAAAATAGAATGTTTGGGTTTAAAATCAGTGACCGTTTGGCATATTCCTGATTTACCTAAATGATGTAATGATACCATAATATTCACCAAGCTTTGGTAACTGTTTATTCATTCTAAATTCATTTTGAAGATTTTTTTTAAAGCTAACCAGTTTCCAGTCATTTTCCCCCTGATTCATACTAAGTATGAAGTATACTAATTGAGAAGTAAATTTCACTTTTCAGGAAGGATATTTCTTTCAAGCAGAGATATTTGAACACTAAACCTCATTTCACATTTGGGCTCTGCTACTTCATGTTTACTTGGGTACTTCTGTGTACTTGTATTTATATGAAGCTCAGAATCCTTTCCACAGAGAGTATATAGTTTCTTAAAGATGAACAATCGCATATGTATCTCATTAAAGGAAGATACATTATTCTATCTGCTTAAAGTACAGCAAAACAAGCATTGGCTGGGTGGCCTTTTACTGACAATAAAATTTCCTTATACTTCATATTTCAAGTGCCCATGAAGCCCAAGAGGGTTGTCGCAGAAGAAAAAGTACCTGTCCCTAGAAAAGAAGTAGCACCACCTGTTAGAGGTACCTAATGGCACTCATTTTAATGTTTTGTTCGTCTTTTGCTGTTGAATTCCTCTTCAGTTCTGTGTGTGAAAACTTCTTTTGTGGGAAAAGTAAATCTTGTCCTTTCTTCTGTTATAAATGGGCCTGTGTTTCTAAGGTGTCTTAATTTTGTTGAGTCATTGGCAAATGTCCAACTTAAAGATAATATCTTTAAAGTGCCAGAAGTGCCTAAAGAACTTGAACCAGAAGAGGTTGCCTTTGAAGAGGAAGTTGTAACCCATGTAGAAGAATATCTTGTAGAAGAAGAAGAAGAGTACATTCATGAAGAAGAGGAGTTCATAACTGAGGAAGAAGTGGTGCCAGTGATACCAGTCAAAGGTAGATGATGCCTCCTGCAAAGGGCTGTGCAACAGCATCTTTGGAGTTTGGGGGTCTGATTTGGTCAGATTCTGGGGGTTATTGGCAGCACCAATGATTGCTTACTTTAAAGCAGATATTTTTAGATGCTGAAATATGATTTCTACAGGTGCTTTTCACATTTTATTTCTTTCCTGCAAAATTTCCAACATTCTTAATAATATCTTTAAAGTGCCTGAGGTACCCAGGAAACCTGTTCCAGAAGAGAAGAAACCTGTTCCTGTTCCCAAGAAGAAGGAAGCTCCACCGGCAAAAGGTACACCACCATTCATTGACGGGTATCTAAGAGACTTCATCTGCCTAGAAATAGTTAACTTTCTTCTGAGTTCAAAACCTTGTGTGTGTGTCACTGTCCGTTGTTAAAAAACATTAGCTGTGTTTTATATGGATGTGTTGTTACTAGTAGTTAGAACTTAACAATAAACAATATCTTTAAAGTGCCTGAGGTTCCTAAGAAGCCAGAGGAGAAAGTTCCTGTGCTTATTCCTAAAAAGGAGAAGCCTCCGCCAGCAAAAGGTACATCCTTATAATCCATCAGTGGAATAGCATGATAATTCACCCATGCAGCATAACTTGGTGAGCCATAGCAGATCTTTCCCCATGACAATATTAACAACATTAATGCCATGACAAGCGCCTCTCAACTGGCCACAGGAGCAGTTTACCCGGTATTCATCTCTGAATTTTACCATCAAATTATGCTTATGCTCAATGGTTGGCTCCTCCTCTTTAGTGGAAAGTTCTTCAAGTAAAATACATTCCTTTTGCATATCAAAATGGACAAAACCATCATTTACCAGGCATTGTGTCTTGTCTTTATCACCAGTCCACGTTTTTTTCGGTGTTTTTTATTTTAATTTTTGTGTATTTTCTGGCCTTTGTTTTGTGGCTATTATAATTTTCAGTCTTAAAGTGAAATTGATAGAATATCTATGCTGCTTCAGTTAAGGCCTTACATTGCCAGCCTTAAAATCTTAGCTATGGGTAAAAAATGTGACACTAACTCTATTTGATATCTTTGAAGTTCCTGAAGTGCCCAAGAAACCTGTGCCAGAGGAGAAAGTACCAGTACCAGTTCCTAAAAAGGTGGAAGCTCCACCTGCCAAAGGTACATGAACTTGCAATGTTGCAATATTTTTATTTCACATTTGCATATGGGTAAAAATTAATTGGTTTAATTCTGTACTCTTTGGGATGCAACTCTTTAGAGAAAATTAAATATTTTATTTTAAAAATAAAATGCTTCTTGGAATACCTTTGTCATACTTTTATTACCTTATCTTAATCTTTTGAAACTATGCTTGGAATCAGTATTTTTATGTCGTATAAAATTTTTCTCTAAATCATTTCGTTAAAGTGCCAGAGGTACCCAAGAAGCCTGTGCCTGAGAAGAAGGTGCCAGTTCCTGCTCCTAAGAAAGTGGAGGCTCCACCTGCAAAAGGTACATAATTTCATCACTTAGAGTACTTGGGGGAAAAAACTCACATCTATGTATACTCACATACAAATTTCCCCATTACATTGTACATTTTTAAAGTGTCTATCTGGTTAGAAATATGTCAGATATTTTGTGATTCTTTTTCATATCTATTGCTCTAAGACATTTTAAAAGAACATATTCCTAAATATAAATAATATCTTTAAAGTGCCAGAGGTGCCCAAGAAGCTCATCCCAGAAGAAAAGAAACCAACACCTGTTCCGAAAAAAGTGGAAGCACCACCACCCAAAGGTACATTAATCTGTAACAGAGCCATGGTAAAAGACAAAACTAACTGGTGTTATACAGCCTTACTAATTATAATTAATGCTTAGTATTTATGTTGATAATAATTGATGCTTTGTGATCACAGAATATTTGCCTTTCATAAGCTTCTTCATTGTTGTGAATATTTTACATAAAAGTGATGTTTGTACCCTTGAATAAATATCTTTAAAGTGCCAAAGAAACGTGAACCAGTTCCAGTTCCTGTAGCTCTACCTCAGGAAGAGGAAGTTCTATTTGAAGAAGAAATTGTTCCTGAAGAGGAAGTTCTACCTGAGGAAGAGGAAGTTCTACCTGAGGAAGAGGAAGTTCTACCTGAAGAAGAGGAAGTTCTACCTGAAGAAGAGGAAATTCCACCTGAGGAAGAGGAAGTTCCTCCCGAAGAAGAATATGTACCTGAGGAAGAAGAATTTGTACCTGAAGAAGAAGTCCTTCCAGAAGTTAAACCTAAGGTGCCAGTACCTGCACCAGGTATAGCAGCTCTTCTTGGAATCATCAAGGCCTCTTTTGTGTTGAATTCTGCTTTCCCATCCTTTTGTTCATCTCCAGTTTTATCTATAATCCTTTACCCTCTGTGATTGACCACCTAAATCTTAGAAAACATTCCAGACATGTGTGTTCTTATTGTGTATCTGCCTTGTGTATCTGTCTATTGTAAATTATCTAAATGTCTTTTCAAATCACATATTATGTTTACATGTTTGTGGTCTTATCCTCACGTGTCTCTTTCATATATATATATATATATATATATATGACCATGTATATGTGGTTTTTAATGCCTTCAAATGAAATGTTTTTAAGTGCCTGAAGTGCCAAAGAAACCTGTACCAGAGAAGAAAGTCCCTGTTCCCGCCCCTAAAAAAGTGGAACCTCCACCACCACCCAAAGGTACACCTCCCCAAAGTGAATACACATTGTTCACCCATAGCTTGGTCACATAAATTATGATGAAACTGGGTTTTAGGAAAATTATATTTACAAAATGGATAATCACACAGTTACATATTTACTTCTAACGATGTTCAGGAACACTGATATCTACTTTTTTCACTGATACAAAGCAGTATTCAAGAACAAAGATGAAAGGAAGCATTGTCCCAGAACTGATACAAAAGTTCTGATTTCATATCATTTGATTAAACATCATAGTTTTCATGGAGATATATTTAAATATATATGAATAAGTATACTATATATTTAAATGTATTGAAAACTATTATGAATAAATATTCTTAAATTTCTTCCTTCAACCATTTATATTAAATGCCTTTTTAACACCAGGCTAAAAAGAAAAAAAGATGAATGTATTTATCAAAACACAGAATAATAGTTATGTCTTCTAATACATATATATAAAGGGCAGCCCAACAGGTTTTGATTTTAGCGTTGACTTTACACCTTGTTGTATTACTCTCAGCGAGTCCTTTAACCAACCTGAGCCTGAAGTTATTTTCCTGTAAATTGGGGATGCTAATATCAGTCTTAATGGGCTCAGCTATTATGGTGAGAATTAAATAAAGTAAGGTATTAAAGTAGTCTATCATTGAATGAATAGTATCCAGATTTAACATATTCAATCAGCTCATAGTACAGGACAGAATTAATATATTTGTGCTTTAAAGCTCAATAATATTTTCTACAAAAGATGCTGGCATGGCTGCTTAAAATCAGCATAACCCTCGCATCAGGCCATATAGTTATATAATCAAATGAAATAGTAAAGCTGATCTTTTATTGGATATCAACGATTCAGAAATACTTTCTAGACAATAAATTACTAGTGAAATTTAAATGTATGAAATGATATTAGGTTGGTGCAAAAGTAATTGCGGTTTTTAGCATTAAAAGTAATGTCAAAACCGCAATTATTTTTGCACCACCCTAATAGCATCTGTCCTCTGATAATGACATATGCTGCTGGTCCCTTGCTTTACAAATCCCAATTACATTATAATATCTGGGCTCCCAACTAACATGACAGACCTGTCTTGAGCGACTGTTAACACATTGGTCTTTCTGGGTGTGGGGTCTTCTTGGTTTCTCTTTTTTTGTCCTTCAAAATAAATCCTTATCATGAAATGATGTCTTTAAAGTGCCTGAAATTAAGAAGAAAGTGACAGAGAAGAAAGTGGTCATTCCCAAGAAAGAGGAGGCTCCCCCTGCCAAAGGTATTGCTATTCCGAAGTAAATTAGACTATGCCATTTCCTTCCTTCTCCTATAAAAGTCAAAATGTCCTGTTTCCGTATTTGTTAATACAACTTATATTACTGCTGTGTCTACTTGTCTTTGTGTGTGTGAAACTGAACTTATAAAATAAAATAATATTTTTAAAGTGTCTGTGGTACCTAAGAAACCTGAGCCAGAAAAGAAGGTCCCTCCTCCTGGTCTTAAGAAAGCAGTGGCCCCTCCTGCCAAAGGTACATCATCCCATAACAGGGATATGTTTGCTGCACCGATGTTGAACTGTGGTTCTATCCACACAGGACACTCAACATAAATGTGTGCATTGTATGGTCTGTCATTCACATTCGTCATTTCTGACTCTTTTGCACCCAAGTTTGTGTTGTGTCCATTTTTTCACTTGGTGTTGGTGTGCTTTACATCGTTTCTCTATGTATGTTGTTTCTAAAAAATAAAAATATATCTTTAAAGAGCCAAAAATAACTAAGGAACTAGTCCCTGAAATACCCATTTCTTCATACCCATTTCTTCCTACAAAAAAAAAAAAGACAAAAGAAAAAAGAAATAGAGGCTCCAGCAGTAAAAAGTAGAATTTCTCTTTAATAAACCCTAAATCTTAAACCACAAACCTTTTTATTCTTTTCTCATTAACCGATTCTGTGAAATGTCAATGTTTCATCTTGTGTATGTGCCTTGTGATATTTACTCTCTTATGTTGGAAACTGGAAACGTGGTCTTTATTCTTCTTTGGTTCTTGCATTTTAAGTGTCTAAAATAATCAATGTCTCTCAAGTTCCTGAGGTGCCTAAGAAGGTGGAAGAAAAACGAATCATTCTCCCTAAAGAAGAGGAAGTTCTACCAGTTGAAGGTAGATAACTTTCTAAGAAAATAACATTTCAAAGTCATCCTTGTCTTATTATTGTCTAATATTTGAAGTAGGTAAATGTAAAATTTACCCCAGGAAATCAACATATTCAGATTCTAAAATAAATTATTATTAACCTAATAGAAATTGGGCAGGCAAATTAATATTATTTGAATCTCTTTGCATGTTCAGCCTGTTTGTCTGTTTGCTATTTGTTTTATTTTAATTAGAATTCATGAAGGGAAACTGTATTTGCTGTGGGAAATTTTTCATCAAATGACTTAGTAGGCAACTGTAAAATAAGCTTATCCAAGAGAAATTCCAGTTAAGCCTGAGTAACTGGTGCAGAAAATCTGATTTCTACCCCAAGTGGCTGTTTGACTTCAAACAAGTCTTTCATTAAAAAAAAAACAATAATAATTTTTTTATTATTATAAATTATCTGAAGTCCTTTCCAGTTCACAAATGCTGGGATATGCCTAACATATTTTGAAGACCCAGTAGAGATTTTTTAAGGACTAGTGAGTTTACACAAGCGTTTCGAAGGCTGAGCAGTTTTCAGATATTATCACTGTAGTCTAATATTCAAAATAATTATAAAAATAATTTACAAAATAATAATCTTTTTAAAGTGACTGAGGAGCCTGAAGAAGAGCCTATTTCAGAAGAAGAAATCCCAGAAGAACCACCTAGCATAGAGGAAGTTGAAGAGGTGGCACCACCTAGAGGTATAACCGCTTTTAAGGATTGAACATTTAAAATTCCTGGTGTTCCAAATCTTTCTCAGTAGCTAAATCTAAGATTCACCAGTATGCTTTTCTTATATCGTATCCATGATAAAGTGAAGATTAATTATTCCTGGCACCTGAATCTATGTGTCCTTTTTTTACCCTAAATTTTTCTACAACATCTGCAATACAACTAAGAATGAGAGATTACTATTTTGTTATTGGCGATTGAATTTTTTTCTGACCAGGCCCTACTATAATAGTTTCTCCTAGATTTCAATCCTTAATTTTGTTTTTAATATTAATATGGGGGGAATCTATTTCTCTGGTGAAAGTGTTCATTTTTTAAGAAAAATCTTTAATTTACTATTCCTGAAGAGTGTGATAATATTTTGCATAATTGGTATTACATTTGCTTATAGGATTTCTAAGTAATATCCTTTACACCTCTAGGGTTCCTACTCCACATTTATTATTACCATTTAGGTTGCTAATATCTTTTAAAAATAAGTCAATGTTTTGTGATATTTATTTATTGGTATATGGGTGGTGTTCTGCTCATCACATGCCACTTTTCAAAATGTTCATAAAATTTCTTTTAAGTGCCTGAAGTGATTAAGAAAGCAGTACCTGAAGCACCTACTCCTGTTCCTAAAAAAGTGGAGGCACCACCAGCTAAAGGTATATCAAATCCTCATTATTAATATCTTTAACTTCCCATTAATTTTCTTTCTTAAAAGCAACATTTTCTTTTTTGACTGCCTTCTTATAATCATTTAGATAGTGAACTGATTAAGGACCAGTAAAAATATAACTCATTCCATTTCTTTAATCTTTTCTAGGATGTTAACGAATAATTGTGTGCATGTGTTTACGTATGAATTATTCTAGAAGCTTCTTAACTGAGAATTTTAATATATTAGTATGTCTCTATATACTTATACACATAGCAATGGATCCCTCTTCCCCACATTTTAGATTTTATTCCATAAGTGGAACGGAGTTTTCTTCTGTGTTATAATAATTATTTTACTATATTTATTATTTTATGGAACAAACCTAATGCTTGGATAATAACTATTTTAAAGAGCCTCACGTCCCTTTTGTAATGTTTAGCCCAAGCATTCAAGGTTATTACAAAATGTCTACTTTTCCCTGCTTCCTAATTCACTTAATGCTTCAGACAGTGCTCTTAAGCAGTTAGATTATGCTGTCCCTGTCATAGTAGACTCCTCAGCTAATAGAAGAGTGCACAGCAGAAAGTGAGGCCAGTGTCAGGGCTTAAATACTCTACAATGGTAATCACTTCAAAAAAGTCTTCATCAAGTTAAAAATAGTAAAAGTGAGTCCATATTGGTAATCCCTGTTATTAAAAGAAAAAAAAAAGAATGGCACAGGTACTTTGTGGACATTTCTTCTTCTATAGGAATGTTAGAACAAATGAGTGATTTGAGAAAGTATCTTTATTGCCTCTAAAATGGATGTCCCACAGTACAGAGTGACTTCTGAAAAACTTTAATTATTGTAATGTTGGCGTTGTCTCTGGTGTTTTTATTTCATGTGTGTTATTGAACATTCTCAGCTAACTAAAACACCTAATATCTTTAAAGTGTCAAAGAAAATTCCTGAGGAAAAAGTACCTGTTCCTGTTCAGAAAAAAGAGGCACCCCCAGCCAAAGGTACATCTTCTCTTTTAAACCTGACTTCCTCTTCTGTCTTTTTTCGTTAAGACTTTTATGTTTCATGTCTCTGTGTCTTGATTGTTTTTGATGATTTTTGTCTATGAAAGCTTGCTCTCGACAGTCCTAAATATTAAAACTGTATCTTTAAAGTGCCTGAAGTACCAAAGAAAGTCCCAGAAAAGAAAGTCCTTGTGCCTAAAAAGGAAGCTGTTCCCCCAGCTAAAGGTATTTTTGGAAAGATCCTGGATTTTCGTGTATTGTTGCATGCAATCCTTTATTCAGTTTTAAAAATATATATTTTGAATGTACATCTTTATTTCTTCAGTGTTTAAAAAAATAAGTCTTAAAATAGATGCTCTTTCAGGGAGAACTGTCCTTGAAGAAAAAGTATCAGTTGCCTTCCGCCAAGAAGTAGTAGTAAAAGAAAGACTAGAATTAGAAGTAGTAGAAGCAGAAGTGGAAGAAATTCCGGAAGAAGAAGAGTTCCATGAAGTTGAAGAATATTTTGAAGAAGGCGAGTTTCATGAAGTAGAAGAATTCATCAAATTAGAACAACATAGAGTTGAAGAAGAACACAGAGTTGAAAAAGTTCATAGGGTAATAGAAGTTTTTGAGGCTGAAGAAGTGGAAGTATTTGAAAAACCAAAAGCTCCACCTAAAGGTATAGGGAATTCTTCAAATACTACAAATTCTTATATCTTGCTCTAACTTTCCTTTGAAAGTAAATTTTGTGTTCAGTTTGGAAGATTAGAAACCCCATGAAATACTTTAAACATGAGTTTAAACTAGTTGACACAAAGATTAATATCTCTTAACCACACGGAGTATAATTTTAGTAGATGATAGTAATATTTGATATCTACTTATCTAAGGAGGTCACTGTATGAATTTGGGGATTATTTTTTAAATCTGACTAAGAATGTTACACAATTGTTACAGGTACCAAAATAACTGACCAGTGTCATTGGTTAAGTGAAAAAGAAACTCCTCAGTTCACTGAGGAATTTACATGTTCAGGCAAAATAATCACTGCTTTAACATTTTAGTCAACTGTTCACAAACTGAGAAATACTTACCAAAAGCTTTTGCCAGTTTATGATACTTTCATTAGAGAAACAACATTAAGGAAGTGAAGTATTGTTAATGGCACCTGTATTCTAGCATACTGTGAAGACAAGCCATAGCACAAATAAGTTATCTGCAATACCACTCTAGATCTTGCACAAATTAACAATATATGTGTAATATGAAGGAATGTGTGTGTGTGTGTGTTTAGCATATATAGCAAATTACAATATACATGATATTTAGCAAATCAAATCTCTTTTGGAAATAAGTGTGTTATAAATTAAAAAAATATAGATAAAGAATTTTGTGACCCCTCATTGTACTAACGTTAGTAGTAGTGCTCCAAAATACTTCAAGAGTTCATTCTAAACCAAAATACTAATATCTTTGAAGGGCCTGAGATATCTGAGAAAATCATCCCTCCAAAAAAACCGCCCACTAAAGTTGTTCCTCGAAAAGAGCCACCAGCTAAAGGTATCTTCTTTGTGAAAAATTACTACTTAACTTTACATACAATAGCACCTTGGTTGCTTTATAAGCACAAGTTTGCATTCCACTTGATGTCTTTCTTCTGTATTTCTTGTTTCTGACATGTCTAAAACAAACTAATATCTTTAAAGCAGCTGAGGGTCCAAGGGAAGTTCTACCAAAAAAAGACAGTCACTGTTGTTATACCTAAAACAACCAAAGCAAATATCTCTAGTAACCAAATAGTGAGCCCAAATTTCCTCCTTTGGTGCTATTTGGTTATATATTCACTAACATGCTTACTGATAAACACATGTTTTTCTATTTATTATTAATTATATTAACCTGGCAAATATAAATACATAGTGAATATGTGTTTAATGTTCTTGCTTTGTTCATTTTTGCAAATCTCTTAAATTTCACAATAGAAATAAAAACAGTATCTAATAAATAATATAAACTTATTTCTTTAAAGTCTCTGAAGCATGTGCGTAAGTTATCACTGAAGAGAAGGTAGCAACTCTTCCACAAAAACAAACAGTAATAGCACCAGCTGAAGGTGTACTGTTAATTTTTCTTCTCAAGTTCTTACCATTCTAACATGGGAAATTTCCCTGGATTTTTGTTATTATATATTTTTTAAATTCAATGCATTTGAAATACTGTAATGTATTTGATAAAGTGTTGTCTGCATTTTATATTGTTGCTGTGTTCTGTTCTGTGTTTATATCTCTCATGCTCTGCTTGTTAAAAAATTGTATATTTAAAAATAAAAGAAATTATTACTATTATCTTTAAAGTACCGGAGGTGCCTAAGAAAATTGTGGTAGAAGAAAAAGTACGTGTTCCTGAAGAGCCCAGAGTTCCACCAACTAAAGGTAACTGGCTTTTCTCATTCATCATTAATATAAAATCCTTTTTTATTCACTTACTATGTAAGAGAGACCTTTCTCTTCTCAATGCCACAAGATGGCTATGAATGACATAAACTTCAATTTATGTTCTATAACATAATCCTGCCTTTTGAGGCAATGTTTTAGGCGTAAAGACATAAGCCCAAAGTTATCATTTGTATTGATCCTCTTATTTAATAACTAAATAATATTGATCCCTCAACTTCTCTTTCAAAAATAATTCATTTTGGAAGCTCTTCTGAAGTAGCTCTGGAAAAAAAAAAGTGTGCTCTAAATGGCAATAGAAAATGATACTATCTCCAAAGAGCAAAGTGTTTCTGATATAATGAATCAAGAACTCATCGACAAAGCAATTCAGAGAAATGCAATGACTACATTTGACTTATAGTTGACTTATAATTGAGGGGTTTTTGGCGTTCATCTTGTTAGATGCCCCTTCTAGGCTTGCTATGTTTACACCCAACTATAATGTTCTGAAAAAATAAGATAAATAAATATCTTTAAAGCACCCGAAGTACCCAAGAAAATTGTCCCAGAAGAAAAAGTTCGTGAAGCTGTTCTGAAAAAGCCTGAAGTTCCACCAGCTAAAGGTATACAGTGATGCTAATCAGAACATGAAATAATTCTTGGTTTAGTTTTTCATGGTTTAAAGTGAATGTGTGTGACATTAAATCCTTGTATTTCGTATCTTATATTTGTTATCTGTAACAATTAATATACTAATATCTTTAAAGTTCCTGGGATGCCTAAGAAAAGTGTTCAAGAAGAAAAATCACCTATTGTTATTTCTGAAGACACAGAGATGTACAGTGAGTGTAGAAAAATTAGTGGTTCTTTTTCGTTTCATTTATGTCCTTAAATTCACTATGTTTGTCTTTTTAGCTTTGAAAAGTAAATATACTAAACTCTTATAAAAGCCTAACATGCCACAAATATATGACTCAAATAATCTTAGTGTCTATTATCCTCAGACAAGTTATATTTCCTCACCAATTTAAAAAAGAAATACTCTACTTATCAGAGTGTATGATTTCAGAAAAGTCAGTTGTCTTGTTAAATTTTCCTAACCTATTCTGTATACAAGTGTCTTTTGCTTTGAAGCAATTTATTTTCTCAGATCATGAAGTAACTTAACTCCATAATATTTTAATTGGATTTTATAAAATCAAAATGTTTCACCATTATTTTTTTTTTTACTCTTGATAACCATAATTGGAAACATTTTGGCAAAACTGCTCAAAGGACCCTAGGTTTACAAGGCCACTCAAACCTCAAAAGAATTCTCACGACCTTTTTTTTTGGGGGGGGGTTTCATACAAAATTAGGTTTAAATAATTTGAATTATGAAATAATCCAAATAGTAAAATATTGTGAATAGAATACTGTTCAACAACCTGAATAGTAAAAGTGACAGTAGTCAAAATATTCTTCCTTTTTTTTTTTTTTTTGAGATGGAATCTCACTCTGCTGCACCCAGGCTGCAGTGCAGTGGCACGATCTTGGCTCACTGCAACCTCCGTCTCCTGGGTTCAAGCTATTCTCCTGCCCCAGCCTCCCGAGTGGCTGGGATTACAGGTGCCTACCACCAGGCCCGGCTAATTTTGTGTATTTTTAGTAGAGACAGGGTTTTACCATGTTGGTCAGGCTGGTCTCAAACTCCTGACCTCAGGTGACCCGCCCACCTCAGCCTCCCAAAGTGCTGGGATTACAGGCATGAGCCACTACACCAGACCCGCTTCCATTTTTTTTAATCTAAAAAATTTCCTGTTGAAACTCAACTTTCTTGTTGTTCATCCTGTTATACTAAGTTGGGATAAAATAATATAATCACTTCCTCCTTTGAATATCCTTTCTATTCTTGACTTTAGTTATTGTTTTCAGACAGTTTTTCTTTCTAAAGGCTGGAGAAATTTTTGTTGTCTTTATTTGCCTTATTTTCTAAGTATTTAATTTTTTTAATTTTCTGCCTCCAAACCCTAAATGGCTTTTACATTCATATTAAACTGTGAAACCATATATTAGATGTGATTTGAAAATATAGATAATGAGGCTTCTAGAAAGGGAAAAGACTTACATGAATTTCTAGTAGGTCAAATATCGGAGAATTCTCAATGTGCAATTCAGCATCTTCCCTGTTCTTTATAGACAAATCCATTAAAAATAAGACCAATAGGACAATTTTACCAATAACTTTCTTAAGGCAAAATGAAGAATTATATAGTCCTTGCCTGAACAATTCCTCCATTTTATTATCATCATCATAGAGAAATGCTTAGAGTCTTACATCATGAAACTGGGAGTGAGGCTATCCCCAGCCAATGCATTCTAGCCACTAATTTGCCTCTATGTGCTACTATTAATTTTGGTGATGAATGTGGTATTATATATTATATTTTTCTTAATACACTTCTTTATCCACCTTGAAACATCCTAATTATTTAAATACTAATATCTTTAAAGTTTATGAAGCATCTGAAGAAGCAGTCCTAGAAGAAAAAGTACTTGTGACTCAACCTCAAAAGACAAAACCCAAACTAGCAAAAGGTATATAACACCAATGATCCACTCTGAAGAAAAATTATTTTTTGGCCCCTTTTAAAAAGCTCAATATTTTTCTTCACCATTTATAAATATAACTATACTCATATCTTTTAAGTGCCTGAGCCACCCAAGAAAGTTGTTCCAGAAGACAAAATATATGTGACTATTCCTAAAAAGAGAGAAACACCAGCAACTAAAGGTATATTTCAAATACATCAAACCCAGATGAGTATCTTTAGCTTTATGACTCAAACATTGCATGCTTTTTATAATTTACTGTTTTTACAACTTTTAAATGTAAACCTACTAATATCTTTAAAGAACCTGATACAACCAGAGGCATTTTTCCAGAGGTGGAGCCACCTGAGGCTATTCCTGAAATTCCAGAACATCCTCCAACTGAAGGTATAATTCTCTAGTTAGGAAAATCTAAAGAAGAAAATATACTGTCTTCAGTCTGCAAAATATTTAATGTTTAATATACATTCTCACAACCTCTAATGTTAAAATACTGTGTTTAAAGGATCTGATATACCCACAACAAAGAATGACCTATGACTTGCCCCCAAGAAAGTCAAGTCCCACACATATAATATACAAAGATAAAATATTAGAACAAAAATAACATTTCTAACATAAAGATATCTGAAATGATATTAACATATCTAACTTTCTTAGTATGTCATGTCTTTATGCCTTTGCCTTTTCTCAATTAAAAAAAATACTAATATCTTTAAAGAGTTTGAAGTCTTCAAGGAAGTCATTCCAGAGGGAGAAACTCCTATTGTTAAAAGAAGAAAAACACCATCACCAACAGGTACAAGTTGGAAGAAAGTCACCTTTTTAATCTCATGTTTGCAGTTGTACTTAACACATGTAAAAATACTAATATCTTTTAAGCCAAAGTGGCTACAGTGGAAATCATTTCAGAGATGGATCCCCCAAGTAGAAGCTCAACCAAATGTATTCATGTCCCAGTGAGTCACTCAAGAGACAACAGAGGGAAAAAATACCTTTAGCTTATACACATGAAAGATAGTTGAGTCAGTGTATTTTTATGAGGACTCCAAAGAAAATATATATACACATATTATGATCAAAACATGTCTTAAAGAAAATATTAATTCAGTGTGAAGCTGATCTGTAATATCTCTACAAGATTAGAGCACCTGAGACCCTCCCAGAATATCCTCCAACCTAGGGAAAAATAATTCCAGTTAAAGCTGGAAATCTCCCCTCCATGTTCATTTGCTCCTCTCATAGCCTATCTTTTATTTTTCAAGCATCATTTTTTTTCATTTTGAATATCTTTAGATAAGTCAAAACATGAAAAAGCTTTAAAACCTCCAGAACAATAATTTCATCATAACACCCATGGTATTCTGTAATTTGAAGAATATCTGAATATTTTGATATTTTTTCTCAGTCTGGAATCTTTTGGTTGTTCTCCTCTCTCCTAAACTTGAAAAACACTCACCTTTTTAAGGTGCCTGAGGTGTGAATACAAAAAAATGCCGACCTAGATTTTTCGAAGTGGCTGTAATTTGTTTTTCTCAACATAATAGCTAGAGGTATAGCATTAATTATAATCAATGTTTCCACTTTCCATGATCTAGTTTTCTATGCATCTACCATTCCAAGAAATAAAATTACTAATACTGATAGTGCCTGAGGTGACCAAGAAAACAGCCGCTTATAACCAAATACTCACACTGCTACAAAAGATCCGATTCTGGGGGCGGGGAGTGGGAGAAGGTTCCCATCTGGAATGTTCTGTATGTGCAGTTAAGATGGGAACTCTTTACTCCTCTTCATAACTCCAAAGTACAATGCATTCATATCTTTAAAGTGCCTGAATCACCTCGAGAAATTGTCCCTGTAAAGGAAACACCCATGGCTGCTCCCCTTGAAATTGAAATACCTCCCACTAAAGGTATCGTTCATCCTGCCATTCCTTCCTTCATTTATTAGAGTGCTTAGCATGTACAGGGTGCTAGGGAACTGGAGAATAATAAACAAAGACAATTAATATGTGGTTCCTCTCCTCAAGATTGTATACCTCCTCAGATTCTTTAAAGGAATCATCTTTTTAGCCATAAATATCACTTTGGTTCAGCTCATTTAATTAATGTCTCCACTGATCCTTTTAACCTCTAACCATAATACTAATATCTTCAAAGCACCAGAAGCTATGAAAGAAGTTGTCCCTGAAATGAAAATATTTGAGGATGTACCTGAAGAGCCAGAAACTCCACGTATGAAAAGTACGTTACCTCTGAACAAATGTGGAAGAAGAAATTATCTGTCCTCTGCTCTTAAAACTATGGTTTCTTCCTAATACTCTTCATAAATTCTAAATATAAACATACTAATATCTTTTAAGTGTCTGAGGTTCCACAGGAAGTTTCCTCTAAAAAGAAATTATTTATGGCTGTTTCTGCCAAAACAGAAAACACTCCTGCTGGAAGTATTCATTCAACAAATCCTTTATAATGAGAGTGTAGAGTGTCGCGAGAGCTCTGTGAGGTTCTGGAGGAGGGGGAGCACCTCCTCTCAAGGATCCACTAACCCCTTAAAAGACTTAGCCTATTGGTGGAACAAAGGGAGGATGGAGGAAAGAGAAGAAAATGTGGTTATATTTCCTAACTTATTGTGGTTACTGTTTTCCATTAATCATTTTAACTCTTAAATGTGAATTGCTAATATCTTTCAAGCGCCCGAAGCTCCTCAAGAAATTATTCCTGCCAAGACAGTTCCTTCCAAAAAAAGAGAACCCCCATCAGTTAAAGGTACAAGTCACCATGCTCTCAGGGTCAAGAACTAGCTCTTGTAGTTTTGAGAATATTTTTGCTATTCCTAGTTATCTGCATAACACTAAACATAAAACTACTAATTTCTTAAAGTGCCTGAAGCTCTCCAAGAAATTGTCCCTGAAAAGAAAACGCTTGTGGTTCCTCTCAGAAAGCCTGAAGTCCTTCCTGATGAAGGTATATCTTGCTGGAAGCTTAGAGGGGTGGGAACATGTCTTTTCTTGTATAAATGTTTTTCCTGATTGTGTTGATTCTTGTAACTTCTAAATGTAAAATTATTAATATCTTCAAAGTGCCGGAGGCTCTCAGAGAAGTTGTCCCGGAAAAGAAAGTGCATCCTCCCCAAAGGGCTGAAGTTGTACCTGTCAAAGGTACATTCTTAACTGTCTTTTTATGGTGGGATAGTGGGTGGGGCGATAGAAAGGACCACCTTTCTAGTTTTGAAAATTATTTTGATGTGTACATGTGAATCATGTCTGTGTTGACTCTTGCAACTCAAGTGTAAATGTATTAATATCTTCAAACTGCCTGAAGCTCCCAAAGAAATGGCTACCAAAAAGAAAATACCGGAAGTTCCTCCTCTAAAACCTGAAACACCACCTATTATGGGAACTTGTTACCACTGATCTCAGCTCAGGAGAAAAAAATAGCTCTTTTGTTCTTGAAAATGTCTTTGTATCTATCTAGTAATCTCTGTATTTTCTGAGTGTAAAAATACTAATATCTTTCAAGTGCACGAAGCTCCCAAAGAGATTATCCCTGAAAAGAAAGTGTCGGTGGTGCCTCCTAAAAAGCCTGAAGTCCCACCTGTTAAAGGTATTTGTCACTGACTTTAGGCTTCAGAAGACCTAATTCTTCTGCTCTTGACAATATTTTTTTCTAGCGGTCTTCATAACACCTAAATGTAATTTCACTAATATCTTTCAAGTGCCAGAAGCTTCCAAAGAGGTTATCCGCGAAGAGAAAGTGCCCTTGGCTCCTCCTAAAGAGCCTGAAGTCCCACCTGTTAAAGGTAGTTGCCACTGACCTTAGGCTTCAGATCTCATTCTTTTGCTCTTGAAGATATTTTTTCCAGTGGTCTTCATAACTTCTGAATGTAATTTTGCTAATATCTTTTAAGTACCAGAGCCTCCCAAAGAAGTAGTTCCTGAAAAGAAAGCGCCAGTGGCTCCTCCTAAAGAGCCTGAAGTCCCACCTGTTAAAGGTATTTGTCACTGATTTTAGGCTTCAGATGATGTATCTCTTCTGCTCTGGAAAATATTTTTCTAGTGGTCTTCATAATGCCTAAATGTAATTTCACTAATATCTTTCAAGTGCCTGAGGCTCCCAAAGAAGTTGTTCCTGAAAAGAAAGTGCCAGTGCCTCCTCCTAAAAAGCCTGAAGTGCCACCCACAAAAGGTAGACACCCTCTTGTTGCTGTGTTTGATATTGTTTGTTTGTCTTTACTTTGTCTAATAATGAAAATACTAATATCTTTAAAGTCCCAGAGGTGCCAAAGGCAGCTGTCCCAGAAAAGAAGTTGCCTGAAGCTATTCCTCCCAAACCGGAAAGTCCTCCCCCTGAAGGTAATGCCAAAGCTATACAAACTATAGGAGAAAAATAACTGTTATTTTAACTAGGAAATTACATGTTAAAAATCCTACTACATAAAGATGATATAATTCTAAAGAAAACAAATGTCAATCGCTATCCAAAATATCTTGGTGGGTGTTTATATGCAAAAGGCATCCATCATTTTCACCTTTTCTAAACACAAATTACAAATATCTTTGAAGTGCCTGAAGTGCTGCCACCGAAGGAAGTGGTCCCAGAAAAGAAAGTACCGGTGCCTCCTGCCAAAAAGCCAGAAGCTCCACCTCCTAAAGGTAGGTATCATTACACATTGTCAGTCGGGGGGCCCTGGGGAAAGACTGCATAGAAGTGTCCGCCGATCTCACAAGTTGTATTTGCTTGGGTAAATGTGGAGTCGATATTCCCCCTTTATAGCTTCTAACTAAAAGATACTAATATCTTCAAAGTTCCTGAAGCTCCTAAAGAAGTTGTACTTGAAAAGAAAGCATCTGTGGCTGTGCCCAAAAAACCGGAAGCCCCACGTGCAAAAGGTATTTATTCCCTCTCCTCTGCTAAGAAAAACTTATCGTCTGTACCCCTCACAATCACTGTAATATATACCTTCACCATTCATAAATTATAAAAATACTAATATCTTTCAAGTGCCTGAAGCTGCTCAAGAAGTTGTCCCAGAAAAGAAAATTCCCAAGGCACCAATCAAAAAACCAGAAGCCCCCGCAGTTACAGGTACATGTCAGCTCAACCTTATCCTGCAGAAGAAATCTCTCTTCCATTCCTGAAAACAATTTTAGTCCATTCCTCTTCATTAACCTAAGTATAAAACTACTAATATCTTTCAAGTGCCAGAAGTTCCTCAAGAAGCCACAGAAAAAGAAATTCCCGTGGCTCCACCCAAAAAACCAGAAGCTCCAATTGTCCCAGGTACACTTTAGCCCTGACTTCATTCTGCAGAAGAGATATCTCCTCTCCTACTGTAAACAATTTTAGCCCATTTCTCTTCATTAACTTAAGTCTAAAACTACTAATATCTTTCAAGTGCCTGAAGCTCAAGAAGTTGTCCCAGAAAAGAAAGTTCCTAAGGCTCCTCCCACAAAACCAGAAGCCCCACCTGCCACAGGTATTTTTTACCCCTGTCCTTTTTCTGCAGAAGAAATATCTCTTCTGATCTTAGAAATATTTTACTCCATTTGTCTCATTAACCTAAGTGAAAAACTACTAATATCTTTCAAGTGCCTGAAGTCCCACAAGAAATTGTGCCAGAAAAGAAAACACTGGTGCTTCCTAAAAAGCCAGAAGTTCCACCTGTTACAGGTACTTGTCATTTGACCTTAAGCTTCAGAAGATCCAATTCCTCTGCTGTATATTTTGCTAGTAGTCTCCATAGCTCCACATGTAACTTTACTAATATCTTTTAAGTGCCAGAGGCTCCCAAAGAAGTTGTCCTTGAAAAGAAAGTGCCCTCGGCTCCTCCTAAAAAGCCTGAAGTCCCACCTGTTAAAGGTATTTGTCACTGATTTTAGGCTTCAGATGATCTATCTCTTGTGCTCTGGAAAATATTTTTCTTTTTATATATATATATATTTTTATTATACTTTAAGTTCTAGGGTACATGTGCACAACGTGCAGGTTGTTACGTATGTATACATGTGCCATGTTGGTGTGCTGCACCCACTAACTCGTCATTTACATTAGGTATGTCTCCTAATGCTATCCCTCCCCCATCCCCCCACCTCACAACACACTCCGGTGTGTGGTGTCCCCCTTCCTGTATCCATGTGTTCTCATTGTTCAATTCCCACCTATGAATGAGAACATGCAATGTTTGGTTTTTTATCCTTGTGATAGTTTGCCAAGAATGATGGTTTCCAGTTTCATCCATGTCCCTACAAAGGACATGAACTCATCATTTTTTATGGCTGCATAGTATTCCATGGAGTATATGTGGAACATTTTCTTAATCCAGTCTATCATTGATGGACATTTGGGTTGGTTCCAAGTCTTTGCTAATATGAATAGTGCCGCAATAAACATACGTGTGCACGTGTCTTTATAGCAGCATGATTTATAATCCTTTGGGTATATACCCAGTAATGGGATGGCTGGGTCAAATGGTATTTCTAGTTCTAGATCCCTGAGGAATCGCCACACTGACTTCCACAATGGTTGAACTAGTTTACAGTCCCAGCAACATTGTAAAAGTGTTCCTATTGCTCCACATCCTCTCCAGCGCCTGTCGTTTCCTGACTTTTTAATGATCACCATTCTAACTGGTGTGAGATGGTATCTCATTGTGGTTTTGATTTGCATTTCTCTGATGGCCAGTGATGATGAGCATTTTTTCTTGTGTATTTTGGCTGCATAAATGTCTTTTTTTGAGAAGTGTCTGTTTGTATCCTTCGCCCACTTGTTGATGGGGTTGTTTTTTTCTTACACGTTTGTTTGAGTTCATTGTAGATTCTGGATATTAGCCCTTCGTCAGATGAGTAGATTGCAAAAATTTTCTCCCATTCTGTGGGTTGCCTGTTCATTCTGATGGTAGTTTCCTTTGCTGTGCAGAAGCTCTTTAGTTTAATTCGATCCTATCTGTCAATTTTGGCTTTTGTTACCATTGCTTTTGGTATTTTAGACATGAAGTCCTTGCCCATGCCTATGTCCTGAATGGTATTGCCTAGGTTTTCTTCTAGGGTTTTTATGGTTTTAGGTCTAACATTTAAGTCTTTACTCCATCTTGAATTAATTTTTGTGTAAGGTGTAAGGAAGGGATCCAATTTCAGCTTTCTACATATGGCTAGCCAGTTTTCCCAGCACCATTTGCTAAATAGGGAACCCTTTCCCCATTTCTTGTTTTTGTCAGGTTTGTCAAAGATCAGATGGTTGCAGATGTGTGGTATTATTCTGAGGGCTCTGTTCTGTTCCATTGGTCTATATCTCTGTTTTGGTACCAGTACCATGCTGTTTTGGTTACTGTAGCCTTGTAATACAGTAGCGTGACGCCTCCAGCTTTGTTCTTTTGGCTTAGGATTGACTTGGCAATGTGGGCTCTTTTTTGGTTCCATATGAACTTTAAAGTAGTTTTTTCCAATTCTGTGAAGAGAGTCATTGATAGCTTGACGGAGATGGCATTGAATCTATAAATTACCTTGGGCAGTATGGCCATTTTCACGGTATTAGTTCTTCCTATCCATGAGCATGGAATGTTCTTCCATTTGTGTCCTCTTTTATTTCGTTGAGCAGTGGTTTGTAGTTCTCCTTGAAGAGGTCCTTCACATCCCTTGTAAGTTGGATTCCTAGGTATTTTATTCTCTTTGAAGCAACTGTGAATGGGAGGTCACTCACGATTTGGCTCTCTGTTTGTCTGTTATTGGTGCATAAGAATGCTTGTGATCTTTGCACATTGATTTTGTATCCTGAGACTTTGCTGAAGTTGCTTATCAGCTTAAGGAGATTTTGGGCTGAGACGATGGGGTTTTCTAGATATACAATCATGCCATCTGCAAACAGGGACAATTTGACTTCCTCTTTTCCTTATTGAATACCCTTTATTTCTTTCTCCTGCCTGATTGCCCTGGCCAGAACTTCCAACACTATGTTGAATAGGAGTGGTGAGAGAGGGCATCCCTGTCTTGTGCCAGTTTTCAAAGGGAATGCTTCCAGTTTTTGCCCATTCAGTATGATACTGGCTGTGGGTTTGTCATAAATAGCTCTTATTATTTTGAGATACGTCCCATCAATACCTAATTTATTGAGAGTCTTTAGCATGAAGGGCTGTTGAATTTTGTCAAAGGCCCTTTCTGCATCTATTGAGATAATCATGTGGTTTTTGTCGTTGGTTCTGTTTATATGATGGATTACGTTTATTGATTTTTGTATGTTGAATCAGCCTTCCATCCCAGGGATGAAGCCCACTTGATCATGGTGGATAAGCTTTTTGATGTGCTGCTGGAAAATATTTTTCTAGTGGTCTTCATAATGCCTAAATGTAATTTCACTAATATCTTTCAAGTGCCTGAGGCTCCCAAAGAAGTTGTTCCTGAAAAGAAAGTGCCAGTGCCTCCTCCTAAAAAGCCTGAAGTGCCACCCACAAAAGGTAGACACCCTCTTGTTGCTGTGTTTGATATTGTTTGTTTGTCTTTACTTTGTCTAATAATGAAAATACTAATATCTTTAAAGTCCCAGAGGTGCCAAAGGCAGCTGTCCCAGAAAAGAAGGTGCCTGAAGCTATTCCTCCCAAACCGGAAAGTCCTCCCCCTGAAGGTAATGCCAAAGCTATACAAACTATAGGAGAAAAATAACTGTTATTTTAACTAGGAAATTACATGTTAAAAATCCTACTACATAAAGATGATATAATTCTAAAGAAAACAAATGTCAATCACTATCCAAAATATCTTGGTGGGTGTTTATATGCAAAAGGCATCCATCGTTTTCACCTTTTCTAAACACAAATTACAAATATCTTTGAAGTGCCTGAAGTGCTGCCACCGAAGGAAGTGGTCCCAGAAAAGAAAGTACCGGTGCCTCCTGCCAAAAAGCCAGAAGCTCCACCTCCTAAAGGTAGGTATCATTACACATTGTCAGTCGGGGGGCCCTGGGGAAAGACTGTATAGAAGTGTCCGCCGATCTCACAAGTTGTATTTGCTTGGGTAAATGTGGAGTCGATATTCCCCCTTTATAGCTTCTAACTAAAAGATACTAATATCTTCAAAGTTCCTGAAGCTCCTAAAGAAGTTGTACTTGAAAAGAAAGCATCTGTGGCTGTGCCCAAAAAACCGGAAGCCCCACGTGCAAAAGGTATTTATTCCCTCTCCTCTGCTAAGAAAAACTTATCGTCTGTACCCCTCACAATCACTGTAATATATACCTTCACCATTCATAAATTATAAAAATACTAATATCTTTCAAGTGCCTGAAGCTGCTCAAGAAGTTGTCCCAGAAAAGAAAATTCCCAAGGCACCAATCAAAAAACCAGAAGCCCCCGCAGTTACAGGTACATGTCAGCTCAACCTTATCCTGCAGAAGAAATCTCTCTTCCATTCCTGAAAACAATTTTAGTCCATTCCTCTTCATTAACCTAAGTATAAAACTACTAATATCTTTCAAGTGCCAGAAGTTCCTCAAGAAGCCGCAGAAAAAGAAATTCCCGTGGCTCCACCCAAAAAACCAGAAGCTCCGATTGTCCCAGGTACACTTTAGCCCTGACTTCATTCTGCAGAAGAGATATCTCCTCTCCTACTGTAAACAATTTTAGCCCATTTCTCTTCATTAACTTAAGTCTAAAACTACTAATATCTTTCAAGTGCCTGAAGCTCAAGAAGTTGTCCCAGAAAAGAAAGTTCCTAAGGCTCCTCCCACAAAACCAGAAGCCCCACCTGCCACAGGTATTTTTTACCCCTGTCCTTTTTCTGCAGAAGAAATATCTCTTCTGATCTTAGAAATATTTTACTCCATTTGTCTCATTAACCTAAGTGAAAAACTACTAATATCTTTCAAGTGCCTGAAGTCCCACAAGAAATTGTGCCAGAAAAGAAAACACTGGTGCTTCCTAAAAAGCCAGAAGTTCCACCTGTTACAGGTACTTGTCATTTGACCTTAAGCTTCAGAAGATCCAATTCCTCTGCTGTATATTTTGCTAGTAGTCTCCATAGCTCCACATGTAACTTTACTAATATCTTTTAAGTGCCAGAGGCTCCCAAAGAAGTTGTCCTTGAAAAGAAAGTGCCCTCGACTCCTCCTAAAAAGCCTGAAGTCCCACCTGTTAAAGGTATTTGTCACTGATTTTAGGCTTCAGATGATCTATCTCTTGTGCTCTGGAAAATATTTTTCTTTTTATATATATATATATTTTTATTATACTTTAAGTTCTAGGGTACATGTGCACAACGTGCAGGTTGTTACGTATGTATACATGTGCCATGTTGGTGTGCTGCACCCACTAACTCGTCATTTACATTAGGTATGTCTCCTAATGCTATCCCTCCCCCATCCCCCCACCTCACAACACACTCCGGTGTGTGGTGTCCCCCTTCCTGTATCCATGTGTTCTCATTGTTCAATTCCCACCTATGAATGAGAACATGCAATGTTTGGTTTTTTATCCTTGTGATAGTTTGCCAAGAATGATGGTTTCCAGTTTCATCCATGTCCCTACAAAGGACATGAACTCATCATTTTTTATGGCTGCATAGTATTCCATGGAGTATATGTGGAACATTTTCTTAATCCAGTCTATCATTGATGGACATTTGGGTTGGTTCCAAGTCTTTGCTAATATGAATAGTGCCGCAATAAACATACGTGTGCACGTGTCTTTATAGCAGCATGATTTATAATCCTTTGGGTATATACCCAGTAATGGGATGGCTGGGTCAAATGGTATTTCTAGTTCTAGATCCCTGAGGAATCGCCACACTGACTTCCACAATGGTTGAACTAGTTTACAGTCCCAGCAACATTGTAAAAGTGTTCCTATTGCTCCACATCCTCTCCAGCGCCTGTCGTTTCCTGACTTTTTAATGATCACCATTCTAACTGGTGTGAGATGGTATCTCATTGTGGTTTTGATTTGCATTTCTCTGATGGCCAGTGATGATGAGCATTTTTTCTTGTGTATTTTGGCTGCATAAATGTCTTTTTTTGAGAAGTGTCTGTTTGTATCCTTCGCCCACTTGTTGATGGGGTTGTTTTTTTCTTACACGTTTGTTTGAGTTCATTGTAGATTCTGGATATTAGCCCTTCGTCAGATGAGTAGATTGCAAAAATTTTCTCCCATTCTGTGGGTTGCCTGTTCATTCTGATGGTAGTACCTTTGCTGTGCAGAAGCTCTTTAGTTTAATTCGATCCTATCTGTCAATTTTGGCTTTTGTTACCATTGCTTTTGGTATTTTAGACATGAAGTCCTTGCCCATGCCTATGTCCTGAATGGTATTGCCTAGGTTTTCTTCTAGGGTTTTTATGGTTTTAGGTCTAACATTTAAGTCTTTACTCCATCTTGAATTAATTTTTGTGTAAGGTGTAAGGAAGGGATCCAATTTCAGCTTTCTACATATGGCTAGCCAGTTTTCCCAGCACCATTTGCTAAATAGGGAACCCTTTCCCCATTTCTTGTTTTTGTCAGGTTTGTCAAAGATCAGATGGTTGCAGATGTGTGGTATTATTCTGAGGGCTCTGTTCTGTTCCATTGGTCTATATCTCTGTTTTGGTACCAGTACCATGCTGTTTTGGTTACTGTAGCCTTGTAATACAGTAGCGTGACGCCTCCAGCTTTGTTCTTTTGGCTTAGGATTGACTTGGCAATGTGGGCTCTTTTTTGGTTCCATATGAACTTTAAAGTAGTTTTTTCCAATTCTGTGAAGAGAGTCATTGATAGCTTGACGGAGATGGCATTGAATCTATAAATTACCTTGGGCAGTATGGCCATTTTCACGGTATTAGTTCTTCCTATCCATGAGCATGGAATGTTCTTCCATTTGTGTCCTCTTTTATTTCGTTGAGCAGTGGTTTGTAGTTCTCCTTGAAGAGGTCCTTCACATCCCTTGTAAGTTGGATTCCTAGGTATTTTATTCTCTTTGAAGCAACTGTGAATGGGAGGTCACTCACGATTTGGCTCTCTGTTTGTCTGTTATTGGTGCATAAGAATGCTTGTGATCTTTGCACATTGATTTTGTATCCTGAGACTTTGCTGAAGTTGCTTATCAGCTTAAGGAGATTTTGGGCTGAGACGATGGGGTTTTCTAGATATACAATCATGCCATCTGCAAACAGGGACAATTTGACTTCCTCTTTTCCTTATTGAATACCCTTTATTTCTTTCTCCTGCCTGATTGCCCTGGCCAGAACTTCCAACACTATGTTGAATAGGAGTGGTGAGAGAGGGCATCCCTGTCTTGTGCCAGTTTTCAAAGGGAATGCTTCCAGTTTTTGCCCATTCAGTATGATACTGGCTGTGGGTTTGTCATAAATAGCTCTTATTATTTTGAGATATGTCCCATCAATACCTAATTTATTGAGAGTCTTTAGCATGAAGGGCTGTTGAATTTTGTCAAAGGCCCTTTCTGCATCTATTGAGATAATCACGTGGTTTTTGTCGTTGGTTCTGTTTATATGATGGATTACGTTTATTGATTTTTGTATGTTGAATCAGCCTTCCATCCCAGGGATGAAGCCCACTTGATCATGGTGGATAAGCTTTTTGATGTGCTGCTGGAAAATATTTTTCTAGTGGTCTTCATAATGCCTAAATGTAATTTCACTAATATCTTTCAAGTGCCTGAGGCTCCCAAAGAAGTTGTTCCTGAAAAGAAAGTGCCAGTGCCTCCTCCTAAAAAGCCTGAAGTGCCACCCACAAAAGGTAGACACCCTCTTGTTGCTGTGTTTGATATTGTTTGTTTGTCTTTACTTTGTCTAATAATGAAAATACTAATATCTTTAAAGTCCCAGAGGTGCCAAAGGCAGCTGTCCCAGAAAAGAAGGTGCCTGAAGCTATTCCTCCCAAACCGGAAAGTCCTCCCCCTGAAGGTAATGCCAAAGCTATACAAACTATAGGAGAAAAATAACTGTTATTTTAACTAGGAAATTACATGTTAAAAATCCTACTACATAAAGATGATATAATTCTAAAGAAAACAAATGTCAATCACTATCCAAAATATCTTGGTGGGTGTTTATATGCAAAAGGCATCCATCATTTTCACCTTTTCTAAACACAAATTACAAATATCTTTGAAGTGCCTGAAGTGCTGCCACCGAAGGAAGTGGTCCCAGAAAAGAAAGTACCGGTGCCTCCTGCCAAAAAGCCAGAAGCTCCACCTCCTAAAGGTAGGTATCATTACACATTGTCAGTCGGGGGGCCCTGGGGAAAGACTGTATAGAAGTGTCCGCCGATCTCACAAGTTGTATTTGCTTGGGTAAATGTGGAGTCGATATTCCCCCTTTATAGCTTCTAACTAAAAGATACTAATATCTTCAAAGTTCCTGAAGCTCCTAAAGAAGTTGTACTTGAAAAGAAAGTATCTGTGGCTGTGCCCAAAAAACCGGAAGCCCCACGTGCAAAAGGTATTTATTCCCTCTCCTCTGCTAAGAATAACTTACTGTCTGTACCCCTCACAATCACTGTAATATATACCTTCGCCATTCATAAATTATAAAAATACTAATATCTTTCAAGTGCCTGAAGCTGCTCAAGAAGTTGTCCCAGAAAAGAAAATTCCCAAGGCACCAATCAAAAAACCAGAAGCCCCCGCAGTTACAGGTACATGTCAGCTCAACCTTATCCTGCAGAAGAAATCTCTCTTCCATTCCTGAAAACAATTTTAGTCCATTCCTCTTCATTAACCTAAGTATAAAACTACTAATATCTTTCAAGTGCCAGAAGTTCCTCAAGAAGCCGCAGAAAAAGAAATTCCCGTGGCTCCACCCAAAAAACCAGAAGCTCCAATTGTCCCAGGTACACTTTAGCCCTGACTTCATTCTGCAGAAGAGATATCTCCTCTCCTACTGTAAACAATTTTAGCCCATTTCTCTTCATTAACTTAAGTCTAAAACTACTAATATCTTTCAAGTGCCTGAAGCTCAAGAAGTTGTCCCAGAAAAGAAAGTTCCTAAGGCTCCTCCCACAAAACCAGAAGCCCCACCTGCCACAGGTATTTTTTACCCCTGTCCTTTTTCTGCAGAAGAAATATCTCTTCTGATCTTAGAAATATTTTACTCCATTTGTCTCATTAACCTAAGTGAAAAACTACTAATATCTTTCAAGTGCCTGAAGTCCCACAAGAAATTGTGCCAGAAAAGAAAACACTGGTGCTTCCTAAAAAGCCAGAAGTTCCACCTGTTACAGGTACTTGTCATTTGACCTTAAGCTTCAGAAGATCCAATTCCTCTGCTGTATATTTTGCTAGTAGTCTCCATAGCTCTACATGTAACTTTACTAATATCTTTTAAGTGCCAGAGGCTCCCAAAGAAGTTGTCCTTGAAAAGAAAGTGCCCTTGGCTCCTCCTAAAAAGCCTGAAGTCCCACCTGTTAAAGGTATTTGTCACTGACCTTAGGCTTCAGATGATCTAATTCTTTTGCAGTTGAAGACATTTTGTTCCAGTGGTCTTCATAACCCCTAAATGTAATTTTACCTAATATCTTTTAAGTGCCAGAGGCTCCCAAAGAAGTTGTTCCTGAAAAGAAAGTGCCAGTGACTCCTCCTAAAAAACCTGAAGTCCCACCTGTTAAAGGTATTTGTCACTGGCTTTAGGCTTCAGAAGACTGAACTCTTCATTTCTTGAAAATACTTTTCTAGTGGTCTTCAAACTTCTAAATGTAATTTCACTAATATCTTTTAAGTGCCAGAGGCTCCCATAGAGGTTGTTCCTGAAAAGAAAATGCCCTTGGCTCCTCCTAAAAAGCCTGAAGTCCCTCCTGTTAAAGGTATTTGTCACTGGCTTTAGGCTTCAGAAGATCAAACTCCTCTATTCTTGAAAATATTTTTTCTAGTGGTCTTCATAACCCCTAAATGTAATTTCACTAATATCTTTTAAGTACCAGAGGCTCCCAAAGAGGTTGTTCCTGAAAAGAAAGTGCCCTCGGCTCCTCCTAAAAAGCCTGAAGTCCCACCTGTTAAAGGTATTTGTCATTGAGTTTAAGCGTCAGAAGATCTATCTCTTCTACTCTTGAAAATATTTTTCCTAATGGTCTTCATAACTTCTAAATGTAATTTCACTAATATCTTTTAAGTGCCAGAGGCTCCGAAAGAAGTTGTTCCTGAAAAGAAAGTGCCAGCGGCTCCTCCTAAAAAGCCTGAAGTCACACCTGTTAAAGGTATTTGTCACTGATTTTAGGCTTCAGATGATCAAACTCTTCTGCTCTGGAAAGTATTTTTCTAGTGGTCTTCATAATGCCTAAATGTAATTTCACTATTATCTTTCAAGTGCCTGAGGCTCCCAAAGAAGTTGTTCCTGAAAAGAAAGTGCCAGTGCCTCCTCCTAAAAAGCCTGAAGTGCCACCCACAAAAGGTAGACACCCTCATGGTGCTGTGTTTGATATTGTTTGTTTGTCTTTACTTTGTCTAACAATGAAAATAATAATATCTTTTAAAGTCCCAGAGGTGCCAAAGGTAGCTGTCCCAGAAAAGAAGGTGCCTGAAGCTATTCCTCCCAAACCGGAAAGTCCTCCCCCTGAAGGTAATAATGAAACTATTCAAATTAGTGTTTTTTAAAAAAATCTTTCCTTAGTGTTGTAAAAACATTTTTTTGCAAACTATCTCAGTTTTAGTCAATTCTGGCATTAAAATGAGCTCATGTCTTTAAAGTGTTCGAGGAGCCTGAGGAAGTTGCCCTAGAAGAGCCTCCTGCTGAAGTTGTGGAAGAGCCAGAGCCAGCGGCGCCTCCACAAGGTACATGGCAAGAAAGCTGCTAGGACACCTCGGCCACTCTTTCCCCTTCCTGCCCTGATAATTCTGGGTGCTCTGAGCTTTTGTCTTGTTTCTCAATCTTCGTTCTTTCTAAAACATACCTTCTAATTCTTTAGTGACCGTACCACCTAAGAAACCTGTCCCAGAAAAGAAAGCACCTGCTGTCGTTGCCAAAAAACCTGAACTACCACCAGTGAAAGGTATTCCTCACTGCCACTAACTCCCTAACAAAAAACTTTCTTTGAAGTGTCATATTCTACTGTTCTGCTTCATGATTTTCACATTTCATTGAAACCATGAGCTTAAACAACTACTAATATCTTTTATAGTGCCCGAGGTGCCCAAGGAGGTTGTTCCTGAAAAGAAGGTGCCTCTGGTGGTTCCCAAAAAGCCAGAAGCCCCACCTGCTAAAGGTATATGTGGCTGTCCACTGTTTGATGGGGGCGGATGGAGCCCCCAGCTTCTAAAAGGGTTTTGTTCTGTGTAAATGTGATGAATGTTTACTGGTGATTGTTTCTAATGTTAAAATACTAATATATTTGAAGTGCCTGAAGTTCCAAAAGAAGTTGTTCCAGAAAAGAAAGTAGCTGTTCCCAAAAAGCCAGAAGTCCCACCAGCAAAAGGTACATGTCACTAATGAGATTCTGCAGAAAAGCACTCACCCTTGTCTAATAAGTCACCTATTATCAAACCTTTTGTTTGCGAGTCCTCTTAAATTTGCAACTACAAAACTGTCATTCTGGATTTTTAGGGTCTGAATACTTTTTAATAATTTTTTCATTGACTTTAAAAAGTGATATATTTACTTATTACAAGCATTGGAAAAGTTTACTAACTTGGTTCTTTTATTCTTAATAGGCCATATTTTCCTCCCCACTATATGAGGGTCCAAAGACAGATCACTGACCTTATTGTGAAATTTGTTCTTGGATCTGTCCCTGGGTTATTTGAGCAAAATGTGAAGTCGATGTGGTATAAATTTAATATACTTCTCAACTACTCATAAGAAAAATGAATTAATATCTTTAAAGTGCCAGAAGTGCCAAAGAAACCTGTCTTGGAAGAGAAACCAGCTGTTCCTGTTCCAGAAAGAGCGGAGTCTCCTCCCCCAGAAGGTACACGTGAGACCGGTGATTAATGACCTTGCCACTTGCGACTATTTCTAATTTAAGCTTTGTTCTTCTTCCTTCCTAACTCATTATTTCTTGGTCATTTTCTAACCTTTAATTATTTGTCTTAATTCATCATTCTAAATTAGCTCCAATCTCAAATCTATTTTGGGTTATTGGTCCACAGTATCTACATAAGTCATAGTAAGCTATATTAAACAAAGCTTCTCCAATGTACATAGAAAGTAAGGCAGGAGAACTAATGATTATAAATGACATTAAACACTAAAAGGGCTTTGCAAGCATTTGAATCAATAGACAAAGAAGTCAGTGCAAATGAGATAGATTTTATCTAAACAAAAATAAGAGAAGGTATCAATTGAAACAAAGGAAGAAATCAAGATTACTATTTATCGTGTTTAGTGTTTGTCCATCTTAGAATATTGTTCCATACATTGAAATAAAATTAACTAATATCTTTAAAGTATATGAAGAACCTGAGGAAATTGCTCCTGAAGAGGAAATTGCTCCTGAAGAGGAAAAGCCAGTTCCTGTTGCAGAAGAGGAGGAACCAGAGGTTCCACCTCCAGCAGGTACAAAGCAGAATCCACTGTATGGGAAAATACAGTCATTTCATTTTTCATGTCTATATATCTTCCTTAAGGCAAAATATCAGTCTTGTATCTTGTTGCCTGAAATCTGACTACATTAAGAACAAAAGTTATTTCTACACATAAAACTTTGGACCCACAGAATTTGGTCCCACATATACCAAGAAATATGTGTGGTTTTTAATTCATTCATTAGCATTAAATTTTTCATTGTAATCACCTAATTCTAAAAGAAATTCCTATTATTCAAGTGCCTGAAGAGCCCAAGAAGATCATCCCAGAGAAGAAAGTTCCTGTCATCAAAAAACCAGAAGCACCGCCTCCTAAAGGTACTCATGTTAAAATGAATACTTCATTTTTGTGGTGTCTACAATTTTACACTCTTCTTATTGTGTGTTGTGTTGTATTATATGTTTGTTAACTCTTACCTATATGTTACAGTGTTGAATAAACTTGTATGTATATCTTACATCTCACAACTTTGTATTATTAAATGCTACTGATATCTTTAAAGAACCTGAGATGCCAAAGAAAGTTGTTCCAGTGAAGAAGGTCCCAACTGTTAAGAAGCCAGAAACACCAGCAGCTAAAGGTATTCACTTCATCGTTGGCATCATAAAAAAGAAAGTATTCTGATATCTTAAAGTGGAATCCAATAAGTTGTCCTCATTGTTGTTGCATAACTAAGGACAAAAATTTCCTTATTTTGCTTTCATTAATTTTAATGCTGCTCCAATAAATACAGGTTTTTTATTCTTAATATTTTAAAATGTTTTTAAATACTATTTTTAAAACAAAACTAATATCTTCAAAGTGCCTGAGGTGCCCAAGAAACTTGTTCCAGTAAAGAAAGAACCTGTGCCTGTTACCAAAAAACCAGAAGTTCTTCCAGAAAAAGGTACCTACCATGAAGAAAAAATAGATTTCTCTAACTGCTATTTAAGCATGTTAATAATAGGTCTTAGAGAAAAACATACTGAATGTGAATTTATGTTAAAACCATATTGCACAGAAAAAAGGGAAATAATGAAGGGAAAAAAATGAAACAGACAAGCAGGAGTGAAAAAATGAGTGGGATTCAGTTGTGCTGTGATATATCACATGGCTACAACTAGTAGAAAAGAACCTTCTCTCATTCAATGTGTAAAACAGCTCAATTCAACATATTTTGTTGAATGTTGACCATTAACAAGACATCATATTAGAAAAATTAAGGCCTGATTCTGTCTTCAAATAAGTTAAATCTGGTGAGAGGATAGAAAGATAACAGGACTCTAATACAGACAGGAAGTGATTACACATAGCAAGTGAATACAAAAGGGCTGCAGAAACACACGGCAAGAAAAGATTAAGTTCAGGCAGAGGCATCATGGGAAGCTGTGTTAAACTGAATTTAAATTTTGATGGACTTTTACATGTAGAAATTGAGGAAATAAGGCCGGATGTGGTGGCTCACGCCTGTCATCCCAACACTTGGGGAGGCCAAGGTGGGTGGATCACTTGAGGTCAGGAGTTCAAGACCAGCCTGGCCAACATGGTGAAACCCCGTCTCTACTAAAAATACAAAAATTAGCTGGGGGTGGTGATATGTGCCTGTAATCCCAGCTACTTGGGAGGCTGAGGCAGGAGAATTGCTTGAACCCAGGAGGCAGAGGTTGCAGTGAGCTGAGATAATGCCACTGCACTCCAGCTTGGGTGACAGAGTGAGCCTCTGTCTCAAAAAAATTAAAAAAAAGAAATTGAGGACATGATATCCCATGGAAAGGGAAGAGCATATTGAAAGGCACAGAGATAGAAGGGTCTAGAATGTTCAAGGATTGTCAAGTAAACTTATGTCAAGTAAACTCAATTTGAGTATGGATTGGCTGTGGAATGTCTTGAAAGATAATACCAGATATAAAGATGGGGTCATATTTTGGAGTACTTCAAATGCCAGTAAAAGGCTTGTACTTTTTTCTGTAGGCAATAGGAAGCTTCAAAGATTTTGAAGCAGGCTTACATATTAATAGGATTTGGGCTTTAGAAAGATAACTGGCAGCAATTTCAGCTACTAAATAGTAAAGACCCATTGCAATTATTTAAGGTCTTTAAGAGTTGGACAAGATCCGTGGCGGCAGAAATGGAAAGGGGGACTGGGTTTGAAAGAGATGGAGACTTAGTGGCCTCTGACCATTATCAAAACCATTAGGGAAATTGAGGAGCCCAAGATCATTGTAAGGTTTAAAGCTAGATGGCCAAAAGAATGGTTCATTGGGTCTCTGAACTAACGTTAGAGGAAAATGGTAGATGTGCTTTTCACCTTTAAAGCATAAAAGTTGGGAGTGTGTATCAGGAGCTTAAGAAAGAGATCAGGCCTAGAGATGTAGATCTTAAAGTCATTCACATGTAAATAAGAATTGAGTGTGCAGGAACAATTACTCAGAAAATGTAGAGCAAATTTTTTTAAGTGTCAAAGTTAGACCACCTTCATTTAAGTGTACACAGAGGACTAGAAGCAAATGAAGAAAGCTGAGAAGATTCATATATAAAATTAGGATGTCCAAAATGGTGCCATGTCTCAGAAGCCATTTTCCCCATGAAATCTAAGATGAAGCTCTTGCCCCTGCATTCTTTGCCTGCTCTTTAGACAATCTTGCATGTCTTCTAAATTCTTAATAGTAAACAAAATCATATCTTTAAAGTGCCCAAAGTGCCTGAGAAAATCATCCCAGAAAAGGAAGTGTCTGTGCCTATCCCTGCAGAGCCAGAAGTTCCACCTGCTGAAGGTACACGGCTTCTCCATAAATCTTGGAAAGATGACAATTGTCTTCATCCTCTTGCTTTGATTGTAGATGAATCTTACGTATTTGTCTGTCTGTATTGAAGTTATTGATATTTGGGGGGTCATCTGAATAATCTGTTATAGAGTGTTACTTAATGTAACTAGGTTGATATGTTAGAATAGTAGTTGCAGTATTCTGTTCTAAATATAGTCTAAAATAAAATACTATGTTTTTTAAAGTTGAAGAGACTCCTGAGGAAATAATATATGAAGAAAAAGCATCTATAACCATTGGTAGAAAAGAGACTCCCCCTGTTGAAGGTATATATATATATATATATATACATTTTTTTAATCTCCTGAAGATTCCTGTTAGAATTACAAAAGCATTTACAGGACAATATTCCTTCTTGAAATTATATACAAGAGCAGTCTAGCATGTTTGACTGCTTTATTTTTGAAATAGTTACACTTCTTTTAAGTTAGAATCTTTAATTTAGTTACTGTTGTTGGTAATTACAATTTCCAAAAGGTACAGTTTACTGAAGCAAAATGGAATAATTGCCTTGGATCCTCAAATGATAACACGGTATCAAATTTTAAAAGTCATCTCATTTGCCATCAATATACATTGAATAATCTAATTAATAGGCAGTTCAAGTAAAAGAACTTTTTCTTATACGTGAATTTTTCTATACATGAATTTGTATGAATTGTATATTTTTATTTTGTGACTGTAATCTTTGCATCAATGTGAAATTTGTATGAGTCTTTTTGAAGAACTTTACATTGCAACCTCATCTCCTTTGTCAACATTCTTTAAAGAACGTGAAATTGAAAAGTATATTAAACCTGAAGAGCCCGAACCTGAACCACAGCCTGAAGAAATACCAGTAAAAGGTATTCAATCCAGTGGACTTAAATCTTCTTTATCATATTCTTTCTCTTGAAATGTATATGGTTTATGTTGTTGTACATATGTAGTATGTCTGTTCCCATTTGTATGTAAAGTATTCTTTGTTGTAAATGTGAGCCTCATTCTTAGGTTTCCATGTAACTTGTACTGTTTCTCTCATGTCAACTGTGGCTTGTCTGGATGCTTTGTTTGTTGTTGTTATTGGTGCCTTTGCTGTATTTCTCATCATCTTTGTAAAGGGTTGATATTTTTATGTTTTATGTTCTGTGTTTTATGTTGGATACTGGTATTACGTACCTTAAAAAGTAAACTTTGTACTTCATATATATATATATATATATATATATATATATATATATATATAATTTCTATTAAATATACTACATATCCACATGCTAACATATACATATACTAACACCTCTGAAATACTCTTTCAAGAACCTGAACCTGAAAAGGTTATTGAGAAGCCAAAACTCAAACCAAGACCCCCACCTCCTCCACCTGCTCCACCTAAGGAAGATGTGAAGGAGAAAATATTCCAACTTAAAGGTAAAAAATGCCACTTCCAAAGTTTTATTAGCCTGCTTCAAACTTCTATCCAGCCATCTGAAATGATGCTTGCAAGAAATGTATGACTTTTAGAAGTGTGTACTTTCAGACATGATTGTACTGTGAGATTGCATAGAGCTGTCTCTTCTGCTGCCCCATGGTTCCTGGGTTGCTTGTCATGCCATGCCTGCTGCTGCAAAAGTCAGAAAGTACATTGATAGCGTCATCCGGGATATCTGAATGCAGGCACTGTCCAATTAACTTTCTTTTGTGGAGTGGGGAGAAAGAGTTTTCTGATTTCAAAGCCTGATTGCTATACATATCATTGCGATCTTATGCTTAAGGAATGTATAAGAAATCCTTGCAAGATATTTTTAATATTGCAGTAACACATTTACATAAAAGCCAAAACTTTGTTCTTAAAGAATTGCATGTGCTTTTAAATATATTACAAGTAATATAGTTATGATTTCCAGTAGCTGATATGTGCCTATATATCATGAAAGGAAAGCATATGAATGACTTGTTACAGTTCCCCCATCTCTTTTTTTTTCTTGCAACTTAAAGAAGTGTTCTGTGTGGTTCTCAGGGGAGCTGGAAAGAGTGGTTATGAAGACATTTGGTATCCAGCATTTATTATTAAACTTCCCTTCCCCCTTCTTATATTTTGATTTTTCTATGAATTGACACAATGTTACTTAATTTTAAAAATATCAGTTTCTTTAAAAGCTGAAATAAACTGGCAGAAACATATTATTCTTATTTTAATAAAAAGTTGTCTTGTGACGTCATATGATTCCCCAATCTAAAATTATCTAGATATAATCTTAGATATGCACTTTCCCTATACAGACCTATGTATCTTCAAACCACAGTCTTCCAGCATAAGACATTGCTGCTGGTGATTCTTGCCCTCTACAACCCTCATAGCCATTAGGGGGACCTTCTGGCACCTCTTGAAAGGCCACCCATCTGTTAATTGACACTCCATGAAGACACACACATAAATACATTTCCCTTAATGTAAAATATATGCTTAAAGGAAAATTTCTTCCTCCTGCCAATAACAAAAATTGTCTTCTTTTTCTGCTGGTCTTTAATTAACTACTGAACTTTGGAGTAAAACTGCAGTCTGTTTTCATGGTTCGAATGCTGCTTGTATGTTCTTTGAAGGCTGTTCTTGGCTGTTATTAATGCTTTCTGGTTATAAGCAAAGCTTGGTTTTGATTCTTGGAGTAGAAAGTTAATCACTTGCTTCAGATTAAATATACAAATAACAAAAGTAAAATCATATTCTTTAAAGCTATTCCAAAGAAGAAAGTTCCTGAAAAACCTCAGGTTCCAGAAAAAGTGGAGCTTACACCTCTGAAAGGTATTTCACAGGCTGAAAAATACATACTTATGTAGTACCCCTTTACCTGACTCCTTGCTCTTTCTGCCTCCATCGAATGTTCTGTCTCTCTTTTTCAATGATCAGAGAGTAGTCCCATTCATTTCTTATATTTCTGTGGCTTTTATGGTCCTGGCTCATGAGTGTTGCTTCCTTTGTCTCCCATCCATTTCATACATGTATAGACATGGTCTATCTTTGTCTCATCTACATATGTCTTCTTGCATTTTCCTAAACTTAAAAATAACAAATTTTACTGGTTAGCCAAAATTGATATCAAGAGACATATGAGATTAAAATGCTGAGAGCTAGTAGTAAACTGTTTTGACATTTCACCTGACATAAAAATTTTAGCCAATGTAATAAGCACTAAAAATAAGTCCTATCTTCCTTTTATATTATTAAGGTTATTTGTAGGGATTTCCTTAGGACTTTCATGTCACTCTCTTCTCACTGGCTCTAAGTCATTCTCTGAGGGGTACGGAACTCACATTTCAGAAAAATTTCCTTATTACTGTAGGTAATTTTTCAAAATGTATTTTTCTGTAAACAATATTTTCCCTAATAAGGTCTCATCTAAAATTAGACCCTAAAGAAAACTAAATGAATTATAAGAGTCTAGAAAACATCTATCAAAAATAAACATAATTTTTCTAATGGGTAGTAGTGTTCTGTTCAAGTAATCAACACATTCAGACCTAGAAATTAAGACTGTTTCTGGTCACTCTGAAATTTTGGGGAAAAAAGTCACCCATATAAATATACATTTCCTGATTTCATAAAGAGGCAATTACAAAATAATGTTATCATGGATATTGATCATAAACATTAAAATAGCATATAATCACATATAATGACTTTAAAAATAATAGCTACAATGTTGGGTTCTCAAACATCAATAAGATTTTTAAAATCAAATAATAATATAAAAAATGCACAGATATATTTTCACTATGTTCATTATATCAGTAAAGAAAATCTATATTATGCCTCCTCACTTTACATTAATTAGATGCATGTGCTTCCTTCTGGGTTTGAGCAATAAAAATAGTTATTAAGAAGATTGGTACCTCTAAAATAGTATTGAAGGCCAACACAATTTATCCTGGATAAAATACGTAATGTTTAACTTTAAAATTTTTACTTAAAATATTTGACATTAAAAAAATGATTATTCAAAACGAAATACATATTTGCCTATTGTAGGTTTAAATTTTTGAAATAAGAGTTAAGCAGTTATCTTTATCACATAAAAAACCATTTAATGAATTGCAAATATCTTGTTTAAAGCCCTAAATAGGAAGTTTTATAGAAATATCTAAAAATTCAGATTCCTAATAGCAAATAGTTACACAATACAAATAAATACTGTTTTAAATTAGATTTTAATTGACATTAGTAGAGAGGAAAATGGTTTAATAATCACCACGTGTTCCTTTCTTTCACCATTCAAATCTATGAGGGCCATAATAGCAAAAGAGGCTGCTCTATAAAATAGCATCATCCACCATGCTCAGTATTCACTGTAGACGCAACAGGAAATTTTGAATTCCTTGCGTTCCTTAATTTGAATGAATTTAAGAACATTTTCTTATTCATGAAAAACGAGCTTCCAACACCAGCTTTGAAATTTTATAATTCTATAATTTTAAATATTTTATCCAGCATTATTTCAAAAAGGAAATCTTAAGAAAGGCTACTCTTCTTCTGTTCAGAAAGTGAGATATGGCCCTTCCCCAGCATCAAAGTCACAAACCGGAACTCTTGGCCACCTTCTTCCCTCAGTGGAGAAGACTGAATGATGGCACTAACACTTGCCAGTATCATTTTCATACATTTAGTGGTTGGGTAGATAACATCGTAGATTTGGACAATCTACAATTGCAGTTTGGGACAAAGATGCTGTCAAGAACCCTGTAATTTGATGAAAGATTCATAAAGTCAGTATGGAGCAACATCCTCTACATGCATTTAAAATGAATACATTTGCCTGCAGTTAATGGAGTTGAATTTCATCACAAGGCTGTATAGATATTTGCAGAGGAGATAACTTGAAATGTATCATTTAAACTTAAATTCTGTGGTATTTATATGCAGCGAAAATTGTTACTTAATGCACTACAGTTAACTAGTTTTAGGAGAGACATTTTTCTTGTTGAAATTCCGTTTTTATATAAATTCACTTCAAAATTTGAAATCATATTCTTTTAAG
>TTN-201,,0,921,230847,231767,GTATAGTATTTTTCAACCATTCTGTCAGCGTTAAGTATATTTTAAAAATGAACTTGAAAGCTTACAAAATGTTTCTGTCCTTTGGTTTTCTTTGAATTGGTTCGCTATTTATCAAAATTTGTTTGTAGTTTCATTGAAAATTAAGAAAAATGTCATTTCCAGATCTTTTTTTTTAAAAAAAAAAGACAGAAATTTTGTGAGCATTCACAGTATTTTGAAATTTAAAATGTTAATAGACATAACTAAGTTGATAATATTCTAAACTAACAACAACTATGACTGCCATTTTCATAACCAAATTATGTAGTAAAGTACACTAAACCTATTAAATACCTTACATGAAACTACTTTAGCTTAAATTCAATATTCAGTTTTAAAGTGTGACACAGGATCACCACAACTAATAAATAACATTTTTAAAAAACTGAACATTTCTTTCTGACTAATAAAATATTAAAGAATGAGAAACAAGATAGTCAAATGAAGAATTAAGTTCTAACATTGTCTTCACATAGAATTACTGATTTTTAGGCTACATTTCTTCAGATATCTCTGCTTAAGTAAACTTTCTACTTATTTACATACTCATTAAATCATTAACATTTAATTATTATTATAATTCGTTGCTATTCAAATTATTCATTTTGTGTTGGAGCTGTTTCTCCCACAGACTTGTCTCAGAATAGACCCTCTATCTAGATAGAAACAAAGTAACTTTGAGTGCTATTATAATTGACAACCTTTGATTTTAAAAAAAACAAAACAAAAAACACTTTCGGTGTAAATGCTTACTTTCCAGAGTGCTAGGTAGCATGCTTTTTTTCATTTTCCTTGCTTTGTACATTATTTGCATTTGTCAAGCTTATTCAACATCTTCATTAGTTTGTCTTGGTTTACATATAAACCTTTTTGTCTTTAAAG
>TTN-201,,0,610,231768,232377,GTAGGAATCTCAGTGACAATTTGTAAGATTATCTTTTAACAAAATGGACATTTAACAAAAGGTTTATCTTGTAAACATAAATGAAGTTAGATGTAAACATGGCTTCATATTTCATCTGTGATGTAGTCTCTGTTTTCCATTGTCTGCTTTCTGTTTAAATATTTTTATAGTAATTCCCAAATCCATTCATGTATTTCCCTGCACTTCATTCTTATCATTACTTTGCAACTTAAGTTCTTCCAGTAGAAATGACTGAAATAATCAAGTGGCTATTCATGGGAGGGTGTCAGCAAAGGTTTCATAATCTGGGGGCTTTTAAATGGGTTGGTTTTTATCATTAGCCTATTCTCAAAGGGCAAAATTATTGGGAACTATTATAGAAGTGATTTAGAAGGAGAGAGCTAAGGGGAGTGGAAGATAAGTGGATGGAATAAAAGGAAGAAAAATAAATGGAAGCAGAGTCAAGAAAATAAAATAGAAATTACTTGATAAACTATAAGGTTTTTTAAAAAACCATCCATAGAGTTTTTGAAAAATAAATTGATATTTCAGATGAGGTGCTTCCTAAATATTCAAATATTAACACTGAAAAAATAATCTTATCTTAAAG
>TTN-201,,0,430,232378,232807,GTACAAATCTACTGTCATTCTTAGTTGTCTCTAAAAATGCAAATATGTATCATTTAAAATATCATTACACTGACATCAAGATTTGAACACATGACCTTAATCTGTTAATCACATATGGCTTAATTTTCTTTACCATCTCACTCTCCTATGCAATTGGCTAATGATTACTCAGTTGCTAAATAAGTTACCTGAAAAAAAATTGTATTTATGGGCAATGAGATAAATAACAACATTAAAACCAAGAACATTGCCTTACTATATTTTCCAAATATTTTGTTTAAAATGAAAACTAATCAAATACTTGATTTGATAATTATATGTATATAAATTCTAATATCTTCCAAGATACGTGGGCTTAATTTTAGTTTTGACTTTGTGAAAAACTTCAAAAATCCTGTAATAATCTGCCCTCTACTCTAAATTATTTCAG
>TTN-201,,0,259,232808,233066,GTGAGCAAGCTTATCCTCAATGTCAACAGCATATTCTTTCTGTATTCACACACATAACATGTACTTAATAAAAGATAGTAGGTGAAAGTCAGTATGTATCAAATGATTTCTAACGTCTCAAAATGCTTAATATACTATTCTCTTAAAAACTAGTTATTTGAAGATTTCAAAATTATATCAGAAGAGGCAAATAAGCTACCAAATAAGTTTTTAGGAAGTGACAAATTGATACACTAATGCAATGGACTTCTCTCTACAG
>TTN-201,,0,2279,233067,235345,GTATTTATCCTGTAGCTTTCTTTTTGCTAGTTTGTTTTGGTGACTTAATAAAAGTATTCACACTTGATTAAAATTCAAGCCCTGTTTATGCTGCAACATAGGTATCATTTCAACTTCGGAGGTTTATGGTAAGTTTCTACCTTTTCTTCATGTGATATCCTTTATCCACCTTGTCTCTTGCCCAGTGGGTGAATATTGTGCCTTAACTGGAATGTACGTTCCTGGGTTGCACCATTTCTTTCATATGCTTTGGAGATTAAGTAATGAATATGTTTGGGGCTGATAAAAACTAAGGAGACAGGCAGAGACCCTGTAAGGGTATACATATAAGAATCCCATGAAGCTTCAAATTTCCCTTATACCCTATTGGAACAATTTCTCTTTTTTAAAAAAGTGTGTATATTGGGATAATGTAAAAGTTCTGGAAATGGATAGTGTTGATGGTTGTACAATATTGTGAATGTATTTCATGCAACTGAATTGAATACTTAAAAATGGCTAAAATGGTAAATTTTATGTTAGGTATATTTTACCACAATAAGAAAGAAAAAGAAAAAAGAGACTCCATATTTCAGTCTTTTAATCTGTATAAGGAATTAGATCAATAATAATTTTCTTAAATGTTCTAACTTAATGATATAGGTATCTCAAGTCCAAACTTAAAGCACCTATTAATTGTATATGAACTATTTAGTATAGTTCATCATTTAAGTGATAATTTGAGATATAATTGATCAAAACTGATTTGATGTGTAATTGATAGTCATTGATAAACATACACATCCTGACTATTTGCCCTTTGGCTCACTATCTGGGTGATGAGATCACTCATATCCCAGACCTCAGCATCATGAAATATATCCACATAACAAAACTGCACATGCATCCCATGAGTTTAAAATAAAAGTTGAAATTATTTTTTTAAAAAAGAAACAACAAAACCAAAAATAAAACAAAGTAAATTTAAAGCGGGGGCGGTGGTGGTGGGGTGGGGAGAAGGCATGTATTGATAATTTTCTAAGATGTGAAGAATCTAAGATATTCAATATAATGCCTTGACAATTTGTTCCTATGGAAAAATGATCATCTCCACTGATAAAGCACAAAATAAAAAATTCAGGGTGAATTTAAAAAAAAAAAAAGAGAACTATTTGTTACATTCCACAGTGAGATGTGCATAGGCCCCGGGAATAACATTTAGAAATGTCCATAATAGTTTGACAGAGAAATTTTTTAATTTAATTTTCTGAACCTAATAATAAAAATTGGCTTATATCTTTAATAAATCAATAAATAAAACTATTTGGAAAAATTATATTATTTTAGATTATTAATTCAATAATTAGTCATTTTATATTTGTTTATATATTTTTATATAAATTATTTAGAAATTTTTTTATTTAAAATTATCTCAAAATATTTGGACATTACCATGTTTAATGACATAAAAAAATACACTATATTCTTTTGACTGTAGTTTAATTTTTAATATTTGTGTTATATTTTGTTGCTGATGTTTATGATTTGGGCATATTCTTTTAAACTTTTATAATGTCAACGTAGTACTTTTATTATTCAGAAAAAGGTGATGAACTGCTCTTGTCTAATTAAGTATGTATAAAAATAAAGCTATTCTCAGTTATCCTGGGGGCTGAAGCTAGAGAACTCATTCCACAGTTTATACTGTCCCTGTATTAATAATGGAATCAAACTCTAAATGTCAGAACTCTCTTGCTTCTGCCTTACTTCATTGTCTAAAGGAAATCTTCAAAGAAACTCATGCATGTGTGGTACATGGACTCTTTTTCCTTAGTCTTCCCTGGATTTGTTTGTCTGCCCAATTTAGACATAAAAAGAAAGGCTTTTGGTAACCTCTCAGCCATTTCCCTTTTCCCTACACTGATTTATTGACAAAACCTTATTTCCTTGGTTCACATAATCAGGACTTACATAAACATATAAAATATTTTGCACAGCTAGGCAGGAGCAAAACTTTTCCTCACAAGGCAACAGTAAGCCTTCCAAAAATGGGAAGATAATAAGGCACTTGCTGAAAGAAGTTGTTAATCCTAAATATGTTGGCAGTTTAGCTTGAGCTCTTCAGTCTCAGAATATGCCTTCCTGGAAATGTGATTATCCATAGAAGTCATATAAATGAAACCAATTTCTCTTTATGCGTTAATATTTATAATGGAGCATGACTCACCCTCCATGGTTTACTATTAAACATGAAATAAGTCCGAAAAGTGTTTAAATGCTGAGTTTTATTTTTATTTCAG
>TTN-201,,0,569,235346,235914,GTGAAATTCATTTTTCTAGTACTTGCATTGTAACCTTCCACTCTGAATTTCCAAAGTTCATATTCAAGGGGAAAAAAATTTCAAAATTCATAACAATTTTTATTTTTTCTAATTGATTCTACTAAAACTAGCATGTTTTCTGATATTTCAAATAATACTTTTAGTATTATGCAAGGAGATATATATATATATATATATATATATATATATATATATATATATCCAACTATATTTTAGCATAGTGAATCCCATAAGTTCTTAGCTTCATTTTTCATATGCATGGTATTTATACATGGCAGATAAAATAATTAGACATTAATCTGGCTATTTTATACTTCAGATTAAAACTTGAGAAAAGGGACATTTATTATTCATGGATTCCTTATACCATCTCATTTTCCTGCCTGAAACAAGGCAGTATAAACTCAATTGGCCTTTCAATTGCCTGGTCTTTAGTTTTCTCGTCTTCTAATTGCTTTACGGCTGGTTTTATCCAGCAGGCAGCCAAGTATGAACTTTCTGACTCCTAAGGAGATGCCAAATCAACTTTTTATTTTACTTTGAATTAG
>TTN-201,,0,156,235915,236070,GTAATTTCTAGTCTTCTGAACATAATCTATATTAAACTTTAATGTAACAAACCTTAGTAGCAACTTGCATTGTAGTTTTACAAAACCTCTTATTTCCAAGTTTTATTTCATTGAAAATATTGTATTTATTGAAATATATACTGAAATTCTCCATAG
>TTN-201,,0,247,236071,236317,GTTAGTACTTTCCTGGGAGATTTCGTTCTGCTTATTGTTACACTAAGAAAATGGAAGAAAGGACCTCGTTTCCCAGTATTACAATATCAGAAATCTTGTACCTAAGAGGGGAATAACAATATATCCTACAGTGGATTAATTATGCCCAGTATTGTGAAATTTTTCCTATTCCTGAAATTTACTAAGGAAGCTATGTATATTACTTGTTCAGACCTTAATCATTTTTTCTGATCTTATTTTCATATAG
>TTN-201,,0,135,236318,236452,GTATAAAATCTTACCTTTTATTCAAATTATAAGTTTTGCGTATGTGTAAAGCCAAATAACACACCAAAACACATAAAAGCAAAGCATCGTTGGGTTGTCTAAAGCATTATGTTACTTCATCCCTGACCAATACAG
>TTN-201,,0,315,236453,236767,GTGAGTAATTTCACATTTTAAATTGTTAGTCATATAAAATAACCACATCCAATATTCAGGATCTATATCCTAGATTCGGGTTGCTTTAATAATAATGGAGTTAATGGAGTCTTCTAAAGTCTCCAAGAAGGAAAGAAATTTTACGTATCATTTGGGGACAACTTGAACAATTTGTGTAAAATGTTATGACAGGGAATTCTCTGCTTACTTTTATTAGTAGTAATTTTTAAAACTCTATAGAAATTTGTATCTGAAACACTTCTCCTATAGGGAATTTATCTCTTTCAAATGGTTACTAAAACTATTGTTTTTCAG
>TTN-201,,0,93,236768,236860,GTATGGGGCTTTTAGAATTTGGGGAGGGGTCTCAACTTTATTTCACTTCCCTGTGCATTCTGAAAAGCCTCATTCTTAATGTCTGATTTTCAG
>TTN-201,,0,282,236861,237142,GTAAGCGAGCTAATGAGATCTGTGACATCCCATAAAGGCATGCAAATATATGACTTTAAAGATAGGACGCCAAGTTCTAAAAGCTGTGATAATGCATCACTAATTAACTTTCACAGTGTTACCAAAACAACCCCCCTTAATTTGTTTTTAGTGGAGCTCTATTTGGAAAGATGAATAAATAAGTGCCATGTGAAATGGGTCCCTTTTACTCAGGCAGATTAGAATGGAATCTTTCTGAAGGTGAATTGTGTTTCTGAGGCATTATCTATGCTTGCATTTCAG
>TTN-201,,0,140,237143,237282,GTAAATGTAACCAAGTATAACCAGATAGCCAGTTTCTGAATCATGGGAGTGGGGAGTAATAAAATATTTTGCAACCTTTTACTCTTTAATAAACTTTAATTTTCACATTCTTCTAATTTTATGCTAAATGTCTTTTACAG
>TTN-201,,0,86,237283,237368,GTGAGTTGCTCAACAATGTAAAATTTACCCTATCTGAATCTGCAGTTTATTAGTTCAGTCATGCTAACAAAACTGTATCATTTCAG
>TTN-201,,0,142,237369,237510,GTAAGTCAAGATTAGCTAATTATATAGGAGAGGGGTTGCTTGGTTGTGTAGGGTGAAAAAAGGCATAAAATATCTTGATGATTTGTAGGAATAACTATATAAATGATGTTCTTTCTTTCCTTCTAACCCTCACTCCAAACAG
>TTN-201,,0,125,237511,237635,GTATGCTCTACTTGTCAGCCACGTTTTTGTATTTTCTCTGCAAGACTTCCTGATACACCCCTGCATTGATCAAGGGTCATCAATGGAAACGTATTCTGACTTCATCCACTGTCCACTTCTTTCAG
>TTN-201,,0,112,237636,237747,GTAAATAGTTTTATCAAATAGTCCACCCCAAAATCATTTTTTTTGCCTTTAGTTTTATATTTCTTCTTTAAAGTGCTTCAATTAATAAGTTCTTTCTTTTTTTTCTTGATAG
>TTN-201,,0,846,237748,238593,GTAAGTGCTTTTTAAATTTTAATTTTACTGCATTAAATTCAACAGAAATTTGTGGAGTATCTATTCTATAAAATAGTCTTCTAAGTGTTATATTGCATGAAAGCAGCCCAACTCCTTAAGAAGCTATCACATATGTAATCAGGCTTATTTCTAAAACACTTTACCTTCATTACTATAAGTTAATGAAGATTCTAGCTTACACCCACAAAATAGCCAATTAAAAGCCAACTTAAAATTCTTCATTAATTATTGAGCCCTGTCATGTTTAAAATAGGAGTATATAAATACTTTCTATCTCTTCATTTTATCAAAATTATTTCAGAGGAATGTTTTTCAAGTTTCCCATAAGAGAAGATATTACATAATTTACATTAATAAGCCTCATTGTTTTTCTTGGCCACCTAATATCAACAAGATTAAACATGAAGGCTAACATATATAGACATGATTAAAGGCAAACTATTAATTGATTAAGAAAAACTAACAATGTGAACCTGAAAGCTTAAAAGTAAACTAGACATAATAGAGTTGCTAAGAATTAGAAATTTACCCAAATAATGGAGGAACACAAAATTGTATTTGAAGCTAAATTTCAGTCTTTTTAGCTACTGTTAATAAAATGTTTCAAAATTCAATATGAATGGATTAGATCTTGATAAATCCCACACACTGATTCCCTTCCTAATATTTAGAGAACTTTTGAACATAAACAGGTTAAATGATTGAACACTTGACACAATTTTAAAAGATACTCAGAACTCTGTGAGTTGTGTCTTAAACTTTCCAAGAGATTGTCATTTCCCTAAGGTGATTAATAAAAGCTTTTCACTTATACTTTACTTGCAG
>TTN-201,,0,90,238594,238683,GTAAGGAAATTTCCATGAGTTTCACTCTTGAAGCATTGGGGTTATTTGTGCCAGAGGCTAATGACCCATGCTGGCCCTTCACTTTTCTAG
>TTN-201,,0,436,238684,239119,GTAAGGCTATTTCTGAACTTGTCAACACCTAAAGGAGCTGTGTGAATTAGAAAAGAACAGGTGAAAGTCAGAGTGGATGCAGGACATTTAAAACATGATAGCAGTTTCTCTATCAGACCCTAAGCCAAAGAGAGATGTCAGGGTCTATGAATGGGCTCAGACTGGCACACTTGCATTACTTTTGATCCAGCAGAGTGAGTATAAGGTTGTAGATACTCTGTGATGCTGCTAGTTGGCTCAGAATTATACAGCTAAAATAAATGTGGCTTTCCTCTTAGTACTTGTAAGCTTTACTTCCTAAAAAAAGAGCTCAAAGTTATATAAAGTTTCATCACCATTTATTTGTTGCATTCCTTTAATTAAGATAATCTATCCTTAGAACAAAATTTCAAAGAAAATTATTTTCTATGAAAGTTTTTCTGTTTTGTTGGTACAG
>TTN-201,,0,797,239120,239916,GTAAGTATTGTATATTTTTCAGGGAAATTAAATAAACACTTTTTCAGAAAATGAATGTGAGTGAAATTAATTGGACCTATTTTATTAGTTAGAAAATATTATTAAAACACAAAAACTGGCTCTCTTGTATTTGCCACTTTGACATTCCAATACAGAAGTGGTTCAAATCGTAAAGTTTTGGAAATTTTGTTGACCTTGCCATTTGAACAAAAGAAAATTTAGCAAATCAGATTTTCCTGCTCTGTAGTCCTCTCATTGAAAGTAGATACACATACAATGAGAATCTAACTCAGAACCCTTAAAGACCACTTCCCTCAAGTGGCTGTGCAACTAGAGCACCAGAAAGACAAGCTTTGCTGTGTGGGCATTTTAGATTCAAGAAAGAAGGTGGGAAGCATTAGGCTAACGTTTCTGGAAGGTGCAAAGTGTTTGATGGATAGGGACAGCCTCTGATTGAGGGCCCCTTGTCCTCTCCCAATCAGAGTCTTAGTTATTTTGGAAGTCACATACCTTATGTAGCAAGAAGAACTTGACGCCTGGCAGAGAGACAGATGCAGCACAGATTTCTCGCTGACCTTGTACGTCAGAACGAAAGGGCCCCTACATATACTCGCTCTCTGGCTACCAGCTCTCCCCTTCTCAGCGCCGTGGGGCCACGTTCACGTGGGAGTTAAAATAGTGGCCAGTCCTGTGGCTTCTTGAAGAAAGCAACCATGAAGATTCATATCTAAGTCTCTATTTATTCTTTTGGGATTACAAAATGAGTAACGCAAAGCTGTTTCTTCCCTCTCGAAAAG
>TTN-201,,0,3904,239917,243820,GTAAAAAGCAGGCATGCCTTGTCTTTCCCGTTCTTTTTCTGGAGTTCTTCCACCTTCACTTGTATGTTCCTTATTCTTTGCTCTTTCTAATGTCTCTTCCTCTGTCTTTGCCTTTCTCTTTCCGCCTTTAGCCTGATTTCTGCTGAAACTGTAAAGCCAATTTTTTGCATTTTTTCTTAGGTTTAACCTGATGATTTTTTTATTGAAATTGAAATAAATTTAAAGTATGATCATGTTTTAGTTTTTTGAAGAAAAGACAAGACTCATTGACTATGAATGATAGTTTGATTAACCAGAAGGCAGGAAGGATCAAAAAGGCTTTCTGATTGCACGCTCTGCAGCCATGGTGCACATTAAGTTTTAAGACTAACGCTCTCCATCCTATTTAGTGTTCTGCATATAAGGGGATTAAGAGGAGAAGACTGAAATTCCATTTCGGGCAGTTGATCAAGTAGTTGAGATAACTTCTGGGCAGATTTGCTCTTCAAGCATTTCTCCAAAGCTATTTTTAACCTTCAAGTGCTCTGGGCTGTGCGATATCTGGAATGCAAGTGGACTATTTAAAGTGCAACTGATGGTACTGACAAGAAAGAAGGGCTCTGTGGTTATCCACATATGTGGATGAAATATTTTTTTTAAGCTTTGGTAAATAACTAGCTCCTGCTTTTAGCTTTTACTAACATTCTTTATGCCCAAGATTTTACCCATAAGTAAAAACTAAGGGATTATTCAGATAGGCCCACAATACAATTTGCCTAAATTGATCTATATGTTTTGTCCCCAGAAACAACATATGTCTTTAAATTATCTTGACAATCCATCATTAATTTTGAATTCTTAAAATAAAATATATGGAATATGTCCAGCCTGGGTTGGAAATAAAGCACAGGACAGTACATTGTTCTGTGACATATTCCCCCAATATTTCAGAAATACTATTAAATGTGCTATAAAGATCTCAACAAAAATCAAACTTTGAAGACTTAAAGGAATATAATTAAAAAGTGATTCAGTTTAACAAAAAGCCACAGCATTGACTGAAGTATTTGAAAGCAATGCCTTCAAGTAACTGCTTTGAAACAAACAAACAAACAACAACAACAACAACAAAACTAGTATTCCACTAAAGTGATTACAGGGTAATTCACCAGCAGTCATCTGATAGGTAACGCCTGCCTGTTATACAGATAATAAGATCTTCTTGGTCTCCTTTTCCAGTGACCAGAAAAAGCAGCAGTACATTCCATTTGTAGCATGGGAATTAAGTTACATATCACAAAACCTTCCTTACAATGAGGTCTTCTAAATATTGAACTGAGGGAGGCACCTCTACCTTCAAGCTTATTGTTTGAAAAAATATATTTTGCCTATCATGCATGATTTAATTAACTTCATGTCTAAAGGCAGAGAATTGGTTGCTTTTTCAAGATTCTTTCTAGATCTGCAAATTCATGATTTATATATAGGAACACTGCTTAAAGACAAATGATATTATTTTTTCATTACCAAATATCTTTTTGTCATAGTAAGAGCTTCTTATTAAAAGATCAGTCTCAGTTCTAATACAAAAACTGCACTATTTTAATTCAAATGTAGACTCCTAAAAATCTTATTCACATTTTATTTTTAAAAAATTCTCATTGTAACTAAAATTTTTTCTAGGGTTAGAAAGGATCAGTTTACTATAATTCTATAGGGCCCCTTTACATCTCTTTTGGCATAGGAATTTTAATCCTTTACTCTAGGCACCCGAAATACCTTAGCCTTTTGTGAACTTGCTCTTGCATTACTTAAATGTCTCTTTTCAAAAAGAACTTAAATATAAACTTTGAAGTAATAAAATCATTTTGTTACATGTGGCAGATTTTGTTTAAATTAAGTCTGTCAGAACAAACTTGCTCTTGTCAATGTAATTCCGAACTTTAATACTCATTTTATGTAAAAATTTTCGCCTTCAAAACTACAATAACCAAACAAGCAAAAACAAGCTGTAGGAATAGGAAATATGAAGAGAAACTTGTAGACATGAGTTGTTTGCATTTTTTCTTTGTTGTTGTAGTTGTTTTTGGCTGTCAGTTTAAGAAAGGACTGCCAAGTTCCAAATGGCATTTGATAATTTTAAAGTTAAATTTTAAATTTGATAAAATTAAAGTTTAAATACAAAACTTTAATAGTTTTGTCATGGTCATAAGCCTACCGTATTATATTAATATGCTTCCACTATAAATAAATATTTTTAAAATCTCTAACATTATTCTTACAATCTACTGCAAAATCTTCAACATTCATTTCATTGGTTTATTTTTATAAGGCACCTACCAGTTTTCCTTTTTTTTCTTTTAACATAGTGGAGGTAGATTGTATACAAGCTGTTTATTGAGACATACTGCATTCTGAGCAGTGTCCTAGAGTAGCTACAGAGGAACTCAGATGATAAAGCAACATAATATTAATAGATAAAATATATCTGTGGGTGGGTTAGAAACTGAGACACCTTTTCAAATAGCCAAAAGTTGCATGCCAAAATTTATACTGAAATGTTATTAAAAAAACAAATTTTTCCCATTTCAGCACCATGCCCTCGGATAAGTAGCTCTGTTCCAAGGGCATATTTAACTACCCCCTCCTAGCTGTTATTTTTCCTTATTATGTTTTTTGGCCACTCTCAATTATTAAGATAATTATGTGACTAACCATGCCCAGTTCTTAATTAAAGAAAACACTTTTAGATGAAACCTTATTTCTGATTCTTTTCTTTACACTAGCATAACAAATAGTTCCACTGGTGAAAAACTTTACATTATTTTTAACGCTAAGTAAACTCTTAAGCAGTGCAAAATCAGTCTGGATGACAGGGCACAGCTTCTTAGGAATTTTATATCATAGAACTGGAAGAACCCCCAAGTCTCTTATCTTTGCTGTCAGAATGACCCCTATCTGTCGCACCATTGACATCTGATTTTCCCATTCCTGATGCTTAGACACATGAAAAAGGAAGAAGAGTCCAACTTTCATTTGCAGTTTTGAACAAAATTAATAGGTTGTACAAATTATTTAATCACAGGTTTAATTGGTTTGCAAAATAAGTTTAATTGCTAAAATAAATGGGAAGAAGAGTTATAGCTTGTTGTTGCATGGCAAACACCTTACATACAGAACATAAGGTTTACTTTTAGCTTGCCATAGCTGATATTTTCTTTCATCCTTTCATGAATTCGCTTTTCTAAGTTCTTCCTTTATATGTATATAAGCCCAGGGGCAGAATGGGGGCACACATATATATACACATATACGTATATACTATATGTGCTGTATATCTACGCATATGCAAAAAAGACCACAAATGTAAACAGAAACTGGCCTGGGCAATTTCAATGTGAAAGGCCACCTAGTAATTATATAAAGGTAACTATGAAACCCTAAAATTTTCTTGAAAGATCCCAAACTGCATAGTATTCCATGGTGTATATGTGCCACATTTTCTTAATCCGGTCTATCATTGTTGGACATTTGGGTTGGTTCCAAGTCTTTGCTATTGTGAATAATGCCACAATAAACATACGTGTGCATGTGTCTTTACAGCAGCATGATTTATAGTCCTTATACCCAATGCTAGATGATGAGTTAGTGGGTGCAGGGCACCAGCATGGCACATGTATACATATGTAACTAACCTGCACATTGTGCACATGTACCCTAAAACTTAAAGTATAATAATAATAAATAAATTTAAAAAAAAGATCCCAAACTATTGGTTGAAATGATTTTTGAATGCATACGTGCTAAATAGATGATTATAAAACAACTTGGAAAGCTCTATTTCCATTTATTTTTATCTAAATGAATTAAATGCACCCATATACTAGATTGCTGTTTCATGTATTCTTTTTTTAAAAACAACTAG
>TTN-201,,0,541,243821,244361,GTAATTACAAGGCTTATTTTAAAAACATGTATAAGGCAGAGGCTCATGAACAATGCCAACTCTCAATTATCTTTATATGATGAGTACTATAGATGTTTAAAATCAACCAAATAATCAAAAGTCTGATTTTACTTTTTAGCATAACAAAATAATTCACAGACTATCTTTTTAAAGAGCCAAAATTGACTAGCATAGGTTTTACTTCCTCCTTCCATCTCTATTGTTTTTATTGCACATCCTAGATTTTCAAAAGCCAGCTGGAGGAAGAATTATTATCAAGCTAGGTATCCATCACTTTATTAACCAAGAGTTGGCTGTTATTTCCTTAATGTTTCCTAGTTTTTAAAAATGATTTTCCTCTTGTCTGTACAAATAATGATAAAATATCATTTTTAGAGGAAAATGTCTGAGTGTAATCAAAACTTGAAAATAAAACTTAGGACAGAACAAAGCCCTGGAGATGGCAGGGGAAAGTTGAGAAGGTACCAAAACTCTTGGAGAAGGAAAGGAGTACCTTGGCTAATGAGTATGATTCTTTCAG
>TTN-201,,0,1697,244362,246058,GTAAGTATTCTTCTTACAAAGGACTTTTCATTTGCAATTCTTTAATAACTACAACAACAAAACAACACAACACTTTTTGCATGCCCTTCTTGGCCTAACTGCATTTCTTGGCAACTTCTAGTATTGACACTGACCTAACCTGATCCTTTATGTGTTTAAAGAAAAAAAGAAAAGAAAAGTCTTATTCTATGTCTGGTCTGATTAATGATGGAGCAATCACTTTTCCCTATGCTTCTTTTCTCTCACTGAGTAGTGAGTAGATGTGCTCTTTGTCTACATGGGGTCAGCCTACTGTATGGATATCCTGATATGGATGAGGAGAAACTGAATTTTAAAGATAAGTAGGGAGTCCTAATTTTAAAAACAAAGTAAAAGTGATTTCCATGTGGAAGGAAAATGAATTTTCAGGTGTGGGGAACAACTAGAAAATGAGCATGAAATTTCAGTCTGAATAGGAGCATACTAGAGATCTGCTGTAATATGACAAAGCACATTCACATGATTCAATCTCTGAGAATAAGAATGGATAAGAAGATGGAGTGAGGCCCTGGATCTTTTGAGTCCTGGACTCTTTGAATGAAGAGAACTCTAATGGTTTTTAACATTACTTCTTCCTCTGGTGAAAAATGTAATGTCTTTTTTCAAAATGCCACATACTAGCTTATTTGTTTCATTCATTCCTTTGTCCAGTGATGACATTTTTCTGCAAATTTTTTGTGCAATATTTGTTTGTTTGGTTTGGTTGCTTCCCATCTGTCAACAGCTACAACCTAGTGACTCTGTGCTTCATGCATCTTGTACCATGTTTTTCTTACCACTTTGTGGTTGCTCTGCTCAAGCTTATGTCAAAGTAGCTTCTTGGGTCTCCTTCTTCACCTTGACATCTACCTTCACTCCAAGAAGGCTCAGCTGCAAGGAGCATATTTTCAAACCTATTAGACAGCATTTGTCTCAGAATCTTATTGCTCAAGAATGGTCATCTTGGGAAGGACTCACAGGGAGCTCTGAAAGAAGGAAGGGCAAGGGGGCAGCTCCCTAATCCTATACACCAGCTGAATTAATTCTACAGATGAATGAAATAACAGATGTAAAATCCTAATCACCCTCCCATACAAAACACATTGCTTTATTGCACTAATAGATGTTATGCCTGACTTATATGTGACGTCTTCAAAGCTGATTTTTTTAAAAAGCTAAATGTATGTTTCAATTACAGCCTCATGCCTCTTAGCCATACACAAGGCTGGCCATAGTGCTTCACGTGTTCTATCTTTGAATTCTGCTAATTTCTCAAAGATTGTGCTAAGTGCCTTAAATAAGACAATGTTTCTTTGCCACTGGTGTCTGAAGTTTCCTTTGACATTATCTTTCAAGTCTGGTGCAGTGCAAATGAAGATTTTTCCTCCAGCTATTATTCAAAAGAACTGAGATGGCTCCCTAGTATATATACTGTACACACACACATGCACACTAGTTGAACATATAGAATGCCACATAATTTTATGTAAACTAAAGAGATATCTAAAAAGCAAAGCATCATACCTGATGGGCAGCTTCAAGTGATTTCAAAGTCAGTTGTAGTCTATTAAGATGGAAAATCCCTAAAAAAGAGTCACTTTTTCTTAATGTATACTATGGTAATGTCAGAGTAAATTTCCAGAAACCTCATTTTGAATTCTGATGACATTCTCTTACAG
>TTN-201,,0,661,246059,246719,GTCTGTGACTGTATACCTGTCATCTTGTACTGTCAAATAACTTTATATTTACTTTTGGTCTAGCCAAAATGGAAAAAAAAAAGTTAGTCACAACTTCTCTGGTCACCACTTTACTTTTAAAGATAATTGTAGTATAAAATGTATTCTTGACTTTAATTGCTCTCTTTTTAGTATTATTAATTTACTATTACTTGAAAAACACTGGACTCACAATCAGGAGATTTAGATATTAGTTTGAACCATATGAAAGTGCTGTTTTCTTAGATCAGAAAGTCAAATATCAGCAATTATATTTCTTTCAACTAAGTACCTCCTGTTGCTATTAACTACCATTGGCAAGTTTCTTCAAGTCTGAGCCTTAGTTTACACATCCAAGAAGTTAGTCTGCATAATGTCTAAGGCTCACTATAGCTCTAAACTTATATGATCCCATTGTTTTTAATAACTGATAATAGTATCACAGCAGCTAACTTAACAGTAATTGGTAAGATTGTTCTTGCTTTTGGGGTTTGTTTATATTTGTGTCTGCCACCTTGGTTCTTCTTCACACTATGAAGTCTTGTTGGTTGCTTTCAGAAAAACTCAGGATCATAGTTTTTCTTAAGGACACCTGTGTGAAGGAACAACAAGAAAACTGATAATCTATTTATCTTAAATATAG
>TTN-201,,0,98,246720,246817,GTAAGAGTAAAGTCATTCTTTGTGAAGTATATGTGTTGGGAAAAAATAATAATTTCCAGCTTAACTCAATGTGGTTTTTGTTTTTTCAATGCTTGCAG
>TTN-201,,0,106,246818,246923,GTATGAAAACTACAGTGAATAATCTTTTATTTCTAACAATTCACACTTGCTAGATTTAAAGTACAAAGACATATGTTTCTAATATCTTGTAACTTTTTCTTCCCAG
>TTN-201,,0,108,246924,247031,GTAAGTTTGTTCTTGCTTTTAGGGTTTTTTGTTTGTTTGTTTGTTTTGTATTTGTATTTACCACTTTGATCATTATTCATACTATAAAGTCTTGTCGGTTGCTTTCAG
>TTN-201,,0,89,247032,247120,GTAAGTAATTTATATACCACTAGAGATTTTTTCATCAGTTTCTGTTATAAAAATAATTAAAATCAACATATTTTTCTCCTTTACAACAG
>TTN-201,,0,104,247121,247224,GTAAGCAAGATCTTTTTATTCTCTATTTCTGTAGCTATATATACACTTTTGACAATTTAGTGGCCATCATTGCAAGCTAACTGATAATCCAATGTCTCCTTTAG
>TTN-201,,0,100,247225,247324,GTACATATTAAGTGAAAAAACAATTCTAATGTTACCAATTTTTTAAAATTGTTAATCAAAATGTAAACATATTTGTATTTATTTCACATTTTCTTTCCAG
>TTN-201,,0,767,247325,248091,GTCAGTCCCTTTATTTTAAAATATCCTTCCAATATCACAGAGTTTAGATTTCAGATTTCACAGTTATTTAATGAGGTAATCCTTGTGAGGGTCTTTCATTTCTAGCAAGCCCTACCCACATGTTAACAACTCTAATTTTGCTCACTACAAAGTAAGTGTCTTGAGTAAGAGGAAATTAATAGCAATAATCTTTACATGCCAGAGCCTTGGACAGTTGCTAGTACATGATGACTATTTATGAACTTAGGCTACAACTAAGCTATCACCCTGAGAGTCTTGGCAAATCTAAAGACGGTCTTATACTCTCCTACTTTACAAACCCCTGTGTGCCTTTTAGGTATGTTCTCATCCTGACCCAGGACATCCTTATACACTGTCCTTATGAAAAAGCCATTAGTGTACCTCTCATTCATAAGAAAAAAGTTTCTCTGATTTATTGAACTAAGTATGCAGTGCCTACTCTATCAAAAAACAAAACAAAACATGTTTTGCACTACACTGAGTCCTATGTTACTATTTTTGGCAAGGAATGCATGTCTTATGATTTTATGCCATTCTCAATCCTCTACTCTCCAATCTAATTTGCACGCACAACAACAACAAAAAGCTATGAGAACTCTAAGCCACTTAGTTTTCTCTGCTATAAAGTTACTGTAGCTTACTTCCAAGGTTATGTAACCAATATTTTCTAATAAATGCATAATAACATGATGTAGCTTGGCTACGTTTAATAGTCGAAAGCGTTCACATGTTATCTTTCTCACTAG
>TTN-201,,0,92,248092,248183,GTAAGCCCTTGGGTCTCTCAGACTTAATTGGCAAAGCACAATTTAAAAGCAAGACAGCACACTAAAAAAATTCCTCTATATGTGAATTTCAG
>TTN-201,,0,107,248184,248290,GTAAGAAGTTTTAAGTAAATTCAAGTTAGCTTTTAAGTAAATTGCAGTCTTTGCCTTCATCATCGTTACCCCAAACTCATATTTTCTTCTTCTGTGGTGAAATCCAG
>TTN-201,,0,266,248291,248556,GTAAGCCCATCAAAAAAGGGAAATAATTACTGCATGAAATCCAGATATTAGGCCTATCAATTAAAATAAATCAAGTTAAATGAAAGTTAATAAAAAGGTAGAATATCATAAAAATTTGGATAAAGTTTTAGAAACCCAGACTGTGCCTACTTTACTTAGTGAATTTGATAAACCTGTTAATGAGGATGATATAATTGATTACAACACTGTTTTCATAAATTGTCACTAACGTAAATGGTATGCTCCAACTCCTTCTTTTATTCCAG
>TTN-201,,0,90,248557,248646,GTAGGTCATTTGCATATAAAAAAGAATATTCAATGTGGATCATGGACATAACTGTATGTGTTTTTTACAAATATTAATTCATAATCGTAG
>TTN-201,,0,106,248647,248752,GTAAATAGATATTTTATTTTTAGATCGGGGAATAGCACATAGCTACTTTGGGGCAACAGGGACTTAAATATGGCACTGCAAACTCATTAACTTTTCTTCTTTGTAG
>TTN-201,,0,98,248753,248850,GTAAGGAACAAAACATTTATCATCTAAGGTGATTTGGCAGTATTAACAAATATTAGTTCAGACTATTAACAGTGACTCGTGAGTGCATTTTTTTTCAG
>TTN-201,,0,690,248851,249540,GTGAGTTTTGAGCAGCACTGCATCAATGCCAAAAATGAGAGTAGGGGAAATCCCAGAAGGTTGGGATGCCATACAAAAGTCTTATGTGCTACAACTTCTTACCTTTACCTCACTGAAAATGTACAAAAACTTTTTAAGAATGCATCGGTGCTAATGCTTCCTGAGGTAGCTCAACCAAGGATTGTATAATTGTAATTGTCTTGTCTTGTGAGCCTTACCAAATTTGTAATAAAAAAAAAAATTCCCTACTGACTTGGTACCTGCTAAGTACCCAATATGTACCCATTAAGCTAGAAGTGGAAAGTAAATATTTATTTCCCTGGTGGTCACACTTCTTATTCCACTAGAATACCTTAGTTGACCTAATCAGCCATTATTTCCTTGTGTTTATATTAGTTACTATTCTTTACCCTGAATTAAAATCATATTTCTGATAAGCAAACTGGTAGAATCAACACCTCATTTGCCATCTTTTTTCATGTGTACAAACTATGAAGCAGTTTTTCTTATATTGAGTCAAATATTATCATGTATCCTACTTTGCAATTTTCCCTAATATGAAATTAATGTAAGAATAATCCCTAGCATTCAAAACAACTGCAGTTTGTATCCCTGGTCATGGTAAAAATCTTTTGGGTTGGCGAAAGGGTTTTTTGGAAATAACTGATTAACTGTATTTCTTTGTCCCAG
>TTN-201,,0,156,249541,249696,GTGAGTACATTCTTGATGATTTCTTACCTAATCTTGTTGCCTGTTTTTGCTTTTAGACCTAGAGTTGAAGTTATGGGGCAAGGCAGGGGTTGGCAATGTGAAGAGAACTGCATAGGTGGCCTGTGTAAGACTGACTCTCTCTTCCAAATGTTGTAG
>TTN-201,,0,338,249697,250034,GTAGGTTTTTAATTTGGCATGAGAGTAAATGTGTACTCCTAGTCACTAAAATGGGCTTTGTTGGGGAAAATTTAAATGTTTGTCTTTTTTCATTGAGAATCCTATGCTGCCGGTGTATCTGTCTGATTTTTAAAGGTGCTGCTGAATGTACTGCCTGCTCAGGGTTTTCATGACAGTATTGAAATGAAAATGTATTCAGTTATAGTGTTGAAGTAATCCAGGTTTAATTTAAAGACTAGTATTATACCAGGGGTTTGAATTTTTGAAAGATTATGAGTACTACACAATGAAACGATTATCGACATCACAGTAAAACATCCTATTCTGTTTTCTGACAG
>TTN-201,,0,93,250035,250127,GTATCTATTTTTGATTTTTGTCTTATCAAATAGGCCTCTGACCTTAAATCTGCTTGAACTTGATAACATCATAAATAATCTTTTCCAATTCAG
>TTN-201,,0,117,250128,250244,GTAAGGAAGGTTCTCATTTTAAAAGGGGATAAACTCTTTGCAGTTACTTTCTTGAAAGAAAAAAATAAAAAAAATGGTGAACAATTTTTTTTTCTGCATCTGTAATGCCATACACAG
>TTN-201,,0,114,250245,250358,GTAAGTTTCTCAATCAGCTGATAAAAAAAAAAGGATGCTTATGTCAAACTTGCATTTTGGTGTCATATTTATATACAGGACATATAACATTTTACACCATTATCCTGTCTATAG
>TTN-201,,0,474,250359,250832,GTATGCTCAGAATCCCCATCAAGATGTTAAGACAGCAGTATATTCAAATGTTTACTCTTTAGTATTCCTTGGGATTACAGATGATTATATATTACTAAAAAAATTTTAAACTACTTTTACTCATATTTTCTATTACCTCATAATTTGAAAAATTATATAAATTCCATTCAAGGGCACATTTCTTAGTTTACTCTAAAATATTAACCTTCAGGAAGTTTCAAAGTGTTTGATCCCCCAGTATATTATGATAATGACCACTGTCATAGATATTATAATTAGATTGGTATGTTTGGCCCAGTCTAAAGTGTGTGGCAGTTAAAAAGCAATTTTTAATTTATATTGAAGTGCTTTTCAGTTAAATTTCCAAATCACCTTTTCACAATTTAAATAAATTAGTCTCTTCTGTGTAAAATAAACATAGGCTTCTTCTGCTTCTTACCATGATGATACACATGCACTTTGTTCCTAATTCAG
>TTN-201,,0,88,250833,250920,GTATTATTTATATAATTTTTGTGGTTATTTCGAAGTTCATATGAACTCCTTTTTGACAAACCTAAACAATGATTTCATTGGCTTGCAG
>TTN-201,,0,196,250921,251116,GTAAGTCACTCTTGATGTCTGGGATATATAAATTCTTCTAATATCTGCCTGTGAGCTACGATATGAGAAAATATGAAAAATTCATTACTATTATTTCCTCCTGGCTACATTACTTCTTAATGACTGCCTGCACTTTCAGACTGACTATTGGGTAATAAAAAAAAAAATGAATTTGTTTTCCTTCCTTCTTTTTCAG
>TTN-201,,0,114,251117,251230,GTATGCTCTTGCACTTAATCTTTGTGACAATAAGTGCTCTCGCACTTAATTTTTGTGACAGGAGATTATCACCTTTCCTCTGGTTTTCCTAATCATTGTTTATTTTATTTTCAG
>TTN-201,,0,102,251231,251332,GTAGAATTTGAATTAATTCATAAAGAATAACTTACACTTGGCTGCAAATTCTTAACTGTGTTTTTTCATTAATGCTAATGAAATGCTTTGTTGTTTCAATAG
>TTN-201,,0,80,251333,251412,GTAAGTAGTGCTGATTATACACAAGATATTGTCTAGAACTTGATGAGACTGTGGATATGAATATTTCACTCTTTTCTCAG
>TTN-201,,0,100,251413,251512,GTAAGAGCACAAGGTCTTTTATAGTTAATAAAATACCCTTTATTCATGCATTGCATTTTGACATACTCTGTTTTTTGCTCTTTTGAATGATATCTTACAG
>TTN-201,,0,603,251513,252115,GTAATCATTCTTTGAAGAAAAACCAGACATTCTTCACATGTAGAGGAAATTAGTTAACTTTGCAGTGCTATTAATAATATAATTGGCTTCATGAACTGGCCACTTGTAAACTAAATGTCACTTCTGATTATGTCTTTCCATAGGAGAAGTAAAACAATTCTAAAGAGATGAAATCGCTAAACGCTTATTAGACTAATTTATACTAGTTTTAGTTAATTGCATGTGAAATACTAATTTAAATAACAGATATTAGCATACCCAAAGAGCATTGAAATGACCACAATTTTTTAATTGCACAGCTTCACATTTTCCCATAGTGTTCTTAACCAGGGATAGTAACATTTTCTGCATTCCCCCCAGCCCTGCAAATAATGTCTGGAAATTTGTGGGGCCATTTTTGCTTGGCACACAGACTTGAGGTAGATACCACTGACATTTAGTAGTTGGGAGCCAAGGATGCTAAATGCTCTGCAGTGTGAATGACACTCCAGCACATCAAAGATTATCCTACCCAAAATACAGATAGCCCCACTTAGAGACAAGTGCATTATTAAAATGCTGATTTTTCAGGATTACTAGAATAATTATCCATTTTTGTAATAG
>TTN-201,,0,103,252116,252218,GTAAGTTTGGACATGGATGCACTATGGCTAAGAACTAATAAACCATAGTTTTGTTTTAAGAAGGTGGTTTTCCTGATACTAACATTTTTTTCTTGTTCTTCAG
>TTN-201,,0,113,252219,252331,GTAAGTTTTGTTTCATGGAGTTGCCACTTTCCCATTTTGAAATAAATGAAAATAATGTTTTGTCAGTTATTTTCATCAGAATTGAAAACATTTATTGGTTATGATCACTATAG
>TTN-201,,0,299,252332,252630,GTGAGTCATTAAAACTACACTTTCCAATGGAAAAAGGTTTTAGTAAAACATAAAAATAAAAAGTTTGGGAGAGAGTTAAAAGAAATGGGACATAGCTTCAGCAAGTTATCCTCAATCATATTTTATCTGCTGGCCATGTAAAAGAAATCACCTGATCTTGTTATTTATTAGCTAATGGAATACAAAGATAGATGTGGGAAAACCACAAATCATGTCAGAGGAGCATGCTCACATTTATATTTTCCATAGCAACCCTTCCCACACAAATTTTTGATTACTGTTCTCTTCTGAAATATTAG
>TTN-201,,0,128,252631,252758,GTAAGTTTCCTTTGGCATCTAAAGTTTGCCTTTTTACCATGTACTTTGGTATATAATTACTACAGCTTTTAAAATTGCATTTTTATGTCATACTGGGAAATTTACTTCAAATGTTATTTTTTTATCAG
>TTN-201,,0,96,252759,252854,GTAAGTAGTTCCTTAAGAAGAAGGTGGAGTAGAACAAGCTATTGTACATTTTAAAACCATCAGGGAGTTTGATTTGTCTATCTTCATTCATTCTAG
>TTN-201,,0,99,252855,252953,GTACTTAACGTTATTGGAATAAAATTATGGATATTTTCTCTATATGGGACTATTTTTTAATCTTTCATGGGCTAATGCATGACTGTTCTCTTTCAACAG
>TTN-201,,0,86,252954,253039,GTAAGGAATGTTGCACTGATTTTCACAGGATTTTCCCAAGTGATACTATCTTATTACATTGATTTTTGGCTTTGTTTTGTTTTCAG
>TTN-201,,0,1307,253040,254346,GTAAAAGAGAAGGTTTCATTGTGTTTATAGAGTAATGTTTTGCTTCTAGTTATATTATTTACTGAGCTTTATGGCTTCAAACTCCCAACAGTCTCAAAATCTATAGCTAAAGAGTAATAAGAAAAGTAAATCAAAAAACTATTAGCAACATTAAAGATATCATATTTCCTATAATTTCAATGTAATTTGTGGCTGTAAGTATATTAATCATGCATGGTTTCTTGTACTGAAAAACTTGGATCTACAGGGGCTTAATAATAACCTAGAAGTAGTTTAGACATATTATATCTCTCCAGTAGAACACATTGGAAGTCGGGTTTTTAAAACTTACTAGCGTAGTAGTTAAAGAGAATTCAATGTTCTTCTAAAAGATTAGACAATTCCTGAGAATAAATGCCTTAGTCTTCCTCTATATTCAAAAAGTCCCCATACTGGAAGGATAGAGAGGCCCAAAACCAGAAACAGCCTCCAAAGAATAGAAAACCAACCAGAGGGAATCTCCCAGAAATCAATACGAAACACTAAAATTGCACACACAGTAATGCACACTGACATCCCATCTAAGAAAGCAAAGGCTTTGAGGAAGACCCATTCCTCAAGAGACAGAAGAACTTATTCCTTCACCATCACCCCCTGAAAAAAAAAAATACATCCTATATCACTGCTGCAGCTCATCTATGAACGTCCAATATACCACAGGCTGTGCCAGAGGCACCAGAACAGAGCTGAGCTTCCACTCCTTCTGGTTGCAATAACAGTCAACAAGTATGGATTGGGTCTAGTTTTACCACTGAAAGCTTAACTCTTAGTTTGGTCCTTCAGGAAAGAAAACTTCAGCAGCATTACATACATCCTCTTTCCACCATATTTTGAACCCACATGTGAGGCAACATGACTCAAAGTATGTTCATAGACATATCCACTATCTGTTAATAAAAGAAAAAACACTTTGCTCTCAGCTGGTCATTCAAAGCAAAGCTTCACAGACTTACTTTCCTAGTTCAGTAGAATTAGAAGCATCCCCAGTTACAAAGGTAAACAATCTAAAATGTTAAATTAAAAAAGCATACGTGCCCTTGATTTATTTTTCACTGATAATCTTGATGAAAAGTTTGCTAAGAAAAATTCTGTCTACATGAATGTCTATAATTTTGGCAACTGACAAGTTTTAGGAATGATTTTAAATAAGGATGTAAGGTTATGCCAAACAGAAGGCTATTTTTTACATAATTAAGTTGAAGTGAAATATTATTTCTTACATGAATATTTATCTCATGCTAATCATTTTCACTTGCCTCTGGCTAAAG
>TTN-201,,0,118,254347,254464,GTGCGGAATCTGAATATAATAATAATTTTAATGCATTTTACAGTGTGCCTTTATCCCATAAGTTGAAAAAAACATCCTTATGACTTTGTTACTGTTTTTCTTTCTCTTCTCTTTGCAG
>TTN-201,,0,88,254465,254552,GTAAGTGACTTGCTTTCTTACATCAAAAAGGCATCCAGTGTCTGTTTAAGAATTGCCTTCTCAATATTCTCTGTTGATTCCTTTCCAG
>TTN-201,,0,402,254553,254954,GTAAACTCTTCTGAATATTTTCTTATACACATTAAAAGTACATGACTCTGGTTTGATGCCATTTTAATATAACCTTGGAATTTGATAATTAAACTCAAAACCACACACGATAAGCTGTTATTTTGTTATTGTAGTGTTTAGCCCCACACACATAAGGCTCCTTAGTACATAGCGTTTGATACACAGATACTCTTTTAATTGAGATCCACTATCAGGTACAATACATCTACATATTTTTATTTTAAAAAAAGCTTTCTCCTTTTCTCTGTCTTCCCATGTTTTGAGTCTATATATTTATTTCTTCTTACAGTCATCCCTCCCAAAATAAGTTGAATTTTTAAATGAGTGAAAACCAACATAAGTATATTCTCTTCAATAAATTTCTGTTTTTCTAATTTCTAG
>TTN-201,,0,1285,254955,256239,GTAAGTATGCTTCCGTTTCTGGGGACTAATTTCTAAAGCACAAAGTCACTAAATGGATAATTCTGCCTTAAATTTCTTATATTTTTCTATGCCAAATTATTTTATTTATTAAAATAAAAAAGGTTCATGTTCACATAGACTATCGGAAGTATATATTTATGTGTGTATACATACATGCACAGATATATACATACACACATACATAAAATCATACAGTTTGTAAACTCTTGGATTAAACCAAATATTTTATGAGGAATCACAATAATAAAGACCTGGACTATAAACTCCTATGTCTTCTGATACTTTAAATAAATTTCTATCTCATTAGATACTGGGGAAATCATCTCTCCCACTAAACAGTCAGACCTTCCAGTAGGAATTCAACAAAAAACAGAATGTTGTTAGCTTTTCTATAATATTATTGAACAAAGATTTAGGATTCTCAGGCATAGTCTGTGAGGTCAAATAAGAGAGAAAAATTCTTCTAAAAGATCTGTGAGCAGATTCGTTCAAAAATTAAAAAATACTGTGGCCATAATAATTCATCCTATTTGCTACATATCTGATTAGATTCTCTATAGAAGAAAAATTCAATTATTTGTTAAAAAGAAAATTTTAAATACTCAAGTGCTATGTGGAGCATATATACCTATATAATGAGGTAGTTATTCATTCATTTGCAAACTAGTATTGAACATGTGCTTTGTGCAAGGATCTATATTAACCACTGGAGGGGGAAAAGTTAAGATTAAAAAGACAAGTACAGTAAAAGAATTTCTGTAATTGTAAAGCACTTTCAGAAAGGTAAAGGATTGTTATGGGATTATTGTAGACACTGATCCTGTCCCTAAAGGGCATTAAGATTAGTTTGTGTTCAAAGGTTTACTAGCTATTGATGGAATCCTTTTTAAATTTTCATATTGTGGCAAATTAAATTTAAATCATGTTTTCAGTAAAGGCTATTGTAGAATTTCTTCAAAGGGATCTCAAAAGTAAAGTAGTTTTTTACCAATCATGTATAAATAGAATGTAAATCTAACAAGATAGGAAGTAGTCTTTCTATTCCCAGTTAGTTGTTTGCTTTCTCTGTTTTTGCATTAATGCTAAAGGAAAATAGACCATTTCCTTTATTTCTCTTCTCTAGAAGGCAACTGTATTTCCTTTTAGCATTTCTATTTTAATATTTTAATAGATTAAAATAATATATGATCATGTGTAGTAAAAGACTCCAGCACTTCATCAGCTTCAAAATCTGATGAAGCTTTTTTTTTTCTTTTGTTATTAG
>TTN-201,,0,131,256240,256370,GTACTAGTACTTACTCAGTTTATGTATTCCTCTTTTGATCTTATTATGAAATTGATTAATTTACTGAAGATATTTCAATTACTTTTGACAAATATGAGCTAAATCCTGTTAAATTGTATGTGGTATTACAG
>TTN-201,,0,87,256371,256457,GTAGGAAAATAACCATTCTCCTCTTTTTTCCACTGAATCACTATAAGGAGTATTTATACTACAACTGACTGTCTCCTTTTCTAATAG
>TTN-201,,0,94,256458,256551,GTAAAAAAATAATAATTAAAATAATTCAGAATATGGTTGACTTCAATATTGCTATGATTTCATTCAATGTATGACTACTATTTTCTTTGTACAG
>TTN-201,,0,93,256552,256644,GTAAGAAAGACTTTGAAAGTTGCTACAGAATAAAAACAAATTATTTTTAAGCATTTAAGGAACGTTGCTTATATTGTGATTTACATCCAACAG
>TTN-201,,0,93,256645,256737,GTAAGCTTTAAAATCTAAATTTAAAATATCTTCTCAAAATTGAAGTATATTATTATAAACAACGCTTAATACTTCCTTTAATTATTTTTACAG
>TTN-201,,0,1003,256738,257740,GTAAGTACCAATGTACTGACAAAGAATGTCCTCCTTACAGCTGCCTTCCTAGGTGTTCAATAATAGTTCACAATTAAAAGAGCTATATCTGTACCTTAGGAAGCTACTATGGCTTGAATGTAGACATGGGCACATTACTTAATTACTCATTCCTTCAATTTCCACAGAATTTTCACATTCCCTTACCTGTTACCTTTTCCCTGTTCAAAGGAGATGATGTCTGTAATTTCCTCGCTGTAATTTTCCTCGCAGTCTGTTTTATTTATCAGAGGCTAAAGCAATTTCTCTGCATGCTCCTCAAAAGGGACAGAAAGTAACCAGTCATTTTCTTAGCAACTGCTGAGACCCATTTATCTTCACAATCAAGTTTTTATTTCTCTATATGAGAAAAGATATATCCATTTTAATGAAGTATATATATATATATATATATATATATATATGGTAATAATTCTTCCTCTGATAATTACCATCACTACTGTTGTGTATTTGTTTATTCTCTCATCTAAGTGTGAAGAAACTGTAGTCACTACCCTCTTTGAATATTTCTGTCCTAAATTTGTGCAAAATGGAAAATTGCTTTCCTTTTATTAACAGTTATATTTCTTAAAAGGGGAATTCACCTTCTTGTGTATCCCTTCATAATTCTGTGTAAATATTAAAGAGAGTATCCCATGATACTCTCCTACTACAATCTCCTCTCTTCCCTTTTGTCAGGATATGAGAATATAATAATACACATCATTACATGCATAATGATGCCAAATAAAGTGAGGCAAGCACAGATACATAGCCACATGTAGATCCAATAAAAGATGCTGACCCCGTGTACCTGCTCCCCAAACTAGCGTAATAGTGTTAAAGACAGAACCATTCTTTATATTGGGCTGAGCTACAAAGTCTGCCTACAGTGGATCCAAACAACTTTATAGTAACTGTGAATTCTACTTTCTATCCCTCAATGCTTTTTGCTCCTAATGACAACTTTTTTTAAATAATCTAG
>TTN-201,,0,108,257741,257848,GTAAAGACTGCATGGTTTGGTTAAAATTACTTGTTTTTCTGTTCATAAATAACATTTGGCTTTAAAATCATCTGAGTGATAAAGGGTTCCTTCTTTAAACCATTTTAG
>TTN-201,,0,83,257849,257931,GTAAGTAGGAGAACATTTTCACATACAAAGCCATTTTTACTTTTTTTTTAAATTTCTTATAATCAATATGATCTTTTTCACAG
>TTN-201,,0,93,257932,258024,GTAAGCCTGGAAACCATTCCTTTTTTTTAAATCTTATTTTCCAAAAGTGCCTTGGAAAAGTCAAGAATACTAACGTATACTGGCTCTTTGCAG
>TTN-201,,0,447,258025,258471,GTAGGAAAACTTGGCACTAAGGAAATGCACTATGAATAAACTAAAAAATGTCATAGTTATTCTCAATCCCATTAACTTCTGTCTATACTTTTTGGATTAAGAAATCAGGAAAATAGCATAATTTTAACTCACATTCCAAACATCTGTTAATGTCAGAAATCGAATCAAAAGTTAAGTCATGTTATTACTAATCTTTTGGTTATAAACCCTGGAATGTGGAATAAATAAATCAAGGTTTAATCATTTGACAATAATTTTAAAGCATAACTCCTGCCAAGTTATTCCATTCAGTGTTGCCTGTAATATCTGATCCCTAAAACCTAAACCAGCAACAATTTTCCCAGAGTAAACAGTTAAATAGGCTGCTGGTGATGCTTTAGGAAGCCATTAAAGCAAGAAGCTACAAAGAACTATTCTAATTATAAAATGTCTATGATTTCTCCCCAG
>TTN-201,,0,88,258472,258559,GTAATTATCAATCCTTCCTTATGCCATCAGTATTTATGTTTCAGATTGAAGGGGAAAAATCACATTTGTAATTTTCAATTGCTTCCAG
>TTN-201,,0,1728,258560,260287,GTAAATACTTTCAATTTGTCTGTGCAACTTTTTAAACCAACATTCTTATTATATTTACACAAAGCTATGCTGTATGCTGTGTAACAAACATTTTGGAAAATAAGAAAAATCACCCATAATCATGTTGAACATTATTAGAATTTTTAAAAATTTCCTCCTTACTTTTTTATTCTATGTGTATTCTGTATGGTGGGTGTAAGTTTACAAATTATATAATTGAGAAAACAGATGCTAACAAGAAGACATGCATCCATGTTTCCAGTGAACCTAAAGAGTGCATGTACACAATTCTCAAATTGCTAGAAGGCCATGAATATGTATTCTGAATCATGGCCCAGAATAAATATGGCTTTTTTATAGAACTTGCCCCCATAGTGTCTATTATGTTGTTATATAGTTTTCATAGAAGCAACTTTCCTTAAACTGTACATGAATGTTTAACAATCTGCAACTTTCCTTAAACTGTACATGAATGTTTAACAATTTGCCAGTGCTGACCATTTCACATCATGAGACTCTACCCCTATCGCTAAATTATCATAATAATGCAAAAACCTGTTTGAAGGGTTTCAGTATTCTAATTGAAGAGAAGCATCATAGTTGGTTATCAATATTGCATTTCTAGTCACTGAATATAGAGTTGAACTCTATGAGGCTTTTTCATGGCTCTCACTGGAGGCTTTAGTCCAGTGATTTGCTCAGAACACGAAGCCTTTCCACTCAGGGCTCTTTCTAAGCATGTCTCTAGGCACAACAATACTCCAGCCACAGTTTTTATGTGAAAATTGCCAGTTCTATGTTGAATATAATTAATATAAGAATGGCATAAGGAAAAATATTTCATTAAGCAGTAGCCCCACAAACTTTCAGGTTAGTTTCAAGCACCTAAAGCTCTTTTGCCTAATGGTTATTACTTTAATTTGAGAACTGGTACATTTCCACGTTAATTATTTGCAACCTCCTCAAAGTCATTCTGAAATTTGGGGCCTCCTATGCTGCTTGTTGATCCACTGGTCATCCAGAAATAAACCATCTCTCTCTCCGTTTCCCCTGCAGAGGAAACTGGACATAGAAACTGACTATGCCACTCTTACCCATCTCTTGTATCCCTCTGCATGCTTGCCTCCCAGCTCCCTCCTGTCCAACTCACAAATTGCTTTTAAAAAGCATTTTTATTTTCCCTTCAGCCTCTACTAAAACCATGGTAACCAATAACTGTTGCAAACCTACTTCATTAACAAATATGGGGCTTGATGCTATGGCTCACACCTGTAATCCCCTGACTTTGGGAGGCCAAGGCAGGTGGATCACTTGAGGTCAGGAGTTCGAGACCAGCCTGACCAACATGGTGAAACCCTGTCTCTACTAAAAATGCAAAAATTAGCCTGGTATGGTGGCACATGCCTGTAGTCCCAGCTACTTGGGAGGCTGAGGCAGGAGAATTGCTTGAACCTGGGAAGCGGAGGTTGCAGTGAGCTGAGATTGTGCCACTGAACTCCAGCCTGGGTGACAGAGCGAGACTCCCATCTCAAAAAAAAAAAAAAAAAAAAAAAGTGGTTGACTGTTTTTGTATTGACTAGATAGCAGAAGGAAAAACTAACTCAATTAGTAGACACAAAACCTTACTTTCTTCAAAACAACATTTTTGTCTCCTTTTAAAAAAACAAGTGTTGAGCATTATCTTTCATTGAAGGCAAACAGCTTGAATTATTTTCTTCTTATTTCCAG
>TTN-201,,0,860,260288,261147,GTAAGTAAAAAAAAAAAAATGTATACTTAATCACTTCTTTACTCATTTAGTACAAGACTATGGTGAAAAAATATGTGTATAAATGCCGTACATTTCATTCACTTGACAAGCAGTTATCACACAACTACTCAGTATCTGATTTGGTAGTATTTGGACAGTGATTGTGAAAGAGATTTTACAAATATGTATAATTCATTGAATTTCTTTTTGTTTTTTTTTTTCTTTTTGGTTTTGTTTTGACACATAGTCTTACTGTTACCGAGGCTGGAGTATAGTGTCATGATCTTGGCTCACTGCAACCTCCACCTCTGAGGTTCAAGTGATTCTTGTGTCTCAGTCTCCCGAGTAGCTGGGATTACAGACATGCACCACCATGCCCAGCTAATTTTTCTATTTCTAGTAGAGGCAGGGTTTTGCCATGTTGGCCAGGCTGGTCTCAAACTCCTGGCCTCAAGTGATCCACCTGCCTCGGCCTCCGAAAGTGCTGGCATTACCACTCCTAGTTCATTTATCAAATTTCTTCCATCTATACCTCACAGATTTTTTTTTAATTTCCCACTTAATGGCATTAATAGAAACTGAATTATTTTCCTACTTCTAAAACTACCAATTCTGAAGACCTTTCCTAAATTATTTTGCCTCAACAAACCTCTATTTCCTCATCTGTCAAGTGAAGAAATTCAATTGTATTGGGTCCTTTTTAACTCTAATAGTTTTATGATGAGATCTCTTTTGCTATTTATGGGAGCAGAGAGTTTAATGTTTAAATGCAATCTTCAGAAAAGGAATATTCACTACATCCTACTACATTCTTAATGTGACATTTTTTTCTACCACAATTCCTATACTTATATTCGCAG
>TTN-201,,0,101,261148,261248,GTATGTGTCTACTACAATTTATACTTCTGAAACTTGCACATTTGTAGATTTGTAATAAGACATCAATAAAAATGACTTGCCTTTATAATTACAAATTTTAG
>TTN-201,,0,93,261249,261341,GTAAGTCTTATTTAGTGGAAAGAATAGATCTTCTGTTCTTTCAAAAGCAGAAATGGCAATAACATTTTGTGCCATGATTTTTTTTTTCTGCAG
>TTN-201,,0,92,261342,261433,GTATGCATTATGTTTCTTTTTAGTGATTCAATGCTTGATAAAACTAATATAAAGAAATAAATTTCTAACGCATTTTCCAACATTTGTTACAG
>TTN-201,,0,89,261434,261522,GTATAGTATTAATGGATTTATTCAGTTTTCATGTTATCTAACTTTGTTTTCAGCTATATGCTAATTCGTTTTTTACTTTTATTTTTTAG
>TTN-201,,0,114,261523,261636,GTGAGTAAAATGCTCTCACTTGTGTTTGCAAGGAAAATAGATGTCTGATTGTATGTGTTTAATTGTAATCTGCATTATGGATCAAATCTGAGTGTTCTGTTCTCTTTATTCTAG
>TTN-201,,0,101,261637,261737,GTAAGAATTTTACTACTTAGGCCATTAAAAATAAATTTTGATAATTTTGAGCTCTTATATGGATAAAATTACTTATCAAACTGTTATTTAACACTTTTTAG
>TTN-201,,0,85,261738,261822,GTAAGTTGCTTTCTCTGAATACAAAACTATTGTTTGACTGTCTTTAAGAATATTACTTTTTCATCATAACTTCTTCTTTGAAAAG
>TTN-201,,0,94,261823,261916,GTAATTTTTGGACTAGCAGTATTACCTTATTTCTTTTTAAAATTATTCATATAGGTGAAAATCAAAATCTAATTTTTTCATGTTTACTTTTCAG
>TTN-201,,0,318,261917,262234,GTAGGATGTCCTTGTTTTTTCTGATATTACAGCAACTCTTAATCTCAAGCACAGAAGTATTCGATAAATAAGTTAATGTAACATCTAAATCTGTAACATCCAAACTGTATTTAGCAAATATTTTTCCAAATAGACCTTTTACCAAAATACCTAAAAGGTACAAACAATAGTAGATTCTCATTTTTATGAAGGAAAATAAAGAGGACACTAATTGAAAAATTGGATGACCTATATTTGATTAACTGAGAATAGGCTATATAAAATTACACATTGAAGTATCACTAGTAGTAGTTAACTATATGTATATTTTACTTTCAG
>TTN-201,,0,98,262235,262332,GTAAGTCCTTCCCTTAGCATGTGATTCATTCACACTTAATTTCTTATGATTTCCCCACATTCTGAAAAATCAATTAATGACCTTAATGTCATTTGCAG
>TTN-201,,0,98,262333,262430,GTGGGTTACTAAAATGCTTCTCCCTCCCACTTCAAAAATGAATTTGTTAATAGGGATGCTGAGGAGACATGTATATCTGATTTTATGATTCTTTACAG
>TTN-201,,0,310,262431,262740,GTAAGTATTATGCTTTCTTCCTCCTTTTAACCCCAGTCTCCTATTTTAGCAAGGTCAAGATACTAATACCATTTTAATCCACTTCTGAAAGAGATTTCATTTGTAGAGACCGAAATAGTGTAATAAATATCTATCTCACTCATGAAACACTTTTTTGATCTGTCTCATCTTATATGTTTTGCTTTTAATGTACTGAACTACAGGTTCTATGTACATTGGAGCAAATCCATACTAAAACTCTTATGTACATTAACAAAGGGGATTTGATTAGGTTACCTAGGTAATCTTCTAAATTATGTTTTTCTTCTAG
>TTN-201,,0,1157,262741,263897,GTAAGTAGTCTTTGCTTCATTTATGTCATGTGGTAAGTTTATTAGAATTTCTTCTTTTATATGTAGACATTTCTCCCTGAGGAATCTAGCTCTAGAAATTCTTGAAAAACAGTAGAGAACAGTGGCTTTCAAACACATGAGTGGGCCAAAAACACACAGTAAATAAACTTATACAAACACATATATAACTAAAAAACATTTCCTGAAACAATACCCATTTATTATCATGTGCATTCTTATGTTTTCTACCCTATTCTGTGTTTTTAAAAATATTGGCTGTACAACAAACATATGAAGAAAAGCTCATCACCACTGGTCACTAGAGAAATGCAAATCAAAACCACAATGAGATACCATCTCACACCAGTTAGAATGGTGATCACTAAAAAGTCAGGAAACAACAGGTGCTAGAGAGGATGTGGAGAAATAGGAAAGCTTTTACACTGTTGGTGGGAGTGTAAATTAGTTCAACCATTATGGAAGACAGTGTGGCGATTCCTCAAGGATCTAGAACCAGAAATACCATTTGACCCAGCAATCTCATTACTGGGTATATACCCAAAGGATTATAAATCATTCTACTATAAAGACACATGCACATGTATGTTTATTGTGGCACTGTTCACAATAGCAAAGACTTGGAACCAACCCAAATGCCCATCAATGACAGACTGGATAAAGAAAATGTGGCACCACATTTACACCACAGGATACTACGCAGCCATAAAAAAGGATGAGTTCATGTCCTTTGCAGGGACATGGATGAAGCTGGAAACCATCATTCTCAGCAAACACAAGAACAGAAAACCAAACACCACATGTTCTCACTCATAAGTGGGAGCTGAACAATGAAAACACATGGACACAGGGAGGGGAGCATCACACACTGGGGCCTGTCAGGGGTTGGGAGGCTAGGGGAAGGATAGCATTAGGAGAATACCTAATGTAGACGATGTGTTGATGGGTGCAGCAAATCACCATGGCACATGTATACCTATGTAACAAGCCTGCACATTCTGCATATGTATCCCAGAACTTAAAGTATATATTAAAAAAAATTGGTGGTAATACAAGCATTAATTTGCACCAGTATAGCTCTCCACCAGAAGAAACTTATCCACCTTCCCAAAATTAATATCTTTTCATTTTACTTTCAG
>TTN-201,,0,103,263898,264000,GTAAGTTAAGTATTAGACAAATGGCCATCTAAATATGAAGCTCAGAAATATTTTTACGTATCAAATCCTTGTTCTTACATTTCTTTCCTCTTGGTTCATGTAG
>TTN-201,,0,90,264001,264090,GTATGTTTTTGTGAAGGAGAAAAAAAGTTGTTTTCTTTCTAGTTTGTTACTTAATGTAGAAACTGACATCTTCCTTGTCTTCATCTCCAG
>TTN-201,,0,369,264091,264459,GTAAGTTTTGGGGTTTTTTTATTGTTGTTGTTGTTTTAGTATTATGGAGGCACATTTAAATCTCGGAGTCTAAGATTTGGACTCCAAGACACAGAGAGTAGTAGAGATCTGAAGATTACAACTCCCATTTAAGAATATGTTCTATCTCTTACAATGAAGATGACATATTAAAAAAAGAAAAGGACATATAATTTCCTTTAAAGCATACAGCAAGGACTCAAAAGTGCATACTAGTTGGACGGTTATTAAAATGGGATAATTGTCTTCCTGTTGAGCTTGTTACTTAGCAGCAGGGATGATAATGTGAAATATGGAAGTTTAAACTTCTGCTGGTAAGATAAATGGTGAGTGTACCTCTTTTTGTTTTAG
>TTN-201,,0,379,264460,264838,GTAAGATTCTGCTGAGTATTATAGGCAAAGATGTAACAGCATTCATGATGGTCATTTTTCCTAATAAAAAACTAAATATACACCTAAGGAAAAAAGGAAAATTAAAATGATGTTTTGTATATAGACACAAACATTATGATTATGGAGAATCATAATAACATGCTAAATTAAAAAGCAAGATACACAACTGTGGCAACTATATAATTTCAATAGTTATTCAATAGTGCAGTTATTATTTGTCTATTAAAAATAAACAAAATGAAATAACACTAAAATTCCATTCTTGAAAGAAGCAGCATATGAATTTCCCACTATTATTAATAAGGATTACATAATATAGCTTTGCATACATTAAGTCCTTTATCTTATTTCTTTCCAG
>TTN-201,,0,347,264839,265185,GTAACTAATAAACTTCATTGGAATCCCATATTTTACTTTGGATAATGGGATGTAAATAGGATTTACAGAATAATGTGGGAGAAGACATTCATATTCTAATGTGTATTTCCTATGCACAGAATTATTCTTATGACAGAACCACGTTTTAGAGTTAAAAAGAGCTTTAGAAATCACATATTTCAATTACCTAATTTTACAAGTGAAGAAACTAAGATTCTAAAAAATTAACTAACCTCCTAGGTCATATAGGAAATTGACAATAGAAAGACTGCAGCCCAGGTCTCCAGACCTCTACTCTATACTCATTCCCCATTCCACATATTCACTCTTCTTCCTTATTCCTTCAG
>TTN-201,,0,87,265186,265272,GTAGGAACATTTCCCGGTGGTTTTTCATTTTATTTTTTAAAATTATCTTTTAGCCTGGGAAATTAACTTTTCAATCAATTTCTGCAG
>TTN-201,,0,101,265273,265373,GTAAGTGTTCATGAACGAGTTCCATATCCTGTGTTAAAAGCAGCATTAAACACCCAGGAAGGAAGTTTTCATGAAAATTTCCTATCATTATTTATTCTCAG
>TTN-201,,0,889,265374,266262,GTAAGTATTACCAGGGGGAGTACATAAGGCTTTTCCTATTAATCATATTCTAAGAGGGAGACTAGAACTCCCTTAGGTAGATTAATTTATTAACAAGGTGTAGAGCTGGTAACTCCAAGAGTACTTTTTAGGAGAGCTGGGTGGGTACTTTACGGTATTGTGGAACAGGCAAATCAAATGCACATGATTTGTGGTTTTGAAAAGCTTTTCATATATATAAGAATTTCCTGTCTTCAAAAGACATGAAATGAGAGAATTTTATTGGAATGTAAGAATTTTATTTTAGGAATAAAGAGGCCTTTTAACTAAGTAGTGAGCTATTTACTATTCTTAGGGTTTCTGTTTTCCAATCCACCATCTCCCTAAGTATGTGACTGGTGGGCTCTCCATCTTAATTTCCCTTCTTCTTATTTCTTCTATTTGCTTATCCTCCATGATAATTTCCCCTTTATTTGAATTACTTGATATTATATGTCACCCTCCAGGTACTTTTCTTCCTACTATGAAATAATAAAGAGAGCTAGAATATGTGGCAGAATACCTTCATGGAATATAGAAAGGAAAAAACAAGAATGAAAGGGAGCCAAAAATCAATCGTCTACTTTCCTTTTAATATATGTAGCATTTCAGAGTACATAAGGCTCATGAAAGAGGAGGTACAGATCCTCCGGGGGGAAAACCTGGTTAAGCCTAAAGCATAGTGGAAAATGGAAAGATCAACAATTAGTACAGAACAGAAAAATGATTTTGAGGATTGTATTAAGGAAGTTTTAAAGAACAAGAAATCAGCTCTAGAAAATAAATGTATTTTAGGAGTGACAAGGCCAGTCCCTGGAAATACATTTGACTATTAAATTTTTATTTAACTTCTTCACCCAAAATTAAACAG
>TTN-201,,0,92,266263,266354,GTAAGTCTATTTCAAAAAAGAATCATATATATTTTAAAATAGCTTATGTATTTTTTACACATTCATTTCTTATTTACCTACTATTTATCCAG
>TTN-201,,0,90,266355,266444,GTAAGCAAATGAACCATCATCCCATCATTTTGAGTTATATCCTTCCTTTGTTATATGGGGCTTACACTTATCATTTCTCCTTTGCTTTAG
>TTN-201,,0,167,266445,266611,GTAAGGCTCTATGCACACATCTTCATTTTTCCTTTATTGTCATCGAAAGTGCACTCTTGTGTCCCACTCACTAGCTTATCTAAAAATCCGTTAAAAGCTAGAACTATTTGAAAAAGTTAATCGCCTGGCCTTAAAAATAACAGTAATTTATCTCTGCTATTTTACAG
>TTN-201,,0,90,266612,266701,GTAAGTGTCTTAAATTCAGAAGACGTAAAGCAAAACACGGTTTTGAGGAGGCTTCTTATTATAAATCTTGCATTATCTACTTTTTTCTAG
>TTN-201,,0,425,266702,267126,GTATTTTGTTTGTTCTTATCCTACAGCTTTTACATCAAGATTCCTCACAAATATTTCCCTGAGAACAGTTGAACATGTGCTTATCGATAACATTATCTGCTTATACAGAAATGTGTTTTTATTTCAGTACATATGGTTAATGTTTAATTTTATTGAAAATATCCTAATGTAATAGTTAATAAAGTATTTCTTAATTATAATATCTATTTTTGTAAGTTAAAATTGTTCACCAAAAAAGACAACAACTATGCATATTCCAAGAGGAAAAAAAAAATGGCACTATGCTTGGGTAATAAAAGTATAGATACTAGCAAGAATGACTACTTGTTCAATATATATGGATATGTATAAATAATTTGGGCAACACATATATATTGTAAAATCAAGCTGCATTTATACTTGATACATCCCTGGGTCTTTTGTAG
>TTN-201,,0,89,267127,267215,GTAAGTCATTATATGAAGAAAAACCCAGGTGCATGTTTTACATGAAGAAAACTGGTATTTGTTTGACTGGTTTTGCTTTTATGTTTTAG
>TTN-201,,0,91,267216,267306,GTAGGTCCATTTTACTTTTTATGTACTTTTTTTTTTAAAGCAAATTAAGCCTCCTTCCTTTTCTGATTAAAATGTATTTTTTTCTTTGCAG
>TTN-201,,0,91,267307,267397,GTATGTAGAGCATGTGAGGGAATTGACATGGAAACATTTATAGCAGAGTTTAGGAAATCATGGATTTCTAATAAATTTGCTTCCTTTTCAG
>TTN-201,,0,112,267398,267509,GTTAGTATTTGTCTTTTTCAACACCGTTCATTCCAGAGTGCCAATATTTTATCTAAATTACCCAAAAGCCAAACTCTGAATATATACTTTTGTGTCTTTGTTTCTTTCTCAG
>TTN-201,,0,673,267510,268182,GTATGTTTTAAGAATAAGGAAATTCTACATATCCACGTTAATTTTGCTAGAATAGTGTGAGTCATTCTAATTAGTCGTTATTTCATCTTAAATGCTTTTGGGTTCACACCCTTCACACCCCAAACTATTCATACTATGGCACAAAATGGAATCTCTAGTGAAGAGTCTTTCATTGATTAAAAAAACAGAAATTTACGTAGCTAAAATTGGATAATATATGTTGAATTTAAGTATTATTGAATCTAACTGTATATATATGTAGGTATACATGTTTATATATATATATACACAGATTATATATATATAGTATGTGTGTATGACATATATCATATGTGTGTATGTGCGTGTGTACAGAAATTGTATATAAAGTTTTTTAAAAGATTGTTCATCTTGTTCCTCTTTTTTATCCCCATGGTGAATTTGGAGTAAATTTTATCATTTAATCTGGTCATTTTACCCTTAATTTGGATTTGAATGCTATAGCATGTAATGACATAGCTTGTGGGAGCCTTGGTTGGTTCAGAAGCAAAATGGGTTATGTAAAAAGGAAGACTAAAATCAACATAAAAATATGGCCTTCATTTAAAAGTTTTCTTTTGACAATACATGAAGAGTGCACATTTAAAAGTGCTGTAATAATTATTCACTTTCTTTTGATGCTTTGTTTTCTTAG
>TTN-201,,0,105,268183,268287,GTATGTCTAATTTTGTGTAGAAGCAAAATTTGAAATTATTTGCATTGATTTATGTTAATTTTCAGAAACACTTTTTCACTTTCACTTTCTATACTCATTTTTCAG
>TTN-201,,0,92,268288,268379,GTAAGTTGTCCAACTTTTCAAAGATCCAGGTTTTCTTTTACCATAAATGTGTTATTGTCTGTACTAATCTATAGGATTTCTCTCTTTTGTAG
>TTN-201,,0,108,268380,268487,GTACGTATTTGTCATGGGAAGGGCAGTTCTGATAACAAAAATGCAAATCTTACTTCTGCGAAGCAAAATATTATAAGTGCCGCTAATCTGCTTCTCTTATTACCACAG
>TTN-201,,0,1695,268488,270182,GTAAGCATGCTTAGCACTTTGAATCAAAATTGCTATTTAACTCAGTATTTCCGCATACCTTTTCCTGGTTCTAATCCTATAGAATAACTTTTACTCTGTGCCTTAATGGGGTTTTTGGAAGAAATTATGGACTAGCTGGGAGTCTGAGGAAAATTCCTTAAATACCTTTCCAGCCCTCTTGACTTGACTGTAAAGTGAGAGATTTAGACCTCAGGATATCTATGGGCCTTTCCAACTTCAACCTTTTATGATTGATTGTATGAGTTGGTGCTTTCATTCTGTTTTAAATTATCAGAGTCAATAATTAAACCATGGTTGAGTTCCTAGAGAATATTGCTCTTAAATAAGCCACAGACTAAACAGAGACTTCATTTTTTGGTTTTTTTTTTTTTGTTTGTTTGTTTGTTTGTTTGTTTTGAGACAGAGTCTCACTCTGTCGCCCAGGCTGTAGTGCAGTGGCACGGTCTTGGTTCACTGCAACTTCCGCCTCCTGGGCTCAAACGATTCTCGTGCCTCAGTCACCTGAGTAGCTGGGATTACAGGCATGCCCCACCACACCCAGCTAATTTTTTGTATTTTTAGTAGGGACGGAGTTTCACCATGTTGGCCAGGCAGGTCTCAACCTCCTGACCTCAGGTGATCCACCCACCTCGGCCTCCCAAAGTGTTGGGATTACAGGTGTGAGCCACCATGCCTGGTCTAAACACAGACTTTGATGATGATAGTATTAGCAGCAGCTAACATTTATTGAGGAATTTTCATGAATTCTTTCCCTTAGTTCTCACAGCCCTCATATTAGCCATCTTATAGAAGGGAAACTGAGGCTGAGAGTGCTTTTGTAACTTCCCCGTTAGGGATGGAGTGGGAATTCAGACAGACAGACTTCAGAGCCCTCTCTATCATGGTTAGTCCAAAATGCGTATTCTTCACCATTCTGGAAAATAAGTGGCACATTCAACTCAACAATGTTTTGAAAATTAAAACGTCATGAGAGTCAGGTATCCTGTGACACTTTACCTAAAAGATCTCCATTTGCTAAGAGAAAATTGAGCCACTGTAGTGTCTGGGCAAAAGTATCCACTTCCATCTTCATGCTGAGAATCTCAGGGCTGTTCATTATTTATGAATCAGGCTTTGTGGATACTGAATCAGTGTTTATGAGAGTATAAAGCAAGTCGAATTTAGTTATCTTTCTTGATAATTCCAAACAGCATGGCAGAAAATCTGTCCAGTAATTATGTAGCTCTGTGGGTAGAGAATTCAGACTTTAAGTGTCTGACATGAACCATCCACACTTGGATATCAGTGAACTGGGATGGGAAAAGAAAAAGAATAGGAGGTGCGTAGAAGAAAAGGAAAGAAAAGCTAAAGTGAAAGGAAATGTTTTAACAGCTTCTTCCATGATGTTCTCACTACCATATCCCATTTCTTCACTGGAATAAAGCAACTAATGGACTTTAAAACACATGTAAAAGGTGCTTAAGTCCCTGCACAACTCACAGTCTTTCTACCCCATCTGAGATAGAAGAGTGGCCTATAAATTTTTAATTTTTAAATAATAATTGCATAGAATTATAATGATGGTGTGTGTGTATAATTTAATAATGGCCAATGACCTTACTTTAAGGTTGGTGCAACTATTTTTTTTTCCATCCTTATAATATTTTAAATATTTCTCATCTGTTTTTCTTGCAG
>TTN-201,,0,112,270183,270294,GTAGGTGCTGAATACAGACCACTGTCATATTACATTTGCCTAAAGCTTAGTAATTTTGAACAAGTAGGCTTTAAAGAAGTACTAACATCGTGTTTTGTCCTTTCACTGATAG
>TTN-201,,0,236,270295,270530,GTGAGACATGATTTCATTAGAAAACTGAAACGTGAAAAATTTAAAAATAAACTACGCTAACCTGTGCATATGCTTTAATTTTCTTTTATATAACACCTGTCTCATTACCATCCTTTTCACAAGGTGAAAAATATAAAAAATAAAACCAATGTTCTTGGAAAGAATGCGAACATCAAAGGTATAATTTATCAGTAATGTGGATTCTTGTACCTTGTTTTCCCTTCCTTTCTAAATAG
>TTN-201,,0,106,270531,270636,GTAAGTGCTCATACCTGCAGCATCTTCACCTGTGTCTTCTATATTCACCTGTGTGACTAAATTGTACATGATTGTGTAATTATTTTATTGTGAATGGCCATTCCAG
>TTN-201,,0,105,270637,270741,GTATGTACCTACTGGTTTGATTATGTTTTTTAATAAGCATACTTCCAGGAAATCACTCTTTTTTGCTTTTAAAATTCACTGTATGTATCCATTTTATGTCTACAG
>TTN-201,,0,369,270742,271110,GTAAGTGATTATTATTCAAATACATTTAGTTTAGCAATTGAACATATTAGAAACAAATATATCAAGGAATGCTTTTCTTCTCTGCATCACCTTCTTACATATCTTCTTGTCACTAGAGAACTGGTCATGTAAAGCAAGAGGAATTATTTTAAGTCAGTCTAATAAACTAATTTGAAGTTCATTTTAAAGACTATGAAATGGAAAGTTGAAATTAATGACCAATATGAGTTTGGGAGATTGAATAAATTACTTATTATAAAAATTTTACTTATTTATTAAAATTATAGAATAATTGTATTGTTCTTCCATGGATGATTAAGACCTGGTTACAAATGTAATGATGCATTTACCTTCCTTATAATTTTTTAG
>TTN-201,,0,693,271111,271803,GTAAGCATTTACAACTTATTTCCAATGAGACTAAGAGCATTCACATTTTTAAAAAACACATTTGGCCCCTGGCCTGTAAAATGGTAACAGAAACAAATTACCCAAGGTTGCTAAGTGGATGAATTATGTCTTTCTACCTTTCAGATGAAAAGAAGAAAAAAATAATTGGCATCAATTATTTTTTCTATTATTTCACTCCATTCCCATATAAAGAGCATGCAGCAAGTGGGAATGAGTTTTTAGCTTTGTAATTTTCGCCACTTAACAGTACATAAAGAAAAGGTTCTCGAGAATAAGTGTCCATCTTTACTGAAGTTATTAAAATACAACATACATCCAACAACACAATCATCCCCTTGCTTGAATGCAGCTGATGGCCTCTTAAAAGAACTTGTGTGACTGTGCAGCAGTATTAGGAAGTACATGATCTGTAAATGTTTCACTTTCCTTTTTACAAAGAGCAATGCAAAATTAAAAACATGACAGGCATTACAAAGGGAATAATAATAGGCAAATATTTAACCCCATAGTCCAAATTCTCAATTATCAATCCTACTTTCAAAATAGGCTTTGGTAGCACAGTAGAAGTCACTACTCTTCCTGGCCTTGTGATATGGCACTACTGAAAAATATATATTTATGTATGTCTTTATTAAGCCAAACTAATACATAGTATTTCTCTTTCTTTTATAG
>TTN-201,,0,116,271804,271919,GTACTTTTAAAATAGCTTCTTAATGCTACAATTTATGAACTTGGATTAGAGACATGCCTAGTTGTATTTTAATGGACAAGGAAAAAGAAACTAACTCTAGAAACTTTTTCTTATAG
>TTN-201,,0,96,271920,272015,GTAAGTTTGCGTTTTTACTAAGCGGTACTATGTCAAAAGTTTAACCTTCCAAGCAAATGCATCTAATTGATTTGGGGTTTTGTTTTTGTTTTACAG
>TTN-201,,0,101,272016,272116,GTAAGAAAAATAAAAATCCTATTTCAAAGTCTCTATTATTAAATGTTTCCCCTGAATTTTATAAAATTGTATTCATACTTAATACCTTTGTTTATATTTAG
>TTN-201,,0,97,272117,272213,GTATGTATCACAATTTAAGGGCATATTTGTTTATTATTACTGATTCTAGTAGAACTCAGAGTGGTATATTTTAACCTTATTTTTGCATCCCTTCCAG
>TTN-201,,0,97,272214,272310,GTAGGAAATAGTCAACATTCTCCTTTTTAAAATTATCTCAATTTATGTGAAAATAAACTCTCAGATATTCATTCATATCTGTTTTGCCTACTGACAG
>TTN-201,,0,95,272311,272405,GTAAGCATGTCAAATGTTCTCACATTTATATAGCATTTTCCAGTGTGGGCAGAAAGAATGATCTTCATCATGGCTTGTCATTACACCTGTTTCAG
>TTN-201,,0,126,272406,272531,GTAAGTATTAACACTTTTAAATAATTTGACAGTTGAAATGTAATAGAATCAGGGGGAGAAGGGAGAAGGGCAGTCTTATCAATAGTAATTTTGTGCAATTCTCATCATCCTTATTTTCATAAACAG
>TTN-201,,0,881,272532,273412,GTGAGCTCCAAGAATCATACATAAATACAATGCTCCTCAAAACTATATGACAGATAATTTTCCAACACACAATCTCTAAGAATTTTTAGAATTTATGAATGGTCTAGAAAAGCACATGCTTATTTGCATGATCATAAATATAGCTTAAGTCAGAGAACATTTTAACTATTACATCTGTTAAGTTAGCAATTAGAATTGCTAAAAGTTGTACAGCATTTTCCAATTAATGAAAAAATATTCTATCAATATGAAAAGAATCTATTTTATAAATTTTCCTTAGAGAAAAATGCATTGTACTGTAATAACTGAAAAGAAAAATGGCAAAACTCCTTTTAAGAAGAGGTTTAGCAGGAACATACAGTTTCTAGTGGTTTCATAAGTTACTGACAAAGTAATTGTGACAAGAGCTTCAAAAATAAGTGGCAAATCCTTTTACAGAGTCTGAGCCCAAGAACTATAAAGGAATAGTCACTGGGACTGAATTGGGGAAGCTAAGGAAACCAATTCTTGTATTCATTAGAAATGTATTGGTGGCAAGTGATACTAACCCAGTGAAAGATAAGCAACTAAAGAAAAGTCCCTAAGAATGGGTACTTTAAGTAATGAGCTTAGCTAATAGAGAACACACAGTAAAGCTGGCCAAAGAAGTAGGGAAGAAATATCTACTTTCCTAAAGCAATTTAATTCTTAAGATAATAATATTAAATTATAATGTGGCACTCTGTGCTGTCCTATAATATCAGGAGCCCAGTTAATAAAGATTATCTTGGTGAGTGTGGACAAGAGCAATAATGCCTTTGTGAGTCTTGAAAACAAAAAATACAAATCTCAACATTTCCTTATTTGCCTAATATCTGCATCTCACTTTTTAAATTCCACAG
>TTN-201,,0,85,273413,273497,GTATTTATCACAGAAGCTTTTAGGTGAATTATTTTCTTCTCACACCTGTCCATGAATTAATTAAATTTTGTCATTAACTTTCCAG
>TTN-201,,0,171,273498,273668,GTAAGCATTTTACTTAAAATTGGCTATACAATGAGTAGATCCTCTAAAACAATATAGCTTGACCTATGATTGATCACCTCTCTAGAAAGGAACTATGTTGATTATATTTCCCCAAGAAAAAAAAAGCTATCAGGCAAATAGGAAATATGAATCTTTCATTCTGTTTTTCAG
>TTN-201,,0,119,273669,273787,GTATGTACCAAATAGCCAAAAAAAAAAAAAAAGTAAAGTAAAATGAAAACATTCAGAATTCGTAACAATTTACCATAAAAATAATGCTTAAGAATAAATGCCTGATTTCTTTCCCATAG
>TTN-201,,0,98,273788,273885,GTAAGGATGTGTGACAAAGATACAAGCAAGTTGATGTTCAGTCACCCAATTTTGATTTGAAGTAAAAATTAATTTCCTGTATTTCTTCTCTTTCATAG
>TTN-201,,0,679,273886,274564,GTAAGTCCACAGGCCCTTCCACCACTCTCCCCACCTCTGATTCTGAATGTTAACAAAAAAGAATTTGTTTTTAATATGCCCTAATGTAAATAAAAATAGGTCACAAAATTAACCCTGTGGTCTTTCTAAGGTTTCTAAACCTCCTTTTCTCAGGTTTCTAAACCTCCTTTTCTCAGAGGTTTTCAACACACTTAGGCTTGATTTTTTTTTTAATATCTTCACTCTTATGAAAGAGAAGAGGAGGGAGTTAGGAAGAAAGGAATGGAAGGAAGAAAAGAGAGAAGGGAAGGAGGAAGAGAGGAAAGGAAGGAGGACTGGCAATGTTATAGTGAGAAAAAAATACAGAGTGCATGCTTAATAAATGTAGAATTGAAGAAAATGAGGAACAGCAAGGAAAGTACAAAATTAAACCTCAGCATCATGCAATATACCCATGTAACAAACTGCACATGTACCCCTGAAGCTAAAAGTCAAAAATTTTTAATAAAAATAATTAAATAATTAAATGATTTAAATTAAAATTTACAAATAGTACAAAAGTGAAACTATTGGAAAAATAGTCATGTGCCTTATGTACCTTTTAAAATACCAACCAAAACCTAAGGAAAACACAAATATATGAGTCATTGTTTTAACGTATTCATATTGCCATATCGTGTTAACCTCTGTCTTGCTGCAG
>TTN-201,,0,911,274565,275475,GTAAGGACATTTTGTATCAGTCAAATTGATTGAGTTACAATTTATATGTGGGAAAATTCACCTTTTTGAAATATATAGTTCTATGACTTTTGAAAAATGTACTGTTTTGTAATCACCACCACAATCAAAATGTGGAATATTTTTATTACCCCGTAAAGTTCCCTTGTGTCCGTTTGTAATCAGTCCCTTCCCCACCCCAGCTGCTAGCGATTTCTGGCAAATAATTTTTAATATTCTTCTCTGGAGTCAATTTCCACTTCTTTAAGATGAGATTCATAATATATGCTTTCTATCACACTTAAAATTTTAAAACAAGTTAATATTTCTGGAAGCACTTTAAAAACTGCTGATAAATGTAAGATAATAATAGTGATTACAAATGAAGCACATTTAAGAGAAAGGAAAGTGAAAAAATGTTAAGTATTTTTAGCTGATAAAATGAATAAAATTTTCTTTTTTCTTTCTTTTGTTTTTTTGTGTTTTTTTGAGACAGAGTCTCACTCTGTCACCCAGGCTGGAGTGCAGTGGCATGATCTTGGCTCACTGCAACCTCTGTCTCCCAGGTTCAAGCAATTCTTCTGCCTCAGCCTCCTGAGTAGCTGGGATTACAGGTGCCTGCCACCACGCATGGCTAATTTTTATGTTTTTAGTAGAGACGCGGTTTCACCATGTTGGCCAGGCTGGTCTTGAACTAACTCCTGACCTCAAGTATCTGCCCACCTTGGCCTCCCAACTTGCTGTGATTACAGGCATGAGCCACCACACCCAGCCATGAATAAAATTTTCACAAGACAAAAAAACAGGCTAATGTTAACAGTCCGTTTCAACAACTCATTGAATTTGTTAGGTGGCACAGCTAATTTTCAACTTTGCAGCAACTTTAACCAGTATATTCTTATTCTTATTCTCAG
>TTN-201,,0,101,275476,275576,GTGAGACATATGATCATTTGCTTTCTGCAATAATTGCCATAGACTTATTTCTTAGTCCCCCTACCCCAAATGCTAAATTGAAACCCTACCTTTTTTTCCAG
>TTN-201,,0,130,275577,275706,GTAAGTGCCCTTTCAACCACAAAATTATAAACATTATTTCAGCACTTTTCTGTTTTTAAATGAAAGTCATTGGCTTATAATACTTGGGACTGTATTCTAATACATGTGTGCTTTCCACTTATATTTACAG
>TTN-201,,0,106,275707,275812,GTAAGGAATTCAGAAGAAGGGGTTAAATTAAAGAAGCAAGCCATGTTTGGTCCTTTTATTTCACCAGTAAAGCTGACTCCCTTTTCATTATTTTAAAATATTTCAG
>TTN-201,,0,622,275813,276434,GTAAGTAGCCTTTGGTTCTCTACTTATGATTTACAAACTAAACAAGTTAAGGCTAATTCCCCCTCTATACTAAGTAGAACCCTGGAAAGCTTTATTGGAGAGCAAGTGTTAAGAAAGAAAAGCAAGTACACACACAGGAAATATGACAAGTTCTACAGGAAACCATTCCAAGCACACAACCTCAGCAGATGTTAGATGGAGTGAACTGAGCACTTTCCTTGAGTAATTCCCTCTAATGCAATGGTTTCTTTTTAAAAATATTTCCCAACAAGATTTGAAAGGTCAACAATTGTATGCCACTTCAATGAACCTAAGTAAGGGCAAGAATACTACAGAATTATAGAGAGAATTTACAGTCCCTTAAAAGCCTATACATTATTAATCCCCTTCCAATCATAAAGAGAAAAAAACACTCTACATAAAATGTGACGATGTGCTCATTGAATCCCTATTTACCATATGATCCTAGGAAAATCACTTCAAAGAGTTTTTAAGAATTAGGCTAATATGTAAATCATGGTATGTGTCAGTAAATAAGGTAAATTCATTCCTGATATACAAGGACAAAGGATTACAGATTGAGTATTAACAGTCACTTAATATTATCTTTCATATTGTTCAG
>TTN-201,,0,98,276435,276532,GTATTTTATTTTTATTTTCAGTGCTTTTTATTTTTAAAGAAAAAAAAATCTCAAAAACACACTATGAAAACCACCACAATTGTATTTTCCCCCAACAG
>TTN-201,,0,362,276533,276894,GTGAGTACAACTTGATTTCTGTATCTTCCTATGGTAAAGTTCCATCTTTGCATAAAATTCTTTTAAACAGAAAGAAATTTTGAAAGGAAATAGCAAAGATTCAGATAAAGTACAAGTGCCTTTTCTTTCACTTTAATTGAATGTTTGCATATCTAAAAGGAGAAATATATATCCTAACCCCATTGTAAAAATAGAACTTTGGTTTTTGATATGTCTTAGTATAAAGTAACCAATTTCATCTTTCTGGAATAGCTATTTTTTAACAAAATTTTGGACTCATATAACATTCTTTTTTAAAAAAATAAGCTTTAATAAAGCTGCCTGTTTCATCTCATGACTCAAATCTTTTTTTTGTTTAATAG
>TTN-201,,0,132,276895,277026,GTAAAAATAAATAAATTATCATCAAGTTGAGGCTAAATGAGTTATTAACTTGGGGGTGGAGGCTATTGCACTTAAACACATACTGTTAGATGTTGCTAAATTATATTCTTTTTTTTTTTTTTTCTGATACAG
>TTN-201,,0,124,277027,277150,GTAACCAGTTCTTAAATGTCTCTTTCTTTTATCTTCTAAAATATTTTATCTTCTAAATTCAGCTTCCCAAAAAAAGCTTAAAATGAAATCACTTTTTAAAACACAAATCATTTGCATTCTACAG
>TTN-201,,0,740,277151,277890,GTAGGTTGGCTTTTGTTTTTACCCACATTTCTTCAGAAGATAATATTAGGGAAATATTTTCAAACATCCCCCCTTATATACACATACAAGAAAGTATTAAAATAAAATTATTTTCCTAATTCCAGAATACAATTTGTACACCAAAGCAGAAACACACATTTGAAGTTAGCATATGCTTTTCTATGAGCATAAAAAGCAGTTATTAAGTACCTAGTTATATGTGGTATTATATAAGATTCCATAGTGTCAGCCCCTGCTCCCAGGAATATTTAAGAATAAAGTCAGTGAATATACAAAATGGCACTACTTGCCTAAACCTTCACAGTTGCTAATTTTCCAAAGCAGTGCAAAGTTAATTAAAGAACTATTTCTATTTTACCAATTAAAATTAGTTTGCTTTCATTTCAATCTTCTGAAAGATAATTTAATGTTTTGGTTACTCAAAATCTCCCAAATCCACTTATCTCCTAAATCCGTTGACTATTCTTTTCAAGACTTTTTTCCTTAAGTCATATGAATCATCTTTGGCTCAGTTTAGTTTAAGGAATCATTACAGTGATCTCAAAAGTCACACATGATAATTTTCCAAAAGTGGAACTGAGAAAGTATTAGGTATTACCTACATTGCATGAAGAAGTTGACTTTTTTTCTTTTTATGTTTTTCACACGCAGAATCTAGAAGAGTAAAAGGTGGGGGTCTCTTTCTAATTAAGTTTGCCTTACAGAGGTTTCTTTTTTAG
>TTN-201,,0,100,277891,277990,GTAAGTTTAATTATGAATATATTATTGAAGAAAAACTAAAATACCATGTCTTCCACATCTGAAGAACTTCAACATTTCTTTTCTTTTTCCTTTGTCTTAG
>TTN-201,,0,525,277991,278515,GTAAGTATCTCCTCACCCTTCTTCCTTACATGTTTAAGGCCTTTAGATCGTTTTTTTGCCTCTCTTTCAAGCACAGAAAACTCTAAGAAGCCTTATTAAATTCCATGTGAAAGAGGGACAGCCAACTGATGTGAATTCATTCTTGTAGTCAAACTTTCTTTATAGCTACACAGAAACTTGGATAGATTACATTTCAAAGTAAAGCTACCAACTGCCGTGTAACATTTATTTGCAGGATGCACAATATGTCAATTACTTTCTATATGACTAATCATTTTTCTCCTAGTGATTCCTAGCACCTGCATGTAATGTAATGATAGAAATATAAGGATTCATGTTTTGGAGACATTGAGCTAGCTCTTGACAAATGTATGTATATATGTATTTGCTTATGCTTCAACAGCAAATTGTTTGGGTTATGCTGCTGTGTGTGTGTTGAAGTTTCCATTTCTGTAAGTCAGCGTCATATGTCATCAATTAACCAGATGTCATTGATGTTCACTGTGTATCTGCTATGCTCCACAG
>TTN-201,,0,138,278516,278653,GTGAGCAATAAAATTACTGGTAGAGGTAGACAAGCCAAGTAACATGGTGTAGTCTTTAGTACACACAATTCAGTAGAAAGCAAATCTTTATTTTTTTCAGTGATTCTAAGACCTTTTTTTTGTCATTGTTCCATAAAG
>TTN-203,ENSE00003809141,1,91,278654,278744,ATGACAACTCAAGCACCGACGTTTACGCAGCCGTTACAAAGCGTTGTGGTACTGGAGGGTAGTACCGCAACCTTTGAGGCTCACATTAGTG
>TTN-203,ENSE00003807606,1,204,278745,278948,GTTTTCCAGTTCCTGAGGTGAGCTGGTTTAGGGATGGCCAGGTGATTTCCACTTCCACTCTGCCCGGCGTGCAGATCTCCTTTAGCGATGGCCGCGCTAAACTGACGATCCCCGCCGTGACTAAAGCCAACAGTGGACGATATTCCCTGAAAGCCACCAATGGATCTGGACAAGCGACTAGTACTGCTGAGCTTCTCGTGAAAG
>TTN-203,ENSE00003810976,1,288,278949,279236,CTGAGACAGCACCACCCAACTTCGTTCAACGACTGCAGAGCATGACCGTGAGACAAGGAAGCCAAGTGAGACTCCAAGTGAGAGTGACTGGAATCCCTACACCTGTGGTGAAGTTCTACCGGGATGGAGCCGAAATCCAGAGCTCCCTTGATTTCCAAATTTCACAAGAAGGCGACCTCTACAGCTTACTGATTGCAGAAGCATACCCTGAGGACTCAGGGACCTATTCAGTAAATGCCACCAATAGCGTTGGAAGAGCTACTTCGACTGCTGAATTACTGGTTCAAG
>TTN-203,ENSE00003809662,1,86,279237,279322,GTGAAGAAGAAGTACCTGCTAAAAAGACAAAGACAATTGTTTCGACTGCTCAGATCTCAGAATCAAGACAAACCCGAATTGAAAAG
>TTN-203,ENSE00003809782,1,245,279323,279567,AAGATTGAAGCCCACTTTGATGCCAGATCAATTGCAACAGTTGAGATGGTCATAGATGGTGCCGCTGGGCAACAGCTGCCACATAAAACACCTCCCAGGATTCCTCCGAAGCCAAAGTCAAGATCCCCAACACCACCGTCTATTGCTGCCAAAGCACAGCTGGCTCGGCAGCAGTCCCCATCGCCCATAAGACACTCCCCTTCCCCGGTCAGACACGTGCGGGCACCGACCCCATCTCCGGTCAG
>TTN-203,ENSE00003805863,1,331,279568,279898,GTCCGTGTCTCCAGCAGCAAGAATCTCCACATCCCCCATCAGGTCTGTTAGGTCTCCATTGCTCATGCGTAAGACTCAGGCATCCACCGTGGCCACAGGTCCTGAAGTGCCTCCCCCTTGGAAGCAAGAGGGCTACGTGGCCTCCTCATCTGAGGCTGAGATGAGAGAGACAACGCTGACAACCTCTACTCAGATCAGGACAGAAGAGAGATGGGAAGGGAGATACGGTGTCCAGGAGCAAGTGACCATCAGTGGTGCTGCGGGTGCTGCCGCCAGTGTGTCGGCCAGTGCTAGCTACGCAGCAGAGGCTGTTGCCACTGGTGCTAAAGAG
>TTN-203,ENSE00003803639,1,153,279899,280051,GTGAAACAAGATGCTGACAAAAGTGCAGCTGTTGCGACTGTTGTTGCTGCCGTTGATATGGCCAGAGTGAGAGAACCAGTGATCAGCGCTGTAGAGCAGACTGCTCAGAGGACAACCACGACTGCTGTGCACATCCAACCTGCTCAAGAACAG
>TTN-203,ENSE00003810843,1,138,280052,280189,GTAAGAAAGGAAGCGGAGAAGACTGCTGTAACTAAGGTAGTAGTGGCCGCCGATAAAGCCAAGGAACAAGAATTAAAATCAAGAACCAAAGAAGTAATTACCACAAAGCAAGAGCAGATGCACGTAACTCATGAGCAG
>TTN-203,ENSE00003803899,1,126,280190,280315,ATAAGAAAAGAAACTGAAAAAACATTTGTACCAAAGGTAGTAATTTCCGCAGCTAAAGCCAAAGAACAAGAAACTAGAATTTCTGAAGAAATTACTAAGAAACAGAAACAAGTAACTCAAGAAGCA
>TTN-203,ENSE00003809802,1,138,280316,280453,ATAATGAAGGAAACTAGGAAAACAGTTGTACCTAAAGTCATAGTTGCCACACCCAAAGTCAAAGAACAAGATTTAGTATCAAGAGGTAGAGAAGGCATTACTACCAAAAGAGAACAAGTGCAAATAACTCAGGAGAAG
>TTN-203,ENSE00003805623,1,138,280454,280591,ATGAGAAAGGAAGCCGAGAAAACTGCCTTGTCTACAATAGCAGTTGCTACTGCTAAAGCCAAAGAACAAGAAACAATACTGAGAACTAGAGAAACTATGGCTACTAGACAAGAACAAATCCAAGTTACCCATGGAAAG
>TTN-203,ENSE00003801659,1,294,280592,280885,GTGGACGTTGGAAAAAAGGCTGAAGCTGTAGCAACAGTTGTTGCTGCAGTAGACCAGGCCCGAGTCAGAGAGCCCAGAGAGCCTGGGCATCTTGAAGAATCCTATGCTCAGCAGACCACTTTGGAGTACGGATATAAGGAACGCATTTCCGCCGCAAAGGTAGCTGAGCCTCCCCAACGTCCAGCCTCAGAACCCCACGTTGTCCCTAAAGCAGTCAAGCCTAGAGTAATCCAGGCTCCTTCTGAGACTCATATCAAAACTACTGATCAAAAGGGAATGCACATATCATCACAG
>TTN-203,ENSE00003804455,1,123,280886,281008,ATCAAGAAAACTACAGATCTAACAACGGAAAGATTAGTCCATGTGGATAAACGCCCCCGCACAGCTAGCCCTCACTTTACTGTTTCAAAAATTTCTGTTCCTAAGACAGAACATGGATATGAG
>TTN-203,ENSE00003810306,1,282,281009,281290,GCATCAATAGCCGGTAGTGCTATTGCCACATTACAAAAAGAGTTGTCAGCCACATCTTCTGCTCAGAAGATCACCAAATCGGTGAAGGCTCCTACTGTGAAGCCCAGTGAGACTAGAGTAAGGGCAGAGCCCACACCCTTGCCACAGTTCCCCTTCGCTGACACACCAGATACTTACAAGAGTGAAGCTGGCGTTGAGGTGAAAAAGGAAGTAGGGGTGAGCATCACTGGCACCACCGTCCGTGAAGAGCGCTTTGAAGTACTGCACGGACGCGAAGCCAAG
>TTN-203,ENSE00003805296,1,66,281291,281356,GTAACAGAAACAGCAAGAGTACCAGCACCTGTTGAAATTCCTGTTACTCCACCAACTTTGGTCTCG
>TTN-203,ENSE00003806123,1,259,281357,281615,GGCTTAAAAAATGTGACTGTCATAGAAGGTGAATCTGTCACCTTGGAGTGCCACATCTCTGGATACCCATCCCCGACAGTGACATGGTACAGGGAAGACTACCAAATCGAAAGTTCCATTGACTTCCAGATAACCTTCCAGAGTGGAATTGCTCGTCTTATGATTCGCGAAGCATTTGCGGAAGACAGCGGGCGATTTACTTGCAGTGCTGTAAATGAGGCTGGAACCGTCAGCACATCCTGCTATCTGGCTGTGCAGG
>TTN-203,ENSE00003808554,1,64,281616,281679,TGTCAGAAGAATTTGAAAAGGAAACCACAGCCGTGACTGAGAAATTTACTACAGAAGAGAAACG
>TTN-203,ENSE00003804962,1,216,281680,281895,CTTTGTTGAGTCAAGAGATGTGGTTATGACTGATACTAGCCTCACAGAGGAACAAGCAGGGCCTGGAGAACCTGCCGCGCCTTACTTTATTACAAAACCAGTGGTCCAGAAACTGGTGGAAGGTGGGAGCGTGGTGTTTGGATGCCAAGTTGGCGGCAACCCAAAGCCCCATGTATACTGGAAAAAATCTGGTGTTCCTCTAACCACTGGATACAG
>TTN-203,ENSE00003804165,1,143,281896,282038,ATACAAAGTGAGTTACAACAAACAAACCGGTGAATGCAAGCTGGTGATTTCTATGACTTTTGCTGATGATGCTGGAGAATACACTATTGTTGTTCGCAATAAGCATGGAGAAACTTCTGCATCTGCTTCCTTGCTTGAAGAAG
>TTN-203,ENSE00003802603,1,206,282039,282244,CTGATTATGAGTTACTGATGAAGTCCCAGCAAGAAATGCTTTATCAGACACAAGTGACTGCATTTGTTCAAGAACCTAAAGTTGGAGAAACAGCACCTGGATTTGTATACTCTGAGTATGAAAAAGAGTATGAAAAAGAACAAGCCTTAATTAGGAAGAAAATGGCCAAAGATACTGTAGTGGTCAGAACTTATGTAGAAGATCAG
>TTN-203,ENSE00003807963,1,234,282245,282478,GAATTCCATATTTCTTCCTTTGAAGAGAGACTTATTAAAGAAATTGAATATAGAATAATAAAGACTACATTAGAAGAACTTCTTGAAGAAGATGGAGAAGAAAAGATGGCAGTTGACATTTCTGAATCTGAAGCTGTTGAATCAGGATTTGATTCAAGAATCAAGAATTATAGAATTCTTGAGGGGATGGGTGTCACTTTTCATTGCAAGATGTCTGGATATCCATTACCAAAG
>TTN-203,ENSE00003808968,1,245,282479,282723,ATTGCTTGGTACAAAGATGGCAAGCGCATCAAACATGGAGAAAGATACCAAATGGACTTTCTACAAGATGGCAGAGCTAGTCTGCGTATACCTGTTGTTCTTCCAGAAGATGAAGGAATCTACACTGCATTTGCCAGCAATATTAAAGGAAATGCAATTTGCTCAGGGAAATTGTATGTGGAGCCTGCTGCACCACTTGGAGCTCCGACTTACATTCCCACACTAGAGCCAGTGAGCAGAATCAG
>TTN-203,ENSE00003802614,1,272,282724,282995,ATCTCTCTCTCCACGTTCAGTGAGCAGGTCTCCTATACGCATGTCTCCTGCACGGATGTCACCTGCAAGGATGTCTCCTGCACGGATGTCCCCTGCAAGAATGTCCCCTGGACGTAGGCTGGAGGAGACAGATGAGTCACAACTTGAGAGACTATATAAACCAGTCTTTGTGTTAAAACCTGTTTCTTTCAAATGTTTAGAAGGGCAAACTGCCAGATTTGACTTAAAGGTTGTTGGTAGACCTATGCCAGAGACGTTCTGGTTTCATGATG
>TTN-203,ENSE00003811446,1,165,282996,283160,GCCAGCAAATTGTCAATGACTATACCCATAAAGTAGTCATTAAAGAAGATGGTACTCAATCACTAATTATTGTCCCTGCCACACCCAGTGATTCTGGGGAATGGACTGTGGTTGCCCAAAACAGGGCAGGCAGATCTTCAATTTCAGTGATTTTAACTGTGGAAG
>TTN-203,ENSE00003805710,1,169,283161,283329,CTGTGGAACATCAGGTAAAACCGATGTTTGTAGAAAAACTGAAAAATGTCAATATAAAGGAAGGTTCCCGACTTGAAATGAAAGTCAGAGCTACGGGTAACCCCAACCCTGACATTGTATGGTTGAAAAACAGTGACATCATTGTGCCTCATAAATATCCCAAAATCAG
>TTN-203,ENSE00003809358,1,1694,283330,285023,AATTGAAGGAACCAAGGGAGAAGCTGCCCTTAAAATCGATTCCACTGTCAGCCAAGATTCTGCCTGGTATACTGCGACTGCTATTAATAAAGCTGGCAGAGACACTACAAGATGCAAAGTAAATGTTGAAGTTGAGTTTGCAGAGCCTGAGCCAGAGAGAAAGTTAATCATCCCACGGGGGACATATAGAGCAAAGGAGATTGCAGCCCCAGAACTGGAGCCCCTCCATTTGCGATATGGCCAAGAGCAATGGGAAGAAGGTGATCTCTATGACAAAGAGAAACAACAGAAACCATTTTTCAAGAAAAAACTCACTTCCTTAAGACTTAAGCGCTTTGGGCCTGCCCACTTTGAATGCAGGCTAACACCCATTGGTGACCCAACGATGGTGGTGGAGTGGCTCCATGATGGAAAGCCACTTGAAGCAGCCAACAGGCTCCGTATGATCAATGAATTTGGGTACTGCAGCCTTGATTATGGCGTTGCATATTCTAGAGACAGTGGTATCATTACTTGCAGAGCCACTAACAAATATGGAACAGATCACACATCTGCTACCCTTATTGTTAAAGATGAGAAAAGTCTTGTGGAAGAATCCCAATTGCCTGAGGGGAGGAAAGGCTTACAGAGAATTGAAGAATTAGAGAGAATGGCTCATGAAGGTGCACTTACAGGTGTAACAACAGATCAGAAAGAAAAGCAAAAGCCAGACATTGTCTTGTACCCAGAGCCAGTTAGAGTACTTGAAGGGGAGACTGCAAGGTTCCGCTGCAGGGTAACAGGCTACCCTCAGCCCAAAGTCAACTGGTACCTCAATGGACAGCTCATCCGCAAAAGCAAAAGGTTCAGAGTTCGCTATGATGGTATCCATTACCTGGACATCGTGGACTGCAAATCATATGACACAGGTGAAGTGAAGGTCACCGCGGAAAATCCTGAAGGTGTGATAGAGCATAAAGTGAAGCTTGAGATTCAACAGAGGGAAGATTTTAGGTCTGTCCTTAGGAGAGCTCCTGAACCAAGGCCTGAGTTTCACGTACATGAACCAGGAAAGCTTCAGTTTGAAGTACAAAAAGTGGATAGACCTGTTGACACCACTGAAACCAAAGAAGTTGTGAAGTTGAAAAGGGCTGAAAGAATTACCCATGAAAAAGTGCCTGAAGAGTCGGAAGAGCTGCGCAGTAAATTCAAGCGCAGAACAGAAGAGGGCTATTATGAAGCCATTACCGCTGTGGAGCTCAAGTCTCGAAAGAAGGATGAATCCTATGAGGAACTCCTCAGGAAGACAAAAGATGAACTTCTCCACTGGACCAAAGAGTTAACTGAAGAGGAAAAGAAAGCTCTTGCCGAAGAAGGCAAAATCACGATTCCAACTTTTAAACCTGACAAGATTGAACTAAGTCCTAGTATGGAGGCTCCAAAAATCTTCGAAAGAATCCAGAGCCAAACAGTGGGCCAAGGATCTGATGCACACTTCCGGGTCAGAGTCGTGGGGAAACCAGACCCCGAATGTGAATGGTACAAAAATGGTGTCAAAATTGAACGGTCTGACCGGATCTACTGGTACTGGCCCGAAGACAATGTTTGTGAATTGGTCATAAGAGATGTGACTGCTGAGGACTCTGCCAGCATCATGGTAAAAGCCATCAACATAGCTGGAGAAACCTCCAGTCACGCATTCTTACTTGTCCAAG
>TTN-203,ENSE00003809440,1,282,285024,285305,CCAAGCAATTGATCACTTTCACACAGGAATTACAAGATGTTGTTGCTAAGGAAAAAGACACTATGGCAACCTTTGAATGTGAAACTTCAGAACCATTTGTCAAAGTGAAATGGTATAAAGATGGTATGGAGGTTCATGAGGGAGATAAATACAGGATGCACTCTGACAGAAAGGTTCACTTCCTCTCCATACTGACCATTGATACGTCTGATGCTGAAGATTACAGCTGTGTACTTGTGGAAGATGAAAATGTCAAAACGACTGCTAAACTTATTGTTGAAG
>TTN-203,ENSE00003802960,1,267,285306,285572,GTGCAGTTGTTGAGTTTGTGAAAGAACTTCAGGACATAGAAGTTCCAGAATCATATTCAGGAGAATTAGAGTGCATTGTATCCCCAGAAAATATAGAAGGAAAATGGTATCATAATGATGTGGAGCTTAAATCCAATGGCAAATATACAATTACATCTCGTCGTGGACGTCAGAACCTCACGGTCAAGGATGTAACCAAGGAGGACCAGGGAGAATACAGCTTTGTCATCGACGGGAAAAAGACAACCTGTAAATTAAAGATGAAAC
>TTN-203,ENSE00003804241,1,273,285573,285845,CCCGCCCCATTGCTATCCTACAAGGACTTAGTGACCAAAAAGTCTGTGAGGGTGACATTGTTCAGCTTGAAGTTAAAGTCTCCTTGGAAAGTGTGGAAGGCGTCTGGATGAAAGACGGCCAAGAAGTGCAGCCCAGTGACAGGGTTCACATTGTGATAGACAAACAATCTCATATGCTGCTCATTGAAGACATGACTAAGGAAGATGCTGGAAATTACTCTTTCACCATTCCAGCCCTTGGCCTCTCCACCAGTGGGCGTGTCTCTGTCTATA
>TTN-203,ENSE00003806988,1,264,285846,286109,GTGTGGACGTGATAACACCTCTAAAAGATGTTAATGTGATTGAAGGCACCAAGGCTGTGCTTGAATGTAAGGTGTCAGTCCCTGATGTGACTTCTGTTAAGTGGTACTTAAATGATGAACAAATCAAGCCTGATGACCGTGTACAGGCCATTGTGAAAGGTACTAAACAGCGACTAGTCATTAACCGAACTCATGCTTCAGACGAAGGACCTTACAAGCTGATAGTTGGCAGAGTTGAAACCAACTGTAATCTCTCTGTAGAAA
>TTN-203,ENSE00003804968,1,261,286110,286370,AAATTAAAATTATCAGAGGTCTTCGTGACCTTACCTGTACAGAAACTCAAAATGTGGTGTTTGAGGTTGAGCTGTCCCACTCTGGAATTGATGTCCTGTGGAATTTTAAGGACAAGGAAATCAAGCCCAGTTCTAAATATAAAATTGAAGCACATGGAAAAATATATAAATTGACAGTTCTAAATATGATGAAAGATGATGAAGGAAAATACACATTTTACGCGGGAGAAAATATGACATCTGGAAAACTTACTGTGGCAG
>TTN-203,ENSE00003809850,1,261,286371,286631,GTGGGGCCATCTCCAAGCCACTCACAGATCAGACCGTAGCTGAATCCCAGGAAGCTGTGTTTGAATGTGAAGTTGCCAACCCAGATTCCAAAGGCGAATGGTTGAGGGATGGCAAACACCTACCACTGACTAACAACATCAGAAGTGAGTCTGATGGCCACAAAAGGAGACTTATCATTGCTGCCACCAAATTAGATGACATTGGAGAATATACCTACAAGGTGGCCACCTCCAAAACATCTGCCAAACTCAAAGTTGAAG
>TTN-203,ENSE00003806479,1,264,286632,286895,CTGTCAAAATTAAGAAGACTCTGAAGAACCTCACAGTGACAGAAACACAGGATGCTGTTTTCACTGTCGAGCTTACACACCCTAATGTCAAAGGTGTCCAGTGGATCAAAAATGGAGTTGTGCTGGAATCCAATGAAAAGTATGCTATCTCTGTCAAAGGAACAATTTACTCTCTGAGGATTAAAAACTGTGCCATCGTGGATGAGTCTGTTTATGGCTTCAGGCTTGGAAGGCTTGGAGCCAGTGCCAGACTGCACGTGGAGA
>TTN-203,ENSE00003804523,1,261,286896,287156,CTGTCAAGATCATTAAAAAGCCAAAGGATGTGACAGCCTTGGAAAATGCCACTGTTGCCTTTGAAGTTAGTGTTTCCCATGACACTGTTCCAGTAAAATGGTTCCATAAGAGTGTGGAAATTAAGCCAAGTGACAAACACAGACTGGTCTCAGAAAGGAAAGTCCACAAGCTGATGCTGCAGAACATCTCCCCCTCAGATGCTGGGGAATACACAGCTGTGGTCGGGCAATTGGAATGCAAAGCAAAACTGTTTGTGGAGA
>TTN-203,ENSE00003807378,1,261,287157,287417,CATTACATATTACAAAAACCATGAAAAATATCGAGGTGCCTGAGACCAAAACTGCCTCTTTTGAGTGTGAGGTGTCCCACTTCAATGTCCCTTCCATGTGGCTGAAGAATGGTGTGGAAATTGAGATGAGTGAAAAGTTCAAGATAGTTGTGCAGGGAAAACTCCATCAGCTGATCATCATGAACACCAGCACAGAGGACTCGGCAGAATACACATTTGTCTGTGGCAATGACCAAGTCAGTGCCACCCTGACAGTCACCC
>TTN-203,ENSE00003807271,1,261,287418,287678,CAATCATGATTACTTCCATGCTGAAAGACATCAACGCTGAAGAAAAAGACACTATTACTTTTGAGGTGACAGTGAACTATGAAGGCATCTCTTACAAATGGTTAAAGAATGGTGTGGAAATCAAATCAACTGACAAGTGCCAGATGAGAACCAAAAAGCTCACACACTCACTGAACATCAGGAATGTTCACTTTGGGGATGCTGCTGACTACACCTTTGTGGCTGGAAAAGCAACATCAACAGCCACACTTTATGTGGAAG
>TTN-203,ENSE00003808172,1,142,287679,287820,CTCGTCATATAGAATTTAGGAAACACATTAAGGACATTAAGGTACTGGAGAAGAAGCGAGCCATGTTTGAATGTGAAGTTTCTGAACCTGACATCACTGTACAGTGGATGAAAGATGACCAGGAACTGCAGATCACAGACAG
>TTN-203,ENSE00003808223,1,166,287821,287986,AATAAAGATTCAGAAGGAGAAATATGTCCACCGCCTTCTGATCCCATCCACCCGGATGTCTGATGCTGGGAAGTACACAGTGGTGGCAGGAGGCAACGTGTCAACTGCAAAACTCTTTGTAGAAGGCAGAGATGTTCGCATCCGAAGTATTAAAAAGGAGGTTCAG
>TTN-203,ENSE00003810851,1,232,287987,288218,GTCATTGAGAAACAGCGTGCTGTTGTTGAATTTGAGGTCAATGAAGACGATGTTGATGCCCACTGGTATAAAGATGGCATTGAAATCAATTTCCAAGTTCAAGAACGACACAAATATGTAGTGGAAAGAAGAATCCACCGAATGTTTATCTCTGAGACCAGACAGAGCGATGCAGGAGAATACACCTTTGTGGCAGGAAGGAACAGGAGTTCTGTCACTCTCTATGTCAATG
>TTN-203,ENSE00003802092,1,285,288219,288503,CTCCTGAACCGCCCCAAGTTCTGCAGGAGCTCCAGCCTGTCACTGTGCAGTCTGGCAAGCCTGCCCGCTTCTGTGCCGTGATATCCGGAAGACCACAGCCCAAAATTTCCTGGTACAAGGAAGAGCAGCTGCTTTCCACTGGCTTCAAGTGCAAATTTCTTCATGATGGGCAAGAATACACGCTTTTGCTAATTGAAGCCTTCCCAGAGGATGCGGCAGTCTATACCTGTGAAGCCAAGAATGACTATGGTGTTGCCACAACATCAGCTTCACTCTCAGTGGAAG
>TTN-203,ENSE00003807103,1,126,288504,288629,TTCCAGAAGTTGTGTCTCCTGATCAGGAAATGCCTGTTTATCCACCTGCCATCATCACCCCGCTTCAGGACACTGTCACTTCTGAAGGGCAGCCAGCCCGTTTTCAATGCCGGGTTTCTGGAACAG
>TTN-203,ENSE00003801355,1,189,288630,288818,ATCTAAAAGTGTCGTGGTACAGCAAAGACAAGAAAATCAAGCCATCTCGGTTCTTTAGAATGACTCAATTTGAAGACACTTATCAACTGGAAATTGCCGAAGCTTATCCAGAAGATGAAGGAACTTACACGTTTGTTGCTAGTAATGCTGTAGGCCAAGTATCAAGCACAGCCAACCTGAGTCTGGAAG
>TTN-203,ENSE00004024281,1,375,288819,289193,GATTTAGCAAATTTGAAGAAAATACATCAAACTCCCAATGGCATGTCTCTTTATCAGTTTCATTTAAGAAGGAGCCCCTTGGCCAAAAGCCCAGCTTCATCCAGCCTCTGTCAAGCCTCAGGGTGCACAACGGGGAGACAGTCAGATTTCATGCGAGGGTTTCTGGCATTCCCAAGCCAGAAATCCAATGGTTTCATAACCAGCAGCTAATTCTACCAACAAAAGATGTAGTTTTCCATTTTGAGGAGTCCACAGGCATGGCTTTAATGCTTATAGTTGATGCTTACTCAGAGCATGCTGGGCAGTACTCTTGCAAAGCAGCCAATAGTGCTGGGGAAGCCACTTGTGCAGCTACACTCACAGTGACTCCAAAAG
>TTN-203,ENSE00003810791,1,57,289194,289250,CTCCTGAATCAATTTTGCATGAGAGGATTGAACAAGAGATTGAGATGGAAATGAAAG
>TTN-203,ENSE00004024265,1,2781,289251,292031,AGTTTTCTAGTTCTTTTCTGTCTGCCGAGGAAGAAGGACTTCATAGCGCCGAACTTCAATTATCTAAAATAAATGAAACACTTGAACTTTTGTCTGAATCTCCAGTTTACCCAACTAAATTTGATTCCGAAAAGGAAGGCACTGGCCCAATTTTCATCAAAGAAGTGTCAAATGCTGATATAAGCATGGGGGATGTGGCTACACTGTCTGTAACTGTCATTGGCATCCCCAAACCTAAAATTCAGTGGTTCTTTAATGGAGTGCTATTAACCCCTTCTGCTGACTACAAATTTGTTTTTGACGGTGATGATCATAGCCTGATCATTCTGTTCACCAAATTGGAGGATGAGGGAGAGTATACATGTATGGCCAGTAATGACTATGGAAAGACAATATGTAGTGCCTATCTAAAAATTAATTCCAAAGGAGAGGGTCACAAAGACACTGAAACAGAATCAGCAGTGGCAAAATCTCTGGAAAAGCTGGGAGGTCCTTGTCCTCCTCACTTCCTTAAGGAGTTAAAACCAATTCGCTGTGCTCAAGGGCTTCCTGCCATCTTTGAGTACACAGTGGTTGGAGAGCCTGCCCCTACTGTTACATGGTTCAAAGAAAACAAGCAGCTTTGCACCAGTGTTTATTACACTATCATTCATAACCCTAATGGCTCTGGAACTTTCATTGTCAATGACCCTCAGAGGGAAGACAGTGGCCTCTATATCTGTAAAGCAGAGAATATGTTGGGTGAGTCCACCTGTGCAGCAGAGCTGCTTGTGCTTCTGGAAGACACAGACATGACTGATACCCCCTGCAAAGCAAAGTCCACACCAGAGGCTCCTGAGGATTTTCCACAGACACCCTTAAAGGGTCCCGCAGTTGAAGCACTTGACTCAGAGCAGGAAATTGCAACGTTTGTAAAAGACACCATTTTGAAAGCTGCTTTAATTACAGAAGAAAACCAGCAACTATCTTATGAGCATATTGCTAAAGCCAATGAATTGAGCAGTCAGCTTCCTTTGGGAGCTCAGGAATTGCAATCCATTTTGGAGCAAGACAAGCTCACTCCTGAAAGCACCAGGGAATTTCTTTGCATCAATGGCAGTATTCACTTTCAGCCTCTCAAGGAACCATCTCCCAACCTACAGCTGCAGATTGTACAGTCCCAGAAAACCTTCTCCAAAGAAGGTATTCTAATGCCTGAAGAGCCTGAGACACAGGCAGTTCTATCAGATACCGAGAAAATCTTCCCAAGTGCCATGTCCATAGAACAAATTAATTCATTAACAGTTGAGCCTCTGAAAACTTTATTAGCTGAACCTGAAGGGAATTATCCACAGTCTTCAATAGAACCTCCAATGCATTCTTATCTAACCTCTGTGGCTGAGGAAGTACTTTCACCAAAAGAAAAGACAGTATCTGACACCAACAGAGAGCAAAGAGTGACTCTTCAAAAGCAAGAGGCACAAAGTGCGCTCATCTTGAGTCAGAGCTTAGCTGAGGGACACGTGGAGAGTCTCCAGAGTCCTGATGTCATGATCTCTCAGGTAAACTATGAGCCCCTAGTCCCTTCAGAACACTCATGCACAGAAGGAGGTAAAATTTTGATAGAAAGTGCAAATCCACTGGAAAATGCAGGGCAAGATTCTGCGGTCAGAATTGAGGAAGGCAAGTCCTTAAGATTTCCACTAGCACTTGAAGAAAAGCAGGTACTGCTCAAAGAAGAGCATTCTGACAACGTGGTGATGCCCCCAGACCAAATCATTGAGTCTAAAAGAGAGCCCGTGGCAATAAAGAAAGTGCAGGAGGTACAGGGAAGGGACCTTCTTTCTAAGGAAAGCTTGCTTTCTGGTATTCCAGAAGAGCAGAGATTAAACCTGAAAATTCAAATCTGCCGGGCTTTGCAAGCAGCCGTGGCCAGCGAGCAGCCAGGTCTTTTCTCTGAGTGGCTAAGAAATATTGAAAAGGTGGAGGTCGAGGCTGTAAACATCACCCAAGAGCCCAGACACATCATGTGCATGTACCTTGTTACTTCGGCAAAGTCTGTAACAGAAGAAGTAACCATCATTATTGAAGATGTTGATCCTCAAATGGCTAACCTGAAAATGGAACTTAGGGATGCTTTGTGTGCTATTATATATGAGGAAATAGACATCCTAACAGCTGAGGGTCCTAGAATTCAGCAAGGAGCCAAAACAAGTTTGCAAGAAGAAATGGATTCTTTTTCAGGTTCACAGAAGGTTGAACCCATTACTGAACCAGAAGTTGAATCTAAATATCTGATCTCAACTGAAGAGGTCAGTTATTTTAACGTGCAAAGTAGGGTTAAATATTTGGATGCCACACCTGTCACTAAAGGGGTTGCTTCAGCTGTTGTCTCTGACGAAAAACAAGATGAGAGTCTGAAACCATCAGAGGAAAAAGAGGAGTCTTCCTCTGAAAGTGGTACTGAGGAGGTTGCTACAGTAAAGATACAGGAAGCTGAGGGTGGCTTAATCAAAGAGGATGGCCCCATGATACATACACCTTTAGTGGACACTGTTTCTGAGGAAGGTGATATTGTACACCTCACAACATCCATAACAAATGCTAAAGAGGTGAATTGGTATTTTGAGAATAAACTGGTGCCTTCAGATGAAAAGTTCAAGTGTTTACAAGATCAAAATACATATACGCTAGTCATCGACAAAGTAAATACCGAAGACCATCAAGGAGAGTATGTCTGTGAGGCCTTGAATGACAGCGGAAAAACAGCAACTTCAGCCAAACTCACTGTAGTAAAAAGAG
>TTN-203,ENSE00003805227,1,279,292032,292310,CTGCCCCAGTGATCAAGAGGAAAATCGAACCCCTGGAAGTAGCACTGGGCCACCTAGCCAAATTCACCTGTGAGATCCAAAGTGCTCCCAATGTCCGGTTCCAGTGGTTTAAAGCTGGCCGAGAAATTTATGAGAGTGACAAGTGTTCTATTCGATCTTCAAAGTATATCTCCAGCCTTGAAATCCTGAGAACCCAGGTGGTTGACTGCGGCGAGTATACATGCAAAGCTTCCAATGAGTATGGCAGTGTCAGCTGTACAGCCACACTAACTGTGACAG
>TTN-203,ENSE00003804802,1,81,292311,292391,TGCCTGGAGGTGAAAAGAAAGTTCGCAAATTACTTCCGGAACGTAAACCTGAACCAAAGGAAGAAGTTGTTCTGAAAAGCG
>TTN-203,ENSE00003811452,1,75,292392,292466,TTCTAAGAAAAAGACCTGAAGAAGAAGAACCTAAAGTAGAACCTAAAAAACTAGAAAAAGTTAAAAAACCTGCAG
>TTN-203,ENSE00003807205,1,90,292467,292556,TACCAGAACCACCACCTCCAAAACCTGTTGAAGAGGTTGAAGTACCTACTGTTACAAAAAGGGAAAGGAAGATTCCTGAACCAACAAAAG
>TTN-203,ENSE00003806747,1,63,292557,292619,TGCCTGAAATCAAGCCAGCAATACCTCTCCCTGCACCTGAACCGAAACCAAAGCCCGAAGCAG
>TTN-203,ENSE00003810755,1,90,292620,292709,AAGTGAAAACAATCAAACCACCTCCTGTGGAACCTGAACCAACCCCCATCGCTGCCCCAGTAACAGTGCCAGTGGTTGGAAAGAAAGCAG
>TTN-203,ENSE00003806122,1,51,292710,292760,AAGCCAAAGCACCTAAGGAAGAGGCTGCCAAGCCAAAAGGTCCTATCAAAG
>TTN-203,ENSE00003804858,1,402,292761,293162,GTGTACCCAAAAAGACTCCTTCACCAATAGAAGCCGAAAGGAGAAAGTTAAGGCCAGGAAGTGGTGGAGAGAAACCTCCTGATGAAGCCCCGTTCACCTACCAGCTAAAGGCTGTGCCACTGAAGTTTGTGAAAGAAATCAAAGACATCATCTTGACAGAATCAGAGTTCGTTGGCTCTTCAGCAATCTTTGAATGTTTGGTCTCCCCTTCCACTGCAATTACAACCTGGATGAAAGACGGTAGCAATATCCGTGAGAGTCCCAAGCACAGGTTTATTGCAGATGGTAAAGACAGAAAGCTGCACATCATTGATGTTCAACTTTCCGATGCTGGTGAATACACCTGTGTTTTACGTTTGGGAAACAAAGAAAAGACCTCCACGGCTAAACTTGTTGTAGAAG
>TTN-203,ENSE00003803996,1,279,293163,293441,AACTTCCTGTGCGTTTTGTAAAAACACTGGAAGAGGAAGTCACAGTGGTCAAAGGACAGCCATTGTACTTGAGCTGCGAGTTAAACAAAGAGCGTGACGTGGTCTGGAGGAAGGATGGCAAGATTGTGGTGGAGAAACCTGGCCGAATTGTGCCAGGCGTCATTGGCTTGATGCGGGCTCTGACCATCAACGATGCAGATGACACAGATGCTGGAACATACACAGTTACTGTGGAAAACGCCAACAACCTGGAGTGTTCATCTTGCGTAAAAGTAGTAG
>TTN-203,ENSE00003807976,1,276,293442,293717,AAGTCATTAGAGATTGGCTGGTGAAACCTATACGAGACCAGCATGTGAAACCCAAGGGGACAGCTATTTTTGCCTGTGATATAGCAAAAGATACTCCAAACATTAAGTGGTTCAAAGGATATGATGAAATCCCTGCGGAACCAAATGATAAGACTGAAATACTGAGAGATGGAAATCATCTGTACCTCAAAATTAAGAATGCTATGCCAGAAGATATTGCTGAGTATGCAGTGGAAATTGAAGGAAAAAGATACCCTGCAAAGCTGACACTTGGAG
>TTN-203,ENSE00003804328,1,140,293718,293857,AGCGTGAAGTTGAACTGCTTAAACCAATAGAGGACGTTACCATTTATGAGAAAGAAAGTGCAAGCTTTGATGCAGAAATCTCAGAGGCAGACATTCCTGGACAATGGAAACTGAAAGGAGAACTTCTAAGGCCCTCACCT
>TTN-203,ENSE00003802254,1,127,293858,293984,ACTTGTGAAATCAAAGCAGAAGGTGGAAAACGCTTCTTAACTTTGCACAAAGTCAAACTGGACCAAGCTGGTGAAGTCCTCTACCAGGCCCTTAATGCAATTACAACTGCCATTTTGACAGTAAAAG
>TTN-203,ENSE00003811410,1,264,293985,294248,AAATCGAACTTGACTTTGCTGTGCCCCTGAAGGATGTCACTGTTCCAGAAAGGCGACAGGCTCGATTCGAATGTGTCCTCACCCGAGAGGCAAATGTTATATGGTCCAAAGGACCTGATATAATTAAGTCATCTGACAAATTTGATATCATCGCTGATGGAAAGAAACATATTCTTGTTATTAATGATTCTCAATTTGATGATGAAGGGGTCTATACTGCTGAGGTGGAGGGCAAGAAGACCTCAGCTCGGTTGTTTGTCACAG
>TTN-203,ENSE00003805150,1,267,294249,294515,GTATAAGACTGAAATTCATGTCACCTCTTGAAGATCAAACAGTAAAAGAAGGTGAAACAGCAACTTTTGTTTGTGAACTTTCTCATGAAAAAATGCATGTAGTCTGGTTCAAAAATGATGCCAAACTCCATACAAGCAGAACAGTACTCATCTCTTCTGAGGGCAAGACTCACAAATTGGAAATGAAAGAAGTGACATTGGATGATATATCTCAGATAAAAGCTCAAGTCAAGGAGCTGAGCTCCACAGCACAGCTGAAGGTCTTAG
>TTN-203,ENSE00003801907,1,264,294516,294779,AGGCCGATCCCTACTTCACTGTGAAATTACATGACAAAACTGCAGTGGAGAAGGATGAGATTACTTTGAAGTGTGAAGTGAGCAAAGATGTACCAGTGAAATGGTTCAAAGATGGTGAAGAGATTGTCCCTTCACCCAAATATTCTATCAAGGCAGATGGCCTGCGCCGCATCTTAAAAATCAAAAAGGCGGACCTTAAAGATAAAGGCGAATATGTGTGTGACTGTGGCACAGACAAGACCAAGGCAAATGTTACTGTTGAGG
>TTN-203,ENSE00003802031,1,140,294780,294919,CTCGACTAATAAAAGTGGAAAAGCCTCTGTACGGAGTAGAGGTGTTTGTTGGTGAAACAGCCCACTTTGAAATTGAACTTTCTGAACCTGATGTTCACGGCCAGTGGAAGCTGAAAGGACAGCCTTTGACAGCTTCCCCT
>TTN-203,ENSE00003811443,1,127,294920,295046,GACTGTGAAATCATTGAGGATGGAAAGAAGCATATTCTGATCCTTCATAACTGTCAGCTGGGTATGACAGGAGAGGTTTCCTTCCAGGCTGCTAATGCCAAATCTGCAGCCAATCTGAAAGTGAAAG
>TTN-203,ENSE00003811384,1,267,295047,295313,AATTGCCTCTTATCTTCATCACACCTCTCAGTGATGTTAAAGTCTTCGAGAAAGATGAGGCTAAGTTTGAGTGTGAAGTATCCAGGGAGCCCAAAACATTCCGTTGGCTAAAAGGAACCCAGGAAATCACAGGTGATGACAGATTTGAGCTTATAAAGGATGGCACTAAGCATTCAATGGTGATCAAGTCAGCTGCTTTTGAAGATGAAGCAAAATACATGTTTGAAGCTGAAGATAAGCACACAAGTGGCAAACTGATCATTGAAG
>TTN-203,ENSE00003801954,1,267,295314,295580,GAATCCGGCTCAAATTCCTCACCCCTCTCAAAGATGTAACTGCCAAAGAGAAGGAAAGTGCTGTATTTACTGTGGAGTTATCTCATGATAACATCCGAGTTAAATGGTTCAAGAATGACCAGCGCCTACACACCACCAGGTCGGTCTCAATGCAAGACGAAGGGAAAACTCATTCGATCACATTCAAAGACCTGTCTATTGATGACACCTCCCAAATTAGAGTAGAAGCTATGGGGATGAGTTCAGAAGCTAAACTCACTGTGCTTG
>TTN-203,ENSE00003809996,1,267,295581,295847,AGGGAGACCCATATTTTACAGGAAAACTTCAAGATTATACTGGTGTAGAGAAAGATGAAGTTATTCTACAGTGTGAAATTAGCAAAGCAGATGCACCAGTGAAATGGTTTAAGGATGGGAAGGAAATAAAGCCATCCAAAAATGCTGTTATTAAGGCAGATGGCAAGAAACGCATGCTAATCCTAAAGAAAGCCTTGAAATCAGATATTGGACAGTACACCTGTGACTGTGGGACAGATAAGACCTCAGGAAAACTTGACATTGAGG
>TTN-203,ENSE00003804589,1,140,295848,295987,ATCGGGAAATTAAACTGGTGCGACCCCTGCACAGTGTGGAGGTGATGGAGACTGAGACAGCACGCTTTGAAACCGAAATCTCTGAAGATGATATCCACGCCAACTGGAAACTCAAGGGAGAGGCCCTACTCCAAACACCT
>TTN-203,ENSE00003805931,1,127,295988,296114,GATTGTGAAATTAAGGAAGAAGGCAAAATACACTCCCTTGTTTTGCACAACTGTCGCCTGGACCAGACGGGTGGGGTGGATTTCCAAGCTGCCAATGTTAAATCTAGTGCCCACCTCCGAGTTAAGC
>TTN-203,ENSE00003811344,1,143,296115,296257,CACGAGTAATTGGTCTTCTGAGGCCTTTAAAGGATGTCACCGTGACTGCAGGGGAAACAGCCACCTTCGACTGCGAGCTCTCCTACGAAGATATCCCAGTGGAATGGTATCTCAAAGGGAAGAAACTAGAGCCCAGCGATAAG
>TTN-203,ENSE00003802375,1,124,296258,296381,GTGGTCCCACGTTCAGAAGGAAAAGTTCATACACTTACTCTGAGGGATGTAAAGTTAGAAGATGCTGGGGAAGTCCAACTAACAGCAAAAGATTTCAAAACTCACGCCAACCTCTTTGTGAAAG
>TTN-203,ENSE00003806733,1,267,296382,296648,AACCCCCAGTTGAATTCACTAAGCCTCTTGAGGACCAGACGGTCGAAGAGGGAGCCACTGCAGTGCTGGAGTGTGAAGTCTCCAGAGAAAATGCTAAGGTGAAATGGTTCAAAAATGGGACAGAAATCCTCAAAAGCAAGAAGTATGAAATTGTTGCTGATGGCAGGGTCAGAAAACTTGTTATACATGACTGTACCCCAGAGGATATTAAAACATACACTTGTGATGCTAAGGATTTTAAGACTTCCTGTAACCTGAATGTCGTGC
>TTN-203,ENSE00003807497,1,98,296649,296746,CTCCTCATGTGGAATTCTTAAGACCACTCACCGACCTTCAAGTTAGAGAAAAAGAAATGGCTCGATTTGAGTGTGAACTTTCCCGAGAAAATGCTAAG
>TTN-203,ENSE00003802530,1,169,296747,296915,GTTAAGTGGTTTAAAGATGGTGCTGAAATTAAAAAGGGCAAAAAATATGACATCATATCCAAGGGAGCAGTGCGCATTCTTGTCATCAACAAATGTCTACTGGATGATGAAGCTGAATATTCCTGTGAAGTAAGGACAGCGAGAACTTCTGGCATGCTGACAGTTCTGG
>TTN-203,ENSE00003811387,1,267,296916,297182,AAGAAGAAGCTGTCTTTACCAAAAATCTTGCCAACATTGAAGTTAGTGAAACAGACACTATAAAACTGGTTTGTGAAGTCTCCAAACCTGGCGCAGAAGTGATTTGGTATAAAGGGGATGAGGAGATCATTGAAACAGGAAGATATGAAATACTGACTGAAGGACGGAAGAGAATCCTGGTCATTCAGAACGCTCACCTTGAGGATGCTGGCAACTACAACTGTCGACTCCCAAGCTCTCGAACCGATGGCAAAGTCAAAGTACATG
>TTN-203,ENSE00003802653,1,267,297183,297449,AACTGGCTGCTGAATTTATCTCAAAGCCTCAAAACCTTGAAATACTTGAAGGAGAAAAGGCTGAATTTGTCTGCTCTATATCAAAAGAAAGCTTTCCAGTCCAGTGGAAGAGGGATGATAAGACACTTGAATCTGGAGATAAATATGACGTTATTGCTGATGGTAAAAAGAGGGTCCTAGTTGTGAAAGATGCCACATTACAAGATATGGGCACTTACGTTGTCATGGTAGGGGCCGCCAGAGCAGCAGCTCACTTGACAGTCATTG
>TTN-203,ENSE00003802540,1,279,297450,297728,AAAAACTCAGGATCGTAGTTCCTCTTAAGGACACCCGGGTGAAGGAACAACAGGAAGTTGTCTTCAACTGTGAAGTCAATACTGAAGGTGCCAAAGCCAAATGGTTCAGAAATGAAGAAGCTATATTTGATAGTTCAAAATACATCATTCTCCAAAAAGACCTAGTCTACACCCTCAGAATTAGAGATGCACACTTAGATGACCAAGCCAACTATAATGTGTCTTTGACCAATCACAGAGGTGAAAATGTTAAAAGTGCAGCCAATCTAATAGTAGAAG
>TTN-203,ENSE00003802874,1,409,297729,298137,AGGAAGACCTTAGGATTGTTGAGCCTCTTAAAGATATTGAAACAATGGAGAAGAAATCTGTCACATTCTGGTGCAAGGTGAATCGTCTCAATGTAACACTGAAGTGGACCAAAAATGGTGAAGAAGTGCCTTTTGACAACCGTGTCTCATACAGAGTTGATAAGTACAAGCACATGTTAACCATTAAAGACTGTGGCTTCCCAGATGAAGGTGAATACATTGTCACTGCTGGACAAGATAAATCTGTTGCTGAGCTTCTCATCATAGAAGCCCCGACAGAATTTGTGGAACACTTGGAAGATCAGACAGTCACTGAGTTCGATGACGCTGTCTTCTCCTGCCAGCTCTCCAGAGAGAAAGCCAATGTAAAATGGTACAGAAATGGGAGAGAAATCAAAGAAGGCAAAAA
>TTN-203,ENSE00003804130,1,125,298138,298262,ATACAAATTTGAAAAAGATGGAAGTATACACAGACTCATTATAAAAGATTGCAGGCTGGATGATGAGTGTGAATATGCTTGCGGGGTAGAAGACAGGAAGTCTCGTGCTAGACTTTTTGTGGAAG
>TTN-203,ENSE00003807647,1,267,298263,298529,AAATTCCTGTTGAGATCATCAGGCCTCCACAAGATATTCTTGAAGCCCCTGGTGCTGATGTTGTCTTTTTAGCAGAACTCAATAAAGATAAGGTGGAAGTCCAATGGCTAAGAAATAACATGGTTGTTGTCCAGGGTGATAAACACCAGATGATGAGTGAAGGAAAGATACATCGACTACAGATTTGTGATATTAAGCCCCGTGACCAGGGTGAATACAGATTTATTGCCAAAGACAAAGAAGCCAGAGCTAAGCTTGAACTGGCAG
>TTN-203,ENSE00003802353,1,270,298530,298799,CTGCACCAAAAATCAAGACAGCTGACCAAGACCTTGTGGTTGATGTTGGCAAGCCTCTGACAATGGTGGTGCCATATGATGCCTACCCCAAAGCAGAAGCTGAATGGTTTAAAGAAAATGAACCTTTATCTACAAAAACCATTGATACTACGGCTGAACAAACTTCTTTCAGAATTTTAGAAGCCAAGAAAGGAGACAAAGGGAGGTATAAAATTGTGCTTCAGAACAAACATGGAAAAGCAGAAGGATTCATCAATTTAAAAGTTATTG
>TTN-203,ENSE00003809195,1,303,298800,299102,ATGTTCCTGGGCCAGTACGTAACTTAGAAGTGACAGAAACATTTGATGGTGAAGTGAGCCTTGCTTGGGAAGAACCTTTAACTGATGGTGGAAGCAAAATCATAGGTTACGTTGTTGAAAGACGTGACATTAAGAGAAAGACCTGGGTTCTGGCCACAGACCGTGCAGAGAGTTGTGAGTTTACTGTCACTGGTCTACAGAAAGGAGGAGTTGAGTACCTATTCCGTGTGAGTGCAAGAAACAGAGTTGGCACTGGTGAGCCAGTAGAAACTGACAATCCTGTAGAAGCAAGGAGTAAATATG
>TTN-203,ENSE00003803170,1,303,299103,299405,ATGTTCCAGGCCCTCCTTTGAATGTAACCATCACTGATGTGAATCGATTTGGTGTCTCACTGACATGGGAACCACCAGAGTATGATGGAGGTGCTGAGATCACAAACTACGTCATTGAATTAAGAGACAAGACTTCTATCAGGTGGGATACTGCCATGACTGTGAGAGCTGAAGACCTGTCTGCAACTGTTACTGATGTGGTAGAAGGACAGGAGTACAGTTTCCGAGTGAGAGCCCAAAATCGAATTGGAGTTGGAAAACCAAGTGCAGCCACACCCTTCGTCAAAGTTGCTGATCCAATTG
>TTN-203,ENSE00003806295,1,188,299406,299593,AGAGACCAAGTCCTCCTGTAAACCTAACTTCCTCAGATCAGACTCAGTCATCAGTTCAGCTCAAATGGGAACCTCCTCTGAAAGATGGAGGAAGCCCAATATTAGGCTATATAATTGAGCGATGCGAAGAAGGAAAAGATAATTGGATTCGTTGCAATATGAAACTTGTCCCTGAACTGACTTACAAG
>TTN-203,ENSE00003810732,1,115,299594,299708,GTTACCGGATTGGAAAAAGGAAATAAATATTTATATAGAGTATCTGCAGAAAATAAAGCTGGTGTTTCAGATCCATCTGAAATTCTTGGTCCTCTCACCGCTGACGATGCATTTG
>TTN-203,ENSE00003809985,1,285,299709,299993,TTGAACCAACAATGGATTTAAGTGCATTTAAAGATGGTCTGGAAGTTATTGTCCCAAATCCTATCACGATCCTGGTTCCAAGTACAGGCTATCCAAGGCCAACTGCAACCTGGTGTTTTGGAGATAAAGTACTAGAAACAGGGGACCGGGTGAAAATGAAGACCTTGTCTGCCTATGCCGAACTTGTCATTTCTCCAAGTGAACGTTCAGACAAGGGCATTTATACACTGAAATTAGAAAACCGTGTGAAAACAATTTCTGGGGAAATTGATGTCAATGTAATTG
>TTN-203,ENSE00003808828,1,152,299994,300145,CTCGCCCAAGTGCACCCAAAGAATTGAAATTTGGTGATATAACCAAGGACTCAGTACATTTGACTTGGGAACCACCTGATGATGATGGAGGAAGTCCGTTAACTGGATACGTTGTTGAAAAACGAGAAGTCAGCCGGAAAACATGGACTAAA
>TTN-203,ENSE00003803811,1,148,300146,300293,GTTATGGACTTTGTGACTGATCTAGAATTCACAGTTCCTGATCTTGTTCAAGGAAAAGAGTACTTATTTAAAGTTTGTGCTCGTAACAAATGTGGCCCTGGAGAACCTGCATATGTTGATGAACCTGTAAATATGTCAACTCCTGCAA
>TTN-203,ENSE00003803944,1,178,300294,300471,CGGTACCTGACCCACCAGAGAATGTTAAATGGAGAGATCGAACAGCCAATAGCATCTTCTTAACATGGGATCCACCTAAAAATGATGGTGGTTCACGCATCAAAGGATATATAGTTGAAAGATGTCCACGTGGTTCTGATAAATGGGTTGCCTGTGGAGAACCTGTTGCAGAAACAAA
>TTN-203,ENSE00003802090,1,122,300472,300593,AATGGAAGTGACAGGTCTTGAGGAAGGCAAATGGTATGCCTACCGCGTGAAGGCCTTAAACAGGCAGGGTGCTAGCAAACCAAGCAGACCCACAGAGGAAATCCAGGCTGTGGACACACAAG
>TTN-203,ENSE00003809522,1,288,300594,300881,AGGCCCCAGAAATCTTCCTCGATGTGAAGCTCCTTGCTGGTCTCACTGTAAAAGCTGGGACCAAGATTGAACTTCCTGCCACCGTAACCGGAAAACCTGAACCTAAAATAACTTGGACAAAGGCTGATATGATTCTGAAGCAGGACAAAAGAATTACCATTGAAAATGTCCCTAAGAAATCCACAGTGACTATTGTTGATAGTAAGAGAAGTGACACTGGCACATATATCATTGAGGCTGTGAATGTGTGTGGCCGGGCCACTGCTGTGGTGGAAGTGAACGTCTTAG
>TTN-203,ENSE00003804879,1,297,300882,301178,ATAAACCCGGACCACCAGCTGCCTTTGACATCACAGATGTAACCAATGAGTCATGTCTTCTAACATGGAACCCACCACGCGATGATGGTGGATCTAAGATCACAAACTATGTTGTGGAGAGACGAGCAACTGATAGTGAAGTGTGGCACAAGCTCTCATCCACCGTCAAGGATACAAACTTCAAGGCCACCAAATTAATCCCCAATAAAGAGTACATCTTCAGAGTTGCTGCAGAAAACATGTATGGTGTTGGTGAACCAGTTCAGGCCTCTCCAATAACAGCCAAATATCAGTTTG
>TTN-203,ENSE00003809410,1,187,301179,301365,ATCCACCTGGTCCTCCAACTCGCCTAGAACCTTCTGATATCACTAAAGACGCAGTGACTCTCACATGGTGTGAGCCAGATGATGATGGTGGCAGCCCAATCACAGGATACTGGGTTGAAAGACTGGATCCTGATACAGATAAATGGGTTAGATGCAATAAGATGCCAGTAAAGGACACAACATACAG
>TTN-203,ENSE00003808827,1,116,301366,301481,AGTGAAAGGTCTCACTAATAAGAAAAAATACAGATTCCGTGTGTTGGCTGAAAATCTTGCTGGACCTGGAAAACCAAGCAAATCAACTGAACCAATCTTAATAAAGGATCCCATAG
>TTN-203,ENSE00003806136,1,300,301482,301781,ATCCTCCATGGCCCCCTGGAAAACCAACTGTAAAAGATGTAGGCAAAACATCAGTAAGGTTGAATTGGACAAAACCAGAACATGATGGAGGTGCAAAGATTGAGTCTTATGTCATTGAAATGCTGAAGACTGGAACAGATGAGTGGGTCAGAGTGGCGGAAGGGGTTCCCACCACTCAGCACTTGCTCCCAGGGCTCATGGAAGGACAGGAATACTCATTCCGAGTTAGAGCTGTGAATAAGGCTGGGGAAAGTGAACCCAGTGAACCCAGTGACCCTGTGCTTTGCCGGGAGAAGCTAT
>TTN-203,ENSE00003804290,1,300,301782,302081,ATCCTCCATCACCACCACGCTGGCTTGAAGTTATTAATATCACAAAAAATACAGCAGACCTAAAATGGACAGTTCCTGAGAAAGATGGAGGGTCCCCCATCACCAACTACATTGTGGAAAAGAGAGACGTCAGGCGAAAAGGCTGGCAAACAGTGGATACCACTGTCAAGGACACCAAGTGCACAGTCACCCCACTGACTGAGGGCTCTTTATATGTGTTCCGAGTTGCTGCAGAAAATGCTATAGGACAAAGCGACTACACCGAAATTGAGGACTCTGTGCTGGCCAAAGACACCTTTA
>TTN-203,ENSE00003803723,1,106,302082,302187,CCACTCCTGGACCACCCTACGCCCTGGCAGTGGTTGATGTGACAAAACGACATGTTGACCTAAAGTGGGAGCCACCTAAAAATGATGGTGGAAGACCAATACAGAG
>TTN-203,ENSE00003805819,1,197,302188,302384,ATATGTCATTGAGAAGAAAGAAAGGTTAGGTACCCGTTGGGTGAAAGCTGGAAAGACTGCAGGACCTGACTGTAACTTCAGAGTAACTGATGTCATCGAAGGAACAGAGGTCCAGTTTCAGGTTCGGGCTGAAAATGAAGCTGGAGTTGGCCACCCAAGTGAACCCACAGAAATCCTATCCATTGAAGATCCAACAA
>TTN-203,ENSE00003806467,1,306,302385,302690,GTCCTCCCTCACCACCCCTTGACCTACATGTGACTGATGCTGGGAGAAAACACATTGCCATTGCTTGGAAGCCTCCAGAGAAAAATGGTGGAAGTCCTATCATAGGATACCATGTTGAAATGTGTCCAGTAGGCACTGAGAAATGGATGAGAGTTAATTCTCGCCCAATAAAGGACTTGAAATTCAAGGTTGAAGAAGGTGTTGTTCCTGACAAAGAATATGTCCTGAGAGTGAGAGCAGTCAATGCTATTGGTGTCAGCGAGCCATCTGAAATCTCTGAAAATGTGGTTGCCAAAGACCCAGACT
>TTN-203,ENSE00003808061,1,279,302691,302969,GCAAGCCAACAATTGACCTGGAGACTCATGACATTATTGTTATTGAAGGTGAAAAGTTAAGCATTCCTGTTCCCTTCAGAGCTGTCCCAGTTCCAACTGTTAGTTGGCATAAAGATGGCAAAGAAGTTAAAGCAAGTGATAGATTAACAATGAAGAATGATCACATCTCTGCACACCTTGAAGTTCCCAAGAGTGTCCGTGCAGATGCCGGAATTTATACCATTACACTGGAGAATAAGCTCGGCTCAGCAACAGCCTCAATCAATGTCAAAGTCATAG
>TTN-203,ENSE00003811164,1,300,302970,303269,GCCTACCTGGACCATGCAAAGATATTAAAGCAAGTGACATTACCAAGAGTTCTTGTAAGTTAACTTGGGAACCTCCAGAATTTGATGGTGGAACCCCAATTCTTCATTATGTCCTGGAGCGCAGAGAAGCTGGGAGGAGAACATATATACCAGTCATGTCTGGTGAGAACAAACTGTCATGGACTGTGAAGGATCTCATACCAAATGGTGAATACTTCTTCCGTGTTAAAGCAGTCAACAAGGTTGGTGGAGGAGAATATATTGAACTGAAAAATCCAGTCATTGCTCAAGATCCAAAGC
>TTN-203,ENSE00003805132,1,303,303270,303572,AACCCCCTGATCCACCTGTAGATGTAGAGGTTCATAATCCTACAGCGGAGGCAATGACTATTACATGGAAGCCACCTTTGTATGATGGAGGGAGCAAGATAATGGGCTACATCATAGAGAAGATTGCTAAGGGTGAAGAAAGGTGGAAGAGATGCAATGAACACCTGGTACCAATCCTGACCTATACAGCAAAAGGACTTGAAGAGGGGAAAGAGTACCAATTCCGTGTGCGAGCAGAGAACGCCGCGGGTATTAGTGAACCTTCTCGGGCTACTCCTCCAACCAAAGCTGTAGATCCCATTG
>TTN-203,ENSE00003805056,1,363,303573,303935,ATGCCCCCAAAGTCATTCTGAGAACAAGCCTAGAAGTGAAACGAGGTGATGAAATAGCACTTGATGCAAGTATTTCTGGATCACCTTACCCAACTATTACATGGATAAAGGATGAAAATGTTATTGTACCAGAGGAAATTAAGAAGCGTGCAGCACCCTTGGTTAGGAGAAGGAAGGGTGAAGTTCAAGAAGAAGAACCATTTGTCCTGCCTCTGACACAGCGTTTGAGTATTGACAACAGCAAAAAGGGAGAATCTCAGCTACGCGTCCGAGATTCTCTCCGACCTGACCATGGTCTGTATATGATCAAAGTTGAAAATGACCACGGTATTGCAAAAGCTCCTTGTACTGTCAGTGTGTTAG
>TTN-203,ENSE00003811138,1,303,303936,304238,ATACACCGGGACCACCAATCAACTTTGTATTTGAAGATATCAGAAAGACCTCAGTCCTTTGTAAATGGGAACCACCCCTTGATGATGGTGGCAGTGAAATCATAAACTACACTTTGGAAAAGAAAGACAAGACAAAACCCGACTCAGAATGGATTGTTGTCACTTCAACACTTAGACATTGCAAATATTCAGTAACAAAACTGATTGAAGGAAAAGAGTACCTCTTCCGTGTAAGAGCTGAAAACAGATTTGGGCCAGGTCCACCATGTGTTTCAAAGCCACTTGTGGCTAAAGATCCATTTG
>TTN-203,ENSE00003809346,1,300,304239,304538,GACCACCTGATGCACCAGATAAGCCCATTGTGGAAGATGTTACCAGCAACAGTATGCTAGTGAAATGGAATGAACCAAAAGATAATGGAAGCCCCATTTTGGGTTACTGGCTTGAAAAACGTGAAGTTAACAGTACACATTGGTCTCGTGTCAACAAAAGCCTTCTGAATGCCTTGAAAGCCAATGTAGATGGCTTATTAGAAGGACTCACCTATGTCTTCAGAGTATGTGCTGAAAATGCAGCTGGACCTGGAAAGTTCAGTCCACCTTCAGATCCCAAAACAGCACATGATCCAATCT
>TTN-203,ENSE00003806782,1,297,304539,304835,CTCCTCCTGGGCCACCTATCCCAAGAGTCACTGACACAAGCTCTACAACTATTGAACTAGAATGGGAACCCCCAGCTTTCAATGGTGGTGGGGAAATTGTTGGCTATTTTGTTGATAAGCAGTTGGTTGGCACAAATGAATGGTCACGCTGCACAGAGAAGATGATCAAGGTCCGTCAGTACACCGTCAAAGAAATCCGAGAGGGTGCTGATTACAAACTTCGGGTGAGTGCTGTCAATGCCGCAGGGGAAGGACCGCCTGGAGAAACACAACCTGTTACTGTGGCTGAACCACAAG
>TTN-203,ENSE00003804121,1,285,304836,305120,AGCCTCCAGCTGTGGAACTGGATGTTTCTGTCAAGGGTGGAATACAAATAATGGCTGGGAAGACTCTTAGAATTCCAGCTGTGGTGACTGGTCGCCCTGTACCTACAAAAGTATGGACCAAAGAAGAAGGGGAGCTGGATAAAGACCGTGTTGTAATAGACAACGTTGGAACCAAATCTGAACTAATTATCAAGGATGCACTGCGAAAAGACCATGGCAGATATGTGATTACAGCTACAAATAGCTGTGGTTCCAAATTTGCAGCAGCCAGGGTAGAAGTTTTTG
>TTN-203,ENSE00003804454,1,294,305121,305414,ATGTCCCTGGTCCAGTTCTTGACTTAAAACCTGTTGTAACAAACAGAAAAATGTGTCTACTTAACTGGTCTGATCCAGAAGATGATGGAGGAAGTGAAATAACAGGCTTTATCATTGAAAGAAAAGATGCCAAGATGCATACTTGGAGACAACCAATAGAGACTGAGAGATCTAAATGTGACATCACAGGTCTGCTTGAGGGACAAGAATATAAGTTCCGTGTTATTGCCAAGAACAAGTTTGGCTGTGGCCCTCCTGTTGAAATAGGACCAATTCTTGCAGTTGATCCACTAG
>TTN-203,ENSE00003803420,1,300,305415,305714,GTCCTCCAACATCTCCAGAGAGGCTCACATACACTGAAAGGACAAAGTCCACTATCACACTTGACTGGAAAGAGCCCCGCAGTAATGGTGGCAGTCCCATCCAAGGATATATCATTGAAAAACGGCGTCATGACAAACCTGACTTTGAAAGAGTTAACAAGCGACTCTGCCCAACCACATCTTTTCTGGTTGAAAATCTTGATGAACACCAAATGTATGAGTTCCGTGTCAAAGCTGTCAATGAAATTGGTGAAAGTGAACCATCCCTACCTCTTAATGTAGTCATACAAGATGATGAAG
>TTN-203,ENSE00003809028,1,309,305715,306023,TGCCTCCAACTATTAAGTTGCGTCTGAGTGTTCGAGGAGACACTATCAAAGTTAAGGCAGGAGAGCCTGTCCACATCCCTGCAGATGTGACAGGCCTTCCAATGCCTAAGATTGAATGGTCCAAAAATGAAACTGTAATTGAAAAACCCACTGATGCACTTCAGATAACCAAGGAAGAGGTATCCCGAAGTGAGGCAAAAACTGAGCTTAGCATTCCCAAAGCGGTCCGGGAGGACAAAGGCACTTACACAGTTACTGCTTCCAATCGCCTTGGCTCAGTGTTCCGAAATGTTCACGTTGAAGTATATG
>TTN-203,ENSE00003801894,1,191,306024,306214,ACCGCCCATCCCCACCAAGAAATCTTGCTGTTACTGACATTAAAGCTGAATCTTGCTACTTGACATGGGATGCCCCTCTTGATAATGGTGGCAGTGAAATCACCCATTATGTTATTGACAAACGTGATGCAAGTAGGAAGAAAGCAGAATGGGAGGAAGTCACCAACACTGCTGTAGAGAAAAGATATGGG
>TTN-203,ENSE00003809851,1,430,306215,306644,ATCTGGAAACTTATCCCCAATGGTCAGTATGAGTTCCGAGTCAGGGCAGTGAATAAATATGGAATCAGTGATGAGTGCAAATCAGATAAAGTAGTCATTCAAGATCCTTATCGCCTTCCTGGACCTCCAGGAAAACCAAAAGTTTTGGCACGCACCAAAGGATCAATGCTAGTGAGCTGGACTCCTCCTTTGGACAATGGTGGCTCTCCAATTACTGGCTACTGGCTGGAGAAAAGAGAAGAGGGAAGTCCTTATTGGTCACGTGTTAGCCGAGCACCAATAACCAAAGTGGGATTGAAAGGCGTGGAATTTAATGTTCCTCGTTTGCTTGAAGGCGTTAAATACCAGTTCAGAGCCATGGCAATAAATGCTGCAGGAATTGGTCCTCCCAGTGAACCATCAGATCCAGAGGTTGCAGGAGATCCCATAT
>TTN-203,ENSE00003808594,1,309,306645,306953,TTCCACCGGGGCCACCTTCTTGCCCAGAAGTTAAAGATAAAACGAAGTCAAGCATCTCACTAGGATGGAAACCTCCAGCCAAAGATGGTGGCAGCCCAATCAAAGGATACATTGTAGAAATGCAAGAAGAAGGTACTACTGACTGGAAAAGAGTAAATGAACCAGACAAACTTATAACTACCTGTGAATGTGTGGTGCCTAATCTGAAAGAGCTCAGGAAGTACAGATTCAGAGTGAAAGCTGTCAATGAAGCTGGTGAATCTGAACCAAGTGATACAACTGGGGAGATCCCTGCCACTGATATTCAAG
>TTN-203,ENSE00003810473,1,149,306954,307102,AGGAACCAGAAGTTTTCATTGACATTGGAGCACAGGACTGTCTGGTTTGTAAAGCTGGCTCACAGATTAGGATTCCTGCTGTCATCAAGGGACGCCCAACACCAAAATCATCTTGGGAATTTGATGGAAAGGCAAAGAAAGCAATGAAG
>TTN-203,ENSE00003801625,1,33,307103,307135,GATGGAGTTCATGACATACCCGAAGATGCACAG
>TTN-203,ENSE00003802643,1,130,307136,307265,CTGGAGACTGCTGAAAACTCCTCAGTAATTATTATTCCGGAGTGTAAACGATCTCATACAGGCAAATACAGCATCACAGCCAAGAATAAAGCAGGACAAAAGACTGCAAATTGCAGAGTTAAAGTCATGG
>TTN-203,ENSE00003804239,1,300,307266,307565,ATGTACCAGGCCCACCCAAAGATCTGAAAGTCAGTGATATCACAAGGGGTAGTTGCAGACTTTCATGGAAGATGCCAGACGACGATGGAGGAGACAGGATCAAAGGCTATGTTATTGAGAAGAGGACTATTGATGGAAAAGCCTGGACCAAAGTCAATCCAGACTGTGGAAGCACCACATTTGTAGTGCCTGATCTCCTCTCTGAACAGCAATATTTCTTCCGTGTGCGAGCAGAAAACCGTTTTGGTATTGGCCCACCTGTGGAAACCATTCAGAGGACCACTGCCAGAGATCCGATAT
>TTN-203,ENSE00003806278,1,318,307566,307883,ATCCTCCTGATCCTCCTATTAAACTCAAGATTGGCCTCATCACAAAGAACACAGTGCATCTGTCATGGAAACCCCCGAAGAATGATGGGGGCTCCCCTGTTACCCACTATATTGTTGAGTGCCTTGCATGGGACCCTACTGGGACAAAGAAAGAAGCCTGGAGGCAGTGCAATAAGCGTGATGTGGAAGAACTGCAATTTACTGTTGAAGACCTAGTAGAGGGTGGGGAATATGAATTCCGAGTCAAAGCTGTCAATGCTGCAGGAGTCAGCAAGCCTTCAGCCACTGTTGGCCCTGTGACTGTCAAAGACCAGACAT
>TTN-203,ENSE00003801391,1,297,307884,308180,GCCCACCATCAATTGATCTAAAAGAATTCATGGAGGTTGAAGAAGGAACCAATGTTAACATTGTGGCCAAAATTAAAGGTGTGCCATTCCCGACACTAACCTGGTTTAAAGCTCCTCCAAAGAAGCCTGATAACAAAGAACCTGTTCTCTATGACACCCATGTCAACAAACTGGTGGTAGATGATACTTGCACTTTAGTTATTCCGCAGTCTCGCAGGAGTGACACTGGCTTATATACCATCACAGCTGTAAATAATCTGGGAACAGCATCAAAGGAGATGAGACTGAATGTCCTGG
>TTN-203,ENSE00003806021,1,300,308181,308480,GTCGTCCTGGCCCTCCAGTGGGACCCATAAAATTTGAATCTGTTTCAGCAGATCAAATGACACTATCTTGGTTTCCACCTAAAGATGATGGTGGGTCTAAGATTACAAACTATGTAATTGAGAAAAGAGAAGCTAACAGGAAGACATGGGTCCATGTCTCCAGTGAACCTAAGGAGTGCACGTACACGATTCCCAAATTGCTAGAAGGCCATGAATATGTATTCCGAATCATGGCCCAGAATAAATATGGCATTGGAGAACCTCTTGACAGTGAACCTGAAACAGCAAGAAACCTCTTCT
>TTN-203,ENSE00003803442,1,315,308481,308795,CTGTCCCTGGAGCACCAGATAAACCAACAGTTAGCAGCGTGACTCGTAACTCCATGACTGTCAACTGGGAAGAGCCAGAATATGATGGAGGCTCTCCTGTGACAGGGTACTGGCTGGAAATGAAAGACACCACTTCAAAGAGATGGAAGAGAGTTAACCGAGATCCTATCAAAGCCATGACTTTGGGTGTTTCTTATAAAGTGACTGGTCTTATTGAAGGTTCCGACTATCAATTCCGGGTATATGCAATCAATGCTGCTGGCGTGGGTCCAGCAAGTCTGCCATCAGACCCAGCGACTGCTAGAGATCCAATTG
>TTN-203,ENSE00003801787,1,149,308796,308944,CCCCTCCTGGTCCTCCATTTCCCAAAGTGACAGATTGGACTAAATCATCTGCAGATCTGGAGTGGTCTCCCCCACTAAAAGATGGTGGATCCAAAGTAACTGGATACATCGTTGAATATAAAGAAGAAGGAAAAGAAGAATGGGAAAAG
>TTN-203,ENSE00003802004,1,151,308945,309095,GGTAAAGATAAAGAAGTGAGAGGAACAAAGCTTGTTGTGACAGGATTAAAGGAAGGAGCATTCTACAAATTTAGAGTTAGAGCAGTCAACATTGCTGGCATTGGAGAACCTGGAGAGGTCACAGATGTCATTGAAATGAAGGACAGACTTG
>TTN-203,ENSE00003808790,1,282,309096,309377,TTTCACCTGACCTTCAGCTAGATGCCAGTGTCAGAGATAGAATTGTTGTCCATGCTGGAGGGGTGATCCGAATCATTGCCTATGTGTCTGGAAAGCCTCCTCCAACCGTCACCTGGAACATGAATGAAAGAACCTTACCTCAAGAAGCCACCATTGAGACCACAGCCATTAGCTCATCCATGGTCATCAAGAACTGCCAGAGGAGCCATCAAGGCGTCTATTCTCTTCTTGCCAAAAATGAAGCCGGAGAAAGAAAGAAGACAATTATTGTTGATGTATTAG
>TTN-203,ENSE00003807896,1,303,309378,309680,ATGTTCCAGGTCCCGTTGGAACACCATTCCTAGCTCACAACCTAACCAATGAGTCCTGCAAACTGACATGGTTTTCTCCAGAAGATGATGGAGGCTCTCCAATCACCAATTATGTCATTGAAAAGCGTGAATCTGACCGCAGAGCATGGACCCCAGTGACATATACAGTTACCCGACAAAATGCTACTGTCCAGGGTCTCATTCAAGGAAAAGCCTACTTTTTCCGAATTGCGGCTGAAAATAGTATTGGCATGGGTCCATTTGTTGAGACATCAGAGGCACTTGTTATCAGAGAGCCAATAA
>TTN-203,ENSE00003801753,1,303,309681,309983,CTGTACCAGAGCGTCCTGAAGACCTGGAAGTCAAAGAAGTTACTAAAAATACTGTAACTTTGACTTGGAATCCTCCTAAGTATGATGGTGGGTCAGAAATTATTAACTATGTCCTAGAAAGTCGGCTCATTGGGACTGAGAAGTTCCACAAAGTTACAAATGACAACTTGCTTAGCAGAAAATACACTGTTAAAGGCTTAAAAGAAGGTGATACCTATGAGTACCGTGTCAGTGCTGTCAACATTGTTGGACAAGGCAAACCATCATTTTGCACCAAACCAATTACTTGCAAGGATGAGCTGG
>TTN-203,ENSE00003807039,1,282,309984,310265,CACCCCCAACGCTTCACCTCGACTTCAGAGATAAGCTCACGATTCGAGTTGGTGAAGCTTTTGCCCTCACTGGCCGTTACTCAGGCAAACCAAAGCCTAAGGTTTCCTGGTTCAAAGATGAAGCTGATGTGCTGGAAGATGATCGCACTCATATAAAGACTACACCAGCAACACTTGCTTTAGAGAAGATCAAGGCCAAACGTTCAGATTCCGGCAAATACTGTGTGGTTGTGGAGAACAGTACAGGCTCTAGGAAAGGTTTCTGTCAAGTTAATGTTGTTG
>TTN-203,ENSE00003804106,1,300,310266,310565,ACCGTCCTGGACCACCAGTAGGACCAGTTAGTTTTGATGAGGTGACCAAAGATTACATGGTTATCTCTTGGAAGCCTCCTTTAGATGATGGAGGCAGTAAAATCACCAATTATATTATTGAGAAGAAGGAAGTGGGTAAAGACGTCTGGATGCCAGTGACATCTGCAAGTGCTAAAACAACATGCAAAGTTTCTAAACTACTTGAAGGAAAAGATTATATTTTCCGGATACATGCTGAAAATCTGTATGGAATAAGTGATCCTCTGGTGTCTGATTCAATGAAAGCCAAAGATCGTTTCA
>TTN-203,ENSE00003801817,1,303,310566,310868,GGGTTCCTGATGCACCTGATCAGCCAATTGTTACAGAAGTTACCAAAGACTCTGCATTAGTAACCTGGAATAAGCCACATGATGGAGGAAAACCCATCACAAACTACATCCTGGAAAAGAGAGAAACTATGTCTAAACGATGGGCTAGAGTTACCAAAGATCCTATTCATCCATACACTAAATTTAGGGTTCCTGATCTTCTAGAAGGATGTCAGTATGAATTCCGGGTTTCTGCAGAAAATGAAATTGGTATTGGAGATCCAAGCCCACCATCCAAACCAGTCTTTGCTAAAGATCCAATTG
>TTN-203,ENSE00003810564,1,309,310869,311177,CTAAACCAAGTCCACCTGTTAATCCTGAAGCAATAGATACAACATGCAATTCAGTCGATCTAACTTGGCAGCCACCACGTCATGATGGTGGGAGCAAGATTCTGGGTTATATTGTTGAGTACCAGAAAGTTGGAGATGAAGAGTGGAGAAGAGCCAATCACACCCCTGAGTCATGTCCTGAAACTAAATATAAAGTCACCGGTCTTCGGGACGGTCAAACCTATAAGTTTAGAGTGTTAGCAGTCAATGCAGCTGGTGAATCAGATCCAGCTCATGTTCCGGAGCCAGTCCTAGTAAAAGACAGGCTTG
>TTN-203,ENSE00003807476,1,282,311178,311459,AACCCCCTGAGTTGATTCTTGATGCCAACATGGCAAGAGAACAACACATTAAAGTTGGTGATACTCTAAGACTTAGTGCCATCATCAAAGGAGTGCCATTCCCAAAAGTAACTTGGAAAAAAGAAGACAGAGATGCTCCAACTAAAGCAAGAATTGATGTGACTCCAGTTGGTAGCAAGCTTGAAATTCGTAATGCTGCCCATGAAGATGGTGGAATTTATTCTTTAACAGTGGAGAATCCAGCTGGTTCAAAAACTGTCTCAGTAAAAGTACTTGTATTAG
>TTN-203,ENSE00003807363,1,300,311460,311759,ATAAACCTGGGCCACCTAGAGATCTGGAAGTCAGTGAAATTAGGAAAGATTCATGTTACCTTACTTGGAAAGAACCACTGGATGATGGTGGTTCTGTTATTACCAATTATGTGGTTGAGAGGAGAGATGTTGCCAGCGCCCAGTGGTCACCTCTCTCAGCTACATCAAAGAAAAAGAGTCACTTCGCTAAGCATCTGAATGAAGGCAACCAGTACCTCTTCCGAGTAGCTGCGGAGAACCAGTATGGACGTGGTCCTTTTGTTGAAACACCAAAACCAATCAAGGCTTTGGATCCTCTCC
>TTN-203,ENSE00003808994,1,294,311760,312053,ATCCCCCAGGGCCACCCAAGGACCTGCACCATGTAGATGTTGACAAGACTGAAGTCTCCCTAGTCTGGAATAAGCCGGATCGTGATGGTGGTTCTCCAATCACTGGATATTTGGTAGAATATCAAGAAGAAGGCACCCAGGACTGGATTAAATTTAAGACTGTGACAAACTTAGAGTGTGTGGTTACTGGACTACAACAAGGAAAGACCTATAGATTCCGTGTAAAAGCTGAAAACATTGTGGGTCTTGGTCTCCCTGACACAACTATCCCGATAGAATGTCAAGAAAAACTAG
>TTN-203,ENSE00003810188,1,2967,312054,315020,TGCCTCCATCCGTGGAGCTAGATGTGAAATTAATTGAAGGTCTTGTGGTAAAGGCTGGAACCACAGTCAGATTCCCTGCTATTATAAGAGGTGTGCCTGTTCCTACTGCAAAGTGGACAACCGATGGGAGTGAGATTAAAACCGATGAGCACTACACAGTTGAAACAGACAACTTCTCATCAGTACTTACCATTAAGAACTGCTTAAGGAGAGACACTGGGGAATATCAAATCACAGTTTCCAATGCAGCCGGTAGCAAAACAGTAGCCGTACATCTTACTGTTCTTGATGTTCCTGGGCCACCAACAGGTCCTATTAATATTCTGGATGTTACTCCTGAACACATGACTATCTCATGGCAGCCACCTAAGGATGATGGAGGAAGCCCTGTGATAAATTATATTGTTGAGAAACAAGATACAAGGAAAGACACGTGGGGTGTTGTCTCTTCCGGAAGCAGTAAGACAAAGCTGAAAATCCCACATCTGCAGAAGGGCTGTGAATATGTTTTCCGAGTTAGAGCAGAGAATAAGATAGGTGTTGGTCCTCCCCTTGACTCCACACCTACTGTTGCTAAGCATAAATTTAGTCCTCCGTCTCCTCCTGGTAAACCAGTGGTTACTGACATTACTGAAAATGCAGCAACAGTGTCTTGGACCCTGCCAAAATCTGATGGTGGCAGTCCAATAACTGGCTACTATATGGAACGTCGAGAAGTAACTGGCAAATGGGTGAGGGTCAACAAAACACCTATCGCTGACCTGAAGTTCAGAGTGACTGGACTCTATGAAGGAAATACATATGAGTTTAGAGTTTTTGCTGAAAATCTTGCAGGACTAAGCAAACCATCCCCAAGTTCTGATCCAATAAAAGCTTGCCGGCCCATCAAACCACCTGGACCACCTATTAATCCTAAACTGAAAGACAAGAGCAGAGAAACAGCTGATTTGGTGTGGACAAAGCCTCTCAGTGATGGTGGTAGCCCCATTCTAGGATATGTAGTGGAATGTCAGAAACCTGGCACAGCACAATGGAACAGGATTAATAAAGATGAACTCATTAGGCAATGTGCCTTTAGGGTACCTGGACTAATTGAAGGAAATGAGTACAGATTCCGTATAAAGGCAGCTAATATTGTAGGAGAGGGTGAGCCAAGAGAACTAGCAGAATCTGTGATTGCAAAAGATATCCTTCATCCTCCAGAAGTAGAACTTGATGTTACTTGTCGTGATGTTATTACCGTGAGAGTAGGCCAAACTATCCGCATTCTAGCTCGAGTCAAAGGCAGACCTGAACCAGACATAACTTGGACTAAGGAAGGCAAAGTATTGGTCCGAGAAAAGAGGGTGGACCTTATTCAGGATCTACCTCGTGTTGAGTTACAAATTAAAGAAGCTGTTAGAGCTGATCATGGCAAGTATATCATCTCAGCTAAGAACAGCAGTGGACATGCCCAAGGTTCAGCCATCGTTAACGTCCTTGACAGACCTGGGCCTTGCCAGAATTTGAAGGTTACCAATGTAACCAAAGAGAACTGTACAATTTCTTGGGAAAACCCACTAGATAATGGTGGCTCAGAAATAACAAACTTCATAGTAGAATATCGCAAACCAAACCAGAAAGGCTGGTCAATTGTTGCATCAGATGTCACTAAACGATTAATCAAGGCCAACCTTTTAGCCAACAATGAATACTATTTCCGAGTTTGTGCAGAGAATAAAGTAGGTGTTGGGCCAACCATCGAAACAAAAACTCCCATTCTGGCTATTAACCCTATTGACAGACCAGGTGAGCCTGAAAACCTTCACATTGCAGATAAAGGAAAGACATTTGTCTATCTAAAGTGGCGGAGGCCTGACTATGATGGTGGCAGTCCAAATCTGTCATATCATGTTGAGAGAAGGCTTAAGGGCTCCGATGACTGGGAAAGAGTGCATAAAGGAAGCATTAAAGAAACTCACTACATGGTTGACAGATGTGTTGAAAACCAGATTTATGAGTTCAGAGTGCAAACAAAGAATGAAGGTGGGGAAAGTGACTGGGTGAAGACAGAGGAAGTTGTTGTGAAAGAAGACTTACAAAAACCAGTACTTGATCTGAAATTAAGTGGGGTCCTAACTGTCAAAGCAGGGGACACCATTAGGCTTGAGGCAGGGGTTAGAGGCAAACCATTCCCAGAAGTTGCATGGACCAAGGACAAAGACGCTACAGACTTAACAAGATCACCAAGGGTCAAGATTGATACCCGTGCTGATTCATCTAAATTTTCTCTTACTAAAGCAAAGCGAAGTGATGGGGGTAAATATGTAGTTACGGCAACTAACACGGCTGGCAGTTTTGTGGCCTATGCCACTGTCAATGTTTTAGATAAGCCTGGTCCTGTGAGAAATCTGAAAATTGTTGATGTGTCCAGTGATAGGTGTACTGTTTGCTGGGATCCACCAGAAGATGATGGTGGCTGTGAAATCCAAAATTATATTCTAGAAAAATGTGAGACAAAGCGAATGGTTTGGTCTACCTATTCTGCTACTGTCTTGACACCTGGTACTACAGTAACACGTCTCATAGAAGGAAATGAATATATTTTCAGAGTCCGTGCAGAAAATAAAATAGGCACAGGGCCTCCAACAGAAAGTAAACCAGTCATAGCCAAAACCAAGTATGATAAACCTGGTCGCCCTGATCCCCCAGAAGTCACTAAAGTAAGCAAAGAAGAGATGACTGTGGTTTGGAATCCACCTGAATATGATGGTGGAAAGTCTATAACTGGATACTTTTTGGAGAAAAAGGAAAAGCATTCAACACGATGGGTCCCTGTCAACAAGAGTGCAATCCCTGAGAGACGTATGAAAGTACAGAATCTCCTCCCAGACCATGAATATCAGTTCCGTGTCAAGGCAGAAAATGAAATTGGAATTGGAGAACCAAGCTTGCCTTCAAGACCGGTGGTGGCAAAAGACCCCATAG
>TTN-203,ENSE00003811401,1,321,315021,315341,AGCCACCTGGTCCACCAACCAATTTCAGAGTGGTTGATACAACCAAACATTCCATAACTCTTGGGTGGGGAAAACCAGTCTATGATGGTGGTGCACCGATCATTGGATATGTTGTGGAAATGAGACCAAAAATAGCAGATGCGTCTCCTGATGAAGGCTGGAAACGGTGTAATGCTGCAGCACAGCTTGTACGCAAGGAATTCACTGTTACCAGCTTGGATGAAAACCAGGAATATGAGTTCAGGGTGTGTGCCCAAAACCAAGTTGGTATTGGGCGCCCTGCAGAGCTAAAGGAAGCTATCAAACCTAAAGAAATACTAG
>TTN-203,ENSE00003805661,1,285,315342,315626,AACCTCCGGAGATTGATTTGGATGCCAGCATGAGGAAACTGGTCATAGTGAGAGCAGGATGCCCTATTCGTCTCTTTGCTATAGTGAGAGGACGACCAGCCCCTAAAGTCACTTGGCGAAAAGTTGGCATTGATAATGTGGTCAGAAAAGGACAAGTTGATCTGGTTGACACTATGGCCTTCCTTGTCATCCCCAATTCTACCCGTGATGACTCAGGAAAATATTCCTTAACACTTGTGAACCCAGCAGGAGAAAAGGCTGTATTCGTAAATGTCAGAGTATTAG
>TTN-203,ENSE00003804742,1,300,315627,315926,ACACTCCTGGGCCTGTGTCTGATTTAAAAGTTTCAGATGTCACTAAAACATCATGCCATGTGTCCTGGGCCCCTCCTGAAAACGACGGTGGGAGCCAAGTGACACATTATATCGTGGAGAAACGTGAGGCAGACAGAAAGACATGGTCGACCGTTACCCCAGAAGTTAAGAAAACAAGCTTCCATGTAACCAATCTTGTCCCTGGGAATGAGTATTACTTCAGAGTAACTGCTGTCAACGAATATGGCCCTGGCGTCCCAACAGATGTCCCAAAACCAGTGCTTGCATCAGATCCTCTAA
>TTN-203,ENSE00003810357,1,303,315927,316229,GTGAGCCGGATCCCCCAAGGAAATTAGAAGTGACTGAAATGACCAAGAACAGTGCCACCTTAGCCTGGTTACCTCCCCTACGTGATGGAGGTGCTAAAATCGATGGCTACATCACTAGTTACAGAGAAGAAGAGCAGCCTGCAGATCGCTGGACAGAGTACTCAGTGGTAAAAGATCTGAGCCTTGTTGTCACTGGCCTAAAGGAAGGAAAGAAATACAAATTTAGAGTAGCGGCCAGAAATGCTGTTGGAGTCAGTTTGCCAAGAGAAGCTGAAGGAGTGTATGAAGCCAAAGAACAACTGT
>TTN-203,ENSE00003801707,1,276,316230,316505,TGCCACCAAAGATCCTTATGCCAGAGCAAATAACTATCAAAGCTGGGAAAAAACTCCGAATTGAAGCCCATGTGTATGGAAAGCCTCATCCCACCTGTAAATGGAAAAAAGGAGAAGATGAAGTTGTCACATCCAGCCACCTGGCAGTGCATAAAGCAGACAGCTCTTCAATTCTGATCATAAAAGATGTGACTAGGAAAGACAGTGGTTACTACAGCCTCACAGCAGAGAACAGTTCTGGGACAGACACTCAGAAAATCAAAGTTGTAGTCATGG
>TTN-203,ENSE00003810399,1,300,316506,316805,ATGCCCCCGGCCCCCCTCAGCCTCCATTTGACATTTCTGATATAGACGCTGATGCTTGCTCCCTGTCATGGCACATCCCTCTGGAGGACGGAGGCAGTAACATCACCAATTATATAGTGGAGAAGTGTGATGTAAGCCGAGGTGACTGGGTCACGGCTCTAGCTTCAGTCACAAAAACTTCCTGCAGGGTTGGAAAGCTGATCCCAGGCCAGGAGTACATCTTCCGGGTCCGTGCTGAAAACCGATTTGGCATTTCAGAGCCTCTCACATCTCCAAAGATGGTTGCGCAGTTCCCATTTG
>TTN-203,ENSE00003810448,1,303,316806,317108,GTGTTCCTAGTGAACCAAAGAATGCACGAGTCACCAAAGTCAACAAGGACTGTATTTTTGTTGCTTGGGACAGACCAGATAGTGATGGAGGGAGCCCCATTATTGGTTATCTGATTGAACGCAAGGAAAGAAACAGTTTGCTGTGGGTGAAAGCCAATGATACTCTTGTCCGGTCAACTGAATATCCTTGTGCTGGCCTTGTAGAAGGTCTTGAGTATTCATTCAGAATCTATGCCCTAAACAAAGCTGGATCCAGCCCACCCAGCAAACCCACAGAATATGTAACTGCAAGAATGCCAGTTG
>TTN-203,ENSE00003802505,1,300,317109,317408,ATCCTCCTGGGAAACCTGAGGTTATTGATGTCACCAAGAGTACTGTATCTCTGATCTGGGCTCGTCCAAAGCATGATGGAGGCAGTAAAATTATTGGCTATTTCGTAGAAGCTTGCAAACTTCCTGGTGATAAATGGGTACGGTGCAATACTGCACCTCACCAGATTCCCCAGGAAGAGTACACAGCTACTGGCCTAGAAGAGAAAGCTCAGTATCAATTTAGAGCTATTGCCAGGACCGCGGTAAACATTAGCCCACCTTCTGAACCTTCTGATCCAGTGACTATCCTCGCAGAAAATG
>TTN-203,ENSE00003806397,1,288,317409,317696,TCCCTCCCAGGATAGACCTGAGTGTGGCTATGAAATCTTTGCTTACTGTGAAAGCTGGAACTAATGTCTGCTTGGATGCTACTGTTTTTGGTAAACCGATGCCAACAGTTTCTTGGAAAAAAGATGGCACACTGCTAAAACCAGCAGAAGGCATAAAGATGGCCATGCAGCGGAATCTGTGCACCTTGGAGCTATTCAGCGTGAACCGGAAGGACTCAGGAGACTATACCATTACTGCTGAAAATTCAAGTGGTTCTAAATCAGCCACCATTAAGCTTAAAGTGTTAG
>TTN-203,ENSE00003807889,1,297,317697,317993,ATAAACCGGGTCCTCCAGCATCTGTTAAAATCAACAAAATGTATTCAGATCGTGCTATGCTTTCTTGGGAACCGCCTCTTGAAGATGGAGGCTCAGAAATCACCAACTATATTGTTGACAAACGTGAAACAAGCAGGCCCAACTGGGCTCAAGTCTCTGCAACTGTGCCTATCACCAGCTGCAGCGTGGAGAAACTTATAGAGGGCCATGAGTATCAGTTCCGTATTTGTGCTGAAAATAAATATGGAGTAGGCGATCCAGTCTTCACTGAACCAGCAATTGCCAAAAACCCATATG
>TTN-203,ENSE00003811290,1,303,317994,318296,ACCCACCAGGACGCTGTGATCCTCCTGTTATTAGCAACATAACCAAAGATCACATGACAGTCAGCTGGAAGCCACCAGCAGATGATGGGGGCTCACCCATCACTGGCTATTTGCTTGAAAAGCGGGAAACCCAGGCTGTTAACTGGACTAAGGTCAACAGAAAACCTATTATAGAAAGAACATTAAAAGCAACAGGTCTTCAAGAAGGTACCGAATATGAGTTCCGTGTTACAGCTATAAATAAAGCTGGACCAGGCAAACCCAGTGACGCATCCAAGGCCGCTTATGCTCGGGACCCTCAGT
>TTN-203,ENSE00003808853,1,306,318297,318602,ATCCTCCTGGCCCACCGGCTTTCCCTAAAGTATATGATACAACTCGCAGCTCTGTGAGTCTATCTTGGGGCAAGCCAGCCTATGACGGCGGCAGCCCTATCATTGGTTATCTCGTTGAAGTAAAACGGGCTGACTCCGATAACTGGGTGAGGTGCAACTTACCACAGAATCTACAGAAAACCCGCTTTGAGGTTACTGGCCTGATGGAAGACACACAATATCAATTCCGTGTGTATGCCGTTAATAAGATTGGATACAGTGACCCCAGTGATGTGCCAGATAAACACTATCCCAAGGACATCTTAA
>TTN-203,ENSE00003807542,1,288,318603,318890,TTCCACCTGAGGGAGAACTTGATGCGGACTTAAGGAAGACACTCATATTACGTGCTGGAGTTACTATGAGACTATATGTACCAGTAAAAGGACGCCCACCTCCAAAGATTACTTGGTCTAAACCAAATGTCAATCTAAGAGACAGGATTGGACTGGACATAAAGTCAACTGACTTTGACACTTTCTTGCGCTGTGAAAATGTGAACAAATATGATGCAGGAAAATATATCTTAACCCTGGAGAACAGCTGTGGTAAAAAGGAATATACCATTGTTGTGAAAGTGCTTG
>TTN-203,ENSE00003810775,1,291,318891,319181,ATACTCCTGGGCCACCTGTCAATGTGACTGTTAAGGAAATATCCAAAGACTCTGCTTATGTTACCTGGGAGCCTCCCATTATTGATGGCGGAAGCCCCATCATAAACTATGTGGTACAAAAACGTGATGCAGAGAGGAAATCCTGGTCTACAGTGACAACTGAGTGCTCCAAAACAAGCTTCAGAGTAGCTAATTTGGAGGAGGGAAAATCCTACTTCTTCCGAGTGTTTGCTGAAAATGAGTATGGCATTGGTGATCCCGGTGAAACTCGTGATGCTGTCAAAGCTTCCC
>TTN-203,ENSE00003811210,1,288,319182,319469,AAACTCCTGGACCAGTTGTGGACCTGAAAGTGAGGTCTGTATCTAAGTCATCCTGTAGCATTGGCTGGAAAAAGCCTCACAGTGATGGTGGAAGTCGGATTATTGGATATGTAGTTGATTTCCTGACTGAAGAAAATAAGTGGCAACGAGTTATGAAATCCTTAAGCCTACAGTACTCTGCAAAAGATTTGACTGAAGGGAAGGAATATACCTTCAGAGTGAGTGCTGAGAATGAAAATGGAGAAGGAACCCCAAGCGAAATCACTGTTGTGGCAAGGGATGATGTTG
>TTN-203,ENSE00003805436,1,588,319470,320057,TGGCTCCTGATCTTGACTTAAAGGGTCTACCTGATTTGTGCTACTTGGCTAAAGAAAACAGCAACTTCCGGCTTAAGATCCCCATAAAAGGCAAGCCAGCTCCATCAGTCTCCTGGAAGAAAGGGGAAGATCCTCTAGCAACTGACACTAGAGTCAGTGTTGAGTCATCTGCGGTTAACACAACTCTTATAGTGTACGATTGCCAAAAATCTGATGCTGGAAAATACACAATCACACTTAAGAATGTTGCTGGCACCAAGGAAGGAACTATCTCCATAAAGGTTGTTGGCAAGCCTGGCATCCCCACTGGACCAATCAAATTTGATGAAGTCACAGCAGAAGCCATGACCTTAAAGTGGGCTCCTCCAAAGGATGATGGAGGTTCTGAAATCACCAACTATATCCTAGAGAAGAGGGATTCTGTGAACAACAAGTGGGTGACGTGCGCCTCAGCTGTCCAGAAAACCACCTTTAGAGTAACCAGACTTCATGAGGGCATGGAATATACCTTCAGGGTCAGTGCCGAAAATAAATATGGTGTAGGGGAAGGCCTGAAATCGGAGCCAATTGTTGCGAGACATCCATTTG
>TTN-203,ENSE00003808777,1,105,320058,320162,ATGTGCCTGATGCTCCCCCACCTCCCAATATTGTGGATGTCAGACACGATTCAGTATCTCTAACTTGGACTGACCCCAAGAAAACTGGTGGTTCTCCAATTACAG
>TTN-203,ENSE00003806939,1,198,320163,320360,GGTATCATCTCGAGTTCAAGGAAAGAAACAGCCTTTTGTGGAAGAGAGCTAACAAGACTCCGATAAGGATGAGAGACTTTAAAGTGACAGGATTAACTGAAGGTCTTGAATATGAATTCCGAGTTATGGCAATCAATTTAGCAGGTGTGGGCAAGCCAAGCCTACCATCAGAGCCTGTTGTGGCACTGGACCCAATTG
>TTN-203,ENSE00003811024,1,297,320361,320657,ATCCTCCTGGAAAACCTGAGGTTATTAACATAACAAGGAATTCAGTGACTCTCATTTGGACTGAACCTAAATATGACGGTGGTCATAAGTTAACTGGATATATAGTGGAGAAGCGAGATCTACCTTCGAAGTCTTGGATGAAAGCCAACCATGTTAATGTCCCAGAATGTGCCTTTACTGTAACTGACCTTGTTGAGGGTGGAAAATATGAATTCAGAATTAGAGCAAAGAATACAGCAGGTGCTATCAGTGCTCCATCAGAAAGTACAGAAACCATTATTTGCAAGGATGAATACG
>TTN-203,ENSE00003803896,1,588,320658,321245,AGGCACCAACAATTGTCCTTGATCCCACAATAAAAGATGGGCTAACAATTAAAGCAGGGGATACCATTGTTTTGAATGCCATTAGCATTCTTGGCAAACCCCTTCCAAAATCAAGTTGGTCCAAGGCAGGAAAAGACATTAGACCATCAGATATCACTCAGATAACTTCAACCCCAACATCTTCCATGCTTACTATCAAGTATGCCACTAGAAAAGATGCGGGTGAATATACCATCACTGCTACCAATCCTTTTGGCACGAAGGTGGAACATGTGAAGGTAACAGTCCTTGATGTACCTGGTCCCCCAGGTCCTGTTGAAATCAGTAATGTTTCTGCTGAAAAAGCAACACTTACATGGACACCTCCCTTGGAAGATGGCGGCTCACCAATTAAGTCCTATATACTTGAAAAGAGAGAAACCAGCCGACTTTTGTGGACAGTGGTTTCTGAAGATATTCAGTCTTGCAGGCATGTGGCAACCAAACTTATCCAAGGAAATGAGTACATCTTCCGGGTCTCAGCTGTAAACCACTATGGCAAAGGAGAACCTGTACAGTCTGAACCTGTCAAAATGGTAGACAGATTTG
>TTN-203,ENSE00003807419,1,303,321246,321548,GTCCCCCTGGCCCTCCTGAAAAACCAGAGGTATCAAATGTCACTAAGAACACTGCCACTGTCAGCTGGAAAAGGCCAGTGGATGATGGTGGCAGCGAAATTACAGGATATCATGTAGAAAGGAGAGAAAAGAAAAGCCTGCGATGGGTGAGAGCAATAAAAACACCAGTTTCCGATCTCAGGTGCAAAGTAACAGGACTGCAAGAAGGAAGCACCTACGAATTCCGTGTCAGTGCAGAAAACAGAGCAGGAATTGGTCCACCCAGTGAGGCTTCAGATTCTGTTCTGATGAAAGATGCAGCAT
>TTN-203,ENSE00003811193,1,17106,321549,338654,ATCCTCCAGGACCACCTTCAAATCCGCATGTCACTGATACTACCAAGAAATCTGCTTCTTTGGCATGGGGCAAGCCTCATTATGATGGTGGACTTGAAATCACTGGCTATGTCGTGGAGCATCAAAAAGTAGGAGACGAGGCCTGGATAAAAGATACCACAGGAACCGCCCTCAGAATCACTCAGTTCGTTGTTCCTGATCTTCAGACTAAAGAAAAATACAACTTCAGAATCAGTGCCATCAACGATGCAGGTGTTGGGGAGCCAGCGGTGATTCCAGATGTTGAAATCGTAGAACGGGAGATGGCTCCTGATTTTGAACTAGATGCCGAGCTTCGAAGAACACTTGTTGTTAGAGCAGGACTCAGTATTAGGATATTTGTGCCAATTAAAGGTCGTCCTGCTCCTGAAGTGACATGGACCAAAGATAACATCAACCTGAAAAACCGAGCCAACATTGAAAATACGGAATCATTTACTCTTCTGATTATCCCAGAATGTAACAGATATGATACCGGTAAATTTGTCATGACCATTGAAAACCCGGCTGGGAAGAAAAGTGGCTTTGTGAACGTCAGAGTCTTGGACACGCCAGGCCCAGTCCTCAACCTGCGGCCTACAGACATCACAAAGGACAGTGTCACCCTGCACTGGGACCTCCCTCTGATAGATGGAGGCTCACGTATAACAAACTACATTGTAGAGAAACGTGAAGCAACACGGAAATCTTATTCCACAGCCACCACTAAGTGCCATAAATGCACATATAAAGTTACCGGCTTGTCTGAAGGGTGTGAATATTTCTTCAGAGTGATGGCAGAGAATGAATATGGAATTGGTGAGCCAACAGAAACTACAGAGCCCGTAAAAGCCTCTGAAGCACCATCTCCACCAGACAGCCTTAACATCATGGACATAACTAAGAGCACCGTCAGCCTGGCATGGCCTAAGCCCAAACACGATGGTGGCAGCAAGATCACTGGCTATGTGATTGAAGCCCAAAGAAAAGGCTCTGACCAGTGGACCCACATCACAACCGTGAAAGGGTTAGAATGTGTTGTGAGGAATCTAACTGAAGGAGAGGAATATACCTTCCAAGTGATGGCAGTGAACAGCGCGGGGAGAAGTGCCCCTAGAGAAAGCAGACCCGTCATTGTCAAGGAGCAGACAATGCTTCCAGAGCTGGATCTCCGTGGCATCTATCAGAAACTGGTCATTGCCAAAGCTGGTGACAACATCAAAGTTGAAATTCCAGTGCTCGGTCGACCGAAGCCCACAGTGACATGGAAAAAAGGAGACCAAATTCTTAAACAGACACAGAGAGTTAATTTTGAAACCACAGCGACTTCAACCATTTTAAATATCAATGAGTGTGTCAGAAGTGATAGTGGGCCCTATCCATTAACAGCAAGGAACATTGTAGGAGAGGTTGGTGATGTCATCACCATTCAAGTCCATGATATCCCAGGGCCACCTACTGGACCAATCAAATTTGATGAAGTTTCATCTGATTTTGTAACCTTCTCTTGGGACCCACCTGAGAACGATGGTGGTGTACCAATAAGCAACTATGTAGTGGAAATGCGGCAGACTGACAGTACTACCTGGGTTGAGTTAGCAACCACCGTTATACGTACTACCTATAAAGCCACCCGCCTTACTACTGGATTAGAGTATCAGTTCCGTGTAAAAGCTCAGAATAGATATGGAGTTGGACCAGGCATCACATCAGCATGCATAGTTGCCAACTATCCATTTAAGGTTCCTGGACCTCCTGGTACCCCTCAGGTAACTGCAGTTACCAAGGATTCAATGACAATTAGCTGGCATGAGCCACTTTCTGATGGTGGAAGCCCCATTTTAGGATATCATGTTGAAAGAAAAGAACGAAATGGTATTCTCTGGCAGACTGTGAGCAAAGCTTTAGTACCAGGCAACATTTTCAAATCAAGTGGACTTACAGATGGTATTGCTTATGAGTTCCGGGTGATTGCAGAAAACATGGCAGGCAAAAGTAAGCCAAGCAAGCCATCAGAACCTATGTTGGCTCTGGATCCCATTGACCCACCTGGAAAACCAGTACCTCTAAATATTACAAGACACACAGTAACACTTAAATGGGCTAAGCCTGAATATACTGGGGGCTTTAAAATTACCAGTTATATCGTTGAAAAGAGAGACCTTCCTAATGGACGGTGGCTGAAGGCCAACTTCAGCAACATTTTGGAGAATGAATTTACAGTCAGTGGCCTAACAGAAGATGCTGCATATGAATTCCGTGTGATCGCCAAAAATGCTGCAGGTGCCATCAGTCCACCATCTGAGCCATCTGATGCTATCACTTGCAGGGATGATGTTGAGGCACCAAAGATAAAGGTGGATGTTAAATTTAAGGACACGGTTATATTAAAAGCAGGTGAAGCATTCAGACTGGAAGCTGATGTTTCAGGCCGCCCACCTCCAACAATGGAATGGAGCAAAGATGGAAAAGAGCTGGAAGGCACAGCAAAGTTAGAAATAAAAATTGCAGATTTCTCTACTAATCTGGTAAACAAAGATTCAACAAGAAGGGATAGTGGTGCCTATACCCTTACAGCGACTAATCCTGGTGGCTTTGCTAAACACATTTTCAATGTCAAAGTTCTTGACAGACCAGGCCCACCTGAAGGACCTTTGGCTGTAACTGAAGTGACATCAGAAAAGTGTGTACTATCATGGTTCCCTCCACTGGATGATGGAGGTGCCAAAATTGATCATTACATAGTACAGAAACGTGAAACCAGCAGATTGGCATGGACAAATGTAGCCTCAGAAGTCCAAGTAACAAAGCTAAAGGTCACTAAACTCTTGAAAGGCAATGAATACATATTCCGTGTCATGGCTGTAAATAAATATGGAGTGGGAGAGCCACTGGAATCAGAGCCTGTGCTTGCAGTGAATCCTTATGGACCCCCTGATCCGCCCAAAAACCCTGAAGTGACAACTATTACTAAAGATTCGATGGTTGTCTGCTGGGGACATCCTGATTCTGATGGTGGAAGTGAAATCATCAATTATATTGTGGAACGGCGTGATAAAGCTGGCCAACGCTGGATTAAATGCAACAAAAAAACTCTTACTGATTTAAGATATAAAGTGTCTGGACTGACAGAAGGACATGAATATGAGTTCAGGATTATGGCTGAAAATGCTGCTGGAATTAGTGCACCAAGTCCTACCAGTCCATTTTACAAGGCTTGTGACACTGTGTTTAAACCTGGACCACCAGGTAACCCACGTGTTCTGGATACAAGCAGATCATCCATTTCAATCGCTTGGAATAAACCTATCTATGATGGTGGTTCAGAAATCACTGGGTATATGGTTGAGATTGCCCTGCCAGAGGAAGATGAATGGCAGATTGTCACTCCACCAGCAGGACTCAAGGCAACTTCGTATACTATCACTGGCCTCACAGAGAATCAGGAATATAAGATCCGCATCTATGCCATGAATTCCGAAGGACTTGGGGAACCTGCCCTTGTTCCTGGAACTCCAAAGGCTGAAGACAGAATGCTGCCTCCAGAAATTGAACTGGATGCTGACCTGCGCAAAGTTGTTACTATAAGGGCCTGCTGCACCCTGAGACTTTTTGTTCCCATCAAAGGAAGGCCTGCACCTGAGGTGAAGTGGGCCCGGGACCATGGAGAATCTTTAGATAAAGCTAGCATCGAATCCACAAGCTCTTACACCCTGCTTATTGTTGGAAATGTAAACAGATTTGACAGTGGCAAATATATACTAACTGTAGAAAATAGTTCAGGCAGCAAGTCTGCATTTGTCAATGTTAGAGTTCTCGATACACCAGGCCCCCCACAGGATCTGAAGGTAAAAGAGGTCACTAAGACATCTGTCACACTCACATGGGACCCACCTCTCCTTGATGGAGGTTCAAAAATCAAGAACTATATTGTTGAAAAGCGGGAATCAACAAGAAAAGCATATTCAACTGTTGCAACAAACTGCCACAAGACTTCCTGGAAGGTAGACCAGCTTCAAGAAGGCTGTAGCTACTATTTCAGGGTTCTCGCAGAAAATGAATATGGCATTGGGCTGCCTGCTGAAACCGCAGAATCTGTGAAAGCATCAGAACGACCTCTTCCTCCAGGAAAAATAACTTTGATGGATGTCACAAGAAATAGTGTGTCACTCTCTTGGGAGAAACCAGAGCATGATGGAGGCAGCCGAATTCTAGGCTACATTGTGGAGATGCAGACCAAAGGCAGTGACAAATGGGCCACGTGTGCCACAGTCAAGGTCACTGAAGCCACTATCACTGGATTAATTCAGGGTGAAGAATACTCTTTCCGTGTTTCAGCTCAGAATGAAAAGGGCATCAGTGATCCTAGACAACTGAGTGTGCCAGTGATCGCCAAAGATCTTGTCATTCCACCAGCCTTCAAACTCCTGTTCAATACTTTCACTGTACTGGCAGGTGAAGACCTAAAAGTTGATGTTCCATTCATTGGCCGCCCTACCCCAGCTGTAACCTGGCATAAAGATAATGTACCACTGAAGCAGACAACTAGAGTAAATGCAGAGAGCACAGAAAATAATTCACTACTGACAATAAAGGACGCCTGCCGAGAAGATGTTGGCCATTATGTGGTTAAACTGACTAACTCAGCTGGTGAAGCTATTGAAACCCTTAATGTTATCGTTCTTGACAAACCAGGGCCTCCAACTGGACCAGTTAAAATGGATGAAGTGACAGCTGATAGTATTACTCTTTCCTGGGGCCCACCCAAGTATGATGGTGGAAGTTCTATCAATAATTACATTGTTGAGAAACGGGACACTTCCACAACCACCTGGCAAATTGTATCAGCTACAGTTGCAAGGACAACAATAAAGGCTTGCAGACTGAAGACTGGATGTGAATATCAGTTTAGAATTGCAGCTGAAAACAGATATGGGAAGAGTACCTACCTCAATTCAGAGCCTACTGTAGCCCAATATCCATTCAAAGTTCCTGGTCCTCCTGGCACTCCAGTTGTCACACTGTCCTCCAGGGACAGCATGGAAGTACAATGGAATGAGCCAATCAGTGATGGAGGAAGTAGAGTCATTGGCTATCATCTAGAACGCAAGGAAAGAAATAGCATCCTCTGGGTTAAGTTGAATAAAACACCTATTCCTCAAACCAAGTTTAAGACAACTGGCCTTGAAGAAGGTGTTGAATATGAATTTAGAGTCTCTGCAGAGAACATCGTGGGCATTGGCAAGCCGAGTAAAGTATCAGAATGTTATGTGGCTCGTGACCCATGTGATCCACCAGGACGGCCAGAGGCAATCATTGTCACAAGGAATTCTGTGACTCTTCAGTGGAAGAAACCCACCTATGACGGTGGAAGCAAGATCACTGGTTATATTGTTGAGAAGAAAGAATTACCTGAGGGCCGTTGGATGAAAGCCAGTTTTACAAATATTATTGACACTCATTTTGAAGTAACTGGCCTAGTTGAAGATCACAGATATGAGTTCCGGGTTATAGCCCGAAATGCCGCAGGAGTGTTTAGTGAGCCTTCAGAAAGCACAGGAGCAATAACAGCTAGAGATGAGGTAGATCCACCACGAATAAGTATGGATCCAAAATACAAAGACACAATCGTGGTTCATGCTGGTGAATCATTCAAGGTTGATGCAGATATTTATGGCAAACCAATACCAACCATTCAGTGGATAAAAGGTGATCAGGAGCTTTCAAACACAGCTCGATTAGAAATAAAGAGCACCGACTTTGCCACCAGTCTCAGTGTAAAAGATGCAGTACGTGTCGACAGTGGAAATTACATACTGAAGGCCAAAAATGTTGCAGGAGAAAGATCAGTTACTGTGAATGTCAAGGTTCTTGACAGACCAGGGCCACCTGAAGGACCTGTTGTTATCTCAGGAGTTACAGCAGAAAAATGCACACTAGCTTGGAAACCCCCACTTCAGGATGGTGGGAGTGACATCATAAATTATATTGTGGAAAGGAGAGAAACCAGCCGCTTAGTTTGGACTGTGGTTGATGCCAATGTGCAGACTCTCAGCTGCAAGGTTACTAAGCTTCTTGAAGGCAATGAATATACTTTCCGTATAATGGCAGTAAACAAATATGGTGTTGGTGAACCTCTTGAATCTGAGCCAGTAGTTGCCAAGAATCCATTTGTAGTACCAGATGCACCAAAAGCTCCAGAAGTCACAACAGTGACCAAGGACTCAATGATTGTTGTATGGGAAAGACCAGCATCTGATGGTGGTAGTGAAATTCTTGGATATGTTCTTGAGAAACGGGATAAAGAAGGCATTAGATGGACAAGATGCCATAAGCGTCTGATTGGAGAGTTGCGCCTGAGAGTAACTGGACTCATAGAAAATCACGATTATGAGTTCAGAGTTTCTGCTGAGAATGCTGCTGGACTTAGTGAACCAAGCCCTCCTTCTGCTTACCAAAAGGCTTGTGATCCTATTTATAAACCAGGACCCCCAAACAACCCCAAAGTCATAGACATAACCAGATCTTCAGTATTCCTTTCTTGGAGCAAACCAATATATGATGGTGGCTGTGAAATTCAAGGATACATTGTTGAAAAATGTGATGTGAGTGTTGGTGAATGGACAATGTGCACTCCACCAACAGGAATTAATAAAACAAACATAGAAGTAGAGAAGCTGTTGGAAAAGCATGAATACAACTTCCGTATCTGTGCTATTAATAAAGCTGGAGTTGGAGAACATGCTGACGTCCCTGGACCTATTATAGTTGAAGAAAAATTAGAAGCACCAGACATTGATCTTGACCTAGAACTAAGGAAAATCATAAATATAAGGGCAGGTGGCTCCTTAAGGTTATTTGTTCCTATAAAAGGTCGTCCTACACCAGAAGTTAAATGGGGAAAGGTGGATGGTGAAATCCGAGATGCAGCTATAATTGATGTCACTAGCAGTTTCACCTCTCTTGTTCTTGACAATGTCAACCGATATGATAGTGGAAAATATACGCTTACATTAGAAAACAGCAGTGGAACAAAGTCTGCCTTTGTTACTGTGAGAGTTCTGGACACGCCAAGTCCACCTGTTAACCTGAAAGTCACAGAAATCACCAAAGACTCAGTATCAATTACATGGGAACCTCCTTTGTTGGATGGGGGATCCAAAATAAAAAATTACATTGTTGAGAAACGTGAAGCCACAAGAAAATCATATGCTGCTGTTGTAACTAACTGCCATAAGAATTCTTGGAAAATCGATCAGCTCCAAGAAGGTTGCAGTTATTACTTTAGAGTCACAGCTGAGAATGAGTATGGTATTGGCCTTCCTGCCCAGACTGCTGATCCAATTAAGGTTGCAGAAGTGCCACAACCTCCTGGAAAAATAACTGTGGATGATGTCACCAGAAACAGTGTCTCTCTGAGTTGGACAAAACCTGAACATGATGGTGGCAGTAAAATCATTCAGTATATTGTGGAAATGCAAGCTAAACACAGTGAGAAATGGTCAGAGTGTGCTCGAGTAAAGTCTCTTCAGGCAGTAATTACCAACCTAACTCAAGGGGAAGAATATCTTTTTAGAGTTGTTGCTGTAAATGAAAAGGGGAGAAGTGATCCTCGGTCCCTTGCAGTTCCAATAGTTGCCAAAGATCTGGTAATTGAGCCAGATGTAAAACCTGCATTCAGTAGTTACAGTGTACAGGTTGGCCAAGATTTGAAAATAGAAGTGCCAATTTCTGGACGTCCTAAGCCAACCATTACCTGGACTAAAGATGGTCTCCCACTGAAGCAGACCACAAGAATCAATGTTACCGATTCACTGGATCTCACCACACTCAGTATTAAAGAAACTCATAAGGATGATGGTGGACAATATGGAATCACAGTTGCCAATGTTGTTGGTCAGAAGACAGCATCCATCGAAATTGTAACTCTAGATAAACCTGATCCTCCAAAAGGACCTGTTAAATTTGATGACGTCAGTGCTGAAAGTATTACATTATCTTGGAACCCTCCATTATATACAGGGGGCTGCCAAATCACCAACTACATTGTTCAGAAAAGAGATACAACCACCACAGTATGGGATGTTGTTTCTGCTACTGTTGCTAGAACTACACTCAAAGTGACCAAACTGAAAACTGGTACAGAATACCAATTTAGAATATTTGCCGAAAACAGATATGGACAAAGCTTTGCCTTAGAGTCTGATCCAATTGTAGCTCAATATCCCTACAAAGAACCAGGCCCTCCAGGTACACCATTTGCCACAGCCATTTCCAAAGACTCCATGGTCATACAGTGGCATGAACCAGTCAACAATGGTGGAAGCCCCGTCATAGGTTACCACCTGGAGAGAAAAGAAAGAAACAGTATTTTGTGGACAAAGGTCAACAAAACTATTATTCATGACACCCAATTCAAAGCACAGAATCTTGAAGAAGGCATTGAATATGAATTCAGAGTGTATGCTGAAAATATTGTTGGTGTAGGCAAAGCAAGCAAGAATTCTGAATGCTATGTAGCCAGAGATCCCTGTGACCCACCAGGAACCCCAGAACCAATAATGGTTAAAAGAAATGAAATCACTTTACAGTGGACCAAACCTGTGTATGATGGTGGAAGTATGATTACAGGCTACATTGTAGAGAAACGTGATTTGCCTGATGGTCGTTGGATGAAAGCTAGCTTTACAAATGTCATTGAAACTCAATTTACTGTGTCAGGTCTTACTGAAGATCAAAGATATGAATTCAGAGTCATTGCAAAGAATGCAGCTGGTGCAATAAGTAAACCCTCTGACAGTACTGGACCAATAACTGCCAAGGATGAGGTTGAACTCCCAAGAATTTCAATGGATCCAAAATTCAGAGACACAATTGTGGTAAATGCTGGAGAAACATTCAGACTTGAGGCTGATGTCCATGGAAAGCCCCTACCTACCATTGAGTGGTTAAGAGGAGATAAGGAAATTGAAGAATCTGCTAGATGTGAAATAAAGAACACAGATTTCAAGGCTTTACTTATTGTAAAAGATGCAATTAGAATTGATGGTGGGCAGTATATTTTAAGAGCTTCCAATGTTGCAGGTTCTAAGTCATTCCCAGTAAATGTAAAAGTATTAGATAGACCAGGACCTCCAGAAGGGCCAGTCCAGGTTACTGGAGTCACTTCTGAAAAATGCTCTTTAACATGGTCTCCACCACTTCAAGATGGTGGCAGTGACATTTCTCACTATGTTGTTGAAAAGCGAGAAACCAGTCGACTTGCCTGGACTGTTGTTGCTTCAGAAGTTGTGACCAATTCTCTGAAAGTTACCAAACTCTTAGAAGGTAATGAATATGTTTTCCGTATAATGGCTGTCAACAAATATGGTGTTGGAGAGCCTTTGGAATCTGCACCAGTACTAATGAAAAATCCATTTGTGCTTCCTGGACCACCAAAAAGCTTGGAAGTCACAAATATTGCCAAAGACTCCATGACCGTCTGTTGGAACCGTCCAGATAGTGATGGTGGAAGTGAGATTATTGGTTACATTGTAGAGAAAAGAGACAGAAGTGGCATTCGATGGATAAAATGTAATAAACGCCGCATTACAGATTTGCGTCTAAGAGTGACAGGATTAACAGAAGATCATGAGTATGAATTCAGGGTCTCTGCAGAAAATGCTGCTGGAGTTGGGGAACCAAGTCCAGCTACAGTTTATTATAAAGCCTGTGATCCTGTGTTCAAACCTGGCCCACCTACCAATGCACACATTGTAGACACCACTAAAAATTCAATCACACTTGCCTGGGGTAAACCCATCTATGATGGCGGCAGTGAGATCTTGGGATATGTAGTAGAAATCTGTAAAGCAGATGAAGAAGAATGGCAAATAGTTACTCCACAGACTGGCCTGAGAGTCACTCGATTTGAAATTTCAAAACTCACTGAACACCAAGAGTATAAAATACGAGTCTGTGCCCTCAACAAAGTTGGTTTAGGTGAGGCTACATCAGTTCCTGGTACTGTGAAACCAGAAGATAAACTTGAAGCACCTGAACTTGACCTTGACTCCGAATTAAGAAAAGGAATTGTTGTAAGAGCTGGTGGATCTGCCAGAATTCACATTCCATTCAAAGGTCGTCCAACGCCTGAGATCACTTGGTCTCGAGAGGAAGGTGAATTCACAGATAAGGTCCAAATTGAAAAGGGAGTAAACTATACCCAACTATCAATAGATAACTGTGATAGAAATGATGCTGGAAAATACATTCTTAAGTTGGAAAACAGCAGTGGATCAAAGTCTGCTTTTGTAACTGTGAAAGTTCTTGACACTCCAGGACCACCACAGAATTTGGCAGTCAAAGAAGTGAGAAAAGATTCTGCCTTCCTGGTATGGGAGCCACCCATCATTGATGGAGGGGCAAAGGTCAAGAACTATGTGATTGACAAACGTGAGTCAACCAGAAAAGCGTATGCTAATGTGAGTAGTAAATGCAGCAAAACAAGTTTTAAAGTGGAAAACCTTACAGAAGGAGCCATTTATTACTTCAGAGTCATGGCTGAAAATGAATTTGGAGTTGGTGTTCCAGTGGAAACTGTTGATGCCGTGAAAGCTGCTGAACCTCCTTCCCCACCAGGAAAGGTTACACTCACTGATGTGTCCCAGACCAGTGCATCACTTATGTGGGAGAAACCTGAACATGATGGCGGTAGCAGAGTCCTGGGGTACGTTGTTGAAATGCAGCCCAAAGGAACTGAAAAATGGAGCATTGTGGCTGAATCCAAAGTCTGTAATGCAGTTGTTACTGGTTTGAGTTCTGGACAAGAATATCAGTTCCGTGTCAAGGCTTATAATGAGAAAGGAAAAAGCGATCCAAGAGTGTTGGGTGTTCCTGTCATAGCCAAGGACTTGACTATACAGCCTAGTTTAAAGTTACCATTTAACACATATAGTATCCAAGCTGGAGAAGATCTTAAAATAGAAATTCCAGTTATAGGCCGACCAAGACCTAACATTTCTTGGGTCAAAGATGGTGAGCCTCTTAAACAGACAACAAGAGTAAACGTTGAAGAAACAGCTACCTCAACTGTTTTGCACATTAAAGAAGGTAACAAAGATGACTTTGGAAAATACACCGTAACGGCAACAAATAGTGCAGGCACAGCAACAGAAAATCTCAGTGTTATCGTTTTAGAAAAGCCTGGACCTCCAGTTGGCCCAGTTCGGTTTGATGAAGTTAGTGCAGACTTTGTAGTCATATCTTGGGAACCTCCAGCCTATACTGGTGGCTGCCAAATAAGCAACTACATTGTAGAGAAGCGAGATACAACCACCACCACTTGGCACATGGTATCAGCAACAGTTGCAAGAACAACAATTAAAATAACCAAACTGAAAACAGGCACGGAGTACCAGTTTAGAATTTTTGCTGAAAACAGGTATGGAAAAAGTGCCCCACTGGATTCTAAGGCAGTTATTGTACAATATCCATTTAAAGAACCTGGACCACCTGGAACTCCTTTTGTGACATCAATCTCAAAAGATCAGATGCTTGTGCAATGGCATGAGCCAGTGAATGATGGAGGCACCAAAATTATTGGCTACCATCTTGAACAGAAAGAAAAGAACAGTATTTTATGGGTCAAGTTAAATAAGACCCCCATTCAGGACACCAAATTCAAAACAACTGGGCTTGATGAGGGCCTTGAGTATGAGTTCAAAGTTTCTGCTGAAAATATTGTTGGCATTGGCAAGCCTAGCAAAGTGTCAGAATGCTTTGTTGCTCGTGATCCATGTGACCCACCTGGTCGCCCTGAAGCCATTGTTATTACAAGAAACAATGTCACACTGAAATGGAAGAAACCTGCCTATGATGGTGGTAGCAAAATAACAGGTTATATTGTAGAAAAGAAAGATCTACCTGATGGCCGCTGGATGAAAGCCAGCTTTACCAACGTATTAGAAACTGAATTTACAGTGAGTGGACTTGTAGAAGACCAAAGATATGAATTTAGAGTAATTGCAAGAAATGCAGCTGGAAACTTTAGTGAACCATCTGATAGTAGTGGTGCCATTACTGCAAGAGATGAAATTGATGCACCAAATGCCTCTCTGGATCCAAAATATAAAGATGTCATCGTTGTTCATGCAGGAGAGACTTTTGTTCTTGAAGCCGACATCCGTGGCAAACCTATACCTGATGTTGTTTGGTCAAAAGATGGAAAAGAACTTGAAGAAACAGCTGCTAGAATGGAAATTAAATCTACTATTCAGAAAACAACTCTTGTTGTCAAAGACTGTATACGGACTGATGGAGGACAATATATTCTGAAACTCAGCAATGTTGGTGGTACAAAGTCTATACCCATCACTGTAAAGGTACTTGACAGGCCAGGGCCTCCTGAAGGGCCTCTGAAAGTTACTGGAGTTACTGCGGAAAAATGTTACCTGGCATGGAACCCACCTTTGCAAGATGGTGGTGCTAATATTTCACATTACATCATTGAAAAGAGGGAGACAAGCCGACTCTCTTGGACCCAGGTTTCAACTGAGGTACAGGCCCTTAACTACAAAGTTACTAAACTTCTTCCTGGTAATGAGTACATTTTCCGTGTCATGGCTGTGAATAAATATGGAATTGGAGAGCCCTTGGAATCTGGGCCTGTTACGGCCTGTAATCCTTATAAGCCACCAGGTCCTCCCTCAACACCTGAAGTCTCAGCAATCACCAAAGATTCTATGGTAGTAACATGGGCACGCCCAGTAGACGACGGAGGTACCGAAATTGAGGGCTACATTCTTGAAAAACGAGATAAGGAAGGCGTTAGATGGACCAAGTGCAACAAGAAAACATTAACGGATCTGCGGCTCAGGGTAACTGGTCTTACCGAAGGCCATTCCTATGAATTCAGAGTTGCTGCTGAAAATGCAGCTGGTGTGGGAGAACCTAGTGAGCCATCTGTTTTCTACCGTGCGTGTGATGCCTTGTATCCACCAGGTCCCCCAAGCAATCCAAAAGTGACGGACACTTCCAGATCTTCTGTCTCCCTGGCATGGAGTAAGCCAATTTATGATGGTGGCGCACCTGTTAAAGGCTATGTTGTAGAGGTCAAAGAAGCTGCTGCGGATGAATGGACAACCTGCACTCCACCAACAGGATTACAAGGAAAGCAGTTCACAGTGACCAAGCTTAAAGAAAACACTGAATATAACTTCCGTATTTGTGCCATCAATTCTGAAGGTGTAGGTGAACCTGCAACTCTACCTGGCTCAGTGGTTGCTCAGGAGAGGATAGAGCCACCAGAAATAGAACTCGATGCTGATCTCAGAAAGGTGGTCGTTCTGCGTGCAAGTGCTACTTTACGCTTATTTGTCACTATCAAAGGTCGACCAGAACCCGAAGTTAAATGGGAAAAGGCAGAAGGCATTCTCACTGACAGGGCTCAGATAGAGGTGACCAGCTCATTTACAATGTTGGTGATTGATAATGTTACCAGATTTGACAGTGGTCGGTATAATCTGACATTAGAAAATAATAGTGGCTCCAAAACAGCTTTTGTTAACGTCAGAGTTCTTGACTCACCAAGTGCCCCTGTGAATTTGACCATAAGAGAAGTGAAGAAAGACTCAGTGACGTTGTCCTGGGAACCACCACTTATTGATGGTGGAGCTAAGATTACAAACTACATTGTCGAAAAACGAGAAACTACAAGAAAAGCCTATGCTACCATTACAAATAATTGCACTAAAACTACTTTCAGAATTGAAAATCTACAAGAAGGATGTTCTTACTACTTCCGAGTCTTGGCTTCCAATGAATATGGGATTGGTTTGCCAGCTGAAACAACAGAACCCGTTAAAGTGTCTGAACCACCCCTCCCACCTGGAAGAGTAACTCTTGTTGATGTGACCCGTAATACAGCTACAATTAAGTGGGAGAAACCAGAAAGTGATGGTGGCAGCAAAATTACTGGTTATGTGGTTGAAATGCAGACTAAAGGGAGTGAAAAGTGGAGCACCTGCACACAAGTTAAGACTCTAGAAGCAACTATATCTGGCTTAACTGCAGGAGAAGAGTATGTCTTCAGGGTAGCTGCAGTTAACGAAAAGGGAAGAAGTGATCCAAGACAACTTGGAGTGCCAGTAATTGCAAGGGATATTGAAATAAAGCCTTCAGTTGAGCTTCCTTTCCATACTTTCAATGTAAAGGCTAGAGAACAACTTAAGATTGATGTGCCATTCAAAGGAAGACCTCAAGCTACTGTGAACTGGAGAAAAGATGGTCAGACTCTTAAAGAGACAACTAGAGTCAATGTTTCTTCTTCAAAGACTGTAACATCACTATCTATTAAGGAAGCTTCAAAGGAAGATGTTGGAACTTATGAATTATGTGTTTCAAACAGTGCTGGATCCATAACAGTTCCTATTACTATAATTGTCCTTGACAGACCAGGACCTCCAGGTCCTATACGTATTGATGAGGTTAGTTGTGACAGCATAACCATTTCTTGGAATCCTCCAGAATATGATGGTGGCTGCCAAATTAGCAATTACATTGTTGAAAAGAAAGAAACCACCTCTACAACATGGCACATAGTTTCACAAGCAGTTGCAAGAACATCCATTAAAATAGTTCGCCTGACAACAGGAAGTGAGTATCAGTTCCGTGTTTGTGCAGAAAACCGCTATGGAAAGAGCTCCTACAGTGAATCTTCAGCTGTTGTTGCAGAGTATCCATTCAGTCCCCCAGGTCCTCCTGGTACTCCTAAAGTTGTGCATGCCACAAAATCTACCATGCTTGTAACCTGGCAAGTGCCAGTTAATGATGGAGGAAGTCGAGTAATTGGCTATCATCTTGAGTATAAAGAAAGAAGCAGCATTCTTTGGTCAAAAGCAAATAAAATCCTCATTGCTGATACTCAAATGAAAGTCTCCGGCCTTGATGAAGGACTGATGTATGAGTATCGTGTATATGCTGAAAATATTGCTGGAATTGGTAAATGCAGTAAATCTTGTGAACCAGTCCCTGCAAGAGATCCTTGTGACCCTCCTGGACAACCTGAAGTCACAAATATCACAAGAAAATCAGTGTCACTTAAATGGTCTAAACCACATTATGATGGTGGAGCTAAGATCACAGGATACATTGTTGAACGCAGAGAACTACCAGATGGCCGGTGGCTGAAGTGCAATTATACTAATATACAAGAAACATACTTTGAAGTAACTGAACTTACTGAAGATCAGCGTTATGAATTCCGGGTTTTTGCAAGGAATGCTGCTGACTCAGTTAGTGAGCCATCTGAATCCACTGGGCCTATTATAGTTAAAGATGATGTTGAGCCTCCAAGAGTTATGATGGATGTCAAGTTCCGAGACGTTATTGTTGTCAAAGCTGGAGAGGTCCTTAAGATAAATGCAGACATTGCAGGGCGACCTCTGCCAGTAATTTCCTGGGCCAAGGATGGTATAGAAATTGAAGAAAGAGCAAGAACAGAAATCATCTCAACAGACAATCATACTTTGTTAACAGTTAAAGACTGTATAAGACGAGACACTGGGCAATATGTACTAACACTGAAGAATGTTGCCGGCACTCGGTCTGTGGCCGTTAATTGCAAAGTACTTGATAAGCCTGGTCCACCAGCAGGACCACTTGAAATAAATGGCCTCACTGCTGAGAAATGCTCTCTTTCCTGGGGACGTCCCCAAGAAGATGGTGGTGCAGATATCGACTATTACATCGTAGAAAAACGTGAAACAAGCCACCTTGCATGGACAATATGTGAAGGAGAGTTACAGATGACATCCTGTAAAGTAACCAAGTTACTCAAAGGCAATGAATATATATTTAGAGTAACTGGTGTTAATAAATATGGTGTTGGTGAGCCCCTAGAGAGTGTAGCTATAAAGGCACTAGATCCATTTACAGTTCCAAGTCCACCCACGTCTTTGGAAATTACTTCTGTGACCAAAGAATCTATGACACTTTGCTGGTCAAGACCCGAGAGTGATGGAGGTAGTGAAATATCTGGATATATAATTGAAAGGCGAGAGAAAAATAGCCTAAGATGGGTGCGTGTAAACAAAAAACCAGTTTATGATCTAAGAGTGAAATCAACAGGACTTCGGGAAGGATGTGAATATGAATATCGTGTTTATGCAGAAAATGCTGCTGGCCTAAGTCTTCCAAGTGAAACCTCTCCCTTAATTAGGGCAGAAGATCCAGTGTTCCTACCATCTCCTCCATCCAAACCCAAAATTGTGGACTCAGGCAAGACAACTATAACTATTGCCTGGGTTAAGCCGCTGTTTGATGGTGGGGCCCCGATAACTGGATATACTGTAGAATACAAAAAATCTGATGACACTGACTGGAAAACTTCCATTCAGAGCTTACGAGGGACAGAATATACAATAAGCGGACTAACAACAGGAGCTGAATATGTTTTCAGAGTAAAATCTGTCAATAAGGTTGGTGCTAGTGACCCCAGTGATAGCTCTGACCCTCAGATAGCAAAGGAAAGAGAAGAAGAACCTTTATTTGATATTGACAGTGAAATGAGGAAGACCTTGATTGTCAAGGCTGGTGCCTCATTTACCATGACTGTGCCTTTCCGAGGAAGACCAGTACCCAATGTCTTGTGGAGTAAGCCAGACACTGACCTCCGTACTAGAGCTTATGTTGATACCACAGACTCTCGTACATCACTGACCATTGAAAATGCCAACAGAAATGACTCTGGAAAGTACACATTAACAATTCAGAATGTTTTGAGTGCTGCTTCACTGACCTTAGTTGTCAAAGTTTTAGATACCCCAGGTCCTCCAACCAACATTACTGTGCAAGATGTAACCAAAGAGTCTGCAGTGTTATCCTGGGATGTTCCTGAAAACGATGGTGGAGCACCAGTGAAGAATTACCACATAGAAAAACGTGAGGCCAGCAAGAAAGCATGGGTCTCTGTGACCAACAACTGTAACCGCCTCTCCTACAAAGTTACCAATTTACAAGAAGGAGCTATCTATTACTTCAGAGTCTCTGGAGAAAATGAGTTTGGTGTTGGTATACCAGCTGAAACAAAGGAAGGAGTAAAAATAACAG
>TTN-203,ENSE00003802597,1,297,338655,338951,AAAAACCAAGCCCACCTGAAAAACTTGGAGTAACAAGTATATCCAAAGACAGTGTTTCCCTGACCTGGCTGAAGCCTGAACATGATGGCGGAAGCAGAATTGTACACTATGTCGTTGAAGCACTAGAAAAAGGACAGAAAAACTGGGTTAAATGTGCAGTGGCAAAGTCAACCCATCACGTTGTTTCCGGTCTGAGAGAGAATTCTGAATACTTTTTCCGAGTGTTTGCTGAAAATCAAGCTGGCCTGAGTGACCCGAGAGAGCTTCTGCTTCCTGTTCTTATTAAGGAGCAACTAG
>TTN-203,ENSE00003802941,1,588,338952,339539,AACCACCTGAAATTGATATGAAGAATTTCCCAAGTCACACTGTATATGTTAGAGCTGGTTCAAACCTTAAAGTTGACATTCCAATCTCTGGAAAACCACTTCCCAAAGTGACCTTATCAAGAGATGGTGTCCCCCTTAAGGCAACCATGAGATTTAATACCGAAATTACTGCTGAGAACCTGACCATCAATCTCAAAGAAAGTGTTACAGCTGACGCTGGGAGATATGAAATCACTGCTGCCAACTCCAGTGGTACAACCAAAGCTTTCATTAACATTGTTGTGCTAGACAGGCCTGGTCCTCCAACTGGCCCTGTTGTTATTAGTGATATAACTGAAGAAAGTGTGACTCTCAAATGGGAGCCACCTAAGTATGACGGTGGAAGTCAAGTTACCAACTACATTCTACTCAAAAGAGAAACAAGTACTGCAGTGTGGACTGAAGTGTCTGCAACAGTTGCAAGAACCATGATGAAAGTCATGAAACTGACCACAGGAGAAGAATACCAATTCCGCATCAAGGCAGAAAACCGCTTTGGCATCAGTGATCATATAGATTCAGCTTGTGTGACTGTCAAACTACCATACA
>TTN-203,ENSE00003808789,1,303,339540,339842,CAACACCTGGACCACCATCTACACCATGGGTCACTAATGTTACTCGAGAAAGCATCACTGTGGGCTGGCATGAACCAGTGTCAAATGGAGGCAGTGCAGTCGTAGGCTATCACCTGGAAATGAAAGACAGAAACAGTATTTTATGGCAAAAAGCCAACAAACTGGTCATCCGCACAACTCACTTCAAAGTCACAACAATCAGTGCTGGACTTATTTATGAATTCAGGGTGTATGCAGAAAATGCTGCTGGAGTTGGAAAACCTAGCCATCCTTCTGAACCAGTCTTGGCAATTGATGCTTGTG
>TTN-203,ENSE00003806587,1,297,339843,340139,AACCCCCAAGAAATGTTCGTATCACTGATATTTCAAAGAACTCTGTCAGCCTTTCATGGCAACAACCAGCTTTCGATGGAGGTAGCAAGATTACAGGCTACATTGTTGAGAGACGTGACCTTCCAGATGGCAGATGGACCAAGGCCAGCTTCACCAATGTTACTGAAACTCAATTCATCATCTCTGGCTTGACTCAGAATTCCCAGTATGAATTCCGTGTCTTTGCTAGGAATGCTGTTGGTTCCATTAGCAATCCATCTGAGGTTGTAGGGCCCATTACTTGCATCGATTCTTATG
>TTN-203,ENSE00003807681,1,288,340140,340427,GTGGTCCTGTAATTGATTTGCCTCTAGAATATACAGAAGTTGTCAAATACAGAGCAGGTACATCTGTGAAGCTCAGAGCTGGCATTTCTGGCAAACCTGCGCCTACTATTGAGTGGTATAAAGATGATAAAGAATTACAAACCAATGCACTGGTGTGTGTTGAAAATACCACGGACCTCGCATCTATACTCATCAAAGATGCCGATCGCCTTAATAGTGGATGCTATGAATTAAAACTAAGGAATGCCATGGGCTCAGCCTCAGCCACCATCAGAGTACAGATCCTTG
>TTN-203,ENSE00003811102,1,300,340428,340727,ACAAACCAGGCCCACCTGGTGGACCAATTGAATTTAAGACTGTAACTGCTGAGAAGATCACCCTTCTCTGGCGGCCTCCAGCTGATGATGGTGGTGCAAAAATCACTCACTACATTGTGGAAAAGCGTGAGACAAGCCGCGTTGTGTGGTCTATGGTGTCTGAACATTTGGAAGAGTGCATCATTACAACCACCAAAATTATCAAAGGAAATGAATACATCTTCCGGGTCCGAGCCGTGAACAAATATGGAATTGGCGAGCCACTGGAATCTGATTCCGTTGTAGCCAAGAACGCATTTG
>TTN-203,ENSE00003802386,1,303,340728,341030,TTACACCTGGGCCACCAGGCATACCAGAAGTGACAAAGATTACCAAGAATTCGATGACTGTTGTATGGAGCAGGCCAATTGCAGATGGCGGTAGTGATATAAGTGGCTATTTCCTTGAAAAACGAGACAAGAAGAGCCTAGGATGGTTTAAAGTACTAAAAGAGACTATCCGTGACACCAGACAAAAAGTAACAGGACTCACAGAAAACAGTGACTATCAATACAGAGTTTGTGCTGTAAACGCTGCTGGACAGGGTCCATTTTCTGAACCATCTGAATTCTACAAAGCTGCTGATCCTATTG
>TTN-203,ENSE00003809908,1,306,341031,341336,ATCCTCCAGGTCCACCTGCTAAGATAAGAATCGCAGATTCAACCAAGTCATCCATCACCCTTGGCTGGAGTAAGCCTGTCTATGATGGGGGCAGTGCTGTTACTGGGTATGTTGTCGAGATAAGACAAGGAGAGGAAGAGGAATGGACTACTGTCTCTACCAAAGGAGAGGTCAGAACTACAGAATATGTGGTATCCAACCTGAAACCTGGAGTCAATTACTACTTCCGGGTATCTGCTGTAAACTGTGCTGGACAAGGAGAACCTATAGAAATGAATGAACCTGTACAAGCTAAAGATATACTTG
>TTN-203,ENSE00003808993,1,1767,341337,343103,AGGCACCAGAGATTGACCTGGATGTGGCTCTCAGAACTTCTGTTATTGCCAAAGCTGGTGAAGATGTACAAGTGTTGATTCCCTTTAAAGGCAGACCTCCACCTACTGTCACATGGAGAAAAGATGAGAAGAATCTTGGCAGTGATGCCAGATACAGCATTGAAAACACTGATTCATCCTCATTACTCACCATTCCTCAAGTTACTCGCAATGATACAGGAAAATATATTCTCACAATAGAAAATGGAGTTGGTGAACCTAAGTCTTCAACTGTGAGTGTTAAAGTGCTTGACACACCAGCTGCCTGCCAGAAACTACAGGTTAAACATGTTTCTCGAGGCACAGTCACTTTGCTCTGGGATCCTCCTCTCATTGATGGAGGATCTCCAATAATTAATTATGTCATTGAAAAGAGAGATGCCACCAAGAGAACATGGTCTGTCGTGTCACACAAATGTTCTAGCACATCCTTCAAGCTAATAGATTTGTCGGAGAAGACTCCATTCTTCTTCAGAGTTCTTGCAGAAAATGAAATTGGAATTGGGGAACCCTGTGAAACTACAGAGCCAGTGAAGGCTGCTGAAGTACCAGCTCCTATACGTGATCTCTCAATGAAAGACTCAACAAAGACATCTGTCATCCTCAGCTGGACCAAACCTGACTTTGATGGTGGTAGCGTCATCACAGAATATGTTGTAGAAAGGAAAGGTAAAGGTGAACAGACGTGGTCCCACGCTGGCATAAGTAAGACATGTGAAATTGAGGTTAGCCAACTTAAGGAGCAGTCAGTCCTGGAGTTCAGAGTGTTTGCCAAAAATGAGAAAGGACTGAGTGATCCTGTCACTATTGGGCCAATTACAGTGAAAGAACTTATTATTACACCTGAAGTTGACCTGTCAGATATCCCTGGGGCACAAGTCACTGTGAGAATTGGGCACAATGTGCACCTTGAATTACCTTATAAGGGAAAACCCAAACCATCCATCAGTTGGCTGAAAGATGGCTTGCCACTGAAAGAAAGTGAATTTGTTCGCTTCAGTAAAACTGAAAACAAAATTACTTTGAGTATTAAGAATGCCAAGAAGGAGCATGGAGGAAAATACACTGTTATTCTTGATAATGCAGTGTGTAGAATTGCAGTCCCCATTACAGTCATCACCCTTGGCCCACCATCAAAGCCCAAAGGACCCATTCGATTTGATGAAATCAAGGCTGATAGTGTCATCCTGTCATGGGATGTACCTGAAGATAATGGAGGAGGAGAAATTACTTGTTACAGCATCGAGAAGCGGGAAACTTCACAAACTAACTGGAAGATGGTGTGTTCAAGTGTTGCCAGAACGACTTTCAAAGTTCCTAATCTAGTCAAAGATGCTGAGTACCAGTTTAGAGTGAGAGCAGAAAACAGATACGGAGTCAGCCAACCACTTGTCTCAAGCATTATTGTGGCAAAACACCAGTTCAGGATTCCTGGTCCCCCAGGAAAGCCAGTTATATACAATGTGACTTCTGATGGCATGTCACTAACTTGGGATGCTCCAGTTTATGATGGTGGTTCAGAAGTTACTGGATTCCATGTTGAAAAGAAAGAAAGAAATAGCATCCTCTGGCAAAAAGTTAATACATCACCAATCTCTGGAAGAGAATATAGAGCCACTGGACTGGTAGAAGGTCTGGATTACCAATTCCGTGTATATGCTGAAAATTCTGCTGGCCTAAGCTCACCTAGTGACCCAAGCAAATTTACCTTAGCTGTTTCTCCAGTAG
>TTN-203,ENSE00003811205,1,294,343104,343397,ACCCACCTGGCACTCCTGACTACATTGATGTCACCCGGGAAACCATCACACTTAAATGGAACCCACCATTGCGTGATGGAGGCAGTAAGATTGTGGGCTATAGCATTGAGAAACGGCAAGGAAATGAACGCTGGGTGAGATGCAACTTTACTGACGTCAGTGAATGTCAGTACACAGTTACAGGACTCAGTCCTGGGGATCGCTATGAGTTCAGAATAATTGCAAGAAATGCTGTTGGAACTATAAGCCCGCCCTCACAGTCTTCTGGCATTATTATGACAAGAGATGAAAATG
>TTN-203,ENSE00003808021,1,288,343398,343685,TTCCACCAATAGTAGAGTTTGGCCCTGAATACTTTGATGGTCTCATTATTAAGTCCGGAGAGAGCCTTAGAATTAAAGCTTTGGTACAAGGAAGACCAGTGCCTCGAGTAACTTGGTTCAAAGATGGAGTGGAAATCGAAAAGAGGATGAATATGGAAATAACCGACGTACTTGGATCCACCAGCCTATTTGTTAGAGATGCTACTCGGGACCATCGTGGTGTATACACAGTGGAAGCCAAAAATGCATCTGGTTCTGCAAAAGCAGAAATTAAAGTGAAAGTACAAG
>TTN-203,ENSE00003804355,1,300,343686,343985,ATACACCAGGAAAAGTAGTTGGGCCAATAAGATTCACCAATATTACTGGGGAGAAGATGACTCTGTGGTGGGATGCCCCACTCAATGACGGTTGTGCTCCCATAACCCACTACATCATTGAAAAACGGGAAACCAGCAGACTTGCCTGGGCACTAATTGAGGATAAATGTGAAGCCCAAAGTTACACTGCCATTAAACTAATAAACGGCAATGAATACCAATTCCGTGTTTCTGCAGTTAACAAGTTTGGTGTTGGCAGGCCACTTGATTCTGATCCAGTGGTTGCTCAAATACAATATA
>TTN-203,ENSE00003807046,1,2067,343986,346052,CTGTTCCTGATGCCCCTGGCATTCCAGAACCTAGCAACATAACAGGCAACAGCATTACCCTGACATGGGCAAGGCCAGAATCAGATGGTGGCAGTGAAATTCAACAGTATATCCTTGAAAGAAGAGAAAAGAAAAGCACAAGATGGGTAAAAGTGATCAGCAAACGACCAATCTCTGAAACAAGATTCAAAGTCACTGGTCTGACAGAAGGCAATGAGTATGAATTCCATGTCATGGCTGAAAATGCTGCAGGAGTTGGACCTGCAAGTGGCATCTCAAGACTCATTAAATGTAGAGAGCCCGTCAACCCACCAGGTCCTCCCACAGTGGTCAAAGTAACAGACACATCAAAGACAACTGTGAGCTTAGAATGGTCCAAACCAGTGTTTGATGGTGGCATGGAAATAATTGGGTATATTATTGAAATGTGTAAGGCCGACTTAGGAGACTGGCACAAGGTGAATGCAGAGGCATGTGTGAAAACAAGATATACAGTCACTGATCTACAAGCAGGTGAAGAATACAAATTCCGAGTTAGTGCTATCAATGGTGCTGGAAAAGGCGACAGCTGTGAAGTGACTGGCACAATTAAAGCAGTTGACCGGTTAACAGCTCCTGAGTTAGACATAGATGCAAACTTCAAACAGACTCATGTTGTTAGAGCTGGGGCCAGTATTCGCCTCTTCATTGCCTACCAAGGTAGACCTACTCCTACAGCTGTGTGGAGCAAACCAGACTCTAACCTTAGCCTTCGGGCTGATATCCATACAACAGATTCCTTCAGCACCCTCACTGTGGAAAACTGCAACAGAAATGATGCAGGGAAATATACCCTTACTGTGGAAAACAACAGTGGTAGTAAGTCAATCACATTCACCGTGAAAGTGCTAGACACTCCAGGCCCACCTGGCCCAATTACCTTCAAAGATGTGACCCGGGGATCTGCTACATTGATGTGGGATGCCCCTCTTCTTGACGGTGGTGCCCGAATCCATCATTATGTGGTAGAGAAACGAGAGGCAAGTCGCCGTAGTTGGCAGGTTATCAGTGAAAAATGCACTCGTCAGATCTTCAAGGTCAATGACCTGGCCGAAGGTGTTCCGTACTATTTCCGTGTTTCTGCAGTAAATGAGTATGGTGTTGGTGAGCCCTATGAAATGCCAGAACCAATTGTAGCCACAGAACAGCCTGCTCCACCTAGGAGACTTGATGTTGTTGATACTAGCAAATCCTCCGCAGTCTTAGCTTGGCTTAAACCTGACCACGATGGAGGCAGCCGGATCACTGGCTACCTGCTTGAAATGAGACAAAAGGGATCTGACTTCTGGGTTGAAGCTGGTCACACCAAACAGCTAACTTTCACAGTAGAGCGTCTTGTTGAGAAAACTGAATATGAATTCCGTGTGAAGGCCAAGAATGATGCTGGCTATAGTGAACCCAGAGAAGCCTTCTCTTCTGTCATCATTAAGGAGCCTCAAATCGAGCCCACTGCTGACCTCACTGGAATTACCAATCAGCTTATAACTTGCAAAGCAGGAAGCCCATTTACCATTGACGTACCAATCAGTGGTCGTCCTGCCCCCAAAGTAACATGGAAACTGGAAGAAATGAGACTTAAAGAGACAGATCGAGTGAGCATTACAACAACAAAAGACAGAACCACACTGACTGTAAAGGACAGCATGAGAGGTGACTCTGGAAGATACTTCTTGACCCTGGAAAATACAGCTGGTGTTAAAACATTTAGCGTCACAGTTGTGGTCATTGGAAGGCCAGGTCCAGTAACCGGCCCCATTGAGGTCTCATCTGTCTCAGCTGAATCGTGTGTCCTGTCATGGGGAGAACCTAAAGATGGAGGAGGCACTGAAATTACTAATTACATAGTTGAAAAGCGTGAATCGGGTACAACAGCTTGGCAGCTTGTCAATTCCAGTGTCAAGCGCACTCAAATTAAAGTCACTCATCTCACAAAATACATGGAATATTCTTTCCGTGTCAGTTCAGAGAACAGATTTGGTGTCAGCAAACCTCTAGAATCAGCACCAATAATTGCTGAACATCCATTTG
>TTN-203,ENSE00003810611,1,303,346053,346355,TCCCACCAAGCGCTCCTACCAGACCTGAGGTCTACCATGTGTCTGCCAATGCCATGTCTATTCGTTGGGAAGAACCCTACCACGATGGTGGCAGTAAAATCATTGGCTACTGGGTTGAGAAGAAAGAACGTAATACAATTCTTTGGGTGAAAGAAAACAAAGTGCCATGCTTAGAGTGCAACTACAAAGTAACTGGTTTAGTAGAAGGACTGGAATATCAGTTCAGAACTTATGCACTCAATGCTGCAGGTGTTAGCAAGGCCAGCGAAGCTTCAAGACCTATAATGGCTCAAAATCCAGTTG
>TTN-203,ENSE00003803222,1,306,346356,346661,ATGCACCAGGCAGACCAGAGGTGACAGATGTCACAAGATCAACAGTATCACTGATTTGGTCTGCCCCAGCGTATGATGGAGGCAGCAAGGTTGTGGGCTACATCATAGAGCGTAAGCCAGTCAGTGAGGTAGGAGATGGTCGCTGGCTGAAGTGCAACTACACCATTGTATCTGACAATTTCTTCACCGTGACTGCTCTCAGTGAAGGAGACACTTATGAGTTCCGTGTGTTAGCCAAGAATGCAGCAGGCGTAATTAGCAAAGGGTCTGAATCTACAGGCCCTGTCACTTGCCGAGATGAATACG
>TTN-203,ENSE00003801213,1,291,346662,346952,CTCCACCCAAAGCCGAACTGGATGCCCGATTACACGGTGATCTGGTTACCATCAGAGCAGGTTCTGATCTTGTTCTGGATGCTGCAGTTGGTGGCAAACCTGAACCCAAAATTATCTGGACCAAAGGAGACAAGGAGCTAGATCTCTGTGAAAAAGTCTCTTTGCAGTATACTGGCAAACGAGCAACTGCTGTGATCAAGTTCTGTGACAGAAGTGACAGTGGAAAATACACTTTAACAGTGAAAAATGCCAGCGGGACCAAGGCCGTGTCTGTCATGGTCAAAGTGCTTG
>TTN-203,ENSE00003809128,1,297,346953,347249,ATTCCCCTGGCCCATGTGGAAAGCTCACCGTCAGCAGAGTAACACAGGAGAAGTGCACTTTAGCCTGGAGCCTTCCGCAGGAAGACGGAGGAGCAGAAATCACTCACTACATCGTGGAAAGACGCGAGACTAGCAGGCTCAACTGGGTGATTGTTGAAGGCGAATGCCCAACCCTATCCTATGTCGTTACCAGGCTCATCAAGAACAATGAGTACATATTCCGAGTGAGGGCAGTAAACAAATATGGCCCTGGTGTGCCTGTTGAATCAGAGCCAATTGTAGCCAGAAACTCATTCA
>TTN-203,ENSE00003803385,1,306,347250,347555,CTATTCCATCACCACCCGGCATACCTGAAGAAGTTGGGACTGGCAAAGAGCATATCATCATTCAGTGGACAAAACCTGAATCTGATGGTGGCAATGAAATCAGCAACTACCTAGTAGACAAACGTGAGAAGAAGAGCCTGCGCTGGACACGTGTCAACAAAGACTATGTGGTGTATGATACCAGGCTGAAGGTGACCAGCCTGATGGAGGGTTGTGATTACCAGTTCCGGGTGACCGCAGTGAATGCAGCTGGTAACAGTGAGCCCAGCGAAGCTTCCAACTTCATCTCATGCAGAGAACCATCAT
>TTN-203,ENSE00003807140,1,306,347556,347861,ATACCCCTGGACCACCTTCTGCTCCAAGAGTTGTGGATACCACCAAACACAGCATTAGTTTGGCATGGACCAAACCCATGTACGATGGTGGTACTGACATTGTAGGATATGTTCTGGAAATGCAAGAGAAGGACACTGATCAGTGGTACCGAGTGCATACCAATGCCACAATAAGAAATACTGAATTCACTGTGCCAGACCTTAAAATGGGCCAGAAATATTCCTTCAGAGTTGCTGCCGTGAACGTGAAGGGTATGAGCGAATACAGCGAATCAATTGCTGAAATTGAGCCCGTGGAAAGAATAG
>TTN-203,ENSE00003809946,1,282,347862,348143,AAATACCAGATCTTGAGCTTGCAGATGATCTAAAGAAGACTGTGACCATCAGGGCTGGGGCCTCCTTGCGCTTGATGGTGTCTGTATCTGGAAGACCACCTCCTGTCATAACGTGGAGCAAGCAGGGCATTGACCTTGCAAGCCGGGCAATTATTGACACCACTGAGAGCTACTCATTGCTAATAGTGGACAAAGTTAATCGGTACGATGCTGGAAAATACACAATTGAAGCTGAAAACCAATCTGGCAAGAAATCAGCAACAGTCCTTGTTAAAGTCTATG
>TTN-203,ENSE00003810384,1,594,348144,348737,ATACTCCTGGTCCCTGTCCTTCAGTGAAAGTTAAGGAAGTATCAAGAGATTCTGTGACTATAACTTGGGAAATTCCCACGATTGATGGTGGAGCTCCAGTCAACAATTACATCGTTGAGAAGCGTGAAGCTGCTATGAGAGCATTCAAAACAGTAACTACCAAATGCAGCAAGACACTTTACAGAATTTCTGGACTTGTAGAAGGAACCATGTACTATTTCAGAGTGCTGCCAGAAAATATTTATGGCATTGGAGAACCTTGTGAAACATCTGATGCAGTACTGGTCTCAGAAGTGCCTTTGGTGCCTGCAAAGCTAGAAGTGGTCGATGTCACCAAATCCACTGTTACCCTTGCCTGGGAAAAACCACTCTACGATGGTGGTAGCCGACTCACTGGATATGTTCTCGAGGCCTGCAAAGCTGGCACAGAGAGATGGATGAAGGTTGTCACCTTAAAACCCACAGTCCTAGAGCACACTGTTACTTCCTTAAATGAAGGTGAACAATACTTATTTAGAATAAGGGCACAAAATGAGAAAGGTGTGTCAGAACCAAGAGAGACTGTCACAGCCGTGACTGTACAAGACCTCAGAG
>TTN-203,ENSE00003802641,1,288,348738,349025,TGTTGCCAACAATCGATCTTTCTACAATGCCTCAGAAGACCATCCATGTCCCAGCTGGCAGACCAGTAGAGCTGGTGATACCTATTGCTGGCCGTCCACCTCCTGCTGCTTCCTGGTTCTTTGCTGGTTCTAAACTGAGAGAATCAGAGCGTGTCACAGTTGAAACTCACACTAAAGTAGCTAAATTAACCATCCGTGAAACCACTATCAGAGATACTGGAGAATACACACTTGAATTGAAGAATGTTACCGGAACTACTTCAGAAACCATTAAAGTTATCATTCTTG
>TTN-203,ENSE00003806194,1,300,349026,349325,ACAAGCCTGGTCCACCAACAGGACCTATTAAGATTGATGAAATTGATGCTACATCAATTACCATTTCCTGGGAACCACCTGAATTGGACGGTGGTGCTCCACTGAGTGGTTATGTGGTAGAACAACGTGACGCTCATCGTCCAGGATGGCTGCCCGTTTCTGAATCAGTGACTAGGTCCACGTTTAAGTTTACCAGACTCACCGAAGGAAATGAGTATGTGTTCCGTGTGGCTGCAACAAACCGCTTCGGGATTGGCTCTTACTTGCAGTCTGAGGTCATAGAGTGTCGCAGCAGCATCC
>TTN-203,ENSE00003805894,1,303,349326,349628,GTATTCCTGGACCCCCAGAAACATTACAGATATTTGATGTTTCCCGTGATGGCATGACACTTACTTGGTACCCACCAGAGGATGACGGTGGCTCCCAAGTGACTGGATATATTGTGGAGCGCAAAGAAGTGAGAGCAGATCGATGGGTCCGTGTAAATAAAGTACCTGTGACAATGACACGGTACCGCTCCACTGGCCTTACTGAAGGCTTAGAATATGAACACCGTGTCACAGCCATTAATGCAAGAGGGTCTGGGAAACCAAGTCGTCCTTCCAAACCCATCGTTGCCATGGATCCAATTG
>TTN-203,ENSE00003808643,1,303,349629,349931,CTCCTCCAGGAAAGCCACAAAACCCAAGAGTTACTGATACAACAAGGACATCAGTCTCCCTGGCCTGGAGTGTTCCAGAAGATGAAGGAGGATCTAAAGTCACAGGCTACTTGATTGAAATGCAAAAAGTAGATCAACATGAATGGACCAAGTGTAACACCACTCCAACCAAGATTCGAGAGTATACTCTAACACACCTACCTCAGGGTGCAGAATACAGGTTCCGCGTCCTAGCTTGTAATGCTGGTGGACCTGGTGAGCCTGCTGAGGTACCAGGAACAGTCAAAGTCACTGAAATGCTTG
>TTN-203,ENSE00003805779,1,585,349932,350516,AATATCCTGATTATGAACTTGATGAAAGATACCAAGAAGGTATCTTTGTAAGGCAAGGTGGCGTCATCAGACTTACCATACCAATCAAAGGAAAACCATTCCCAATATGTAAATGGACCAAGGAAGGCCAGGATATTAGTAAGCGTGCCATGATTGCAACATCTGAAACACACACTGAGCTTGTGATCAAAGAAGCAGACAGGGGTGATTCTGGCACTTATGACCTGGTTCTGGAAAATAAATGTGGCAAGAAGGCTGTCTACATCAAGGTCAGGGTGATAGGAAGTCCCAACAGTCCAGAAGGGCCACTGGAATATGATGACATCCAAGTCCGCTCTGTGAGGGTCAGCTGGAGACCTCCTGCTGATGATGGTGGTGCTGACATCTTAGGCTACATCCTCGAGAGACGAGAAGTGCCTAAAGCCGCCTGGTATACCATTGATTCCAGAGTCCGAGGTACATCTCTGGTGGTAAAAGGCCTCAAAGAGAATGTAGAATACCATTTCCGTGTTTCAGCAGAAAACCAGTTTGGCATAAGCAAACCCTTGAAATCTGAGGAACCAGTCACACCAAAAACACCATTGA
>TTN-203,ENSE00003806836,1,306,350517,350822,ATCCTCCAGAACCTCCAAGCAATCCTCCAGAAGTACTCGATGTAACCAAGAGTTCTGTTAGCTTGTCCTGGTCCCGGCCCAAAGATGATGGTGGTTCTAGAGTCACAGGCTACTACATCGAACGCAAAGAGACATCCACTGACAAGTGGGTCAGACACAACAAGACTCAGATCACCACCACAATGTACACTGTCACAGGGCTTGTTCCCGATGCTGAGTATCAGTTCCGCATCATCGCACAGAATGATGTTGGCCTGAGTGAGACCAGCCCTGCTTCTGAACCAGTTGTTTGCAAAGATCCATTTG
>TTN-203,ENSE00003810204,1,300,350823,351122,ATAAACCAAGCCAACCAGGAGAACTTGAGATTCTTTCAATATCCAAAGATAGTGTCACTCTACAGTGGGAGAAACCTGAATGTGATGGTGGTAAAGAAATTCTTGGATACTGGGTTGAATATAGACAGTCTGGAGACAGTGCCTGGAAGAAGAGCAATAAGGAACGTATTAAGGACAAGCAATTCACAATAGGAGGTTTGCTGGAAGCTACTGAGTATGAATTCAGGGTTTTTGCTGAGAATGAGACTGGGCTGAGCAGACCTCGCAGAACTGCTATGTCTATAAAGACTAAACTCACAT
>TTN-203,ENSE00003805486,1,576,351123,351698,CTGGAGAGGCCCCAGGAATACGCAAAGAAATGAAGGATGTTACCACAAAATTGGGTGAAGCTGCTCAACTCTCATGCCAGATTGTTGGAAGGCCTCTTCCTGACATTAAATGGTACAGATTTGGTAAAGAGCTCATACAAAGCCGGAAATACAAAATGTCTTCAGATGGACGCACACACACTCTTACAGTAATGACAGAGGAACAGGAAGATGAAGGTGTTTATACCTGCATAGCCACCAATGAGGTTGGAGAAGTAGAAACCAGTAGTAAGCTTCTCCTGCAAGCAACACCGCAGTTCCATCCTGGTTACCCACTGAAAGAGAAATATTATGGAGCTGTGGGTTCCACACTTCGGCTTCATGTTATGTACATTGGTCGTCCAGTACCTGCCATGACTTGGTTCCATGGTCAGAAACTTTTGCAAAACTCAGAAAACATTACTATTGAAAACACTGAGCACTATACTCATCTTGTCATGAAGAATGTCCAACGTAAGACTCATGCTGGGAAATACAAAGTCCAGCTCAGCAATGTTTTTGGAACAGTTGATGCCATCCTTGATGTGGAAATACAAG
>TTN-203,ENSE00003801306,1,306,351699,352004,ATAAACCAGACAAACCTACAGGACCAATTGTGATCGAAGCTCTATTGAAGAACTCCGCAGTGATCAGCTGGAAACCACCCGCAGATGACGGAGGCTCCTGGATCACCAACTATGTGGTGGAAAAATGTGAGGCCAAGGAGGGGGCTGAATGGCAATTGGTGTCTTCAGCCATCTCAGTGACAACCTGTAGAATTGTGAACCTCACAGAAAATGCTGGCTATTACTTCCGGGTTTCAGCTCAGAACACTTTCGGCATCAGTGACCCTCTAGAAGTGTCCTCAGTTGTGATCATTAAGAGTCCATTTG
>TTN-203,ENSE00003808123,1,594,352005,352598,AAAAGCCAGGTGCTCCTGGCAAACCAACTATTACTGCTGTCACAAAAGATTCTTGTGTTGTGGCCTGGAAGCCACCTGCCAGTGATGGAGGTGCAAAGATTAGAAATTACTACCTTGAGAAGCGTGAGAAGAAGCAGAATAAATGGATTTCTGTGACAACAGAAGAAATTCGAGAAACTGTCTTTTCAGTGAAAAACCTTATTGAAGGTCTTGAATACGAGTTTCGTGTGAAATGTGAAAATCTAGGTGGGGAAAGTGAATGGAGTGAAATATCAGAACCCATCACTCCCAAATCTGATGTCCCAATTCAGGCACCACACTTTAAAGAGGAACTGAGAAATCTAAATGTCAGATATCAGAGCAATGCTACCTTGGTCTGCAAAGTGACTGGTCATCCAAAACCTATCGTCAAATGGTACAGACAAGGCAAAGAAATCATTGCAGATGGATTAAAATATAGGATTCAAGAATTTAAGGGTGGCTACCACCAGCTCATCATTGCAAGTGTCACAGATGATGATGCCACAGTTTACCAAGTCAGAGCTACCAACCAAGGGGGATCTGTGTCTGGCACTGCCTCCTTGGAAGTGGAAG
>TTN-203,ENSE00003808212,1,5609,352599,358207,TTCCAGCTAAGATACACTTACCTAAAACTCTTGAAGGCATGGGAGCAGTTCATGCTCTCCGAGGTGAAGTGGTCAGCATCAAGATTCCTTTCAGTGGCAAACCAGATCCTGTGATCACCTGGCAGAAAGGACAAGATCTCATTGACAATAATGGCCACTACCAAGTTATTGTCACAAGATCCTTCACATCACTTGTTTTCCCCAATGGGGTAGAGAGAAAAGATGCTGGTTTCTATGTGGTCTGTGCTAAAAACAGATTTGGAATTGATCAGAAGACAGTTGAACTGGATGTGGCTGATGTTCCTGACCCACCCAGAGGAGTCAAAGTTAGTGATGTCTCACGAGATTCTGTCAACTTAACATGGACTGAGCCAGCCTCTGATGGTGGCAGCAAAATCACCAACTACATTGTTGAAAAATGTGCAACTACTGCAGAAAGATGGCTCCGTGTAGGACAGGCCCGAGAAACACGTTATACCGTGATCAACTTATTTGGAAAAACAAGTTACCAGTTCCGGGTAATAGCTGAAAATAAATTTGGTCTGAGCAAGCCTTCAGAGCCTTCAGAACCAACCATAACCAAAGAAGATAAGACCAGAGCTATGAACTATGATGAAGAGGTAGATGAAACCAGGGAAGTCTCCATGACTAAAGCATCTCACTCTTCAACCAAGGAACTCTATGAGAAATATATGATTGCTGAAGATCTTGGGCGTGGTGAGTTTGGAATTGTCCATCGTTGTGTTGAAACATCCTCAAAGAAGACATACATGGCCAAATTTGTTAAAGTCAAAGGGACTGATCAGGTTTTGGTAAAGAAGGAAATTTCCATTCTGAATATTGCTAGGCATAGAAACATCTTACACCTCCATGAATCATTTGAAAGCATGGAAGAATTAGTTATGATCTTTGAGTTTATATCAGGACTTGACATATTTGAGCGCATTAACACAAGTGCTTTTGAACTTAATGAAAGAGAAATTGTAAGTTATGTTCACCAGGTCTGTGAAGCACTTCAGTTTTTACACAGTCATAATATTGGACACTTTGACATTAGACCAGAAAATATCATTTACCAAACCAGAAGAAGCTCTACCATTAAAATCATAGAATTTGGTCAAGCCCGTCAGCTGAAACCAGGGGACAACTTCAGGCTTCTATTCACTGCCCCAGAATACTATGCACCTGAAGTCCACCAGCATGATGTTGTCAGCACAGCCACAGACATGTGGTCACTTGGAACACTGGTATATGTGCTATTGAGTGGTATCAACCCATTCCTGGCTGAAACTAACCAACAGATCATTGAGAATATCATGAATGCTGAATATACTTTCGATGAGGAAGCATTCAAAGAGATTAGCATTGAAGCCATGGATTTTGTTGACCGGTTGTTAGTGAAAGAGAGGAAATCTCGCATGACAGCATCGGAGGCTCTCCAGCACCCATGGTTGAAGCAGAAGATAGAAAGAGTCAGTACTAAAGTTATCAGAACATTAAAACACCGGCGTTATTACCACACCCTGATCAAGAAAGACCTCAACATGGTTGTGTCAGCAGCCCGGATCTCCTGTGGTGGTGCAATTCGATCTCAGAAGGGAGTGAGTGTTGCTAAAGTTAAAGTGGCATCCATTGAAATTGGCCCAGTTTCTGGGCAGATAATGCATGCAGTTGGTGAAGAAGGAGGACATGTCAAATATGTATGCAAAATTGAAAATTATGATCAGTCTACCCAAGTGACTTGGTACTTTGGCGTCCGACAGCTGGAGAACAGTGAGAAATACGAAATCACCTACGAAGATGGAGTGGCCATCCTCTATGTCAAAGACATTACCAAATTAGATGATGGTACCTACAGATGCAAAGTAGTCAATGACTATGGTGAAGACAGTTCTTATGCAGAGCTATTTGTTAAAGGTGTGAGAGAAGTCTATGACTATTACTGCCGTAGAACCATGAAGAAAATTAAGCGCAGAACAGACACAATGAGACTCCTGGAAAGGCCACCAGAATTTACCCTGCCTCTCTATAATAAGACAGCTTATGTAGGTGAAAATGTCCGGTTTGGAGTAACTATAACTGTCCACCCAGAGCCTCATGTAACATGGTATAAATCAGGTCAGAAAATCAAACCAGGTGACAATGACAAGAAGTACACATTTGAGTCAGACAAGGGTCTTTACCAATTAACAATCAACAGTGTCACTACAGATGATGACGCTGAATATACTGTTGTGGCAAGGAACAAATATGGTGAAGACAGCTGTAAAGCAAAGCTGACAGTAACCCTACACCCACCTCCAACAGATAGTACCTTAAGACCCATGTTCAAAAGGTTACTGGCAAATGCAGAATGCCAAGAAGGCCAAAGTGTCTGCTTTGAGATCAGAGTGTCTGGCATCCCCCCACCAACATTAAAATGGGAGAAAGATGGTCAGCCACTGTCCCTCGGGCCTAACATTGAAATTATCCATGAAGGCTTGGATTATTATGCTCTGCACATCAGGGACACTTTGCCTGAAGACACGGGTTATTATAGAGTCACAGCCACTAACACAGCTGGGTCCACCAGCTGCCAGGCTCACCTACAAGTGGAACGCCTGAGGTACAAGAAACAGGAATTCAAGAGTAAGGAGGAGCATGAGCGACACGTACAAAAACAAATTGACAAAACCCTCAGAATGGCTGAAATTCTTTCTGGAACTGAAAGTGTACCACTGACACAGGTAGCTAAAGAGGCTCTGAGAGAAGCTGCTGTCCTTTATAAACCGGCTGTAAGCACCAAGACTGTAAAAGGGGAATTCAGACTTGAGATAGAAGAAAAGAAGGAGGAGAGAAAACTCCGGATGCCTTATGATGTACCAGAGCCACGCAAGTATAAGCAGACTACCATAGAAGAAGACCAACGCATCAAGCAGTTCGTGCCCATGTCTGACATGAAGTGGTATAAAAAGATACGTGATCAGTATGAAATGCCTGGGAAACTTGACAGAGTTGTACAGAAACGACCCAAGCGCATCCGCCTTTCAAGATGGGAACAGTTCTATGTGATGCCTCTTCCACGCATTACAGATCAATACAGACCTAAATGGCGTATTCCTAAACTGTCCCAAGATGATCTTGAGATAGTGAGACCAGCCCGCCGGCGTACACCTTCTCCTGATTATGACTTTTACTACCGACCTAGAAGACGTTCTCTTGGGGACATCTCTGATGAAGAATTACTCCTCCCCATTGATGACTACTTAGCAATGAAAAGAACAGAGGAAGAGAGGCTGCGTCTTGAAGAAGAGCTTGAGTTAGGTTTTTCAGCTTCACCCCCAAGTCGAAGCCCTCCACACTTTGAGCTTTCTAGCCTACGTTACTCTTCACCACAAGCTCATGTCAAGGTGGAGGAAACAAGAAAAGACTTCAGGTATTCAACCTATCACATCCCAACGAAGGCTGAAGCTAGTACAAGTTATGCAGAACTGAGGGAACGGCATGCCCAGGCTGCGTACAGACAGCCAAAGCAACGGCAAAGAATCATGGCTGAGAGGGAGGATGAAGAGTTGCTTCGCCCAGTTACGACCACCCAGCATCTCTCAGAATACAAAAGCGAACTTGACTTCATGTCAAAGGAGGAAAAGTCTAGAAAGAAATCAAGGCGACAAAGAGAAGTGACAGAAATAACAGAAATTGAGGAAGAATACGAAATCTCAAAACATGCTCAAAGAGAATCATCCTCATCTGCGTCTAGACTACTGAGACGACGGCGCTCCCTGTCTCCAACTTATATTGAGTTAATGAGGCCAGTGTCTGAGCTGATCCGGTCACGTCCACAACCGGCTGAGGAATACGAAGATGACACAGAAAGAAGGTCACCTACTCCAGAGAGAACTCGCCCACGATCCCCCAGCCCTGTGTCTAGTGAGAGATCACTCTCGAGATTTGAGAGGTCTGCAAGATTTGATATCTTTTCCAGGTATGAGTCCATGAAAGCTGCTTTAAAAACTCAGAAGACATCAGAAAGGAAGTATGAAGTTTTGAGTCAGCAGCCTTTCACACTGGACCATGCCCCTCGAATCACACTGAGAATGCGCTCGCACAGGGTACCATGTGGCCAAAATACACGTTTTATTTTAAATGTTCAGTCTAAGCCAACTGCCGAGGTTAAATGGTACCACAATGGTGTGGAACTCCAAGAAAGCAGTAAGATTCATTACACCAACACGAGTGGAGTCCTCACCCTGGAAATTCTGGACTGTCATACTGATGACAGTGGAACCTACCGTGCTGTGTGCACCAACTACAAGGGCGAAGCTTCTGACTATGCAACGTTGGACGTGACAGGAGGGGATTATACCACCTATGCTTCCCAACGCAGAGATGAAGAGGTCCCCAGATCTGTTTTCCCTGAGCTGACAAGAACAGAGGCGTATGCTGTTTCATCATTTAAGAAAACATCTGAGATGGAAGCTTCGTCTTCTGTCAGGGAAGTGAAATCACAGATGACGGAGACAAGGGAAAGTCTCTCCTCATATGAACACTCTGCATCTGCAGAAATGAAAAGTGCTGCATTAGAAGAAAAGTCACTGGAAGAAAAATCCACAACCAGAAAGATCAAGACGACTTTGGCAGCAAGAATTCTAACAAAGCCACGGTCCATGACCGTCTACGAGGGCGAGTCTGCAAGGTTTTCTTGTGACACCGATGGTGAGCCGGTACCAACTGTGACCTGGCTGCGTAAAGGACAAGTGCTAAGTACTTCTGCCCGCCACCAAGTGACCACCACAAAGTACAAATCAACCTTTGAGATCTCTTCAGTCCAGGCTTCCGATGAGGGCAATTACAGCGTGGTGGTAGAAAACAGTGAAGGGAAACAAGAAGCAGAGTTCACTCTGACTATTCAAAAGGCCAGGGTAACTGAAAAGGCTGTGACATCACCACCAAGAGTCAAATCCCCAGAGCCTCGGGTGAAATCCCCAGAAGCAGTTAAGTCTCCAAAACGAGTGAAATCTCCAGAACCTTCTCACCCGAAAGCCGTATCACCCACAGAGACAAAACCAACACCAACAGAGAAAGTTCAGCACCTCCCAGTCTCTGCCCCACCAAAGATTACTCAGTTCCTGAAAGCAGAAGCTTCTAAAGAGATTGCAAAACTGACCTGTGTGGTTGAAAGCAGTGTATTAAGGGCAAAAGAGGTCACCTGGTATAAAGATGGCAAGAAACTGAAGGAAAATGGGCATTTCCAGTTTCATTATTCAGCAGATGGTACCTATGAGCTCAAAATCAATAACCTCACTGAATCTGATCAAGGAGAATATGTTTGTGAGATTTCTGGTGAAGGTGGAACGTCTAAAACCAACTTACAATTTATGGGGCAAGCCTTTAAGAGTATCCATGAGAAGGTATCAAAAATATCAGAAACTAAGAAATCAGATCAGAAAACCACTGAGTCAACAGTAACCAGAAAAACTGAACCAAAAGCTCCTGAACCAATTTCCTCAAAACCAGTAATTGTTACTGGGTTGCAGGATACAACTGTTTCTTCAGACAGTGTTGCTAAATTTGCAGTTAAGGCTACTGGAGAACCCCGGCCAACTGCCATCTGGACAAAAGATGGAAAG
>TTN-203,ENSE00003811220,1,157,358208,358364,GCCATTACACAAGGAGGTAAATATAAACTCTCTGAAGACAAGGGAGGGTTCTTCTTAGAAATTCATAAGACTGATACTTCTGACAGTGGACTTTATACTTGTACAGTAAAAAATTCAGCTGGATCTGTGTCCTCTAGCTGCAAATTAACAATAAAAG
>TTN-203,ENSE00003801641,1,692,358365,359056,CTATAAAAGATACTGAGGCACAGAAAGTCTCTACACAAAAGACTTCTGAAATTACACCTCAGAAGAAAGCTGTTGTCCAAGAGGAAATTTCCCAAAAAGCCCTAAGGTCTGAAGAAATTAAGATGTCAGAGGCAAAATCTCAAGAAAAGTTAGCCCTCAAAGAGGAAGCTTCAAAGGTTCTGATTTCTGAAGAAGTCAAGAAATCAGCAGCAACCTCCCTGGAAAAATCCATTGTCCATGAGGAAATCACTAAAACATCACAGGCATCAGAAGAAGTCAGAACTCATGCTGAGATTAAAGCATTTTCTACTCAGATGAGCATAAACGAAGGTCAAAGACTGGTTTTAAAAGCCAACATTGCTGGTGCCACTGATGTGAAATGGGTACTGAATGGCGTAGAGCTTACCAACTCTGAGGAGTACCGATATGGTGTCTCAGGCAGCGATCAGACCCTAACCATCAAGCAAGCCAGTCACAGAGATGAAGGAATCCTCACCTGCATAAGCAAAACCAAGGAAGGAATCGTCAAGTGTCAGTATGATTTGACACTGAGCAAAGAACTCTCAGATGCTCCAGCCTTCATCTCACAGCCTAGATCTCAAAATATTAATGAAGGACAAAATGTTCTCTTTACTTGTGAAATCAGTGGCGAGCCATCCCCTGAAATCGAATGGTTTAAAAACAACCTGCCA
>TTN-203,ENSE00003801638,1,154,359057,359210,ATTTCTATTTCTTCAAATGTCAGCATAAGCCGCTCCAGAAATGTATACTCCCTTGAAATCCGAAATGCATCAGTCAGCGACAGTGGAAAGTACACAATTAAGGCCAAAAATTTCCGTGGCCAGTGTTCAGCTACAGCTTCCTTAATGGTCCTTC
>TTN-203,ENSE00003805382,1,303,359211,359513,CTCTAGTTGAAGAACCTTCCAGAGAGGTAGTATTGAGAACAAGTGGTGACACAAGCTTGCAAGGAAGCTTCTCGTCTCAGTCAGTCCAAATGTCTGCCTCCAAGCAGGAGGCCTCCTTCAGCAGTTTCAGCAGCAGCAGTGCTAGCAGCATGACTGAGATGAAATTTGCAAGCATGTCTGCCCAAAGCATGTCCTCCATGCAAGAGTCCTTTGTAGAAATGAGTTCCAGCAGCTTTATGGGAATATCTAATATGACACAACTGGAAAGCTCAACTAGTAAAATGCTTAAAGCAGGCATAAGAG
>TTN-203,ENSE00003809884,1,1319,359514,360832,GAATTCCGCCTAAAATTGAAGCTCTTCCATCTGATATCAGCATTGATGAAGGCAAAGTTCTAACAGTAGCCTGTGCTTTCACGGGTGAGCCTACCCCAGAAGTAACATGGTCCTGTGGTGGAAGAAAAATCCACAGTCAAGAACAGGGGAGGTTCCACATTGAAAACACAGATGACCTGACAACCCTGATCATCATGGACGTACAGAAACAAGATGGTGGACTTTATACCCTGAGTTTAGGGAATGAATTTGGATCTGACTCTGCCACTGTGAATATACATATTCGATCCATTTAAGAGGGCCTGTGCCCTTATACTCTACACTCATTCTTAACTTTTCGCAAACGTTTCACACGGACTAATCTTTCTGAACTGTAAATATTTAAAGAAAAAAAAGTAGTTTTGTATCAACCTAAATGAGTCAAAGTTCAAAAATATTCATTTCAATCTTTTCATAATTGTTGACCTAAGAATATAATACATTTGCTAGTGACATGTACATACTGTATATAGCCGGATTAACGGTTATAAAGTTTTGTACCATTTATTTTATGACATTTTACAATGTAAGTTTTGAAACTAACTGTTGGTAGGAGAAAGTTTCTTATGGAACGAATACCCTGCTCAACATTTAATCAATCTTTGTGCCTCAACATACTGTTGATGTCTAAGTATGCCTCAGTGGGTTGAGAAAATCCCCATTGAAGATGTCCTGTCCACCTAAAAGAGAATGATGCTGTGCATATCACTTGATATGTGCACCAATACCTACTGAATCAGAAATGTAAGGCATTGGTGATGTTTGCATTTACCCTCCTGTAAGCAACACTTTAACGTCTTACATTTTCTCTGATGATGTCACACAAAATTATCATGACAAATATTACCAGAGCAAAGTGTAACGGCCAACACTTTGTTCGCTCATTTTACGCTGTCTCTGACATAAGGAGTGCCTGAATAGCTTGGAAAAGTAACATCTCCTGGCCATCCCTTCATTTAACCAAGCTATTCAAGTATTCCTATGCCAGAGCAGTGCCAACTCTTGGAGGTCCCAGAGTGCAGCCAATGCCTTTGTGTGGTAGTTCTAAATTTTAATTGCACCTGAAAAACCTGGGCACCTAAGCAATGAGCCACAGCAAAAAGTAAAGAACAACAACAAAATAAAGCTGTTGTTAAATTTTAAACAATATTACTAATTGCCCAAAATGTCAATTTGATGTAGTTCTTTTCATGCAAGTATAAATTCAATTGTTAGTTATAATTGTTGGACCTCCTTGAGATAGTAACAACAAAATAAAGCAAGCTATCTGCACCTCAAAA
>TTN-203,,0,2210,360833,363042,GTAAGCTCACACATTCACACTTTTGTTTTTTTTTCCTTTGCCTCCTCTCCAGTAAGTTAACGTTGCTGCAGGACTTGACGCCAAGTTTAAGCCCTGCTTTCACTTCGGAAAATTAGTCCAACACTATGGAAAGGTCATTTTAAGGGTATACCATTCACAGAGTACTGACAAAATCTGACAATATAATGGCTTGAAATGTTTTATTCATATTTATTATTCCACAAAGCAAAAATAATTAGTGTTGGATTAAAATTGCCGTTAGAATCCAGCAACTAAATAGGACCAAATTTAGTCATTCTATATTTGGGCTCAGCTGCAGAGCCAGACTGGAAGCCAAGAACTCAAGCCCAATAGAAGCCAGCCACAGAGCCATGGGGTAGGCAGTCTGGGCTGCCTGCTCTGGACACCTGAACTTCAGTTGGTTCACACGCAAAATAACAGTGCATCTAATTTTCCTCAGAGGCAGAGCTGTTCAGTAATTAACCAACTCCTCATTATTTTATTATTTTATTTTCAATCTTTATTGAGTGATTCTAATGAATTAAAAGACTTTCCAATCGTTTTGAAATGACAGAAAATAATATGCTTCTCGGGTGTCTCTATTTAAAAGGAAGCAAACACTAACCCTAGAATTTTATCTGAAAGGAAGTTCATCTCTTTTTTGCCTTCTTTTTCTTCCTCATAACTCAGTTTATGGATGGTTCAAAAAAATGCATGGTATCATCTTATGAAAAAATGGAGAGTAGTGTATGAACTATATTGTAAATAATTTTAAAATTAATCAATATTTTCTCTTTCTGTAGTATTGTAACGAGCCATGTAAGATGGATACGGATTAAAAAAAATCATGCTTAATTCTTAATTTAGTGCACTTCCATGGTTCATTGCCCACTTCTTTTTTAAAATTTTATGGCTTATAATAAAGATATAAAATAAAATTTCTTTTTTTCTCTTTTTTTCTATTATATGCACCAATCTTATTCATAACTGGATAATACTTTCTTTTACATTGTACAAATATCATATAATCATTGCTTATTTTCTATTGTACATATATAGACCAATGAAATTCCCTTTTCATTGGTCTATATATGTACAATAGAAAATAAGTCTTACCGACTTCCAAATAATTTACCTATTTATCTGGTAACACTCAGTAACTTCTGAACTGAGCAGAACACATATGACTTCAGTGGGAATTTGCCTCCTTGAGAAGTAGTGGAATCTGGCTACTTCATATCTTCTTGTTCCTTCAAACTATATGCAAATAAATTATTACAAAGACACTACTGAAAATATCCAATACCCATAAATCAGTCCAATAAACTATTTAATTGGCCATAGTGGGAGATGGGCTAATGTATAAACAACAAAATAGACTTTCTCTAGATTATCTTTACCTACCAGCGTAAGTAGATAGAGCATCAACCTTTATGCCAAGTGTGAAATAAATCATGCCCTGAATGTGCCTCGTACATTCTCAATGTACAGAGTTTTAATATATTTAAAACATCAAACCATGGACATGTAGTTCTTGGCTCTACAATTTATGGCAGATAAAGAGAATTTGGCTTTCTACCTGCAATTCCAATGATCCATGTTGTTCTGGAAGACTAGGTTTGGATTAGTCTCTTATGAGAAATTGCTTGTCCATGTTACAATGTTTTTACTGATTGCACTTGTGAAAGCAGAAGAGTCCAAGAAGACAGTGTCCCTGTAACCACAGAGGAGGGAGGAGGGCATGCCTCCTGGGCTTGTCAGGCAGAAACTGGAGATCAGTTTGCTGCTTTTGTTCTTCACTTGCTCTCAAAGAGGACAACAATCACTCTTTATTTCAAATTTTCCTTGGTTCTTCATTTTTATAAGTCCCTTTCATGATTTTAATGTTGTCTATTAAATTGCATCAGATAGAGCCCTAGGCAGGCAGGCAGGAGATGGAAATTCTAGTCCCCTCTGTGTCACTGCTAGCTGAAGGACCTTGGAAAAATCATTAGGCCTCTTTTGGTCTCAGTTTCCTCCCTTCCTGCCTTCCTAATGGTCTGCAGGTTTACACACTGATCATGCAACTGTAGGGTTTTCCCTATCATTAAGTGGCATTCCATGCTGGAAAGCTTTTACAGATTCGGACAAGGCAGTGAACATGATGGGACAGAGCAGAGGACTTTGTGGTGCCCATTCAAACATAAAGGTGAATTGTTCTTGCTCTTCAG
>TTN-203,,0,1455,363043,364497,GTAGGCTGCTGGGGACCTGCCAATCCTCTGCTCCCCCAGAGGACATCTCCAGCAAATTGGGAAAGGAGTCCAGAAAAAGCTATGGGCAGAGGTAGATGCAGCTCTTAAACTACAGAAGGGTCTACTGGAGGCTGAATTATTTATAACCAAGTTGTTTGCCTTTTGGAATTTAATTTTCCTCTAGAGTACATCGTAAAAGTGACTGAGAATCAGTTTCTCAATACACATATTAAACACTCAAAAGTATGTTAAGGAAATATTAAAAATCATGTTTCTCAGCAAGTAGAAAAGCTTGGAGCCTTGTTTATAAGTCCTTTAAGGAATAAGACATATTCTCCAGGGAAGTGTGAATCTCCAGGAATTCACACTTTAACAAGCATCCAGATAATTCTGATGCCGGTAGTCTACAGACCACCCATTTAAGAGGCATGTAAACATACCCAGAAGAAAATAAATGCTTGTTTATTATTCAAATGCATGACACTGTTTCCCCAGAAAACTTATCACCAATCTTAGTGGCCTCTGTTGTTTTTCTCTATCCTTTACTACCTAGTGAGACATTAGTATACAGAATATTGCATGCCTTTACATGTTTTATAACAATATCTTACATGAGCTACGTAAAGTTACATATGCTTATCCAATAAACTTTACCTTCAATGATGTTCAATTATAGGGCTATAATTGACCTAAGCAGAAACCACATCAAGTAACATCAGGTAGAACTTTAGCATGCACCCAGAAAATTCACAAATGGAAAATGCACAGGGTTGGCAGCACCTGCTGTTGTTTATTACTCAAAATCATGTCAAAGTTAATTCCACTCACTCCTCACACTTATAAAAAATTTCCTTCAACATAACCAAAAAAATCCCCTTTCTGTAACACAATTAAAATGAAGTAATGTTATTATTGGGATTAACGTTTTAAATGCAAGTAAATATTTGGGTTATTTGAATACCTATCAAGTTGGAGAAGGTTTAGAATTTTAAAAATTAAATTAAAAATGTAATGATTCTTTAAGTAACAGGTACACCCATCGTAGCAACCACTGGAATTCATTTTAATGCAACTTACTGGAATATGCAACATGGCTTTCACATATTAATAGAGCGCTAGATGTGAGGTAGAGGGGGAAGTACCAGAAAGATTCTCAAGAAATGTTATAACAAAATCTAGAGCTTTTATTTAAAACAAAGAAACAAAAGGTGGTGGCCTAAACTGCTCAGCAAAACAAAGCAAATAAAATAAAATATGGTGGTGAGAAAGCCTTCTGTAATCTCCTGGCTCCCATTCTTGCTGTCATTGCTGGGTGAGCTGGGTTCAAGGACATTCAAGGATGTTTAGATTGGCGAGTCATCACCTGGTTTTGGAATTGGAGCTGTGATTATTTAAAAATACCTTGTAGGGAGCACCCTGGCTCTCACTCTTGACTTTGTTCTCTTGTCCCCGCAG
>TTN-203,,0,484,364498,364981,GTACGTGCTGGAGGTTGAGGAACAGAGAGAAGGGGAGAGAGCTGGTTTGTGTCTAAATGGGGCCAAGCGTCCACTTGCCACCTCTCACAGCCCTGGGAAGAATGCTGTGAGCTGATATAAAAGCTGGCTTTTCGACACCCATGAAAAGTCCCTGAGATTCTAGTCAGGAGCGCAGAATAGAAGCAATCTGTGCTTATGAATCTCATTATAAACTGGAAAGGGTTTCAATTAAGTGATCTACATTTCCAAATTATTGGCAAATAATGAAATTTTAAAAAATCATTCTAAGTAAATTTTTATCTTGTAATGAACATTTTCTATTTTTAAACCTAATTTATATTCATGCAAAATCCAAAACTTTCTGCAATTTTCTCCATTGGGATATCCAGAAAATCTTTTTGACTTTGTAGTCAGAATTAACAGAATCTCTTTTAAAATGGGTCATTGTGCCCCCTCCCAAACATTCATCTTTCCCTTCCCACAG
>TTN-203,,0,93,364982,365074,GTATTTTTCTATACTGTTGGTTTTCAAGCCTTTCAGGCTGTTGCGTCCCCAGCTATTCCTCCTCAACGTGGGCTTTGTTTTAATCTTTTACAG
>TTN-203,,0,4234,365075,369308,GTAAAGCTGCCATAGAGAGAGCAGATTATTGCACATTTTGGAACTAGGTTTTGAAACGAGAAAGATTCCCTTGTCCCCCTCGCAGGGCATGCGACGCGGAGAGTGGTTCGCTTCTTCAGTGTCCCGCTGCTCAAACCTCTAGGGGAGCATACAAACGGGCAGGTTGTGGGGCTCCGTGTTCCTCTGGACATCCAGCCGCTTGTGTGTCTGCCTACTAGGGTCTCAGGGGTTTTTATAGGCATAGGGTGTGGGCGTGGCAGGTCAGGGTGATCTTGGGAAATGCAACATTTGGGCGGGAAGGCAGGAGTGTTTGTCCTCACCTAGGTCCATGGGCACAGGCCTCGCTAGGGACCACGCACTTCTCTTCCCAGCACTTCCCTGCCCTCCTCCCGTGTAAGTTTCATGCACTCAAAAATGTAGCAGGTGACAAAGGAGGTAAACCAAGAAGTTACTGAATATGATTTTCACAAATCCTCACTGTCCACAGGTAAATTGAAGACCCTTATAAACTTCTGAATTCTTATTTATATTTCATGTAATAAATATCTACTTTAGGGGCCAAAATATGGCACAGTGAAAGGAGAAGAGCACAGAAGTTAGAGTTCAAAGCCCTAAGGACAAATCAGCCTGATCACTTAACAGTTTGATTTAGGGCAATAAGTATAAATAATAAAATAATTGTTATTATATATGGATCACTTCCTCTATCAGATTGGAACTATACATACATTATCTCATTAAATGTTCACAACCTGTAAGAATTATTATCCTCAATGTTATTGATAGGTAACTGGAATTAAAGAAGTTAAGCAGTTTATTTAAGGTTTCAGTTGTGTCATCTGTAAATTAAAGAGAGTCACAATAAGAATGATCTCAAGCTGCATTTTGGGGCTTCAATGAGATAATTAGTTGAAAGTGCCTTGTAAATAGAAAATAATTATGCCAATATTCTTATATTCAGATGGTAAGTAAAACCTTTTAAATATTTTGCATATGCTTGTGTTATTTTATCTAGAAAATAAAATGGACTTCTATGCTTACTTAATATGGAAGTATTTTAGAAGGTGATCATGTATCATGATCAGGGCTCAGAAATTATATAATCAAGTGTAAATTGTCCACAACAGTTTTGAAAGTTTGGGATTTAGTTTATCATGATGAAACTTTTAATATGATGAAATGAAAAATGTACAAAATTTGAGCAAAGAAGTGTTTATTGATCAATTTAAATGAAATAAAAAACACATGGATGTTCCCTGCCAAGAAAATTTTTTATAAAAGAATAATAAGGAGATAGTTGACCTAAATAATATTCAAACATACTGTAAAGTTACTATAATCAGAACAGTATGGTATTGGTAAATGAATAGAAAAATACACCAGGGGAACAAAACAGAGAGTCCAGAAAGAGATCCAAGTATAATAGATCCAAGTATATAGGGAATTCAAAAAGCAAAGTGGCCTTTCAATTCAGGGGAGGGAGAGGTATTTTAATAAAGAATGCTGGTCCAATTAGCTATCCATCTGGAAGCAAACAAACATAAACCTCTGCCTCTCACTATTTACAGAATAAATTTCAGCTTGATTAAATAGTTAAAAAATGAAAAAAAAAGAGAAGACAATCTGCAAAAGCATTTATGGGTGAAAGCTTTTAAAAAGACAGTTACAGATTCAACTACATAAAAATCAACATGTATGTATGGCAAAAGCAAAAAGTCATTTCTAAACCAAACAGCACTTGTGAAAAAATTTTAAGACCTTTCTCCTCCTCAAGGTACTTCATTGCCTCTGCCATAAAAGTATCACAATAAACATAAAATGGCTACAAGGTAGACAACACCAGCCTAGAAACAGTATATAACATACAAAATTACGTAAGCTTATGCTGGATAAGACCCATAAACAAGCAAAATATTGAAATGGATTAAAAGAAATGGATCTGGGGGAATGTTTGCAACACTTACGACAAATAACCAATAAATGCACTAAATGCATTAAAAATCATCCACAAATTAATTTTTAAAGGAAAAAAATGCAACACAAAAAAAGACAAAAGATACAAAAAAGTATTTAACATAAGAGGCAATGTAAAAGTCCAATAAACATGTGAAAAAAAATGCTAGATGTTTTCCAATTTTTATTGTTTTAGCCACAAAAATGTAAAGATATTGGCAAACACTAACATGAAACCTTGAACAAAAAGCTTACTTTAAAAAACATGTCTAGCAGTCGAATAAAAAAAAATGTTCAGTCTCAGGCTAAATCCAAGTTTGCACACCATGAAATCACAACACAAGCCAAATGCAATTTCTTGAGGAGATAACAACCTAACTATATTTTAAAACCCAAGCCTAAGGGTCATTTAGAATCATGGAGTGTCCCTGATCCCATGGAGCATTTTGACCATCTTAGCAGTTTTGAAAGTTCATTAATAACCATCCAAATTGCCCCAAAATTTTGCTTTCCAATAATTAAGAAATAAAATGCCAATTTGCAGAGAAAATAATGGTTATCAAAGATAGACTGCTTCCTAAATATCTCATAGTTTAATCTTGATTTTTGTTGTAGAGTAAGGCAAACATATTTCATTGAATAAGGTGCATTGTATCTCGCTGTGACCAGGTGATTATTTTTTGTTGTAAGTACAGAAATAAGCACTCTCCTATAATGACCAAAATTACAATGATTTTCACAGTTATGGGCTTACCTGTGTCCTGCTGTTAATCAGTCATGTCATGCTAATCATGTCTTTAACTCTTTTTGAATTAAACCCATTTACTAAGTACAGCAAGAACAAGGCACAGGGTGAAACTTAAAAGCACATGTCTCTTTGCTTTTCTTCAGTTAGTGGAAACCACACATTATTCTAACTTGGTTTTTGTTATATTTCAAAGGCAGTCATGTTCAGAAAAGAGGCTTATTCCCTAGATTTCCCTTTAGTTTGATTACAACTTCATTTACAAAATGTAAATGGATTTTCACACAAAAAAAGCCATTCTTCGAGAAAATAAACATTTCTTCGTGAAACTGGTTAATGTTGTAATGTACTGTTAGGGTACTCTGTAAGTTAGAGAAAATATCAACTGTACCTTGAGCTTAATTAGAATAATCATTTCATGTATGATCAGTGTAAGCTAAATATCCTAGATAGTGACAAGATGCATTTATAAACATTTTCTTATATGCAGAATTAATAAAATGCAATGATAGGGCAATACTGCCACCTAGAGAGGAAAATGTAATAAGCCTTATTAAGAATTAAATCAGTTCTGAAAAAAATTTTACCTTACAATAGTTGGCCAATCCCCAGAATTATTGCTATAGATCAGAAATAGTCTTTTTTGGCCATCAGTGCTGGGATTTAGCACCCAAATTCTTCAACTGATGCTACTTGCACTTTGGATACACCTAAAAAGCAAACAATGAAAACTATTCTGGAAGAAGCAACTTTATCAATTTACCCAAAAATCACAGAATCATTAGTTTTTAAGTTAGTCAATTCCCACAATAACTCTAAAGATATTTAAAATAAGTCCAGAGTGCAATACAAGGGGGGCGAGTGTAAACAAATATGGAGGAAATTAAAAGTAGCTGTCCACAAACACTTCGGCTAAAGCAGCAATTTGCAAAGTGCACTGCACAACCTGTACCCAGCAACATGCTGCAGAAAGCTTCCTGAGGATGTGTCCCCCTGTCCTGGAAATTCACAAGGCATACTGACATAGTAAAGGCTGTGGGAAGTCCTGCAGGGGAAAAAAAAAAATGGCTTAAGCTGCTTAGTCAAGAGTGGCACAAGCATTTTGATTACAGAAACCTTTCTTCTTATAACACCTATTTGACATCCTCTAACCCCCCCAGAATTGGAATACAGAGATGAATTTGGAATACAGAGGTTGCTGGATTTGACATGTCTTTCCTTTGGCTGCATATTAAAGAAGTAGCTTTTTCTGTTGTGATTTTTTTTTTTTTTTAATGTGAGAAGGTGCAAGGCACAAAATCTCCAGCTTATTTGGAATTAAAGCTGATTCTCTTACAGGGTTACAGCAGATAAGAATAGGTTTATTGAGATTTAAAACAAATTACTTCCAAGTACATTATTTACCCTCTGAATGGGTTATGGAGGCACACATTTTAAAACTCTGCCTTAAAGCACTTCCAGCTTTTCATCTCATGATTCACATCCAGTTACCCCTCCTTGCTTTGACATTCTTGACCTCTGCCTTTTGGTTTTCAG
>TTN-203,,0,370,369309,369678,GTACTGTCAGAATGGTTTTGTTTTTCCTTATTTCACATTCTAGTTTCTCCAACTGGATTTCTGCCATGAAACTCAGTCTGTATAAATTGGAGGAAAAATGCATATGAACATAAAAATATAGCAGCAACTGAAGACCAAATTCAGTAGTCATGCTTTGTAAAACCATTTTTAATTAGGACAAAAGCTCCAATCTGTGAAGTTTCCATAATATACAGGTTTTAATGATACAGTCTCTGTATTTCTTGGCAATAATAAATGCTTATGTATGAGTGTATTTTGCTCTAGGTGGCTCAGTTTTCCAGTATGCTTTTTTATTTTCTACTGGGCATGTCATTTAAAAAAGTAATCTACTTGGTCATTTCTAATCTAG
>TTN-203,,0,857,369679,370535,GTACGTGCGAGGCTGCCATGGGGCACCCGCAGAGCCACGTCCTTCAGTGCACATTAACTCAACCACCATCCACTGAGCTTGGCATGCAGCTGTGCTCAATTCATTCTGAAGACAGCCTTGAGCCCAGCAGGGCCCAGACTTTTAGAACTTTCTGAGCAAAAGGTGGTCGGAGATGTCAAAGGTGTTGACAATGTGAGTATCACAAGAGCAGAGTAGGCCAGAAATACCTGGGCTATATGAGCAGGCAAAAGTCAACTATGGTATTCAAGGTAGGAAGGCAAAGAGTGGCCAGAGAAACAGAGACCAGTCAATTCCAGAGCTCAGTCACTGCACACACTGGATGTGGAAACTACTATTTCAGGGAAGGCATTACATTTCTCTAAGTTTCCCCAAAGGACTTTTGTTTTTACTTTTCTCAAAACAAACATGACACTTGATTCATAGCTGGAACAGTGTCATAAATCCAGGATAATGTCCCACCTCGCATTTGAATAGATTTTCTGTTACAGTTTAAAATCATTCCAGCTTTCCTCCTTATCCTCTTGTGTGACATTTATGTCTAAATCCTGACAGATTATTGTAACTTTTTTTTCTTTTCTGAGACAGAGTCTCGCTCTGTCACCCAGGCTAGAGTGCAGTGGCATGACCTCCGCTCACTGCAGCCTCCGCCTCCTGGGTTTAAGTGATTCTTGTGCCTCAGTCTCGTGAGTAGCTGGGATTACAGGTGTGCGCCACCACACCCAGCTAATTTTTGTATTTTTTAGTAGAGGATTTCACCATGTTGGCGAGGCTGGTCTTGAACTAATTTTTATGTAAGATGCATTAAGGTGTTTTCTTCCTTTCTCTATGAAAAGCAG
>TTN-203,,0,1206,370536,371741,GTGAAAATGGGTTTGTATTTTAAATTCACTGAGGTTCTTACAGGGGTCAACACAGATAATCACCTTTACCATGAAGAGTGTTGTTCCTTGGGCCACATGGTTGTTAGCATACTAATAAGATCCCCTTGTTGTATGTGTAAATTTCTGGGTACTGGATACCAAAGTTTGGTAGTGTCCCTGAATGCTCCCCTTGTGAGTATGAAAAAGAACTCTGTGAACATACACCAGGAGTAGAAACAGGGGTCTCATCACATTGATCTGGGGATGCACTAAGTATAAGACTATAGGGAGAGGACAGATGGCTAAAACCAGGAGGAAGAAATAGATGCTGAGGCAGGAATGGGGAAAAGTGGAGGAGACACTGAACTCACTTTGCTTTAGAAATCTTAGCAACTGCTTCCTGGCTCCTTCGGAAGACATTTGCACATGAGTTTGAAGTGGAATGGACAGCATGGCTTTAACAAGCCAAATGACCAGAAAAGGTGAAAAGGACAGCCCCATGGTTGGCGGCATTTGGGGACAGATTGGAAAATGCCAGTTAGTAGAGCTCTTGGCCAGTGGAACCAGTTGGCAGTTGGGTGGTTTGAGAAGATGAATTTCAAGTCCCTTTCAGCCTTGAGATCCTGTGTTTCAGTGATGAGATATTTGAGAATGGCAAAGAGGCAAATAGAGAAAACTGTCCCCCTACATACGCATATACCTTAGGTGCCCAGATGGAAACAGCATTCTTCACAGTATTTAGGAAAACTGACAAAACAAAAATATTGTATAAATGCAGATTATAAATTATCCATGCTTGATTTCTCACATGTAAAATAAAAAGATCAGACAAAATTACTTCTAAAGTCTTCCATTCTGATATATATTCTAAGATTACCTTTAGATGACAGAATTAGTACAGAATAATATTGCCATAGATCTATTTGTAAACATTGGAAGTCATTTTAAAGAAGACTACAATTCTGCTGTTCAAAACAAAGTGTTGAATTCAACTTTGTTTTCTCTAAGCAGCCTACATAATTTACAGTTTAAGGAGAGAAAGAGCATGATCTTATTTATGAACATGGGATTATTTATTTTATTTAGTGACATCTGCAGAAAAGGGATTTTACATCTTCAAATTCCTATGTTGTTATATTTAATAAACACCATATTATTTCATTGGGCATCAGGAAATAAAGTTTTTTCTTAAATCATTCTTTGCAG
>TTN-203,,0,1956,371742,373697,GTAAGTCTGATTTTCTAAATATTTTGTAGTTTGTTGACAATATCACATTACAGCCAGCTGCAGGTAGCTTATAGTCAAAACCCTTAAATGGAGAAGTCTTTGGTTGTATATTTTTTGTTATTGTTCCTCTATGTCTAGTATTGAAACTCAGGATGGAAATTATGTTCACATTGCACTATTTTCCACTCACTTGATCAGTTTTCAGGAGATTGTCTACAGAACAGTTTAGGGCACATCTATGAACTTTCTAGAACATACATAAATGGATGATAGATATCATGCCAGTCCAGTTACCCACCGGGACAGTTGGTTTCTTCGTGCATAGCCTAAGCCCTCAGTCACTTAGATTGTAATGCACAAACTTTACATGCACACACACATGCACACACACACACACACACACACACATATACACATACATCAGCCATAAACACCCCGAATAAATAGCAAGGGAAAGTGAGGATATGCCAGACATCGGAGAAAGCAAATACTTCCTCAAAAAAAAAAATTCCTTCAATTCACGGTTGATAAACAGTGACCTAGAAGCATTTGCTGCTGTTGTGCCGTAGAGCTGTGTGAGGACAATCTCAGTGTCACTAAAATCCACATCTCTCCCGTATGTGAAATCAAACCTTTAAGTGTCAGGAGAGAGGCATTTATCTTGAATTCTTCCATGTCAAAGAGGGCGCCTGTGCTCATCCTCCTTGAACTCAAGCTCTTTGCTGATCTTAGAGCTACTTTCTTTAAAGGTCCAGTTGAGAACCTTGTACACTTAAAAGGCTGACCAGAGGCTGCTGACTGAATTTCCCTCTCCTTACTGTGAGTGAGACATTTTGAAAGCAGCAAGAACCCTACTTAGGATAATCAAAGGCATAGAAATCCCCATTGCCATTGCAATGCTGGTGACTGGCAAGTTCAGCTGGCCTATGGTTTTCCAGCCACTTGTCAGCAGCCACCCACCGGGTTCCCTAACACGTTGACATGTCTCAAGATGAGATATGTTCAGTTCTAGGACAATTTGCTAAGGCGCATGTGGGCAGAAAAGAAGCCCATTCCTCAGGAAAGCAGTCTATGTATTAAGCACAAGTGTAGGCCCCTGAAATGGAAATCTGACATTTTATCGTTCACCACTAAGCATCCTGTATTTTCCTGAGTGTTTCAAGGATGTCTTCCCATTGCTTTTGTATCTTTTGAAACTCAAATCTTTATTTTACTCTAAACATCAGATAAGACAGGAAACTGAGATAACTGCTGCATCCATGGTGGTAGTTGCCACTGCAAAGTCCACAAAACTAGAAACAGTCCCGGGAGCTCAAGAAGAAACTACCACACAACAAGATCAAATGCACCTAAGTTATGAAAAGGTGATGACTTCCTGCCAATGTGAAAGTCACTCTTGCACCATTTCATTTGCAAATCACCTACATTTTCATCATGGATCTTAATCATCACTTCTTCACTTCCACCTCTTCTTATAATGCAAATAGAAAATTTCTTTTCCCACACAGCTACCTTTCACTGTCAATTCATTCCTAACTTTCAGACTTTCTTTGGCTTGTTACTAATATAATATAATAATTCACTTTAATATCTTCCTATTGAAGCAGATGTCCGTAAACAAGTCAATTCATAATACAAAAAATTATGTGCTATTTACAGTGCTACTGAAATGTCTCAGAGATTGCAGTTTTAAAAAATGTGAAAAGTACAAAATAGCACTCATTAGTCTTTTATTGCTAATCACATTTTTTTCTTTTAAACTGGACTTATTGTTTTGATATTTTTGCCAGTGAAACAGTATGGATGATCAAAGTAACTCAAATGATATATTTTAGTGCAATTAAAATTTCCTTGAATAGGAAGAAATTTTGCCTCCTTTCTTTTTGACTTACGTTTCTTTTATTAAAGATTTATGGAATTTAATGACTATTTTCTTACTTTCTTTTGTATGATCAG
>TTN-203,,0,480,373698,374177,GTGAATACAGATATTTGAGCTGTGAAAAGTTCATCTTTAAACTAATTTCTAGTAAACTATTAACTACAATATGGTATGAATTATTAATCTGTATTTGCCTTTTAAAATCCCTAACTAAAAACAAAATGGTAAATATGAGACTGATTATCATTAATTTTATCTGCACATTTGATTTTCATCCATCTGTAACATTTATAATTCATTTTATTCACCATTATTCTTTGCATGAAGATTAGCATTTTTTAGCTTAATTTTTAAAAAGTGACACAGGGACTCATCTAGAGGTTTTTTAATAGCTAACATTTCTAAGTTTTGTGATTCTCAGTCAGTATATGTAGACATTGCCGGTGAAAGTTTATTTCTCTTGTGTATTTAACCCTGAATAACCATCTTGCATCCCCATGAGGAAGGGGGAAGGGTCATACTATGTGTGTTTGAAGCCCTGTTCAACTTAAATCTTGATTTTACTGTAATAATCAG
>TTN-203,,0,3218,374178,377395,GTGACTATTGTTGTTCCAAGTGTGAAATCCCCTATTATAATACATTAATACCACATATCATGTGAAATTCCTTATTGTAATACATTAATATCAAGTCTCTGAATTTCTTATGTATGAGTCACTATTAACCAAATTTATTTTTTAGACAATTAAATAATTGGAAACTAAAAAAATTTATTATTGTTAATATTACTACATATCCCTTTCTCCACTTATCTCTTCACCATTATTGTCAACATTTTATTAACATCTGGGAATCTTCCAGAAGTTGATTAAAATTGCATGCAGGCTAATTTTAAGAGGCCCATGAACATTTTTTAAAAACACGGAAGATGTATAAGTAAATGATGACTCTTACTCACTGTCAAGAAGATGTGTGTTTTGAAGGGTCATAAATTCAGTATATTATGTTATGGAGTATGACTTATTTCAGTAAATTACCCATAATTTTCTTTGTATGAAACTTTATCTTTTTTCCCTCCTGTAAATATCAGAGGAGAAGATAAGCTGAAAAAATTATAATGCATGCTGTAGCAGCTCCCACTAAAGCTAAACAAGATGCATATTAAAATCTAGAGAAGGAAGTATCCAAACAGAACAATTACACATAAGCCATGAAAAGATTACCGTATCTATTTGTAGCTATGAAATATCCATGAATTAAACTGTTTCCCATGACTCTGTCATTTACTCCAAATGAGCCATTTACCTAATTGTATTCTTTATTGCTAATATACCACTTGAAAATTAGCAACTAAAGTTTTTCCATTTCATTAGCAGGATGGCCTGAATCCTATTTGTATTTCCCTCAGTGTCATTTTCTGACTCTACATCTTTTTTTTCTAAGATATGATTTAAGATAAACTTTTTAAACCTTTACTCAAATCTAACATTTAATGGCATATCAGCCTTTCAGAAGTCTCATAAATGACAGAAATTCCACTATGCAACATACTTCATGAGTGATTAACTTTTTACTTTTGTTTCCATTCAAATTTTGTCATGAATTGACTATCTTGTTTTTGTTAAAAATTAGCTAAGGATGGAAGCTGAGAAAATGTTTATACCTGAAGTAGTAGTTACCACTGCAAAATCTGCTGAACCAGCCACACCGCCAATGACTAGAGAAGGATTCACTATTAAACAAAAACAAATACATCTTTTTCGAGAAGAGATGAAAACTGATGCTATGGAGGTGAAAAGTATTGTTTCATCCCATTTCATCATCAACTCTCATAACTTTTCATCCGTCGTGAATTGTGCTTCTAGTGTTCCATCTAATTGTTTAACTGATCAATAAAACAATAGAGATGGTTAGATTCAGTCCATCCTCCAGTTGAACAGTGAGCATTTCTAGTAGTGAAAAGTCAGACCAAATAATACTCTTCTTTATGTCTCCTAAATTTATTCTCAGCATTTAACTCGTATGAATTGGAGTATTCTAGTCCAATTTGTCTTCCTGCTTCTCTAGGTTACAAACATGTGAGAGATATCAAAGTCCACTAAGAAATAAAAGCGGTTACCAGCATACTCATTTGTAGTCCACCAATAAGTGTGTGTATATAAATCTGATATACAATAATTCAAGGAAAAAACAGACAGATGCTTCCTCAATTTAAAATATTTTACCATGATTAAGATTTTTCCATATGTTTAAAATCAAGAACAAAATTTAAATATTTCAGTTGTGTGATATTTAGTCATATGACAGTTTCTTTGACAGTTTCTTTTATCATTGTTAAAATAAAATTAAGACTTAAGCTGACTACTTCATAGCAGACTGGCTAAAAGGTTCAAATGAGATATAGTGGAAATGTGATCACACTACAATCAAAATAATATTTATTTATTTAGTGTTATCTGTCGAAGATGTTAACATTTTAAAATGTCTATACAATTAAAGTCAGCTCATTGCCAATATAGTTTTTAAAAAAGAAAAAAATAAATGGACAAACTTAACTCACCTAAGCCTCATGTGTATTTTATGTTTTTTTCTGAGATGATGCAATCTAAAGTGAAGATGGTATTTGCAGTCCTTCGAGGCAGATGAAATTGTTTGTGTCTTCCTAAAAGGAAGCCCTGGATAAAGCCCATGATCACTAAAGACCCAATTCCATCTCAGAAAAATCTCATTTATATCTTGAATGGTTCAGAGAATAATTTTTAAAGATATGCAGGTAGCATAGTTGAAGAATGTTTCTGATGCATTCTAGATTCTATTCACAGGTATAGAAAACTGAATATTAATAAAATTTTCCAATCTTACTTTTAAAATGCACTTTTAAAATGTACTTTTAAAATGAACATGGCTATGTGATTTTTGAGGTATGCTGTTTCCAAGTATCACATAGAATCATAATATCTAAGCCACATCAGCTAGTTTGCCTTCTTTAAAAGAGAACCTCCTCTGCAAATTGTATTTCCATTAATGTTCATCAGACTCAGAAACGAGAAAATAATATTTGTTTCATTCTTTGCTTTAACTCTCCATAATAATGAAAGTAAATTAAACTTCAATGTGAAAGGTTGTTCTCTTGAATCCAAACATGATAACACTTTCATTTTAATCACAATATTTTTATTTGCACGGGGTTCTCTTTGTCATCTGTGTGTTTTAAGAAAGGTATTTTCTGATAGATTAAACAATCTTACCCTTAGGGAATCATAAGTAAATTCATATGCTCACTCTGTGTTTGTGAGCTTTCATGTTATGTCCGATTTGCATGCAACCATATAACTCTGTAGTCACTGATTTTTCTGGACAGGATGATGACGGTATTTGAGTGCACTTATATCATCACTGTCACTGCATTAATACCAGACTAAATGGTCAACAAGATAATAAAAATAATCAGTGAAAAGAACCAGCTCCAAAATTCTGATTTTCCAATTGCTGATTGATTGTCTGCCTGGAAAAATTCTAGAAAATTTCAAAATCTTCTTGTGATTTTATGTTCATATTGTGATTGTCCTATGTTGTGTATATGTGATTTAATGTCTAGTATAATTAAGTAGGTGTACAGAGAGTATATCTAAATAGATGTCTGTACAATATAATAATCAATGAAATAGTCCCTAAAAGTGTTTCTGAGATACATTTCTAGACACGTTAACACTGCTGTATAATGTGGACGCCATCTGCCTGTCCTGATGCCCAGGAGATATTCCAGCCTGATCTCGATATTCCTATGTATTAATTCTGGAAACCTTGTCTCCAG
>TTN-203,,0,105,377396,377500,GTGAGTCTATACCTGCTGATTTTTCACCTTGTTCATGGTAAAGCAAGCCTCACTGCTGTGGTCATCTGGTGATCAATGGTATCACTGAGTTTCATTTCAATGCAG
>TTN-203,,0,1268,377501,378768,GTAAGAAGTTACAGAGCATGATACAGAAATGTTTAAAGGAAATAAGTATCTAACCTGTGAAACAGAGCATCTCTGGGGTAGGCCAATGGAGGATTCTTTTTTGGTGATGTGTGTGTGCGTGTGTTTGCATTCACAGTGGGCCCAGACACCCTAAAGATTTGGTTTCTGAAACTCGCCCAGGGGAGTGAGCCTAGAGTCACAAGTGGTTATCTTATACCTCTGAGGAGAGACAAATCCACACAGGCTTCTCTCTAGTTCACATTTCAGGGACAGCTCAAACTCAATTGTTTTGATTACTATTGTTCTAATGATTTTGTGAAAGGTAGTGTGTTACACAGCATAGTTTTACTTATGCTGTGAGACATTTCAGAGTAACTTAACTGTGAATGTGTTTCAATAATAAAGACAGACATTGAGAAATCATATATTTATATACTCAATATAGCAAGATGGAGAGGTGGTACTGTATGGTGGTCGGGTTGGATTGTGGAATCAAATAGCTCTGGATTAGTGCCCTATCTTCTCCCTTATAATCTCTGTCATCAGGAGAAAGTAAGCATACATGTAAAATGCAAGTAAAAAGGACATAAAAACCTGCAGTTGTCAGCATGTAATAAATCCTTGATATTAGTCACTATTGTTATTATACACATCCAAGAAATAGAACCCAAACCTTCTATGCCTTCAAAGAACTGTAAGTTACATATAATGCCTATATTTGATTTAGTCCCAAATTACAAAACAAATAACCATAGACCACAACAGAATAAAAGCAGTAAGGAAACCTTTAAAATATTTTTTCTGAATGTCTTCATGTTTACCTTTCACATAGATTTGTGGCTAAAACCCAAATGTACTATTGCAAAGTAGTTCTTAGGCATTTACCAACAATTTCAATAATTTCTTAATTTTGAATCTCCCACTGTGGTATTTTCAAAAGTGGCATTCATCGGAATGGTTAAGTGAAAATTCGTGACTAAGCTTTAGAAGATCCTGTCCTTTTATGATAAAAGCTGTAAAATAAGGAGTTCTGAATACAACTCTTTAAAAAAGATATTTTAAAATTTGTTTTACAAACTAACAGGCATGACAAGGAGCTTTATAATTGGCTTATCTCTAAATGACTTTTCATTAACTGTGTGATAATGAGTGCTAATGAGAACATTAAAGAACAGACCTTATAGAAAATAGGCTCAGACTCAGTCCAAGAGGGCTAGCCATCGGAGGATGGTTAAATGACTTTATTTTCTGACTCTGTTTCCATGTAG
>TTN-203,,0,284,378769,379052,GTTGGTCACTGGTTACCCGCTGTTACATGGTCCACTCCCATTGAGCAGGGCCAGGTGGTTGGCTAGTTTGTACTGAAAAGTAGCCAGTGGAGTCTTGCCTTTCTCCTTTGCCATACTAAGACTTGATTTTTATGGAGCATAGTATGGGTCAGAGATCATTTTCTCAAATTATTTTTATAATTATTTTTATATTTTTATAATTATATAATGTTGCATGAGCTAAGAGTTTATGAGATTTCCCTTAATTTCATGAGCATTTTGTAATATAATTTGTAAAAATCTAG
>TTN-203,,0,655,379053,379707,GTGAGTAAAGAAGTTGATAATGCTGGACCCTATTCATATCTCCTCAAATCATTTTAATACACGTTTGCAAAGATCAGTTTCTCAAATTAATACAAAAATGACATTAGTGAGCTTACAGATGCTCATTTTAAGACCGTATTTGGTCTGGAAGACCATATTTGACCATATTTGGCAAGGAAGAAGGGAATTCTATGTGGTACATCATTCATGGATTCAAAAGATTTAATGAGCTTCTAATATGCAGAAGGCATTATTGCAGGAGCTGTGCAGACATAAAGACCAATCCATCCCTCTTTGAAATATTTTCTTTGCCATCAGAGAAAATGTACACAAACAAGCATAATAAAATATATAAGGTGATAAACATCACAACAGAAGGAGAATCCATGGGAGGCATAGATTCATTCCAGTTGGTGATACCATGGCAAAGCTTTGTTGAATAGGTAGCATTTGCTATTGAGCCTTACAGCTCTTTACTAATATATTAGTATATTATATAAATATTAGTTTCTCTACTACTATTTCTGGAGTCCTGATTAAAAGGCCATTTTGTGGCAGTTGAAATGCATAAGTTCAAACTCTACATTTGTTACAAAACAGAAGTGATTAATGAATATGCACACGTATCATTATTTATTTTTTCTCCTCTCTTCAG
>TTN-203,,0,203,379708,379910,GTTAGTGGCCACCCTCCCACAGTCCTAATGCACATGCCATCACTTTCATCTGACACTCTTTTCCACAATATGGTTTCTGTGCACCTTGAAATGATGTCCCTTTTTGGAACTTGGGGGGAGATTATATGGTCAATTTAACTGTCAGTGCTAAGCAGGGGTCACTAAACATCTCATCTCAATGAGAAACTTTTGTCTTCTTTTAG
>TTN-203,,0,111,379911,380021,GTAAAATATTTTGCTAATTAGTAGCTGTTCTAGTACCATTTTGACTTTCAGCCCCACCAGTATTGGCAAATTGCAACCCGGAAGCTAATATGAGGGGAATTCTCTTTCCAG
>TTN-203,,0,948,380022,380969,GTATTTTGATGGCTGAATATAGAGTTCTCTGTGACTTGTATAATACGTGCATGAAGCCTAGAGTAGAATTTACTCACCCCACCGACCCTGAGCATAGGCTCTTTCATTGTGGAGCCTTCTTAGTTTGTTTTGAGGTATTTTTACATTTTTTTTGTGCAAAGTCTTCCTAAGAAATAAAGCTATGTGACAAAAGTGGATGGAAGATATATTTCTTTACATTATAGTTTAATTCATTGAGTTTGTGAAAGTAGAGAAAATATGGATTTTCACACAAACACACCCACACACACACACACACACACACACTTCCAGAAAAGATTTGAGACAATTTTCAATAAAAACATGTAATAACTAAGTGACTAAAAGATAGAAGAATAGCCATGTAATGAAGAAGAAAGCTAGTTATGCACAAAAATCTATGCTAGTAATTTTTCTTCAATTCAATATAAAATTTAGCTCTGAATATTTTGCAATTTAAGATAAAAAGAGCAACCTGGTAATCTAAAAATGTAGGTGCCGTACCTTCATAATAATAAATATAATGTACCAGAGAGTTAATACTGAAATATTTGAAGGAATTTATTGTTTTAATTATTCATTTGATCTCTGAATGAAATAATGAGAAAAATAACGAACAAAGAGAAAATACCTGTTGTTTAAGTGACCTGATCATTTGCTAACATAAACACTGAAAACCACTTAATTTCATGACTGATTCTAGCAATAAATATTCTTTAAAATGAATATTTTAACTTATTTGGCCCTAATTACTCATGTTCTTGCATTTTTCTCAATTTTCAGCAATCTTATAATCTATTGTGGAGCTTAGTCATATGTTTAGGGTCATTGAATTTTATACCACAGATCCACTCACAGATAAGTCCAATTATTTTACCCACAGAAGAGTTGTTGATAACTGATTTTTAAATTTTGTACATTTACATAAAG
>TTN-203,,0,915,380970,381884,GTAAGTGCAACTCCAGTTTCTATGTGCATGATAAGAACTGAAATACAAGGAGATAGCAGTGCTGTCCGTTTGCTGAAAAACCTGTTGCCACTTACTGGTTCTGATACTTTGCCCCAGTGTCTTTGCCTCAGTTGTATGGAAAATGTTTTAGACCACATGGCCTCAAAAACTATACTGTCATTAAACTTCTGAGGTTCTAGCAATAGTTTCTTTTTGTTGTATTTGTTTCTAGGCATATCATGCCTCTGAAAATGCAGAGATTCTAAATCCGGTTGCCTTCCAGGCCCAGGCAGGTAACAGTGAGCTCAATGAAAACAGTAGCAAACTGGAGAGTAGGTGCCCTGCCTCAAAGAGACAGTAGCTGTGTTGTTGCCAGGCATGCACCAGGCTGTTACCAGGCTCAGTGTTGCTAGAGCTCCTGATATCTTAAAGAAAACCTGGAAGTCAGGATTTTCAATGTTTATAACTTGAAAACAAATGTAACAGCTTTCATGCTAGACTGTTCACATTTACAGTGAACTGGCTCACACTCTGTTTCACTTGACCTACACAGTATCCCTTAGAGGAAATTACAATATTATCTTCATTTAGCAGATAAAGCACTCAATATTCAGGAAGGTAAATGAATTGTTAAAAGACACACAGCAAATTAGGAAGTCCTCCGTGGTAGATCCCCCCAAAACTGACTGCTAATATAAAATTCTTTCTACAATTGTAATGGCTGGTTGGATTTGTTAGTGTTAGTTTGGTTTCCAAATTCCATCTAGAAAATATTGAGCACTTCAATAGTAGATATTTGGAAAATTTGGTTTTTGGTTATCAACTTTCCCCAGTGTAGAGTTTACCTGAATGCATAGTGGTATGACTGTTTTCTAATAAGAGCATTAAAAATTAACTGATGTTCTTAACTCTTAG
>TTN-203,,0,537,381885,382421,GTGAGTATAAAAGTAATGACCAACCAAACAATTTCATAAATTATACTTTCCTTTTTTTATTTGATATTTTCATTTTCAAGTGATGAGCTCGGGGTTAGACAGCTATTAGAAGGTCCAAGTTCACTGTTGCTAAGTTTCCTTAATCTTCATGGTATGTTGCACCTGTGAGTTTAGAAATAGAGATTACATATAGGCCATAAATGTGACTTTAAAAATAGGGCTTATAATATATTAAGGAAAACACCAATATTAGCACAGCTGAGTTCATTCATGCCAAGATCTCTTCATCTGTGTGATAAGCTAATGTAACCTCTAACCCAAATCTAACTCCTGCTTTTGGAATACCTTTCTACCCAAGATGCCACAACATTCACTGGGAAAGATGACCATAATGCAGATTAAAACAAACAAACCAAAAAGTCCTCTAGATTCTTCTCCCAGCTAAAAACTTCAACAGTCTAGCTCAGATACATCTCCTTAAATAATTTATATCAGTAAGGATATGTATTTTTAACAGACCATAATCTTTTTGCATAG
>TTN-203,,0,110,382422,382531,GTAAAATATAAACATTTATCATAGCTCCTTGCCACAGTAAAGATACAAATTGGTTAAAATATAACTATTTGATGTAAATTTTATTCATACATGCATGGTATTCTTTGCAG
>TTN-203,,0,898,382532,383429,GTAAGACTTGTAATAATTTGGGTTATTTAGTATGTAAATTGTTTTCAAAACATCAAATAGTAGCAAATTGCTATTGTGTAAGAAGAAAATCGAGGGCTAAAATGGCACAGAAACTTACCATTGGCAACACCAACAATTGCCAGAAGTTTTTATTTCTTGCCCCTGTGTAAGATGAGCAAAGAATTTTCATCAGTGTAACATACTGTTTATTTTCCTAGTGCTATAGCTAATATCACAATAGCTCTTATTTGACACCTGATTTTTACATATGTAAATTTATACAACAGCCCTGCAATAAAAAGATGACTATTATTGGTTTGGAAATAGGAACACTGAGGCCCTGGGAATCTATGAAAATTGTCTTAATTCATCCAGCCTGTAAGCGGTGGTGCCAGCATTCAAACTCCAAGTCAGTCTGGCTGCAATGTGTAGATGGAGTCTTGTTTTGCTTTGTTTTGTTTCCAAATTCATTTCTATGTTTTCCTCCTCTGAGATAAAGAATGTGTATTTTTTATTTTTCCATAAATGTATTCATTGGTTTACTTATCCAACCAACATTTATTAGGATGTTTTAGTAGTTAAATCAAAAAAGTCTAGTGACTGATTAAATCCAAGTGGTAAGGAAAAGAGAGTATTGAGGATTATTCCAAGATTTTTGAGCCTGGGTACCTGGATATACTGAATGACTACCAGCTAAAATTGAGAATATAGGAAAAACATAGTTGTGGGGGCAACAATAATATATTCTATTTTAGATCTGAATGAGTTTGAGGTGCCTTCTAATACGTGCAAGAAGTAAATTCTAAAATAACATGAATAATGAATAAGACAAAATGAAGTTTGTTTTGCTGAGTTTTCTTTATGCCTCACGAAAGTATTGTGTGTCTTTGTTTTGCAG
>TTN-203,,0,119,383430,383548,GTAAGCGTGATAAGTTTTTGCTCATGAATCATAAAAACACAAAAACAAGCTTATGTATGCATCTAACAATTTTTAAAAACTATTTTAAAATCTACTTTCTTTTAAACATATTTTCACAG
>TTN-203,,0,102,383549,383650,GTAAAATGAGATAAAATAAAAATAAATGAATTTTCTTATCACTTGGGTTATAAACAGGTATTTCAGCCTTACTCCCTCTAAATCATGACCTTTCTCTTTCAG
>TTN-203,,0,99,383651,383749,GTAAGTATGGAAATAATAAAGCTAAGCTCATTATACAAATCCAATAACCAGGGAAGCTATACCACTATATTGATTATTCCCTCCCCCAACTTTTTATAG
>TTN-203,,0,153,383750,383902,GTAATTTGCATGTCTTTCCTTTGATGGACCTGTCTTTGTATTCAAGAATATCCATGAGTGTGTTTACTTTTATTTTCTTTCCCCATTCCTCAGGTTGAGAATTTAATTTAATATAATGTGCTCTCCCCTTTTTCCCCCACCTTTTTCTTGTAG
>TTN-203,,0,447,383903,384349,GTATTCAACAACGAAGGATTTCATTGTTTACCTAAGCTCTAAAGTCACCCTTAGCATGTGGTAAAATTAGCTATGCAATTTTTCTTTCATGAAACAATTATTTGGAAATTGACTATAAGTTTCATAGCCAGAATCATAAATTTATGTTCGTAATTAAGAATGTTAACAATTTGACCATTTGGATTTTTTAAAGTAGTATTATCTTGATTTTTAGCTTTTAAGTTTTTTATTGAAGCATAATTCTTTACTTTCAAAAATATTTAAAAATTAAAATAAAATAACTGCTTCTTATTGAAAATTTATCTCTCAGCCCATCAGCGGGTAGATATTAAGAATACACCTGATAGTATGGGGGAGATAAAAGACATACAAGACATCATCTCTATCCTAAGTCTAGATGCATACCTCTCCAAAAAAATTGATTTATCTTTCTGTTATACACTTCAG
>TTN-203,,0,96,384350,384445,GTAAGTCCTCCCATTCCTGTCAGCCTGCAGTGAGCATCATTATGGTTTATTGATAAAAAATGATCATAACATTCTTTTTCTCCCCATATTTCACAG
>TTN-203,,0,112,384446,384557,GTGAGTCCTAATTATAAAATTTTATGTTTACACTATTAAGCAACATAAAGAACTTCAAGGAGCAGACAATTTCAACAAAATTCATTCATCTTGTGTGTGTATGATTTTGCAG
>TTN-203,,0,92,384558,384649,GTAAGGATTATTCTACCTATCTAATAATTACTTTAAGCATTCTACTTTCCCAGTGTAACAATAACCAAGAGATTATTTTATTTTTTCCCCAG
>TTN-203,,0,1637,384650,386286,GTTGGTATATTTATTAACCTAAATTCTTACGAGGAGTGATTGTTATTTTAAGAAATTATTATTCATTTCCCCCAAAATTCCTTTCAGTTTCCCACTTCCATGCCTCTGCTTATGCTGTTCCCAAAGCCAATAGTACTTGCAACACCATTCCCACCAGCCTAAATTACAAATGTTCTTCTAGGCCTACCTCAAACGTCACCTTCTCCATTAAACCTTCCTTAATCTCTCCATTTGTATATGATCTCTTCCTCATCCAACCCCAGGATCACTTTATATGTGCCTCTTTCCTAGTGTTTATTATGCACTTGTCTTATTCCCCATTTCCTCTTTCAATATCAGTGTATAAACTCCTGAAATCTGGAATTCTATTTGTATATTCCAATATATTGCAAATGACAGATAATCAATTGGTGTTTGCTGTATTGAGCTTTATTTAAACTTCCTTACTCTAAAGAATTATTTCCTTTTTTAGCCATTCTTGCTTCTTTAGCCTTTGTGCCTTTTATTTTCTTCCTACTTTTTAATGAAATCAATAAATATTTTCAAAATACAGCTTAATGTAACTGTATTTCTTATGATATCATGTAGAAATAAGACCATCATTCAGTAGAATTTCTTAGCTTTACAATGAAGAATAAAAAATGTAAATCAATTGCCAGAAAAAACTAGAAGTCATCATTAATTTGTTTGGTTCATTACAGTTTAAATTTTGAGGAGTTGAGATGTTACATTCAGATCGTGTTGTCCATTACATCTAGTATTGAAGCAAGTCATATGGTAATGATTTGTCTTATTTGGTATGAAAGTTTCATGGTTTATACTTACTTACGTTATAAGATTTCTTCAGAGATCGGACCATGAAAAGACTTGTAAAACAAAATTTCAGATTCAGCATTTTTATACATTTAATATAAATTACATGTTTTAAATGTGTGGAAACAGGAATAAACTATGAACTCCTCTGTGATTTCACCCAGTGTTTTTAAAGTACCTACCATTGGTCAGACACTTGTAGAAACTCAGGACACAAAACTAAATAAGAAATGATTTTTTTCTTGAGAAATTCATAATTTAGAGAGGACAGATACATAAGCAACTAGCTTGTTAAAGCAGTAATTATTTCTGCTAATGGATGATAAGAGTGGAGGCAATGGGGTGAAACTTCATAGAATGGGCGACATTTGCCAACACAGTGATTTTTAATATATAGAAATCCTCAATGTAGTAGAAACATTGATGACTCGTACATTTTGTTTAGCAAATTTTTATGTAGTCAAAATATCAGATTCCCAGGAAATAATCATTAAAAGACCAAGTAAAATGCTTTTGAAGAAGAAGGAATTGGGTTAGAGACTATCCTGGTGGTATACTGTTCTAAGAATTTCCTATTAATTCAACAGTTATTTTTTCTTCACAAAACTTTTCTGATTCCAGTATTTCTCCTAATTATCAGTTATGCATACTTAGAATAAGGGATTTCTTTGGTACCTTCTCAATATGGGTAAAAACAATCATAGACATTTCATGATTTCAAAATCATGTTCTTAAATTTGATATTTTATATTTACTTCTGCAAAGATTTTCCCATTGTGTGAATATGTTTAAAGGACTCATACTGTACATCTCTTGTTCCAAAG
>TTN-203,,0,535,386287,386821,GCAAGTAACATAGGATTTGTCCTTTTCAAATCATATTACAATCTTGATCGTTATCGTTTTAAAAGACAAACGATATGGCCATTTTGGATACCATAAATTTTCATTTCATAAAGTCATTCTAGATCCTCTAAACCTTCCTGAGACACATTCCACAAGGTACAAAATTGCTTATCAAATGCGTTTATGCAAAAAAGCCATTTCTTAGGTTAAAGCTCTGTGAAACAGCTAAATCAGACACTGATTCTCCATTCGTCTTTCACCCTTCTCCAATCAGTCTATTATGCTGCTAATACATAGCTATGCAAACTTCATACTACTAAAGCATAGAAAAATCATTTCACGATGTACATGTCCAGTTGGATCCCAGGTTCCCCTAAATAATCTCAGGTGTTTTTTAAAACAGAGGTGCTGCATAACTGTAAAATGTTTGGTAGCCATTCTTTTGCAGGGTGAGTAAGCAATGATCTTGTTCAGGACTTCTTTTCCTTGATGATGTCATCTATATTTTCTAACCCAATCATAAATTTGTCTTTAG
>TTN-203,,0,91,386822,386912,GTAAGTTGATTTAGAAACACTTTTCAAGCAGTCAGCCCATGGTTACCATTAAGTTAACCCTATCACTGAATTGCTCCAATTTTCCTCTTAG
>TTN-203,,0,120,386913,387032,GTAAGTATCAGGCAGCCCCCTACAGCCCTTTCCTTAATGAACCCCATGTATCTATTTGTTTGGTTTCATCTACTTTTTAAACAAATTGTATTAACTGAAGTGCTCTTTGATTTTACCAAG
>TTN-203,,0,745,387033,387777,GTAAGTTAAAAAATATATATATATATATACACATATATATAAAATATCAAATATTCAGTAGATTCATTGATATTCTATATCCTACACTTTGCTGACCACTCAAAAATCCTTGATTGGGTGGGCAGGGTGGCTCAAGCCTGTAATCCCAGCACTTTGGGAGGCCAAGGCAGGAGAATCACTTGAGATCAAGATTTTGAGACCAGGCTGGGAAATACAATGAGATCCTGCCTCTAGCAAAGACAAAAGGAAAAAAAAAAATTAGCTGGGCATGGTGGCACACACTTGTAGTCCCAGCTACTCAGGAGGCTGAGGTGGGAAGATCGCTTGGGCCCAGAAGGCCAAGGCTGCAGTGAGCCACAATCACGGCACTGCACTGCAGCCTGGGCGACAAAGTGAGAACCTGCCTCAAAAAATAAAGAAAAAAAATTGTTAATTGAAACATCTAGTATGTGGTTACACTGAGTAAAGCACTAGTATCTCCACCTGGATAAAATGTTCCAGTTAGAGTAGCATTGAAAGGCTACCTGGAAAGATGCCTCAGTGTCTATCACTTGATCTTTCTGTTCCTCTGTGAGTTGGCACTGTCCTGTATAGTACATGGAAGGTATCAAAGCTTATATCTCTAAACTGTAATCTCCTCAACAGACGCACTAAAAACATTCCAAATTTTTATTCTGCACCTGTTATAACCCACATCATATTTACGTAAAGTCTCCTTGGGTGTTTTTTCTTTTCTCCTTTGCAG
>TTN-203,,0,517,387778,388294,GTATGGTTTCATACATATTAGATCCATAGAAAAAATGTCATACATGCTTTATAAAATTTAGTGTATCAATTAATGAATGGATAAATAAAATGTGGGATAGCCATACGATGGGATATCATTCAGCAATAAAAAGGAAGCACTACGATATGCTACAACATGGATGAACCTTTAAAACTTTATGCTAAGTGAAAGAAGCCAGAGACCATACAAAGACCACATATTGTATGATTCCATTTATATGAAATGTCCAAGATACACAAATCTATAGAGATGTAGATTGGTGGTTGCTTAGGTCTACAGGGGAGACAATAGAAAAGTCCTTGGGGTGATGGCTAAGGGTTACATGATTTCTTCTTGGGGAATGAGAATGTTCTAAAATTATGGTGATGGCTACACAATGATGAATACATGGAAATTCATTGAATTGTATACTTTAAATTGGTGGATTGTACAGTATGTGAATTATATCTCAATAAAGCTGTTAAAAATGTTAATTTTTCTACATGCTATTTTCCAG
>TTN-203,,0,89,388295,388383,GTCAGTTGTTTTGTCTTGCTACATTCCAGTAATTCCCAGTTTCCTCTGAATCACCATACGGTAAACTCGAATTTCCATTTCATCCATAG
>TTN-203,,0,1146,388384,389529,GTATTGTCTACATACTAAATGTTTTGAAAAATCATCAGTAGTCCATAATCTATCATTTTATATTTTAATGTTTCCCTTTTACATTTTCTAACCACCATCCTTTAAAGAATTAAATCAGCTCATTCTTACTTGGCTTAGACTCTCTTATGCTGACCTCAATTTAGTCACAGTTTCCACTCAGGGAATAAGGGTGTCCCTAGCAGCTGTCTAAATACGTTAATTAAAGCAGCTGTAGAAATTTCACTGTCTAATAAATGGCTGCTTGCCAAGCAGCACCAACCAGAAAAGAATTAAAATGTAAATCGTGAGGTTCACACATCAATTAGAATTAAGGAAATTTAGAACAAGGTGATATTTTCTCAGAAGGTTTCTATCTGTGGAGAGGCAAGTGTCAAGGAACTTAGTGGCTAGAAATACTTTCTGTGAAGTCTAAGAGAAAGCCCTGTCCAAGCCGTGCTGGGTTCCTGGCAAGGATGCTGGGCACTCTTGCTGTCGGCTGCATTTACAGAGCTTGTCCTCATAAGTGTCCACCATCCCAAATGATATAATGGAGGAAACATGTCTAGAGAAATACCAGTTGAGTTCAGCTTTATCATATTGCTCATCCAAAGAAAACCAGGCTTTACAGACTGTGGACTATAATGAAAAAGGCTTCAATGAGGACTCAGATAACCTGGAGATGTCTTCCATCATTTATTTGCCAATTCTGAACCTCAGTGTTCTCACTCTTAAAATGAGGATAATAATTCCTACCTAGCCCACAAAGTTATTATTCATATAAAATGAAATCAAATTAAGTAATAACTTTTTAGACAATAAAAAGCCCCCAAAGGTAAAGCATCATTATATCCCTTATTAGTAAATAAGAAGCAAACATTTAAGGATGAAATAATTGTCTCTTTGGGGCAGCTCCTTTCCTCCATGCAGCTGTAAACACAATTCTCTACAAGAGAAGTTTATGTACCATTTGTCCAATACTAGGCAGGAAAAATTAGAGAGTGCTATAATCAGCCAACTTATTACATTATAATATATTGGTTTCACATGCCATTCATTGACCAGTTTTAGAAATTGATTAACTGGGAGGAAACCAGAGCTTCAAGTTTTTGTTGTTGTTGTTGTTTTTTTATGTTGTTCCATCAACAG
>TTN-203,,0,1569,389530,391098,GTATGTAGGGACAGATTTCAGCATATTTTGTGGATCCATCAGAAATAATCCTCCTGTTTAAGTCACTAAATTCTTGTAACTTGAAGGAAATTTCTAAAGAACCTATGGTATTCATGTGGTTCCAGCTACATTTTTTTTCACATTATATCTATGGAAAAGGGAGGGCAGCTGTTAAAAGACCTATTGAGAAGTTATTTTCAGAAAGCACCTGATGGCCAGATCCTCATCTGGTTGCTCAAAACTATTGAACACCCATTGGGTGTCCATTTTCATATACCCCAGATGAGCTTCTAGATTCGCTGTTAAACTATTTTAGTTCTCTGCCCTCTGCCTGAACTGCTCAAGTCCTAGCAGCACTACCAAGTGAAAGGGGTGTTTCCAGCCTCTGATATGGAGTGCCTGGGAGAACTCAAAAGTCCTCTTTGAGACCCTGGAAGGCCTAGAGAGCCTCAGGCAATGTGGAACTCGATCCTCTCTACCCCAAGCTCTAAGAACAGGGGCTCTTACTTTGGACAGGGAATTCCACATGCTACCAAGCACTCCTGAGGAGCCTCTGAGCAGTCCCCAGGGAAGTGCTGTTAAACCTCTGCTCTCCTCATTAGAAATCTTAAGGCTGAATCTCAAGCTGACCTTGTTTTGAGTCTAACCTAGATGCAAGAGAAAAATGGAACCTCCCTTCCTATTCTCATCCTAGGCCATATCTCTTTGAATAAAATACCCCTGAGGCAGATGCAGGAACTCCAGGGGTAATCTCAAGATTCACAAAGATGAACCATATCGCCAGCATTCCCTAGGTTCCTAGAAGACCAAATGGTCATGGCATCCAGTTCTTATTATCTCTGTATTAGTAGTGGAGAAACTGAGGCACAGAAAAGTAAAGATCTTTTCTATGATAGTGTCAGAAACCAGCCTCACAGAAGTCATTTCTTCTAATTTCTGGGTTCCATGAACTAACCAGGTCCCCTCACTCATCACAGCACTGAGAATATGCTTTAGTTAGCAAAACAGGAAAGCTGAATTTGTTAAGTCTACCTAATGGCATTTAACTAGATCTGAAATAGTGTTAATTCAGTCATTCATTCAATACTTACTGATTGCATTTTACTGGCACTGGTACATAACAAAATGACTATGACATAAACACAAATACTTGCAAAACAAACAAACTGGAATGATATGAGCCTCTTCACCACATGATTTGTCCAAATGAATTTTAAAAATAGGTAGCACACGGAAGTTATTGTATAATTCATTCAGGTGTCCATCGCTAAGCCCCCACCACAAACAGAAACTGGGATAATCAGGTTAACTCGGCACTCTCAGCATGCCCCCCAAATATCAAAAATATCTTTCTGAAGCTATTCCCTCTGCATGTGGACAAATTCCAAGTGCTTTCTTCATTCTTAGCACAAAGAATGTTCTAATATTCTGAGGCAAGTAAAAATACCACAATTCCAAAATTTTGTCTCTGGATGTATAACTAGCCAGCAACAAATTAATGTAGAGTTTTGCATGCTCTCTTGTGTTTTTACACTTTTTCATGGGCTATTTGTCAACATTTACTCCTAG
>TTN-203,,0,224,391099,391322,GTAGGAATGCCTCGCTACTTCCAGCTGAAAATAAAACCTAAGAAGCAGGCTTTTGTCCTTTCCCAGTGCATTTAAAAATACAATTTGGAGCTCATAAAAGTAGATTGCTACCCAACTTTGAAAGCACTCTGCAGTGAAATAAATTAAGATAAACCTACATGCTCCCTTCTGTGAGGTCTCTATGGTGACTTAATCATGACAAATCTTGTGGTTTCTTTCTTTAG
>TTN-203,,0,5004,391323,396326,GTAGGTTTAAGAACAAAAGGTGTCATTGCCAATACTTACAAATAATTACATGGGAAAAACATTCTGTCAGCTTCTCCTCCATCACAAACATCTCTCATGCATAATTTGAAGCTTAATGGAAATCTAACAGAAAACTTATTTCAATTATTAAATTAAGAATTAGATAAGTGTTTTTCACTATTTTGTGCCCTTAATAATGGTTGTTTATGTTATGTTATGTGTTCTTTATCACAATAAAAAAATTAGTGTTTTTCACTAATATTAAAAAAGGTCATGTTCCCTTTATGATTGTAGCTGCACTTTAATTTCTTCATTGATAAAATACAATGACAAAACTAAAATTATTAGATTATAATAGCATCTACATATAATTCAAAAGAATAATACATTTATATAAGACATTATTCAGTCTATGGACAATGCTTGTGTGAAAGGTATCCTTTGGAAGACAATATCCTATAGTGGTCAAAAGTCGGGGCTTCATTGTCAAAGATGCTGAATTTGAATCTTGCCTTCAATATATATCATGTCTCTCGTTCTCCTTCTGTCATGAATACATTGAGTATATGATTGCATTCAATCCTAGAAAATATATTTTATGAGGCTAGGAATTCCGTTTTAGTGCCTAGAATTTGGCATCTGAAAAATAGTACCTGCTAGAAGGTAAGCTCTATGAAAACAAGAGTGGATGGTTGCCCCAGAATATCACCTGATACATAGTAGATACTCCATAAGTAATTGTTGACTGGACTAATTAATGATGGTTAAATGACTGTTACCAAACACTTAAGATTATTATCAAGATTAAGTTAGGTAACTCAAGTCAGCACATAGCACAGTGCTCATCATACAGTAATCAATCAGAGTTAGCTGCTACCATTTTTAATTGGGGCATGCTTCTCAAGTACCACCAGCCAATTTCCTCATCCCAGGAATCTGATCTTGGTAGAATGAGACAATATATGTGGAACCACTTCAAGTCATAACTGATTGTCTATAATCACAATTATTTGAGAGTTTCCCAGCCAAAGGGAAACTCTCAAAGCTTGGGCATCTCCCAGCCCTCTTATTAGGCTGATGCAAAAGTAATTGCAAAGTTGTATTGTTTTGTTTATTATGCTTCTCCCATTAGTTTATAATCCAATCTCTACCTTGTCAAGATTTATTTTTCTCAACAGGTTAGTACTTCAGTTGGTCTTCTGACCCAATTATTTCCTCCTCAGGAATGGAGATGGTGATCTAGAAATCTAATAGACCTATTTGATTTTATGAGCATAATTAAAAGATATAATGTATGTAAAGCACCTATAGGCATGGCTGCCAGGTAACTGGGGCTCAATACATTCATTTTATTATAGCCATAGAGAGGAATTATATAAACATCAATGTTTAGTATTGTATGGCCAGTATGGACAAATACCATAGACTGTATATTTGAGGGATAGTGTTCAAGAAATGCTAAATATTAATAAATGAGGACTGATTTGATAATATCCTACTAACACAATAATACAAAATATATTTTAAAAGCAAGTTCATTAAAGCTACACTAAATAATTTATCCATTTATTTAATTTTTAGAGGAATTTTTTAATATAAACATATATGTACATCATTCAAAGTAGTAATATTTGTCTTAACTATATTGGTATAGTGCTTTTAAGTCTATAACATATTAACATATGGTAGTATTGCCTTTAAAGTGTTGTAGAAATACACCTGAAGCACTCTACAAGACACCAATTGGGGTAGAAAGAGAAAAATTTCACTATCTTTTCTGCATAACCAATGTCTTTAAAAAGGTTTGAATAGGCTTTGTAAACTGAGAAGATCATTAACTTCCTATGTGTGGTAATATCTGTACACATATAGTGGTTTTAGCATCCTCTTATAAATTTGTTTTCTATATGAAAGAAATTAAATTCATTAAATAGAATGACCCTTCAAAAACTTGCCAACTCACATAGTTTCATACCACTGGGACTAAAAATATTTACAGAACTTCCTCTGGCCAGGTATTGCCTTAAGTAAGTGTAGCCCTGCTTTCCACAAATTGGAAAGAAATTGGGAGTCTTCAGAAGCTCCCATGTTCTTGGGGGTTGTAATACTTTCTGAAGCATGAAACGTGGCCCTGAGCAACCAGGTGCTGTTTCTAACAGCGAAAATGTTACCTATTGAAGGTCTCCAGTGCCACCTACTGGTAGAGGAGTAATTTGGAAAAGCAGAATCTTAAAATGTAAAAAAGCTATTTTTTTGCTGTTTATTCTACAGATGATGAGTCAGTGTCATTTGGAGGCTTACAGAGTGACAGCTAGCTAAACAGAAATGATGAATAATTAGTTTAACAATGATATTGTCTGTTATTCATTTAAGCATCTGTGCAATTTTAATTCTACCATTTATTGTTTCCCTGCTATTGAGATATTACCCTAGGTGCTGGGGTGCAGATCTTGCTCTTGCCTTTAAGGAGCTTGACATGTAGGTGAGGAGATGCATGCACACAACTATATCCCAAGGTTGTAAGTGCTATTAACAGGCCCACGTACTCATCATTCTCTGTCTGGGAGAGAGCCAGAGAAAGATGTGTGAACTGAGCATTGAAAAATATGTAGGATCATTGAACACAGTGGCATCCTATGATGAGAAAACAACATCTCCAAGTCATCAAAACTTGCAATAATGCTTCATGTGCTAGAAGCAAGTGGTTTAAGTACAGTTGGAAAGTGATATCATGAGTGGGTAAGAAGGCTGGATAATACAGCAAAGGCCGTGCTAAAGTTTTTGGTATTCTATGCTGAAGATTTTGGAATTGATCTTGTTTACATTTAGGAGACACTGCAGGATTTTTAAGCCCCTGGGTACCATGATCAGGTTTACTTTTTAGAAGTGATACTGTGATAGGGAAAGAAGGGATGGACAGATGTGGGAGGCAAGACTGGCAGTCAGGAACTGGAGAGAGATTATTACAATAGGCCTGGAGAGCGTGGATGAGGCCCTCAGCCAGGGCAGTCAGGAGAGACAAGTGGGGTATTGCAGAAGTAGTAATATGGGAGAAGAATGGCCTCAAAGAAGACACGAGAGGCTAATGAGTAACGCAGATCATGGCATCACAGCCACAAGCACCAAGTCCACTACCAAGAAAAGTTTTACCTGTTAACTCACTTATTGTGTGCAGTTCATGTCCAGTGGCAGTTCATGTGTATCCTGGTGCCTCATTCAGTTCACCAAAGGAAGAAGCTGTCAGTAGAAATAAGCAGAGAACCTTGTAAGAGGATGTACCATTGATGATCTCACACACACACACACACACACACACACACACACACACCCCTTCACACAAACTAAATAGGGGTGGTGTTTCATGTTATATCACATGGCACTGTCTTTTGGCGTGTTATTGAAGACAACGTTGCTTCCATCTGTGATGTTAGATATTCTTGCTATAATGACTGACTTGTGCCAGTGGCTTATAAAGCCCTTCCATGTGTGTTATATCATTTAATTCTCACAGCAATTATATGCAACGAATAGCCCATAAATTATTACGCATGCCATTTTACAAATGAAAAGACTAATCCAGAAAGCTTAAATGACATTTCCAAGGCCACACAGCTGACAAGTTGTAGTGTCAAGATTTCATTTTCTTTATATGTATATATTTTGATGGAGTCTTGCTCTGTCACCAGGCTGGAGATCTCGGCTCACTGCAACCTCCCCCTCCCGGGTTCAAGCTATTCTCCTGCCTGAGCCTCCTGAATAGCTGGGATTATAGGTGTGTGCCACCACACCTGGCTAATTTTTGTATTTTCAGGAGAGACTAGGTTTCACCACGTTCGTCAGGCTGTTCTCGAACTCCTGACCTCGTGATCTGCCCGCCTCAGCCTCCCAAAGTGCTGGGATTACAGGTGTGAAGCACCGCGCCTGGCCAGGATTTCATCTTCTACTTTACCTTACTATCTAAGGAACTGAACAGATTTGTTACTCTAAGAGGAGAACCTGCCATTTATACACATCTACCATCATGGGCAGGAGAGTAACTTTTATAGACAAGTATTGGCATTAAAATGCAGACAAATGCTAGATGATTGGACTATTAGAAGATCATCTTGGATGGTTTTGAGACCAAGAAGTGGTATAGTGACTGTGCTCCAAAAACAAGATGGCTTTGATTTTGGCTATTCAAACAGTTAACTAAAATTAAAGTGCATATCACCTACAATTATTACAACACAATAACCTGCTACTTTACTGTAATTTGGGTTTTTACTTTCTATTATTTTAAGATGGTTCAAATCCTTATATAGAAATAGCTAGCTTTATTATAATGTCTTATAACTGCCACTCTGAAAAGAGTCAAATGTATCTAAGATGCTCAAATACCATAATAAATCACCCTCTTTATTTAAAAAATTATTTTCTCTACAATTATTTGTGCCATATATACTGCGTACTGAAACCTTTTGCTCATTAGTAACAAAGATAGAGATTTTTTTTCTACAGCCTTCAAAGGTATCTATTTTAGACTTTTCATATCTTGATCTTCTCAGCTCTCTTTTTGATTGATTTTTCTGCAAACCAAAAGTGGAGATTTTTCTCATTTCCTGTCCCAGAAGGCAACTACAAGCCCAGATCAAACCTTTCCTGATGACTCTTCTTAGGACTGTCTTTTTCTCAAAGTCACTGAATATGTCAAAATCTTGTCTCTGCTTCCACTGCATGACATGCAAATGTCTAAAGAGAATGTAACTGAAGTTCTATCATTTTAAACATTACAACCAGTTCAACCTTAGGACAAGCTATATTTTTCTATCATTACATTTCCTTCTTGAAGATGAAAGGAAATCATTTAACAATAGTAGATATGGCATGCCCAGAGAAAAGTATCATGTTATTAAGTCAAATATGAAATGTAGGCACTAGTATTATTAACATTGTGTTTGCAGGTAAATTGTAAAAATCCACTCATTTTTGTGGTTGAAGTATCTCTTTTCTTTTGTGTCGCAG
>TTN-203,,0,1067,396327,397393,GTAAAGTAAAACAACTTTCAGAACCCCATTTAAATATAGATCGAATCTTAACAATGTCTGTAACAATTACTCAAGAGTTCATGTAAATCATTGTTGTTCCTACCATTCTCTTCTAATTCAACTAATTATTTCCCTGTTATATGCCATGGTCTCGCCTCTCCTTTACCACTTTTCATTGTGAATCATAGACCATCACGTTTCATTTGGCCCCGCTTTTTCTCTGTAACAATTTGTAATGTATTGCTGCTGTCACCAGCTGTCATGCTTCCTAATCAGCATGAATCAGAAGGGGGCGAAATATGCTGCATAAATAGGTAGATTTGTTTTCTCAATTGGCTAAGATAAAAATTAAATTTTAAAAACATCTAAGAGTGTTATCATCCTCCTATCATGCTGACACAATTTTGATTTCACAAAAGCTAGACCGTTTCAGGTCTGTACACCAGCGAGCTATATTCATCCTCCTCTCAAGAATGTCTTAGTGTTAAGAAGTCCAGTCCTAAAGTGGTTTAACATTTCTGTTAGTTGGGGCTCTTAAATTGTAATCAGAAACACTTCCTCAGTAACATGGGGAATTTGATTCAAACAAGGATAGCATTTTTATATAGTGGTACTATTTTTCCTGAGCAAATATAGTCTATGTAGTATTAAGTACATACAAATACATAAGGATTTAGAGAAACTATTTTTTTCTTAACCTTATGCATTAACTGTAACTAGATGTTTTTTTAAATAATGAATTTAAAGTGGTTTAAAATTAAAAAGTTGACTTTACAACAAGAGGAAGAAAGAAAAGAATATCCAAAACCCTGTTGGGTACTCCACTATTGCCTTCATGAACAATGTAGTGAAGTTCCTTAGCCCATTCATGTCTCAGCTTGCTTCTCTGGGAAATGGAAGTGAACTTGTGTGACTTCGAGTCAATAGTGACATACAAGGACAAGGCAGTAGGAGTGGACTGAATTCTAGTCCATTATTGAAATTTGTGACAAATCTGTAGACAACTCCAAATGAGTTCTGGTTTCAGTGCAAGGTAAGACATTAAAAATTGGTATGCTTCTTTTCAG
>TTN-203,,0,4361,397394,401754,GTAAAGCCCATCTTGCTTCAAGGACTTTGATTTGCTGTATACCTCTCAGTCCCACTGTTACTAATGAGAGTCTCTGCTGTTTGTTTTATTGCATACTGTGGTCAGTCCATAACTTACTAATAAAATAACATGCAATAACTCCCGCTAGGTCCTCAATTATGGGTTAACCTACATACTTTAAATTTCACTGAAGTATGTGTTCTATGCACTAGAGAACCAATAATTATTTTATTAGGCACCACCTTTGCTTGGCTTCTTTACTCTTCTAAGCAATATTGTATCATTGCATCATTAAATGATCTATTTGCTGATTATTACTTACTGTACTTAAAGTAAGTACAGTATTACTTACTGTACTTAAAGTAAGTACAGTATTACTTACTGTACTTAAAGCATACAGTGGACGGAGAGCAAATGCTAACCCAAATACAGTCAGCTAGAGGGAGAGAGAGAAAGACAGACTGGGTCACTTTGGATAGCTGAAATGACAACAGAAAGAAGGAACCAGATACTGCATGGCATCTGCATGAGTCTTCATCAACCACTCAGCACTGAATCACCAGGAATGAATTTTCTTTTGTGTGATCCTGACATCTAGATCATATTGCATCTGGCATGCTGCTTTCAAGTGACAACTACGTCTTTCATCTTCATCTTCCATGCCATTTTGTGTTACTAACATGGGCAAGTGACAAAGCTTAGATCTTAATATTCTTTTCTTTTTCTTGTCACTTGATTATACAGTGCAAGCCCTAGATAGGCAAAGTTCTGGGAAAGATGTAAGAGAGTCCACCAAGTCCCAGGCAGTGGCAGATTCCTCTTTCACAAAGGAGGAGAGCAAAATATCTCAAAAGGAAATTAAGTCATTTCAAGGATCATCATATGAATATGAAGTGCAGGTTTTTGAAAGTGTATCTCAAAGTTCCATCCACACAGCTGCATCTGTTCAAGATACACAGTTGTGCCATACTGCATCCCTTTCACAAATTGCAGAAAGCACTGAGCTATCTAAGGAATGTGCTAAAGAGTCCACGGGTGAGGCGCCCAAGATTTTCCTGCATCTTCAGGACGTCACTGTAAAGTGCGGTGACACGGCTCAATTCCTCTGTGTTTTAAAAGATGATTCTTTCATTGATGTAACCTGGACTCACGAAGGTGCAAAGATAGAGGAATCCGAGAGACTGAAACAATCACAAAATGGAAATATTCAGTTTCTTACCATATGTAATGTTCAGCTGGTAGACCAAGGACTATACAGCTGCATTGTACACAATGACTGTGGAGAGAGGACAACGTCAGCAGTACTAAGTGTAGAAGGTGGTTAATTGATTTTTAGCTATGACTTGCTTCATTTCATCCTCATCGCTTTATGCAGCTTTTCTGCCATGCAAATTCAATCGACGAATATATTAATTAGAATATCTCTAAATTAGCACCCTATTCATAAGTGACTTCTGAAAGTCAGCCAAGTCATTGGCCATGATTATCCTGAAAATTTAACTTACCAGTCTAGATTCAGAAAGTTTAATTTTTAAACGTAGGTTCGGGAAGCAAAGGTTTATTTCCTATGTGCTGCATTTTCTAATATTTACCAACGCACTACCAAGAAAGTGTAGCAAAGTTAAAATGTTGTATTCTGAGAAGTACTTATTGGGTATTTATTATTGTGCCAGATACTGTGGTAAATTTCAGTTTAATTGTTTTAATAGCAAGAGGTTCAACAATTCTTATCTCCTCTTTATTTTCACATCTGGAGGTTCTAGTTGTTTACAAAGGGGCCATGAAAATAGAAAATTGGGACCAAGTACAGTGACTCATGCCTGTAATCCCAGCACTTTGGGAGGCCGAGGCAGCCAGATCACTTGAGGTCAGGAGTTTGAGACCAGCCTGGCTAATATGGTGAAACCCCATCTCTACTAAAAATACAAAAATTAGCCAGGCATGTTGGATGTTGGTGCATGCCTGTAATCCCAACTACTCAGGAGGCTGAGGCCAGGAGAATCGCTTGAACCCAGGAGGCAGAGGTTGCAGTGAGCCGAAATAGGGTCACTGTACTCCAGCCTGGGCAACAGAACTAGACTCCATCTCCAAAAAAGAAAAATAGAAAATTGAAAATTGGGCACTGAAAATAACAAAGCTCTCTCTGGACCAAAATTAGAAGTCTCTAGATATTTCTCCATAAATGATGCTGCTTTTACAGGCTTAAAATCCTCCTGGAATTGTATAATTTTCTCATGGCAAGATCACAATTTTTGTCGTTATTGGGCTTGATTCTCCATTATGTCTGGAAGAGCAGGAATAAACTTGTCTGGGCAAGTAATAACTTCTTCCTCTTATCCATGGACTTTCCTTTTGGATATTAATGAAATGAGAAAAATATTTTTCAGGTGCCATAAGCCTGTGTTGTGTGCCCGTAGTCAAAACAGCTTCACTGAGTCTCATGGAAGGAAGCTGGTGGAATAAATTCAGGCATCTCCAGGGGTCTGTGGAAAGCTCTGGCCTCAAGTTCCTCCCTGATCCTGGCCATAGTGGTGTTAGGGATGAAAAGGGGGCAATGCAGTGCTATGTAGGTGCACAGCCATCTCTGCACAGAATTTTGAAACAGTGGCCTTTCTTCCTACCCAGTACAGAGAATACAGTTTATTGATTCATATAATGTATCCGCAACACCTACTCACCAAAAAGAGGTCTTATTCTTTCTTAATGAGATTTTGTTCTATAGCTATCTCTCATTCTGTCACCGTAGCCTACAAAGGCAATATCTCAAGAACTGAGGTCTAGTTATGTAAATTAGATAGAAAATTCCACCAGCCAGAGAGTTGACCCTCAATTTCACTACAGCTGCTGGCTAGCACAGTAATCACACAGAGTCACTATTTATTTGGAGGTGTTGTCTACAAGTCCTGTAGGTGACAGTGTGACAATTTTTTCAGTAATGTAATTGGGAGTTGGCTGTGTTGTGAAGGTGGGAGAAATGTAGATCTCTTAACTCACTTCCTAAAGAATCTAGTGCTATAGTGCGGTGTTTGACTGTCATATTCCCAGAATTGATTTGAACTCGGCTCTTTTGCCCTAGGATCTCCAGTTCATTCAGTTCCAATTGATAATATTATTAAAGTGTTCTTGAAGCAAAAGAATTTTTTTGAACATCCAACTGCCTTACTTGTACCTAAGAAAGTTGAAAGATAAGACATTTTTAGATGTTTGAAGAGTGAAAGATCAGGCACAGTTGTCTAATTATTTGACATAGGCCAGTCTTTATATGTTCCTTTTTTATTTTGGCTTAATAAGTTCATATAGGCTACAGAGTTATCCACCAAGATCAAGTAGGAATGTCAAACCCCTGGAAGTCTTTTTGAATACAGTTATTATGTGCATAATAAACATAAACATATCATATATAAGTTTCATGACTAACATGCTGCCTTTCCTTCTCATCCTAATGACATTCCATCTTCTCCACATTCAGCATGTTTTTCATTCTTACAAACACAGCTAATTTATGCCTTTCCCTAACTTTATTCTTACCTAGCAAAAGAATCGCAAGCCAGAGCACTTACAAAAATTACTCTGGGTTCTGACACTAAAAGTATTAAAACACTCAGAGAGTCACAAATTAAAACAACCCGTGAAGTAAAAAGAGAATCGTCAAAGAAAACATCAAGTTTGTCATTAACTTCATGCCAAAAACCGTAAGAAACTGAGAACAAGGGAATAAAGTCTACTGACAGGATACCACGTGGACTGAAGACTGAGAGTGATACGAGAGCCCCAGCCTTTCCCAAGGAGCTGCCCTAGATATGACTGTGTCTAAAAGCTGTGCATATTCCTTGTGGAATAAAAACAGTTTTGATAAGTCTTTGTTTTGTTTCTTAATATGTAATTTGGACTTCATGTAGTTCAAAGTTTGAAAGGTGATTCAAATCAAAGGAGTGTTTACTAGCAGGAAAAACTGAGAATAGCCCTCTGCTAAAGTAGCAATTTAGAAAATGCATGTTCTTTCTAAATGTGATTTCATCTCTTAGCAAGTGTTTAGTCAATAGGACATTTTTTAGAAAATAATATTCCTTCGGTTTGTAGATTGCTTTCTGCATGCATGTAAAGGCATGGGGAATTATAGAACTAAAAGTGGAAATTTCATGAAGAACCTAAAATAAAAATGTTTTAAATCTTTCTGTCAACATTGTCATGTGTTTTATCAGCTCAATAGTTTGTTTGGCATGGACTTTTTGGTAAATTTGGGGAATGTAGTTTTCTGTTGTTATAATAAAAAGAAAACTTTAATCATACAAGTCATGAATTGATGCAGAAAATATATGCAATTAATCACTAAAATCTCTTTATATGTTTTTCTATTTTAG
>TTN-203,,0,11202,401755,412956,GTATTGTTATAATGGATGTGAGATTTAAGTAGAAATTCTAAAGGATTAATAGGATCCTTGAGTTGCCTTCTTTCTCTTAGTATTATTGAGAAAAAAATGACATAGATATACAAATATATCTCTTAGAGTATATATTACTATGTCGCATGCTTGGTTTAGAATTTTGATGGTTACATGCATTTCACAGTAATTTATTGTAAGTTAATTTAAAATTTTGTATTTAAAATTTATCAGCCAAATTCAACTTTATGTTTGCAGTCATTTCCAAAAGTGTATATTAGGAGAAGTTGTCATCTTAATGCATGAAATCATGAAGTAGAAGTTTGTTTTCAAAATCACGGTGAATTACATTGAAAATAGACAATAACCTAGCTGTCATTCTCAGAATGCAATGTCATGAATGAATTATGATTGAAATGCTACTTTACTGAGGTTGTGTGAAAACATTACATTCCCATCTGGTTTACACTTCATTCACATATATCATTTTAACATTGATATGTCTCTTACACTGGCTTGCAGATAGCTGCCTTATGTGATCCTTATTGCCTGCTTTTCTTTGCATAACATTGTGACTTTATGGCTGTATTAGTTCGAATAAACGCCTTCTCATTTTATTTTAGCTAATTATTTATGGTTATAGTTCTTGTATATACTCTTTAAATAGTTGATTCTCAAAAATATAATAATTTAATCTACAATCAAAAGAATCAGAAAGGGCGTTTATTCCACTCTCTGCAAGTCAGGTAAGATTTTCCACTTAGCCATCAAAAGAACAAAGTTTTCCTGCTCTCAAAACAAATATGCACAGGAACATGTTATTTTGAAATGCATTTTTGCTTGTTCAAGAAGAAATTTCAACAGTTTGAAGAAAAGACCAGACAACGAACGATTTTCGTGTCAGAATCTTTTAAACAGAGCATGGTGTTGCGTTTATTCGAACAAATATGGTGAGTGAATTTTTCTATGGATTTGTGAGATCTGTAGCATGCAATTTATTTCATTTCCTATTTTGCAATTTTATTTACTTTCAACTTTTTCAAGTTCTATGGAAAATAGTAAAGGTTTTTTTTTTTTTTTCCAGAATTATTCTCTGAGGGGGAATCTGAACATTCAGAAAGGGATACACGTGACGCCTTTTCAGATTCTGAAGACATAGACCACAAATCCATGGCTGCTAAAAGATATGCAAGTAGAATATCATCTACAAGCTCCTGGCCTGAATATTTTAAGCCTTCTTTTACCCAGAAACTTACATTTAAATATGTTTTAGAGGGTGAACCGGTTGTTTTTACATGTAGATTAATTGCCTGTCCAACTCCAGAAATGACTTGGTTTCATAACAATCGGCCCATCCCAACAGGTCTTCGTCGGATTATAAAAGCTGAGAGTGATTTACACCATCACTCTTCCAGCTTAGAGATTAAAAGGGTCCAAGACAGAGATTCTGGAAGTTATAGGTTACTAGCAATTAATAGTGAAGGGTCTGCAGAATCAACTGCATCATTGCTTGTTATCCAAAAAGGGCAAGATGAGAAATATTTAGAATTTCTGAAAAGAGCAGAACGGACACATGAAAATGTGGAGGCTTTAGTTGAAAGGGGAGAAGATAGGATAAAGGTTGACCTGAGGTTTACTGGCTCTCCCTTTAACAAAAAACAAGATGTGGAACAAAAGGGAATGATGAGAACTATACATTTTAAGACAATGAGTTCTGCCAAGAAAACAGATTACATGTATGATGAAGAATATTTAGAAAGTAAATCTGACATAAGAGGTTGGCTTAATGTAGGTGAAAGTTTCCTGGACAAGGAGACCAAAGTGAAGTTGCAACGTTTAAGGGAGGCTAGAAAAACATTAATGGAGAAAAAGAAATTATCTCTTTTAGATACGTCTTCTGAAATAAGCTCAAGAACTTTGAGAAGTGAAGCTAGTGATAAAGATATTCTGTTCTCTAGAGAGGACATGAAAATCAGATCTATGTCTGATCTAGCTGAAAGTTATAAGGTAGATCATTCAGCTGAGAGTATTGTGCAAAATCCACATGCCCTTTCTAATCAAATGGATCAAAATATAGAATCTGAGGAACTTCCCACAAGCTTTCAAACTATTGTTGATGAAGAAATTTTCCAGACTGAAATAAGAATGAGCCAAGAAGCACTGGTAAAGGAAAGTCTACCAAAAGACCATTTATATGGTGAAATTCTAGTAAATGAAAATACCCAAGCAAGAGGACAGCTGGAAGAAATTATGGCCAATACTACAATTGGAGAGTCATCCACATATATCACTAATGTATGTGAGAAGGAGGAAGTATATGAGACTCCTGAAAATGTGTCTCAAGCTATTACACCACATGCCAGCGAATCTTTTGGTACACTTGTAAATGTTGAAGAAAGTGAAGAAATAGCTAGTGAAAGAATAAAAAAGGATGATTTGAGAGAATTACAACTCTCTGCTTCTACACGAATTGATGAATTCAAAACCGAACAGAAGGAAGAAAACATGAGATTTTTTGAAAATTCTTTTCGAAAACGCCCACAACGTTGCCCACCTTCATTTCTTCAAGAAATTGAATCTCAAGAAGTTTATGAAGGTGACAGTTGTAATTTTGTGTGTCATTTTCAAGGATATCCTCAACCTATAGTGACGTGGTATAACAATGACATGCCAATCCCACGTAATCAAAACTTTATCATTCATTCGTTGGAAAACTATTCAATATTAACTCTTTCATCTGTTCATCATCAGAATGAAGGTTCTATTACTTGTGTGCTATTTAACCAATATGGAACAGTAAAAACAACCAGTATGCTTAAAGTGAAAGCAAAACAAAAACATGATGTCAAAGCACATAAAGTCCCAGTGTTCCATGACTACTTGGATGAGGAAGAAGAGTTAGCATTGGTGTTTGACCAAGCAAAAGGCGCCCATCCATCTATGAGTCAAGAGGGCCAAACAAATCTTCATTTGTTAAAAACTAACCCACCAGTTCCTCCCTCTGGAGACACAGAATTGCTTTCCTTTCCTGTAGAAATTCAGGTAACAGCAGCTACTCCTATCCCAGAACAGGATAAAGAGTCTAAAGAAGTGTTTCAAACTGAGGAGCTGGAACCTAAAGCAATGCCTCAAGATCAAGTTACTCAATCACCAAAACACAGATTTGTATTTTTGTCTGATATTACTAATGAACCACCAAAAATGTTACAAGAAATGCCAAAGCATGCCAGGTGTAGAGAAGGGGATTCCATCATTCTTGAATGTTTAATATCTGGTGAGCCCCAGCCAGTTGTAACATGGTTTCAAAATGGAGTCCTTTTAAAGCAGAACCAGAAGTTTCAGTTTGAAGAAGTTAATTGTAGCCACCAATTATATATTAAGGATGTTAATTCTCAAGATTCTGGAAAATATAAATGTGTTGCTGAAAACAATTCAGGGGCAGTTGAAAGTGTTTCAGATCTAACAGTGGAGCCTGTCACTTATAGAGAAAATAGTCAATTCGAAAATATTGGTGAAATTTATGGAAAATATTCCAGAGATCAGCAACTGCAAGACCAGGGAGAATCTGTAAGGGCACATTTTTATGATTATCCAGCTGGTCCCTTTACTCCCTGGACAAATGTAAAAGAATATTCAGTAAGGGACTATTTTCAAAGCCTTGAGACTATTGAGCAAATAGACCAGAAAGAGCAGGTGCGTTGCATACCTTCTAGAGAAAAAATTCCCAGATTTGTGCATGGTGCTTCAAGAACCATAAAAATCAGCAAGCCCATCAGGGCTGAATTCATACAATGTCAGGCTGAAGGGAAAGAGAGACATGTAAGTGAAAAATCAAAGCTGCACCAAGCAGAGGGTACTGTTTATCCATTTGTTGATGATTTCAGTGATGTCACTATTAAGAAAGAAATAAGAAATAATTTTGGAAAACTTGGTAGATCAGAAAAGGAAAATGTACAAGAATGTGCCCAAAGTGACTATTTACCAAATATTCACTCTGAGAGAATTTCTGACAGTTACAATACAAAAGATTCATCTGCCATTGTATATGAAGAATCCCTTGGTGAAGAGATACACTACCCGGGGAAAAAGGTGAAGCATAGAATTATCGAATTTGAAAAATTACATGTAGAAAAAGGAGTTCTAGAAAAAAGACCTACCAGAACATCAATTGTTAATCCTCCTCAAAAGAAGATTGATGACAAAGCCTTTTCATTAAAGCAAAGAGAATCAAGATCAAGCAATCTAAATGCAAATATGTATCAGGCAGAGAAAATGTCTCCAAATACTGAATCAGATTCATCTAACATTGCAATAAATTTAAAGCTGCTTTCCTCTCAAACTCATAAAGAATTTGACGCACAAGAAAGGGAACAACAGGAAAAAATAAGTCTTATAGATAAACCTGCAATTTCTAAAAGAGCTGAACATGAATCACCTATTACATTTGACTTAAAGCAGTTTCACACTCAAATAAAACACACAGATGTGAAATTCCAAGAATTAGATAGTGGTCAACCAGAAGAAGCTTATTTTAAAATCCAACATCCTGCTGACACTGAGAACATTGTATTTGATCTAAAACAAATGTATTCTCATATAGGAGATCCAGCTCTGGAGTTCCAAGGGCAAGAAACTAGGGAACAGCAGGAAATACATTATAAAGAAAAAATTCCTAGCCCTGAAACGTTACAACCTGACACACACAATATCTCTAAAAGTGTGCAAAATAATGTATTTGCCAGTCAAGAAATTTCTTCCAGTCAAGAGCTTTCAAATAGAACTATGGTGGAGAAAAGTAGTATTGATGAAAATTCCATTTCTTTAGAAAAAGAAGTCCGACATGTACAGGAACAAAACTTAGACATTTTAAAAACTGATCTTTCTCTTAAATCCTTTTCTGAAGAAATCTATAGTGAATCATGTGCCCTACTTCCAACCTCATCTGCAGATATAGAAGAAACTGATCTTTCTGAGAAAAGTTGTCCTCTAGAAAATGGAGGCAGAAGTTCCATCTCACATTTGAAAAAAGCAGCAAGTGAGGAAAAGCCTTTAGGGGTTGGTGAAATGGAAGAAGAATGCACTCTAGAACCAGAGTTGGCAGCATTTCCAAAGCAGGATGGTGGGACACAGGAATATACAGATGCCACTTTGGAAGACCACAGAGGTGATGTTCAGGAAGCTGACACACTCCATAGACAGCTCTCCCTGAGTCAGTGCTTCCCACTCTTGATGACTGAAGAACAACAGAATCCAGGTGAACAAATAAGTACAAACATTCATGCCTCTGGAGAAGAAAAATGTTATGAAGAAGTTCAAGTTCAGAATGAAGCTTCTTTCTCCACTTTAGAAGGAGAAATGATAGAAACTAGTTTTTCTCAAAATATTCCTAAATTAGATGAGGCACATACCACTGAGGCAGCAGAATCTGAGACCTCCCTAACACAATATTTACTTGCTGCTGGAAAGCGTGAGGTTCCTGAAACTAAAGACACCAGAGACCAGGCAAAGCTTGTCCAGAGTGAATCAATCACTTCAATGGAGGTGGAAGAAGTAACTTTCAACACTGTGTATGAATACTACAACCAGAAACAGGAATCACTAGGTCGTCCACTTTCTCCTGAGTCTGACATTTCCATTGGTGTGGGAAGTACAACCAGTGAAGAAATATCTGAGTTAGATCAGTTTTATACCCCACCATCATCTGTTGAATATTTTGAATCTCCAAAGTCCCCTGACTTATATTTTAATCCTTCAGATATAACTAAACAATCCTCAATACATTCAGGAGGTGAGACAGTTGAAAGATATTCCACACCTTTAGGGGAAGTTGCTGAAAGATATTCAACACCTTCCGAAGGTGAGGTAGGAGAAAGATACTCCACACCCCCAGGGGAGACACTAGAGAGATACTCCACACCTCCAGGAGAGACTCTAGAGAGATACTCCACACCCCCAGGAGAGACTCTAGAGAGATATTCCACACCCCCAGGAGAGACTCTGGAGAGATACTCCACACCCCCAGGAGAGACTCTAGAGCGATATTCCACACCCCCAGGGGAGGCACTAGAGAGATATTCTATTCCTACTGGAGGACCAAACCCCACTGGTACTTTTAAAACATATCCATCAAAAATAGAAAGGGAAGACGGTACACCAAATGAGCATTTCTACACACCTACAGAAGAGAGGGGTTCAGCTTATGAAATATGGCGTTCCGATTCATTTGGTACACCCAATGAAGCCATTGAGCCAAAAGACAATGAAATGCCTCCATCTTTTATTGAACCTCTGACCAAAAGGAAGGTATATGAAAACACAACACTAGGCTTCATTGTTGAAGTTGAAGGTCTTCCAGTTCCTGGTGTGAAATGGTATCGAAATAAATCTTTACTAGAGCCAGATGAAAGAATCAAAATGGAAAGAGTGGGTAATGTGTGTTCACTGGAAATTTCTAACATTCAAAAAGGAGAAGGGGGAGAGTACATGTGTCATGCTGTAAACATCATAGGGGAAGCAAAGAGCTTTGCAAATGTAGACATAATGCCCCAGGAAGAAAGAGTGGTGGCACTACCACCTCCAGTAACACATCAGCATGTCATGGAGTTTGATTTGGAACACACCACATCATCAAGAACACCTTCTCCTCAAGAAATTGTCCTGGAAGTTGAATTAAGTGAAAAAGACGTTAAAGAATTTGAGAAGCAGGTGAAAATAGTGACAGTTCCCGAATTTACTCCTGACCATAAAAGTATGATTGTGAGTCTAGATGTTCTTCCATTTAATTTTGTAGATCCAAATATGGATTCAAGGGAGGGAGAAGACAAAGAACTAAAAATTGATTTAGAAGTATTTGAAATGCCTCCTCGCTTTATAATGCCTATTTGTGATTTTAAAATTCCAGAAAATTCAGATGCTGTATTCAAATGTTCAGTCATAGGGATCCCGACTCCCGAAGTTAAGTGGTATAAAGAATATATGTGTATTGAGCCAGATAATATTAAATACGTGATTAGCGAGGAGAAGGGAAGTCACACTCTTAAAATTCGAAATGTCTGTCTTTCTGATAGTGCAACATACAGGTGCAGAGCTGTGAATTGTGTAGGAGAGGCTATCTGTCGGGGATTCCTCACCATGGGAGATTCTGAAATATTTGCTGTGATAGCAAAGAAAAGCAAAGTGACTTTAAGCAGTTTAATGGAAGAATTGGTCTTAAAGAGCAACTACACAGACAGTTTTTTTGAATTTCAGGTGGTGGAAGGGCCTCCCAGGTTTATCAAAGGTATTTCTGACTGTTATGCACCAATAGGTACAGCAGCATATTTTCAGTGCTTAGTTCGTGGCTCTCCAAGACCCACGGTTTACTGGTACAAAGATGGAAAATTAGTCCAAGGAAGAAGGTTCACTGTTGAGGAAAGTGGCACAGGGTTCCATAACCTGTTTATAACAAGCTTAGTAAAGAGTGATGAAGGAGAGTATAGGTGTGTAGCTACAAACAAATCAGGAATGGCTGAGAGCTTTGCAGCACTCACCTTAACTTAAAATGTAATGTTTTAGTGCCTCAGTAATTATTAGCATTGATCTGAGTGCTTTCATATTTTCCAAATTATGTGGATCTAATAAACTTCCAAACAGGTCCACCATATTTGAATTCATTACCTTGGAGACCCCTAAAGAAATAATCTCTATGTAGAAATCTCATCTTTGTAATACATGTAAATATTTTGTTATCTGAACTGTGGAATCATCACTTGTGTCAATCATGCTGTGTAATATCAAACACAATTAAATCTCTCCTTGGCTACCTAATTGTTTGTACTTCTATTTACCCTCATGCCTCCTCCACAAAGTGTTTCAGTGGAATGGACTCTCTTTTAGCAGATAAACCATATATGCAAAAGTACAATGTAAAAGTGGAGACCATATCAGATGACCACGCAGACAAATTGGTAAGGGCAAATCTCTCTGCTCCCATTCTAAGTTATTTTTGGAATTTTAACCCCTTTGCATCCAAACTCATGTTTATTTACTTTGACTTAGAATAGGCAAAACAAACAACAAAAACCAGCTTCTCCCAATTGGCAACTAACTCTATAATCTGTTTGACATTTCAATCTTAATATATTAACTTCATCTCTTTTAAAAATGTTTTCGTTATTAATATTCCTCTTCATAAGTGCTTTAATTCTCACTGGCTTCAAGGGACCAATTGTGCTCTTTGTGGGCAGGGTTCACCTAGACATTTGCAAAATAAGCAAATAGATCTTTCCACTTTTGGAGATACCTTATTTTTCTCCATTTTTGAGATGACATCAAGTGTAAAATGCAGCAATAATTTAGTATTGGCCTGGGGAAAAAAGGGAAACTATCATATTGTGTTTACATATAGATTTTAAAACTGTATTCTGATTTCAGAATCTTTAAAATTTAAAAAAAGGTGGGATATTTTTAGAATTGAGACAATATGGTAATTTGTATTTCAGATTATATATAAATAACAAGATAACAAGCTTTCCTATCAGTTTCACTGAATTTCATCTTTAAAACGAATATAGCTTAATAAGCATTCAATTTTTATTGTGATGTTTATGTTTCTAAAGTAACTCTTTAATTTTGTCTTTTAAAATTAAAATAACAGTAAATTAACATACTCCTTAATATCTTACCTATATACTAATGTGGACCCAAGTCTTCTCATATAAGACTCGACAAATATAAAAAATTCTGAAAATGAAGGGTAGGACCAAAAGACCTTAGAGGTGATCATTCAACAATACAATTCTGTGTTAAGCTAATAGTAATTATTCTTAATACAATTTAGAATAAACTTTAATTTTGTAACAAAGGACGAGAGAAATAATATTACAATGAAAGATAAATTTTATCTCCCTCCACCTCTTAAATTACTTATTGTTACTTAATGGCTACATTTGTCACCTGCATTTAGCAATATTTAAGTACCATTATCATATTTAAAATGCTAATTTTAATTAGAAATGTAAACAATTTAAATTTAATTTTCAAAAGAATTCATATCCAATTATGTTTATTATGTTTCTTTCATCTATCAGTCTTTATTCTCAACATGGGAATTCTCTAACAGCTATCCAAATTAAAGAAGCAATAGAGACAATGTACAGAAAATAGGCAGAGCAGCCAGGCCTCCCCTGCCTCCCTCACAAAAAAAATTTTGAATTATCTGTTTGAGCCACCATAACTCATCAGCATAGATACACTATTGTAGAACAATCATTCCTGTTCCAACCAGTGAGCACACAATATCTGTGATAATAATTATAGACATAATGTAATATATCACATCACAAATTCCTGAAATAAAACTAATTCTATAGATTAGGAACTTAGAGATTTATTCTGCACTTAGTCACATAATGGATGTTAAAATTAACGAGAAACTCAGATTGAGGCAAACATGACAAGCATGCTTTACTCAAACATCATACAGCACAGCAACAGTTCAAACCTTGTTTCTTAAAAAAAGAGAAAGAGAGAAATAGAAAAATGTTTTTATGTCCTACTGGATTTCAGGAAGAGCTGAAAAACACTCTTATTCATATAGTAAAGAGGGCTTTGTTTGGTTTTGCTCATTAGAATTCTGTAATTCTGTTAGTTTCAAGTATGGTGAGCTTGAGTATACGCAGAATAACAGTGACTGAATAAAGAAAAGTAAGCCTTGGCTTACTTTAATTGTCATAGATAATGAAATGGAATTTTTTATTTTCTGACTCAATGGCACGTAACATAAAACCCCAAAATATTAATTTCTCTGATTCTGGATAAAGAATTTATTGTATTGCACATAGTTGAGTTTAGACAATTAATAGCTGCTACCACAACATGTAATTTTTTAAACTATGCCTTTCAAGTTTCAGCACATTTGAATTTCATTTACTATCCTTTTTATGGCTAATAATACCATGGCTTGAAGTAAAATATTTGCAAATAGTTCAACATAGTAGTGAGTAAGGGTATTTTAACTGTATTCACATTCACTCCCTTTACAGATATTTTGTGAGTTCAAGTGAAGGGAAAGGTAACGCGAATTATGTATTGTAGATTAAATGCGAAGTTAAGTGATCACCATTAATATGTAAAATTATCAATGGTTTTATGGTTTACTTAAAATAATAAATACCTGAATATGTATTCTGCATGCTATAGATGAGTTTCTCCAGTATTTTTACAGCCAGCAGACACTTGAGTCCTGTCTTCTAATGCTTATATGCTAGAACAGAAAGGAATTAAGGTGTAAGTCTATTTCATGTGATGCAAGTGAAGTCACCAAATAAAATCATAAAACTGCCTTTTGCTAAGGCAATAAAACTACTAATAACAGGCCTGTTCTACATAGCTAAGAGGTTTAATAAAAAATCGAATTCCTTGTTTAAAATTACATGTCTTTCATCCTGTCATCCAGGATACTGTTTAAAGAGTCTCTGTTATGCACTGCTTTGTTTCTTGCTCAGTGGTTCTGTATAGGTTTTCTTATACAATAAAATACAATGAACTTTTAATATTGGAGTTGTTTTCTCTTATTTTTGATTATCTTATTTTCTTGGCTAATGCCTTATTACAAAGGCTTTGTTCAAGTAATATGGTGATTTACATAGATGAAAGAAGGCCTGCATTTCTAGAAACTGAAAACAGTGGTTCTCTTACAAATCCAAATTAAACATTTCCTGTAGCCTCTTATTTTTAATAATGACTTTAGAGGCAGTAATTAGAACATCAATGGTTTATTTTGGAAATAATCAGTCTTTAACAAAGAAGATTATTCTTAACCTCAAGAAAACTCTAAATATAAATAACAATTCTGGATCTTTTTAGAAGTTGATTTAAATAATGCTGGATTATTATAACTATTTAATTAGCAGTTTTTCAAACTTTAAAATTGGAATTATATCTCAAGAAAAACTCATGAGAGCATTTTTAAAACATGAACTCTATCACAGATGAAGTGGATCAAAAATTGCTTTTGTACAGTATCTATAATTTTGCATAATTTTATATGTTAAGCTAAGAAAAATTTAGAAATGTGCTTTTTGATACATTAATCTTGGAATAATCTAATCATTCCAGGAATAAAGCAGAAGAAGGCCATCAACTGGTGTCTAATTCTTTGATTTCTATTTTTATATTAAATAAAATTTTATAGTAAAATAATAATCATTTTTCCCCATACAG
>TTN-203,,0,780,412957,413736,GTTGGATTTTAAGGATAAAATAGATCAAATGCTAACATTCACTGGATTGTAATGATTTAGCTTGCATCACTTAAATTTTCACTTATCTGCCACTTCCAGAATGTAATTTATTTAGAGTAAGAATGAAATCACAGACATAATCATGGTTATGAACTCACCTTTTCCCTTACTGCCCTGTTGGGTGCTATGCTATCATATCCATGGTACTATTTATTTTAAAAATAAAACATATTTTCATATGTTTCATAATACCAATAGATAAGCTTTTAGTTAATTTTCATATGAAGATAACTTTCATAATATGTAATAAAAAGTATCAGTGAACACCTAGCCACTCTGAAATCACTGGTCTCACCCTTAGATTTAAAATAACCATGATTAGTTGTCTGTTTCTTTTTTCTGTTTATTTTTTGTTGTTGTTTCACTTCATCACTTTATTTAGTATATCATGTTTCTTCACATTATTTTCAGTGTTCCCATTCAGCATGGTATATTTAAAGAATATATCATGTTGTTATGCATATAATCCAATAGCATCACATTTTTTCACAATTCACTGCAAAGCAATGATTGAATAGGTTTTTTTTAAAAAAAGCTTATTGTCTTCTTTTGCCTTCAATGATCTTTCTCATTTTCCAGTCACTTGCCTTAAACTGCTGTAATCCATCTCACCAATTTCAACTGTTTTACTCCATTAACAGCAACAAAAGTTAGAAGAAAAACAAAAATGTCATATGCCTGATAAGGAGGCATGTTAATGGACTCTACTTCCCTTTGCAG
>TTN-203,,0,95764,413737,509500,GTAAATGCCATACATTGGCACAGATGTTGTCACTTCATTTCATATTGTTGTCCTTTTTGCTTTCTGTACATGTGTGGGAAATGCTTGTATTACCAACTGGAGAGACCAACAACCAAGACAGTAACATGGTAGGTAGGTACTGCAGAGCCTATATGGGATAAGAAATCATTATTTACAGTCACATTTCTACTACTGACCAAAGAAAAAATAATTTATTATTTGAGAACAAAGTTAAGTAATCAAATGAGCTCAGCTTGGCCCTTCATATAAAACATATCAGGACAGTTTGGTGCCACTAAAAAAAAATAATGTCTCAATGTATTTAAAAATTTTAAATCAAATAACCAATTAAGAACAGAATTACAAACTTAAAAAAGTCAGTGTCTAAGTCTAAAATTAAATCCTAATGTAAGACAGGGAGCTAGTATAGGACTGAAAACTAGGATTCTCTCTAGGCATTTTTACTAATTTAAAAATAAGACGGCTGGGCACGGTGGCTCACGCTTGTAATCCCAGCACTTTGGGAGGCCAAGGCAGGCGGATCACAAGGTCAGGAGATCGAGACCATCCTGGCTAACACAGTGAAACCCGATCTCTACTAAAAATATAAAAAATTAGCCAGGCGTGGTGTCACGCACCTGTAGTCCCAGCTACTTGGGAGGCTGAGGCAGGAGAATTGCTTGAAGCCAGGAGGCAGAGGTTGCAGTAAGCCAGGATTGCACCACTGCTCTCCAGCCTGGGCAACATAGCGAGACTCCACCTAAAAAAAAAAAAAGAAAGAAAGAAAATAAGACAACTACACAAATATCCTATTCCCAATTTTCTAATTGATATGTAGGGTGACTTTCAAATAGTTAACACTCATCAAATACTTGAATGCCTTCATTAACCAAAATATTAGTAGCAAGCTTTTCTTCCTTTCTTCCTACCTTCTTTCCTTCCTTCCTTCCTTCCCTCCTTCCCTCCCTCCTCTCTATCTTTCTTTCTTTCTTTTCTTTCTTTCCCTCTTCCCAAGAGAAAGTGTGAGTATGAACTGTGGTTTGAGGACAGGGGTAGAGGTACAGTCAAGCCATACTTGGACTGTTGGGGAAGGCTGTCCCTTGGTCTTCTTTGTCAATGAGAATATCAAGGGGAAGGGCAAATGCAGCACATCTCTTGAATGTGAAAACGATGAGGTTCCCTATAGCTTCCTCTTCTCTACAATCCTTTTACGTGATCCTAAGAAAAACCCAGGCCCATGATGACCCAACCAGTGCTTTTCACTCTGGTCAAAATGTCTCCATAAAACCAAGTACATGATATTATTCATACTGACGCGTTTGGAAGTTTCTTTACTCAAATTAGGTCAATTTAGGAATGCGACTAATATTGAAGCTTCAGATAATAAGAGGAAAGGATAAGGAGGATGACTTAAAAAAATTAAAAAGAGAGGTTCTGAAAGTCTGGCTTCAAGATGCAGAATGGAAAGGGGAAGTTGCTGCTATTAAATATTTTTACAAGTTTGAGTTGGCCTAGAGGATGCATTCATAGTTAAGCCATATAAGAATTTCCAGGCAGTTGACATGAGGGTTAGAAAGACATTACAAAACTACTTCAATCTTCTTATCACTTAATATCCCTACTCTTCAGAAGAGTCAAATACATTTTCTTTATCTTCCTTACATAATCTTCTAATTTGCAGAATTAAAGTATCAGCTCAATAGCTTATCAAATAATTAAACAAGCAGCCACTAAAATGGACAAATCTTTAGTAATGTTACTTAATAAAGGAACGCTTGTCTTTTCTTTGATAGAGACAAGTAAAGTGATGTCTTGCTCCCTTATAAAGAACACTCTCATCCCTTTCCTTTGACAATCTTTTGTTCTTATTAACACATTACTCCATTTTAAATTATGGCTCATGTCTATCTAAAGACTTAACTCATCTTTTCTCTGTCTTGGAATATATAATTACAGCAAGTGCTTTGGTGGGGACTAAATGTAATGCTGGAAAAATTTCTTTTGCAGAGGCATATCCACCAACCTTTCTCTCCAGACCTAAGTCCCTTACAACTTTTGTGGGTAAGGCAGCCAAGTTCATCTGCACAGTGACAGGGACTCCTGTGATAGAAACCATTTGGCAGAAAGATGGTGCTGCACTCTCACCTTCACCTAACTGGAGGATTTCCGACGCAGAAAACAAACACATTTTAGAACTCTCAAACCTTACCATTCAAGATAGAGGAGTTTATTCTTGTAAGGCTTCCAACAAGTTTGGAGCAGACATCTGCCAAGCAGAGTTGATCATCATTGATAAGCCACATTTCATTAAAGAATTAGAGCCTGTGCAGTCCGCTATCAATAAGAAGGTCCACCTTGAGTGCCAAGTAGATGAAGACAGAAAAGTCACAGTTACGTGGAGCAAAGATGGGCAAAAACTCCCCCCAGGGAAAGATTATAAGATCTGTTTTGAAGATAAAATAGCAACACTTGAGATTCCTTTGGCCAAACTGAAAGATTCAGGAACCTATGTCTGTACAGCTTCAAATGAGGCTGGAAGCAGCTCCTGCTCAGCCACAGTCACTGTCAGAGGTAAGAAACGTGTGAATGTATTTTCTAGTCCCTTCTCTGCAAGGAATCCTCAGTAGAAAAACTGTTGGCAAACAATTCAGTCAGTACACTTTGTTATTAAAATAATGTCATTCAGCAAACATTATGGTTTGGGAAAGTCCTGGCATTGTTTGATTTTATTTTTTTAATCCTCTTCAAAGTTCACTTAACTTTTGTTCTTTTAAATTGTCTGCTATTAACAAAGCTTGCTTAAAATTTCTTCTAAGAAAAAACTCCAAGTGTCTGAGCAATTCTTAACTATCTTCTTTTATAAAATTCTTCTTTGTGTAGGTAGTCTGTTTATTGTTGTTTTATTTTAAATCAAGAGACTGGGAAAGTGTCTTAGAATGATAGGAACCTATTAAATGCACCACAGCTTTTACAGAAATTTTGTGGAGATATTTTATGTGTGTTGGGTCTCTTTGTTGTATATGTCTACTTTTCTTTTGCGGAGTTTATGTTTCAGATATCTTCTCCTTTTTCTTTTTTGTAAACTTCATGTAGAGCCACCATCCTTCGTGAAGAAGGTGGATCCCTCTTATTTAATGCTCCCAGGTGAATCAGCACGCCTCCATTGCAAGCTGAAAGGCTCACCTGTGATCCAGGTTACTTGGTTTAAAAATAACAAAGAACTCAGTGAAAGTAACACAGTCCGAATGTATTTTGTCAATTCTGAGGCTATACTTGATATTACGGATGTAAAAGTTGAAGACAGTGGGAGTTACTCATGTGAAGCAGTGAATGACGTCGGCAGTGATAGCTGCAGTACTGAAATAGTTATCAAAGGTTTGTTTACTGAGTTTCCATCCAGTATTTTTCTGAGAAAAGATTTCCCTTTTAATTACTTATTACCCATTACTTACACAATGCTTTCATGCTTTTGTAGAACCTCCTTCTTTCATCAAAACTCTTGAGCCTGCAGACATAGTGAGAGGAACAAATGCTCTACTTCAGTGTGAAGTCTCAGGCACTGGACCATTTGAAATTAGCTGGTTCAAAGACAAGAAACAAATTCGAAGTAGTAAAAAATACAGATTGTTTTCTCAGAAGTCTCTTGTGTGTCTGGAGATCTTTTCGTTTAATAGTGCAGATGTTGGTGAATATGAATGTGTTGTTGCTAATGAAGTCGGCAAGTGTGGCTGCATGGCAACCCACTTACTCAAAGGTTAGTGCTTGAAAAACTAATGTCTCTTTAATAAATTGTCAAACTAGCTTTCTTACCCCATGGAAGAAAAACTGGTACTTTCTTCTCTTGTCCTATCCTTTAAATTTGTTTTGTCTTGGTTTGACCTGGGACCTTGGGAACAAAGTCAGTAACTTTCACCTGGTCTTTTTCCCGAGACTAGTGTAAATATCTATTATCTGATAACAAAAGGGAATAATAAGCCATTTTGTCAGCTGACAAACATGTATCATCTATGCCTCTGTCTCTTGGATGGAATTATAATTATTCTTAACTTTTATTTCTTCTTCTAATTAACACTATGAAATAGTAGTATTGGGACAAGATAAATATAATCTTGAAAAAACTCTTAAATATAGATGGTGTTGAAAGTGTTTGGGAATTGATATGTTTTATATGCTCTCTTTCCTTAACTAGAACCTCCAACCTTTGTAAAGAAAGTAGATGATTTGATTGCACTAGGAGGACAAACCGTTACCCTGCAAGCTGCTGTGAGAGGGTCAGAGCCCATTTCTGTCACATGGATGAAAGGTCAAGAGGTCATCAGAGAAGACGGAAAAATCAAAATGAGCTTTTCCAATGGTGTTGCAGTCTTGATAATCCCTGATGTTCAGATTAGTTTTGGAGGCAAATACACGTGCCTGGCTGAAAATGAAGCTGGAAGCCAAACATCTGTTGGGGAATTAATAGTTAAAGGTTTGTGTAGGAACATTTAAACCTCAAATTGCTATTTAGAATTAAAGTGAAACCCTAACAAGCATTTAGGGTGCTAACTATTTCATACCATTGTAGAACCTGCCAAAATCATTGAGCGAGCAGAACTGATCCAGGTGACAGCAGGAGATCCCGCCACACTGGAGTACACAGTGGCAGGCACGCCAGAACTGAAGCCCAAATGGTACAAAGATGGGAGACCCTTGGTCGCCAGTAAAAAATACCGAATAAGTTTTAAAAACAATGTTGCCCAGCTCAAATTTTATTCAGCTGAGCTGCACGACAGTGGCCAATACACATTTGAGATTTCCAATGAAGTGGGCAGCAGCTCCTGTGAGACTACATTCACTGTATTAGGTTAGTATTTTTAGAAAATGATGCTACATATGCATTTGAAACCCAACAAATGGCCTAAAGTCAATCACTGAGCACTCTTCTATATTGACCTTTTCTCCCTTCTTGTGCAACACACAGATCGAGACATTGCTCCATTTTTTACCAAACCCTTGCGCAACGTGGATAGTGTTGTTAATGGTACCTGCAGACTGGACTGCAAAATTGCAGGCTCCCTCCCCATGAGGGTGTCCTGGTTTAAGGATGGCAAAGAAATAGCTGCTTCTGACAGATACAGGATAGCATTTGTGGAAGGCACAGCCTCTTTGGAGATCATCAGAGTAGACATGAATGATGCAGGGAATTTCACTTGTCGAGCCACAAATTCCGTGGGAAGCAAAGACAGCAGTGGAGCCCTGATTGTGCAAGGTTGGCTGGAGACTTTGCATTTTATCCTTATTAAAGATTATGTTCAAATTAAGTCATCTTCCCTTAGATCAACCCTCTTAACTCTTTGAAATTCTTTCTTATACCCCTTCTTCAGAACCACCCAGTTTTGTAACTAAACCCGGCTCAAAGGATGTTCTGCCTGGCTCAGCAGTCTGCCTGAAGAGCACTTTCCAAGGATCTACTCCTCTCACAATCAGATGGTTTAAGGGCAACAAAGAGCTGGTTTCTGGTGGAAGCTGCTATATTACCAAAGAAGCTTTAGAGAGTTCCCTGGAACTCTATTTAGTAAAAACCTCTGATTCGGGCACGTACACATGTAAAGTCAGCAATGTCGCTGGAGGGGTGGAATGCAGTGCAAACTTGTTTGTAAAAGGTTTGCATTGTTTTCTTGACATCTTTGTGCTAACCTTGTTATAAATTCTTTCCTCTTTCTCACATTTCTTAATAACTTCCTTCCTTCCACAGAACCTGCCACATTTGTTGAAAAGTTAGAGCCATCACAGCTGTTAAAGAAGGGAGATGCCACCCAGCTAGCCTGCAAAGTAACTGGTACCCCTCCAATTAAAATAACATGGTTTGCAAATGATAGAGAAATTAAGGAGAGCAGCAAACACAGAATGTCTTTTGTGGAGTCTACTGCAGTTCTAAGACTGACAGATGTTGGCATCGAAGACAGTGGTGAATATATGTGTGAGGCCCAAAATGAGGCTGGCAGTGACCACTGCAGTAGCATTGTAATAGTCAAAGGTTTGTGTTCACTTTGCCTCTTGTGTTGCCAAAGTTATGGCCCATGGCACAGACCCCTCCTCCCTTAATGCAAATCATTCCTTTTTTACTGTAGAGTCACCTTATTTTACCAAGGAATTTAAGCCAATTGAAGTCTTAAAGGAGTACGATGTCATGTTGCTGGCTGAGGTGGCAGGCACTCCTCCCTTTGAGATCACTTGGTTCAAAGATAACACAATCCTGCGAAGTGGTAGAAAGTATAAGACTTTCATTCAGGATCATCTGGTTAGCCTGCAGATCCTCAAGTTTGTAGCTGCAGATGCTGGCGAATACCAGTGTCGGGTGACCAATGAGGTGGGCAGCAGCATCTGCAGTGCCAGGGTGACTTTAAGAGGTTAGTGTTGGTTCCAGTGAGGGACTGGCTTTTCTGAAGAGTCAATTCTTTTTTTTAAGCCACTTTTGCTATAGGGATAATATTGATTGAGAATTCATTCTTCTGTTAGAACCCCCATCCTTCATAAAGAAGATCGAGAGTACCAGCTCCCTCCGGGGAGGCACAGCTGCCTTCCAGGCCACTCTGAAGGGCTCCTTGCCAATTACGGTGACTTGGCTAAAAGACAGCGATGAAATCACTGAAGACGATAATATAAGAATGACCTTTGAGAACAATGTGGCCAGTTTGTACCTCAGTGGCATTGAAGTCAAGCATGATGGGAAATATGTCTGTCAGGCCAAAAATGATGCAGGAATACAAAGATGTTCTGCATTACTCTCAGTAAAAGGTTGGTTCAGAACGTTTGCCTTGGGTTTGAGGAAGAAATGCAGATGTAAGCCTTTCAGCAGGGTAATGCACAACCCACATCTATCCCTTTGTTTTCTACAGAACCTGCAACAATCACCGAGGAAGCTGTGTCTATAGATGTCACCCAAGGAGACCCAGCCACTTTGCAGGTTAAATTTTCAGGGACTAAGGAGATTACAGCCAAATGGTTTAAAGATGGCCAAGAACTGACCCTGGGCTCAAAATATAAAATCAGTGTCACTGATACAGTCTCAATACTGAAGATTATTTCTACAGAAAAGAAAGATAGTGGAGAATATACTTTCGAGGTCCAAAATGATGTTGGGAGGAGCAGCTGCAAGGCTAGAATTAATGTATTAGGTTGGTATTGTTCTTCTACAGAGAGGATTGGGCATTTCCATGCTCCTTCTTCCCTTAAAATTTAAAAAAAAAAACAAAAACAAATTAGTAGATTGACCTTTTTTTGTTGTTGTTTGCTTTTTCATTGAATAGATCTTATCATACCTCCTTCATTCACCAAAAAGCTGAAGAAAATGGACAGCATTAAAGGTTCTTTCATTGATTTAGAATGTATAGTGGCTGGGTCACATCCCATAAGCATCCAGTGGTTCAAAGATGACCAAGAAATATCAGCTAGTGAAAAGTACAAATTCTCTTTTCATGACAATACTGCCTTCTTGGAAATCAGCCAGCTGGAAGGTACAGACAGTGGGACATACACTTGTTCTGCCACAAATAAGGCAGGGCACAACCAATGCAGTGGGCATCTGACAGTCAAAGGTTGGCAAATTTTATTTCCACTTATCAAGAACTTACAAAATATTTTTGTTTCATTTCTAAATTTTCACCTTTATTGCTAAGTTATAAAATAAAACTTCCTATTTTCTTTTGCTTGTTTTTTCTTTCACCTCAGAACCCCCTTACTTTGTGGAAAAGCCACAGTCACAAGATGTCAATCCCAACACAAGGGTACAGTTAAAGGCTCTTGTGGGTGGCACTGCACCCATGACAATAAAGTGGTTTAAAGATAACAAAGAGTTACACTCAGGAGCAGCCCGCTCAGTTTGGAAGGATGACACCTCTACCAGTCTAGAGCTCTTTGCAGCCAAAGCTACCGATTCTGGAACCTACATTTGCCAACTAAGCAATGATGTTGGCACAGCAACCAGCAAAGCCACTCTCTTTGTAAAAGGTCTGGTCTCTACATCTCCTCACTTTCTTGCTTGTCTAGATTTTCTTGCCTGGGGTGGGCCGGGGCGGGGGACGCTTAAGACAGCAGTTTTGCCCAGTGACCTGTTTTTAAAAATATTCAACATCACAATTCTTTTTCCATCTTTAGAACCTCCTCAATTCATTAAGAAGCCCAGTCCAGTCTTAGTGCTGAGGAATGGACAGTCAACAACATTTGAATGCCAAATAACAGGCACTCCTAAAATCCGAGTGTCTTGGTATCTAGACGGGAATGAAATAACAGCCATTCAGAAACATGGCATTTCCTTCATTGATGGTTTAGCCACTTTCCAGATTTCTGGTGCCAGGGTAGAAAATAGTGGGACTTATGTGTGTGAAGCTCGAAATGACGCAGGCACGGCGAGCTGCAGCATTGAACTCAAAGTGAAAGGTTCGTGAATGGAATCTATTCTCCATTTTGGCTGTGCTGCCTGATAAGTTTGGGGTCTTCCCTTGAGTAAGCTACTGTCTTCCTTTTGAATCTTTAGAACCCCCCACCTTTATCAGAGAGCTGAAGCCTGTGGAGGTAGTAAAATATAGTGACGTGGAGCTGGAGTGTGAAGTTACGGGAACACCTCCGTTTGAAGTCACTTGGCTGAAGAATAACAGGGAAATTCGAAGCAGCAAAAAATACACATTGACCGACAGAGTGTCTGTGTTTAACCTCCATATAACCAAGTGTGACCCTTCAGACACTGGGGAATACCAGTGCATTGTATCCAATGAAGGCGGCAGCTGCTCATGCAGTACTAGAGTTGCCCTGAAAGGTCAGTTATACAAGAAGCAGCCTATCAAATAAAAATTCTGTAACGCTTTTAAATCTTATCATTATGGGTAGGAGTTACAATATGTTTCTTCTTTTCACACTCTCTTATTTAATCACAGAACCACCATCATTCATTAAGAAGATAGAAAATACCACTACTGTTTTGAAAAGTTCTGCCACCTTTCAGAGTACCGTGGCAGGTTCTCCTCCTATTTCTATAACCTGGCTAAAGGATGATCAGATTCTTGATGAAGATGATAATGTCTATATTTCATTTGTGGACAGTGTGGCCACACTTCAAATCAGAAGTGTGGATAATGGACACAGTGGGAGATATACCTGTCAAGCCAAGAATGAGTCAGGAGTTGAGAGGTGTTATGCTTTCCTTTTAGTACAAGGTTTGTAAGCTATTCTCTTTCAAAGATAGTCTATAGCGACAGTTTCATTAGCAGACATTATTTCTAGTGGAGTTACCAATGTAACTCATCCACATTTTCATTTTTACTACAGAACCAGCTCAAATCGTAGAGAAAGCTAAATCAGTTGATGTTACGGAGAAAGATCCCATGACCTTGGAATGTGTTGTGGCTGGAACACCAGAACTCAAAGTGAAATGGCTTAAAGACGGGAAACAAATAGTTCCCAGTAGATACTTTTCAATGAGTTTTGAAAATAACGTGGCCAGTTTTAGAATTCAGTCAGTAATGAAGCAGGACAGCGGTCAGTACACTTTCAAGGTGGAAAATGACTTCGGAAGCAGTAGCTGTGATGCCTACTTAAGAGTGCTAGGTTTGTATCTTCACCCCAGTCAGCTTCCCTTATTTATAGTATGTCCTTTGTAAACAAATAGCAAGAGATTAATGGATGTGTTTTGCTGTTTGCATTGGACAGATCAAAATATTCCTCCATCATTCACCAAAAAATTAACCAAAATGGATAAAGTTCTGGGCTCTTCTATTCATATGGAGTGCAAGGTGTCTGGTTCACTTCCCATTAGTGCTCAGTGGTTTAAGGATGGAAAAGAAATATCTACAAGTGCAAAATACAGACTTGTGTGCCATGAGAGATCTGTGTCTCTGGAAGTTAATAATCTGGAATTAGAAGATACTGCAAATTACACATGCAAAGTGTCAAATGTAGCAGGAGATGATGCATGCAGTGGCATCTTAACTGTGAAAGGTTAGAATTTCTTTACCTCTTCTTGATTCTTCCTTGCGAATGCTTCTTAAATGTATCACTCTTGCCTTTGTATCCTTTAGAGCTAAAATCTCTATGATTCTGGTTCTTTAGATACATATTCATTGTGTTCAAGAAATATTCAGCCATTGCCTCTTTCCAAGAGTGTTTTCTTAAATGTCCATAAAACTGTCACAATAATTCAACTGCAAGCAATTTAATTAAATATATCTCTCTTAAAATCTATAGAACCACCAAGCTTCCTAGTGAAACCTGGGCGACAGCAAGCCATACCTGATTCTACAGTGGAATTTAAGGCAATACTAAAAGGAACACCACCATTTAAAATAAAATGGTTTAAGGATGATGTGGAACTTGTCTCAGGTCCTAAATGTTTCATTGGCTTGGAAGGGTCGACTAGCTTCTTAAATCTCTACTCAGTGGATGCTTCTAAGACTGGACAGTATACTTGCCATGTTACCAATGATGTTGGTAGCGACTCTTGTACTACGATGTTGCTTGTGACAGGTGTGCAAATTTGATTCCTTTATGTTTCTGTCTGACTGTGTCTTTGGTTCTCTGTATTCAGTTACAATGTCTCTAAACAATCAAGAAAGTAGTATTCTTTCTAACATAGTAAACAGTATTTGCTCATGTTTTTCTCTTGCCTGTATACTATCTAATTTAACTATTGTTATTTATTTCTGTTCCCTGATACTCTCCTCTTTCCTGACTCTTTAGAACCACCAAAGTTTGTAAAGAAATTAGAAGCCTCCAAAATTGTGAAAGCAGGTGACTCTTCACGACTTGAATGCAAGATAGCTGGATCCCCAGAAATCAGAGTTGTGTGGTTCCGAAATGAACATGAACTTCCAGCCAGTGATAAGTACAGAATGACTTTCATTGACTCAGTGGCCGTCATACAGATGAACAATCTCAGTACTGAGGACAGTGGAGATTTCATTTGTGAGGCTCAGAATCCCGCTGGCAGCACAAGCTGCAGTACCAAGGTTATAGTAAAAGGTAGACATCTTGTTCTTGTGTTTCTCATTAAATGAAAACCACCTTCTCCCCTGGGTATTATAGCTCTTTATTCATTTACTATCATTTTAGTTTCCATTTGAGATCATAGAATATTTTTCTGAGCTAGTATTATTTCCCTTTTTAGATGGTTTCCTTCTTGAATTTTGCTTACATGTAACTAGTCATTATGAAATATTTTTGTTATTCCAGTGTCATAATTCTGATTACCTCAACACATTTGCCAAACATCAAACGTGATGTTTCAAAACTGCACAAAAAAATGAAGTAGGCATTTTAAAATTAGTCTTTTGCTTTCAATCAACTTACAGATATATCATTCTCACTATAATCTATATCATTAATAACAAGCACTTTTACTATATCTATGCAAAGTGAAAGCAATACAGGTTTTAAACTTATGTTTAAAACAGGACAATAATATTTTTTCCTTCTCTCTCAAGGATCACTTCCTATCCTTTAAAAATTATATGACTATACCTTGGTACAAATAGTATCTGTGTTTTTTTGCTGCAATTTTCCAGTGCTTTTTTTTTTTGTCACAAAGGCCAAGTTTGTCTTGTTTTAAGACAATTATTGCAGTAATCATTTGCTGAAATGGAAGACTTAGATCACGGATGTTGTGATGACTTCCAAGTGTCTGTTATAGAACATATACAAAAAAAATCATCCTTGAAATTAGAATTCCATACTTCATGCAAATCATTATTTATTGCTATACTTGCTTGTTTGCAATTTTTGTATCAATCTTTGTAGCCTAAGATACATCAGTAAGGTGTAGTAGATAGAATGTTGAACTGTTCAGTAACGACATCTAGGATCTATCTGGGTTCTCTGCCCATCTAGCTGGTTATCTTGTGAAGGCAAATGGCTTCTGAGGCTGTTATCCCATGAGAGTGTTAGTGCTGGACTCTACTTACCCATTAGAATATCTTAAACCTTTCTTCCAATTTAAAGACAAATAAAAAATTTTCATTTTGTGAAATTCAGTAGCCCAATTCATGAGAAATTCTTGTTTTTTGCAGAGCCACCTGTTTTTAGCAGCTTCCCTCCTATAGTAGAAACCCTTAAAAATGCTGAAGTCAGTCTTGAATGTGAACTTTCGGGAACACCACCGTTTGAGGTGGTATGGTACAAAGACAAGCGGCAACTCAGAAGCAGCAAGAAATACAAGATTGCATCCAAAAACTTCCACACAAGTATTCACATTCTCAATGTGGACACTTCAGACATCGGTGAATACCACTGCAAAGCACAGAATGAAGTGGGAAGTGATACTTGTGTTTGTACTGTAAAATTGAAAGGTAAATATAGTTCATCCACATGGCAGAAATGTCATAAATGTGCAAAATCCTACTTTTTTCACTCTCGCATGATCTGGACAATCTTTTCAACAATTTCCATCCATCTTTTCCTGTTCAGAACCACCAAGATTTGTCTCCAAACTGAACAGCCTCACTGTTGTAGCCGGAGAGCCTGCTGAATTACAAGCATCCATAGAAGGCGCCCAGCCTATTTTTGTCCAGTGGCTTAAAGAGAAGGAAGAAGTGATTAGAGAAAGTGAAAACATCAGGATTACATTTGTGGAAAATGTTGCAACTCTACAGTTTGCAAAAGCAGAGCCAGCTAATGCTGGAAAGTATATCTGCCAAATCAAGAATGATGGTGGAATGAGGGAGAACATGGCCACACTGATGGTCTTAGGTTGGTACAATAGCCCACGATAGAAACTGGTGCCAAATGCTGGAATGAATTACTAAGAGTTACTGGCAGATTCTTTTTCTGAGTTTCTTCTAGAACTATATTTATCCTCATCTATTTGAAAGGTCTAGAGGAAAGACATAGTTGATCTTTCAAACACTCTTTTCTGTTTCTGTGATTCTAACAAAAATTAGACATCTGTTTTATTGTTTAATAACTACCTGTCTATATCAATTAGCAGATACAATCATGACTCTCTTTGATTAAGCATGAAAGAATACAGAGCCCAGCATGTGCTACAAGAGTAATTGTTAAAACTAACAAGAACTCCAAAGGTTGGCATTTGATAGCAAAGCTTCCACATAAAATTAATGACAATTAAACAATTGTTTGAATAACAACTTTCAAAGAATTGTCTTTAGCACCTTAAGGTAGAGCAAAAATACCAAGTAATTCACAATAACCTGTAGACTTTGATCTACAGAGGGTCAAGTGGAAATCAATATATACTATCTAATGCACATTGTTTAAATTGTTTTGAAGTTGAGTCATGCACGAACATATATTTCTTAAGAATAATTGCTACATAAGACGACAGCAAGAGTGGTGGGAAAAACAAAAAATAAAGAAAAAACTGAAAAGAAAAAATATTAAAATAAAAAATAGCTATAATTCTATGACTGCATGTAATTATGGAATCACACTTTAAAGTCGAGAGAGAGAGCACCCTAACATAACCATCTCACTGGGAGAAACAATCTTAGTGAATGTGATAGTAGAGACAGAGTAAAGATCCCAGACTTTGACAGATGGATATCACGTTTTATTTCAGAGCCCGCAGTCATTGTTGAGAAGGCAGGACCGATGACGGTGACTGTAGGAGAAACGTGCACTCTGGAGTGTAAGGTGGCTGGCACTCCGGAACTCTCTGTTGAATGGTACAAGGATGGAAAGCTGTTGACCAGCAGCCAAAAACACAAATTTAGCTTCTACAACAAAATCTCTTCCTTAAGGATTCTCTCAGTTGAAAGGCAAGATGCAGGCACATACACTTTCCAGGTTCAAAATAATGTTGGGAAAAGCAGCTGCACAGCTGTGGTTGATGTTTCAGGTTAGTTCTGCTGTTTTCTTCTGGTTGCTTATGCAAATTCCTTTTACAAGTTTCCTTCTTTCAAGTCTCTTCTATTCTTTCAAATCATGATGAGTCTCTTACCTTTCCTCACACAGACCGAGCAGTTCCTCCCTCTTTCACACGAAGACTGAAAAATACTGGTGGGGTGTTAGGTGCTTCTTGCATCTTGGAATGCAAAGTAGCTGGATCATCACCTATTTCAGTTGCCTGGTTTCATGAGAAAACCAAGATTGTCAGTGGAGCAAAGTACCAAACCACATTTTCAGATAATGTCTGCACATTGCAGTTGAATTCTCTGGATTCCTCAGATATGGGCAATTACACATGCGTGGCTGCTAATGTCGCTGGGTCTGATGAATGTCGTGCAGTGCTAACTGTACAAGGTCAGTAGACAGTCAAACTTGTAAGGAATTTCTTACAAATTCCTCTTCAGGTGCACATCTATGTTGACAAACATTTGAAAGTGCTCTAATGTTTTATTCAAAATTGCAACTCCATCTGAAGCTTACAGGATCTTTTAATTGTTCTCCATGTCTATATAGAACCACCCTCTTTTGTGAAAGAACCTGAACCTTTGGAAGTACTACCAGGCAAAAATGTAACCTTCACAAGCGTTATTAGAGGAACCCCTCCATTCAAAGTCAACTGGTTCAGAGGTGCCAGAGAACTAGTGAAAGGAGACCGGTGCAACATCTATTTTGAAGACACTGTGGCAGAACTGGAATTATTTAATATTGACATATCTCAGAGTGGGGAATACACCTGTGTGGTTTCTAACAACGCTGGCCAAGCATCTTGCACTACCCGTCTCTTTGTGAAAGGTTTGCTCAAGTGGATTCACTTTTTCTGTTTTCTGTATACCGACATCCTTGTGTTTTTCTTGTGTTTAACTGCTGTGCTTTGTCACTTACTAGAACCAGCTGCATTTTTGAAGAGATTAAGTGATCATTCTGTAGAACCAGGGAAGTCCATAATTCTGGAGAGCACCTACACTGGAACACTTCCAATTTCTGTCACTTGGAAAAAGGATGGTTTTAACATAACTACCTCTGAAAAATGTAACATAGTCACAACAGAGAAAACTTGTATCCTGGAAATTCTGAATAGCACAAAAAGAGATGCAGGGCAGTATTCCTGCGAGATTGAAAATGAGGCAGGAAGGGATGTTTGTGGAGCTCTGGTATCTACATTAGGTGTGTTGTCTTATTGTCTCTTAAATCATTTGCATTCTTCTAACATGTAGCATAGTTTCTTTGATATTCATTAATTCCAGTTGCTAACTGTGAGCCTTTCTTCCTTAGAACCGCCTTATTTTGTTACGGAACTGGAACCTCTGGAGGCAGCAGTTGGAGATTCGGTTTCTTTACAATGCCAAGTTGCTGGGACACCAGAAATTACAGTGTCTTGGTACAAAGGAGATACCAAATTACGGCCAACTCCTGAATACAGGACCTACTTTACAAACAATGTGGCCACACTTGTTTTTAATAAAGTGAACATCAATGACAGTGGAGAGTACACATGCAAAGCAGAAAATAGTATAGGAACTGCTTCTTCTAAGACTGTGTTCAGAATTCAAGGTGATGATATTTTACAAATTAAAAAAATTCTTTTTTCCTTAACTCTTGTATCTTTATGGTGAACTTCTCATTTCATCTCCTAACACCTTAAGTATTACATGTCTCCCTACAGAGCGCCAACTCCCACCTTCTTTTGCAAGACAATTAAAGGACATTGAACAAACTGTGGGGTTACCTGTTACACTCACTTGTCGATTAAATGGCTCTGCACCCATCCAAGTGTGCTGGTATAGAGATGGAGTACTTTTAAGAGACGATGAAAATCTACAGACTTCATTTGTAGATAATGTGGCAACTTTAAAAATTTTGCAAACTGACTTGAGTCACTCTGGCCAGTACTCTTGCTCAGCTTCCAACCCACTTGGAACAGCATCTTCTAGTGCTAGACTCACAGCAAGAGGTTTGTTCACACGTCACTCTTTTTCTTTGCAAACTGTGGCTTCATATTTCATTGTCAAAGTAGAAACGACCAATGGCAAAAAAACAAACAAAAAATACACATTGCCTTTCTTCTCATCCTCCAGAACCCAAGAAATCTCCCTTCTTTGACATCAAGCCTGTATCTATAGATGTTATTGCTGGAGAAAGTGCTGATTTTGAGTGTCATGTTACTGGTGCTCAACCGATGCGAATCACTTGGTCAAAAGATAACAAGGAGATCCGTCCTGGAGGAAACTATACAATCACATGTGTGGGAAACACTCCTCATTTGAGAATTCTTAAAGTAGGCAAAGGAGACTCTGGTCAATATACTTGCCAAGCAACCAATGATGTTGGCAAAGACATGTGCTCAGCTCAGCTCAGTGTAAAAGGTATCATTCCATGACTTTTGACAATATTTGTTCCTTACCATATTTGCATAATTGTCTTATAAAAGTTTCTTTGGTTTTTAAATGTTTGAGAGAAACTAACTGGACATGTTAGAATTTGTGTATTAGTGTTGGAGGCAACATTAATCAAAGTTGTGTTTTCTCTTTATATTGTTCTTTACATTAGTGTAACTCTAAGTGTAATCTTATCAAAAAGTATTGTTTAATTGAAATTTGTTAAATGTTGTTTTAACTATCTAGTCCATTTTTTAATGCTTTCTTGTTATATGGCATTCTGATTTATCATTACTAAATGTTGATCAAATACATCTATAATACATTAACTTTTATGTTTTAACTTACATAGTCAAACTAAAAAAAAGAATCAACTAAATTCTCTATTAAAAATGCACATGTACCCTAAAACTTAAAGTATAATAATAATAAATTTTAAAAAACTAAAAAAAAAATGTTATGAGATTATTTAACTTAAAAGATAACTTATTTTACTGTAAAATCCTCAGAAAGTATATTCTTAATAACAAACCAGTTTAAATATAAATTTATGGGATCTTCAGCTACAAAAACAAGCTCTTTTAACATGTATAATAAATATCCCTTACTGACTGTTTTGTTTGGTTTACTAGAACCTCCAAAGTTTGTTAAGAAATTAGAAGCTTCAAAAGTTGCAAAGCAGGGAGAATCCATTCAACTGGAATGTAAAATAAGTGGCTCCCCAGAAATCAAAGTTTCATGGTTCCGAAATGACAGCGAACTTCATGAAAGTTGGAAATACAACATGTCATTCATTAATTCTGTGGCATTGCTTACGATCAATGAAGCTAGTGCTGAAGACAGCGGGGACTACATTTGTGAGGCTCATAATGGTGTTGGTGACGCCAGCTGCAGCACAGCGTTGACAGTGAAAGGTTAGACACACTAAGCTTCTTTGTTTCTTTATTCTCCTCTGATTTGGGCTCTTAGCAAAGTTATGAGTTCCAAAATAAAAGGATAATTAAGGTTATTTGGTTGCAATTCTTCAACAAGTTTTAATGAATTGTCATTTCTTGTGTCAGCATGTATTGTCATATGATCACACCAGTCACTCTTCAAGGTTCTAGATTTAATTTTTTTTTCCTTTATAGTAAGCAAGTGTTCTCATTGTTTATCTCCTTTTTTCTGGTAGCACCTCCTGTTTTCACCCAGAAGCCTTCTCCAGTAGGAGCTCTTAAAGGTTCTGATGTGATTCTCCAATGTGAAATTTCGGGAACTCCCCCATTTGAAGTAGTATGGGTTAAAGATCGAAAGCAGGTTAGAAACAGCAAGAAATTTAAAATCACTTCAAAACATTTTGATACAAGTCTTCATATCCTTAATCTTGAAGCCTCCGATGTCGGGGAATATCACTGCAAAGCTACTAATGAGGTGGGAAGTGACACGTGTTCTTGCTCTGTCAAGTTCAAAGGTTTGTATACATGGACACAAAAATATATGCCCCTTCCTCCTATCTGTTCTTGCCTAACTAATAACTTGTGTGGCCATGATTCTCACATTTTTTCCTCTAACCACAAATTTCTTTCATCAGAACCTCCACGATTCGTGAAAAAGCTAAGTGACACCTCAACCCTTATTGGGGATGCTGTTGAGTTACGGGCCATAGTGGAGGGCTTCCAGCCAATTTCTGTTGTCTGGCTGAAAGATAGAGGTGAAGTCATCAGAGAGAGTGAAAATACCAGGATTTCATTCATTGATAACATTGCAACCCTCCAGCTGGGGAGTCCAGAAGCATCTAATTCTGGAAAATATATATGCCAAATCAAAAACGATGCTGGAATGAGAGAATGCTCTGCAGTCTTGACTGTACTAGGTTAGTAGCAAAGCACAGCCAGAGAAAAAATCAATTTACTTGATCCATGATCATTTTCCTCAAATATTCCTCTTATCCAGTAATTCAGTGATTGCACTCTTGAGTTTGAAAGGTTACTTTGTTTTCAATGCAAAATACTTCTTCTTTTAGAACCAGCAAGAATCATAGAGAAGCCCGAACCCATGACTGTCACTACTGGAAATCCTTTTGCATTAGAGTGTGTAGTGACTGGAACACCAGAACTCTCAGCCAAGTGGTTCAAAGATGGAAGAGAATTGTCTGCAGACAGCAAACATCACATTACATTCATCAATAAAGTGGCTTCCCTTAAAATCCCCTGTGCCGAAATGAGTGACAAAGGATTATATAGCTTTGAAGTGAAAAACAGTGTTGGCAAAAGTAACTGCACTGTATCCGTCCATGTTTCTGGTGAGTAGAATGAGATTTTTATGAATATACAATATTTCCAGGGGGTGGAGGGGCACAGAATAAAACTTCTCTTTAAACGCAAAACTACCCTTCCCCACATAGATCGGATTGTGCCTCCTTCCTTCATCCGCAAGCTGAAAGACGTGAATGCCATCCTGGGGGCCTCAGTTGTTTTGGAGTGCCGAGTCTCTGGCTCAGCCCCGATTTCAGTTGGCTGGTTTCAGGATGGAAATGAGATTGTTAGTGGGCCCAAATGTCAGTCCAGCTTTTCGGAAAACGTCTGTACTTTGAATCTGAGCTTGTTGGAGCCCTCCGACACAGGCATATACACGTGTGTGGCTGCCAATGTAGCTGGTTCCGATGAGTGCTCAGCAGTCCTGACTGTGCAAGGTCAGTGTGCAAGGATAAAGCTGCTGCTTCTCTAACACCTCTTTCATGTGGACGTGGTGCCTGCCTTCCCTGGAGTTTCTTTATTTTGTCTTCATGTTTAGTCTTAGCTCCCTTTTTTTAAGGAGCAAAAGCACTTCTCACTTGGATTTCTTTCTTCTCTTTATCTCCCCTTCCGCCTTGCAATATCTAGAACCACCATCTTTTGAACAAACCCCTGATTCTGTGGAAGTTTTGCCTGGAATGAGCCTCACATTCACCAGTGTCATCAGAGGCACCCCTCCTTTCAAGGTCAAGTGGTTTAAAGGCAGCAGGGAACTGGTGCCTGGGGAGTCATGCAACATCTCTCTGGAAGATTTTGTCACAGAACTGGAGTTGTTTGAGGTGCAGCCATTAGAAAGTGGAGACTATTCTTGCCTCGTTACAAATGATGCTGGCAGTGCTTCCTGTACCACACATCTTTTTGTGAAAGGTTTGCTCTTTCCCCCAATATATACATCTTTTAAAATTTCTCTTAAGTCTTCATTAGAAGGCAAGAATTTTACCCACATGTTTTCTCCTTATAGAACCAGCCACCTTTGTGAAAAGATTGGCTGATTTCAGTGTTGAGACAGGAAGCCCCATAGTTCTCGAGGCCACATACACTGGCACACCTCCAATCTCAGTGAGCTGGATAAAGGACGAGTATCTTATTTCACAATCTGAGAGATGCAGTATTACTATGACAGAAAAATCTACCATACTGGAAATTCTTGAGAGCACAATAGAGGATTATGCACAGTACAGCTGCCTGATAGAAAATGAGGCTGGTCAAGATATCTGTGAAGCTCTGGTGTCTGTCTTAGGTGTGTTGACAGCTACCTCTTTTTATTGCTCTCTTTCTTTTCAAACATCCTCTTTTACATGGCATGACTGACTTGCTGACTACCATCCTTTGTACCATAGAACCACCGTACTTTATTGAACCTCTGGAACATGTGGAAGCAGTCATTGGAGAACCTGCAACTTTACAGTGTAAAGTGGATGGAACTCCAGAAATTAGAATTTCTTGGTATAAAGAACACACAAAGCTACGATCAGCTCCTGCATATAAAATGCAATTCAAAAATAACGTTGCTTCCTTAGTAATCAACAAAGTGGATCACAGTGATGTGGGAGAGTATTCATGCAAGGCAGACAACAGTGTGGGGGCAGTCGCTTCTTCAGCTGTGCTTGTTATCAAAGGTGATGGTGTTGTTTAACCTAGTGTGTGTGAACAGATTCATTTTCTTAAAAACGTTAAAACTTTTATGAATTGAAATATGTTGTGGATGCCTTCTCACCTGTAAATAAGGATTATCTGTAACTTCTTTACAGCGCGCAAACTTCCACCTTTCTTTGCAAGAAAACTGAAAGACGTTCATGAGACTCTAGGCTTCCCAGTTGCATTTGAATGCCGCATCAATGGCTCAGAACCTCTTCAAGTGTCTTGGTACAAGGATGGGGTTCTTTTGAAAGATGATGCTAATTTGCAGACATCTTTTGTTCATAATGTAGCAACTCTTCAGATTTTACAAACTGACCAGAGCCACATAGGGCAGTATAATTGCTCTGCTTCTAATCCTCTTGGGACTGCTTCATCCAGTGCCAAGCTCATTCTCTCAGGTGAGTAACTCACAGTACCCTCTTCATTGTAAAGCAGCTTCACTGCTCCAGGCCACCAAAAGGCTGGTGCCATTTAGTTTCTGCTCTGTATGTGAGAGCATGGAAATAAAAATCACCATGTTGGTCTTCATTCTTTTCAGAGCATGAAGTGCCTCCTTTCTTTGATCTAAAGCCTGTATCAGTAGATCTTGCTCTTGGAGAAAGTGGTACTTTTAAATGTCATGTAACTGGGACTGCACCAATCAAAATCACTTGGGCCAAAGATAACCGAGAGATTCGCCCTGGAGGCAACTACAAGATGACTTTGGTAGAAAATACTGCCACTCTGACAGTTCTCAAAGTAGGCAAAGGCGATGCCGGGCAGTACACCTGCTATGCAAGCAACATCGCTGGAAAAGACTCTTGTTCTGCTCAGCTGGGTGTACAAGGTACTTGTTAGAGTGAAGGAGCAAGATCTCTTTTACATTTTCAGTATCTTAAAATATAGGAGGGTGGGTGTGCTTGAGAGAGAGCTATGTTTAGGACCAGGGTCTAGTGATGAAAATGGATCAAGTGGATCAAGGACCTTCCAAATGGAGACAAGTATTTTTTAATTACTTTAAAAAAAAAATTTAAAACTAGGAAAACATGGACCAAAAGTCCATTTTAAGAGACTAAAAATAGAGACTAGAGAGAGATAACCGAAACTCTACAAAATTGCAAGAAAATCCTAGTTTGAAAGACGGTATCATAGGACAAAAGCGAAGTTATTGCAAATGACTTTTTTCCCACAGTACTTAGTAAATGAATGGATTTTGTCCCTCTAAGGCATAGCAAAGAGCCAAACTATCAAGCCCTTCAAGGAGAATTCAGATGAGAATGATAAGTTCAACTTACTTTCCTCCACTAGCCCCACTTAAATAATAGTGGAGGTCAGGGGCTGGGGAGTAAGTAGATCAGTATCTGCTATTATGGAAGGCAGTCATGTGTTTCTGCCACATGTTTATCGCTGCTACTGTCAGAAATTAAATAGTTCACTCAATGGACTGCTAGTCTAGTCCATTAGAGTATTTTTAAGGGTTTTTGTAGTGGTGGTTTATAAATATCTTGAAATTAAAATATAATTAGATTTAGCAGCCCATTTGCTCTATGACATATAGCTAATCACTTTTACTTCCCTATGCCTGAATTTTTTGCTTCAGTTAATGAGGAAATCATTACTCTCACACACTTCAAAGGAAAATTATGAAGGTTGAGGAAATACCCATTTAACACCTAAAAGAGGAAAATGGCATTTTAAAAATATTAAGATATCTGACCCACTTTGCCATTCCGGCTCTTCATGCTATGTAACTGATAGCATTGCAGCCTTAGGAAATAGTTCTCCACTGGTTCATATACAAGACAGTAATCAAATTCTCATTCCCCGTGGACCTCAGAGGGCTTCCACTGACAGATACATGCTATTATCTCTGATCTTGGCACTAGAGAAGGGACTCTTTTGCTGGGGAGAGGATGGCACAATAAAGAGTAATGTCTTTTTCTCCTTCTTTTAGTAATAATACTTGATGTGGATGCTTACAAAAACAAGCATATTTTATTTTAGAAATTTTCTATTTAGGTTTCATTTAACTCTTCTTCCTTGAACTGCATAAATTTGTTTTCCAGAGCTAAAGACCTCTCTAGCAAAGATTATTTTTTCCACCTCATCTTGAATTATATGCATCTGTTCCATCCCTTACCCTGTGTTTTTCCTCTTGGTTCCATAGAACCACCCAGGTTCATTAAGAAGCTAGAACCTTCAAGAATTGTGAAACAGGATGAATTCACAAGGTATGAATGCAAAATCGGTGGGTCTCCAGAAATCAAAGTTTTATGGTATAAGGACGAGACTGAAATTCAAGAGAGCAGTAAATTCAGAATGTCATTCGTTGACTCGGTGGCTGTGCTGGAAATGCACAATCTCAGTGTTGAAGACAGTGGAGACTACACCTGTGAGGCCCACAATGCAGCAGGCAGTGCCAGCAGCAGCACATCCTTAAAAGTTAAAGGTCAGCGCTCTCCCCACCTGTGTGTTTTTCACATTAGCCTCCTCTTTAATTGTCCTCTTAACTTCCTGTTTGACTCTTCAACGATGTTTTAAAATAGGGAAAGGACACAACAAAGAATTGAAAGTGTTTTTTTCACTCTCTATCTCTCTGATGGAGTGGAAGATTGATTCTTACTTTTAACTATATACTTACAGAATACATCCGTATTTTCCTTTTTTCCAATTTTAGAACCACCCATTTTCCGCAAAAAGCCTCATCCTATAGAGACACTGAAAGGAGCTGATGTTCACCTTGAATGTGAGCTTCAGGGCACTCCCCCATTTCACGTTTCTTGGTATAAAGACAAGAGAGAACTTAGGAGCGGCAAGAAGTACAAGATAATGTCTGAGAACTTCCTAACCAGTATCCACATCCTGAATGTCGATGCTGCAGACATTGGGGAATATCAGTGTAAAGCCACAAATGATGTGGGAAGCGACACTTGCGTTGGTTCCATCGCTCTCAAAGGTTAGATGGACTGCATTCACTTCTGCTCACTACTTCCCTTCTAATTGTAATACTCTGTTGCCCCCTCCACCCCAGCCCAGTCTTATCACTAGCAGCCTATTCCACTTTCCCTTTGTTTCCTCTCCAAGTCCTTTTCTGTTTAGTCTGCTTCCCTTTTCCAAATCCTACTGAATATCCTTTTAGATAATGTTGTAATTAGGTTTTGATTGGATTAAGAAAGCTGGAGTAGATGAGATATTCAACTTTCCTACTGAATACAAACTTTAATGTGTCCCTGCTCGCATCCACCAAAAATGCCTCTTAAATGGAAATAACACATTATCACTAGTTTGATTCCCGGCATTCACGATTTGAGCAAAATGCTGTCAGTCTCACAAATTTTAAAACCCAGGCTTTCCTCCTTTTTCATCAGCACCACCAAGATTTGTGAAGAAGCTCAGTGACATATCTACTGTCGTTGGTAAAGAAGTTCAGCTGCAGACTACCATTGAAGGCGCTGAACCCATTTCAGTGGTGTGGTTCAAAGATAAGGGAGAAATCGTTAGAGAAAGTGACAACATATGGATTTCTTATTCAGAAAACATTGCAACCTTACAGTTTTCAAGAGTGGAACCAGCCAATGCTGGAAAATACACTTGTCAGATCAAAAACGATGCTGGGATGCAAGAGTGCTTCGCCACGCTATCCGTTCTCGGTTAGTAAAAAGATGATGTTATCACAGATACAAGGCACACACTCACCAGGATCTGTATTTTCTTTAGTTTTTCAATTTGAGTTTAAAATATGGATATCTTTTACATTTCATTCCAGAGCCTGCAACAATTGTAGAAAAGCCAGAATCCATAAAAGTTACCACGGGAGACACCTGTACCTTGGAGTGTACAGTAGCTGGCACCCCTGAACTCAGTACTAAGTGGTTTAAGGATGGAAAAGAGCTAACAAGTGACAACAAATACAAAATAAGCTTCTTCAACAAAGTATCCGGCCTTAAGATCATCAATGTAGCACCGAGTGACAGTGGGGTATACAGTTTTGAGGTGCAGAACCCTGTTGGCAAAGACAGCTGCACAGCTTCATTGCAGGTTTCAGGTTGGTTGATTTCTTGGGCTTTTCCTTCATCATTATAATAATGTAGTTCCTGATTTTCATAAATGTATATGGGTTGTTACATCTTCTATAGGATAACATGAGTCCGACATCTTCTGAATCAGCAAATTCAGAGGCAATACCATCTGTAGAATTAGAAGAAAACCATGTTCAAAAGTTATATCCCTTTCTTTTTGAGGAATTTCCAAAATGATGATAGGAATGAAAAATAGTCCCTGGATAAGGTTAAAGCAGTCTTCATTTATGCTGAAATAATTCACCACATAATTCTTCACGGCAAAGAGAGAACAAAATCCCTAGCAAGTCAACCATCACATTCTGCCCACTGATTCTCCAAGCTTTTGATAGTGTGAACCCATAGAGGAGTTTTTAATACCGTCACAAAAGAGCCAAATGGATCTAGGGATAGTCCATCAAAAAGACAGTTCTCTCTTCAAGTCATTTTATAATTGTTGTCCTTTGTTTTTTTTGTTTTGTTTTGTTTTGTTTTGTTTTGTATCATTCAGACCGAACCGTTCCTCCTTCATTCACAAGAAAATTGAAAGAGACAAATGGTCTATCCGGCTCCTCAGTTGTAATGGAGTGTAAAGTCTATGGGTCACCTCCAATCTCTGTCTCCTGGTTCCATGAAGGAAATGAGATCAGTAGTGGAAGGAAATACCAGACCACCCTGACAGATAATACTTGTGCTTTAACTGTGAACATGCTGGAAGAATCAGACAGTGGTGACTACACATGTATAGCTACTAATATGGCTGGTTCTGATGAATGTAGTGCTCCTTTGACTGTGAGAGGTCAGTTTACAAAACAGTAAAATGAATTGCATTTCATAGTTTATTAAGCATGTTTGTCATAACAATTCACAAATACTAAACCTTTTCTGATATGTGCTTTTGTGTTTAGAACCACCATCTTTTGTTCAGAAACCTGATCCCATGGATGTTTTAACTGGGACCAATGTAACTTTCACAAGTATCGTAAAAGGAACACCTCCTTTCAGTGTTAGCTGGTTCAAAGGTAGCAGTGAACTAGTACCAGGTGACAGATGCAACGTGTCTTTGGAGGATTCAGTTGCTGAACTGGAGTTGTTCGATGTAGATACATCACAAAGTGGAGAATATACTTGCATAGTTAGCAATGAAGCTGGCAAGGCTTCTTGTACAACACATCTCTACATAAAAGGTTTGTCAGACTGCTCTTCTAGATTTATACGATTAGTAATTAGATGTGTCTTTGTCTGTATGTATATGTGTTTGATTTTATATTTTCAATTTGGTCACTTTAGCCCCAGCCAAATTTGTGAAGAGGCTGAATGATTACAGCATAGAGAAAGGAAAACCCCTGATCCTAGAGGGTACATTCACTGGAACTCCTCCCATTTCGGTTACCTGGAAGAAAAATGGCATAAATGTAACTCCTTCTCAGAGGTGTAATATAACTACGACTGAAAAATCGGCAATCCTGGAAATTCCAAGTAGCACAGTAGAGGATGCAGGACAATACAACTGCTACATTGAAAATGCCTCTGGAAAAGATTCCTGTTCAGCACAAATACTCATACTAGGTTTGTCATGATTGCACATTTTTATCTTTGTATACAATCGATGATCTGGCATGTCTCCTTCATGACTGATTGATTATCTCTCTTGGCTGCAGAACCACCGTATTTTGTCAAGCAGTTGGAGCCGGTTAAGGTGTCTGTTGGAGATTCTGCCTCTCTACAATGCCAGCTTGCTGGAACCCCTGAAATTGGGGTATCCTGGTATAAAGGAGATACAAAATTGAGACCCACTACGACTTACAAAATGCATTTTAGGAATAATGTTGCTACACTGGTTTTCAACCAGGTTGATATTAATGATAGTGGAGAATATATCTGCAAAGCTGAAAACAGCGTGGGAGAAGTTTCTGCATCAACTTTCCTTACCGTTCAAGGTGATTGCAATATTTTTAAAGTGAACGAATTTGTGTTTCTTTTGAACAAGATTTAAAATGTCTGGGGAGGCCTATTTTTTAGGAAAATCTTTCCAAAGGCTTAAAATTCTGCTTAAGTAATCCTATTTACAGTTAGTGGCTTATCTTTTTCTATGGATTCTACAGAGAGATAATATGACTAAATCTTTAATTGGAAGGATTATGCAATCATTTGCTTCTATAATTAAATCTTTTTTAAAAAGTGACCATATATTTTTAAATTCCACCCCGTAAGTATCTCATGCAAATTGCTAGAAGGCAGTCTTTAAAATTACAGGAATCTGCTGCTTGCCCAGAGACATGCCTTCAGCCAACCAATTGCTTTATTGGTTTTCATACTGTTTTGCACCTACTGTGCATTAGGGTTGGTCTCAGAGTGATACTTTTGCTCCAGAAATCTATATGCTTTTCTTTATCTCCAAGTTAATTCAAGAGACATTAATAATTCCTGATTTTTAATAGAAATTGCATATATACGTGCGTTTGTATATATATAATTGTGAGAAGAGCATTTAGTAAATTAAAGTATTTGTTACTTTTATTCTGTTCCTACAGAGCAAAAACTTCCACCATCATTTTCTCGACAATTGAGAGATGTTCAAGAAACAGTTGGACTGCCAGTTGTTTTTGATTGTGCCATAAGTGGATCAGAACCTATCTCCGTGTCTTGGTATAAAGACGGCAAGCCATTGAAAGACAGCCCAAATGTACAAACATCATTTTTAGACAATACAGCCACACTCAATATTTTTAAAACTGACCGGAGCCTTGCAGGCCAGTATTCCTGCACAGCTACAAACCCTATAGGCTCTGCTTCTTCCAGTGCCAGGCTCATTCTCACAGGTTTGTGGATTCTTAAACTTTCATTTCTAGAATTAAAGTATTATAATCAAATATGAACTTAGGGAGAAATTTCTATTTCAGTAAACTGACATGGTCCAGATATTGAGCCTGAAACCTTGTCTTTCTGCTCTACTATTAGAGGGGAAGAACCCACCCTTCTTTGACATCCGTCTTGCCCCTGTGGATGCTGTGGTGGGAGAAAGTGCTGACTTTGAGTGCCACGTCACGGGCACACAACCGATAAAGGTCAGCTGGGCCAAAGACAGCAGAGAAATACGAAGTGGCGGAAAGTACCAGATTAGTTATCTGGAAAACAGCGCCCACCTGACAGTCCTCAAAGTAGACAAAGGAGATTCTGGACAATATACCTGCTATGCTGTGAATGAAGTGGGAAAAGACTCTTGCACAGCTCAGCTGAATATAAAAGGTATCGTTTATTTTGCAAGTGGTCCAACAAAAGTGTAATCATTTTGTAGTATAGCCTGAAGGTGTCGTTTTTATGATGATGAATGCAATTTAGGACATTTTTAAACAAATGAAAAGAAAATGTTTAAGAGGAAATAAGTTTATCTAGAGAAGAAGTCATTTTTTAAATCTGTATTTCTTTCTTTCCTCGAGACAGGATCTCATTCTGTCGCACAGGCTGGAGTACAGTGGCGTGATCTCAGTTCACTGCAACCTCTGCCTCCTGGGTTCAAGTGATTCTTGTGCCTCAGCCTCCTGAGTAGCTGGGATTACAGGCGCCTGCCACCATGACCAACTAATTTTTGTATTTTTTGGTAGAAACGGGGTTTCACCATGTTGGCCAGGTTGGTCTGGAGCTCCTGACCTCAAGTGATCCACCCGCCTTGGCCTCCCAAAGTGCTGGGATTACAGGCATGAGCCACCACACCCAGCTTATAATCTATATTTCTAAAACTTTATATATTCCCTATGATACTGAGACTACCCCTTCTTTTTACAAATTTGTGATTCTCTAAATGGCCATGAGTTACTTCTTATCATCCACCTTGTAAGTCAAAGAACAGTTTAGAATAAGCTCGTAGAAGGAGGCTGAAATGTTTAGGAACATATTCTGATATAGTGTATTTAGTTGGTTAGCCTTGATTTTTAACTAAAAATATGAGGGTTTTTTTTCTTGAAAAGCTTCATATTAGTAATCTGCTTCTAGCTTCTACTTCATATATCCTTGCAATTTCTTATAGAGCGGCTCATCCCACCAAGTTTCACTAAAAGACTCTCAGAGACAGTAGAAGAAACAGAAGGGAATTCTTTCAAACTTGAGGGACGTGTGGCTGGTTCCCAACCTATAACTGTTGCCTGGTACAAAAATAATATAGAGATACAACCAACTTCTAACTGTGAAATAACATTCAAGAACAACACGTTAGTGCTGCAAGTCAGGAAAGCAGGCATGAACGACGCTGGTTTGTACACATGCAAAGTGTCCAATGATGCAGGCTCTGCTCTGTGCACGTCTTCAATCGTCATCAAAGGTGAGTTATCCTCACAGCCCCAACCTGTTGTGTTTTTCTTCACTGCCTGTTATATATCCATGAGCATTTCTTATGATATCTTGACCAAGTAAGTTATAACAAATATAAATACACATTATTTAACTGTGTATTTATCACTCCATATGTTTACTAAAAATATAAATTATTGTAATTTAATTATGTGGCTTCCCGAAGGAGGTGTCATTTAACGGACTAATATCTTAGGTTTCTAAATCATATCCTAAAATTCCTTTAGGTAGTTAGAAGTTTCAGCGTACTCTGAAATGTGTGCATATGTGACATATATTTTTATGAAGCACATTTGTTTTGAAATTTTTTTAATGTTCATCACCAAATATCACATTAACTTGACTATTATTGAGTTATATATTATATCACAGTCTGAAACTTTCTCCTTTCCAAGTGTATTTCTAAAGGATTATTGTTTAATGTATATTGCCCAAAGCGTTTGACCTGCAAACAAATATTAATCCCAGACAAAAGGGTAACATTTGCCCAAAAAGAAAAATAATGGGTAGAAAACATTGCATATCATTATGGAAGACATATTTAAATACACAATCATCGCTTGAGAAAATGAAATAGACCATGTTGTTTAAGGATATCTTTATCTGTTTCTCTTCACTGTAATGGCTTCCAGTAATTACAACATAGCTTCATCAAAATCACATTAAAAACTAACCTCCTAGAGCAGCCTGGAATTAATTACCAACTCTTATGATCTGGTTAGTTATCTCACAGTGCACAGGTAGTAAGTTATTATTAATAGGCTGATATCACTAATAAGTAAATATCACTGAGTTGTCTTAAAATTCCAGTTTCACCACTCATTTTGTGGAATTTAGATGCATTTAGTTTTAAAACACATTTTATAAAATGAAAAATATATACTTAGCAGTGGCTTATCTTCATGATTTACACTCATGATGGTTTTACCATGGGCAGATAAATGCTTTCTATAGAATTCTGAAGCTATTTATAAAATGTTTTTAAAGGATAGACATCAGAAGTTTTAATCTTTGCAATAACAAAAAAAATGGCCTTATTCTTTCTAGGTACAGGTCTCAGAACCATTGAACAAAATCATTACATAATACTGAGTTGTACATTGCCTTCCTATCATGTTACTCATCAATGTCTTCATCATTGGTCTTCAGTTAAACACTGAGCCTCAACTCCTAATTCCCTTGGGCTAAGATTGGATTTTAAATGCTACTGTGGCTGCATTTAATAGCTAAAGATGAACATCAGAGAAAATCACATATAAATATGTGGGCTCATGTATTACTCAAATGCTAGCTTTCTTTCCTAGAGGGTAGCAATCATTGCCGCTGGAGATAAGCAGAATTCCCAAATAAGCCCTTCATTTTCAGGGTTCAGCAAAAACACCGCTGTACACAGGTTTGAGAGAATTAATAGTGTGCTATATGGCAAAGAAGTTCATAGTAACTGCCAATGTCTGCAGTGCTTAGTAAGGACACAGAGGCTGGGGCAATTTGTGGGCAGCATGTGATGTGTTCTTTGCTTGTTTTTAAACCTTTATCTTTTTAAAAAATCCAACAAATTTAAACTATTGTCTTTAGAGAGGAATAAACCAGGCACATAATTCTGTCCTACTACAGCAACAGTGTTACCTGTTAGAGGCCAGTTTTTCTCTTTATTTGTTTCTCTTGTGGAATTTAATACTTTTTTGCCTTTATGTTCCTCATGAAAATACCTTTTCAATTCCAGAACCTAAGAAGCCACCTGTATTTGATCAGCACCTTACTCCAGTAACAGTGAGTGAAGGAGAATACGTGCAGCTCAGCTGCCATGTCCAGGGATCTGAGCCAATTAGGATCCAGTGGTTGAAGGCTGGCAGGGAAATAAAGCCTTCAGACAGATGCAGCTTCAGCTTTGCTAGTGGGACAGCTGTACTGGAACTCAGAGATGTGGCTAAAGCAGATTCGGGAGATTATGTGTGTAAAGCTTCAAATGTGGCTGGAAGTGACACTACCAAATCAAAAGTGACCATTAAAGGTACAGACACCTCAAAAGTATTATGCAGCTCAAGCCAGCAACCACTCATGTTTATTTGCTTATTATGATTTCCCTAGAAATGGAATTAGATTTTTAGAAATATCAGTTGTTGCTCATCTGCAATTTGTAGGCTCCTTATTATAATTGAAATATTAGGTAATTTAACAGAAATAATGTCAATACAAAGTATCTGAAATTACTACAAGTTTACCACCCTATTTCTTGAACTTCTTTTCACCATATCCATTAAGATGTAATTAACGCAGTTCCAAAAATGATGCTATAATAATGCGATAGAAAGTAGGCTGTTGTGATACACCTGGAAAAAATAAAACCAAGTCTAAAAATATTGACACTACTAATATGATTATAGTTCAACCTTTGATAGCTATCATTAGCATAAATGTCTGAGAAGCTGCTTTATCTTCTGTAACCCACCCTTACATAGAAAGAGAATTCTGCAGTACTTACTTATCAAACTGCCAACCTCCTAAGGCTTATTTTACAAAGGGGGATATGTATTGTAATTCTGAGGTGATTGTAGTAACAAAACATGTAAATGTTTTTTCAGACAAACCAGCTGTGGCCCCAGCAACCAAGAAAGCTGCGGTAGATGGAAGACTCTTTTTTGTGTCAGAACCTCAGAGTATCAGAGTCGTAGAAAGTAAGTGCACTTCATGAGAAGTACATCTTCATCTATCTTATACCTTTTACTTATGATTTAATTTTGGAAGAACTGATTTTAGAAAATTAAATTTTTATTCACTTGTTTTCATTATTCCTTAGAAACCACTGCGACCTTCATTGCAAAAGTTGGAGGTGACCCAATCCCAAATGTTAAATGGACAAAAGGGAAGTGGAGACAGCTGAACCAAGGAGGTCGTGTTTTCATCCACCAAAAAGGCGATGAAGCAAAACTGGAGATTAGGGACACCACAAAAACTGATTCTGGGTTATACCGATGCGTGGCATTTAACGAACATGGTGAAATTGAAAGTAATGTTAACTTACAGGTGGATGAAAGGAAGAAACAAGAGAAAATTGAAGGCGATCTTAGAGCAATGCTGAAAAAGTGAGTTCAATAAAAACCACAAATCGTACAATCAGCCCTCCATATAAGTGGGTTCCGCATCCACAGTCAACCAGCCCCAGTGGAAAGTATTAAAGAACAAAAAATTTAAAAATACAAATAAACAATACAGCATAACAACCATTTACACAGCACTTACATTGTATTAGATATTATAAGTAATCTAGAGATGAAGCATATGGGAGGATGTGCATAGGTTACATGCAAATACTATGCCATTTTGCATCAGGGACTTGAGCATCTGGCCACAGGCCTCCTGAAGCCAATCTCCCAGGCATAGAGAGGGATGACTGTAATGTCCCATTCACAAAAAGAATCTCTCAAGAGTCATGGGCCATCCATCTCAAGATTCAGATTGTTAAAGAACATAGGCATATAGACATTTTCACAGAAGCAGATAAGCAAATACACAACATCTGGGTGTTCTTGTTTCATTAGAATCAATTTCCGAATTTAAGAGAAAGTTTTAAGAATGAGGTGAATGTCTATTAAGATTTTTAAACAAAAAGAAATGGCCTATAAAGAAACCCCAGTATTGTCTGTGCCTAGGTATGAAACTTTTTTTCTATATATGATTTCTTATGTTATGAATGGTTCTCTAAAACAACTGTTTTAAACATTTTCCATAATTATCATTCATTTCAATATGGTTCATTTTTCAACATAATTATTAAATTAAATCCACACTCAATTTCCACACATCGTTTCCGTGATATGTATACTATTCTATTATTAAAGTTTTCCATTGCTATTATTATTTTTTCTGATATTATAATTCATTAGCTAGGCTCTTTGGTTATAAAGTTTACAGAAATACTTCTATTATCCTTTCCCTTCTTAAAATTTTCATTCCTACATCTATATTTTATTACAATGGTCCTAATCCATCTGATCTTAATCGACTCCATCTCCAAACCCACATTTTTAAATTGTTTCACAGCTAACATGGTAAAATTAATATTTATTGAATAAAGAACATAGAAAACCTTAATGAAGTATATAATCTTTGAATGATGATAGACAATTAAAAATAAGTAGAAGACAGGTGTTTTATCCTTACTTTTTAAATTTTATTTAGGACTCCAATCTTAAAGAAAGGAGCTGGAGAAGAAGAGGAAATTGATATCATGGAACTTCTCAAAAATGTTGATCCTAAAGAATATGAAAAATATGCCCGCATGTATGGAATCACTGACTTCCGAGGTCTTCTTCAAGCATTTGAACTGCTCAAGCAAAGCCAAGAAGAAGAGACACATAGACTGGTATGCTCCTTCATATATAGCATCATGCTAAAAAAGTCACATTTAAAACATCTCACATATTCCCTTTGAATTACCAGAATCCTATAGTTATATGACGTCATTTAATATGACCTAACCAGCATCCAGAATGGAAGCTGAATATAGTCATGCGTCCTCTAAATCAAATTTTGTTTCATCTGTAATGCCTATCATTTTTGTTCTTCTCAGGAAATTGAGGAAATAGAGAGGTCAGAGAGGGACGAAAAGGAATTTGAGGAACTTGTATCATTTATTCAGCAAAGACTGTCACAGACAGAGGTAAAAAGAATTATGTTGATAATAAAATGAACAAGTTATTATTGAGTATTATTATAAGGGAAGGAGTAACAAATGTGTTTTAATTCTTTATTCTCCTAGCCTGTCACTCTGATCAAGGACATTGAAAATCAGACAGTTTTGAAAGATAATGATGCTGTCTTTGAAATTGACATTAAAATTAATTATCCAGAAATCAAGCTTTCGTGGTACAAAGGAACTGAAAAACTGGAACCCAGTGATAAATTTGAAATAAGCATTGATGGTGACCGACATACACTCAGAGTCAAAAACTGTCAACTTAAAGACCAGGGCAATTATCGATTGGTTTGTGGTCCACACATCGCTAGCGCTAAACTAACTGTAATTGGTAAGTTAGAAAAGGCTTATGAAATACTTGTGAGATTTAAATTACTGTTGAGCACATCTGCGTGTGATATTGAACAAAATGCGTGTTGTATCACATGAACAGAGCCTGCATGGGAACGGCATCTTCAGGATGTGACTCTGAAAGAAGGCCAGACTTGCACCATGACATGCCAATTTTCTGTACCAAATGTAAAATCTGAATGGTTCAGAAATGGCAGAATCCTTAAACCCCAAGGTAGACATAAAACAGAAGTGGAACACAAAGTCCATAAATTGACCATTGCAGATGTTCGAGCAGAAGACCAGGGTCAGTACACCTGCAAATATGAAGACCTTGAAACTTCAGCAGAACTCAGAATCGAAGGTGCGTGAAACACTATGGAGTCCTTGTGGGTACAGCATAGGTCAATGGCAAATGTTGTGCAGGACCCCTGCAACCCTACCTGTAGACACACACCAAAGTGGTCATGTGTTCTTATTTCCCAACACACGTTCTCATAGTATTCATCTCAAAGTTCATACAAAAGCACAAGGGAAATATTCAAATGAGTGTCAGTTCTTTTGCATCGTTCTTTTAGATTTTAATCTAGTCTAAGACATAATCTTTAACAGTTATTTCTGTCTAAAGTCTAAATTTCATGATTCTCATATCTAGGATTGTAGAAAGAAAGCTAGGAAAGGACAAGATCTCATAGATGTAAATCTGGAGGATCTTGGCTAGGAATTGATATTTTGTTTATAGGACTTAGTCTGACTTTCTCTGTACAAAATTATATAGATAACATAAACATGTCATGTGCAATTAGCAACTATTTTTCAAAAATATTTATTTCATTTTCAGATCATGTTTCAACCTTCTGAATCTCTGAAATTAAGTGAAATCTCAGAATTTAGGAGTAACAACATTCATTTCCTAATTGATTATACACATTTTCCAAAGACACCCTCAAACTGTATTGAGAAAAATTTTGGCTATGATAATAGCATCTGCTTTCAGCTATTGGTGCCCATTCGTAGTTGCTGAAACACAAATATATGACATTGGATTTACATAAGCATGTCAACTTTTCTGACTTACCTTACAATGAATATCAGTGACTGGTTGTATTTTAAATGGTTTTCAAATTAAAGGGCCAGCTGCAAGTACTAATTATTTTTTAAATAATTGATATTTTTAATATAATTCTTTAGTAAATAGAGCTCACCAGAGTACTGTGATTTCTAAGACTTTATGGTACTGTTATACATATAAGACCCTCCCCTCCAGCCTCTTCTAGAAAGCACTCCTGCCATCCACACACATACTTTGTTTGTGCCCATATGTACTTAGCAGATTTCTGAACTCTAAAATTTTTCTTTTTGAAATTTAGAAGTGCAGATTTCCGATTGCGTTTGAAATTATTTTACAGGAAAAGTTATACATATTAGATAAACAATTATAGATCCTGAATAGCAAAAATTATTTTACTGAGGCAAGAAAGAATTTCACAGAGGAATAAGTTGTAGAGTACAATCAAGTTTGTGTTCCCTAACACTTTTAAAATTTAATTTGACTTTGGGTCATTAGCTCTCTTTAGTATGTTCTTTATATAAATATTTTAAGAACTCACAATAATTTCTTTACACTTTGCTACATTCGACCAGCATGAATACACTTAAGAATTGGGATACTTTTTTGTTAGTGATGCAAAGAAGAGTGCATTTCTTCTCATTTTGGATTTTTGAACTTTTCTTGCTATTTTATAACTGGGTACAAAGATGGAGATTTTAAGTATCTGAGGTAAAAGCAAGTAAAAGAAATTCCTCTCTATATAATCTAACTTTGAACCCTCTTTGTACTTAAACAGCTGAACCAATTCAGTTTACAAAGCGCATACAGAACATCGTGGTGAGTGAGCATCAGTCTGCCACCTTTGAGTGTGAAGTGTCCTTTGATGATGCCATTGTAACATGGTACAAAGGACCAACAGAACTGACAGAGAGCCAGAAATACAACTTCAGGAATGATGGCCGCTGCCATTATATGACCATCCACAATGTGACCCCAGACGATGAAGGTGATTTCATTGACAGTTTTCCAGTGAATGTATAATTTAAGCCTCGTCTGTTTTCTGTATTTCTACCCTGTATGCGCTCATGCTCTCATTCTATCTAGAATGCTTTTTTAGAAAAGACAAGTGTAAATAAACACATACGTATATTGAAGTAAAGAAGTGTTATTTGCAACATATCAGAAAACAAAAGTTGGATGATTTTTCACCCTAGGTGTCTACTCGGTCATCGCTCGGCTGGAGCCAAGAGGTGAAGCAAGAAGCACGGCAGAGCTGTACCTAACGACGAAAGGTGAGGTAGCGCCATCAGAAAGCCACCCTGCCATCTTCGAAACACGTAGCCTACCTATACCATTCTGAACACAAAAATATCATTTTTTTTTTATTTTGCAGAAATCAAACTTGAGCTGAAGCCTCCTGGTAAGTTGTTTTGTAAAAATCAATCCTTGCTTACAATAAATTTGGCATAATTTTGTAAATCACAGAAGCCAAACTAAAATGTATAAGATATCTTTCTCTTTTGGGTAAAATATTTTTCAATAAAACTGTTATGCAGTAGAATTACTTTCAGTCAAATAATAAAATGTTAAACCTTGTGAGTCTGGCAAATTAGAGATAATAAGGTCTCACTCAGCTGATGCTAGAATCATGTTAAATAGAATAGCCACAGAATGAAACAAATTTTGACAGTGAACAAAACTTACCTGCGTGGTTGCATACAAAAGAATACTAATATTATTTTGTCTGTATATTAGATTCTGCCATTAGATATGCCTGACATATCTCAGGATCTAATAAATCAAACACACCTTAGTTTTCTAATAAATAGCTTGTTCTCAGTCTCTCTATGCTTATTACATGTCCCTTTCCAGATATTCCTGACTCCAGAGTTCCAATCCCAACCATGCCTATCAGAGCAGTGCCACCAGAAGGTAAGACCCAGAACCTCAACATCTGAGCTTGGAGCAGCAATATTCTAGCACTAGGAATCTGTACGAAATTTTATACCAGCGACCAAACTGCAGCAGAGTCAGAACAAAACCTTCCATGTCATATTCTTCAGTGAGCAATTAGAAATTAAAGTAAAAAAAAAAAGTAGTTCCAGTTATAAATAAATGCTACTTTTATTTGTTCCGACTGATGAATTCGTACTATAATACCTATGAAGTACTGAAAGAAATGCATGAGACTTTTCATTATATTTTACGCAAAATAAGAAACTAAAACATGTTACTAACGGCATTTATTTTCTTCAGAAATCCCTCCTGTGGTTGCTCCTCCTATCCCCCTTTTGCTACCAACACCCGAAGAAAAGAAACCACCACCAAAACGTATTGAAGGTATTATACCTCATCTACCTAGATGTCGAAATAAGAATTTCACTCTGCTGACCCGAAAAATGTTGCTTAATACAACGCATTGGCCCTCTAGTGGTCAAGAGGTGGAATTGCCTTTCAAAATGTAAATTACTTTCTCAAAGTATTAGCTAACTAAATGTGTAAGTTATGTGCTTAAAACTCTGAAAATCATCAAACAAAATACTATTTTGGTATTAAAATATTTTATTTTAATGAAATTACTGAAACATTAATAGAGAACTAATTTAATGTTTCATATTTTCCTAACTACTATGTATAACAAAAAGAATAATGGAACCAATTTCTAGTGCAGCTTATAGAAATAAACCATAGTAGTTTACAGCCAAATTGCAAATTATAGCTTGTGGCTTTTCTCAATTTATAGTATTAACTACTCTTAAAAATTTACTATTTTGTCACATAAAATATGATTTAGAATACTTATGAAATATTTGACTTCTTTTGTACCTAAGGCATGATCTCACCAATAAAGAGATCTTAAGTGTTCCAAGGAATTGCTCCTCTCAAATACTCAGTAGAGAAGTTGTAGTATTTGTGTCCCAAAGCTTCTCAACTAAATTAGACAACAGATTTCCTGGGACTTTCTGGAGTTATAGGGAGTTCAGAAATGCTGTCAGAATTCTCCCAGCATGGTCAGAAAAAATTCTGTATGTCAAAATCACATTTTTCTATAGCTAAGTCACTACTACTGTATTAGATTCAAGGGGTGGAAATGGTAGGCCCTTAACACCCGCTATAATTGGCATTAAACGCTTGACCTATTTTTCAGCCAGCCTTAGAGGAAATTCAATTAGAAACTTCCAATTTTGTGACTAATGCAACCTCATTAACAAAGAGAAGCATTTTTATGATTCATACGAACATAAGCATTTTATCTAGCTGTGAGAACAGAGAGGAACAAGAATCAACAATCATAAATTGGATTTCCATTTCTATTTCTGTTGTCAAAAATAATAACTTATGTTAATGAATGATTTGTTCTTTGACTGGTAGTATCAACATGGCTAAGTTTGGTACTCACTGTGAAACTTGAGAAGTTAAATAATGTTTTAAAAATTAAAAAAGAGGCCTGGCGCGGTGGCTCACGCTTGTAATCCCAGCACTTTGGGAGGCCGAGGTGGGCGGATCACGAGGTCAGGAGATCGAGACCACGATGAAACCGCGTCTCTACTAAAAATACAAAAAATTAGCCGGGCGTGGTGGTGGGCACCTGTAGTCCCAGCTACTCAGAGAGGCTGAGGCAGGAGAATGGCGTGAACCCGGGAGGCGGAGCTTGCAATGAGCCGAGATCGAGCCACTGCACTCCAGCCTGGGTGACAGAGTGAGACTCCGTCTCAAAAAAAAAAAAAAAAAAAAATTAAAAAAGAGTGGGCTGGGCGCGGTGGCTCACGCCTGTAATCCCAGCACTTTGGGAGGCCGAGGCGGGCGGATCACAAGGTCAGGAGATCGAGACCATCTTGGCTAACACGGTGAAACCCCGTCTCTACTAAAAATACAAAAAATTAGCCGGGCGCGGTGGCGGGCGCCTGTAGTCCCAGCTACTCGGGAGGCTGAGGCAGGAGAATGGTGTGGACCTGGGAGGCGGAGCTTGCAGTGAGCCGAGATTGCGCCACTGCAATCCGGCCTGGGCTAAACAGCGGGACTCCGTCTCAAAAAAAAAAAAAAAAAAAAAAAAAAAAAAAAAAAAAAAAAAAAAAGAGTGTTATTTATTCATGAATACAAAAGGCCATAATCAAGTATGATTAGGAACCGTGGTTAAGGTATAACAGCTGCACAACAAAGGACTTTAAACCCACTTGTTACTCTTCCTCCTAACATATTTGTGTTCGTCCCTAAGGATGAAGCAAAGATGAAAATGTGTACTTTACTATTTATGATATCACTTAGATTCACACTCCATGTTCTGAAAACTTTAACTCTCAGCAGACATAAAATCAGTGAAGATGTAAGATCACAGTACATTTTCTATATCCCTCCAAAACAATTTTTTTGCATCTAGTCCTAGATCTTTCCAAAACAAATATCTTGTAGTAATATGCAGAATCTCGCTACTATCAACATATGGAAAAATAAAATATTTCAATAAAATTCCTAGTTTCCTGAAAGCATTTTAGTTACTTACACCAGAAATATTTTTTCTTTTTTTTTCTTTTTTTTTTTTTTTAGTTACCAAAAAGGCTGTGAAGAAAGATGCCAAAAAAGTTGTTGCAAAGCCCAAAGAGATGACACCACGTGAAGGTATTATAATTAATCAAAAAGCAGTCTTAACACTTTTTTCTTGGCCAAAACTTTTAAATTCTAAACAGTGGAGGGTGAAGGAAGGGTAAGAGTTTGCAATCACAAAATGGTACCTCTCCCTTCACTCACTTTCGCCCTCGTCTTTGACTCAGTCCTCACTCTCTCAACTCCTTTTTTCCCCCTTTTCTCTTTCCTGTCCTCCTGAGCCCCTGGGAACCAATGACAACACCAGTGTATTCTGGTTATTTCTGGATGAAAATTTAAAGAAGGTCTTGCCCAGAAATCCAACAGCTATTCTTTTTTTTTCTTTTTTATTTTATTGTAAATTGACTATTTACTATTGTGTATATATTTATGGGGTACAAAGTGATGTTATGATCTGTGAATACAATATGGAATAATTAAATCAAGCCAATTAACATATCCATCACCTCAAATACTTAACATTTTTGTGGTGAGAATATTTGAAATTTACTCTTAGCGATTTTGAAATGTACAGTACACTATTATTAACTATATTCACCACTCTGTGCAACAGATCTCAAGAAAAGCCATGTTTCTTCTGTCTAAGATTTTGTACCCTTTGACCAACATTTCCCCATTCCCTCAAATCCCCAGCCTCTGTAACCATCATTCTACTCTTTATGAATTCAACTTTTTTAGTTCCACATCTAAGTGAGAACTTACAGTCTTTGTCTTTCTGTGCCTGGCTTATTTCACTTAGCATAATCTCCAGTTCTATCCATGTTGTCACAAATGACAAAATTCCCTTTTTTTATAAGGCTGAATAGTATTCCATTGTGTATTTATATACCACCTTTTCCTTATGTATTCATCCATTGATGGACACTTAGGGTGTTTCCATAACTTGGTCTTTGTGAATAATGCTGCAATGAACATGGAAGTACCCAACAGCTGGTCTTGATAAAGTCACATCAATGTAAGATCAAGGGTTGCTGCTAATTTTAAGAGGTTGCTGCAACCCACCTCAGTATCTTTCCTGATTTAGGTGATCTAAATATCAATATTTGAAGAAAAAATACTTTATGAAGGAGGATCAATTCAAATCACTTTAACTTTCAATATATCCTCGAAGATTTTTAGGAAAACAGTTGGATAACTAAATTTAAACAAATAGTTTTAACTCATTTGACTAAGATTAGAGTACAGCAACCTCCATAAAGAAGGAAAATATGGAAACACAAGGCATCATTCATCATTCAGACTTTTCTGAGTGGTCATTTGTGAAACATCATGGAATAAGAGGACACTCAAAAAGCATGGATATTTCATGAACTTCATAGTTAATAATTGAAAAAGTCTAATGTGTTATTTTTAGCATTGGACATATTAAACATTCTCTTCATGCTTAATGTTAACTTATTAGAAATCAATCTAAACTAGAACCAATTTAAATGATCTTAAATCAATCTAAACTAGAATCAAACTTTGGCCTTTTGCATGTTTGATTTTTGTTAATATGGCCTTGCATAGCATTTCTAATGAGCTAGATTTGGAAATTATAGAAGCATTATTATGATTCCTGGAAGGGCTGGTGTATGAGTAGTAGTCATAGCTCCTACAAACAACTAACAATGATGTGGAGGATTAGTAAACATTAATAATAATGTAATCTAAAAATAAACACACATTTTTATGTTTTTAAACTCCCAGAGATTGTCAAGAAGCCTCCACCTCCTACTACCTTAATTCCAGCAAAAGGTAAATAAAGATAAATTATTTTTATTCTGTTTATTCCTGAGATTTGCACTTCTGCTAACTATTCTTATTTTAAATATTAGGCTTCCAACTTATTGAAAGTTGTGGAGTCTCCTCTGCTGTGTTAAATTTAGCATTAGAAATGATGGCTATTTCATATTGCCCCTTTCCCAGGAAAACAAACCCAGGCAGATGTTTATGCTGCCTCTGTGCAATGGTCTCAGAGAAAGAAGAAGTGAGGGCTAGAAAGGAAGGGCCATTCCTTATTTTTTTATTGTAGTTAACACAAATGTTAAGAGTCATATAAATAATGAGAGCCCTTAAGAACTTTAAAAATCTGTTATCTAAAAGTACCTAATTAACTTGGTTACATAATTTTAAATGTTGTTTTTATGAAACTGACTAAGGGATCATATGCAATAGTCAAAAACCTAGGTTTAAAATTAGAAATGTTTTTGAAATAATAATCAGAACTTTTTAAAAAGGTTAACTGTATAAATATGAAATATAAATTCCATGAACTTATCGAATATTAAAACTATTCCACTGGAAGAAACTAGGGGTTCTGCAAACTGGAGCTCTCATGGAATAATAGAAGGTGTGTCCATTTGATAATATTTATTGAATCCATTTTTTCATACTGGAAAAATCCTCAAATCAAGAGTAGAATGCATCTTGATACTCTACTATGTTCCATAGTCAAAAATTTAAATGGAACCAATACAAAAAAAAAAAACAAATTATCAATAAAATAGATCTGAAATACTGATGTTGTTTAACTAGGTAGATTTTTGTTTAGTGAAGCAGTTGGATGGATAGAATTAATATGCTAATAGTATCTTTATCTATTTTAGCTCCTGAAATCATTGATGTATCCTCTAAAGCTGAAGAAGTAAAAATAATGACTATAACCAGAAAGAAAGAGGTTCAGAAAGAAAAAGAAGCTGTGTATGAGAAAAAGCAAGCAGTCCACAAGGAGAAGAGAGTCTTCATTGAATCTTTCGAAGAACCTTATGACGAACTGGAGGTAGAACCATACACAGAGCCATTTGAACAACCTTATTATGAAGAACCAGATGAAGACTATGAAGAGATTAAGGTAGAAGCTAAAAAAGAAGTTCACGAGGAATGGGAAGAAGATTTTGAAGAAGGGCAAGAATACTATGAAAGGGAAGAAGGCTATGACGAAGGGGAGGAAGAGTGGGAAGAGGCTTACCAAGAAAGGGAAGTAATTCAAGTTCAAAAGGAGGTCTATGAAGGTATGTATAAACTGAATGACTTGTTTCCCTCTTTTCTTCATTTTTGCTCAGTTCATTAAATTTTCAATGCTATGAACCTGATTTGCAGTTTATGTGAAATAGTTAAAATGATCTTAGATTTTTTTAAGGTTAGAAATCTTTTAAAAGTTATTTTCCTCAGAGTTACTTTCATGCTTTGACATTACAAGCTAAATCATTTAGTCTTATTACTAACACTAAATTCCAAGTGCTAATTTCTAATGCAGAAGTTCAAGTTTTACTTTTACTGCCTTGTTGCATCTCTGCTTGATCCTGCTTCAAATCCTAGCACTAAGAATTGTGTTGGTAATAACGATCCCAAATATAATACTTCACACGATTATATATTATCCTTACCTTATCTCATTTGCAATTAACAACCTAAGAGAACTTACCTATTTAAGCATCCCTTCTTATTCCTGTGTTTTTATTTCAGAATCACATGAGAGAAAAGTTCCAGCCAAAGTACCTGAAAAGAAAGCACCACCACCTCCTAAAGGTAAGTAATTAGAAATATTTAAATAGACTAGAGCATCAACATCATTATCATGGCTTGTTTGGCAGCAATGTATAAATCAGCAGTTCAATCCAATAGGCACAACTTCTTCTCTAAGCTTTATTGTGAATGATTTTTTTTTCTTAAAATTTCTATCTAATTGATTTCATTAAAAAATCAAAAGATGATAAAAATTGTAATGGTAAACTTAAATATAACCAAAATATGTTAAGTACAGAAACTTGTACCCAGAGTTCAAAGTTGTGCGTAAAGGTCAAAGAAAAAAAAACCGAACTCATCTCTCTCTTTAAAAAATGATACATGTATCTGCATATACACTTATAGGTGTGTATAAACACATATACACAGAGAGAGAGAGATAGAGAGAGAGAGAATTTTAATAGGAATTCTAAAAGTACTGCAATTTCTCTAAAATGCTTGCAGTTATAAAGAAGCCAGTAATTGAAAAAATTGAAAAGACTTCTCGAAGAATGGAGGAAGAAAAAGTTCAAGTCACCAAAGGTATTATTTAAAACATTCCTAGCACCCATGTACACAAGTAATATGTTTACTGATCTATACTCACATTAGTTATTTATATAATCAAATACTTTTAAATTTTGTGCAAAGCAATATTCTTCAAAATACAAATATATTTGTACATATTTTTAAAGTACCTGAAGTTTCAAAGAAGATTGTTCCACAAAAACCTTCCCGGACTCCAGTACAGGAAGAAGTTATTGAAGTGAAAGGTATACATCTTTGTGTTTCAGCTACAAGTTCAAAATTTTTTTATTTATGTGTATGGACATGTGTACATATATTGCTAAGTAACTCACAAATCTGAAACGACCAAAAACAGCACATTTTTACATAATACAAATTTTATGTTGAGTTGCACATATGTTTAATTTAAATAGTAACATTATCTACTTTGTTTCTAGTTCTGCTTAAAAATTACATTTTTTTATTATAAAGAAGGTTTGTGTTTAATTAGTAGTTTGCTAACTTCACTATGCAATGCATTCCATTGCATATAATATTCCCTGTCCTCTTATTTATAGAAATAGACCCTAACAGATTTGGAAAAGCACAACATTGTGTGTGAAGAAGTTGTGTCTATTTGATTCTCATTTAAGAATGTTTGATGAAGGCTGCATGCATTGTTTGTCCCTATAGATCAAAACATGATTTGTTTTCTTGTCAATACTGAATTTGTTCTCAAGCTACCATATTAACCCACTCATTCTGTGTCTAAATACTTGAGTATAAAATCCATGTGTTTGATCTGATGTCTTGTACTAAAAAAAAGGAATACTAATGTGAAATACTCTCTTTAAAGTACCAGCTGTGCATACAAAGAAGATGGTTATTTCAGAAGAAAAGATGTTCTTTGCTTCTCACACAGAGGAGGAGGTGTCAGTCACAGGTATAAGGCAAACTGGAATGTGGGGGCTCAAATGGAAGGGTTTTAGGCAGATTTTTATCCCTCTTGTTGTCTAATTTGTGATCGTGTAGACATTTCTGTCTCCTTGTAAATTCTGTCATCTTTTTCATTTCATGTTTGTCTCTGTTTTCATTTTTATTTTAATGTTCTTTGTAAATTACAATTACCACCCACAACATGGCATATCAGTAATTAAAATGTACATTTTTTTAAGTCCCCGAGGTACAAAAGGAAATTGTTACTGAAGAGAAAATTCACGTTGCCATTTCCAAAAGGGTTGAACCACCACCTAAAGGTATTAGTAATTCATTCTAAGTTTAAACTCTTTTAATAAAAATTAGTACAAATACCATAGTAAAACATTTATGTTAGTATTAAATAATAGATTTAGTCACAGTGTGCATACCTATAGCCACTATGTACAAAGGATGTGATGGGGGACGGGAAGAACCATGAGGAAGGCACAGGGGGAAAAAAGTGAAAATTATGGGAGGCTCCATTCCCTGCTTCAGAGAGTTTGCAATCTCGTAACCTGTTACTTGGAAATACAGTGTCCTGGAGCCAGTTCATGCTAGCTCACCAGAGCCTATGGTTACATTTTCAGGAATTTTGCCAGTCAGTAGTTTAACACCACCATTATTAAAAATTAGATTATGTAAATTTACAGTCCAATAAAGTATATTTTTAAATATTAATAAATACTCAAAACTCCTATTTTACTGCATTTTGTTCTTATCTGTGTTTCTGAGATTGTTTCCATCTTTGTGTCTGTGTGGTGGAAATGCCATATAATGTACTACTGCACATCTCTTTCCAACTCCAGGACAATGACATCACCTTGACAGCCAGGGTGGGAGGGAGTGTTTATACCACCTTGGAAATCGGAAATCTGCAAGCACTATAGATCAAGGCTCCACCCCCTCCATCCCACCCAAATTGTTAAACATTTAAGACACAAAAAAATCTAATGCAATTGTATTTATGAAACTGCTTTATAAAAGTAAAGGTTACAAAAAAAAAAACTAACTTCATAGTTATCGATGTTCATAAAAAGCTGGTTTCTGAGGAACTGACACAGGCACCTCCGAGGGAGGATTGCTCCTACCTGTTCCTGACAAAGTAGAGGCTTCTGCAGTTAAAGGTGACAGCAGTCACATTTTCTAATTAGCCATTCAGCCATCTTCATTTACTCTCATTTCTAAAGCATAATTTTCTTGCATTCAGTTGGTATAAAAAGGGAATCTCTATTTAATTCTAAGTCTTACAACAACATATGCCTTGTCAAATGCACACTTTCTCAAAAATGGCACTTTTCTTTTAAAGTCCCTGAGCTACCTGAGAAACCAGCTCCAGAAGAAGTGGCCCCTGTTCCTATCCCTAAAAAAGTGGAGCCCCCAGCACCAAAAGGTAGAATAATATTTGTGAAAAAAATAATTCTTAGCATCCATCTTGTATCTTTTTCTATAAGATCTGTGTATTAACAAAATAGCATCTGTAAACCATCTATAATATATTTAATTCTGTGTATATTGATTTCATTTATTTGTGGTGATGTGTTATACAAGTATTGGTAACATTTCTAAACTCCAGATCACGCTAACTGGGTCTTTGTCTGCTTGTGTAATGTATGTAATGTCTATATGGTGTTGAGGTATTTAGCTTTCATTTCTACCACAAGTAGGCATATTTAAATTACTTCCTAATTCTCACACTGTTAGTGAAGATTTATGCTTTAATGTAATCTTAGATGTCTCAGAAGGTGACTAGAATATTCCACATTATTTCAACAATTGTATCTTTAAAGTTCCTGAGGTTCCCAAGAAACCCGTGCCAGAGGAGAAAAAGCCAGTTCCTGTGCCTAAGAAGGAACCTGCTGCTCCCCCAAAAGGTACGCCAGAGCCAATGATGGGGAGACTCTTTGCTCCAAGTGCCAGCCTTTTGCTTTCTACGATCTTCATATGTACTATGCTGCCTTTGTCTTTTGTCTCTTTTACATTCTTCTTGTGTTTTTACTGTTTGTCAGCTTCCGTGCCATGCTCTTGACATACTTTATTTATTATACTGAATATTCCTAAGACATCACCAAAAAGTATTGTTAAAGGAAGTAACTATGTCAAACTGCTATCTTACATTTTTAATATCTTCCCTCTTTTAGAGAAAGAGGAAATGTTTGTGAAACTTGTTTTCTACTGACATGTTTCTAGGAAAAAACCTTTCATCCTTCATAAATGTAACTTTTTCTTAATAAAAGCAGTTTCATGCATTATGAAGAGGTGGAGACAGGCAATGACAACTGGAGAGTGTCTGGCAGAACTGAATGTTAATTACATAAAGACGTACATAGTACCACGCTTCTTAAAAGTCAATAGTGGCGAGTCTTCAATAGTGGGGAACATACAGATTTTTTGAAGTTTACTTTCACCATTTTCTTGAGACCTTAACTGAGCTTCAGTATTTGCCATAAATGTTTCCGTTATCTAATTAGCTAGTCAAAGTACCTTTCACAGAGGTATGTTTGAATGAAAATGTGCTGCTGTGGTATATCACAAATCCCTTGCTTTGGTTTGTTTGGGATTTTTTTGGCGATAAAAGGCACTATCTTATTGAAGCACTGAAGCTACAATTGCACGCATCCATTCAGTTATAGAGAGACTCAGCAAGAATTCAACATTATCCAATTTAGGAGAAACCAGACCTAACTAAAATAGTACATTTTGAATAGTGTTCCCTTGGCCTGACTTTGCAATGTTTCTATTTTCTTCCTGAATCAAATATGCTTCTCTCTTTCTCAAACTCTTGGCTCTTTCAAAATTCTTTTGATTATCTAACCATTAAATACAAAGGTCATGTTAGTAAAACCAATACTAATACTAAAGCTACTTGAGACAGATCGTCTTAGATAAATTAAATCCATTGTTATTATGTACTACATTTCCCCATACAAAGCATAAAGAACCTTTTCTATATACTATCTGAACATTCTTGACTGTTTGTGTAATCACTAATTCGTTTTCAGCAAAGTCATATATGTCTTCTAAAGGAGACACAGAGGCATCTCTCATTTACTCATAAAAACAAATACACATAGTATAATAGCACGTATATATATATAAATACTGCATGTATATATAGCATAACATATACATATATAAATTAACAGCTATATAATTGCACCAAAATATTACAAATGCACGTGCAGAGGTGCAGGGATTCACAAAAGCTGCCAATATTGTATTTAAAATGAGAACAATTATTGCCAATAATGCATGCTGTTAAAATTCATCTTCCAATTAAAAAGTCAACATTATCCATTCTTAGAATAGATAAATCAAATACACTGTAAACATTTTTTAGGTTGAAAACCCTGTTCAAAACTCTAGAGCCCCTTAGAAAAAAAAAGCACAAATACACATACCCACAAAATTCTGCACACAAAGCTCTGTAAAGTCATTAACACATGGGTATCAGATTGAGAGACCTACTCTAGAGTGTTTCCTGAGTTTTGAATTCACTACAGGCACACCCCCCAAAAATGAGAGGAGAAATGTGGGGAAGAGAAGTAAGTTACACATATTCAACTATTCTAAGACTTCTTAGTCTTAGTCTAAAATAGTCTTAGATAAACTAAAGCCATTGTTATTAAGTACTCCATTTCTCAATACAAAGCGTAAAGAAGTTTTCTATATACCATATCCACATTCTTGATTGTTTGTGTCATCACTAATTTGTTTTTAGCAAGGTCATACAATATATAAAGGATGAATTCTGTGCACAACTTTGTTACATAACTCATTTTTGCCTAAATGCCTCTAAAACATTATTTGTGATATTTATCACATTGTGATCCTTGGAATAGTATAGTTAGTTTAATTTTCTGGATAATTTTGCTGATGCATAGATAATCCATAACAACATTAATGTACTACATAAAGATTTGTGCATGTGCCTATGTTCTTTCATAAAAGTGATATATGTCTGAACTAACATTGTGTTTCAAAAACTTTAAGTCCCAGAGGTGCCAAAGAAACCTGTCCCTGAAGAAAAGATTCCCGTTCCTGTTGCAAAGAAAAAGGAAGCTCCCCCAGCTAAAGGTACAGTGGCTTTCGACGTAAAGCCCTATCTTTTATCTTTGATACAAAATATGTTGTGTTTAATTATCTGTTCATTGAGTTAGTTTAATTCTAAATGAATGTTTTGTGGTGAGAACTGAACAAAAGTGTCTGTCCACCCGTCTGCTTTCTTAAAAAAAATAACTGTGCATAGCTACTTTAGAAAATATAAAGTCAATTCTAAAAATGTCTCTTCAAGTTCCTGAAGTACAGAAGGGAGTTGTGACAGAAGAAAAAATAACCATTGTAACTCAAAGAGAGGAATCTCCACCACCAGCAGGTACTTAATCCCATCTCCATGAAATAACCTTGTCTTTCCTTCAAGCCTCTTTAATTGCATGTCTTCTTTAATTGCCACTTCTATGTTGCTCATTTATTTGGCCTTTTTGACAAATTTTAAAATTCAATACTATCCTTTAAGTGCCAGAAATACCAAAGAAGAAAGTTCCTGAAGAAAGGAAACCTGTTCCTCGGAAGGAGGAAGAAGTTCCACCACCACCAAAAGGTATTGTTTCTCCATCTTCCCAAGAACTGTCTTTATGTTCCAGTGATTTTGTTAGTTTTGTGATATGAGTGCACTGTGGGTGTATTTCTTTGTTTTGCACTGGGCTTCAATGAGATCACATTAAATTTCTAAAAGTGCATAATGTCTCTAAAGTGCCAGCTCTGCCTAAGAAACCCGTCCCAGAGGAGAAAGTTGCAGTGCCAGTTCCTGTCGCTAAGAAAGCTCCTCCTCCCCGAGGTAGGATTTGCCTCAATCCTCTGACAAAAAAAAAAAAAAAAAAAAAAAATCTTCGAGTGTGTTAAATTCTTGCTTTTTCCATCTGGTCTGTGCTTATACTGATCCATTGTCTCACTTGCAGTGAAACTTTTGTGTTTATGTCCTTGTGATATGTAACTTGTTTTCCCATTTTGCTAGTCAAAGTGGTGTACTGTGCAACTCTTCCCCAAATTCTAGAAAGTGAGAATTGTTAAAATTCTTGATTTTAAACTTCAACTTTAACACTTTCTTAAAGCTGAAGTCTCTAAGAAAACTGTTGTAGAAGAAAAGAGATTTGTTGCTGAAGAAAAACTATCCTTCGCAGTTCCTCAAAGAGTGGAAGTCACGCGGCACGAAGGTATATAATCGGAAGTCAGGGGATAAATGAGTTTGTGTGTGTTTCCTCAAAGTCTCTTCTTCTTCCACATGTGATTGTTTACTTTAGAACATGTCCTCATCAGTTATTTCTCCTTATGTTGGTATTAGAATGTGTCTACCTTTTGTAGCCTTCTGGGACTGAGTCTTTTGTGTCTATGTTGGCCTTGAATCATTCGAAGGAAGTGGATGAGTCCCGAAAATGTTATAATTTTGAAAGTGGCCACACTTGGACATAACTCAAGTATCATTCTCAGTCTTGGGCTGTACTTGCCCTCATCTTAAATTAGCTTCCTCCTTCTTATAGTGAGGAAGTACCATGAAGCTATGTCCTAAGCAGATAGAAGAACAGTTATCCATCTGTAGTGACCACATGGCTGTATATACATCTGTATCTCAGCAGGCTGAATTTAAATGAAACCTTATCTTTTAAAGTATCTGCAGAGGAGGAATGGAGTTACTCAGAAGAGGAGGAAGGTGTGTCCATTTCAGTTTATAGAGAAGAAGAAAGAGAGGAGGAGGAAGAAGCAGAGGTTACAGAATATGAAGGTAAACAATGCAAATAAGCTAGAGATGATCTGGGGTTTTGATGAGGTGTTTTCTTTCACAAATTGTCTACAGACCAATGAAAAGAGACAGAAAAAAGTGACACAAATTCAGTGAACATCTACCAGTCTCATTAAATGAATATTTTGATCAAAACACAAGATTCAGGAGGATTATACTAGATTAGAGAAATCCAGTGTATTTCTTCTGCATCCCTTCTTACTTGCCTACATAGAATAAAAGAGGCTTCATATTTATATATAATTAATCAGGGCAGGTATCTCCATATACATATATCCTTTCATTAAACAGGACTTGGCTTCAGCATGGTGGGCTGGCATAAGCTTTACCTTAGTAGCCTAATGCCTAATTGGTGTTTCTCAAACATTGCTTGTACCACAATCCACAGACAGAAATATATTTTATATTATAATCCTTTAATTTTTTTATTCTAGGCATTTAAAAAATACAAGTTATAATCCATTAAGTCAATTGCAGAAGTCACTATAATGTCTTAAAATGTTTTAAAATGAGCAAGAAAATATATTACCTCATTACATTCCAGGAGTCAATGCCATATTTGTGAGTCTGAAGCCCTGAACACATAAGGCTTTCCTGTATTTTACATATGGAGAAAACCATTGTGTTATATATGGGATCAGACTGACTTGTTACTCAGATCTTTTCATACCTATAATGCTAATTATCTATAGTTTCTTAAGGACAGAACCAACAAACTATTCCATTGGGATATTTTTTCAATGAATTAAGGCAGCACCAGGTTTCCAACTAAAATCCAGCATTCTGGCTAGAGCCATGTGGCCAAAAGAACTTTCCTAAGAAAGTTCCTAAGGTCTGCTTTTAAAGAGAAATCAATAAGCTCCTTAACCAAACTAACTCTCTCCCCAGTGAGAAGATGAGTAGAATTGAAGTACATTTAGATGTCCCAAGTATCTGTTTTTATCTGTCTAATAAAAGATGGCACACCATGCCCCTTTTTTCACTTGGAACAAAAGCCCATGTAAAAATCCAAGGTGCCATAGTCTTAGTGGAATGCCTTGGAATAGGCCAAGATGGGACATGACTCCCAGGAGGAAATCCATTAACTCTGTTGTGCTTCCTGGAAGAGGCCATGATGGTGGACATAAGTCAGGAAGCTGGTAGATTTGAAGACGACTCCATCTTTTCTAAAAGTGTTTGTAAAACCAAACATAGTCTGATTTCAACTTTTGACACTATAAACTTCCTGTAGTACTCCAGACTCTAGTTAAAAGGAGAAACACTGTGATTATTTTTATGTTCTCATTATGCCCCAAAGATGGGTGGCTTGTTAGGTTTACTTTCAGCGTAAGGAGCAGATATGTTTTTAACCAGACACTTCTATTCCTTATTTAACTTTGACCAGGCATGGTGGCTCATGCCTATAATCCCAGTGCTTTGGGAGGCTGAGAAGGGAGGATTGCTTGAGCACAGGAGTTCAAGACCAGCCTATGCAACATAGCAAGCCCCATTCTACAAAAATTAAAAAAACAGCTAGGCATGGTGGCATGCACCTCTAGTCCCAGCTACTCAGGAGGCTGATGCAGGAGGATCATTTGAACCCAGGAGTTCGAGGTTACAGTGAGCTGTGATTACACCACTGCATTTTAGCCTGGGCAACAAAGCAAGACATTGTCTTAAAAAAAATTAAAACTGGCCGGGCGCGGTGGCTCACGCCTGTAATCCCAGCACTTTGGGAGGCCGAGGCGGGTGGATCACGAGGTCAGGAGATCGAGACCATCCCGGCTAAAACGGTGAAACCCCGTCTCTACTAAAAATACAAAAAATTAGCCGGGCGTAGTGGCGGGCGCCTGTAGTCCCAGCTACTTGGGAGGCTGAGGCAGGAGAATGGCGTGAACCCGGGAGGCGGAGCTTGCAGTGAGCCGAGATCCCGCCACTGCACTCCAGCCTGGGCGACAGAGCGAGACTCCGTCTCAAAAAAAAAAAAAAAAAAAAAAAAATTAAAACTGTATACACTTAGGCTCAAAAATCATGTGAAGCCTCCTGCCTCTTCTACCATACCTGCCCCACAAAACTGGCGGGGAAAACAATATGGAATATTATCTTACAATTCACTTAAATCCTCAAGTATGTTTCTGCCCTGTGGCCTTCAAATCTACAGTGCTCTGCTATTTGTGAAACTCATCTTCAAATTCTTCTGTTCTTATTAACTCAGCTATTATAATCGTTTCTTGTCCCGTACTTGTCCTGTCGTTGCTGTGGATATAAGCATTATTATCTGTATGACACATTTGAAAATTAAGTTAATGAAACCTATTTCCCATTTCCCATACTCTTCATTAACGCATGTGCTTTGATTAAAATGCTCTTTGAGTATTTTAAATAGGAACAAGCAGGGGTTTGGCAAGGGTTAAACTTTTGCTATTTTGATTACTCTTTGAAGTGATAAATTAAAGCTAAAAATAAACATGAAAAACACTGTAATTTATCTTCTTTAAAACTGCTGTCTTTAAAGTGATGGAAGAGCCTGAGGAATATGTTGTGGAAGAAAAGCTGCACATTATTTCTAAGAGAGTGGAAGCTGAGCCAGCTGAAGGTATGCTGACTCTTTAATTAGTTTTATCCCTATGTTAGCTTGTCTCCTTCTTTATGTTTCCTTATAGCTAATTTGTCATCCATATTGCAAATATTGATAAATATCATGTCTAATAAAAAGATCCCTTACACTTTTATCGAAAAGAAATCTAGACATTTCTACAAACATATTTTATAATCTTTTCAAGTGACAGAGAGGCAGGAGAAGAAAATTGTACTGAAACCAAAAATTCCTGCTAAAATAGAGGAGCCTCCACCGGCTAAAGGTATGATTTCTTTCAAAGAAATGCAACACTATTTATTTTAATGTATATAATAATACCTTCACATTTGCATAACTGTCTTATGCATAACAATTTGCATAACTGTCTACGTTTTGTCAGAACACATGTATGAACGTATTTACTGAGTATAGTCATTAACGTTTGTATATATGTGCAATCTTTTCAAAAAGTGAATGCTAAGCCCCACAACTGTGTCACTTCATATGTAAGGCAAACTCATATTCTTAAACCTAATCTTTCTAAAGTTCCTGAAGCACCTAAGAAAATTGTGCCAGAAAAGAAAGTTCCTGCTCCAGTTCCTAAAAAGGAAAAGGTGCCCCCACCTAAAGGTATATTGGATTTTATTTTATTCTCAAGACTGTCTTTTTTTAATCTTAAATTGATACATTCTTCAGATTTTTTAAACATTAACCAGAAAATAAGTGTGCCTGTGTTTAGTGTTTTCCATATCGTATGTTTGATGGTATTGCCTGGTATCTTTTAAGTGCCAGAAGAGCCAAAGAAACCAGTTCCAGAAAAAAAGGTTCCTCCAAAAGTCATTAAGATGGAAGAACCTCTCCCAGCCAAAGGTAAACAAACCTCCCCAGCAGAAAAACTAGGAACATATGGCTTGTCTTTCTTTCTCTCTGCTGCTGTTCTTTGGGTCATACTGTTTATATGTTGGTGGGTGACAATGGTGTCTTTGGGTAGAGTATTACTTGTGATGTTTTTGTGTGTGTGCCTTGTAAATTCTTCTATTCTAAAATCACAGTACTTTCTGGCTAGTATATTTTTTACGTCCACTTTGATATAACTCCCTAATCCTAAAATTATCTTTTAAGTGACTGAGAGGCACATGCAAATTACCCAGGAAGAAAAAGTTCTTGTTGCTGTAACTAAAAAAGAGGCGCCTCCAAAAGCAAGAGGTACATCCGCCCTTCCATTATGCACAATATTGTACTTGCCCTACTCTCTTTACCAAATACACTGGTTATGGGGGCTGGTTTTTGTTGTTGTTGTTGTTGTTGATGTTGTTGTTGTTGTTACAGTTGTTGTTTTATGTTTGAAATAATGAAAATGTCAAGTGTTTATGTTTGGGCTACTACTTTATGGCTGCCTTTTTGTGGTTTGAAAGAGGGAAACAATACTTTAAAGTGAAATCTCTCTTTAAAGTGCCAGAGGAACCGAAGAGAGCTGTCCCAGAAGAAAAAGTTCTGAAACTCAAACCTAAAAGAGAGGAGGAACCACCAGCTAAAGGTATACTGACTCTTAAAAAAAAAAAAAAAATCAAAATAAGCATCCAGACACTAAAACTAATCTAGTGGAATAGGTTCCATTAGAAAAAAAAAGACATAGTATAAAGTAAGCAATATAAGTTTGTTAATGCATATCACTTCAAAACTAAACATTTTTGATAACAGAAAGTACTTTTTTCTTAAAAAAAAGTGAGGCTTCTTCTAAACGTATGTGAATAATTTTCCTTAATCTGTATTTGTCTTCTAATGTCTTTTCCATATACTAAACTCATCTGCCTAGATGCTTGCTTTATGTGGCAATCTCTGATGAAATTTTTAATTTTTTCAATTCTGAATTTTCTACATTGTACCAATAGAGCTAAGGAAAATGTCTTAGAAGTGAGGTGAAGAAACTATTCATGTAACATAGGTTTCTGTCTAATGCTTCTACTTAGTTTGATAGTCATTATTTATGCTGTTTAGTTGTCTTTTTAAACTTTTATAAATACTACTTGATTTTCCTAAAATTATTCAATGTCTTTGACGTACTTCATATGTATATTAGAGTAAGTTTATTTCCAAGTCTATTGATTTTCTTGCTTTTTAAATGAAAGTTTAATCAGGCACTGTTATGGTTGTCTTTGTCCTTGAATTGTTTGAACAAAATTTCTCTTCACACACACATTTTCAGAATCTTGCAATTCACTTTTAATAATTACTCCTTTAAAGTGACTGAATTCAGAAAAAGAGTGGTTAAAGAAGAAAAAGTATCAATTGAAGCTCCAAAAAGAGAACCTCAACCCATCAAAGGTATATTGAACTTTGATTAAGTAATGTGAGGCATGAAACTATCTGGCTCTTTGCCTTCTAGTTCCCAATCTGACTCCTATACTTTATTAGCTTATTGTTGATTAAGGGCAGGGTATATAACATTTGAAATCACAATTGCTAAATATACTCTATGATACCTTGACTGGCCAAAAAAGAACAGTCAGGGTCTCCCATAATCAGTGCATGAAACAAACGCAAAAGAATAAAATCAAAGCACATTGTTACTATCAGTCATCCTTAAAAGTGCTTTAAAGTAAAGTGCTGCCTGTTGTTAATATTGTTTCAGAAGTAACTATAATGGAAGAGAAAGAAAGGGCTTATACCCTAGAAGAAGAAGCTGTTTCAGTACAACGGGAAGAAGAATATGAGGAATATGAAGAATATGATTATAAAGAATTTGAGGAGTATGAACCAACAGAAGAATATGACCAATATGAAGAATACGAGGAGCGGGAGTATGAACGATATGAAGAGCATGAAGAATACATCACAGGTATGAGCAAAACTGCAAACTCAAAACCACACTAAATATGTGCACACTCAAACAAGATAAAACAAGATAAATCATAACAAGATAAAAATTTGGATACCCAAAGAAATTTGGAAAGAACTTTGTTTCATTTCGCAAATGCGGAATTTTCTTCTTTGATAACTTCTAGAAAAAATTTTAAAAACCCTCTATAAATCTTAAGGTTATTGTTAGACTTTTGTTCCGGGAATAATCTAATACCCCCCTCATTTTTGCTCGTATGCAAAATAGCAAATGTCCCTAAGTTTCTTTTTCAAAAAGGTTACAAGTTTATCTTCAAGTGCCCGTGATCATTCTAGTACATGGTTAAAAATTTCTGAACATCCTTTATTCTAAAACTTGCTATTACGGAGTATGATAGGCTATTGAGAAAATGTATTTACCCACAGGGTTCCCATTATCAAAACTTGACAATGACTGCTTCAAAAGTTAAGATAGAGATGTAAGCTAACACAAGCTGTTGTGTTTTACCTAATGAAGGTCAAATTTGTTGGCATATAGTTTGGGCTTCAAATTGTTTATTTTACTCAAAGAATAAATCTCTATTGAAATTTTGAAATGAATCAATCTTATTTCACTTATTCAGTCTCTGATGTTTCATAGCCCAACTTTGAGAACATTCTACATAGTCTTACTGATAGCTTTAAAAAAACCATATTATAGGGGAGTTTCAGCCAGGAATTTATCTACCTGAAATGAAATGAGAATTTTAATATGTAAGAATTACCTAATTAAAGAAAATAGCAAGAAGGAAAGGGCAATATGAGCTTGTTCTGCTTGGATCTCTGATTCTTGCCTACTTCAATAGGCTATGGCTATACTGTAGATAAAAGATATTATTTCAATTATTTGATTCCTTTTAAGAAATGTTTAAACTTATATTCTAAGTCTAACATGAAATACCTTGTATGTACTTTTAAAGAACCAGAGAAGCCTATCCCTGTAAAGCCTGTCCCAGAAGAACCAGTTCCCACAAAACCAAAGGCCCCACCGGCTAAAGGTAGAGTGAAAAAAACATTATTACCTGTAAGAGATCTTTGTTTCCTCCATGTCTGTCCTACTATAAAAATATATGTAAAAGTGGCAGTGTACAAATTATGTGTGTGTTTGGGAATATTATGTTGTATTTGTCTTTCTTAACTTTTTGTTCTTGCTAGCCTTGAGAAACCTGTTTCAATTTTTAAAATCTCTTAATATTGATATTTTGAAGTGCTGAAGAAAGCTGTCCCTGAAGAAAAAGTACCAGTGCCCATTCCTAAGAAACTCAAACCTCCACCACCCAAAGGTACATTACTGAGTAATAATCACCAAAAACAACTTTGTTATGTATGTTCTAAAATCATGTCTTCCTAGCCCGTCTGATGGTCTGTGTTTTTGCTGAGTAGGATGTTCTTGTCCTGATTCTTACATTTCAGTTTTTTATGTGTATTTATTACATAGTATTCAAGGAGTTGGTTTTAATGCTCTTTAATAATTAATATCTTTAAAGTGCCTGAAGAACCAAAGAAAGTTTTTGAGGAAAAAATACGTATTTCAATTACCAAACGTGAAAAAGAGCAGGTGACTGAACCCGCTGCTAAAGGTATAATGATTTCCTTCCTCGATTGTGATCTTTTCTGATGCCTCTTTTGAAATTAATGTAACTATGATTCATTTCATTTTGTTGTTTCATGTCTTTTAAATTAGTTGTCAGCAGAATGTTGGATGTAAAAATGTGTAAATACAGGATAAGAAGATAATGCCTTTAAAAGGAAAAATTATTTCTAAATACATCCATAGCCTGTTAGCCAGTGGCTGTGTCCTGCCACATGGCTACAATACATATAAAATAGAATGTTTGGGTTTAAAATCAGTGACCGTTTGGCATATTCCTGATTTACCTAAATGATGTAATGATACCATAATATTCACCAAGCTTTGGTAACTGTTTATTCATTCTAAATTCATTTTGAAGATTTTTTTTAAAGCTAACCAGTTTCCAGTCATTTTCCCCCTGATTCATACTAAGTATGAAGTATACTAATTGAGAAGTAAATTTCACTTTTCAGGAAGGATATTTCTTTCAAGCAGAGATATTTGAACACTAAACCTCATTTCACATTTGGGCTCTGCTACTTCATGTTTACTTGGGTACTTCTGTGTACTTGTATTTATATGAAGCTCAGAATCCTTTCCACAGAGAGTATATAGTTTCTTAAAGATGAACAATCGCATATGTATCTCATTAAAGGAAGATACATTATTCTATCTGCTTAAAGTACAGCAAAACAAGCATTGGCTGGGTGGCCTTTTACTGACAATAAAATTTCCTTATACTTCATATTTCAAGTGCCCATGAAGCCCAAGAGGGTTGTCGCAGAAGAAAAAGTACCTGTCCCTAGAAAAGAAGTAGCACCACCTGTTAGAGGTACCTAATGGCACTCATTTTAATGTTTTGTTCGTCTTTTGCTGTTGAATTCCTCTTCAGTTCTGTGTGTGAAAACTTCTTTTGTGGGAAAAGTAAATCTTGTCCTTTCTTCTGTTATAAATGGGCCTGTGTTTCTAAGGTGTCTTAATTTTGTTGAGTCATTGGCAAATGTCCAACTTAAAGATAATATCTTTAAAGTGCCAGAAGTGCCTAAAGAACTTGAACCAGAAGAGGTTGCCTTTGAAGAGGAAGTTGTAACCCATGTAGAAGAATATCTTGTAGAAGAAGAAGAAGAGTACATTCATGAAGAAGAGGAGTTCATAACTGAGGAAGAAGTGGTGCCAGTGATACCAGTCAAAGGTAGATGATGCCTCCTGCAAAGGGCTGTGCAACAGCATCTTTGGAGTTTGGGGGTCTGATTTGGTCAGATTCTGGGGGTTATTGGCAGCACCAATGATTGCTTACTTTAAAGCAGATATTTTTAGATGCTGAAATATGATTTCTACAGGTGCTTTTCACATTTTATTTCTTTCCTGCAAAATTTCCAACATTCTTAATAATATCTTTAAAGTGCCTGAGGTACCCAGGAAACCTGTTCCAGAAGAGAAGAAACCTGTTCCTGTTCCCAAGAAGAAGGAAGCTCCACCGGCAAAAGGTACACCACCATTCATTGACGGGTATCTAAGAGACTTCATCTGCCTAGAAATAGTTAACTTTCTTCTGAGTTCAAAACCTTGTGTGTGTGTCACTGTCCGTTGTTAAAAAACATTAGCTGTGTTTTATATGGATGTGTTGTTACTAGTAGTTAGAACTTAACAATAAACAATATCTTTAAAGTGCCTGAGGTTCCTAAGAAGCCAGAGGAGAAAGTTCCTGTGCTTATTCCTAAAAAGGAGAAGCCTCCGCCAGCAAAAGGTACATCCTTATAATCCATCAGTGGAATAGCATGATAATTCACCCATGCAGCATAACTTGGTGAGCCATAGCAGATCTTTCCCCATGACAATATTAACAACATTAATGCCATGACAAGCGCCTCTCAACTGGCCACAGGAGCAGTTTACCCGGTATTCATCTCTGAATTTTACCATCAAATTATGCTTATGCTCAATGGTTGGCTCCTCCTCTTTAGTGGAAAGTTCTTCAAGTAAAATACATTCCTTTTGCATATCAAAATGGACAAAACCATCATTTACCAGGCATTGTGTCTTGTCTTTATCACCAGTCCACGTTTTTTTCGGTGTTTTTTATTTTAATTTTTGTGTATTTTCTGGCCTTTGTTTTGTGGCTATTATAATTTTCAGTCTTAAAGTGAAATTGATAGAATATCTATGCTGCTTCAGTTAAGGCCTTACATTGCCAGCCTTAAAATCTTAGCTATGGGTAAAAAATGTGACACTAACTCTATTTGATATCTTTGAAGTTCCTGAAGTGCCCAAGAAACCTGTGCCAGAGGAGAAAGTACCAGTACCAGTTCCTAAAAAGGTGGAAGCTCCACCTGCCAAAGGTACATGAACTTGCAATGTTGCAATATTTTTATTTCACATTTGCATATGGGTAAAAATTAATTGGTTTAATTCTGTACTCTTTGGGATGCAACTCTTTAGAGAAAATTAAATATTTTATTTTAAAAATAAAATGCTTCTTGGAATACCTTTGTCATACTTTTATTACCTTATCTTAATCTTTTGAAACTATGCTTGGAATCAGTATTTTTATGTCGTATAAAATTTTTCTCTAAATCATTTCGTTAAAGTGCCAGAGGTACCCAAGAAGCCTGTGCCTGAGAAGAAGGTGCCAGTTCCTGCTCCTAAGAAAGTGGAGGCTCCACCTGCAAAAGGTACATAATTTCATCACTTAGAGTACTTGGGGGAAAAAACTCACATCTATGTATACTCACATACAAATTTCCCCATTACATTGTACATTTTTAAAGTGTCTATCTGGTTAGAAATATGTCAGATATTTTGTGATTCTTTTTCATATCTATTGCTCTAAGACATTTTAAAAGAACATATTCCTAAATATAAATAATATCTTTAAAGTGCCAGAGGTGCCCAAGAAGCTCATCCCAGAAGAAAAGAAACCAACACCTGTTCCGAAAAAAGTGGAAGCACCACCACCCAAAGGTACATTAATCTGTAACAGAGCCATGGTAAAAGACAAAACTAACTGGTGTTATACAGCCTTACTAATTATAATTAATGCTTAGTATTTATGTTGATAATAATTGATGCTTTGTGATCACAGAATATTTGCCTTTCATAAGCTTCTTCATTGTTGTGAATATTTTACATAAAAGTGATGTTTGTACCCTTGAATAAATATCTTTAAAGTGCCAAAGAAACGTGAACCAGTTCCAGTTCCTGTAGCTCTACCTCAGGAAGAGGAAGTTCTATTTGAAGAAGAAATTGTTCCTGAAGAGGAAGTTCTACCTGAGGAAGAGGAAGTTCTACCTGAGGAAGAGGAAGTTCTACCTGAAGAAGAGGAAGTTCTACCTGAAGAAGAGGAAATTCCACCTGAGGAAGAGGAAGTTCCTCCCGAAGAAGAATATGTACCTGAGGAAGAAGAATTTGTACCTGAAGAAGAAGTCCTTCCAGAAGTTAAACCTAAGGTGCCAGTACCTGCACCAGGTATAGCAGCTCTTCTTGGAATCATCAAGGCCTCTTTTGTGTTGAATTCTGCTTTCCCATCCTTTTGTTCATCTCCAGTTTTATCTATAATCCTTTACCCTCTGTGATTGACCACCTAAATCTTAGAAAACATTCCAGACATGTGTGTTCTTATTGTGTATCTGCCTTGTGTATCTGTCTATTGTAAATTATCTAAATGTCTTTTCAAATCACATATTATGTTTACATGTTTGTGGTCTTATCCTCACGTGTCTCTTTCATATATATATATATATATATATATATGACCATGTATATGTGGTTTTTAATGCCTTCAAATGAAATGTTTTTAAGTGCCTGAAGTGCCAAAGAAACCTGTACCAGAGAAGAAAGTCCCTGTTCCCGCCCCTAAAAAAGTGGAACCTCCACCACCACCCAAAGGTACACCTCCCCAAAGTGAATACACATTGTTCACCCATAGCTTGGTCACATAAATTATGATGAAACTGGGTTTTAGGAAAATTATATTTACAAAATGGATAATCACACAGTTACATATTTACTTCTAACGATGTTCAGGAACACTGATATCTACTTTTTTCACTGATACAAAGCAGTATTCAAGAACAAAGATGAAAGGAAGCATTGTCCCAGAACTGATACAAAAGTTCTGATTTCATATCATTTGATTAAACATCATAGTTTTCATGGAGATATATTTAAATATATATGAATAAGTATACTATATATTTAAATGTATTGAAAACTATTATGAATAAATATTCTTAAATTTCTTCCTTCAACCATTTATATTAAATGCCTTTTTAACACCAGGCTAAAAAGAAAAAAAGATGAATGTATTTATCAAAACACAGAATAATAGTTATGTCTTCTAATACATATATATAAAGGGCAGCCCAACAGGTTTTGATTTTAGCGTTGACTTTACACCTTGTTGTATTACTCTCAGCGAGTCCTTTAACCAACCTGAGCCTGAAGTTATTTTCCTGTAAATTGGGGATGCTAATATCAGTCTTAATGGGCTCAGCTATTATGGTGAGAATTAAATAAAGTAAGGTATTAAAGTAGTCTATCATTGAATGAATAGTATCCAGATTTAACATATTCAATCAGCTCATAGTACAGGACAGAATTAATATATTTGTGCTTTAAAGCTCAATAATATTTTCTACAAAAGATGCTGGCATGGCTGCTTAAAATCAGCATAACCCTCGCATCAGGCCATATAGTTATATAATCAAATGAAATAGTAAAGCTGATCTTTTATTGGATATCAACGATTCAGAAATACTTTCTAGACAATAAATTACTAGTGAAATTTAAATGTATGAAATGATATTAGGTTGGTGCAAAAGTAATTGCGGTTTTTAGCATTAAAAGTAATGTCAAAACCGCAATTATTTTTGCACCACCCTAATAGCATCTGTCCTCTGATAATGACATATGCTGCTGGTCCCTTGCTTTACAAATCCCAATTACATTATAATATCTGGGCTCCCAACTAACATGACAGACCTGTCTTGAGCGACTGTTAACACATTGGTCTTTCTGGGTGTGGGGTCTTCTTGGTTTCTCTTTTTTTGTCCTTCAAAATAAATCCTTATCATGAAATGATGTCTTTAAAGTGCCTGAAATTAAGAAGAAAGTGACAGAGAAGAAAGTGGTCATTCCCAAGAAAGAGGAGGCTCCCCCTGCCAAAGGTATTGCTATTCCGAAGTAAATTAGACTATGCCATTTCCTTCCTTCTCCTATAAAAGTCAAAATGTCCTGTTTCCGTATTTGTTAATACAACTTATATTACTGCTGTGTCTACTTGTCTTTGTGTGTGTGAAACTGAACTTATAAAATAAAATAATATTTTTAAAGTGTCTGTGGTACCTAAGAAACCTGAGCCAGAAAAGAAGGTCCCTCCTCCTGGTCTTAAGAAAGCAGTGGCCCCTCCTGCCAAAGGTACATCATCCCATAACAGGGATATGTTTGCTGCACCGATGTTGAACTGTGGTTCTATCCACACAGGACACTCAACATAAATGTGTGCATTGTATGGTCTGTCATTCACATTCGTCATTTCTGACTCTTTTGCACCCAAGTTTGTGTTGTGTCCATTTTTTCACTTGGTGTTGGTGTGCTTTACATCGTTTCTCTATGTATGTTGTTTCTAAAAAATAAAAATATATCTTTAAAGAGCCAAAAATAACTAAGGAACTAGTCCCTGAAATACCCATTTCTTCATACCCATTTCTTCCTACAAAAAAAAAAAAGACAAAAGAAAAAAGAAATAGAGGCTCCAGCAGTAAAAAGTAGAATTTCTCTTTAATAAACCCTAAATCTTAAACCACAAACCTTTTTATTCTTTTCTCATTAACCGATTCTGTGAAATGTCAATGTTTCATCTTGTGTATGTGCCTTGTGATATTTACTCTCTTATGTTGGAAACTGGAAACGTGGTCTTTATTCTTCTTTGGTTCTTGCATTTTAAGTGTCTAAAATAATCAATGTCTCTCAAGTTCCTGAGGTGCCTAAGAAGGTGGAAGAAAAACGAATCATTCTCCCTAAAGAAGAGGAAGTTCTACCAGTTGAAGGTAGATAACTTTCTAAGAAAATAACATTTCAAAGTCATCCTTGTCTTATTATTGTCTAATATTTGAAGTAGGTAAATGTAAAATTTACCCCAGGAAATCAACATATTCAGATTCTAAAATAAATTATTATTAACCTAATAGAAATTGGGCAGGCAAATTAATATTATTTGAATCTCTTTGCATGTTCAGCCTGTTTGTCTGTTTGCTATTTGTTTTATTTTAATTAGAATTCATGAAGGGAAACTGTATTTGCTGTGGGAAATTTTTCATCAAATGACTTAGTAGGCAACTGTAAAATAAGCTTATCCAAGAGAAATTCCAGTTAAGCCTGAGTAACTGGTGCAGAAAATCTGATTTCTACCCCAAGTGGCTGTTTGACTTCAAACAAGTCTTTCATTAAAAAAAAAACAATAATAATTTTTTTATTATTATAAATTATCTGAAGTCCTTTCCAGTTCACAAATGCTGGGATATGCCTAACATATTTTGAAGACCCAGTAGAGATTTTTTAAGGACTAGTGAGTTTACACAAGCGTTTCGAAGGCTGAGCAGTTTTCAGATATTATCACTGTAGTCTAATATTCAAAATAATTATAAAAATAATTTACAAAATAATAATCTTTTTAAAGTGACTGAGGAGCCTGAAGAAGAGCCTATTTCAGAAGAAGAAATCCCAGAAGAACCACCTAGCATAGAGGAAGTTGAAGAGGTGGCACCACCTAGAGGTATAACCGCTTTTAAGGATTGAACATTTAAAATTCCTGGTGTTCCAAATCTTTCTCAGTAGCTAAATCTAAGATTCACCAGTATGCTTTTCTTATATCGTATCCATGATAAAGTGAAGATTAATTATTCCTGGCACCTGAATCTATGTGTCCTTTTTTTACCCTAAATTTTTCTACAACATCTGCAATACAACTAAGAATGAGAGATTACTATTTTGTTATTGGCGATTGAATTTTTTTCTGACCAGGCCCTACTATAATAGTTTCTCCTAGATTTCAATCCTTAATTTTGTTTTTAATATTAATATGGGGGGAATCTATTTCTCTGGTGAAAGTGTTCATTTTTTAAGAAAAATCTTTAATTTACTATTCCTGAAGAGTGTGATAATATTTTGCATAATTGGTATTACATTTGCTTATAGGATTTCTAAGTAATATCCTTTACACCTCTAGGGTTCCTACTCCACATTTATTATTACCATTTAGGTTGCTAATATCTTTTAAAAATAAGTCAATGTTTTGTGATATTTATTTATTGGTATATGGGTGGTGTTCTGCTCATCACATGCCACTTTTCAAAATGTTCATAAAATTTCTTTTAAGTGCCTGAAGTGATTAAGAAAGCAGTACCTGAAGCACCTACTCCTGTTCCTAAAAAAGTGGAGGCACCACCAGCTAAAGGTATATCAAATCCTCATTATTAATATCTTTAACTTCCCATTAATTTTCTTTCTTAAAAGCAACATTTTCTTTTTTGACTGCCTTCTTATAATCATTTAGATAGTGAACTGATTAAGGACCAGTAAAAATATAACTCATTCCATTTCTTTAATCTTTTCTAGGATGTTAACGAATAATTGTGTGCATGTGTTTACGTATGAATTATTCTAGAAGCTTCTTAACTGAGAATTTTAATATATTAGTATGTCTCTATATACTTATACACATAGCAATGGATCCCTCTTCCCCACATTTTAGATTTTATTCCATAAGTGGAACGGAGTTTTCTTCTGTGTTATAATAATTATTTTACTATATTTATTATTTTATGGAACAAACCTAATGCTTGGATAATAACTATTTTAAAGAGCCTCACGTCCCTTTTGTAATGTTTAGCCCAAGCATTCAAGGTTATTACAAAATGTCTACTTTTCCCTGCTTCCTAATTCACTTAATGCTTCAGACAGTGCTCTTAAGCAGTTAGATTATGCTGTCCCTGTCATAGTAGACTCCTCAGCTAATAGAAGAGTGCACAGCAGAAAGTGAGGCCAGTGTCAGGGCTTAAATACTCTACAATGGTAATCACTTCAAAAAAGTCTTCATCAAGTTAAAAATAGTAAAAGTGAGTCCATATTGGTAATCCCTGTTATTAAAAGAAAAAAAAAAGAATGGCACAGGTACTTTGTGGACATTTCTTCTTCTATAGGAATGTTAGAACAAATGAGTGATTTGAGAAAGTATCTTTATTGCCTCTAAAATGGATGTCCCACAGTACAGAGTGACTTCTGAAAAACTTTAATTATTGTAATGTTGGCGTTGTCTCTGGTGTTTTTATTTCATGTGTGTTATTGAACATTCTCAGCTAACTAAAACACCTAATATCTTTAAAGTGTCAAAGAAAATTCCTGAGGAAAAAGTACCTGTTCCTGTTCAGAAAAAAGAGGCACCCCCAGCCAAAGGTACATCTTCTCTTTTAAACCTGACTTCCTCTTCTGTCTTTTTTCGTTAAGACTTTTATGTTTCATGTCTCTGTGTCTTGATTGTTTTTGATGATTTTTGTCTATGAAAGCTTGCTCTCGACAGTCCTAAATATTAAAACTGTATCTTTAAAGTGCCTGAAGTACCAAAGAAAGTCCCAGAAAAGAAAGTCCTTGTGCCTAAAAAGGAAGCTGTTCCCCCAGCTAAAGGTATTTTTGGAAAGATCCTGGATTTTCGTGTATTGTTGCATGCAATCCTTTATTCAGTTTTAAAAATATATATTTTGAATGTACATCTTTATTTCTTCAGTGTTTAAAAAAATAAGTCTTAAAATAGATGCTCTTTCAGGGAGAACTGTCCTTGAAGAAAAAGTATCAGTTGCCTTCCGCCAAGAAGTAGTAGTAAAAGAAAGACTAGAATTAGAAGTAGTAGAAGCAGAAGTGGAAGAAATTCCGGAAGAAGAAGAGTTCCATGAAGTTGAAGAATATTTTGAAGAAGGCGAGTTTCATGAAGTAGAAGAATTCATCAAATTAGAACAACATAGAGTTGAAGAAGAACACAGAGTTGAAAAAGTTCATAGGGTAATAGAAGTTTTTGAGGCTGAAGAAGTGGAAGTATTTGAAAAACCAAAAGCTCCACCTAAAGGTATAGGGAATTCTTCAAATACTACAAATTCTTATATCTTGCTCTAACTTTCCTTTGAAAGTAAATTTTGTGTTCAGTTTGGAAGATTAGAAACCCCATGAAATACTTTAAACATGAGTTTAAACTAGTTGACACAAAGATTAATATCTCTTAACCACACGGAGTATAATTTTAGTAGATGATAGTAATATTTGATATCTACTTATCTAAGGAGGTCACTGTATGAATTTGGGGATTATTTTTTAAATCTGACTAAGAATGTTACACAATTGTTACAGGTACCAAAATAACTGACCAGTGTCATTGGTTAAGTGAAAAAGAAACTCCTCAGTTCACTGAGGAATTTACATGTTCAGGCAAAATAATCACTGCTTTAACATTTTAGTCAACTGTTCACAAACTGAGAAATACTTACCAAAAGCTTTTGCCAGTTTATGATACTTTCATTAGAGAAACAACATTAAGGAAGTGAAGTATTGTTAATGGCACCTGTATTCTAGCATACTGTGAAGACAAGCCATAGCACAAATAAGTTATCTGCAATACCACTCTAGATCTTGCACAAATTAACAATATATGTGTAATATGAAGGAATGTGTGTGTGTGTGTGTTTAGCATATATAGCAAATTACAATATACATGATATTTAGCAAATCAAATCTCTTTTGGAAATAAGTGTGTTATAAATTAAAAAAATATAGATAAAGAATTTTGTGACCCCTCATTGTACTAACGTTAGTAGTAGTGCTCCAAAATACTTCAAGAGTTCATTCTAAACCAAAATACTAATATCTTTGAAGGGCCTGAGATATCTGAGAAAATCATCCCTCCAAAAAAACCGCCCACTAAAGTTGTTCCTCGAAAAGAGCCACCAGCTAAAGGTATCTTCTTTGTGAAAAATTACTACTTAACTTTACATACAATAGCACCTTGGTTGCTTTATAAGCACAAGTTTGCATTCCACTTGATGTCTTTCTTCTGTATTTCTTGTTTCTGACATGTCTAAAACAAACTAATATCTTTAAAGCAGCTGAGGGTCCAAGGGAAGTTCTACCAAAAAAAGACAGTCACTGTTGTTATACCTAAAACAACCAAAGCAAATATCTCTAGTAACCAAATAGTGAGCCCAAATTTCCTCCTTTGGTGCTATTTGGTTATATATTCACTAACATGCTTACTGATAAACACATGTTTTTCTATTTATTATTAATTATATTAACCTGGCAAATATAAATACATAGTGAATATGTGTTTAATGTTCTTGCTTTGTTCATTTTTGCAAATCTCTTAAATTTCACAATAGAAATAAAAACAGTATCTAATAAATAATATAAACTTATTTCTTTAAAGTCTCTGAAGCATGTGCGTAAGTTATCACTGAAGAGAAGGTAGCAACTCTTCCACAAAAACAAACAGTAATAGCACCAGCTGAAGGTGTACTGTTAATTTTTCTTCTCAAGTTCTTACCATTCTAACATGGGAAATTTCCCTGGATTTTTGTTATTATATATTTTTTAAATTCAATGCATTTGAAATACTGTAATGTATTTGATAAAGTGTTGTCTGCATTTTATATTGTTGCTGTGTTCTGTTCTGTGTTTATATCTCTCATGCTCTGCTTGTTAAAAAATTGTATATTTAAAAATAAAAGAAATTATTACTATTATCTTTAAAGTACCGGAGGTGCCTAAGAAAATTGTGGTAGAAGAAAAAGTACGTGTTCCTGAAGAGCCCAGAGTTCCACCAACTAAAGGTAACTGGCTTTTCTCATTCATCATTAATATAAAATCCTTTTTTATTCACTTACTATGTAAGAGAGACCTTTCTCTTCTCAATGCCACAAGATGGCTATGAATGACATAAACTTCAATTTATGTTCTATAACATAATCCTGCCTTTTGAGGCAATGTTTTAGGCGTAAAGACATAAGCCCAAAGTTATCATTTGTATTGATCCTCTTATTTAATAACTAAATAATATTGATCCCTCAACTTCTCTTTCAAAAATAATTCATTTTGGAAGCTCTTCTGAAGTAGCTCTGGAAAAAAAAAAGTGTGCTCTAAATGGCAATAGAAAATGATACTATCTCCAAAGAGCAAAGTGTTTCTGATATAATGAATCAAGAACTCATCGACAAAGCAATTCAGAGAAATGCAATGACTACATTTGACTTATAGTTGACTTATAATTGAGGGGTTTTTGGCGTTCATCTTGTTAGATGCCCCTTCTAGGCTTGCTATGTTTACACCCAACTATAATGTTCTGAAAAAATAAGATAAATAAATATCTTTAAAGCACCCGAAGTACCCAAGAAAATTGTCCCAGAAGAAAAAGTTCGTGAAGCTGTTCTGAAAAAGCCTGAAGTTCCACCAGCTAAAGGTATACAGTGATGCTAATCAGAACATGAAATAATTCTTGGTTTAGTTTTTCATGGTTTAAAGTGAATGTGTGTGACATTAAATCCTTGTATTTCGTATCTTATATTTGTTATCTGTAACAATTAATATACTAATATCTTTAAAGTTCCTGGGATGCCTAAGAAAAGTGTTCAAGAAGAAAAATCACCTATTGTTATTTCTGAAGACACAGAGATGTACAGTGAGTGTAGAAAAATTAGTGGTTCTTTTTCGTTTCATTTATGTCCTTAAATTCACTATGTTTGTCTTTTTAGCTTTGAAAAGTAAATATACTAAACTCTTATAAAAGCCTAACATGCCACAAATATATGACTCAAATAATCTTAGTGTCTATTATCCTCAGACAAGTTATATTTCCTCACCAATTTAAAAAAGAAATACTCTACTTATCAGAGTGTATGATTTCAGAAAAGTCAGTTGTCTTGTTAAATTTTCCTAACCTATTCTGTATACAAGTGTCTTTTGCTTTGAAGCAATTTATTTTCTCAGATCATGAAGTAACTTAACTCCATAATATTTTAATTGGATTTTATAAAATCAAAATGTTTCACCATTATTTTTTTTTTTACTCTTGATAACCATAATTGGAAACATTTTGGCAAAACTGCTCAAAGGACCCTAGGTTTACAAGGCCACTCAAACCTCAAAAGAATTCTCACGACCTTTTTTTTTGGGGGGGGGTTTCATACAAAATTAGGTTTAAATAATTTGAATTATGAAATAATCCAAATAGTAAAATATTGTGAATAGAATACTGTTCAACAACCTGAATAGTAAAAGTGACAGTAGTCAAAATATTCTTCCTTTTTTTTTTTTTTTTGAGATGGAATCTCACTCTGCTGCACCCAGGCTGCAGTGCAGTGGCACGATCTTGGCTCACTGCAACCTCCGTCTCCTGGGTTCAAGCTATTCTCCTGCCCCAGCCTCCCGAGTGGCTGGGATTACAGGTGCCTACCACCAGGCCCGGCTAATTTTGTGTATTTTTAGTAGAGACAGGGTTTTACCATGTTGGTCAGGCTGGTCTCAAACTCCTGACCTCAGGTGACCCGCCCACCTCAGCCTCCCAAAGTGCTGGGATTACAGGCATGAGCCACTACACCAGACCCGCTTCCATTTTTTTTAATCTAAAAAATTTCCTGTTGAAACTCAACTTTCTTGTTGTTCATCCTGTTATACTAAGTTGGGATAAAATAATATAATCACTTCCTCCTTTGAATATCCTTTCTATTCTTGACTTTAGTTATTGTTTTCAGACAGTTTTTCTTTCTAAAGGCTGGAGAAATTTTTGTTGTCTTTATTTGCCTTATTTTCTAAGTATTTAATTTTTTTAATTTTCTGCCTCCAAACCCTAAATGGCTTTTACATTCATATTAAACTGTGAAACCATATATTAGATGTGATTTGAAAATATAGATAATGAGGCTTCTAGAAAGGGAAAAGACTTACATGAATTTCTAGTAGGTCAAATATCGGAGAATTCTCAATGTGCAATTCAGCATCTTCCCTGTTCTTTATAGACAAATCCATTAAAAATAAGACCAATAGGACAATTTTACCAATAACTTTCTTAAGGCAAAATGAAGAATTATATAGTCCTTGCCTGAACAATTCCTCCATTTTATTATCATCATCATAGAGAAATGCTTAGAGTCTTACATCATGAAACTGGGAGTGAGGCTATCCCCAGCCAATGCATTCTAGCCACTAATTTGCCTCTATGTGCTACTATTAATTTTGGTGATGAATGTGGTATTATATATTATATTTTTCTTAATACACTTCTTTATCCACCTTGAAACATCCTAATTATTTAAATACTAATATCTTTAAAGTTTATGAAGCATCTGAAGAAGCAGTCCTAGAAGAAAAAGTACTTGTGACTCAACCTCAAAAGACAAAACCCAAACTAGCAAAAGGTATATAACACCAATGATCCACTCTGAAGAAAAATTATTTTTTGGCCCCTTTTAAAAAGCTCAATATTTTTCTTCACCATTTATAAATATAACTATACTCATATCTTTTAAGTGCCTGAGCCACCCAAGAAAGTTGTTCCAGAAGACAAAATATATGTGACTATTCCTAAAAAGAGAGAAACACCAGCAACTAAAGGTATATTTCAAATACATCAAACCCAGATGAGTATCTTTAGCTTTATGACTCAAACATTGCATGCTTTTTATAATTTACTGTTTTTACAACTTTTAAATGTAAACCTACTAATATCTTTAAAGAACCTGATACAACCAGAGGCATTTTTCCAGAGGTGGAGCCACCTGAGGCTATTCCTGAAATTCCAGAACATCCTCCAACTGAAGGTATAATTCTCTAGTTAGGAAAATCTAAAGAAGAAAATATACTGTCTTCAGTCTGCAAAATATTTAATGTTTAATATACATTCTCACAACCTCTAATGTTAAAATACTGTGTTTAAAGGATCTGATATACCCACAACAAAGAATGACCTATGACTTGCCCCCAAGAAAGTCAAGTCCCACACATATAATATACAAAGATAAAATATTAGAACAAAAATAACATTTCTAACATAAAGATATCTGAAATGATATTAACATATCTAACTTTCTTAGTATGTCATGTCTTTATGCCTTTGCCTTTTCTCAATTAAAAAAAATACTAATATCTTTAAAGAGTTTGAAGTCTTCAAGGAAGTCATTCCAGAGGGAGAAACTCCTATTGTTAAAAGAAGAAAAACACCATCACCAACAGGTACAAGTTGGAAGAAAGTCACCTTTTTAATCTCATGTTTGCAGTTGTACTTAACACATGTAAAAATACTAATATCTTTTAAGCCAAAGTGGCTACAGTGGAAATCATTTCAGAGATGGATCCCCCAAGTAGAAGCTCAACCAAATGTATTCATGTCCCAGTGAGTCACTCAAGAGACAACAGAGGGAAAAAATACCTTTAGCTTATACACATGAAAGATAGTTGAGTCAGTGTATTTTTATGAGGACTCCAAAGAAAATATATATACACATATTATGATCAAAACATGTCTTAAAGAAAATATTAATTCAGTGTGAAGCTGATCTGTAATATCTCTACAAGATTAGAGCACCTGAGACCCTCCCAGAATATCCTCCAACCTAGGGAAAAATAATTCCAGTTAAAGCTGGAAATCTCCCCTCCATGTTCATTTGCTCCTCTCATAGCCTATCTTTTATTTTTCAAGCATCATTTTTTTTCATTTTGAATATCTTTAGATAAGTCAAAACATGAAAAAGCTTTAAAACCTCCAGAACAATAATTTCATCATAACACCCATGGTATTCTGTAATTTGAAGAATATCTGAATATTTTGATATTTTTTCTCAGTCTGGAATCTTTTGGTTGTTCTCCTCTCTCCTAAACTTGAAAAACACTCACCTTTTTAAGGTGCCTGAGGTGTGAATACAAAAAAATGCCGACCTAGATTTTTCGAAGTGGCTGTAATTTGTTTTTCTCAACATAATAGCTAGAGGTATAGCATTAATTATAATCAATGTTTCCACTTTCCATGATCTAGTTTTCTATGCATCTACCATTCCAAGAAATAAAATTACTAATACTGATAGTGCCTGAGGTGACCAAGAAAACAGCCGCTTATAACCAAATACTCACACTGCTACAAAAGATCCGATTCTGGGGGCGGGGAGTGGGAGAAGGTTCCCATCTGGAATGTTCTGTATGTGCAGTTAAGATGGGAACTCTTTACTCCTCTTCATAACTCCAAAGTACAATGCATTCATATCTTTAAAGTGCCTGAATCACCTCGAGAAATTGTCCCTGTAAAGGAAACACCCATGGCTGCTCCCCTTGAAATTGAAATACCTCCCACTAAAGGTATCGTTCATCCTGCCATTCCTTCCTTCATTTATTAGAGTGCTTAGCATGTACAGGGTGCTAGGGAACTGGAGAATAATAAACAAAGACAATTAATATGTGGTTCCTCTCCTCAAGATTGTATACCTCCTCAGATTCTTTAAAGGAATCATCTTTTTAGCCATAAATATCACTTTGGTTCAGCTCATTTAATTAATGTCTCCACTGATCCTTTTAACCTCTAACCATAATACTAATATCTTCAAAGCACCAGAAGCTATGAAAGAAGTTGTCCCTGAAATGAAAATATTTGAGGATGTACCTGAAGAGCCAGAAACTCCACGTATGAAAAGTACGTTACCTCTGAACAAATGTGGAAGAAGAAATTATCTGTCCTCTGCTCTTAAAACTATGGTTTCTTCCTAATACTCTTCATAAATTCTAAATATAAACATACTAATATCTTTTAAGTGTCTGAGGTTCCACAGGAAGTTTCCTCTAAAAAGAAATTATTTATGGCTGTTTCTGCCAAAACAGAAAACACTCCTGCTGGAAGTATTCATTCAACAAATCCTTTATAATGAGAGTGTAGAGTGTCGCGAGAGCTCTGTGAGGTTCTGGAGGAGGGGGAGCACCTCCTCTCAAGGATCCACTAACCCCTTAAAAGACTTAGCCTATTGGTGGAACAAAGGGAGGATGGAGGAAAGAGAAGAAAATGTGGTTATATTTCCTAACTTATTGTGGTTACTGTTTTCCATTAATCATTTTAACTCTTAAATGTGAATTGCTAATATCTTTCAAGCGCCCGAAGCTCCTCAAGAAATTATTCCTGCCAAGACAGTTCCTTCCAAAAAAAGAGAACCCCCATCAGTTAAAGGTACAAGTCACCATGCTCTCAGGGTCAAGAACTAGCTCTTGTAGTTTTGAGAATATTTTTGCTATTCCTAGTTATCTGCATAACACTAAACATAAAACTACTAATTTCTTAAAGTGCCTGAAGCTCTCCAAGAAATTGTCCCTGAAAAGAAAACGCTTGTGGTTCCTCTCAGAAAGCCTGAAGTCCTTCCTGATGAAGGTATATCTTGCTGGAAGCTTAGAGGGGTGGGAACATGTCTTTTCTTGTATAAATGTTTTTCCTGATTGTGTTGATTCTTGTAACTTCTAAATGTAAAATTATTAATATCTTCAAAGTGCCGGAGGCTCTCAGAGAAGTTGTCCCGGAAAAGAAAGTGCATCCTCCCCAAAGGGCTGAAGTTGTACCTGTCAAAGGTACATTCTTAACTGTCTTTTTATGGTGGGATAGTGGGTGGGGCGATAGAAAGGACCACCTTTCTAGTTTTGAAAATTATTTTGATGTGTACATGTGAATCATGTCTGTGTTGACTCTTGCAACTCAAGTGTAAATGTATTAATATCTTCAAACTGCCTGAAGCTCCCAAAGAAATGGCTACCAAAAAGAAAATACCGGAAGTTCCTCCTCTAAAACCTGAAACACCACCTATTATGGGAACTTGTTACCACTGATCTCAGCTCAGGAGAAAAAAATAGCTCTTTTGTTCTTGAAAATGTCTTTGTATCTATCTAGTAATCTCTGTATTTTCTGAGTGTAAAAATACTAATATCTTTCAAGTGCACGAAGCTCCCAAAGAGATTATCCCTGAAAAGAAAGTGTCGGTGGTGCCTCCTAAAAAGCCTGAAGTCCCACCTGTTAAAGGTATTTGTCACTGACTTTAGGCTTCAGAAGACCTAATTCTTCTGCTCTTGACAATATTTTTTTCTAGCGGTCTTCATAACACCTAAATGTAATTTCACTAATATCTTTCAAGTGCCAGAAGCTTCCAAAGAGGTTATCCGCGAAGAGAAAGTGCCCTTGGCTCCTCCTAAAGAGCCTGAAGTCCCACCTGTTAAAGGTAGTTGCCACTGACCTTAGGCTTCAGATCTCATTCTTTTGCTCTTGAAGATATTTTTTCCAGTGGTCTTCATAACTTCTGAATGTAATTTTGCTAATATCTTTTAAGTACCAGAGCCTCCCAAAGAAGTAGTTCCTGAAAAGAAAGCGCCAGTGGCTCCTCCTAAAGAGCCTGAAGTCCCACCTGTTAAAGGTATTTGTCACTGATTTTAGGCTTCAGATGATGTATCTCTTCTGCTCTGGAAAATATTTTTCTAGTGGTCTTCATAATGCCTAAATGTAATTTCACTAATATCTTTCAAGTGCCTGAGGCTCCCAAAGAAGTTGTTCCTGAAAAGAAAGTGCCAGTGCCTCCTCCTAAAAAGCCTGAAGTGCCACCCACAAAAGGTAGACACCCTCTTGTTGCTGTGTTTGATATTGTTTGTTTGTCTTTACTTTGTCTAATAATGAAAATACTAATATCTTTAAAGTCCCAGAGGTGCCAAAGGCAGCTGTCCCAGAAAAGAAGTTGCCTGAAGCTATTCCTCCCAAACCGGAAAGTCCTCCCCCTGAAGGTAATGCCAAAGCTATACAAACTATAGGAGAAAAATAACTGTTATTTTAACTAGGAAATTACATGTTAAAAATCCTACTACATAAAGATGATATAATTCTAAAGAAAACAAATGTCAATCGCTATCCAAAATATCTTGGTGGGTGTTTATATGCAAAAGGCATCCATCATTTTCACCTTTTCTAAACACAAATTACAAATATCTTTGAAGTGCCTGAAGTGCTGCCACCGAAGGAAGTGGTCCCAGAAAAGAAAGTACCGGTGCCTCCTGCCAAAAAGCCAGAAGCTCCACCTCCTAAAGGTAGGTATCATTACACATTGTCAGTCGGGGGGCCCTGGGGAAAGACTGCATAGAAGTGTCCGCCGATCTCACAAGTTGTATTTGCTTGGGTAAATGTGGAGTCGATATTCCCCCTTTATAGCTTCTAACTAAAAGATACTAATATCTTCAAAGTTCCTGAAGCTCCTAAAGAAGTTGTACTTGAAAAGAAAGCATCTGTGGCTGTGCCCAAAAAACCGGAAGCCCCACGTGCAAAAGGTATTTATTCCCTCTCCTCTGCTAAGAAAAACTTATCGTCTGTACCCCTCACAATCACTGTAATATATACCTTCACCATTCATAAATTATAAAAATACTAATATCTTTCAAGTGCCTGAAGCTGCTCAAGAAGTTGTCCCAGAAAAGAAAATTCCCAAGGCACCAATCAAAAAACCAGAAGCCCCCGCAGTTACAGGTACATGTCAGCTCAACCTTATCCTGCAGAAGAAATCTCTCTTCCATTCCTGAAAACAATTTTAGTCCATTCCTCTTCATTAACCTAAGTATAAAACTACTAATATCTTTCAAGTGCCAGAAGTTCCTCAAGAAGCCACAGAAAAAGAAATTCCCGTGGCTCCACCCAAAAAACCAGAAGCTCCAATTGTCCCAGGTACACTTTAGCCCTGACTTCATTCTGCAGAAGAGATATCTCCTCTCCTACTGTAAACAATTTTAGCCCATTTCTCTTCATTAACTTAAGTCTAAAACTACTAATATCTTTCAAGTGCCTGAAGCTCAAGAAGTTGTCCCAGAAAAGAAAGTTCCTAAGGCTCCTCCCACAAAACCAGAAGCCCCACCTGCCACAGGTATTTTTTACCCCTGTCCTTTTTCTGCAGAAGAAATATCTCTTCTGATCTTAGAAATATTTTACTCCATTTGTCTCATTAACCTAAGTGAAAAACTACTAATATCTTTCAAGTGCCTGAAGTCCCACAAGAAATTGTGCCAGAAAAGAAAACACTGGTGCTTCCTAAAAAGCCAGAAGTTCCACCTGTTACAGGTACTTGTCATTTGACCTTAAGCTTCAGAAGATCCAATTCCTCTGCTGTATATTTTGCTAGTAGTCTCCATAGCTCCACATGTAACTTTACTAATATCTTTTAAGTGCCAGAGGCTCCCAAAGAAGTTGTCCTTGAAAAGAAAGTGCCCTCGGCTCCTCCTAAAAAGCCTGAAGTCCCACCTGTTAAAGGTATTTGTCACTGATTTTAGGCTTCAGATGATCTATCTCTTGTGCTCTGGAAAATATTTTTCTTTTTATATATATATATATTTTTATTATACTTTAAGTTCTAGGGTACATGTGCACAACGTGCAGGTTGTTACGTATGTATACATGTGCCATGTTGGTGTGCTGCACCCACTAACTCGTCATTTACATTAGGTATGTCTCCTAATGCTATCCCTCCCCCATCCCCCCACCTCACAACACACTCCGGTGTGTGGTGTCCCCCTTCCTGTATCCATGTGTTCTCATTGTTCAATTCCCACCTATGAATGAGAACATGCAATGTTTGGTTTTTTATCCTTGTGATAGTTTGCCAAGAATGATGGTTTCCAGTTTCATCCATGTCCCTACAAAGGACATGAACTCATCATTTTTTATGGCTGCATAGTATTCCATGGAGTATATGTGGAACATTTTCTTAATCCAGTCTATCATTGATGGACATTTGGGTTGGTTCCAAGTCTTTGCTAATATGAATAGTGCCGCAATAAACATACGTGTGCACGTGTCTTTATAGCAGCATGATTTATAATCCTTTGGGTATATACCCAGTAATGGGATGGCTGGGTCAAATGGTATTTCTAGTTCTAGATCCCTGAGGAATCGCCACACTGACTTCCACAATGGTTGAACTAGTTTACAGTCCCAGCAACATTGTAAAAGTGTTCCTATTGCTCCACATCCTCTCCAGCGCCTGTCGTTTCCTGACTTTTTAATGATCACCATTCTAACTGGTGTGAGATGGTATCTCATTGTGGTTTTGATTTGCATTTCTCTGATGGCCAGTGATGATGAGCATTTTTTCTTGTGTATTTTGGCTGCATAAATGTCTTTTTTTGAGAAGTGTCTGTTTGTATCCTTCGCCCACTTGTTGATGGGGTTGTTTTTTTCTTACACGTTTGTTTGAGTTCATTGTAGATTCTGGATATTAGCCCTTCGTCAGATGAGTAGATTGCAAAAATTTTCTCCCATTCTGTGGGTTGCCTGTTCATTCTGATGGTAGTTTCCTTTGCTGTGCAGAAGCTCTTTAGTTTAATTCGATCCTATCTGTCAATTTTGGCTTTTGTTACCATTGCTTTTGGTATTTTAGACATGAAGTCCTTGCCCATGCCTATGTCCTGAATGGTATTGCCTAGGTTTTCTTCTAGGGTTTTTATGGTTTTAGGTCTAACATTTAAGTCTTTACTCCATCTTGAATTAATTTTTGTGTAAGGTGTAAGGAAGGGATCCAATTTCAGCTTTCTACATATGGCTAGCCAGTTTTCCCAGCACCATTTGCTAAATAGGGAACCCTTTCCCCATTTCTTGTTTTTGTCAGGTTTGTCAAAGATCAGATGGTTGCAGATGTGTGGTATTATTCTGAGGGCTCTGTTCTGTTCCATTGGTCTATATCTCTGTTTTGGTACCAGTACCATGCTGTTTTGGTTACTGTAGCCTTGTAATACAGTAGCGTGACGCCTCCAGCTTTGTTCTTTTGGCTTAGGATTGACTTGGCAATGTGGGCTCTTTTTTGGTTCCATATGAACTTTAAAGTAGTTTTTTCCAATTCTGTGAAGAGAGTCATTGATAGCTTGACGGAGATGGCATTGAATCTATAAATTACCTTGGGCAGTATGGCCATTTTCACGGTATTAGTTCTTCCTATCCATGAGCATGGAATGTTCTTCCATTTGTGTCCTCTTTTATTTCGTTGAGCAGTGGTTTGTAGTTCTCCTTGAAGAGGTCCTTCACATCCCTTGTAAGTTGGATTCCTAGGTATTTTATTCTCTTTGAAGCAACTGTGAATGGGAGGTCACTCACGATTTGGCTCTCTGTTTGTCTGTTATTGGTGCATAAGAATGCTTGTGATCTTTGCACATTGATTTTGTATCCTGAGACTTTGCTGAAGTTGCTTATCAGCTTAAGGAGATTTTGGGCTGAGACGATGGGGTTTTCTAGATATACAATCATGCCATCTGCAAACAGGGACAATTTGACTTCCTCTTTTCCTTATTGAATACCCTTTATTTCTTTCTCCTGCCTGATTGCCCTGGCCAGAACTTCCAACACTATGTTGAATAGGAGTGGTGAGAGAGGGCATCCCTGTCTTGTGCCAGTTTTCAAAGGGAATGCTTCCAGTTTTTGCCCATTCAGTATGATACTGGCTGTGGGTTTGTCATAAATAGCTCTTATTATTTTGAGATACGTCCCATCAATACCTAATTTATTGAGAGTCTTTAGCATGAAGGGCTGTTGAATTTTGTCAAAGGCCCTTTCTGCATCTATTGAGATAATCATGTGGTTTTTGTCGTTGGTTCTGTTTATATGATGGATTACGTTTATTGATTTTTGTATGTTGAATCAGCCTTCCATCCCAGGGATGAAGCCCACTTGATCATGGTGGATAAGCTTTTTGATGTGCTGCTGGAAAATATTTTTCTAGTGGTCTTCATAATGCCTAAATGTAATTTCACTAATATCTTTCAAGTGCCTGAGGCTCCCAAAGAAGTTGTTCCTGAAAAGAAAGTGCCAGTGCCTCCTCCTAAAAAGCCTGAAGTGCCACCCACAAAAGGTAGACACCCTCTTGTTGCTGTGTTTGATATTGTTTGTTTGTCTTTACTTTGTCTAATAATGAAAATACTAATATCTTTAAAGTCCCAGAGGTGCCAAAGGCAGCTGTCCCAGAAAAGAAGGTGCCTGAAGCTATTCCTCCCAAACCGGAAAGTCCTCCCCCTGAAGGTAATGCCAAAGCTATACAAACTATAGGAGAAAAATAACTGTTATTTTAACTAGGAAATTACATGTTAAAAATCCTACTACATAAAGATGATATAATTCTAAAGAAAACAAATGTCAATCACTATCCAAAATATCTTGGTGGGTGTTTATATGCAAAAGGCATCCATCGTTTTCACCTTTTCTAAACACAAATTACAAATATCTTTGAAGTGCCTGAAGTGCTGCCACCGAAGGAAGTGGTCCCAGAAAAGAAAGTACCGGTGCCTCCTGCCAAAAAGCCAGAAGCTCCACCTCCTAAAGGTAGGTATCATTACACATTGTCAGTCGGGGGGCCCTGGGGAAAGACTGTATAGAAGTGTCCGCCGATCTCACAAGTTGTATTTGCTTGGGTAAATGTGGAGTCGATATTCCCCCTTTATAGCTTCTAACTAAAAGATACTAATATCTTCAAAGTTCCTGAAGCTCCTAAAGAAGTTGTACTTGAAAAGAAAGCATCTGTGGCTGTGCCCAAAAAACCGGAAGCCCCACGTGCAAAAGGTATTTATTCCCTCTCCTCTGCTAAGAAAAACTTATCGTCTGTACCCCTCACAATCACTGTAATATATACCTTCACCATTCATAAATTATAAAAATACTAATATCTTTCAAGTGCCTGAAGCTGCTCAAGAAGTTGTCCCAGAAAAGAAAATTCCCAAGGCACCAATCAAAAAACCAGAAGCCCCCGCAGTTACAGGTACATGTCAGCTCAACCTTATCCTGCAGAAGAAATCTCTCTTCCATTCCTGAAAACAATTTTAGTCCATTCCTCTTCATTAACCTAAGTATAAAACTACTAATATCTTTCAAGTGCCAGAAGTTCCTCAAGAAGCCGCAGAAAAAGAAATTCCCGTGGCTCCACCCAAAAAACCAGAAGCTCCGATTGTCCCAGGTACACTTTAGCCCTGACTTCATTCTGCAGAAGAGATATCTCCTCTCCTACTGTAAACAATTTTAGCCCATTTCTCTTCATTAACTTAAGTCTAAAACTACTAATATCTTTCAAGTGCCTGAAGCTCAAGAAGTTGTCCCAGAAAAGAAAGTTCCTAAGGCTCCTCCCACAAAACCAGAAGCCCCACCTGCCACAGGTATTTTTTACCCCTGTCCTTTTTCTGCAGAAGAAATATCTCTTCTGATCTTAGAAATATTTTACTCCATTTGTCTCATTAACCTAAGTGAAAAACTACTAATATCTTTCAAGTGCCTGAAGTCCCACAAGAAATTGTGCCAGAAAAGAAAACACTGGTGCTTCCTAAAAAGCCAGAAGTTCCACCTGTTACAGGTACTTGTCATTTGACCTTAAGCTTCAGAAGATCCAATTCCTCTGCTGTATATTTTGCTAGTAGTCTCCATAGCTCCACATGTAACTTTACTAATATCTTTTAAGTGCCAGAGGCTCCCAAAGAAGTTGTCCTTGAAAAGAAAGTGCCCTCGACTCCTCCTAAAAAGCCTGAAGTCCCACCTGTTAAAGGTATTTGTCACTGATTTTAGGCTTCAGATGATCTATCTCTTGTGCTCTGGAAAATATTTTTCTTTTTATATATATATATATTTTTATTATACTTTAAGTTCTAGGGTACATGTGCACAACGTGCAGGTTGTTACGTATGTATACATGTGCCATGTTGGTGTGCTGCACCCACTAACTCGTCATTTACATTAGGTATGTCTCCTAATGCTATCCCTCCCCCATCCCCCCACCTCACAACACACTCCGGTGTGTGGTGTCCCCCTTCCTGTATCCATGTGTTCTCATTGTTCAATTCCCACCTATGAATGAGAACATGCAATGTTTGGTTTTTTATCCTTGTGATAGTTTGCCAAGAATGATGGTTTCCAGTTTCATCCATGTCCCTACAAAGGACATGAACTCATCATTTTTTATGGCTGCATAGTATTCCATGGAGTATATGTGGAACATTTTCTTAATCCAGTCTATCATTGATGGACATTTGGGTTGGTTCCAAGTCTTTGCTAATATGAATAGTGCCGCAATAAACATACGTGTGCACGTGTCTTTATAGCAGCATGATTTATAATCCTTTGGGTATATACCCAGTAATGGGATGGCTGGGTCAAATGGTATTTCTAGTTCTAGATCCCTGAGGAATCGCCACACTGACTTCCACAATGGTTGAACTAGTTTACAGTCCCAGCAACATTGTAAAAGTGTTCCTATTGCTCCACATCCTCTCCAGCGCCTGTCGTTTCCTGACTTTTTAATGATCACCATTCTAACTGGTGTGAGATGGTATCTCATTGTGGTTTTGATTTGCATTTCTCTGATGGCCAGTGATGATGAGCATTTTTTCTTGTGTATTTTGGCTGCATAAATGTCTTTTTTTGAGAAGTGTCTGTTTGTATCCTTCGCCCACTTGTTGATGGGGTTGTTTTTTTCTTACACGTTTGTTTGAGTTCATTGTAGATTCTGGATATTAGCCCTTCGTCAGATGAGTAGATTGCAAAAATTTTCTCCCATTCTGTGGGTTGCCTGTTCATTCTGATGGTAGTACCTTTGCTGTGCAGAAGCTCTTTAGTTTAATTCGATCCTATCTGTCAATTTTGGCTTTTGTTACCATTGCTTTTGGTATTTTAGACATGAAGTCCTTGCCCATGCCTATGTCCTGAATGGTATTGCCTAGGTTTTCTTCTAGGGTTTTTATGGTTTTAGGTCTAACATTTAAGTCTTTACTCCATCTTGAATTAATTTTTGTGTAAGGTGTAAGGAAGGGATCCAATTTCAGCTTTCTACATATGGCTAGCCAGTTTTCCCAGCACCATTTGCTAAATAGGGAACCCTTTCCCCATTTCTTGTTTTTGTCAGGTTTGTCAAAGATCAGATGGTTGCAGATGTGTGGTATTATTCTGAGGGCTCTGTTCTGTTCCATTGGTCTATATCTCTGTTTTGGTACCAGTACCATGCTGTTTTGGTTACTGTAGCCTTGTAATACAGTAGCGTGACGCCTCCAGCTTTGTTCTTTTGGCTTAGGATTGACTTGGCAATGTGGGCTCTTTTTTGGTTCCATATGAACTTTAAAGTAGTTTTTTCCAATTCTGTGAAGAGAGTCATTGATAGCTTGACGGAGATGGCATTGAATCTATAAATTACCTTGGGCAGTATGGCCATTTTCACGGTATTAGTTCTTCCTATCCATGAGCATGGAATGTTCTTCCATTTGTGTCCTCTTTTATTTCGTTGAGCAGTGGTTTGTAGTTCTCCTTGAAGAGGTCCTTCACATCCCTTGTAAGTTGGATTCCTAGGTATTTTATTCTCTTTGAAGCAACTGTGAATGGGAGGTCACTCACGATTTGGCTCTCTGTTTGTCTGTTATTGGTGCATAAGAATGCTTGTGATCTTTGCACATTGATTTTGTATCCTGAGACTTTGCTGAAGTTGCTTATCAGCTTAAGGAGATTTTGGGCTGAGACGATGGGGTTTTCTAGATATACAATCATGCCATCTGCAAACAGGGACAATTTGACTTCCTCTTTTCCTTATTGAATACCCTTTATTTCTTTCTCCTGCCTGATTGCCCTGGCCAGAACTTCCAACACTATGTTGAATAGGAGTGGTGAGAGAGGGCATCCCTGTCTTGTGCCAGTTTTCAAAGGGAATGCTTCCAGTTTTTGCCCATTCAGTATGATACTGGCTGTGGGTTTGTCATAAATAGCTCTTATTATTTTGAGATATGTCCCATCAATACCTAATTTATTGAGAGTCTTTAGCATGAAGGGCTGTTGAATTTTGTCAAAGGCCCTTTCTGCATCTATTGAGATAATCACGTGGTTTTTGTCGTTGGTTCTGTTTATATGATGGATTACGTTTATTGATTTTTGTATGTTGAATCAGCCTTCCATCCCAGGGATGAAGCCCACTTGATCATGGTGGATAAGCTTTTTGATGTGCTGCTGGAAAATATTTTTCTAGTGGTCTTCATAATGCCTAAATGTAATTTCACTAATATCTTTCAAGTGCCTGAGGCTCCCAAAGAAGTTGTTCCTGAAAAGAAAGTGCCAGTGCCTCCTCCTAAAAAGCCTGAAGTGCCACCCACAAAAGGTAGACACCCTCTTGTTGCTGTGTTTGATATTGTTTGTTTGTCTTTACTTTGTCTAATAATGAAAATACTAATATCTTTAAAGTCCCAGAGGTGCCAAAGGCAGCTGTCCCAGAAAAGAAGGTGCCTGAAGCTATTCCTCCCAAACCGGAAAGTCCTCCCCCTGAAGGTAATGCCAAAGCTATACAAACTATAGGAGAAAAATAACTGTTATTTTAACTAGGAAATTACATGTTAAAAATCCTACTACATAAAGATGATATAATTCTAAAGAAAACAAATGTCAATCACTATCCAAAATATCTTGGTGGGTGTTTATATGCAAAAGGCATCCATCATTTTCACCTTTTCTAAACACAAATTACAAATATCTTTGAAGTGCCTGAAGTGCTGCCACCGAAGGAAGTGGTCCCAGAAAAGAAAGTACCGGTGCCTCCTGCCAAAAAGCCAGAAGCTCCACCTCCTAAAGGTAGGTATCATTACACATTGTCAGTCGGGGGGCCCTGGGGAAAGACTGTATAGAAGTGTCCGCCGATCTCACAAGTTGTATTTGCTTGGGTAAATGTGGAGTCGATATTCCCCCTTTATAGCTTCTAACTAAAAGATACTAATATCTTCAAAGTTCCTGAAGCTCCTAAAGAAGTTGTACTTGAAAAGAAAGTATCTGTGGCTGTGCCCAAAAAACCGGAAGCCCCACGTGCAAAAGGTATTTATTCCCTCTCCTCTGCTAAGAATAACTTACTGTCTGTACCCCTCACAATCACTGTAATATATACCTTCGCCATTCATAAATTATAAAAATACTAATATCTTTCAAGTGCCTGAAGCTGCTCAAGAAGTTGTCCCAGAAAAGAAAATTCCCAAGGCACCAATCAAAAAACCAGAAGCCCCCGCAGTTACAGGTACATGTCAGCTCAACCTTATCCTGCAGAAGAAATCTCTCTTCCATTCCTGAAAACAATTTTAGTCCATTCCTCTTCATTAACCTAAGTATAAAACTACTAATATCTTTCAAGTGCCAGAAGTTCCTCAAGAAGCCGCAGAAAAAGAAATTCCCGTGGCTCCACCCAAAAAACCAGAAGCTCCAATTGTCCCAGGTACACTTTAGCCCTGACTTCATTCTGCAGAAGAGATATCTCCTCTCCTACTGTAAACAATTTTAGCCCATTTCTCTTCATTAACTTAAGTCTAAAACTACTAATATCTTTCAAGTGCCTGAAGCTCAAGAAGTTGTCCCAGAAAAGAAAGTTCCTAAGGCTCCTCCCACAAAACCAGAAGCCCCACCTGCCACAGGTATTTTTTACCCCTGTCCTTTTTCTGCAGAAGAAATATCTCTTCTGATCTTAGAAATATTTTACTCCATTTGTCTCATTAACCTAAGTGAAAAACTACTAATATCTTTCAAGTGCCTGAAGTCCCACAAGAAATTGTGCCAGAAAAGAAAACACTGGTGCTTCCTAAAAAGCCAGAAGTTCCACCTGTTACAGGTACTTGTCATTTGACCTTAAGCTTCAGAAGATCCAATTCCTCTGCTGTATATTTTGCTAGTAGTCTCCATAGCTCTACATGTAACTTTACTAATATCTTTTAAGTGCCAGAGGCTCCCAAAGAAGTTGTCCTTGAAAAGAAAGTGCCCTTGGCTCCTCCTAAAAAGCCTGAAGTCCCACCTGTTAAAGGTATTTGTCACTGACCTTAGGCTTCAGATGATCTAATTCTTTTGCAGTTGAAGACATTTTGTTCCAGTGGTCTTCATAACCCCTAAATGTAATTTTACCTAATATCTTTTAAGTGCCAGAGGCTCCCAAAGAAGTTGTTCCTGAAAAGAAAGTGCCAGTGACTCCTCCTAAAAAACCTGAAGTCCCACCTGTTAAAGGTATTTGTCACTGGCTTTAGGCTTCAGAAGACTGAACTCTTCATTTCTTGAAAATACTTTTCTAGTGGTCTTCAAACTTCTAAATGTAATTTCACTAATATCTTTTAAGTGCCAGAGGCTCCCATAGAGGTTGTTCCTGAAAAGAAAATGCCCTTGGCTCCTCCTAAAAAGCCTGAAGTCCCTCCTGTTAAAGGTATTTGTCACTGGCTTTAGGCTTCAGAAGATCAAACTCCTCTATTCTTGAAAATATTTTTTCTAGTGGTCTTCATAACCCCTAAATGTAATTTCACTAATATCTTTTAAGTACCAGAGGCTCCCAAAGAGGTTGTTCCTGAAAAGAAAGTGCCCTCGGCTCCTCCTAAAAAGCCTGAAGTCCCACCTGTTAAAGGTATTTGTCATTGAGTTTAAGCGTCAGAAGATCTATCTCTTCTACTCTTGAAAATATTTTTCCTAATGGTCTTCATAACTTCTAAATGTAATTTCACTAATATCTTTTAAGTGCCAGAGGCTCCGAAAGAAGTTGTTCCTGAAAAGAAAGTGCCAGCGGCTCCTCCTAAAAAGCCTGAAGTCACACCTGTTAAAGGTATTTGTCACTGATTTTAGGCTTCAGATGATCAAACTCTTCTGCTCTGGAAAGTATTTTTCTAGTGGTCTTCATAATGCCTAAATGTAATTTCACTATTATCTTTCAAGTGCCTGAGGCTCCCAAAGAAGTTGTTCCTGAAAAGAAAGTGCCAGTGCCTCCTCCTAAAAAGCCTGAAGTGCCACCCACAAAAGGTAGACACCCTCATGGTGCTGTGTTTGATATTGTTTGTTTGTCTTTACTTTGTCTAACAATGAAAATAATAATATCTTTTAAAGTCCCAGAGGTGCCAAAGGTAGCTGTCCCAGAAAAGAAGGTGCCTGAAGCTATTCCTCCCAAACCGGAAAGTCCTCCCCCTGAAGGTAATAATGAAACTATTCAAATTAGTGTTTTTTAAAAAAATCTTTCCTTAGTGTTGTAAAAACATTTTTTTGCAAACTATCTCAGTTTTAGTCAATTCTGGCATTAAAATGAGCTCATGTCTTTAAAGTGTTCGAGGAGCCTGAGGAAGTTGCCCTAGAAGAGCCTCCTGCTGAAGTTGTGGAAGAGCCAGAGCCAGCGGCGCCTCCACAAGGTACATGGCAAGAAAGCTGCTAGGACACCTCGGCCACTCTTTCCCCTTCCTGCCCTGATAATTCTGGGTGCTCTGAGCTTTTGTCTTGTTTCTCAATCTTCGTTCTTTCTAAAACATACCTTCTAATTCTTTAGTGACCGTACCACCTAAGAAACCTGTCCCAGAAAAGAAAGCACCTGCTGTCGTTGCCAAAAAACCTGAACTACCACCAGTGAAAGGTATTCCTCACTGCCACTAACTCCCTAACAAAAAACTTTCTTTGAAGTGTCATATTCTACTGTTCTGCTTCATGATTTTCACATTTCATTGAAACCATGAGCTTAAACAACTACTAATATCTTTTATAGTGCCCGAGGTGCCCAAGGAGGTTGTTCCTGAAAAGAAGGTGCCTCTGGTGGTTCCCAAAAAGCCAGAAGCCCCACCTGCTAAAGGTATATGTGGCTGTCCACTGTTTGATGGGGGCGGATGGAGCCCCCAGCTTCTAAAAGGGTTTTGTTCTGTGTAAATGTGATGAATGTTTACTGGTGATTGTTTCTAATGTTAAAATACTAATATATTTGAAGTGCCTGAAGTTCCAAAAGAAGTTGTTCCAGAAAAGAAAGTAGCTGTTCCCAAAAAGCCAGAAGTCCCACCAGCAAAAGGTACATGTCACTAATGAGATTCTGCAGAAAAGCACTCACCCTTGTCTAATAAGTCACCTATTATCAAACCTTTTGTTTGCGAGTCCTCTTAAATTTGCAACTACAAAACTGTCATTCTGGATTTTTAGGGTCTGAATACTTTTTAATAATTTTTTCATTGACTTTAAAAAGTGATATATTTACTTATTACAAGCATTGGAAAAGTTTACTAACTTGGTTCTTTTATTCTTAATAGGCCATATTTTCCTCCCCACTATATGAGGGTCCAAAGACAGATCACTGACCTTATTGTGAAATTTGTTCTTGGATCTGTCCCTGGGTTATTTGAGCAAAATGTGAAGTCGATGTGGTATAAATTTAATATACTTCTCAACTACTCATAAGAAAAATGAATTAATATCTTTAAAGTGCCAGAAGTGCCAAAGAAACCTGTCTTGGAAGAGAAACCAGCTGTTCCTGTTCCAGAAAGAGCGGAGTCTCCTCCCCCAGAAGGTACACGTGAGACCGGTGATTAATGACCTTGCCACTTGCGACTATTTCTAATTTAAGCTTTGTTCTTCTTCCTTCCTAACTCATTATTTCTTGGTCATTTTCTAACCTTTAATTATTTGTCTTAATTCATCATTCTAAATTAGCTCCAATCTCAAATCTATTTTGGGTTATTGGTCCACAGTATCTACATAAGTCATAGTAAGCTATATTAAACAAAGCTTCTCCAATGTACATAGAAAGTAAGGCAGGAGAACTAATGATTATAAATGACATTAAACACTAAAAGGGCTTTGCAAGCATTTGAATCAATAGACAAAGAAGTCAGTGCAAATGAGATAGATTTTATCTAAACAAAAATAAGAGAAGGTATCAATTGAAACAAAGGAAGAAATCAAGATTACTATTTATCGTGTTTAGTGTTTGTCCATCTTAGAATATTGTTCCATACATTGAAATAAAATTAACTAATATCTTTAAAGTATATGAAGAACCTGAGGAAATTGCTCCTGAAGAGGAAATTGCTCCTGAAGAGGAAAAGCCAGTTCCTGTTGCAGAAGAGGAGGAACCAGAGGTTCCACCTCCAGCAGGTACAAAGCAGAATCCACTGTATGGGAAAATACAGTCATTTCATTTTTCATGTCTATATATCTTCCTTAAGGCAAAATATCAGTCTTGTATCTTGTTGCCTGAAATCTGACTACATTAAGAACAAAAGTTATTTCTACACATAAAACTTTGGACCCACAGAATTTGGTCCCACATATACCAAGAAATATGTGTGGTTTTTAATTCATTCATTAGCATTAAATTTTTCATTGTAATCACCTAATTCTAAAAGAAATTCCTATTATTCAAGTGCCTGAAGAGCCCAAGAAGATCATCCCAGAGAAGAAAGTTCCTGTCATCAAAAAACCAGAAGCACCGCCTCCTAAAGGTACTCATGTTAAAATGAATACTTCATTTTTGTGGTGTCTACAATTTTACACTCTTCTTATTGTGTGTTGTGTTGTATTATATGTTTGTTAACTCTTACCTATATGTTACAGTGTTGAATAAACTTGTATGTATATCTTACATCTCACAACTTTGTATTATTAAATGCTACTGATATCTTTAAAGAACCTGAGATGCCAAAGAAAGTTGTTCCAGTGAAGAAGGTCCCAACTGTTAAGAAGCCAGAAACACCAGCAGCTAAAGGTATTCACTTCATCGTTGGCATCATAAAAAAGAAAGTATTCTGATATCTTAAAGTGGAATCCAATAAGTTGTCCTCATTGTTGTTGCATAACTAAGGACAAAAATTTCCTTATTTTGCTTTCATTAATTTTAATGCTGCTCCAATAAATACAGGTTTTTTATTCTTAATATTTTAAAATGTTTTTAAATACTATTTTTAAAACAAAACTAATATCTTCAAAGTGCCTGAGGTGCCCAAGAAACTTGTTCCAGTAAAGAAAGAACCTGTGCCTGTTACCAAAAAACCAGAAGTTCTTCCAGAAAAAGGTACCTACCATGAAGAAAAAATAGATTTCTCTAACTGCTATTTAAGCATGTTAATAATAGGTCTTAGAGAAAAACATACTGAATGTGAATTTATGTTAAAACCATATTGCACAGAAAAAAGGGAAATAATGAAGGGAAAAAAATGAAACAGACAAGCAGGAGTGAAAAAATGAGTGGGATTCAGTTGTGCTGTGATATATCACATGGCTACAACTAGTAGAAAAGAACCTTCTCTCATTCAATGTGTAAAACAGCTCAATTCAACATATTTTGTTGAATGTTGACCATTAACAAGACATCATATTAGAAAAATTAAGGCCTGATTCTGTCTTCAAATAAGTTAAATCTGGTGAGAGGATAGAAAGATAACAGGACTCTAATACAGACAGGAAGTGATTACACATAGCAAGTGAATACAAAAGGGCTGCAGAAACACACGGCAAGAAAAGATTAAGTTCAGGCAGAGGCATCATGGGAAGCTGTGTTAAACTGAATTTAAATTTTGATGGACTTTTACATGTAGAAATTGAGGAAATAAGGCCGGATGTGGTGGCTCACGCCTGTCATCCCAACACTTGGGGAGGCCAAGGTGGGTGGATCACTTGAGGTCAGGAGTTCAAGACCAGCCTGGCCAACATGGTGAAACCCCGTCTCTACTAAAAATACAAAAATTAGCTGGGGGTGGTGATATGTGCCTGTAATCCCAGCTACTTGGGAGGCTGAGGCAGGAGAATTGCTTGAACCCAGGAGGCAGAGGTTGCAGTGAGCTGAGATAATGCCACTGCACTCCAGCTTGGGTGACAGAGTGAGCCTCTGTCTCAAAAAAATTAAAAAAAAGAAATTGAGGACATGATATCCCATGGAAAGGGAAGAGCATATTGAAAGGCACAGAGATAGAAGGGTCTAGAATGTTCAAGGATTGTCAAGTAAACTTATGTCAAGTAAACTCAATTTGAGTATGGATTGGCTGTGGAATGTCTTGAAAGATAATACCAGATATAAAGATGGGGTCATATTTTGGAGTACTTCAAATGCCAGTAAAAGGCTTGTACTTTTTTCTGTAGGCAATAGGAAGCTTCAAAGATTTTGAAGCAGGCTTACATATTAATAGGATTTGGGCTTTAGAAAGATAACTGGCAGCAATTTCAGCTACTAAATAGTAAAGACCCATTGCAATTATTTAAGGTCTTTAAGAGTTGGACAAGATCCGTGGCGGCAGAAATGGAAAGGGGGACTGGGTTTGAAAGAGATGGAGACTTAGTGGCCTCTGACCATTATCAAAACCATTAGGGAAATTGAGGAGCCCAAGATCATTGTAAGGTTTAAAGCTAGATGGCCAAAAGAATGGTTCATTGGGTCTCTGAACTAACGTTAGAGGAAAATGGTAGATGTGCTTTTCACCTTTAAAGCATAAAAGTTGGGAGTGTGTATCAGGAGCTTAAGAAAGAGATCAGGCCTAGAGATGTAGATCTTAAAGTCATTCACATGTAAATAAGAATTGAGTGTGCAGGAACAATTACTCAGAAAATGTAGAGCAAATTTTTTTAAGTGTCAAAGTTAGACCACCTTCATTTAAGTGTACACAGAGGACTAGAAGCAAATGAAGAAAGCTGAGAAGATTCATATATAAAATTAGGATGTCCAAAATGGTGCCATGTCTCAGAAGCCATTTTCCCCATGAAATCTAAGATGAAGCTCTTGCCCCTGCATTCTTTGCCTGCTCTTTAGACAATCTTGCATGTCTTCTAAATTCTTAATAGTAAACAAAATCATATCTTTAAAGTGCCCAAAGTGCCTGAGAAAATCATCCCAGAAAAGGAAGTGTCTGTGCCTATCCCTGCAGAGCCAGAAGTTCCACCTGCTGAAGGTACACGGCTTCTCCATAAATCTTGGAAAGATGACAATTGTCTTCATCCTCTTGCTTTGATTGTAGATGAATCTTACGTATTTGTCTGTCTGTATTGAAGTTATTGATATTTGGGGGGTCATCTGAATAATCTGTTATAGAGTGTTACTTAATGTAACTAGGTTGATATGTTAGAATAGTAGTTGCAGTATTCTGTTCTAAATATAGTCTAAAATAAAATACTATGTTTTTTAAAGTTGAAGAGACTCCTGAGGAAATAATATATGAAGAAAAAGCATCTATAACCATTGGTAGAAAAGAGACTCCCCCTGTTGAAGGTATATATATATATATATATATACATTTTTTTAATCTCCTGAAGATTCCTGTTAGAATTACAAAAGCATTTACAGGACAATATTCCTTCTTGAAATTATATACAAGAGCAGTCTAGCATGTTTGACTGCTTTATTTTTGAAATAGTTACACTTCTTTTAAGTTAGAATCTTTAATTTAGTTACTGTTGTTGGTAATTACAATTTCCAAAAGGTACAGTTTACTGAAGCAAAATGGAATAATTGCCTTGGATCCTCAAATGATAACACGGTATCAAATTTTAAAAGTCATCTCATTTGCCATCAATATACATTGAATAATCTAATTAATAGGCAGTTCAAGTAAAAGAACTTTTTCTTATACGTGAATTTTTCTATACATGAATTTGTATGAATTGTATATTTTTATTTTGTGACTGTAATCTTTGCATCAATGTGAAATTTGTATGAGTCTTTTTGAAGAACTTTACATTGCAACCTCATCTCCTTTGTCAACATTCTTTAAAGAACGTGAAATTGAAAAGTATATTAAACCTGAAGAGCCCGAACCTGAACCACAGCCTGAAGAAATACCAGTAAAAGGTATTCAATCCAGTGGACTTAAATCTTCTTTATCATATTCTTTCTCTTGAAATGTATATGGTTTATGTTGTTGTACATATGTAGTATGTCTGTTCCCATTTGTATGTAAAGTATTCTTTGTTGTAAATGTGAGCCTCATTCTTAGGTTTCCATGTAACTTGTACTGTTTCTCTCATGTCAACTGTGGCTTGTCTGGATGCTTTGTTTGTTGTTGTTATTGGTGCCTTTGCTGTATTTCTCATCATCTTTGTAAAGGGTTGATATTTTTATGTTTTATGTTCTGTGTTTTATGTTGGATACTGGTATTACGTACCTTAAAAAGTAAACTTTGTACTTCATATATATATATATATATATATATATATATATATATATATATAATTTCTATTAAATATACTACATATCCACATGCTAACATATACATATACTAACACCTCTGAAATACTCTTTCAAGAACCTGAACCTGAAAAGGTTATTGAGAAGCCAAAACTCAAACCAAGACCCCCACCTCCTCCACCTGCTCCACCTAAGGAAGATGTGAAGGAGAAAATATTCCAACTTAAAGGTAAAAAATGCCACTTCCAAAGTTTTATTAGCCTGCTTCAAACTTCTATCCAGCCATCTGAAATGATGCTTGCAAGAAATGTATGACTTTTAGAAGTGTGTACTTTCAGACATGATTGTACTGTGAGATTGCATAGAGCTGTCTCTTCTGCTGCCCCATGGTTCCTGGGTTGCTTGTCATGCCATGCCTGCTGCTGCAAAAGTCAGAAAGTACATTGATAGCGTCATCCGGGATATCTGAATGCAGGCACTGTCCAATTAACTTTCTTTTGTGGAGTGGGGAGAAAGAGTTTTCTGATTTCAAAGCCTGATTGCTATACATATCATTGCGATCTTATGCTTAAGGAATGTATAAGAAATCCTTGCAAGATATTTTTAATATTGCAGTAACACATTTACATAAAAGCCAAAACTTTGTTCTTAAAGAATTGCATGTGCTTTTAAATATATTACAAGTAATATAGTTATGATTTCCAGTAGCTGATATGTGCCTATATATCATGAAAGGAAAGCATATGAATGACTTGTTACAGTTCCCCCATCTCTTTTTTTTTCTTGCAACTTAAAGAAGTGTTCTGTGTGGTTCTCAGGGGAGCTGGAAAGAGTGGTTATGAAGACATTTGGTATCCAGCATTTATTATTAAACTTCCCTTCCCCCTTCTTATATTTTGATTTTTCTATGAATTGACACAATGTTACTTAATTTTAAAAATATCAGTTTCTTTAAAAGCTGAAATAAACTGGCAGAAACATATTATTCTTATTTTAATAAAAAGTTGTCTTGTGACGTCATATGATTCCCCAATCTAAAATTATCTAGATATAATCTTAGATATGCACTTTCCCTATACAGACCTATGTATCTTCAAACCACAGTCTTCCAGCATAAGACATTGCTGCTGGTGATTCTTGCCCTCTACAACCCTCATAGCCATTAGGGGGACCTTCTGGCACCTCTTGAAAGGCCACCCATCTGTTAATTGACACTCCATGAAGACACACACATAAATACATTTCCCTTAATGTAAAATATATGCTTAAAGGAAAATTTCTTCCTCCTGCCAATAACAAAAATTGTCTTCTTTTTCTGCTGGTCTTTAATTAACTACTGAACTTTGGAGTAAAACTGCAGTCTGTTTTCATGGTTCGAATGCTGCTTGTATGTTCTTTGAAGGCTGTTCTTGGCTGTTATTAATGCTTTCTGGTTATAAGCAAAGCTTGGTTTTGATTCTTGGAGTAGAAAGTTAATCACTTGCTTCAGATTAAATATACAAATAACAAAAGTAAAATCATATTCTTTAAAGCTATTCCAAAGAAGAAAGTTCCTGAAAAACCTCAGGTTCCAGAAAAAGTGGAGCTTACACCTCTGAAAGGTATTTCACAGGCTGAAAAATACATACTTATGTAGTACCCCTTTACCTGACTCCTTGCTCTTTCTGCCTCCATCGAATGTTCTGTCTCTCTTTTTCAATGATCAGAGAGTAGTCCCATTCATTTCTTATATTTCTGTGGCTTTTATGGTCCTGGCTCATGAGTGTTGCTTCCTTTGTCTCCCATCCATTTCATACATGTATAGACATGGTCTATCTTTGTCTCATCTACATATGTCTTCTTGCATTTTCCTAAACTTAAAAATAACAAATTTTACTGGTTAGCCAAAATTGATATCAAGAGACATATGAGATTAAAATGCTGAGAGCTAGTAGTAAACTGTTTTGACATTTCACCTGACATAAAAATTTTAGCCAATGTAATAAGCACTAAAAATAAGTCCTATCTTCCTTTTATATTATTAAGGTTATTTGTAGGGATTTCCTTAGGACTTTCATGTCACTCTCTTCTCACTGGCTCTAAGTCATTCTCTGAGGGGTACGGAACTCACATTTCAGAAAAATTTCCTTATTACTGTAGGTAATTTTTCAAAATGTATTTTTCTGTAAACAATATTTTCCCTAATAAGGTCTCATCTAAAATTAGACCCTAAAGAAAACTAAATGAATTATAAGAGTCTAGAAAACATCTATCAAAAATAAACATAATTTTTCTAATGGGTAGTAGTGTTCTGTTCAAGTAATCAACACATTCAGACCTAGAAATTAAGACTGTTTCTGGTCACTCTGAAATTTTGGGGAAAAAAGTCACCCATATAAATATACATTTCCTGATTTCATAAAGAGGCAATTACAAAATAATGTTATCATGGATATTGATCATAAACATTAAAATAGCATATAATCACATATAATGACTTTAAAAATAATAGCTACAATGTTGGGTTCTCAAACATCAATAAGATTTTTAAAATCAAATAATAATATAAAAAATGCACAGATATATTTTCACTATGTTCATTATATCAGTAAAGAAAATCTATATTATGCCTCCTCACTTTACATTAATTAGATGCATGTGCTTCCTTCTGGGTTTGAGCAATAAAAATAGTTATTAAGAAGATTGGTACCTCTAAAATAGTATTGAAGGCCAACACAATTTATCCTGGATAAAATACGTAATGTTTAACTTTAAAATTTTTACTTAAAATATTTGACATTAAAAAAATGATTATTCAAAACGAAATACATATTTGCCTATTGTAGGTTTAAATTTTTGAAATAAGAGTTAAGCAGTTATCTTTATCACATAAAAAACCATTTAATGAATTGCAAATATCTTGTTTAAAGCCCTAAATAGGAAGTTTTATAGAAATATCTAAAAATTCAGATTCCTAATAGCAAATAGTTACACAATACAAATAAATACTGTTTTAAATTAGATTTTAATTGACATTAGTAGAGAGGAAAATGGTTTAATAATCACCACGTGTTCCTTTCTTTCACCATTCAAATCTATGAGGGCCATAATAGCAAAAGAGGCTGCTCTATAAAATAGCATCATCCACCATGCTCAGTATTCACTGTAGACGCAACAGGAAATTTTGAATTCCTTGCGTTCCTTAATTTGAATGAATTTAAGAACATTTTCTTATTCATGAAAAACGAGCTTCCAACACCAGCTTTGAAATTTTATAATTCTATAATTTTAAATATTTTATCCAGCATTATTTCAAAAAGGAAATCTTAAGAAAGGCTACTCTTCTTCTGTTCAGAAAGTGAGATATGGCCCTTCCCCAGCATCAAAGTCACAAACCGGAACTCTTGGCCACCTTCTTCCCTCAGTGGAGAAGACTGAATGATGGCACTAACACTTGCCAGTATCATTTTCATACATTTAGTGGTTGGGTAGATAACATCGTAGATTTGGACAATCTACAATTGCAGTTTGGGACAAAGATGCTGTCAAGAACCCTGTAATTTGATGAAAGATTCATAAAGTCAGTATGGAGCAACATCCTCTACATGCATTTAAAATGAATACATTTGCCTGCAGTTAATGGAGTTGAATTTCATCACAAGGCTGTATAGATATTTGCAGAGGAGATAACTTGAAATGTATCATTTAAACTTAAATTCTGTGGTATTTATATGCAGCGAAAATTGTTACTTAATGCACTACAGTTAACTAGTTTTAGGAGAGACATTTTTCTTGTTGAAATTCCGTTTTTATATAAATTCACTTCAAAATTTGAAATCATATTCTTTTAAG
>TTN-203,,0,921,509501,510421,GTATAGTATTTTTCAACCATTCTGTCAGCGTTAAGTATATTTTAAAAATGAACTTGAAAGCTTACAAAATGTTTCTGTCCTTTGGTTTTCTTTGAATTGGTTCGCTATTTATCAAAATTTGTTTGTAGTTTCATTGAAAATTAAGAAAAATGTCATTTCCAGATCTTTTTTTTTAAAAAAAAAAGACAGAAATTTTGTGAGCATTCACAGTATTTTGAAATTTAAAATGTTAATAGACATAACTAAGTTGATAATATTCTAAACTAACAACAACTATGACTGCCATTTTCATAACCAAATTATGTAGTAAAGTACACTAAACCTATTAAATACCTTACATGAAACTACTTTAGCTTAAATTCAATATTCAGTTTTAAAGTGTGACACAGGATCACCACAACTAATAAATAACATTTTTAAAAAACTGAACATTTCTTTCTGACTAATAAAATATTAAAGAATGAGAAACAAGATAGTCAAATGAAGAATTAAGTTCTAACATTGTCTTCACATAGAATTACTGATTTTTAGGCTACATTTCTTCAGATATCTCTGCTTAAGTAAACTTTCTACTTATTTACATACTCATTAAATCATTAACATTTAATTATTATTATAATTCGTTGCTATTCAAATTATTCATTTTGTGTTGGAGCTGTTTCTCCCACAGACTTGTCTCAGAATAGACCCTCTATCTAGATAGAAACAAAGTAACTTTGAGTGCTATTATAATTGACAACCTTTGATTTTAAAAAAAACAAAACAAAAAACACTTTCGGTGTAAATGCTTACTTTCCAGAGTGCTAGGTAGCATGCTTTTTTTCATTTTCCTTGCTTTGTACATTATTTGCATTTGTCAAGCTTATTCAACATCTTCATTAGTTTGTCTTGGTTTACATATAAACCTTTTTGTCTTTAAAG
>TTN-203,,0,610,510422,511031,GTAGGAATCTCAGTGACAATTTGTAAGATTATCTTTTAACAAAATGGACATTTAACAAAAGGTTTATCTTGTAAACATAAATGAAGTTAGATGTAAACATGGCTTCATATTTCATCTGTGATGTAGTCTCTGTTTTCCATTGTCTGCTTTCTGTTTAAATATTTTTATAGTAATTCCCAAATCCATTCATGTATTTCCCTGCACTTCATTCTTATCATTACTTTGCAACTTAAGTTCTTCCAGTAGAAATGACTGAAATAATCAAGTGGCTATTCATGGGAGGGTGTCAGCAAAGGTTTCATAATCTGGGGGCTTTTAAATGGGTTGGTTTTTATCATTAGCCTATTCTCAAAGGGCAAAATTATTGGGAACTATTATAGAAGTGATTTAGAAGGAGAGAGCTAAGGGGAGTGGAAGATAAGTGGATGGAATAAAAGGAAGAAAAATAAATGGAAGCAGAGTCAAGAAAATAAAATAGAAATTACTTGATAAACTATAAGGTTTTTTAAAAAACCATCCATAGAGTTTTTGAAAAATAAATTGATATTTCAGATGAGGTGCTTCCTAAATATTCAAATATTAACACTGAAAAAATAATCTTATCTTAAAG
>TTN-203,,0,430,511032,511461,GTACAAATCTACTGTCATTCTTAGTTGTCTCTAAAAATGCAAATATGTATCATTTAAAATATCATTACACTGACATCAAGATTTGAACACATGACCTTAATCTGTTAATCACATATGGCTTAATTTTCTTTACCATCTCACTCTCCTATGCAATTGGCTAATGATTACTCAGTTGCTAAATAAGTTACCTGAAAAAAAATTGTATTTATGGGCAATGAGATAAATAACAACATTAAAACCAAGAACATTGCCTTACTATATTTTCCAAATATTTTGTTTAAAATGAAAACTAATCAAATACTTGATTTGATAATTATATGTATATAAATTCTAATATCTTCCAAGATACGTGGGCTTAATTTTAGTTTTGACTTTGTGAAAAACTTCAAAAATCCTGTAATAATCTGCCCTCTACTCTAAATTATTTCAG
>TTN-203,,0,259,511462,511720,GTGAGCAAGCTTATCCTCAATGTCAACAGCATATTCTTTCTGTATTCACACACATAACATGTACTTAATAAAAGATAGTAGGTGAAAGTCAGTATGTATCAAATGATTTCTAACGTCTCAAAATGCTTAATATACTATTCTCTTAAAAACTAGTTATTTGAAGATTTCAAAATTATATCAGAAGAGGCAAATAAGCTACCAAATAAGTTTTTAGGAAGTGACAAATTGATACACTAATGCAATGGACTTCTCTCTACAG
>TTN-203,,0,2279,511721,513999,GTATTTATCCTGTAGCTTTCTTTTTGCTAGTTTGTTTTGGTGACTTAATAAAAGTATTCACACTTGATTAAAATTCAAGCCCTGTTTATGCTGCAACATAGGTATCATTTCAACTTCGGAGGTTTATGGTAAGTTTCTACCTTTTCTTCATGTGATATCCTTTATCCACCTTGTCTCTTGCCCAGTGGGTGAATATTGTGCCTTAACTGGAATGTACGTTCCTGGGTTGCACCATTTCTTTCATATGCTTTGGAGATTAAGTAATGAATATGTTTGGGGCTGATAAAAACTAAGGAGACAGGCAGAGACCCTGTAAGGGTATACATATAAGAATCCCATGAAGCTTCAAATTTCCCTTATACCCTATTGGAACAATTTCTCTTTTTTAAAAAAGTGTGTATATTGGGATAATGTAAAAGTTCTGGAAATGGATAGTGTTGATGGTTGTACAATATTGTGAATGTATTTCATGCAACTGAATTGAATACTTAAAAATGGCTAAAATGGTAAATTTTATGTTAGGTATATTTTACCACAATAAGAAAGAAAAAGAAAAAAGAGACTCCATATTTCAGTCTTTTAATCTGTATAAGGAATTAGATCAATAATAATTTTCTTAAATGTTCTAACTTAATGATATAGGTATCTCAAGTCCAAACTTAAAGCACCTATTAATTGTATATGAACTATTTAGTATAGTTCATCATTTAAGTGATAATTTGAGATATAATTGATCAAAACTGATTTGATGTGTAATTGATAGTCATTGATAAACATACACATCCTGACTATTTGCCCTTTGGCTCACTATCTGGGTGATGAGATCACTCATATCCCAGACCTCAGCATCATGAAATATATCCACATAACAAAACTGCACATGCATCCCATGAGTTTAAAATAAAAGTTGAAATTATTTTTTTAAAAAAGAAACAACAAAACCAAAAATAAAACAAAGTAAATTTAAAGCGGGGGCGGTGGTGGTGGGGTGGGGAGAAGGCATGTATTGATAATTTTCTAAGATGTGAAGAATCTAAGATATTCAATATAATGCCTTGACAATTTGTTCCTATGGAAAAATGATCATCTCCACTGATAAAGCACAAAATAAAAAATTCAGGGTGAATTTAAAAAAAAAAAAAGAGAACTATTTGTTACATTCCACAGTGAGATGTGCATAGGCCCCGGGAATAACATTTAGAAATGTCCATAATAGTTTGACAGAGAAATTTTTTAATTTAATTTTCTGAACCTAATAATAAAAATTGGCTTATATCTTTAATAAATCAATAAATAAAACTATTTGGAAAAATTATATTATTTTAGATTATTAATTCAATAATTAGTCATTTTATATTTGTTTATATATTTTTATATAAATTATTTAGAAATTTTTTTATTTAAAATTATCTCAAAATATTTGGACATTACCATGTTTAATGACATAAAAAAATACACTATATTCTTTTGACTGTAGTTTAATTTTTAATATTTGTGTTATATTTTGTTGCTGATGTTTATGATTTGGGCATATTCTTTTAAACTTTTATAATGTCAACGTAGTACTTTTATTATTCAGAAAAAGGTGATGAACTGCTCTTGTCTAATTAAGTATGTATAAAAATAAAGCTATTCTCAGTTATCCTGGGGGCTGAAGCTAGAGAACTCATTCCACAGTTTATACTGTCCCTGTATTAATAATGGAATCAAACTCTAAATGTCAGAACTCTCTTGCTTCTGCCTTACTTCATTGTCTAAAGGAAATCTTCAAAGAAACTCATGCATGTGTGGTACATGGACTCTTTTTCCTTAGTCTTCCCTGGATTTGTTTGTCTGCCCAATTTAGACATAAAAAGAAAGGCTTTTGGTAACCTCTCAGCCATTTCCCTTTTCCCTACACTGATTTATTGACAAAACCTTATTTCCTTGGTTCACATAATCAGGACTTACATAAACATATAAAATATTTTGCACAGCTAGGCAGGAGCAAAACTTTTCCTCACAAGGCAACAGTAAGCCTTCCAAAAATGGGAAGATAATAAGGCACTTGCTGAAAGAAGTTGTTAATCCTAAATATGTTGGCAGTTTAGCTTGAGCTCTTCAGTCTCAGAATATGCCTTCCTGGAAATGTGATTATCCATAGAAGTCATATAAATGAAACCAATTTCTCTTTATGCGTTAATATTTATAATGGAGCATGACTCACCCTCCATGGTTTACTATTAAACATGAAATAAGTCCGAAAAGTGTTTAAATGCTGAGTTTTATTTTTATTTCAG
>TTN-203,,0,569,514000,514568,GTGAAATTCATTTTTCTAGTACTTGCATTGTAACCTTCCACTCTGAATTTCCAAAGTTCATATTCAAGGGGAAAAAAATTTCAAAATTCATAACAATTTTTATTTTTTCTAATTGATTCTACTAAAACTAGCATGTTTTCTGATATTTCAAATAATACTTTTAGTATTATGCAAGGAGATATATATATATATATATATATATATATATATATATATATATATCCAACTATATTTTAGCATAGTGAATCCCATAAGTTCTTAGCTTCATTTTTCATATGCATGGTATTTATACATGGCAGATAAAATAATTAGACATTAATCTGGCTATTTTATACTTCAGATTAAAACTTGAGAAAAGGGACATTTATTATTCATGGATTCCTTATACCATCTCATTTTCCTGCCTGAAACAAGGCAGTATAAACTCAATTGGCCTTTCAATTGCCTGGTCTTTAGTTTTCTCGTCTTCTAATTGCTTTACGGCTGGTTTTATCCAGCAGGCAGCCAAGTATGAACTTTCTGACTCCTAAGGAGATGCCAAATCAACTTTTTATTTTACTTTGAATTAG
>TTN-203,,0,156,514569,514724,GTAATTTCTAGTCTTCTGAACATAATCTATATTAAACTTTAATGTAACAAACCTTAGTAGCAACTTGCATTGTAGTTTTACAAAACCTCTTATTTCCAAGTTTTATTTCATTGAAAATATTGTATTTATTGAAATATATACTGAAATTCTCCATAG
>TTN-203,,0,247,514725,514971,GTTAGTACTTTCCTGGGAGATTTCGTTCTGCTTATTGTTACACTAAGAAAATGGAAGAAAGGACCTCGTTTCCCAGTATTACAATATCAGAAATCTTGTACCTAAGAGGGGAATAACAATATATCCTACAGTGGATTAATTATGCCCAGTATTGTGAAATTTTTCCTATTCCTGAAATTTACTAAGGAAGCTATGTATATTACTTGTTCAGACCTTAATCATTTTTTCTGATCTTATTTTCATATAG
>TTN-203,,0,135,514972,515106,GTATAAAATCTTACCTTTTATTCAAATTATAAGTTTTGCGTATGTGTAAAGCCAAATAACACACCAAAACACATAAAAGCAAAGCATCGTTGGGTTGTCTAAAGCATTATGTTACTTCATCCCTGACCAATACAG
>TTN-203,,0,315,515107,515421,GTGAGTAATTTCACATTTTAAATTGTTAGTCATATAAAATAACCACATCCAATATTCAGGATCTATATCCTAGATTCGGGTTGCTTTAATAATAATGGAGTTAATGGAGTCTTCTAAAGTCTCCAAGAAGGAAAGAAATTTTACGTATCATTTGGGGACAACTTGAACAATTTGTGTAAAATGTTATGACAGGGAATTCTCTGCTTACTTTTATTAGTAGTAATTTTTAAAACTCTATAGAAATTTGTATCTGAAACACTTCTCCTATAGGGAATTTATCTCTTTCAAATGGTTACTAAAACTATTGTTTTTCAG
>TTN-203,,0,93,515422,515514,GTATGGGGCTTTTAGAATTTGGGGAGGGGTCTCAACTTTATTTCACTTCCCTGTGCATTCTGAAAAGCCTCATTCTTAATGTCTGATTTTCAG
>TTN-203,,0,282,515515,515796,GTAAGCGAGCTAATGAGATCTGTGACATCCCATAAAGGCATGCAAATATATGACTTTAAAGATAGGACGCCAAGTTCTAAAAGCTGTGATAATGCATCACTAATTAACTTTCACAGTGTTACCAAAACAACCCCCCTTAATTTGTTTTTAGTGGAGCTCTATTTGGAAAGATGAATAAATAAGTGCCATGTGAAATGGGTCCCTTTTACTCAGGCAGATTAGAATGGAATCTTTCTGAAGGTGAATTGTGTTTCTGAGGCATTATCTATGCTTGCATTTCAG
>TTN-203,,0,140,515797,515936,GTAAATGTAACCAAGTATAACCAGATAGCCAGTTTCTGAATCATGGGAGTGGGGAGTAATAAAATATTTTGCAACCTTTTACTCTTTAATAAACTTTAATTTTCACATTCTTCTAATTTTATGCTAAATGTCTTTTACAG
>TTN-203,,0,86,515937,516022,GTGAGTTGCTCAACAATGTAAAATTTACCCTATCTGAATCTGCAGTTTATTAGTTCAGTCATGCTAACAAAACTGTATCATTTCAG
>TTN-203,,0,142,516023,516164,GTAAGTCAAGATTAGCTAATTATATAGGAGAGGGGTTGCTTGGTTGTGTAGGGTGAAAAAAGGCATAAAATATCTTGATGATTTGTAGGAATAACTATATAAATGATGTTCTTTCTTTCCTTCTAACCCTCACTCCAAACAG
>TTN-203,,0,125,516165,516289,GTATGCTCTACTTGTCAGCCACGTTTTTGTATTTTCTCTGCAAGACTTCCTGATACACCCCTGCATTGATCAAGGGTCATCAATGGAAACGTATTCTGACTTCATCCACTGTCCACTTCTTTCAG
>TTN-203,,0,112,516290,516401,GTAAATAGTTTTATCAAATAGTCCACCCCAAAATCATTTTTTTTGCCTTTAGTTTTATATTTCTTCTTTAAAGTGCTTCAATTAATAAGTTCTTTCTTTTTTTTCTTGATAG
>TTN-203,,0,846,516402,517247,GTAAGTGCTTTTTAAATTTTAATTTTACTGCATTAAATTCAACAGAAATTTGTGGAGTATCTATTCTATAAAATAGTCTTCTAAGTGTTATATTGCATGAAAGCAGCCCAACTCCTTAAGAAGCTATCACATATGTAATCAGGCTTATTTCTAAAACACTTTACCTTCATTACTATAAGTTAATGAAGATTCTAGCTTACACCCACAAAATAGCCAATTAAAAGCCAACTTAAAATTCTTCATTAATTATTGAGCCCTGTCATGTTTAAAATAGGAGTATATAAATACTTTCTATCTCTTCATTTTATCAAAATTATTTCAGAGGAATGTTTTTCAAGTTTCCCATAAGAGAAGATATTACATAATTTACATTAATAAGCCTCATTGTTTTTCTTGGCCACCTAATATCAACAAGATTAAACATGAAGGCTAACATATATAGACATGATTAAAGGCAAACTATTAATTGATTAAGAAAAACTAACAATGTGAACCTGAAAGCTTAAAAGTAAACTAGACATAATAGAGTTGCTAAGAATTAGAAATTTACCCAAATAATGGAGGAACACAAAATTGTATTTGAAGCTAAATTTCAGTCTTTTTAGCTACTGTTAATAAAATGTTTCAAAATTCAATATGAATGGATTAGATCTTGATAAATCCCACACACTGATTCCCTTCCTAATATTTAGAGAACTTTTGAACATAAACAGGTTAAATGATTGAACACTTGACACAATTTTAAAAGATACTCAGAACTCTGTGAGTTGTGTCTTAAACTTTCCAAGAGATTGTCATTTCCCTAAGGTGATTAATAAAAGCTTTTCACTTATACTTTACTTGCAG
>TTN-203,,0,90,517248,517337,GTAAGGAAATTTCCATGAGTTTCACTCTTGAAGCATTGGGGTTATTTGTGCCAGAGGCTAATGACCCATGCTGGCCCTTCACTTTTCTAG
>TTN-203,,0,436,517338,517773,GTAAGGCTATTTCTGAACTTGTCAACACCTAAAGGAGCTGTGTGAATTAGAAAAGAACAGGTGAAAGTCAGAGTGGATGCAGGACATTTAAAACATGATAGCAGTTTCTCTATCAGACCCTAAGCCAAAGAGAGATGTCAGGGTCTATGAATGGGCTCAGACTGGCACACTTGCATTACTTTTGATCCAGCAGAGTGAGTATAAGGTTGTAGATACTCTGTGATGCTGCTAGTTGGCTCAGAATTATACAGCTAAAATAAATGTGGCTTTCCTCTTAGTACTTGTAAGCTTTACTTCCTAAAAAAAGAGCTCAAAGTTATATAAAGTTTCATCACCATTTATTTGTTGCATTCCTTTAATTAAGATAATCTATCCTTAGAACAAAATTTCAAAGAAAATTATTTTCTATGAAAGTTTTTCTGTTTTGTTGGTACAG
>TTN-203,,0,797,517774,518570,GTAAGTATTGTATATTTTTCAGGGAAATTAAATAAACACTTTTTCAGAAAATGAATGTGAGTGAAATTAATTGGACCTATTTTATTAGTTAGAAAATATTATTAAAACACAAAAACTGGCTCTCTTGTATTTGCCACTTTGACATTCCAATACAGAAGTGGTTCAAATCGTAAAGTTTTGGAAATTTTGTTGACCTTGCCATTTGAACAAAAGAAAATTTAGCAAATCAGATTTTCCTGCTCTGTAGTCCTCTCATTGAAAGTAGATACACATACAATGAGAATCTAACTCAGAACCCTTAAAGACCACTTCCCTCAAGTGGCTGTGCAACTAGAGCACCAGAAAGACAAGCTTTGCTGTGTGGGCATTTTAGATTCAAGAAAGAAGGTGGGAAGCATTAGGCTAACGTTTCTGGAAGGTGCAAAGTGTTTGATGGATAGGGACAGCCTCTGATTGAGGGCCCCTTGTCCTCTCCCAATCAGAGTCTTAGTTATTTTGGAAGTCACATACCTTATGTAGCAAGAAGAACTTGACGCCTGGCAGAGAGACAGATGCAGCACAGATTTCTCGCTGACCTTGTACGTCAGAACGAAAGGGCCCCTACATATACTCGCTCTCTGGCTACCAGCTCTCCCCTTCTCAGCGCCGTGGGGCCACGTTCACGTGGGAGTTAAAATAGTGGCCAGTCCTGTGGCTTCTTGAAGAAAGCAACCATGAAGATTCATATCTAAGTCTCTATTTATTCTTTTGGGATTACAAAATGAGTAACGCAAAGCTGTTTCTTCCCTCTCGAAAAG
>TTN-203,,0,3904,518571,522474,GTAAAAAGCAGGCATGCCTTGTCTTTCCCGTTCTTTTTCTGGAGTTCTTCCACCTTCACTTGTATGTTCCTTATTCTTTGCTCTTTCTAATGTCTCTTCCTCTGTCTTTGCCTTTCTCTTTCCGCCTTTAGCCTGATTTCTGCTGAAACTGTAAAGCCAATTTTTTGCATTTTTTCTTAGGTTTAACCTGATGATTTTTTTATTGAAATTGAAATAAATTTAAAGTATGATCATGTTTTAGTTTTTTGAAGAAAAGACAAGACTCATTGACTATGAATGATAGTTTGATTAACCAGAAGGCAGGAAGGATCAAAAAGGCTTTCTGATTGCACGCTCTGCAGCCATGGTGCACATTAAGTTTTAAGACTAACGCTCTCCATCCTATTTAGTGTTCTGCATATAAGGGGATTAAGAGGAGAAGACTGAAATTCCATTTCGGGCAGTTGATCAAGTAGTTGAGATAACTTCTGGGCAGATTTGCTCTTCAAGCATTTCTCCAAAGCTATTTTTAACCTTCAAGTGCTCTGGGCTGTGCGATATCTGGAATGCAAGTGGACTATTTAAAGTGCAACTGATGGTACTGACAAGAAAGAAGGGCTCTGTGGTTATCCACATATGTGGATGAAATATTTTTTTTAAGCTTTGGTAAATAACTAGCTCCTGCTTTTAGCTTTTACTAACATTCTTTATGCCCAAGATTTTACCCATAAGTAAAAACTAAGGGATTATTCAGATAGGCCCACAATACAATTTGCCTAAATTGATCTATATGTTTTGTCCCCAGAAACAACATATGTCTTTAAATTATCTTGACAATCCATCATTAATTTTGAATTCTTAAAATAAAATATATGGAATATGTCCAGCCTGGGTTGGAAATAAAGCACAGGACAGTACATTGTTCTGTGACATATTCCCCCAATATTTCAGAAATACTATTAAATGTGCTATAAAGATCTCAACAAAAATCAAACTTTGAAGACTTAAAGGAATATAATTAAAAAGTGATTCAGTTTAACAAAAAGCCACAGCATTGACTGAAGTATTTGAAAGCAATGCCTTCAAGTAACTGCTTTGAAACAAACAAACAAACAACAACAACAACAACAAAACTAGTATTCCACTAAAGTGATTACAGGGTAATTCACCAGCAGTCATCTGATAGGTAACGCCTGCCTGTTATACAGATAATAAGATCTTCTTGGTCTCCTTTTCCAGTGACCAGAAAAAGCAGCAGTACATTCCATTTGTAGCATGGGAATTAAGTTACATATCACAAAACCTTCCTTACAATGAGGTCTTCTAAATATTGAACTGAGGGAGGCACCTCTACCTTCAAGCTTATTGTTTGAAAAAATATATTTTGCCTATCATGCATGATTTAATTAACTTCATGTCTAAAGGCAGAGAATTGGTTGCTTTTTCAAGATTCTTTCTAGATCTGCAAATTCATGATTTATATATAGGAACACTGCTTAAAGACAAATGATATTATTTTTTCATTACCAAATATCTTTTTGTCATAGTAAGAGCTTCTTATTAAAAGATCAGTCTCAGTTCTAATACAAAAACTGCACTATTTTAATTCAAATGTAGACTCCTAAAAATCTTATTCACATTTTATTTTTAAAAAATTCTCATTGTAACTAAAATTTTTTCTAGGGTTAGAAAGGATCAGTTTACTATAATTCTATAGGGCCCCTTTACATCTCTTTTGGCATAGGAATTTTAATCCTTTACTCTAGGCACCCGAAATACCTTAGCCTTTTGTGAACTTGCTCTTGCATTACTTAAATGTCTCTTTTCAAAAAGAACTTAAATATAAACTTTGAAGTAATAAAATCATTTTGTTACATGTGGCAGATTTTGTTTAAATTAAGTCTGTCAGAACAAACTTGCTCTTGTCAATGTAATTCCGAACTTTAATACTCATTTTATGTAAAAATTTTCGCCTTCAAAACTACAATAACCAAACAAGCAAAAACAAGCTGTAGGAATAGGAAATATGAAGAGAAACTTGTAGACATGAGTTGTTTGCATTTTTTCTTTGTTGTTGTAGTTGTTTTTGGCTGTCAGTTTAAGAAAGGACTGCCAAGTTCCAAATGGCATTTGATAATTTTAAAGTTAAATTTTAAATTTGATAAAATTAAAGTTTAAATACAAAACTTTAATAGTTTTGTCATGGTCATAAGCCTACCGTATTATATTAATATGCTTCCACTATAAATAAATATTTTTAAAATCTCTAACATTATTCTTACAATCTACTGCAAAATCTTCAACATTCATTTCATTGGTTTATTTTTATAAGGCACCTACCAGTTTTCCTTTTTTTTCTTTTAACATAGTGGAGGTAGATTGTATACAAGCTGTTTATTGAGACATACTGCATTCTGAGCAGTGTCCTAGAGTAGCTACAGAGGAACTCAGATGATAAAGCAACATAATATTAATAGATAAAATATATCTGTGGGTGGGTTAGAAACTGAGACACCTTTTCAAATAGCCAAAAGTTGCATGCCAAAATTTATACTGAAATGTTATTAAAAAAACAAATTTTTCCCATTTCAGCACCATGCCCTCGGATAAGTAGCTCTGTTCCAAGGGCATATTTAACTACCCCCTCCTAGCTGTTATTTTTCCTTATTATGTTTTTTGGCCACTCTCAATTATTAAGATAATTATGTGACTAACCATGCCCAGTTCTTAATTAAAGAAAACACTTTTAGATGAAACCTTATTTCTGATTCTTTTCTTTACACTAGCATAACAAATAGTTCCACTGGTGAAAAACTTTACATTATTTTTAACGCTAAGTAAACTCTTAAGCAGTGCAAAATCAGTCTGGATGACAGGGCACAGCTTCTTAGGAATTTTATATCATAGAACTGGAAGAACCCCCAAGTCTCTTATCTTTGCTGTCAGAATGACCCCTATCTGTCGCACCATTGACATCTGATTTTCCCATTCCTGATGCTTAGACACATGAAAAAGGAAGAAGAGTCCAACTTTCATTTGCAGTTTTGAACAAAATTAATAGGTTGTACAAATTATTTAATCACAGGTTTAATTGGTTTGCAAAATAAGTTTAATTGCTAAAATAAATGGGAAGAAGAGTTATAGCTTGTTGTTGCATGGCAAACACCTTACATACAGAACATAAGGTTTACTTTTAGCTTGCCATAGCTGATATTTTCTTTCATCCTTTCATGAATTCGCTTTTCTAAGTTCTTCCTTTATATGTATATAAGCCCAGGGGCAGAATGGGGGCACACATATATATACACATATACGTATATACTATATGTGCTGTATATCTACGCATATGCAAAAAAGACCACAAATGTAAACAGAAACTGGCCTGGGCAATTTCAATGTGAAAGGCCACCTAGTAATTATATAAAGGTAACTATGAAACCCTAAAATTTTCTTGAAAGATCCCAAACTGCATAGTATTCCATGGTGTATATGTGCCACATTTTCTTAATCCGGTCTATCATTGTTGGACATTTGGGTTGGTTCCAAGTCTTTGCTATTGTGAATAATGCCACAATAAACATACGTGTGCATGTGTCTTTACAGCAGCATGATTTATAGTCCTTATACCCAATGCTAGATGATGAGTTAGTGGGTGCAGGGCACCAGCATGGCACATGTATACATATGTAACTAACCTGCACATTGTGCACATGTACCCTAAAACTTAAAGTATAATAATAATAAATAAATTTAAAAAAAAGATCCCAAACTATTGGTTGAAATGATTTTTGAATGCATACGTGCTAAATAGATGATTATAAAACAACTTGGAAAGCTCTATTTCCATTTATTTTTATCTAAATGAATTAAATGCACCCATATACTAGATTGCTGTTTCATGTATTCTTTTTTTAAAAACAACTAG
>TTN-203,,0,541,522475,523015,GTAATTACAAGGCTTATTTTAAAAACATGTATAAGGCAGAGGCTCATGAACAATGCCAACTCTCAATTATCTTTATATGATGAGTACTATAGATGTTTAAAATCAACCAAATAATCAAAAGTCTGATTTTACTTTTTAGCATAACAAAATAATTCACAGACTATCTTTTTAAAGAGCCAAAATTGACTAGCATAGGTTTTACTTCCTCCTTCCATCTCTATTGTTTTTATTGCACATCCTAGATTTTCAAAAGCCAGCTGGAGGAAGAATTATTATCAAGCTAGGTATCCATCACTTTATTAACCAAGAGTTGGCTGTTATTTCCTTAATGTTTCCTAGTTTTTAAAAATGATTTTCCTCTTGTCTGTACAAATAATGATAAAATATCATTTTTAGAGGAAAATGTCTGAGTGTAATCAAAACTTGAAAATAAAACTTAGGACAGAACAAAGCCCTGGAGATGGCAGGGGAAAGTTGAGAAGGTACCAAAACTCTTGGAGAAGGAAAGGAGTACCTTGGCTAATGAGTATGATTCTTTCAG
>TTN-203,,0,1697,523016,524712,GTAAGTATTCTTCTTACAAAGGACTTTTCATTTGCAATTCTTTAATAACTACAACAACAAAACAACACAACACTTTTTGCATGCCCTTCTTGGCCTAACTGCATTTCTTGGCAACTTCTAGTATTGACACTGACCTAACCTGATCCTTTATGTGTTTAAAGAAAAAAAGAAAAGAAAAGTCTTATTCTATGTCTGGTCTGATTAATGATGGAGCAATCACTTTTCCCTATGCTTCTTTTCTCTCACTGAGTAGTGAGTAGATGTGCTCTTTGTCTACATGGGGTCAGCCTACTGTATGGATATCCTGATATGGATGAGGAGAAACTGAATTTTAAAGATAAGTAGGGAGTCCTAATTTTAAAAACAAAGTAAAAGTGATTTCCATGTGGAAGGAAAATGAATTTTCAGGTGTGGGGAACAACTAGAAAATGAGCATGAAATTTCAGTCTGAATAGGAGCATACTAGAGATCTGCTGTAATATGACAAAGCACATTCACATGATTCAATCTCTGAGAATAAGAATGGATAAGAAGATGGAGTGAGGCCCTGGATCTTTTGAGTCCTGGACTCTTTGAATGAAGAGAACTCTAATGGTTTTTAACATTACTTCTTCCTCTGGTGAAAAATGTAATGTCTTTTTTCAAAATGCCACATACTAGCTTATTTGTTTCATTCATTCCTTTGTCCAGTGATGACATTTTTCTGCAAATTTTTTGTGCAATATTTGTTTGTTTGGTTTGGTTGCTTCCCATCTGTCAACAGCTACAACCTAGTGACTCTGTGCTTCATGCATCTTGTACCATGTTTTTCTTACCACTTTGTGGTTGCTCTGCTCAAGCTTATGTCAAAGTAGCTTCTTGGGTCTCCTTCTTCACCTTGACATCTACCTTCACTCCAAGAAGGCTCAGCTGCAAGGAGCATATTTTCAAACCTATTAGACAGCATTTGTCTCAGAATCTTATTGCTCAAGAATGGTCATCTTGGGAAGGACTCACAGGGAGCTCTGAAAGAAGGAAGGGCAAGGGGGCAGCTCCCTAATCCTATACACCAGCTGAATTAATTCTACAGATGAATGAAATAACAGATGTAAAATCCTAATCACCCTCCCATACAAAACACATTGCTTTATTGCACTAATAGATGTTATGCCTGACTTATATGTGACGTCTTCAAAGCTGATTTTTTTAAAAAGCTAAATGTATGTTTCAATTACAGCCTCATGCCTCTTAGCCATACACAAGGCTGGCCATAGTGCTTCACGTGTTCTATCTTTGAATTCTGCTAATTTCTCAAAGATTGTGCTAAGTGCCTTAAATAAGACAATGTTTCTTTGCCACTGGTGTCTGAAGTTTCCTTTGACATTATCTTTCAAGTCTGGTGCAGTGCAAATGAAGATTTTTCCTCCAGCTATTATTCAAAAGAACTGAGATGGCTCCCTAGTATATATACTGTACACACACACATGCACACTAGTTGAACATATAGAATGCCACATAATTTTATGTAAACTAAAGAGATATCTAAAAAGCAAAGCATCATACCTGATGGGCAGCTTCAAGTGATTTCAAAGTCAGTTGTAGTCTATTAAGATGGAAAATCCCTAAAAAAGAGTCACTTTTTCTTAATGTATACTATGGTAATGTCAGAGTAAATTTCCAGAAACCTCATTTTGAATTCTGATGACATTCTCTTACAG
>TTN-203,,0,661,524713,525373,GTCTGTGACTGTATACCTGTCATCTTGTACTGTCAAATAACTTTATATTTACTTTTGGTCTAGCCAAAATGGAAAAAAAAAAGTTAGTCACAACTTCTCTGGTCACCACTTTACTTTTAAAGATAATTGTAGTATAAAATGTATTCTTGACTTTAATTGCTCTCTTTTTAGTATTATTAATTTACTATTACTTGAAAAACACTGGACTCACAATCAGGAGATTTAGATATTAGTTTGAACCATATGAAAGTGCTGTTTTCTTAGATCAGAAAGTCAAATATCAGCAATTATATTTCTTTCAACTAAGTACCTCCTGTTGCTATTAACTACCATTGGCAAGTTTCTTCAAGTCTGAGCCTTAGTTTACACATCCAAGAAGTTAGTCTGCATAATGTCTAAGGCTCACTATAGCTCTAAACTTATATGATCCCATTGTTTTTAATAACTGATAATAGTATCACAGCAGCTAACTTAACAGTAATTGGTAAGATTGTTCTTGCTTTTGGGGTTTGTTTATATTTGTGTCTGCCACCTTGGTTCTTCTTCACACTATGAAGTCTTGTTGGTTGCTTTCAGAAAAACTCAGGATCATAGTTTTTCTTAAGGACACCTGTGTGAAGGAACAACAAGAAAACTGATAATCTATTTATCTTAAATATAG
>TTN-203,,0,98,525374,525471,GTAAGAGTAAAGTCATTCTTTGTGAAGTATATGTGTTGGGAAAAAATAATAATTTCCAGCTTAACTCAATGTGGTTTTTGTTTTTTCAATGCTTGCAG
>TTN-203,,0,106,525472,525577,GTATGAAAACTACAGTGAATAATCTTTTATTTCTAACAATTCACACTTGCTAGATTTAAAGTACAAAGACATATGTTTCTAATATCTTGTAACTTTTTCTTCCCAG
>TTN-203,,0,108,525578,525685,GTAAGTTTGTTCTTGCTTTTAGGGTTTTTTGTTTGTTTGTTTGTTTTGTATTTGTATTTACCACTTTGATCATTATTCATACTATAAAGTCTTGTCGGTTGCTTTCAG
>TTN-203,,0,89,525686,525774,GTAAGTAATTTATATACCACTAGAGATTTTTTCATCAGTTTCTGTTATAAAAATAATTAAAATCAACATATTTTTCTCCTTTACAACAG
>TTN-203,,0,104,525775,525878,GTAAGCAAGATCTTTTTATTCTCTATTTCTGTAGCTATATATACACTTTTGACAATTTAGTGGCCATCATTGCAAGCTAACTGATAATCCAATGTCTCCTTTAG
>TTN-203,,0,100,525879,525978,GTACATATTAAGTGAAAAAACAATTCTAATGTTACCAATTTTTTAAAATTGTTAATCAAAATGTAAACATATTTGTATTTATTTCACATTTTCTTTCCAG
>TTN-203,,0,767,525979,526745,GTCAGTCCCTTTATTTTAAAATATCCTTCCAATATCACAGAGTTTAGATTTCAGATTTCACAGTTATTTAATGAGGTAATCCTTGTGAGGGTCTTTCATTTCTAGCAAGCCCTACCCACATGTTAACAACTCTAATTTTGCTCACTACAAAGTAAGTGTCTTGAGTAAGAGGAAATTAATAGCAATAATCTTTACATGCCAGAGCCTTGGACAGTTGCTAGTACATGATGACTATTTATGAACTTAGGCTACAACTAAGCTATCACCCTGAGAGTCTTGGCAAATCTAAAGACGGTCTTATACTCTCCTACTTTACAAACCCCTGTGTGCCTTTTAGGTATGTTCTCATCCTGACCCAGGACATCCTTATACACTGTCCTTATGAAAAAGCCATTAGTGTACCTCTCATTCATAAGAAAAAAGTTTCTCTGATTTATTGAACTAAGTATGCAGTGCCTACTCTATCAAAAAACAAAACAAAACATGTTTTGCACTACACTGAGTCCTATGTTACTATTTTTGGCAAGGAATGCATGTCTTATGATTTTATGCCATTCTCAATCCTCTACTCTCCAATCTAATTTGCACGCACAACAACAACAAAAAGCTATGAGAACTCTAAGCCACTTAGTTTTCTCTGCTATAAAGTTACTGTAGCTTACTTCCAAGGTTATGTAACCAATATTTTCTAATAAATGCATAATAACATGATGTAGCTTGGCTACGTTTAATAGTCGAAAGCGTTCACATGTTATCTTTCTCACTAG
>TTN-203,,0,92,526746,526837,GTAAGCCCTTGGGTCTCTCAGACTTAATTGGCAAAGCACAATTTAAAAGCAAGACAGCACACTAAAAAAATTCCTCTATATGTGAATTTCAG
>TTN-203,,0,107,526838,526944,GTAAGAAGTTTTAAGTAAATTCAAGTTAGCTTTTAAGTAAATTGCAGTCTTTGCCTTCATCATCGTTACCCCAAACTCATATTTTCTTCTTCTGTGGTGAAATCCAG
>TTN-203,,0,266,526945,527210,GTAAGCCCATCAAAAAAGGGAAATAATTACTGCATGAAATCCAGATATTAGGCCTATCAATTAAAATAAATCAAGTTAAATGAAAGTTAATAAAAAGGTAGAATATCATAAAAATTTGGATAAAGTTTTAGAAACCCAGACTGTGCCTACTTTACTTAGTGAATTTGATAAACCTGTTAATGAGGATGATATAATTGATTACAACACTGTTTTCATAAATTGTCACTAACGTAAATGGTATGCTCCAACTCCTTCTTTTATTCCAG
>TTN-203,,0,90,527211,527300,GTAGGTCATTTGCATATAAAAAAGAATATTCAATGTGGATCATGGACATAACTGTATGTGTTTTTTACAAATATTAATTCATAATCGTAG
>TTN-203,,0,106,527301,527406,GTAAATAGATATTTTATTTTTAGATCGGGGAATAGCACATAGCTACTTTGGGGCAACAGGGACTTAAATATGGCACTGCAAACTCATTAACTTTTCTTCTTTGTAG
>TTN-203,,0,98,527407,527504,GTAAGGAACAAAACATTTATCATCTAAGGTGATTTGGCAGTATTAACAAATATTAGTTCAGACTATTAACAGTGACTCGTGAGTGCATTTTTTTTCAG
>TTN-203,,0,690,527505,528194,GTGAGTTTTGAGCAGCACTGCATCAATGCCAAAAATGAGAGTAGGGGAAATCCCAGAAGGTTGGGATGCCATACAAAAGTCTTATGTGCTACAACTTCTTACCTTTACCTCACTGAAAATGTACAAAAACTTTTTAAGAATGCATCGGTGCTAATGCTTCCTGAGGTAGCTCAACCAAGGATTGTATAATTGTAATTGTCTTGTCTTGTGAGCCTTACCAAATTTGTAATAAAAAAAAAAATTCCCTACTGACTTGGTACCTGCTAAGTACCCAATATGTACCCATTAAGCTAGAAGTGGAAAGTAAATATTTATTTCCCTGGTGGTCACACTTCTTATTCCACTAGAATACCTTAGTTGACCTAATCAGCCATTATTTCCTTGTGTTTATATTAGTTACTATTCTTTACCCTGAATTAAAATCATATTTCTGATAAGCAAACTGGTAGAATCAACACCTCATTTGCCATCTTTTTTCATGTGTACAAACTATGAAGCAGTTTTTCTTATATTGAGTCAAATATTATCATGTATCCTACTTTGCAATTTTCCCTAATATGAAATTAATGTAAGAATAATCCCTAGCATTCAAAACAACTGCAGTTTGTATCCCTGGTCATGGTAAAAATCTTTTGGGTTGGCGAAAGGGTTTTTTGGAAATAACTGATTAACTGTATTTCTTTGTCCCAG
>TTN-203,,0,156,528195,528350,GTGAGTACATTCTTGATGATTTCTTACCTAATCTTGTTGCCTGTTTTTGCTTTTAGACCTAGAGTTGAAGTTATGGGGCAAGGCAGGGGTTGGCAATGTGAAGAGAACTGCATAGGTGGCCTGTGTAAGACTGACTCTCTCTTCCAAATGTTGTAG
>TTN-203,,0,338,528351,528688,GTAGGTTTTTAATTTGGCATGAGAGTAAATGTGTACTCCTAGTCACTAAAATGGGCTTTGTTGGGGAAAATTTAAATGTTTGTCTTTTTTCATTGAGAATCCTATGCTGCCGGTGTATCTGTCTGATTTTTAAAGGTGCTGCTGAATGTACTGCCTGCTCAGGGTTTTCATGACAGTATTGAAATGAAAATGTATTCAGTTATAGTGTTGAAGTAATCCAGGTTTAATTTAAAGACTAGTATTATACCAGGGGTTTGAATTTTTGAAAGATTATGAGTACTACACAATGAAACGATTATCGACATCACAGTAAAACATCCTATTCTGTTTTCTGACAG
>TTN-203,,0,93,528689,528781,GTATCTATTTTTGATTTTTGTCTTATCAAATAGGCCTCTGACCTTAAATCTGCTTGAACTTGATAACATCATAAATAATCTTTTCCAATTCAG
>TTN-203,,0,117,528782,528898,GTAAGGAAGGTTCTCATTTTAAAAGGGGATAAACTCTTTGCAGTTACTTTCTTGAAAGAAAAAAATAAAAAAAATGGTGAACAATTTTTTTTTCTGCATCTGTAATGCCATACACAG
>TTN-203,,0,114,528899,529012,GTAAGTTTCTCAATCAGCTGATAAAAAAAAAAGGATGCTTATGTCAAACTTGCATTTTGGTGTCATATTTATATACAGGACATATAACATTTTACACCATTATCCTGTCTATAG
>TTN-203,,0,474,529013,529486,GTATGCTCAGAATCCCCATCAAGATGTTAAGACAGCAGTATATTCAAATGTTTACTCTTTAGTATTCCTTGGGATTACAGATGATTATATATTACTAAAAAAATTTTAAACTACTTTTACTCATATTTTCTATTACCTCATAATTTGAAAAATTATATAAATTCCATTCAAGGGCACATTTCTTAGTTTACTCTAAAATATTAACCTTCAGGAAGTTTCAAAGTGTTTGATCCCCCAGTATATTATGATAATGACCACTGTCATAGATATTATAATTAGATTGGTATGTTTGGCCCAGTCTAAAGTGTGTGGCAGTTAAAAAGCAATTTTTAATTTATATTGAAGTGCTTTTCAGTTAAATTTCCAAATCACCTTTTCACAATTTAAATAAATTAGTCTCTTCTGTGTAAAATAAACATAGGCTTCTTCTGCTTCTTACCATGATGATACACATGCACTTTGTTCCTAATTCAG
>TTN-203,,0,88,529487,529574,GTATTATTTATATAATTTTTGTGGTTATTTCGAAGTTCATATGAACTCCTTTTTGACAAACCTAAACAATGATTTCATTGGCTTGCAG
>TTN-203,,0,196,529575,529770,GTAAGTCACTCTTGATGTCTGGGATATATAAATTCTTCTAATATCTGCCTGTGAGCTACGATATGAGAAAATATGAAAAATTCATTACTATTATTTCCTCCTGGCTACATTACTTCTTAATGACTGCCTGCACTTTCAGACTGACTATTGGGTAATAAAAAAAAAAATGAATTTGTTTTCCTTCCTTCTTTTTCAG
>TTN-203,,0,114,529771,529884,GTATGCTCTTGCACTTAATCTTTGTGACAATAAGTGCTCTCGCACTTAATTTTTGTGACAGGAGATTATCACCTTTCCTCTGGTTTTCCTAATCATTGTTTATTTTATTTTCAG
>TTN-203,,0,102,529885,529986,GTAGAATTTGAATTAATTCATAAAGAATAACTTACACTTGGCTGCAAATTCTTAACTGTGTTTTTTCATTAATGCTAATGAAATGCTTTGTTGTTTCAATAG
>TTN-203,,0,80,529987,530066,GTAAGTAGTGCTGATTATACACAAGATATTGTCTAGAACTTGATGAGACTGTGGATATGAATATTTCACTCTTTTCTCAG
>TTN-203,,0,100,530067,530166,GTAAGAGCACAAGGTCTTTTATAGTTAATAAAATACCCTTTATTCATGCATTGCATTTTGACATACTCTGTTTTTTGCTCTTTTGAATGATATCTTACAG
>TTN-203,,0,603,530167,530769,GTAATCATTCTTTGAAGAAAAACCAGACATTCTTCACATGTAGAGGAAATTAGTTAACTTTGCAGTGCTATTAATAATATAATTGGCTTCATGAACTGGCCACTTGTAAACTAAATGTCACTTCTGATTATGTCTTTCCATAGGAGAAGTAAAACAATTCTAAAGAGATGAAATCGCTAAACGCTTATTAGACTAATTTATACTAGTTTTAGTTAATTGCATGTGAAATACTAATTTAAATAACAGATATTAGCATACCCAAAGAGCATTGAAATGACCACAATTTTTTAATTGCACAGCTTCACATTTTCCCATAGTGTTCTTAACCAGGGATAGTAACATTTTCTGCATTCCCCCCAGCCCTGCAAATAATGTCTGGAAATTTGTGGGGCCATTTTTGCTTGGCACACAGACTTGAGGTAGATACCACTGACATTTAGTAGTTGGGAGCCAAGGATGCTAAATGCTCTGCAGTGTGAATGACACTCCAGCACATCAAAGATTATCCTACCCAAAATACAGATAGCCCCACTTAGAGACAAGTGCATTATTAAAATGCTGATTTTTCAGGATTACTAGAATAATTATCCATTTTTGTAATAG
>TTN-203,,0,103,530770,530872,GTAAGTTTGGACATGGATGCACTATGGCTAAGAACTAATAAACCATAGTTTTGTTTTAAGAAGGTGGTTTTCCTGATACTAACATTTTTTTCTTGTTCTTCAG
>TTN-203,,0,113,530873,530985,GTAAGTTTTGTTTCATGGAGTTGCCACTTTCCCATTTTGAAATAAATGAAAATAATGTTTTGTCAGTTATTTTCATCAGAATTGAAAACATTTATTGGTTATGATCACTATAG
>TTN-203,,0,299,530986,531284,GTGAGTCATTAAAACTACACTTTCCAATGGAAAAAGGTTTTAGTAAAACATAAAAATAAAAAGTTTGGGAGAGAGTTAAAAGAAATGGGACATAGCTTCAGCAAGTTATCCTCAATCATATTTTATCTGCTGGCCATGTAAAAGAAATCACCTGATCTTGTTATTTATTAGCTAATGGAATACAAAGATAGATGTGGGAAAACCACAAATCATGTCAGAGGAGCATGCTCACATTTATATTTTCCATAGCAACCCTTCCCACACAAATTTTTGATTACTGTTCTCTTCTGAAATATTAG
>TTN-203,,0,128,531285,531412,GTAAGTTTCCTTTGGCATCTAAAGTTTGCCTTTTTACCATGTACTTTGGTATATAATTACTACAGCTTTTAAAATTGCATTTTTATGTCATACTGGGAAATTTACTTCAAATGTTATTTTTTTATCAG
>TTN-203,,0,96,531413,531508,GTAAGTAGTTCCTTAAGAAGAAGGTGGAGTAGAACAAGCTATTGTACATTTTAAAACCATCAGGGAGTTTGATTTGTCTATCTTCATTCATTCTAG
>TTN-203,,0,99,531509,531607,GTACTTAACGTTATTGGAATAAAATTATGGATATTTTCTCTATATGGGACTATTTTTTAATCTTTCATGGGCTAATGCATGACTGTTCTCTTTCAACAG
>TTN-203,,0,86,531608,531693,GTAAGGAATGTTGCACTGATTTTCACAGGATTTTCCCAAGTGATACTATCTTATTACATTGATTTTTGGCTTTGTTTTGTTTTCAG
>TTN-203,,0,1307,531694,533000,GTAAAAGAGAAGGTTTCATTGTGTTTATAGAGTAATGTTTTGCTTCTAGTTATATTATTTACTGAGCTTTATGGCTTCAAACTCCCAACAGTCTCAAAATCTATAGCTAAAGAGTAATAAGAAAAGTAAATCAAAAAACTATTAGCAACATTAAAGATATCATATTTCCTATAATTTCAATGTAATTTGTGGCTGTAAGTATATTAATCATGCATGGTTTCTTGTACTGAAAAACTTGGATCTACAGGGGCTTAATAATAACCTAGAAGTAGTTTAGACATATTATATCTCTCCAGTAGAACACATTGGAAGTCGGGTTTTTAAAACTTACTAGCGTAGTAGTTAAAGAGAATTCAATGTTCTTCTAAAAGATTAGACAATTCCTGAGAATAAATGCCTTAGTCTTCCTCTATATTCAAAAAGTCCCCATACTGGAAGGATAGAGAGGCCCAAAACCAGAAACAGCCTCCAAAGAATAGAAAACCAACCAGAGGGAATCTCCCAGAAATCAATACGAAACACTAAAATTGCACACACAGTAATGCACACTGACATCCCATCTAAGAAAGCAAAGGCTTTGAGGAAGACCCATTCCTCAAGAGACAGAAGAACTTATTCCTTCACCATCACCCCCTGAAAAAAAAAAATACATCCTATATCACTGCTGCAGCTCATCTATGAACGTCCAATATACCACAGGCTGTGCCAGAGGCACCAGAACAGAGCTGAGCTTCCACTCCTTCTGGTTGCAATAACAGTCAACAAGTATGGATTGGGTCTAGTTTTACCACTGAAAGCTTAACTCTTAGTTTGGTCCTTCAGGAAAGAAAACTTCAGCAGCATTACATACATCCTCTTTCCACCATATTTTGAACCCACATGTGAGGCAACATGACTCAAAGTATGTTCATAGACATATCCACTATCTGTTAATAAAAGAAAAAACACTTTGCTCTCAGCTGGTCATTCAAAGCAAAGCTTCACAGACTTACTTTCCTAGTTCAGTAGAATTAGAAGCATCCCCAGTTACAAAGGTAAACAATCTAAAATGTTAAATTAAAAAAGCATACGTGCCCTTGATTTATTTTTCACTGATAATCTTGATGAAAAGTTTGCTAAGAAAAATTCTGTCTACATGAATGTCTATAATTTTGGCAACTGACAAGTTTTAGGAATGATTTTAAATAAGGATGTAAGGTTATGCCAAACAGAAGGCTATTTTTTACATAATTAAGTTGAAGTGAAATATTATTTCTTACATGAATATTTATCTCATGCTAATCATTTTCACTTGCCTCTGGCTAAAG
>TTN-203,,0,118,533001,533118,GTGCGGAATCTGAATATAATAATAATTTTAATGCATTTTACAGTGTGCCTTTATCCCATAAGTTGAAAAAAACATCCTTATGACTTTGTTACTGTTTTTCTTTCTCTTCTCTTTGCAG
>TTN-203,,0,88,533119,533206,GTAAGTGACTTGCTTTCTTACATCAAAAAGGCATCCAGTGTCTGTTTAAGAATTGCCTTCTCAATATTCTCTGTTGATTCCTTTCCAG
>TTN-203,,0,402,533207,533608,GTAAACTCTTCTGAATATTTTCTTATACACATTAAAAGTACATGACTCTGGTTTGATGCCATTTTAATATAACCTTGGAATTTGATAATTAAACTCAAAACCACACACGATAAGCTGTTATTTTGTTATTGTAGTGTTTAGCCCCACACACATAAGGCTCCTTAGTACATAGCGTTTGATACACAGATACTCTTTTAATTGAGATCCACTATCAGGTACAATACATCTACATATTTTTATTTTAAAAAAAGCTTTCTCCTTTTCTCTGTCTTCCCATGTTTTGAGTCTATATATTTATTTCTTCTTACAGTCATCCCTCCCAAAATAAGTTGAATTTTTAAATGAGTGAAAACCAACATAAGTATATTCTCTTCAATAAATTTCTGTTTTTCTAATTTCTAG
>TTN-203,,0,1285,533609,534893,GTAAGTATGCTTCCGTTTCTGGGGACTAATTTCTAAAGCACAAAGTCACTAAATGGATAATTCTGCCTTAAATTTCTTATATTTTTCTATGCCAAATTATTTTATTTATTAAAATAAAAAAGGTTCATGTTCACATAGACTATCGGAAGTATATATTTATGTGTGTATACATACATGCACAGATATATACATACACACATACATAAAATCATACAGTTTGTAAACTCTTGGATTAAACCAAATATTTTATGAGGAATCACAATAATAAAGACCTGGACTATAAACTCCTATGTCTTCTGATACTTTAAATAAATTTCTATCTCATTAGATACTGGGGAAATCATCTCTCCCACTAAACAGTCAGACCTTCCAGTAGGAATTCAACAAAAAACAGAATGTTGTTAGCTTTTCTATAATATTATTGAACAAAGATTTAGGATTCTCAGGCATAGTCTGTGAGGTCAAATAAGAGAGAAAAATTCTTCTAAAAGATCTGTGAGCAGATTCGTTCAAAAATTAAAAAATACTGTGGCCATAATAATTCATCCTATTTGCTACATATCTGATTAGATTCTCTATAGAAGAAAAATTCAATTATTTGTTAAAAAGAAAATTTTAAATACTCAAGTGCTATGTGGAGCATATATACCTATATAATGAGGTAGTTATTCATTCATTTGCAAACTAGTATTGAACATGTGCTTTGTGCAAGGATCTATATTAACCACTGGAGGGGGAAAAGTTAAGATTAAAAAGACAAGTACAGTAAAAGAATTTCTGTAATTGTAAAGCACTTTCAGAAAGGTAAAGGATTGTTATGGGATTATTGTAGACACTGATCCTGTCCCTAAAGGGCATTAAGATTAGTTTGTGTTCAAAGGTTTACTAGCTATTGATGGAATCCTTTTTAAATTTTCATATTGTGGCAAATTAAATTTAAATCATGTTTTCAGTAAAGGCTATTGTAGAATTTCTTCAAAGGGATCTCAAAAGTAAAGTAGTTTTTTACCAATCATGTATAAATAGAATGTAAATCTAACAAGATAGGAAGTAGTCTTTCTATTCCCAGTTAGTTGTTTGCTTTCTCTGTTTTTGCATTAATGCTAAAGGAAAATAGACCATTTCCTTTATTTCTCTTCTCTAGAAGGCAACTGTATTTCCTTTTAGCATTTCTATTTTAATATTTTAATAGATTAAAATAATATATGATCATGTGTAGTAAAAGACTCCAGCACTTCATCAGCTTCAAAATCTGATGAAGCTTTTTTTTTTCTTTTGTTATTAG
>TTN-203,,0,131,534894,535024,GTACTAGTACTTACTCAGTTTATGTATTCCTCTTTTGATCTTATTATGAAATTGATTAATTTACTGAAGATATTTCAATTACTTTTGACAAATATGAGCTAAATCCTGTTAAATTGTATGTGGTATTACAG
>TTN-203,,0,87,535025,535111,GTAGGAAAATAACCATTCTCCTCTTTTTTCCACTGAATCACTATAAGGAGTATTTATACTACAACTGACTGTCTCCTTTTCTAATAG
>TTN-203,,0,94,535112,535205,GTAAAAAAATAATAATTAAAATAATTCAGAATATGGTTGACTTCAATATTGCTATGATTTCATTCAATGTATGACTACTATTTTCTTTGTACAG
>TTN-203,,0,93,535206,535298,GTAAGAAAGACTTTGAAAGTTGCTACAGAATAAAAACAAATTATTTTTAAGCATTTAAGGAACGTTGCTTATATTGTGATTTACATCCAACAG
>TTN-203,,0,93,535299,535391,GTAAGCTTTAAAATCTAAATTTAAAATATCTTCTCAAAATTGAAGTATATTATTATAAACAACGCTTAATACTTCCTTTAATTATTTTTACAG
>TTN-203,,0,1003,535392,536394,GTAAGTACCAATGTACTGACAAAGAATGTCCTCCTTACAGCTGCCTTCCTAGGTGTTCAATAATAGTTCACAATTAAAAGAGCTATATCTGTACCTTAGGAAGCTACTATGGCTTGAATGTAGACATGGGCACATTACTTAATTACTCATTCCTTCAATTTCCACAGAATTTTCACATTCCCTTACCTGTTACCTTTTCCCTGTTCAAAGGAGATGATGTCTGTAATTTCCTCGCTGTAATTTTCCTCGCAGTCTGTTTTATTTATCAGAGGCTAAAGCAATTTCTCTGCATGCTCCTCAAAAGGGACAGAAAGTAACCAGTCATTTTCTTAGCAACTGCTGAGACCCATTTATCTTCACAATCAAGTTTTTATTTCTCTATATGAGAAAAGATATATCCATTTTAATGAAGTATATATATATATATATATATATATATATATGGTAATAATTCTTCCTCTGATAATTACCATCACTACTGTTGTGTATTTGTTTATTCTCTCATCTAAGTGTGAAGAAACTGTAGTCACTACCCTCTTTGAATATTTCTGTCCTAAATTTGTGCAAAATGGAAAATTGCTTTCCTTTTATTAACAGTTATATTTCTTAAAAGGGGAATTCACCTTCTTGTGTATCCCTTCATAATTCTGTGTAAATATTAAAGAGAGTATCCCATGATACTCTCCTACTACAATCTCCTCTCTTCCCTTTTGTCAGGATATGAGAATATAATAATACACATCATTACATGCATAATGATGCCAAATAAAGTGAGGCAAGCACAGATACATAGCCACATGTAGATCCAATAAAAGATGCTGACCCCGTGTACCTGCTCCCCAAACTAGCGTAATAGTGTTAAAGACAGAACCATTCTTTATATTGGGCTGAGCTACAAAGTCTGCCTACAGTGGATCCAAACAACTTTATAGTAACTGTGAATTCTACTTTCTATCCCTCAATGCTTTTTGCTCCTAATGACAACTTTTTTTAAATAATCTAG
>TTN-203,,0,108,536395,536502,GTAAAGACTGCATGGTTTGGTTAAAATTACTTGTTTTTCTGTTCATAAATAACATTTGGCTTTAAAATCATCTGAGTGATAAAGGGTTCCTTCTTTAAACCATTTTAG
>TTN-203,,0,83,536503,536585,GTAAGTAGGAGAACATTTTCACATACAAAGCCATTTTTACTTTTTTTTTAAATTTCTTATAATCAATATGATCTTTTTCACAG
>TTN-203,,0,93,536586,536678,GTAAGCCTGGAAACCATTCCTTTTTTTTAAATCTTATTTTCCAAAAGTGCCTTGGAAAAGTCAAGAATACTAACGTATACTGGCTCTTTGCAG
>TTN-203,,0,447,536679,537125,GTAGGAAAACTTGGCACTAAGGAAATGCACTATGAATAAACTAAAAAATGTCATAGTTATTCTCAATCCCATTAACTTCTGTCTATACTTTTTGGATTAAGAAATCAGGAAAATAGCATAATTTTAACTCACATTCCAAACATCTGTTAATGTCAGAAATCGAATCAAAAGTTAAGTCATGTTATTACTAATCTTTTGGTTATAAACCCTGGAATGTGGAATAAATAAATCAAGGTTTAATCATTTGACAATAATTTTAAAGCATAACTCCTGCCAAGTTATTCCATTCAGTGTTGCCTGTAATATCTGATCCCTAAAACCTAAACCAGCAACAATTTTCCCAGAGTAAACAGTTAAATAGGCTGCTGGTGATGCTTTAGGAAGCCATTAAAGCAAGAAGCTACAAAGAACTATTCTAATTATAAAATGTCTATGATTTCTCCCCAG
>TTN-203,,0,88,537126,537213,GTAATTATCAATCCTTCCTTATGCCATCAGTATTTATGTTTCAGATTGAAGGGGAAAAATCACATTTGTAATTTTCAATTGCTTCCAG
>TTN-203,,0,1728,537214,538941,GTAAATACTTTCAATTTGTCTGTGCAACTTTTTAAACCAACATTCTTATTATATTTACACAAAGCTATGCTGTATGCTGTGTAACAAACATTTTGGAAAATAAGAAAAATCACCCATAATCATGTTGAACATTATTAGAATTTTTAAAAATTTCCTCCTTACTTTTTTATTCTATGTGTATTCTGTATGGTGGGTGTAAGTTTACAAATTATATAATTGAGAAAACAGATGCTAACAAGAAGACATGCATCCATGTTTCCAGTGAACCTAAAGAGTGCATGTACACAATTCTCAAATTGCTAGAAGGCCATGAATATGTATTCTGAATCATGGCCCAGAATAAATATGGCTTTTTTATAGAACTTGCCCCCATAGTGTCTATTATGTTGTTATATAGTTTTCATAGAAGCAACTTTCCTTAAACTGTACATGAATGTTTAACAATCTGCAACTTTCCTTAAACTGTACATGAATGTTTAACAATTTGCCAGTGCTGACCATTTCACATCATGAGACTCTACCCCTATCGCTAAATTATCATAATAATGCAAAAACCTGTTTGAAGGGTTTCAGTATTCTAATTGAAGAGAAGCATCATAGTTGGTTATCAATATTGCATTTCTAGTCACTGAATATAGAGTTGAACTCTATGAGGCTTTTTCATGGCTCTCACTGGAGGCTTTAGTCCAGTGATTTGCTCAGAACACGAAGCCTTTCCACTCAGGGCTCTTTCTAAGCATGTCTCTAGGCACAACAATACTCCAGCCACAGTTTTTATGTGAAAATTGCCAGTTCTATGTTGAATATAATTAATATAAGAATGGCATAAGGAAAAATATTTCATTAAGCAGTAGCCCCACAAACTTTCAGGTTAGTTTCAAGCACCTAAAGCTCTTTTGCCTAATGGTTATTACTTTAATTTGAGAACTGGTACATTTCCACGTTAATTATTTGCAACCTCCTCAAAGTCATTCTGAAATTTGGGGCCTCCTATGCTGCTTGTTGATCCACTGGTCATCCAGAAATAAACCATCTCTCTCTCCGTTTCCCCTGCAGAGGAAACTGGACATAGAAACTGACTATGCCACTCTTACCCATCTCTTGTATCCCTCTGCATGCTTGCCTCCCAGCTCCCTCCTGTCCAACTCACAAATTGCTTTTAAAAAGCATTTTTATTTTCCCTTCAGCCTCTACTAAAACCATGGTAACCAATAACTGTTGCAAACCTACTTCATTAACAAATATGGGGCTTGATGCTATGGCTCACACCTGTAATCCCCTGACTTTGGGAGGCCAAGGCAGGTGGATCACTTGAGGTCAGGAGTTCGAGACCAGCCTGACCAACATGGTGAAACCCTGTCTCTACTAAAAATGCAAAAATTAGCCTGGTATGGTGGCACATGCCTGTAGTCCCAGCTACTTGGGAGGCTGAGGCAGGAGAATTGCTTGAACCTGGGAAGCGGAGGTTGCAGTGAGCTGAGATTGTGCCACTGAACTCCAGCCTGGGTGACAGAGCGAGACTCCCATCTCAAAAAAAAAAAAAAAAAAAAAAAGTGGTTGACTGTTTTTGTATTGACTAGATAGCAGAAGGAAAAACTAACTCAATTAGTAGACACAAAACCTTACTTTCTTCAAAACAACATTTTTGTCTCCTTTTAAAAAAACAAGTGTTGAGCATTATCTTTCATTGAAGGCAAACAGCTTGAATTATTTTCTTCTTATTTCCAG
>TTN-203,,0,860,538942,539801,GTAAGTAAAAAAAAAAAAATGTATACTTAATCACTTCTTTACTCATTTAGTACAAGACTATGGTGAAAAAATATGTGTATAAATGCCGTACATTTCATTCACTTGACAAGCAGTTATCACACAACTACTCAGTATCTGATTTGGTAGTATTTGGACAGTGATTGTGAAAGAGATTTTACAAATATGTATAATTCATTGAATTTCTTTTTGTTTTTTTTTTTCTTTTTGGTTTTGTTTTGACACATAGTCTTACTGTTACCGAGGCTGGAGTATAGTGTCATGATCTTGGCTCACTGCAACCTCCACCTCTGAGGTTCAAGTGATTCTTGTGTCTCAGTCTCCCGAGTAGCTGGGATTACAGACATGCACCACCATGCCCAGCTAATTTTTCTATTTCTAGTAGAGGCAGGGTTTTGCCATGTTGGCCAGGCTGGTCTCAAACTCCTGGCCTCAAGTGATCCACCTGCCTCGGCCTCCGAAAGTGCTGGCATTACCACTCCTAGTTCATTTATCAAATTTCTTCCATCTATACCTCACAGATTTTTTTTTAATTTCCCACTTAATGGCATTAATAGAAACTGAATTATTTTCCTACTTCTAAAACTACCAATTCTGAAGACCTTTCCTAAATTATTTTGCCTCAACAAACCTCTATTTCCTCATCTGTCAAGTGAAGAAATTCAATTGTATTGGGTCCTTTTTAACTCTAATAGTTTTATGATGAGATCTCTTTTGCTATTTATGGGAGCAGAGAGTTTAATGTTTAAATGCAATCTTCAGAAAAGGAATATTCACTACATCCTACTACATTCTTAATGTGACATTTTTTTCTACCACAATTCCTATACTTATATTCGCAG
>TTN-203,,0,101,539802,539902,GTATGTGTCTACTACAATTTATACTTCTGAAACTTGCACATTTGTAGATTTGTAATAAGACATCAATAAAAATGACTTGCCTTTATAATTACAAATTTTAG
>TTN-203,,0,93,539903,539995,GTAAGTCTTATTTAGTGGAAAGAATAGATCTTCTGTTCTTTCAAAAGCAGAAATGGCAATAACATTTTGTGCCATGATTTTTTTTTTCTGCAG
>TTN-203,,0,92,539996,540087,GTATGCATTATGTTTCTTTTTAGTGATTCAATGCTTGATAAAACTAATATAAAGAAATAAATTTCTAACGCATTTTCCAACATTTGTTACAG
>TTN-203,,0,89,540088,540176,GTATAGTATTAATGGATTTATTCAGTTTTCATGTTATCTAACTTTGTTTTCAGCTATATGCTAATTCGTTTTTTACTTTTATTTTTTAG
>TTN-203,,0,114,540177,540290,GTGAGTAAAATGCTCTCACTTGTGTTTGCAAGGAAAATAGATGTCTGATTGTATGTGTTTAATTGTAATCTGCATTATGGATCAAATCTGAGTGTTCTGTTCTCTTTATTCTAG
>TTN-203,,0,101,540291,540391,GTAAGAATTTTACTACTTAGGCCATTAAAAATAAATTTTGATAATTTTGAGCTCTTATATGGATAAAATTACTTATCAAACTGTTATTTAACACTTTTTAG
>TTN-203,,0,85,540392,540476,GTAAGTTGCTTTCTCTGAATACAAAACTATTGTTTGACTGTCTTTAAGAATATTACTTTTTCATCATAACTTCTTCTTTGAAAAG
>TTN-203,,0,94,540477,540570,GTAATTTTTGGACTAGCAGTATTACCTTATTTCTTTTTAAAATTATTCATATAGGTGAAAATCAAAATCTAATTTTTTCATGTTTACTTTTCAG
>TTN-203,,0,318,540571,540888,GTAGGATGTCCTTGTTTTTTCTGATATTACAGCAACTCTTAATCTCAAGCACAGAAGTATTCGATAAATAAGTTAATGTAACATCTAAATCTGTAACATCCAAACTGTATTTAGCAAATATTTTTCCAAATAGACCTTTTACCAAAATACCTAAAAGGTACAAACAATAGTAGATTCTCATTTTTATGAAGGAAAATAAAGAGGACACTAATTGAAAAATTGGATGACCTATATTTGATTAACTGAGAATAGGCTATATAAAATTACACATTGAAGTATCACTAGTAGTAGTTAACTATATGTATATTTTACTTTCAG
>TTN-203,,0,98,540889,540986,GTAAGTCCTTCCCTTAGCATGTGATTCATTCACACTTAATTTCTTATGATTTCCCCACATTCTGAAAAATCAATTAATGACCTTAATGTCATTTGCAG
>TTN-203,,0,98,540987,541084,GTGGGTTACTAAAATGCTTCTCCCTCCCACTTCAAAAATGAATTTGTTAATAGGGATGCTGAGGAGACATGTATATCTGATTTTATGATTCTTTACAG
>TTN-203,,0,310,541085,541394,GTAAGTATTATGCTTTCTTCCTCCTTTTAACCCCAGTCTCCTATTTTAGCAAGGTCAAGATACTAATACCATTTTAATCCACTTCTGAAAGAGATTTCATTTGTAGAGACCGAAATAGTGTAATAAATATCTATCTCACTCATGAAACACTTTTTTGATCTGTCTCATCTTATATGTTTTGCTTTTAATGTACTGAACTACAGGTTCTATGTACATTGGAGCAAATCCATACTAAAACTCTTATGTACATTAACAAAGGGGATTTGATTAGGTTACCTAGGTAATCTTCTAAATTATGTTTTTCTTCTAG
>TTN-203,,0,1157,541395,542551,GTAAGTAGTCTTTGCTTCATTTATGTCATGTGGTAAGTTTATTAGAATTTCTTCTTTTATATGTAGACATTTCTCCCTGAGGAATCTAGCTCTAGAAATTCTTGAAAAACAGTAGAGAACAGTGGCTTTCAAACACATGAGTGGGCCAAAAACACACAGTAAATAAACTTATACAAACACATATATAACTAAAAAACATTTCCTGAAACAATACCCATTTATTATCATGTGCATTCTTATGTTTTCTACCCTATTCTGTGTTTTTAAAAATATTGGCTGTACAACAAACATATGAAGAAAAGCTCATCACCACTGGTCACTAGAGAAATGCAAATCAAAACCACAATGAGATACCATCTCACACCAGTTAGAATGGTGATCACTAAAAAGTCAGGAAACAACAGGTGCTAGAGAGGATGTGGAGAAATAGGAAAGCTTTTACACTGTTGGTGGGAGTGTAAATTAGTTCAACCATTATGGAAGACAGTGTGGCGATTCCTCAAGGATCTAGAACCAGAAATACCATTTGACCCAGCAATCTCATTACTGGGTATATACCCAAAGGATTATAAATCATTCTACTATAAAGACACATGCACATGTATGTTTATTGTGGCACTGTTCACAATAGCAAAGACTTGGAACCAACCCAAATGCCCATCAATGACAGACTGGATAAAGAAAATGTGGCACCACATTTACACCACAGGATACTACGCAGCCATAAAAAAGGATGAGTTCATGTCCTTTGCAGGGACATGGATGAAGCTGGAAACCATCATTCTCAGCAAACACAAGAACAGAAAACCAAACACCACATGTTCTCACTCATAAGTGGGAGCTGAACAATGAAAACACATGGACACAGGGAGGGGAGCATCACACACTGGGGCCTGTCAGGGGTTGGGAGGCTAGGGGAAGGATAGCATTAGGAGAATACCTAATGTAGACGATGTGTTGATGGGTGCAGCAAATCACCATGGCACATGTATACCTATGTAACAAGCCTGCACATTCTGCATATGTATCCCAGAACTTAAAGTATATATTAAAAAAAATTGGTGGTAATACAAGCATTAATTTGCACCAGTATAGCTCTCCACCAGAAGAAACTTATCCACCTTCCCAAAATTAATATCTTTTCATTTTACTTTCAG
>TTN-203,,0,103,542552,542654,GTAAGTTAAGTATTAGACAAATGGCCATCTAAATATGAAGCTCAGAAATATTTTTACGTATCAAATCCTTGTTCTTACATTTCTTTCCTCTTGGTTCATGTAG
>TTN-203,,0,90,542655,542744,GTATGTTTTTGTGAAGGAGAAAAAAAGTTGTTTTCTTTCTAGTTTGTTACTTAATGTAGAAACTGACATCTTCCTTGTCTTCATCTCCAG
>TTN-203,,0,369,542745,543113,GTAAGTTTTGGGGTTTTTTTATTGTTGTTGTTGTTTTAGTATTATGGAGGCACATTTAAATCTCGGAGTCTAAGATTTGGACTCCAAGACACAGAGAGTAGTAGAGATCTGAAGATTACAACTCCCATTTAAGAATATGTTCTATCTCTTACAATGAAGATGACATATTAAAAAAAGAAAAGGACATATAATTTCCTTTAAAGCATACAGCAAGGACTCAAAAGTGCATACTAGTTGGACGGTTATTAAAATGGGATAATTGTCTTCCTGTTGAGCTTGTTACTTAGCAGCAGGGATGATAATGTGAAATATGGAAGTTTAAACTTCTGCTGGTAAGATAAATGGTGAGTGTACCTCTTTTTGTTTTAG
>TTN-203,,0,379,543114,543492,GTAAGATTCTGCTGAGTATTATAGGCAAAGATGTAACAGCATTCATGATGGTCATTTTTCCTAATAAAAAACTAAATATACACCTAAGGAAAAAAGGAAAATTAAAATGATGTTTTGTATATAGACACAAACATTATGATTATGGAGAATCATAATAACATGCTAAATTAAAAAGCAAGATACACAACTGTGGCAACTATATAATTTCAATAGTTATTCAATAGTGCAGTTATTATTTGTCTATTAAAAATAAACAAAATGAAATAACACTAAAATTCCATTCTTGAAAGAAGCAGCATATGAATTTCCCACTATTATTAATAAGGATTACATAATATAGCTTTGCATACATTAAGTCCTTTATCTTATTTCTTTCCAG
>TTN-203,,0,347,543493,543839,GTAACTAATAAACTTCATTGGAATCCCATATTTTACTTTGGATAATGGGATGTAAATAGGATTTACAGAATAATGTGGGAGAAGACATTCATATTCTAATGTGTATTTCCTATGCACAGAATTATTCTTATGACAGAACCACGTTTTAGAGTTAAAAAGAGCTTTAGAAATCACATATTTCAATTACCTAATTTTACAAGTGAAGAAACTAAGATTCTAAAAAATTAACTAACCTCCTAGGTCATATAGGAAATTGACAATAGAAAGACTGCAGCCCAGGTCTCCAGACCTCTACTCTATACTCATTCCCCATTCCACATATTCACTCTTCTTCCTTATTCCTTCAG
>TTN-203,,0,87,543840,543926,GTAGGAACATTTCCCGGTGGTTTTTCATTTTATTTTTTAAAATTATCTTTTAGCCTGGGAAATTAACTTTTCAATCAATTTCTGCAG
>TTN-203,,0,101,543927,544027,GTAAGTGTTCATGAACGAGTTCCATATCCTGTGTTAAAAGCAGCATTAAACACCCAGGAAGGAAGTTTTCATGAAAATTTCCTATCATTATTTATTCTCAG
>TTN-203,,0,889,544028,544916,GTAAGTATTACCAGGGGGAGTACATAAGGCTTTTCCTATTAATCATATTCTAAGAGGGAGACTAGAACTCCCTTAGGTAGATTAATTTATTAACAAGGTGTAGAGCTGGTAACTCCAAGAGTACTTTTTAGGAGAGCTGGGTGGGTACTTTACGGTATTGTGGAACAGGCAAATCAAATGCACATGATTTGTGGTTTTGAAAAGCTTTTCATATATATAAGAATTTCCTGTCTTCAAAAGACATGAAATGAGAGAATTTTATTGGAATGTAAGAATTTTATTTTAGGAATAAAGAGGCCTTTTAACTAAGTAGTGAGCTATTTACTATTCTTAGGGTTTCTGTTTTCCAATCCACCATCTCCCTAAGTATGTGACTGGTGGGCTCTCCATCTTAATTTCCCTTCTTCTTATTTCTTCTATTTGCTTATCCTCCATGATAATTTCCCCTTTATTTGAATTACTTGATATTATATGTCACCCTCCAGGTACTTTTCTTCCTACTATGAAATAATAAAGAGAGCTAGAATATGTGGCAGAATACCTTCATGGAATATAGAAAGGAAAAAACAAGAATGAAAGGGAGCCAAAAATCAATCGTCTACTTTCCTTTTAATATATGTAGCATTTCAGAGTACATAAGGCTCATGAAAGAGGAGGTACAGATCCTCCGGGGGGAAAACCTGGTTAAGCCTAAAGCATAGTGGAAAATGGAAAGATCAACAATTAGTACAGAACAGAAAAATGATTTTGAGGATTGTATTAAGGAAGTTTTAAAGAACAAGAAATCAGCTCTAGAAAATAAATGTATTTTAGGAGTGACAAGGCCAGTCCCTGGAAATACATTTGACTATTAAATTTTTATTTAACTTCTTCACCCAAAATTAAACAG
>TTN-203,,0,92,544917,545008,GTAAGTCTATTTCAAAAAAGAATCATATATATTTTAAAATAGCTTATGTATTTTTTACACATTCATTTCTTATTTACCTACTATTTATCCAG
>TTN-203,,0,90,545009,545098,GTAAGCAAATGAACCATCATCCCATCATTTTGAGTTATATCCTTCCTTTGTTATATGGGGCTTACACTTATCATTTCTCCTTTGCTTTAG
>TTN-203,,0,167,545099,545265,GTAAGGCTCTATGCACACATCTTCATTTTTCCTTTATTGTCATCGAAAGTGCACTCTTGTGTCCCACTCACTAGCTTATCTAAAAATCCGTTAAAAGCTAGAACTATTTGAAAAAGTTAATCGCCTGGCCTTAAAAATAACAGTAATTTATCTCTGCTATTTTACAG
>TTN-203,,0,90,545266,545355,GTAAGTGTCTTAAATTCAGAAGACGTAAAGCAAAACACGGTTTTGAGGAGGCTTCTTATTATAAATCTTGCATTATCTACTTTTTTCTAG
>TTN-203,,0,425,545356,545780,GTATTTTGTTTGTTCTTATCCTACAGCTTTTACATCAAGATTCCTCACAAATATTTCCCTGAGAACAGTTGAACATGTGCTTATCGATAACATTATCTGCTTATACAGAAATGTGTTTTTATTTCAGTACATATGGTTAATGTTTAATTTTATTGAAAATATCCTAATGTAATAGTTAATAAAGTATTTCTTAATTATAATATCTATTTTTGTAAGTTAAAATTGTTCACCAAAAAAGACAACAACTATGCATATTCCAAGAGGAAAAAAAAAATGGCACTATGCTTGGGTAATAAAAGTATAGATACTAGCAAGAATGACTACTTGTTCAATATATATGGATATGTATAAATAATTTGGGCAACACATATATATTGTAAAATCAAGCTGCATTTATACTTGATACATCCCTGGGTCTTTTGTAG
>TTN-203,,0,89,545781,545869,GTAAGTCATTATATGAAGAAAAACCCAGGTGCATGTTTTACATGAAGAAAACTGGTATTTGTTTGACTGGTTTTGCTTTTATGTTTTAG
>TTN-203,,0,91,545870,545960,GTAGGTCCATTTTACTTTTTATGTACTTTTTTTTTTAAAGCAAATTAAGCCTCCTTCCTTTTCTGATTAAAATGTATTTTTTTCTTTGCAG
>TTN-203,,0,91,545961,546051,GTATGTAGAGCATGTGAGGGAATTGACATGGAAACATTTATAGCAGAGTTTAGGAAATCATGGATTTCTAATAAATTTGCTTCCTTTTCAG
>TTN-203,,0,112,546052,546163,GTTAGTATTTGTCTTTTTCAACACCGTTCATTCCAGAGTGCCAATATTTTATCTAAATTACCCAAAAGCCAAACTCTGAATATATACTTTTGTGTCTTTGTTTCTTTCTCAG
>TTN-203,,0,673,546164,546836,GTATGTTTTAAGAATAAGGAAATTCTACATATCCACGTTAATTTTGCTAGAATAGTGTGAGTCATTCTAATTAGTCGTTATTTCATCTTAAATGCTTTTGGGTTCACACCCTTCACACCCCAAACTATTCATACTATGGCACAAAATGGAATCTCTAGTGAAGAGTCTTTCATTGATTAAAAAAACAGAAATTTACGTAGCTAAAATTGGATAATATATGTTGAATTTAAGTATTATTGAATCTAACTGTATATATATGTAGGTATACATGTTTATATATATATATACACAGATTATATATATATAGTATGTGTGTATGACATATATCATATGTGTGTATGTGCGTGTGTACAGAAATTGTATATAAAGTTTTTTAAAAGATTGTTCATCTTGTTCCTCTTTTTTATCCCCATGGTGAATTTGGAGTAAATTTTATCATTTAATCTGGTCATTTTACCCTTAATTTGGATTTGAATGCTATAGCATGTAATGACATAGCTTGTGGGAGCCTTGGTTGGTTCAGAAGCAAAATGGGTTATGTAAAAAGGAAGACTAAAATCAACATAAAAATATGGCCTTCATTTAAAAGTTTTCTTTTGACAATACATGAAGAGTGCACATTTAAAAGTGCTGTAATAATTATTCACTTTCTTTTGATGCTTTGTTTTCTTAG
>TTN-203,,0,105,546837,546941,GTATGTCTAATTTTGTGTAGAAGCAAAATTTGAAATTATTTGCATTGATTTATGTTAATTTTCAGAAACACTTTTTCACTTTCACTTTCTATACTCATTTTTCAG
>TTN-203,,0,92,546942,547033,GTAAGTTGTCCAACTTTTCAAAGATCCAGGTTTTCTTTTACCATAAATGTGTTATTGTCTGTACTAATCTATAGGATTTCTCTCTTTTGTAG
>TTN-203,,0,108,547034,547141,GTACGTATTTGTCATGGGAAGGGCAGTTCTGATAACAAAAATGCAAATCTTACTTCTGCGAAGCAAAATATTATAAGTGCCGCTAATCTGCTTCTCTTATTACCACAG
>TTN-203,,0,1695,547142,548836,GTAAGCATGCTTAGCACTTTGAATCAAAATTGCTATTTAACTCAGTATTTCCGCATACCTTTTCCTGGTTCTAATCCTATAGAATAACTTTTACTCTGTGCCTTAATGGGGTTTTTGGAAGAAATTATGGACTAGCTGGGAGTCTGAGGAAAATTCCTTAAATACCTTTCCAGCCCTCTTGACTTGACTGTAAAGTGAGAGATTTAGACCTCAGGATATCTATGGGCCTTTCCAACTTCAACCTTTTATGATTGATTGTATGAGTTGGTGCTTTCATTCTGTTTTAAATTATCAGAGTCAATAATTAAACCATGGTTGAGTTCCTAGAGAATATTGCTCTTAAATAAGCCACAGACTAAACAGAGACTTCATTTTTTGGTTTTTTTTTTTTTGTTTGTTTGTTTGTTTGTTTGTTTTGAGACAGAGTCTCACTCTGTCGCCCAGGCTGTAGTGCAGTGGCACGGTCTTGGTTCACTGCAACTTCCGCCTCCTGGGCTCAAACGATTCTCGTGCCTCAGTCACCTGAGTAGCTGGGATTACAGGCATGCCCCACCACACCCAGCTAATTTTTTGTATTTTTAGTAGGGACGGAGTTTCACCATGTTGGCCAGGCAGGTCTCAACCTCCTGACCTCAGGTGATCCACCCACCTCGGCCTCCCAAAGTGTTGGGATTACAGGTGTGAGCCACCATGCCTGGTCTAAACACAGACTTTGATGATGATAGTATTAGCAGCAGCTAACATTTATTGAGGAATTTTCATGAATTCTTTCCCTTAGTTCTCACAGCCCTCATATTAGCCATCTTATAGAAGGGAAACTGAGGCTGAGAGTGCTTTTGTAACTTCCCCGTTAGGGATGGAGTGGGAATTCAGACAGACAGACTTCAGAGCCCTCTCTATCATGGTTAGTCCAAAATGCGTATTCTTCACCATTCTGGAAAATAAGTGGCACATTCAACTCAACAATGTTTTGAAAATTAAAACGTCATGAGAGTCAGGTATCCTGTGACACTTTACCTAAAAGATCTCCATTTGCTAAGAGAAAATTGAGCCACTGTAGTGTCTGGGCAAAAGTATCCACTTCCATCTTCATGCTGAGAATCTCAGGGCTGTTCATTATTTATGAATCAGGCTTTGTGGATACTGAATCAGTGTTTATGAGAGTATAAAGCAAGTCGAATTTAGTTATCTTTCTTGATAATTCCAAACAGCATGGCAGAAAATCTGTCCAGTAATTATGTAGCTCTGTGGGTAGAGAATTCAGACTTTAAGTGTCTGACATGAACCATCCACACTTGGATATCAGTGAACTGGGATGGGAAAAGAAAAAGAATAGGAGGTGCGTAGAAGAAAAGGAAAGAAAAGCTAAAGTGAAAGGAAATGTTTTAACAGCTTCTTCCATGATGTTCTCACTACCATATCCCATTTCTTCACTGGAATAAAGCAACTAATGGACTTTAAAACACATGTAAAAGGTGCTTAAGTCCCTGCACAACTCACAGTCTTTCTACCCCATCTGAGATAGAAGAGTGGCCTATAAATTTTTAATTTTTAAATAATAATTGCATAGAATTATAATGATGGTGTGTGTGTATAATTTAATAATGGCCAATGACCTTACTTTAAGGTTGGTGCAACTATTTTTTTTTCCATCCTTATAATATTTTAAATATTTCTCATCTGTTTTTCTTGCAG
>TTN-203,,0,112,548837,548948,GTAGGTGCTGAATACAGACCACTGTCATATTACATTTGCCTAAAGCTTAGTAATTTTGAACAAGTAGGCTTTAAAGAAGTACTAACATCGTGTTTTGTCCTTTCACTGATAG
>TTN-203,,0,236,548949,549184,GTGAGACATGATTTCATTAGAAAACTGAAACGTGAAAAATTTAAAAATAAACTACGCTAACCTGTGCATATGCTTTAATTTTCTTTTATATAACACCTGTCTCATTACCATCCTTTTCACAAGGTGAAAAATATAAAAAATAAAACCAATGTTCTTGGAAAGAATGCGAACATCAAAGGTATAATTTATCAGTAATGTGGATTCTTGTACCTTGTTTTCCCTTCCTTTCTAAATAG
>TTN-203,,0,106,549185,549290,GTAAGTGCTCATACCTGCAGCATCTTCACCTGTGTCTTCTATATTCACCTGTGTGACTAAATTGTACATGATTGTGTAATTATTTTATTGTGAATGGCCATTCCAG
>TTN-203,,0,105,549291,549395,GTATGTACCTACTGGTTTGATTATGTTTTTTAATAAGCATACTTCCAGGAAATCACTCTTTTTTGCTTTTAAAATTCACTGTATGTATCCATTTTATGTCTACAG
>TTN-203,,0,369,549396,549764,GTAAGTGATTATTATTCAAATACATTTAGTTTAGCAATTGAACATATTAGAAACAAATATATCAAGGAATGCTTTTCTTCTCTGCATCACCTTCTTACATATCTTCTTGTCACTAGAGAACTGGTCATGTAAAGCAAGAGGAATTATTTTAAGTCAGTCTAATAAACTAATTTGAAGTTCATTTTAAAGACTATGAAATGGAAAGTTGAAATTAATGACCAATATGAGTTTGGGAGATTGAATAAATTACTTATTATAAAAATTTTACTTATTTATTAAAATTATAGAATAATTGTATTGTTCTTCCATGGATGATTAAGACCTGGTTACAAATGTAATGATGCATTTACCTTCCTTATAATTTTTTAG
>TTN-203,,0,693,549765,550457,GTAAGCATTTACAACTTATTTCCAATGAGACTAAGAGCATTCACATTTTTAAAAAACACATTTGGCCCCTGGCCTGTAAAATGGTAACAGAAACAAATTACCCAAGGTTGCTAAGTGGATGAATTATGTCTTTCTACCTTTCAGATGAAAAGAAGAAAAAAATAATTGGCATCAATTATTTTTTCTATTATTTCACTCCATTCCCATATAAAGAGCATGCAGCAAGTGGGAATGAGTTTTTAGCTTTGTAATTTTCGCCACTTAACAGTACATAAAGAAAAGGTTCTCGAGAATAAGTGTCCATCTTTACTGAAGTTATTAAAATACAACATACATCCAACAACACAATCATCCCCTTGCTTGAATGCAGCTGATGGCCTCTTAAAAGAACTTGTGTGACTGTGCAGCAGTATTAGGAAGTACATGATCTGTAAATGTTTCACTTTCCTTTTTACAAAGAGCAATGCAAAATTAAAAACATGACAGGCATTACAAAGGGAATAATAATAGGCAAATATTTAACCCCATAGTCCAAATTCTCAATTATCAATCCTACTTTCAAAATAGGCTTTGGTAGCACAGTAGAAGTCACTACTCTTCCTGGCCTTGTGATATGGCACTACTGAAAAATATATATTTATGTATGTCTTTATTAAGCCAAACTAATACATAGTATTTCTCTTTCTTTTATAG
>TTN-203,,0,116,550458,550573,GTACTTTTAAAATAGCTTCTTAATGCTACAATTTATGAACTTGGATTAGAGACATGCCTAGTTGTATTTTAATGGACAAGGAAAAAGAAACTAACTCTAGAAACTTTTTCTTATAG
>TTN-203,,0,96,550574,550669,GTAAGTTTGCGTTTTTACTAAGCGGTACTATGTCAAAAGTTTAACCTTCCAAGCAAATGCATCTAATTGATTTGGGGTTTTGTTTTTGTTTTACAG
>TTN-203,,0,101,550670,550770,GTAAGAAAAATAAAAATCCTATTTCAAAGTCTCTATTATTAAATGTTTCCCCTGAATTTTATAAAATTGTATTCATACTTAATACCTTTGTTTATATTTAG
>TTN-203,,0,97,550771,550867,GTATGTATCACAATTTAAGGGCATATTTGTTTATTATTACTGATTCTAGTAGAACTCAGAGTGGTATATTTTAACCTTATTTTTGCATCCCTTCCAG
>TTN-203,,0,97,550868,550964,GTAGGAAATAGTCAACATTCTCCTTTTTAAAATTATCTCAATTTATGTGAAAATAAACTCTCAGATATTCATTCATATCTGTTTTGCCTACTGACAG
>TTN-203,,0,95,550965,551059,GTAAGCATGTCAAATGTTCTCACATTTATATAGCATTTTCCAGTGTGGGCAGAAAGAATGATCTTCATCATGGCTTGTCATTACACCTGTTTCAG
>TTN-203,,0,126,551060,551185,GTAAGTATTAACACTTTTAAATAATTTGACAGTTGAAATGTAATAGAATCAGGGGGAGAAGGGAGAAGGGCAGTCTTATCAATAGTAATTTTGTGCAATTCTCATCATCCTTATTTTCATAAACAG
>TTN-203,,0,881,551186,552066,GTGAGCTCCAAGAATCATACATAAATACAATGCTCCTCAAAACTATATGACAGATAATTTTCCAACACACAATCTCTAAGAATTTTTAGAATTTATGAATGGTCTAGAAAAGCACATGCTTATTTGCATGATCATAAATATAGCTTAAGTCAGAGAACATTTTAACTATTACATCTGTTAAGTTAGCAATTAGAATTGCTAAAAGTTGTACAGCATTTTCCAATTAATGAAAAAATATTCTATCAATATGAAAAGAATCTATTTTATAAATTTTCCTTAGAGAAAAATGCATTGTACTGTAATAACTGAAAAGAAAAATGGCAAAACTCCTTTTAAGAAGAGGTTTAGCAGGAACATACAGTTTCTAGTGGTTTCATAAGTTACTGACAAAGTAATTGTGACAAGAGCTTCAAAAATAAGTGGCAAATCCTTTTACAGAGTCTGAGCCCAAGAACTATAAAGGAATAGTCACTGGGACTGAATTGGGGAAGCTAAGGAAACCAATTCTTGTATTCATTAGAAATGTATTGGTGGCAAGTGATACTAACCCAGTGAAAGATAAGCAACTAAAGAAAAGTCCCTAAGAATGGGTACTTTAAGTAATGAGCTTAGCTAATAGAGAACACACAGTAAAGCTGGCCAAAGAAGTAGGGAAGAAATATCTACTTTCCTAAAGCAATTTAATTCTTAAGATAATAATATTAAATTATAATGTGGCACTCTGTGCTGTCCTATAATATCAGGAGCCCAGTTAATAAAGATTATCTTGGTGAGTGTGGACAAGAGCAATAATGCCTTTGTGAGTCTTGAAAACAAAAAATACAAATCTCAACATTTCCTTATTTGCCTAATATCTGCATCTCACTTTTTAAATTCCACAG
>TTN-203,,0,85,552067,552151,GTATTTATCACAGAAGCTTTTAGGTGAATTATTTTCTTCTCACACCTGTCCATGAATTAATTAAATTTTGTCATTAACTTTCCAG
>TTN-203,,0,171,552152,552322,GTAAGCATTTTACTTAAAATTGGCTATACAATGAGTAGATCCTCTAAAACAATATAGCTTGACCTATGATTGATCACCTCTCTAGAAAGGAACTATGTTGATTATATTTCCCCAAGAAAAAAAAAGCTATCAGGCAAATAGGAAATATGAATCTTTCATTCTGTTTTTCAG
>TTN-203,,0,119,552323,552441,GTATGTACCAAATAGCCAAAAAAAAAAAAAAAGTAAAGTAAAATGAAAACATTCAGAATTCGTAACAATTTACCATAAAAATAATGCTTAAGAATAAATGCCTGATTTCTTTCCCATAG
>TTN-203,,0,98,552442,552539,GTAAGGATGTGTGACAAAGATACAAGCAAGTTGATGTTCAGTCACCCAATTTTGATTTGAAGTAAAAATTAATTTCCTGTATTTCTTCTCTTTCATAG
>TTN-203,,0,679,552540,553218,GTAAGTCCACAGGCCCTTCCACCACTCTCCCCACCTCTGATTCTGAATGTTAACAAAAAAGAATTTGTTTTTAATATGCCCTAATGTAAATAAAAATAGGTCACAAAATTAACCCTGTGGTCTTTCTAAGGTTTCTAAACCTCCTTTTCTCAGGTTTCTAAACCTCCTTTTCTCAGAGGTTTTCAACACACTTAGGCTTGATTTTTTTTTTAATATCTTCACTCTTATGAAAGAGAAGAGGAGGGAGTTAGGAAGAAAGGAATGGAAGGAAGAAAAGAGAGAAGGGAAGGAGGAAGAGAGGAAAGGAAGGAGGACTGGCAATGTTATAGTGAGAAAAAAATACAGAGTGCATGCTTAATAAATGTAGAATTGAAGAAAATGAGGAACAGCAAGGAAAGTACAAAATTAAACCTCAGCATCATGCAATATACCCATGTAACAAACTGCACATGTACCCCTGAAGCTAAAAGTCAAAAATTTTTAATAAAAATAATTAAATAATTAAATGATTTAAATTAAAATTTACAAATAGTACAAAAGTGAAACTATTGGAAAAATAGTCATGTGCCTTATGTACCTTTTAAAATACCAACCAAAACCTAAGGAAAACACAAATATATGAGTCATTGTTTTAACGTATTCATATTGCCATATCGTGTTAACCTCTGTCTTGCTGCAG
>TTN-203,,0,911,553219,554129,GTAAGGACATTTTGTATCAGTCAAATTGATTGAGTTACAATTTATATGTGGGAAAATTCACCTTTTTGAAATATATAGTTCTATGACTTTTGAAAAATGTACTGTTTTGTAATCACCACCACAATCAAAATGTGGAATATTTTTATTACCCCGTAAAGTTCCCTTGTGTCCGTTTGTAATCAGTCCCTTCCCCACCCCAGCTGCTAGCGATTTCTGGCAAATAATTTTTAATATTCTTCTCTGGAGTCAATTTCCACTTCTTTAAGATGAGATTCATAATATATGCTTTCTATCACACTTAAAATTTTAAAACAAGTTAATATTTCTGGAAGCACTTTAAAAACTGCTGATAAATGTAAGATAATAATAGTGATTACAAATGAAGCACATTTAAGAGAAAGGAAAGTGAAAAAATGTTAAGTATTTTTAGCTGATAAAATGAATAAAATTTTCTTTTTTCTTTCTTTTGTTTTTTTGTGTTTTTTTGAGACAGAGTCTCACTCTGTCACCCAGGCTGGAGTGCAGTGGCATGATCTTGGCTCACTGCAACCTCTGTCTCCCAGGTTCAAGCAATTCTTCTGCCTCAGCCTCCTGAGTAGCTGGGATTACAGGTGCCTGCCACCACGCATGGCTAATTTTTATGTTTTTAGTAGAGACGCGGTTTCACCATGTTGGCCAGGCTGGTCTTGAACTAACTCCTGACCTCAAGTATCTGCCCACCTTGGCCTCCCAACTTGCTGTGATTACAGGCATGAGCCACCACACCCAGCCATGAATAAAATTTTCACAAGACAAAAAAACAGGCTAATGTTAACAGTCCGTTTCAACAACTCATTGAATTTGTTAGGTGGCACAGCTAATTTTCAACTTTGCAGCAACTTTAACCAGTATATTCTTATTCTTATTCTCAG
>TTN-203,,0,101,554130,554230,GTGAGACATATGATCATTTGCTTTCTGCAATAATTGCCATAGACTTATTTCTTAGTCCCCCTACCCCAAATGCTAAATTGAAACCCTACCTTTTTTTCCAG
>TTN-203,,0,130,554231,554360,GTAAGTGCCCTTTCAACCACAAAATTATAAACATTATTTCAGCACTTTTCTGTTTTTAAATGAAAGTCATTGGCTTATAATACTTGGGACTGTATTCTAATACATGTGTGCTTTCCACTTATATTTACAG
>TTN-203,,0,106,554361,554466,GTAAGGAATTCAGAAGAAGGGGTTAAATTAAAGAAGCAAGCCATGTTTGGTCCTTTTATTTCACCAGTAAAGCTGACTCCCTTTTCATTATTTTAAAATATTTCAG
>TTN-203,,0,622,554467,555088,GTAAGTAGCCTTTGGTTCTCTACTTATGATTTACAAACTAAACAAGTTAAGGCTAATTCCCCCTCTATACTAAGTAGAACCCTGGAAAGCTTTATTGGAGAGCAAGTGTTAAGAAAGAAAAGCAAGTACACACACAGGAAATATGACAAGTTCTACAGGAAACCATTCCAAGCACACAACCTCAGCAGATGTTAGATGGAGTGAACTGAGCACTTTCCTTGAGTAATTCCCTCTAATGCAATGGTTTCTTTTTAAAAATATTTCCCAACAAGATTTGAAAGGTCAACAATTGTATGCCACTTCAATGAACCTAAGTAAGGGCAAGAATACTACAGAATTATAGAGAGAATTTACAGTCCCTTAAAAGCCTATACATTATTAATCCCCTTCCAATCATAAAGAGAAAAAAACACTCTACATAAAATGTGACGATGTGCTCATTGAATCCCTATTTACCATATGATCCTAGGAAAATCACTTCAAAGAGTTTTTAAGAATTAGGCTAATATGTAAATCATGGTATGTGTCAGTAAATAAGGTAAATTCATTCCTGATATACAAGGACAAAGGATTACAGATTGAGTATTAACAGTCACTTAATATTATCTTTCATATTGTTCAG
>TTN-203,,0,98,555089,555186,GTATTTTATTTTTATTTTCAGTGCTTTTTATTTTTAAAGAAAAAAAAATCTCAAAAACACACTATGAAAACCACCACAATTGTATTTTCCCCCAACAG
>TTN-203,,0,362,555187,555548,GTGAGTACAACTTGATTTCTGTATCTTCCTATGGTAAAGTTCCATCTTTGCATAAAATTCTTTTAAACAGAAAGAAATTTTGAAAGGAAATAGCAAAGATTCAGATAAAGTACAAGTGCCTTTTCTTTCACTTTAATTGAATGTTTGCATATCTAAAAGGAGAAATATATATCCTAACCCCATTGTAAAAATAGAACTTTGGTTTTTGATATGTCTTAGTATAAAGTAACCAATTTCATCTTTCTGGAATAGCTATTTTTTAACAAAATTTTGGACTCATATAACATTCTTTTTTAAAAAAATAAGCTTTAATAAAGCTGCCTGTTTCATCTCATGACTCAAATCTTTTTTTTGTTTAATAG
>TTN-203,,0,132,555549,555680,GTAAAAATAAATAAATTATCATCAAGTTGAGGCTAAATGAGTTATTAACTTGGGGGTGGAGGCTATTGCACTTAAACACATACTGTTAGATGTTGCTAAATTATATTCTTTTTTTTTTTTTTTCTGATACAG
>TTN-203,,0,124,555681,555804,GTAACCAGTTCTTAAATGTCTCTTTCTTTTATCTTCTAAAATATTTTATCTTCTAAATTCAGCTTCCCAAAAAAAGCTTAAAATGAAATCACTTTTTAAAACACAAATCATTTGCATTCTACAG
>TTN-203,,0,740,555805,556544,GTAGGTTGGCTTTTGTTTTTACCCACATTTCTTCAGAAGATAATATTAGGGAAATATTTTCAAACATCCCCCCTTATATACACATACAAGAAAGTATTAAAATAAAATTATTTTCCTAATTCCAGAATACAATTTGTACACCAAAGCAGAAACACACATTTGAAGTTAGCATATGCTTTTCTATGAGCATAAAAAGCAGTTATTAAGTACCTAGTTATATGTGGTATTATATAAGATTCCATAGTGTCAGCCCCTGCTCCCAGGAATATTTAAGAATAAAGTCAGTGAATATACAAAATGGCACTACTTGCCTAAACCTTCACAGTTGCTAATTTTCCAAAGCAGTGCAAAGTTAATTAAAGAACTATTTCTATTTTACCAATTAAAATTAGTTTGCTTTCATTTCAATCTTCTGAAAGATAATTTAATGTTTTGGTTACTCAAAATCTCCCAAATCCACTTATCTCCTAAATCCGTTGACTATTCTTTTCAAGACTTTTTTCCTTAAGTCATATGAATCATCTTTGGCTCAGTTTAGTTTAAGGAATCATTACAGTGATCTCAAAAGTCACACATGATAATTTTCCAAAAGTGGAACTGAGAAAGTATTAGGTATTACCTACATTGCATGAAGAAGTTGACTTTTTTTCTTTTTATGTTTTTCACACGCAGAATCTAGAAGAGTAAAAGGTGGGGGTCTCTTTCTAATTAAGTTTGCCTTACAGAGGTTTCTTTTTTAG
>TTN-203,,0,100,556545,556644,GTAAGTTTAATTATGAATATATTATTGAAGAAAAACTAAAATACCATGTCTTCCACATCTGAAGAACTTCAACATTTCTTTTCTTTTTCCTTTGTCTTAG
>TTN-203,,0,525,556645,557169,GTAAGTATCTCCTCACCCTTCTTCCTTACATGTTTAAGGCCTTTAGATCGTTTTTTTGCCTCTCTTTCAAGCACAGAAAACTCTAAGAAGCCTTATTAAATTCCATGTGAAAGAGGGACAGCCAACTGATGTGAATTCATTCTTGTAGTCAAACTTTCTTTATAGCTACACAGAAACTTGGATAGATTACATTTCAAAGTAAAGCTACCAACTGCCGTGTAACATTTATTTGCAGGATGCACAATATGTCAATTACTTTCTATATGACTAATCATTTTTCTCCTAGTGATTCCTAGCACCTGCATGTAATGTAATGATAGAAATATAAGGATTCATGTTTTGGAGACATTGAGCTAGCTCTTGACAAATGTATGTATATATGTATTTGCTTATGCTTCAACAGCAAATTGTTTGGGTTATGCTGCTGTGTGTGTGTTGAAGTTTCCATTTCTGTAAGTCAGCGTCATATGTCATCAATTAACCAGATGTCATTGATGTTCACTGTGTATCTGCTATGCTCCACAG
>TTN-203,,0,138,557170,557307,GTGAGCAATAAAATTACTGGTAGAGGTAGACAAGCCAAGTAACATGGTGTAGTCTTTAGTACACACAATTCAGTAGAAAGCAAATCTTTATTTTTTTCAGTGATTCTAAGACCTTTTTTTTGTCATTGTTCCATAAAG
>TTN-216,ENSE00001465556,1,212,557308,557519,GAGCAGTCGTGCATTCCCAGCCTCGCCTCGGGTGTAGGGATTGCATAGAAAAGCAAAACTACACAGTCTTGACTGTGTAGTTTTGTTTTTAGGATTAGAGGCTCACCGATTCATGTCGGAGATGGTCAGAAAAACCAACTCTCCATAGGACGTCGTTTCAGAAGCAACCTTGGGCTTAGTCCCACCCTTTTTAGGCACTCTTGAGAAATCAG
>TTN-216,ENSE00003502146,1,104,557520,557623,AGTGCCTAGAAAGATGACAACTCAAGCACCGACGTTTACGCAGCCGTTACAAAGCGTTGTGGTACTGGAGGGTAGTACCGCAACCTTTGAGGCTCACATTAGTG
>TTN-216,ENSE00003807606,1,204,557624,557827,GTTTTCCAGTTCCTGAGGTGAGCTGGTTTAGGGATGGCCAGGTGATTTCCACTTCCACTCTGCCCGGCGTGCAGATCTCCTTTAGCGATGGCCGCGCTAAACTGACGATCCCCGCCGTGACTAAAGCCAACAGTGGACGATATTCCCTGAAAGCCACCAATGGATCTGGACAAGCGACTAGTACTGCTGAGCTTCTCGTGAAAG
>TTN-216,ENSE00003810976,1,288,557828,558115,CTGAGACAGCACCACCCAACTTCGTTCAACGACTGCAGAGCATGACCGTGAGACAAGGAAGCCAAGTGAGACTCCAAGTGAGAGTGACTGGAATCCCTACACCTGTGGTGAAGTTCTACCGGGATGGAGCCGAAATCCAGAGCTCCCTTGATTTCCAAATTTCACAAGAAGGCGACCTCTACAGCTTACTGATTGCAGAAGCATACCCTGAGGACTCAGGGACCTATTCAGTAAATGCCACCAATAGCGTTGGAAGAGCTACTTCGACTGCTGAATTACTGGTTCAAG
>TTN-216,ENSE00003809662,1,86,558116,558201,GTGAAGAAGAAGTACCTGCTAAAAAGACAAAGACAATTGTTTCGACTGCTCAGATCTCAGAATCAAGACAAACCCGAATTGAAAAG
>TTN-216,ENSE00003809782,1,245,558202,558446,AAGATTGAAGCCCACTTTGATGCCAGATCAATTGCAACAGTTGAGATGGTCATAGATGGTGCCGCTGGGCAACAGCTGCCACATAAAACACCTCCCAGGATTCCTCCGAAGCCAAAGTCAAGATCCCCAACACCACCGTCTATTGCTGCCAAAGCACAGCTGGCTCGGCAGCAGTCCCCATCGCCCATAAGACACTCCCCTTCCCCGGTCAGACACGTGCGGGCACCGACCCCATCTCCGGTCAG
>TTN-216,ENSE00003805863,1,331,558447,558777,GTCCGTGTCTCCAGCAGCAAGAATCTCCACATCCCCCATCAGGTCTGTTAGGTCTCCATTGCTCATGCGTAAGACTCAGGCATCCACCGTGGCCACAGGTCCTGAAGTGCCTCCCCCTTGGAAGCAAGAGGGCTACGTGGCCTCCTCATCTGAGGCTGAGATGAGAGAGACAACGCTGACAACCTCTACTCAGATCAGGACAGAAGAGAGATGGGAAGGGAGATACGGTGTCCAGGAGCAAGTGACCATCAGTGGTGCTGCGGGTGCTGCCGCCAGTGTGTCGGCCAGTGCTAGCTACGCAGCAGAGGCTGTTGCCACTGGTGCTAAAGAG
>TTN-216,ENSE00003803639,1,153,558778,558930,GTGAAACAAGATGCTGACAAAAGTGCAGCTGTTGCGACTGTTGTTGCTGCCGTTGATATGGCCAGAGTGAGAGAACCAGTGATCAGCGCTGTAGAGCAGACTGCTCAGAGGACAACCACGACTGCTGTGCACATCCAACCTGCTCAAGAACAG
>TTN-216,ENSE00003810843,1,138,558931,559068,GTAAGAAAGGAAGCGGAGAAGACTGCTGTAACTAAGGTAGTAGTGGCCGCCGATAAAGCCAAGGAACAAGAATTAAAATCAAGAACCAAAGAAGTAATTACCACAAAGCAAGAGCAGATGCACGTAACTCATGAGCAG
>TTN-216,ENSE00003803899,1,126,559069,559194,ATAAGAAAAGAAACTGAAAAAACATTTGTACCAAAGGTAGTAATTTCCGCAGCTAAAGCCAAAGAACAAGAAACTAGAATTTCTGAAGAAATTACTAAGAAACAGAAACAAGTAACTCAAGAAGCA
>TTN-216,ENSE00003801659,1,294,559195,559488,GTGGACGTTGGAAAAAAGGCTGAAGCTGTAGCAACAGTTGTTGCTGCAGTAGACCAGGCCCGAGTCAGAGAGCCCAGAGAGCCTGGGCATCTTGAAGAATCCTATGCTCAGCAGACCACTTTGGAGTACGGATATAAGGAACGCATTTCCGCCGCAAAGGTAGCTGAGCCTCCCCAACGTCCAGCCTCAGAACCCCACGTTGTCCCTAAAGCAGTCAAGCCTAGAGTAATCCAGGCTCCTTCTGAGACTCATATCAAAACTACTGATCAAAAGGGAATGCACATATCATCACAG
>TTN-216,ENSE00003804455,1,123,559489,559611,ATCAAGAAAACTACAGATCTAACAACGGAAAGATTAGTCCATGTGGATAAACGCCCCCGCACAGCTAGCCCTCACTTTACTGTTTCAAAAATTTCTGTTCCTAAGACAGAACATGGATATGAG
>TTN-216,ENSE00003810306,1,282,559612,559893,GCATCAATAGCCGGTAGTGCTATTGCCACATTACAAAAAGAGTTGTCAGCCACATCTTCTGCTCAGAAGATCACCAAATCGGTGAAGGCTCCTACTGTGAAGCCCAGTGAGACTAGAGTAAGGGCAGAGCCCACACCCTTGCCACAGTTCCCCTTCGCTGACACACCAGATACTTACAAGAGTGAAGCTGGCGTTGAGGTGAAAAAGGAAGTAGGGGTGAGCATCACTGGCACCACCGTCCGTGAAGAGCGCTTTGAAGTACTGCACGGACGCGAAGCCAAG
>TTN-216,ENSE00003805296,1,66,559894,559959,GTAACAGAAACAGCAAGAGTACCAGCACCTGTTGAAATTCCTGTTACTCCACCAACTTTGGTCTCG
>TTN-216,ENSE00003806123,1,259,559960,560218,GGCTTAAAAAATGTGACTGTCATAGAAGGTGAATCTGTCACCTTGGAGTGCCACATCTCTGGATACCCATCCCCGACAGTGACATGGTACAGGGAAGACTACCAAATCGAAAGTTCCATTGACTTCCAGATAACCTTCCAGAGTGGAATTGCTCGTCTTATGATTCGCGAAGCATTTGCGGAAGACAGCGGGCGATTTACTTGCAGTGCTGTAAATGAGGCTGGAACCGTCAGCACATCCTGCTATCTGGCTGTGCAGG
>TTN-216,ENSE00003808554,1,64,560219,560282,TGTCAGAAGAATTTGAAAAGGAAACCACAGCCGTGACTGAGAAATTTACTACAGAAGAGAAACG
>TTN-216,ENSE00003804962,1,216,560283,560498,CTTTGTTGAGTCAAGAGATGTGGTTATGACTGATACTAGCCTCACAGAGGAACAAGCAGGGCCTGGAGAACCTGCCGCGCCTTACTTTATTACAAAACCAGTGGTCCAGAAACTGGTGGAAGGTGGGAGCGTGGTGTTTGGATGCCAAGTTGGCGGCAACCCAAAGCCCCATGTATACTGGAAAAAATCTGGTGTTCCTCTAACCACTGGATACAG
>TTN-216,ENSE00003804165,1,143,560499,560641,ATACAAAGTGAGTTACAACAAACAAACCGGTGAATGCAAGCTGGTGATTTCTATGACTTTTGCTGATGATGCTGGAGAATACACTATTGTTGTTCGCAATAAGCATGGAGAAACTTCTGCATCTGCTTCCTTGCTTGAAGAAG
>TTN-216,ENSE00003802603,1,206,560642,560847,CTGATTATGAGTTACTGATGAAGTCCCAGCAAGAAATGCTTTATCAGACACAAGTGACTGCATTTGTTCAAGAACCTAAAGTTGGAGAAACAGCACCTGGATTTGTATACTCTGAGTATGAAAAAGAGTATGAAAAAGAACAAGCCTTAATTAGGAAGAAAATGGCCAAAGATACTGTAGTGGTCAGAACTTATGTAGAAGATCAG
>TTN-216,ENSE00003807963,1,234,560848,561081,GAATTCCATATTTCTTCCTTTGAAGAGAGACTTATTAAAGAAATTGAATATAGAATAATAAAGACTACATTAGAAGAACTTCTTGAAGAAGATGGAGAAGAAAAGATGGCAGTTGACATTTCTGAATCTGAAGCTGTTGAATCAGGATTTGATTCAAGAATCAAGAATTATAGAATTCTTGAGGGGATGGGTGTCACTTTTCATTGCAAGATGTCTGGATATCCATTACCAAAG
>TTN-216,ENSE00003808968,1,245,561082,561326,ATTGCTTGGTACAAAGATGGCAAGCGCATCAAACATGGAGAAAGATACCAAATGGACTTTCTACAAGATGGCAGAGCTAGTCTGCGTATACCTGTTGTTCTTCCAGAAGATGAAGGAATCTACACTGCATTTGCCAGCAATATTAAAGGAAATGCAATTTGCTCAGGGAAATTGTATGTGGAGCCTGCTGCACCACTTGGAGCTCCGACTTACATTCCCACACTAGAGCCAGTGAGCAGAATCAG
>TTN-216,ENSE00003802614,1,272,561327,561598,ATCTCTCTCTCCACGTTCAGTGAGCAGGTCTCCTATACGCATGTCTCCTGCACGGATGTCACCTGCAAGGATGTCTCCTGCACGGATGTCCCCTGCAAGAATGTCCCCTGGACGTAGGCTGGAGGAGACAGATGAGTCACAACTTGAGAGACTATATAAACCAGTCTTTGTGTTAAAACCTGTTTCTTTCAAATGTTTAGAAGGGCAAACTGCCAGATTTGACTTAAAGGTTGTTGGTAGACCTATGCCAGAGACGTTCTGGTTTCATGATG
>TTN-216,ENSE00003811446,1,165,561599,561763,GCCAGCAAATTGTCAATGACTATACCCATAAAGTAGTCATTAAAGAAGATGGTACTCAATCACTAATTATTGTCCCTGCCACACCCAGTGATTCTGGGGAATGGACTGTGGTTGCCCAAAACAGGGCAGGCAGATCTTCAATTTCAGTGATTTTAACTGTGGAAG
>TTN-216,ENSE00003805710,1,169,561764,561932,CTGTGGAACATCAGGTAAAACCGATGTTTGTAGAAAAACTGAAAAATGTCAATATAAAGGAAGGTTCCCGACTTGAAATGAAAGTCAGAGCTACGGGTAACCCCAACCCTGACATTGTATGGTTGAAAAACAGTGACATCATTGTGCCTCATAAATATCCCAAAATCAG
>TTN-216,ENSE00003809358,1,1694,561933,563626,AATTGAAGGAACCAAGGGAGAAGCTGCCCTTAAAATCGATTCCACTGTCAGCCAAGATTCTGCCTGGTATACTGCGACTGCTATTAATAAAGCTGGCAGAGACACTACAAGATGCAAAGTAAATGTTGAAGTTGAGTTTGCAGAGCCTGAGCCAGAGAGAAAGTTAATCATCCCACGGGGGACATATAGAGCAAAGGAGATTGCAGCCCCAGAACTGGAGCCCCTCCATTTGCGATATGGCCAAGAGCAATGGGAAGAAGGTGATCTCTATGACAAAGAGAAACAACAGAAACCATTTTTCAAGAAAAAACTCACTTCCTTAAGACTTAAGCGCTTTGGGCCTGCCCACTTTGAATGCAGGCTAACACCCATTGGTGACCCAACGATGGTGGTGGAGTGGCTCCATGATGGAAAGCCACTTGAAGCAGCCAACAGGCTCCGTATGATCAATGAATTTGGGTACTGCAGCCTTGATTATGGCGTTGCATATTCTAGAGACAGTGGTATCATTACTTGCAGAGCCACTAACAAATATGGAACAGATCACACATCTGCTACCCTTATTGTTAAAGATGAGAAAAGTCTTGTGGAAGAATCCCAATTGCCTGAGGGGAGGAAAGGCTTACAGAGAATTGAAGAATTAGAGAGAATGGCTCATGAAGGTGCACTTACAGGTGTAACAACAGATCAGAAAGAAAAGCAAAAGCCAGACATTGTCTTGTACCCAGAGCCAGTTAGAGTACTTGAAGGGGAGACTGCAAGGTTCCGCTGCAGGGTAACAGGCTACCCTCAGCCCAAAGTCAACTGGTACCTCAATGGACAGCTCATCCGCAAAAGCAAAAGGTTCAGAGTTCGCTATGATGGTATCCATTACCTGGACATCGTGGACTGCAAATCATATGACACAGGTGAAGTGAAGGTCACCGCGGAAAATCCTGAAGGTGTGATAGAGCATAAAGTGAAGCTTGAGATTCAACAGAGGGAAGATTTTAGGTCTGTCCTTAGGAGAGCTCCTGAACCAAGGCCTGAGTTTCACGTACATGAACCAGGAAAGCTTCAGTTTGAAGTACAAAAAGTGGATAGACCTGTTGACACCACTGAAACCAAAGAAGTTGTGAAGTTGAAAAGGGCTGAAAGAATTACCCATGAAAAAGTGCCTGAAGAGTCGGAAGAGCTGCGCAGTAAATTCAAGCGCAGAACAGAAGAGGGCTATTATGAAGCCATTACCGCTGTGGAGCTCAAGTCTCGAAAGAAGGATGAATCCTATGAGGAACTCCTCAGGAAGACAAAAGATGAACTTCTCCACTGGACCAAAGAGTTAACTGAAGAGGAAAAGAAAGCTCTTGCCGAAGAAGGCAAAATCACGATTCCAACTTTTAAACCTGACAAGATTGAACTAAGTCCTAGTATGGAGGCTCCAAAAATCTTCGAAAGAATCCAGAGCCAAACAGTGGGCCAAGGATCTGATGCACACTTCCGGGTCAGAGTCGTGGGGAAACCAGACCCCGAATGTGAATGGTACAAAAATGGTGTCAAAATTGAACGGTCTGACCGGATCTACTGGTACTGGCCCGAAGACAATGTTTGTGAATTGGTCATAAGAGATGTGACTGCTGAGGACTCTGCCAGCATCATGGTAAAAGCCATCAACATAGCTGGAGAAACCTCCAGTCACGCATTCTTACTTGTCCAAG
>TTN-216,ENSE00003809440,1,282,563627,563908,CCAAGCAATTGATCACTTTCACACAGGAATTACAAGATGTTGTTGCTAAGGAAAAAGACACTATGGCAACCTTTGAATGTGAAACTTCAGAACCATTTGTCAAAGTGAAATGGTATAAAGATGGTATGGAGGTTCATGAGGGAGATAAATACAGGATGCACTCTGACAGAAAGGTTCACTTCCTCTCCATACTGACCATTGATACGTCTGATGCTGAAGATTACAGCTGTGTACTTGTGGAAGATGAAAATGTCAAAACGACTGCTAAACTTATTGTTGAAG
>TTN-216,ENSE00003802960,1,267,563909,564175,GTGCAGTTGTTGAGTTTGTGAAAGAACTTCAGGACATAGAAGTTCCAGAATCATATTCAGGAGAATTAGAGTGCATTGTATCCCCAGAAAATATAGAAGGAAAATGGTATCATAATGATGTGGAGCTTAAATCCAATGGCAAATATACAATTACATCTCGTCGTGGACGTCAGAACCTCACGGTCAAGGATGTAACCAAGGAGGACCAGGGAGAATACAGCTTTGTCATCGACGGGAAAAAGACAACCTGTAAATTAAAGATGAAAC
>TTN-216,ENSE00003804241,1,273,564176,564448,CCCGCCCCATTGCTATCCTACAAGGACTTAGTGACCAAAAAGTCTGTGAGGGTGACATTGTTCAGCTTGAAGTTAAAGTCTCCTTGGAAAGTGTGGAAGGCGTCTGGATGAAAGACGGCCAAGAAGTGCAGCCCAGTGACAGGGTTCACATTGTGATAGACAAACAATCTCATATGCTGCTCATTGAAGACATGACTAAGGAAGATGCTGGAAATTACTCTTTCACCATTCCAGCCCTTGGCCTCTCCACCAGTGGGCGTGTCTCTGTCTATA
>TTN-216,ENSE00003806988,1,264,564449,564712,GTGTGGACGTGATAACACCTCTAAAAGATGTTAATGTGATTGAAGGCACCAAGGCTGTGCTTGAATGTAAGGTGTCAGTCCCTGATGTGACTTCTGTTAAGTGGTACTTAAATGATGAACAAATCAAGCCTGATGACCGTGTACAGGCCATTGTGAAAGGTACTAAACAGCGACTAGTCATTAACCGAACTCATGCTTCAGACGAAGGACCTTACAAGCTGATAGTTGGCAGAGTTGAAACCAACTGTAATCTCTCTGTAGAAA
>TTN-216,ENSE00003804968,1,261,564713,564973,AAATTAAAATTATCAGAGGTCTTCGTGACCTTACCTGTACAGAAACTCAAAATGTGGTGTTTGAGGTTGAGCTGTCCCACTCTGGAATTGATGTCCTGTGGAATTTTAAGGACAAGGAAATCAAGCCCAGTTCTAAATATAAAATTGAAGCACATGGAAAAATATATAAATTGACAGTTCTAAATATGATGAAAGATGATGAAGGAAAATACACATTTTACGCGGGAGAAAATATGACATCTGGAAAACTTACTGTGGCAG
>TTN-216,ENSE00003809850,1,261,564974,565234,GTGGGGCCATCTCCAAGCCACTCACAGATCAGACCGTAGCTGAATCCCAGGAAGCTGTGTTTGAATGTGAAGTTGCCAACCCAGATTCCAAAGGCGAATGGTTGAGGGATGGCAAACACCTACCACTGACTAACAACATCAGAAGTGAGTCTGATGGCCACAAAAGGAGACTTATCATTGCTGCCACCAAATTAGATGACATTGGAGAATATACCTACAAGGTGGCCACCTCCAAAACATCTGCCAAACTCAAAGTTGAAG
>TTN-216,ENSE00003806479,1,264,565235,565498,CTGTCAAAATTAAGAAGACTCTGAAGAACCTCACAGTGACAGAAACACAGGATGCTGTTTTCACTGTCGAGCTTACACACCCTAATGTCAAAGGTGTCCAGTGGATCAAAAATGGAGTTGTGCTGGAATCCAATGAAAAGTATGCTATCTCTGTCAAAGGAACAATTTACTCTCTGAGGATTAAAAACTGTGCCATCGTGGATGAGTCTGTTTATGGCTTCAGGCTTGGAAGGCTTGGAGCCAGTGCCAGACTGCACGTGGAGA
>TTN-216,ENSE00003804523,1,261,565499,565759,CTGTCAAGATCATTAAAAAGCCAAAGGATGTGACAGCCTTGGAAAATGCCACTGTTGCCTTTGAAGTTAGTGTTTCCCATGACACTGTTCCAGTAAAATGGTTCCATAAGAGTGTGGAAATTAAGCCAAGTGACAAACACAGACTGGTCTCAGAAAGGAAAGTCCACAAGCTGATGCTGCAGAACATCTCCCCCTCAGATGCTGGGGAATACACAGCTGTGGTCGGGCAATTGGAATGCAAAGCAAAACTGTTTGTGGAGA
>TTN-216,ENSE00003807378,1,261,565760,566020,CATTACATATTACAAAAACCATGAAAAATATCGAGGTGCCTGAGACCAAAACTGCCTCTTTTGAGTGTGAGGTGTCCCACTTCAATGTCCCTTCCATGTGGCTGAAGAATGGTGTGGAAATTGAGATGAGTGAAAAGTTCAAGATAGTTGTGCAGGGAAAACTCCATCAGCTGATCATCATGAACACCAGCACAGAGGACTCGGCAGAATACACATTTGTCTGTGGCAATGACCAAGTCAGTGCCACCCTGACAGTCACCC
>TTN-216,ENSE00003807271,1,261,566021,566281,CAATCATGATTACTTCCATGCTGAAAGACATCAACGCTGAAGAAAAAGACACTATTACTTTTGAGGTGACAGTGAACTATGAAGGCATCTCTTACAAATGGTTAAAGAATGGTGTGGAAATCAAATCAACTGACAAGTGCCAGATGAGAACCAAAAAGCTCACACACTCACTGAACATCAGGAATGTTCACTTTGGGGATGCTGCTGACTACACCTTTGTGGCTGGAAAAGCAACATCAACAGCCACACTTTATGTGGAAG
>TTN-216,ENSE00003808172,1,142,566282,566423,CTCGTCATATAGAATTTAGGAAACACATTAAGGACATTAAGGTACTGGAGAAGAAGCGAGCCATGTTTGAATGTGAAGTTTCTGAACCTGACATCACTGTACAGTGGATGAAAGATGACCAGGAACTGCAGATCACAGACAG
>TTN-216,ENSE00003808223,1,166,566424,566589,AATAAAGATTCAGAAGGAGAAATATGTCCACCGCCTTCTGATCCCATCCACCCGGATGTCTGATGCTGGGAAGTACACAGTGGTGGCAGGAGGCAACGTGTCAACTGCAAAACTCTTTGTAGAAGGCAGAGATGTTCGCATCCGAAGTATTAAAAAGGAGGTTCAG
>TTN-216,ENSE00003810851,1,232,566590,566821,GTCATTGAGAAACAGCGTGCTGTTGTTGAATTTGAGGTCAATGAAGACGATGTTGATGCCCACTGGTATAAAGATGGCATTGAAATCAATTTCCAAGTTCAAGAACGACACAAATATGTAGTGGAAAGAAGAATCCACCGAATGTTTATCTCTGAGACCAGACAGAGCGATGCAGGAGAATACACCTTTGTGGCAGGAAGGAACAGGAGTTCTGTCACTCTCTATGTCAATG
>TTN-216,ENSE00003802092,1,285,566822,567106,CTCCTGAACCGCCCCAAGTTCTGCAGGAGCTCCAGCCTGTCACTGTGCAGTCTGGCAAGCCTGCCCGCTTCTGTGCCGTGATATCCGGAAGACCACAGCCCAAAATTTCCTGGTACAAGGAAGAGCAGCTGCTTTCCACTGGCTTCAAGTGCAAATTTCTTCATGATGGGCAAGAATACACGCTTTTGCTAATTGAAGCCTTCCCAGAGGATGCGGCAGTCTATACCTGTGAAGCCAAGAATGACTATGGTGTTGCCACAACATCAGCTTCACTCTCAGTGGAAG
>TTN-216,ENSE00003807103,1,126,567107,567232,TTCCAGAAGTTGTGTCTCCTGATCAGGAAATGCCTGTTTATCCACCTGCCATCATCACCCCGCTTCAGGACACTGTCACTTCTGAAGGGCAGCCAGCCCGTTTTCAATGCCGGGTTTCTGGAACAG
>TTN-216,ENSE00003801355,1,189,567233,567421,ATCTAAAAGTGTCGTGGTACAGCAAAGACAAGAAAATCAAGCCATCTCGGTTCTTTAGAATGACTCAATTTGAAGACACTTATCAACTGGAAATTGCCGAAGCTTATCCAGAAGATGAAGGAACTTACACGTTTGTTGCTAGTAATGCTGTAGGCCAAGTATCAAGCACAGCCAACCTGAGTCTGGAAG
>TTN-216,ENSE00004024281,1,375,567422,567796,GATTTAGCAAATTTGAAGAAAATACATCAAACTCCCAATGGCATGTCTCTTTATCAGTTTCATTTAAGAAGGAGCCCCTTGGCCAAAAGCCCAGCTTCATCCAGCCTCTGTCAAGCCTCAGGGTGCACAACGGGGAGACAGTCAGATTTCATGCGAGGGTTTCTGGCATTCCCAAGCCAGAAATCCAATGGTTTCATAACCAGCAGCTAATTCTACCAACAAAAGATGTAGTTTTCCATTTTGAGGAGTCCACAGGCATGGCTTTAATGCTTATAGTTGATGCTTACTCAGAGCATGCTGGGCAGTACTCTTGCAAAGCAGCCAATAGTGCTGGGGAAGCCACTTGTGCAGCTACACTCACAGTGACTCCAAAAG
>TTN-216,ENSE00004024285,1,576,567797,568372,TGCAAGCCCTAGATAGGCAAAGTTCTGGGAAAGATGTAAGAGAGTCCACCAAGTCCCAGGCAGTGGCAGATTCCTCTTTCACAAAGGAGGAGAGCAAAATATCTCAAAAGGAAATTAAGTCATTTCAAGGATCATCATATGAATATGAAGTGCAGGTTTTTGAAAGTGTATCTCAAAGTTCCATCCACACAGCTGCATCTGTTCAAGATACACAGTTGTGCCATACTGCATCCCTTTCACAAATTGCAGAAAGCACTGAGCTATCTAAGGAATGTGCTAAAGAGTCCACGGGTGAGGCGCCCAAGATTTTCCTGCATCTTCAGGACGTCACTGTAAAGTGCGGTGACACGGCTCAATTCCTCTGTGTTTTAAAAGATGATTCTTTCATTGATGTAACCTGGACTCACGAAGGTGCAAAGATAGAGGAATCCGAGAGACTGAAACAATCACAAAATGGAAATATTCAGTTTCTTACCATATGTAATGTTCAGCTGGTAGACCAAGGACTATACAGCTGCATTGTACACAATGACTGTGGAGAGAGGACAACGTCAGCAGTACTAAGTGTAGAAGGTG
>TTN-216,ENSE00003810791,1,57,568373,568429,CTCCTGAATCAATTTTGCATGAGAGGATTGAACAAGAGATTGAGATGGAAATGAAAG
>TTN-216,ENSE00004024265,1,2781,568430,571210,AGTTTTCTAGTTCTTTTCTGTCTGCCGAGGAAGAAGGACTTCATAGCGCCGAACTTCAATTATCTAAAATAAATGAAACACTTGAACTTTTGTCTGAATCTCCAGTTTACCCAACTAAATTTGATTCCGAAAAGGAAGGCACTGGCCCAATTTTCATCAAAGAAGTGTCAAATGCTGATATAAGCATGGGGGATGTGGCTACACTGTCTGTAACTGTCATTGGCATCCCCAAACCTAAAATTCAGTGGTTCTTTAATGGAGTGCTATTAACCCCTTCTGCTGACTACAAATTTGTTTTTGACGGTGATGATCATAGCCTGATCATTCTGTTCACCAAATTGGAGGATGAGGGAGAGTATACATGTATGGCCAGTAATGACTATGGAAAGACAATATGTAGTGCCTATCTAAAAATTAATTCCAAAGGAGAGGGTCACAAAGACACTGAAACAGAATCAGCAGTGGCAAAATCTCTGGAAAAGCTGGGAGGTCCTTGTCCTCCTCACTTCCTTAAGGAGTTAAAACCAATTCGCTGTGCTCAAGGGCTTCCTGCCATCTTTGAGTACACAGTGGTTGGAGAGCCTGCCCCTACTGTTACATGGTTCAAAGAAAACAAGCAGCTTTGCACCAGTGTTTATTACACTATCATTCATAACCCTAATGGCTCTGGAACTTTCATTGTCAATGACCCTCAGAGGGAAGACAGTGGCCTCTATATCTGTAAAGCAGAGAATATGTTGGGTGAGTCCACCTGTGCAGCAGAGCTGCTTGTGCTTCTGGAAGACACAGACATGACTGATACCCCCTGCAAAGCAAAGTCCACACCAGAGGCTCCTGAGGATTTTCCACAGACACCCTTAAAGGGTCCCGCAGTTGAAGCACTTGACTCAGAGCAGGAAATTGCAACGTTTGTAAAAGACACCATTTTGAAAGCTGCTTTAATTACAGAAGAAAACCAGCAACTATCTTATGAGCATATTGCTAAAGCCAATGAATTGAGCAGTCAGCTTCCTTTGGGAGCTCAGGAATTGCAATCCATTTTGGAGCAAGACAAGCTCACTCCTGAAAGCACCAGGGAATTTCTTTGCATCAATGGCAGTATTCACTTTCAGCCTCTCAAGGAACCATCTCCCAACCTACAGCTGCAGATTGTACAGTCCCAGAAAACCTTCTCCAAAGAAGGTATTCTAATGCCTGAAGAGCCTGAGACACAGGCAGTTCTATCAGATACCGAGAAAATCTTCCCAAGTGCCATGTCCATAGAACAAATTAATTCATTAACAGTTGAGCCTCTGAAAACTTTATTAGCTGAACCTGAAGGGAATTATCCACAGTCTTCAATAGAACCTCCAATGCATTCTTATCTAACCTCTGTGGCTGAGGAAGTACTTTCACCAAAAGAAAAGACAGTATCTGACACCAACAGAGAGCAAAGAGTGACTCTTCAAAAGCAAGAGGCACAAAGTGCGCTCATCTTGAGTCAGAGCTTAGCTGAGGGACACGTGGAGAGTCTCCAGAGTCCTGATGTCATGATCTCTCAGGTAAACTATGAGCCCCTAGTCCCTTCAGAACACTCATGCACAGAAGGAGGTAAAATTTTGATAGAAAGTGCAAATCCACTGGAAAATGCAGGGCAAGATTCTGCGGTCAGAATTGAGGAAGGCAAGTCCTTAAGATTTCCACTAGCACTTGAAGAAAAGCAGGTACTGCTCAAAGAAGAGCATTCTGACAACGTGGTGATGCCCCCAGACCAAATCATTGAGTCTAAAAGAGAGCCCGTGGCAATAAAGAAAGTGCAGGAGGTACAGGGAAGGGACCTTCTTTCTAAGGAAAGCTTGCTTTCTGGTATTCCAGAAGAGCAGAGATTAAACCTGAAAATTCAAATCTGCCGGGCTTTGCAAGCAGCCGTGGCCAGCGAGCAGCCAGGTCTTTTCTCTGAGTGGCTAAGAAATATTGAAAAGGTGGAGGTCGAGGCTGTAAACATCACCCAAGAGCCCAGACACATCATGTGCATGTACCTTGTTACTTCGGCAAAGTCTGTAACAGAAGAAGTAACCATCATTATTGAAGATGTTGATCCTCAAATGGCTAACCTGAAAATGGAACTTAGGGATGCTTTGTGTGCTATTATATATGAGGAAATAGACATCCTAACAGCTGAGGGTCCTAGAATTCAGCAAGGAGCCAAAACAAGTTTGCAAGAAGAAATGGATTCTTTTTCAGGTTCACAGAAGGTTGAACCCATTACTGAACCAGAAGTTGAATCTAAATATCTGATCTCAACTGAAGAGGTCAGTTATTTTAACGTGCAAAGTAGGGTTAAATATTTGGATGCCACACCTGTCACTAAAGGGGTTGCTTCAGCTGTTGTCTCTGACGAAAAACAAGATGAGAGTCTGAAACCATCAGAGGAAAAAGAGGAGTCTTCCTCTGAAAGTGGTACTGAGGAGGTTGCTACAGTAAAGATACAGGAAGCTGAGGGTGGCTTAATCAAAGAGGATGGCCCCATGATACATACACCTTTAGTGGACACTGTTTCTGAGGAAGGTGATATTGTACACCTCACAACATCCATAACAAATGCTAAAGAGGTGAATTGGTATTTTGAGAATAAACTGGTGCCTTCAGATGAAAAGTTCAAGTGTTTACAAGATCAAAATACATATACGCTAGTCATCGACAAAGTAAATACCGAAGACCATCAAGGAGAGTATGTCTGTGAGGCCTTGAATGACAGCGGAAAAACAGCAACTTCAGCCAAACTCACTGTAGTAAAAAGAG
>TTN-216,ENSE00003805227,1,279,571211,571489,CTGCCCCAGTGATCAAGAGGAAAATCGAACCCCTGGAAGTAGCACTGGGCCACCTAGCCAAATTCACCTGTGAGATCCAAAGTGCTCCCAATGTCCGGTTCCAGTGGTTTAAAGCTGGCCGAGAAATTTATGAGAGTGACAAGTGTTCTATTCGATCTTCAAAGTATATCTCCAGCCTTGAAATCCTGAGAACCCAGGTGGTTGACTGCGGCGAGTATACATGCAAAGCTTCCAATGAGTATGGCAGTGTCAGCTGTACAGCCACACTAACTGTGACAG
>TTN-216,ENSE00003808619,1,564,571490,572053,AGGCATATCCACCAACCTTTCTCTCCAGACCTAAGTCCCTTACAACTTTTGTGGGTAAGGCAGCCAAGTTCATCTGCACAGTGACAGGGACTCCTGTGATAGAAACCATTTGGCAGAAAGATGGTGCTGCACTCTCACCTTCACCTAACTGGAGGATTTCCGACGCAGAAAACAAACACATTTTAGAACTCTCAAACCTTACCATTCAAGATAGAGGAGTTTATTCTTGTAAGGCTTCCAACAAGTTTGGAGCAGACATCTGCCAAGCAGAGTTGATCATCATTGATAAGCCACATTTCATTAAAGAATTAGAGCCTGTGCAGTCCGCTATCAATAAGAAGGTCCACCTTGAGTGCCAAGTAGATGAAGACAGAAAAGTCACAGTTACGTGGAGCAAAGATGGGCAAAAACTCCCCCCAGGGAAAGATTATAAGATCTGTTTTGAAGATAAAATAGCAACACTTGAGATTCCTTTGGCCAAACTGAAAGATTCAGGAACCTATGTCTGTACAGCTTCAAATGAGGCTGGAAGCAGCTCCTGCTCAGCCACAGTCACTGTCAGAG
>TTN-216,ENSE00003811334,1,282,572054,572335,AGCCACCATCCTTCGTGAAGAAGGTGGATCCCTCTTATTTAATGCTCCCAGGTGAATCAGCACGCCTCCATTGCAAGCTGAAAGGCTCACCTGTGATCCAGGTTACTTGGTTTAAAAATAACAAAGAACTCAGTGAAAGTAACACAGTCCGAATGTATTTTGTCAATTCTGAGGCTATACTTGATATTACGGATGTAAAAGTTGAAGACAGTGGGAGTTACTCATGTGAAGCAGTGAATGACGTCGGCAGTGATAGCTGCAGTACTGAAATAGTTATCAAAG
>TTN-216,ENSE00003807496,1,279,572336,572614,AACCTCCTTCTTTCATCAAAACTCTTGAGCCTGCAGACATAGTGAGAGGAACAAATGCTCTACTTCAGTGTGAAGTCTCAGGCACTGGACCATTTGAAATTAGCTGGTTCAAAGACAAGAAACAAATTCGAAGTAGTAAAAAATACAGATTGTTTTCTCAGAAGTCTCTTGTGTGTCTGGAGATCTTTTCGTTTAATAGTGCAGATGTTGGTGAATATGAATGTGTTGTTGCTAATGAAGTCGGCAAGTGTGGCTGCATGGCAACCCACTTACTCAAAG
>TTN-216,ENSE00003806831,1,279,572615,572893,AACCTCCAACCTTTGTAAAGAAAGTAGATGATTTGATTGCACTAGGAGGACAAACCGTTACCCTGCAAGCTGCTGTGAGAGGGTCAGAGCCCATTTCTGTCACATGGATGAAAGGTCAAGAGGTCATCAGAGAAGACGGAAAAATCAAAATGAGCTTTTCCAATGGTGTTGCAGTCTTGATAATCCCTGATGTTCAGATTAGTTTTGGAGGCAAATACACGTGCCTGGCTGAAAATGAAGCTGGAAGCCAAACATCTGTTGGGGAATTAATAGTTAAAG
>TTN-216,ENSE00003801788,1,279,572894,573172,AACCTGCCAAAATCATTGAGCGAGCAGAACTGATCCAGGTGACAGCAGGAGATCCCGCCACACTGGAGTACACAGTGGCAGGCACGCCAGAACTGAAGCCCAAATGGTACAAAGATGGGAGACCCTTGGTCGCCAGTAAAAAATACCGAATAAGTTTTAAAAACAATGTTGCCCAGCTCAAATTTTATTCAGCTGAGCTGCACGACAGTGGCCAATACACATTTGAGATTTCCAATGAAGTGGGCAGCAGCTCCTGTGAGACTACATTCACTGTATTAG
>TTN-216,ENSE00003804186,1,288,573173,573460,ATCGAGACATTGCTCCATTTTTTACCAAACCCTTGCGCAACGTGGATAGTGTTGTTAATGGTACCTGCAGACTGGACTGCAAAATTGCAGGCTCCCTCCCCATGAGGGTGTCCTGGTTTAAGGATGGCAAAGAAATAGCTGCTTCTGACAGATACAGGATAGCATTTGTGGAAGGCACAGCCTCTTTGGAGATCATCAGAGTAGACATGAATGATGCAGGGAATTTCACTTGTCGAGCCACAAATTCCGTGGGAAGCAAAGACAGCAGTGGAGCCCTGATTGTGCAAG
>TTN-216,ENSE00003805178,1,279,573461,573739,AACCACCCAGTTTTGTAACTAAACCCGGCTCAAAGGATGTTCTGCCTGGCTCAGCAGTCTGCCTGAAGAGCACTTTCCAAGGATCTACTCCTCTCACAATCAGATGGTTTAAGGGCAACAAAGAGCTGGTTTCTGGTGGAAGCTGCTATATTACCAAAGAAGCTTTAGAGAGTTCCCTGGAACTCTATTTAGTAAAAACCTCTGATTCGGGCACGTACACATGTAAAGTCAGCAATGTCGCTGGAGGGGTGGAATGCAGTGCAAACTTGTTTGTAAAAG
>TTN-216,ENSE00003806856,1,282,573740,574021,AACCTGCCACATTTGTTGAAAAGTTAGAGCCATCACAGCTGTTAAAGAAGGGAGATGCCACCCAGCTAGCCTGCAAAGTAACTGGTACCCCTCCAATTAAAATAACATGGTTTGCAAATGATAGAGAAATTAAGGAGAGCAGCAAACACAGAATGTCTTTTGTGGAGTCTACTGCAGTTCTAAGACTGACAGATGTTGGCATCGAAGACAGTGGTGAATATATGTGTGAGGCCCAAAATGAGGCTGGCAGTGACCACTGCAGTAGCATTGTAATAGTCAAAG
>TTN-216,ENSE00003804074,1,279,574022,574300,AGTCACCTTATTTTACCAAGGAATTTAAGCCAATTGAAGTCTTAAAGGAGTACGATGTCATGTTGCTGGCTGAGGTGGCAGGCACTCCTCCCTTTGAGATCACTTGGTTCAAAGATAACACAATCCTGCGAAGTGGTAGAAAGTATAAGACTTTCATTCAGGATCATCTGGTTAGCCTGCAGATCCTCAAGTTTGTAGCTGCAGATGCTGGCGAATACCAGTGTCGGGTGACCAATGAGGTGGGCAGCAGCATCTGCAGTGCCAGGGTGACTTTAAGAG
>TTN-216,ENSE00003807057,1,279,574301,574579,AACCCCCATCCTTCATAAAGAAGATCGAGAGTACCAGCTCCCTCCGGGGAGGCACAGCTGCCTTCCAGGCCACTCTGAAGGGCTCCTTGCCAATTACGGTGACTTGGCTAAAAGACAGCGATGAAATCACTGAAGACGATAATATAAGAATGACCTTTGAGAACAATGTGGCCAGTTTGTACCTCAGTGGCATTGAAGTCAAGCATGATGGGAAATATGTCTGTCAGGCCAAAAATGATGCAGGAATACAAAGATGTTCTGCATTACTCTCAGTAAAAG
>TTN-216,ENSE00003807032,1,279,574580,574858,AACCTGCAACAATCACCGAGGAAGCTGTGTCTATAGATGTCACCCAAGGAGACCCAGCCACTTTGCAGGTTAAATTTTCAGGGACTAAGGAGATTACAGCCAAATGGTTTAAAGATGGCCAAGAACTGACCCTGGGCTCAAAATATAAAATCAGTGTCACTGATACAGTCTCAATACTGAAGATTATTTCTACAGAAAAGAAAGATAGTGGAGAATATACTTTCGAGGTCCAAAATGATGTTGGGAGGAGCAGCTGCAAGGCTAGAATTAATGTATTAG
>TTN-216,ENSE00003810010,1,288,574859,575146,ATCTTATCATACCTCCTTCATTCACCAAAAAGCTGAAGAAAATGGACAGCATTAAAGGTTCTTTCATTGATTTAGAATGTATAGTGGCTGGGTCACATCCCATAAGCATCCAGTGGTTCAAAGATGACCAAGAAATATCAGCTAGTGAAAAGTACAAATTCTCTTTTCATGACAATACTGCCTTCTTGGAAATCAGCCAGCTGGAAGGTACAGACAGTGGGACATACACTTGTTCTGCCACAAATAAGGCAGGGCACAACCAATGCAGTGGGCATCTGACAGTCAAAG
>TTN-216,ENSE00003805733,1,279,575147,575425,AACCCCCTTACTTTGTGGAAAAGCCACAGTCACAAGATGTCAATCCCAACACAAGGGTACAGTTAAAGGCTCTTGTGGGTGGCACTGCACCCATGACAATAAAGTGGTTTAAAGATAACAAAGAGTTACACTCAGGAGCAGCCCGCTCAGTTTGGAAGGATGACACCTCTACCAGTCTAGAGCTCTTTGCAGCCAAAGCTACCGATTCTGGAACCTACATTTGCCAACTAAGCAATGATGTTGGCACAGCAACCAGCAAAGCCACTCTCTTTGTAAAAG
>TTN-216,ENSE00003805836,1,282,575426,575707,AACCTCCTCAATTCATTAAGAAGCCCAGTCCAGTCTTAGTGCTGAGGAATGGACAGTCAACAACATTTGAATGCCAAATAACAGGCACTCCTAAAATCCGAGTGTCTTGGTATCTAGACGGGAATGAAATAACAGCCATTCAGAAACATGGCATTTCCTTCATTGATGGTTTAGCCACTTTCCAGATTTCTGGTGCCAGGGTAGAAAATAGTGGGACTTATGTGTGTGAAGCTCGAAATGACGCAGGCACGGCGAGCTGCAGCATTGAACTCAAAGTGAAAG
>TTN-216,ENSE00003802637,1,279,575708,575986,AACCCCCCACCTTTATCAGAGAGCTGAAGCCTGTGGAGGTAGTAAAATATAGTGACGTGGAGCTGGAGTGTGAAGTTACGGGAACACCTCCGTTTGAAGTCACTTGGCTGAAGAATAACAGGGAAATTCGAAGCAGCAAAAAATACACATTGACCGACAGAGTGTCTGTGTTTAACCTCCATATAACCAAGTGTGACCCTTCAGACACTGGGGAATACCAGTGCATTGTATCCAATGAAGGCGGCAGCTGCTCATGCAGTACTAGAGTTGCCCTGAAAG
>TTN-216,ENSE00003809504,1,279,575987,576265,AACCACCATCATTCATTAAGAAGATAGAAAATACCACTACTGTTTTGAAAAGTTCTGCCACCTTTCAGAGTACCGTGGCAGGTTCTCCTCCTATTTCTATAACCTGGCTAAAGGATGATCAGATTCTTGATGAAGATGATAATGTCTATATTTCATTTGTGGACAGTGTGGCCACACTTCAAATCAGAAGTGTGGATAATGGACACAGTGGGAGATATACCTGTCAAGCCAAGAATGAGTCAGGAGTTGAGAGGTGTTATGCTTTCCTTTTAGTACAAG
>TTN-216,ENSE00003802968,1,279,576266,576544,AACCAGCTCAAATCGTAGAGAAAGCTAAATCAGTTGATGTTACGGAGAAAGATCCCATGACCTTGGAATGTGTTGTGGCTGGAACACCAGAACTCAAAGTGAAATGGCTTAAAGACGGGAAACAAATAGTTCCCAGTAGATACTTTTCAATGAGTTTTGAAAATAACGTGGCCAGTTTTAGAATTCAGTCAGTAATGAAGCAGGACAGCGGTCAGTACACTTTCAAGGTGGAAAATGACTTCGGAAGCAGTAGCTGTGATGCCTACTTAAGAGTGCTAG
>TTN-216,ENSE00003810612,1,288,576545,576832,ATCAAAATATTCCTCCATCATTCACCAAAAAATTAACCAAAATGGATAAAGTTCTGGGCTCTTCTATTCATATGGAGTGCAAGGTGTCTGGTTCACTTCCCATTAGTGCTCAGTGGTTTAAGGATGGAAAAGAAATATCTACAAGTGCAAAATACAGACTTGTGTGCCATGAGAGATCTGTGTCTCTGGAAGTTAATAATCTGGAATTAGAAGATACTGCAAATTACACATGCAAAGTGTCAAATGTAGCAGGAGATGATGCATGCAGTGGCATCTTAACTGTGAAAG
>TTN-216,ENSE00003806423,1,279,576833,577111,AACCACCAAGCTTCCTAGTGAAACCTGGGCGACAGCAAGCCATACCTGATTCTACAGTGGAATTTAAGGCAATACTAAAAGGAACACCACCATTTAAAATAAAATGGTTTAAGGATGATGTGGAACTTGTCTCAGGTCCTAAATGTTTCATTGGCTTGGAAGGGTCGACTAGCTTCTTAAATCTCTACTCAGTGGATGCTTCTAAGACTGGACAGTATACTTGCCATGTTACCAATGATGTTGGTAGCGACTCTTGTACTACGATGTTGCTTGTGACAG
>TTN-216,ENSE00003805536,1,282,577112,577393,AACCACCAAAGTTTGTAAAGAAATTAGAAGCCTCCAAAATTGTGAAAGCAGGTGACTCTTCACGACTTGAATGCAAGATAGCTGGATCCCCAGAAATCAGAGTTGTGTGGTTCCGAAATGAACATGAACTTCCAGCCAGTGATAAGTACAGAATGACTTTCATTGACTCAGTGGCCGTCATACAGATGAACAATCTCAGTACTGAGGACAGTGGAGATTTCATTTGTGAGGCTCAGAATCCCGCTGGCAGCACAAGCTGCAGTACCAAGGTTATAGTAAAAG
>TTN-216,ENSE00003807762,1,279,577394,577672,AGCCACCTGTTTTTAGCAGCTTCCCTCCTATAGTAGAAACCCTTAAAAATGCTGAAGTCAGTCTTGAATGTGAACTTTCGGGAACACCACCGTTTGAGGTGGTATGGTACAAAGACAAGCGGCAACTCAGAAGCAGCAAGAAATACAAGATTGCATCCAAAAACTTCCACACAAGTATTCACATTCTCAATGTGGACACTTCAGACATCGGTGAATACCACTGCAAAGCACAGAATGAAGTGGGAAGTGATACTTGTGTTTGTACTGTAAAATTGAAAG
>TTN-216,ENSE00003809887,1,282,577673,577954,AACCACCAAGATTTGTCTCCAAACTGAACAGCCTCACTGTTGTAGCCGGAGAGCCTGCTGAATTACAAGCATCCATAGAAGGCGCCCAGCCTATTTTTGTCCAGTGGCTTAAAGAGAAGGAAGAAGTGATTAGAGAAAGTGAAAACATCAGGATTACATTTGTGGAAAATGTTGCAACTCTACAGTTTGCAAAAGCAGAGCCAGCTAATGCTGGAAAGTATATCTGCCAAATCAAGAATGATGGTGGAATGAGGGAGAACATGGCCACACTGATGGTCTTAG
>TTN-216,ENSE00003811356,1,279,577955,578233,AGCCCGCAGTCATTGTTGAGAAGGCAGGACCGATGACGGTGACTGTAGGAGAAACGTGCACTCTGGAGTGTAAGGTGGCTGGCACTCCGGAACTCTCTGTTGAATGGTACAAGGATGGAAAGCTGTTGACCAGCAGCCAAAAACACAAATTTAGCTTCTACAACAAAATCTCTTCCTTAAGGATTCTCTCAGTTGAAAGGCAAGATGCAGGCACATACACTTTCCAGGTTCAAAATAATGTTGGGAAAAGCAGCTGCACAGCTGTGGTTGATGTTTCAG
>TTN-216,ENSE00003804298,1,288,578234,578521,ACCGAGCAGTTCCTCCCTCTTTCACACGAAGACTGAAAAATACTGGTGGGGTGTTAGGTGCTTCTTGCATCTTGGAATGCAAAGTAGCTGGATCATCACCTATTTCAGTTGCCTGGTTTCATGAGAAAACCAAGATTGTCAGTGGAGCAAAGTACCAAACCACATTTTCAGATAATGTCTGCACATTGCAGTTGAATTCTCTGGATTCCTCAGATATGGGCAATTACACATGCGTGGCTGCTAATGTCGCTGGGTCTGATGAATGTCGTGCAGTGCTAACTGTACAAG
>TTN-216,ENSE00003807700,1,279,578522,578800,AACCACCCTCTTTTGTGAAAGAACCTGAACCTTTGGAAGTACTACCAGGCAAAAATGTAACCTTCACAAGCGTTATTAGAGGAACCCCTCCATTCAAAGTCAACTGGTTCAGAGGTGCCAGAGAACTAGTGAAAGGAGACCGGTGCAACATCTATTTTGAAGACACTGTGGCAGAACTGGAATTATTTAATATTGACATATCTCAGAGTGGGGAATACACCTGTGTGGTTTCTAACAACGCTGGCCAAGCATCTTGCACTACCCGTCTCTTTGTGAAAG
>TTN-216,ENSE00003803086,1,279,578801,579079,AACCAGCTGCATTTTTGAAGAGATTAAGTGATCATTCTGTAGAACCAGGGAAGTCCATAATTCTGGAGAGCACCTACACTGGAACACTTCCAATTTCTGTCACTTGGAAAAAGGATGGTTTTAACATAACTACCTCTGAAAAATGTAACATAGTCACAACAGAGAAAACTTGTATCCTGGAAATTCTGAATAGCACAAAAAGAGATGCAGGGCAGTATTCCTGCGAGATTGAAAATGAGGCAGGAAGGGATGTTTGTGGAGCTCTGGTATCTACATTAG
>TTN-216,ENSE00003806655,1,279,579080,579358,AACCGCCTTATTTTGTTACGGAACTGGAACCTCTGGAGGCAGCAGTTGGAGATTCGGTTTCTTTACAATGCCAAGTTGCTGGGACACCAGAAATTACAGTGTCTTGGTACAAAGGAGATACCAAATTACGGCCAACTCCTGAATACAGGACCTACTTTACAAACAATGTGGCCACACTTGTTTTTAATAAAGTGAACATCAATGACAGTGGAGAGTACACATGCAAAGCAGAAAATAGTATAGGAACTGCTTCTTCTAAGACTGTGTTCAGAATTCAAG
>TTN-216,ENSE00003805355,1,288,579359,579646,AGCGCCAACTCCCACCTTCTTTTGCAAGACAATTAAAGGACATTGAACAAACTGTGGGGTTACCTGTTACACTCACTTGTCGATTAAATGGCTCTGCACCCATCCAAGTGTGCTGGTATAGAGATGGAGTACTTTTAAGAGACGATGAAAATCTACAGACTTCATTTGTAGATAATGTGGCAACTTTAAAAATTTTGCAAACTGACTTGAGTCACTCTGGCCAGTACTCTTGCTCAGCTTCCAACCCACTTGGAACAGCATCTTCTAGTGCTAGACTCACAGCAAGAG
>TTN-216,ENSE00003804884,1,288,579647,579934,AACCCAAGAAATCTCCCTTCTTTGACATCAAGCCTGTATCTATAGATGTTATTGCTGGAGAAAGTGCTGATTTTGAGTGTCATGTTACTGGTGCTCAACCGATGCGAATCACTTGGTCAAAAGATAACAAGGAGATCCGTCCTGGAGGAAACTATACAATCACATGTGTGGGAAACACTCCTCATTTGAGAATTCTTAAAGTAGGCAAAGGAGACTCTGGTCAATATACTTGCCAAGCAACCAATGATGTTGGCAAAGACATGTGCTCAGCTCAGCTCAGTGTAAAAG
>TTN-216,ENSE00003805805,1,282,579935,580216,AACCTCCAAAGTTTGTTAAGAAATTAGAAGCTTCAAAAGTTGCAAAGCAGGGAGAATCCATTCAACTGGAATGTAAAATAAGTGGCTCCCCAGAAATCAAAGTTTCATGGTTCCGAAATGACAGCGAACTTCATGAAAGTTGGAAATACAACATGTCATTCATTAATTCTGTGGCATTGCTTACGATCAATGAAGCTAGTGCTGAAGACAGCGGGGACTACATTTGTGAGGCTCATAATGGTGTTGGTGACGCCAGCTGCAGCACAGCGTTGACAGTGAAAG
>TTN-216,ENSE00003803146,1,279,580217,580495,CACCTCCTGTTTTCACCCAGAAGCCTTCTCCAGTAGGAGCTCTTAAAGGTTCTGATGTGATTCTCCAATGTGAAATTTCGGGAACTCCCCCATTTGAAGTAGTATGGGTTAAAGATCGAAAGCAGGTTAGAAACAGCAAGAAATTTAAAATCACTTCAAAACATTTTGATACAAGTCTTCATATCCTTAATCTTGAAGCCTCCGATGTCGGGGAATATCACTGCAAAGCTACTAATGAGGTGGGAAGTGACACGTGTTCTTGCTCTGTCAAGTTCAAAG
>TTN-216,ENSE00003806016,1,282,580496,580777,AACCTCCACGATTCGTGAAAAAGCTAAGTGACACCTCAACCCTTATTGGGGATGCTGTTGAGTTACGGGCCATAGTGGAGGGCTTCCAGCCAATTTCTGTTGTCTGGCTGAAAGATAGAGGTGAAGTCATCAGAGAGAGTGAAAATACCAGGATTTCATTCATTGATAACATTGCAACCCTCCAGCTGGGGAGTCCAGAAGCATCTAATTCTGGAAAATATATATGCCAAATCAAAAACGATGCTGGAATGAGAGAATGCTCTGCAGTCTTGACTGTACTAG
>TTN-216,ENSE00003808302,1,279,580778,581056,AACCAGCAAGAATCATAGAGAAGCCCGAACCCATGACTGTCACTACTGGAAATCCTTTTGCATTAGAGTGTGTAGTGACTGGAACACCAGAACTCTCAGCCAAGTGGTTCAAAGATGGAAGAGAATTGTCTGCAGACAGCAAACATCACATTACATTCATCAATAAAGTGGCTTCCCTTAAAATCCCCTGTGCCGAAATGAGTGACAAAGGATTATATAGCTTTGAAGTGAAAAACAGTGTTGGCAAAAGTAACTGCACTGTATCCGTCCATGTTTCTG
>TTN-216,ENSE00003802442,1,288,581057,581344,ATCGGATTGTGCCTCCTTCCTTCATCCGCAAGCTGAAAGACGTGAATGCCATCCTGGGGGCCTCAGTTGTTTTGGAGTGCCGAGTCTCTGGCTCAGCCCCGATTTCAGTTGGCTGGTTTCAGGATGGAAATGAGATTGTTAGTGGGCCCAAATGTCAGTCCAGCTTTTCGGAAAACGTCTGTACTTTGAATCTGAGCTTGTTGGAGCCCTCCGACACAGGCATATACACGTGTGTGGCTGCCAATGTAGCTGGTTCCGATGAGTGCTCAGCAGTCCTGACTGTGCAAG
>TTN-216,ENSE00003809965,1,279,581345,581623,AACCACCATCTTTTGAACAAACCCCTGATTCTGTGGAAGTTTTGCCTGGAATGAGCCTCACATTCACCAGTGTCATCAGAGGCACCCCTCCTTTCAAGGTCAAGTGGTTTAAAGGCAGCAGGGAACTGGTGCCTGGGGAGTCATGCAACATCTCTCTGGAAGATTTTGTCACAGAACTGGAGTTGTTTGAGGTGCAGCCATTAGAAAGTGGAGACTATTCTTGCCTCGTTACAAATGATGCTGGCAGTGCTTCCTGTACCACACATCTTTTTGTGAAAG
>TTN-216,ENSE00003809650,1,279,581624,581902,AACCAGCCACCTTTGTGAAAAGATTGGCTGATTTCAGTGTTGAGACAGGAAGCCCCATAGTTCTCGAGGCCACATACACTGGCACACCTCCAATCTCAGTGAGCTGGATAAAGGACGAGTATCTTATTTCACAATCTGAGAGATGCAGTATTACTATGACAGAAAAATCTACCATACTGGAAATTCTTGAGAGCACAATAGAGGATTATGCACAGTACAGCTGCCTGATAGAAAATGAGGCTGGTCAAGATATCTGTGAAGCTCTGGTGTCTGTCTTAG
>TTN-216,ENSE00003810498,1,279,581903,582181,AACCACCGTACTTTATTGAACCTCTGGAACATGTGGAAGCAGTCATTGGAGAACCTGCAACTTTACAGTGTAAAGTGGATGGAACTCCAGAAATTAGAATTTCTTGGTATAAAGAACACACAAAGCTACGATCAGCTCCTGCATATAAAATGCAATTCAAAAATAACGTTGCTTCCTTAGTAATCAACAAAGTGGATCACAGTGATGTGGGAGAGTATTCATGCAAGGCAGACAACAGTGTGGGGGCAGTCGCTTCTTCAGCTGTGCTTGTTATCAAAG
>TTN-216,ENSE00003807178,1,288,582182,582469,CGCGCAAACTTCCACCTTTCTTTGCAAGAAAACTGAAAGACGTTCATGAGACTCTAGGCTTCCCAGTTGCATTTGAATGCCGCATCAATGGCTCAGAACCTCTTCAAGTGTCTTGGTACAAGGATGGGGTTCTTTTGAAAGATGATGCTAATTTGCAGACATCTTTTGTTCATAATGTAGCAACTCTTCAGATTTTACAAACTGACCAGAGCCACATAGGGCAGTATAATTGCTCTGCTTCTAATCCTCTTGGGACTGCTTCATCCAGTGCCAAGCTCATTCTCTCAG
>TTN-216,ENSE00003808579,1,288,582470,582757,AGCATGAAGTGCCTCCTTTCTTTGATCTAAAGCCTGTATCAGTAGATCTTGCTCTTGGAGAAAGTGGTACTTTTAAATGTCATGTAACTGGGACTGCACCAATCAAAATCACTTGGGCCAAAGATAACCGAGAGATTCGCCCTGGAGGCAACTACAAGATGACTTTGGTAGAAAATACTGCCACTCTGACAGTTCTCAAAGTAGGCAAAGGCGATGCCGGGCAGTACACCTGCTATGCAAGCAACATCGCTGGAAAAGACTCTTGTTCTGCTCAGCTGGGTGTACAAG
>TTN-216,ENSE00003801249,1,282,582758,583039,AACCACCCAGGTTCATTAAGAAGCTAGAACCTTCAAGAATTGTGAAACAGGATGAATTCACAAGGTATGAATGCAAAATCGGTGGGTCTCCAGAAATCAAAGTTTTATGGTATAAGGACGAGACTGAAATTCAAGAGAGCAGTAAATTCAGAATGTCATTCGTTGACTCGGTGGCTGTGCTGGAAATGCACAATCTCAGTGTTGAAGACAGTGGAGACTACACCTGTGAGGCCCACAATGCAGCAGGCAGTGCCAGCAGCAGCACATCCTTAAAAGTTAAAG
>TTN-216,ENSE00003810208,1,279,583040,583318,AACCACCCATTTTCCGCAAAAAGCCTCATCCTATAGAGACACTGAAAGGAGCTGATGTTCACCTTGAATGTGAGCTTCAGGGCACTCCCCCATTTCACGTTTCTTGGTATAAAGACAAGAGAGAACTTAGGAGCGGCAAGAAGTACAAGATAATGTCTGAGAACTTCCTAACCAGTATCCACATCCTGAATGTCGATGCTGCAGACATTGGGGAATATCAGTGTAAAGCCACAAATGATGTGGGAAGCGACACTTGCGTTGGTTCCATCGCTCTCAAAG
>TTN-216,ENSE00003802440,1,282,583319,583600,CACCACCAAGATTTGTGAAGAAGCTCAGTGACATATCTACTGTCGTTGGTAAAGAAGTTCAGCTGCAGACTACCATTGAAGGCGCTGAACCCATTTCAGTGGTGTGGTTCAAAGATAAGGGAGAAATCGTTAGAGAAAGTGACAACATATGGATTTCTTATTCAGAAAACATTGCAACCTTACAGTTTTCAAGAGTGGAACCAGCCAATGCTGGAAAATACACTTGTCAGATCAAAAACGATGCTGGGATGCAAGAGTGCTTCGCCACGCTATCCGTTCTCG
>TTN-216,ENSE00003802351,1,279,583601,583879,AGCCTGCAACAATTGTAGAAAAGCCAGAATCCATAAAAGTTACCACGGGAGACACCTGTACCTTGGAGTGTACAGTAGCTGGCACCCCTGAACTCAGTACTAAGTGGTTTAAGGATGGAAAAGAGCTAACAAGTGACAACAAATACAAAATAAGCTTCTTCAACAAAGTATCCGGCCTTAAGATCATCAATGTAGCACCGAGTGACAGTGGGGTATACAGTTTTGAGGTGCAGAACCCTGTTGGCAAAGACAGCTGCACAGCTTCATTGCAGGTTTCAG
>TTN-216,ENSE00003807933,1,288,583880,584167,ACCGAACCGTTCCTCCTTCATTCACAAGAAAATTGAAAGAGACAAATGGTCTATCCGGCTCCTCAGTTGTAATGGAGTGTAAAGTCTATGGGTCACCTCCAATCTCTGTCTCCTGGTTCCATGAAGGAAATGAGATCAGTAGTGGAAGGAAATACCAGACCACCCTGACAGATAATACTTGTGCTTTAACTGTGAACATGCTGGAAGAATCAGACAGTGGTGACTACACATGTATAGCTACTAATATGGCTGGTTCTGATGAATGTAGTGCTCCTTTGACTGTGAGAG
>TTN-216,ENSE00003804939,1,279,584168,584446,AACCACCATCTTTTGTTCAGAAACCTGATCCCATGGATGTTTTAACTGGGACCAATGTAACTTTCACAAGTATCGTAAAAGGAACACCTCCTTTCAGTGTTAGCTGGTTCAAAGGTAGCAGTGAACTAGTACCAGGTGACAGATGCAACGTGTCTTTGGAGGATTCAGTTGCTGAACTGGAGTTGTTCGATGTAGATACATCACAAAGTGGAGAATATACTTGCATAGTTAGCAATGAAGCTGGCAAGGCTTCTTGTACAACACATCTCTACATAAAAG
>TTN-216,ENSE00003810094,1,279,584447,584725,CCCCAGCCAAATTTGTGAAGAGGCTGAATGATTACAGCATAGAGAAAGGAAAACCCCTGATCCTAGAGGGTACATTCACTGGAACTCCTCCCATTTCGGTTACCTGGAAGAAAAATGGCATAAATGTAACTCCTTCTCAGAGGTGTAATATAACTACGACTGAAAAATCGGCAATCCTGGAAATTCCAAGTAGCACAGTAGAGGATGCAGGACAATACAACTGCTACATTGAAAATGCCTCTGGAAAAGATTCCTGTTCAGCACAAATACTCATACTAG
>TTN-216,ENSE00003811103,1,279,584726,585004,AACCACCGTATTTTGTCAAGCAGTTGGAGCCGGTTAAGGTGTCTGTTGGAGATTCTGCCTCTCTACAATGCCAGCTTGCTGGAACCCCTGAAATTGGGGTATCCTGGTATAAAGGAGATACAAAATTGAGACCCACTACGACTTACAAAATGCATTTTAGGAATAATGTTGCTACACTGGTTTTCAACCAGGTTGATATTAATGATAGTGGAGAATATATCTGCAAAGCTGAAAACAGCGTGGGAGAAGTTTCTGCATCAACTTTCCTTACCGTTCAAG
>TTN-216,ENSE00003801476,1,288,585005,585292,AGCAAAAACTTCCACCATCATTTTCTCGACAATTGAGAGATGTTCAAGAAACAGTTGGACTGCCAGTTGTTTTTGATTGTGCCATAAGTGGATCAGAACCTATCTCCGTGTCTTGGTATAAAGACGGCAAGCCATTGAAAGACAGCCCAAATGTACAAACATCATTTTTAGACAATACAGCCACACTCAATATTTTTAAAACTGACCGGAGCCTTGCAGGCCAGTATTCCTGCACAGCTACAAACCCTATAGGCTCTGCTTCTTCCAGTGCCAGGCTCATTCTCACAG
>TTN-216,ENSE00003808430,1,288,585293,585580,AGGGGAAGAACCCACCCTTCTTTGACATCCGTCTTGCCCCTGTGGATGCTGTGGTGGGAGAAAGTGCTGACTTTGAGTGCCACGTCACGGGCACACAACCGATAAAGGTCAGCTGGGCCAAAGACAGCAGAGAAATACGAAGTGGCGGAAAGTACCAGATTAGTTATCTGGAAAACAGCGCCCACCTGACAGTCCTCAAAGTAGACAAAGGAGATTCTGGACAATATACCTGCTATGCTGTGAATGAAGTGGGAAAAGACTCTTGCACAGCTCAGCTGAATATAAAAG
>TTN-216,ENSE00003809007,1,291,585581,585871,AGCGGCTCATCCCACCAAGTTTCACTAAAAGACTCTCAGAGACAGTAGAAGAAACAGAAGGGAATTCTTTCAAACTTGAGGGACGTGTGGCTGGTTCCCAACCTATAACTGTTGCCTGGTACAAAAATAATATAGAGATACAACCAACTTCTAACTGTGAAATAACATTCAAGAACAACACGTTAGTGCTGCAAGTCAGGAAAGCAGGCATGAACGACGCTGGTTTGTACACATGCAAAGTGTCCAATGATGCAGGCTCTGCTCTGTGCACGTCTTCAATCGTCATCAAAG
>TTN-216,ENSE00003803910,1,288,585872,586159,AACCTAAGAAGCCACCTGTATTTGATCAGCACCTTACTCCAGTAACAGTGAGTGAAGGAGAATACGTGCAGCTCAGCTGCCATGTCCAGGGATCTGAGCCAATTAGGATCCAGTGGTTGAAGGCTGGCAGGGAAATAAAGCCTTCAGACAGATGCAGCTTCAGCTTTGCTAGTGGGACAGCTGTACTGGAACTCAGAGATGTGGCTAAAGCAGATTCGGGAGATTATGTGTGTAAAGCTTCAAATGTGGCTGGAAGTGACACTACCAAATCAAAAGTGACCATTAAAG
>TTN-216,ENSE00003804245,1,93,586160,586252,ACAAACCAGCTGTGGCCCCAGCAACCAAGAAAGCTGCGGTAGATGGAAGACTCTTTTTTGTGTCAGAACCTCAGAGTATCAGAGTCGTAGAAA
>TTN-216,ENSE00003801649,1,286,586253,586538,AAACCACTGCGACCTTCATTGCAAAAGTTGGAGGTGACCCAATCCCAAATGTTAAATGGACAAAAGGGAAGTGGAGACAGCTGAACCAAGGAGGTCGTGTTTTCATCCACCAAAAAGGCGATGAAGCAAAACTGGAGATTAGGGACACCACAAAAACTGATTCTGGGTTATACCGATGCGTGGCATTTAACGAACATGGTGAAATTGAAAGTAATGTTAACTTACAGGTGGATGAAAGGAAGAAACAAGAGAAAATTGAAGGCGATCTTAGAGCAATGCTGAAAAA
>TTN-216,ENSE00003805371,1,184,586539,586722,GACTCCAATCTTAAAGAAAGGAGCTGGAGAAGAAGAGGAAATTGATATCATGGAACTTCTCAAAAATGTTGATCCTAAAGAATATGAAAAATATGCCCGCATGTATGGAATCACTGACTTCCGAGGTCTTCTTCAAGCATTTGAACTGCTCAAGCAAAGCCAAGAAGAAGAGACACATAGACTG
>TTN-216,ENSE00003802112,1,90,586723,586812,GAAATTGAGGAAATAGAGAGGTCAGAGAGGGACGAAAAGGAATTTGAGGAACTTGTATCATTTATTCAGCAAAGACTGTCACAGACAGAG
>TTN-216,ENSE00003810323,1,268,586813,587080,CCTGTCACTCTGATCAAGGACATTGAAAATCAGACAGTTTTGAAAGATAATGATGCTGTCTTTGAAATTGACATTAAAATTAATTATCCAGAAATCAAGCTTTCGTGGTACAAAGGAACTGAAAAACTGGAACCCAGTGATAAATTTGAAATAAGCATTGATGGTGACCGACATACACTCAGAGTCAAAAACTGTCAACTTAAAGACCAGGGCAATTATCGATTGGTTTGTGGTCCACACATCGCTAGCGCTAAACTAACTGTAATTG
>TTN-216,ENSE00003810781,1,261,587081,587341,AGCCTGCATGGGAACGGCATCTTCAGGATGTGACTCTGAAAGAAGGCCAGACTTGCACCATGACATGCCAATTTTCTGTACCAAATGTAAAATCTGAATGGTTCAGAAATGGCAGAATCCTTAAACCCCAAGGTAGACATAAAACAGAAGTGGAACACAAAGTCCATAAATTGACCATTGCAGATGTTCGAGCAGAAGACCAGGGTCAGTACACCTGCAAATATGAAGACCTTGAAACTTCAGCAGAACTCAGAATCGAAG
>TTN-216,ENSE00003805599,1,210,587342,587551,CTGAACCAATTCAGTTTACAAAGCGCATACAGAACATCGTGGTGAGTGAGCATCAGTCTGCCACCTTTGAGTGTGAAGTGTCCTTTGATGATGCCATTGTAACATGGTACAAAGGACCAACAGAACTGACAGAGAGCCAGAAATACAACTTCAGGAATGATGGCCGCTGCCATTATATGACCATCCACAATGTGACCCCAGACGATGAAG
>TTN-216,ENSE00003809461,1,78,587552,587629,GTGTCTACTCGGTCATCGCTCGGCTGGAGCCAAGAGGTGAAGCAAGAAGCACGGCAGAGCTGTACCTAACGACGAAAG
>TTN-216,ENSE00003805821,1,27,587630,587656,AAATCAAACTTGAGCTGAAGCCTCCTG
>TTN-216,ENSE00003803485,1,60,587657,587716,ATATTCCTGACTCCAGAGTTCCAATCCCAACCATGCCTATCAGAGCAGTGCCACCAGAAG
>TTN-216,ENSE00003803812,1,84,587717,587800,AAATCCCTCCTGTGGTTGCTCCTCCTATCCCCCTTTTGCTACCAACACCCGAAGAAAAGAAACCACCACCAAAACGTATTGAAG
>TTN-216,ENSE00003804844,1,72,587801,587872,TTACCAAAAAGGCTGTGAAGAAAGATGCCAAAAAAGTTGTTGCAAAGCCCAAAGAGATGACACCACGTGAAG
>TTN-216,ENSE00003810688,1,48,587873,587920,AGATTGTCAAGAAGCCTCCACCTCCTACTACCTTAATTCCAGCAAAAG
>TTN-216,ENSE00003806388,1,405,587921,588325,CTCCTGAAATCATTGATGTATCCTCTAAAGCTGAAGAAGTAAAAATAATGACTATAACCAGAAAGAAAGAGGTTCAGAAAGAAAAAGAAGCTGTGTATGAGAAAAAGCAAGCAGTCCACAAGGAGAAGAGAGTCTTCATTGAATCTTTCGAAGAACCTTATGACGAACTGGAGGTAGAACCATACACAGAGCCATTTGAACAACCTTATTATGAAGAACCAGATGAAGACTATGAAGAGATTAAGGTAGAAGCTAAAAAAGAAGTTCACGAGGAATGGGAAGAAGATTTTGAAGAAGGGCAAGAATACTATGAAAGGGAAGAAGGCTATGACGAAGGGGAGGAAGAGTGGGAAGAGGCTTACCAAGAAAGGGAAGTAATTCAAGTTCAAAAGGAGGTCTATGAAG
>TTN-216,ENSE00003803093,1,63,588326,588388,AATCACATGAGAGAAAAGTTCCAGCCAAAGTACCTGAAAAGAAAGCACCACCACCTCCTAAAG
>TTN-216,ENSE00003802009,1,78,588389,588466,TTATAAAGAAGCCAGTAATTGAAAAAATTGAAAAGACTTCTCGAAGAATGGAGGAAGAAAAAGTTCAAGTCACCAAAG
>TTN-216,ENSE00003806356,1,78,588467,588544,TACCTGAAGTTTCAAAGAAGATTGTTCCACAAAAACCTTCCCGGACTCCAGTACAGGAAGAAGTTATTGAAGTGAAAG
>TTN-216,ENSE00003803112,1,87,588545,588631,TACCAGCTGTGCATACAAAGAAGATGGTTATTTCAGAAGAAAAGATGTTCTTTGCTTCTCACACAGAGGAGGAGGTGTCAGTCACAG
>TTN-216,ENSE00003811115,1,81,588632,588712,TCCCCGAGGTACAAAAGGAAATTGTTACTGAAGAGAAAATTCACGTTGCCATTTCCAAAAGGGTTGAACCACCACCTAAAG
>TTN-216,ENSE00003810048,1,84,588713,588796,TCCCTGAGCTACCTGAGAAACCAGCTCCAGAAGAAGTGGCCCCTGTTCCTATCCCTAAAAAAGTGGAGCCCCCAGCACCAAAAG
>TTN-216,ENSE00003809302,1,84,588797,588880,TTCCTGAGGTTCCCAAGAAACCCGTGCCAGAGGAGAAAAAGCCAGTTCCTGTGCCTAAGAAGGAACCTGCTGCTCCCCCAAAAG
>TTN-216,ENSE00003811271,1,84,588881,588964,TCCCAGAGGTGCCAAAGAAACCTGTCCCTGAAGAAAAGATTCCCGTTCCTGTTGCAAAGAAAAAGGAAGCTCCCCCAGCTAAAG
>TTN-216,ENSE00003811169,1,81,588965,589045,TTCCTGAAGTACAGAAGGGAGTTGTGACAGAAGAAAAAATAACCATTGTAACTCAAAGAGAGGAATCTCCACCACCAGCAG
>TTN-216,ENSE00003802187,1,84,589046,589129,TGCCAGAAATACCAAAGAAGAAAGTTCCTGAAGAAAGGAAACCTGTTCCTCGGAAGGAGGAAGAAGTTCCACCACCACCAAAAG
>TTN-216,ENSE00003810484,1,84,589130,589213,TGCCAGCTCTGCCTAAGAAACCCGTCCCAGAGGAGAAAGTTGCAGTGCCAGTTCCTGTCGCTAAGAAAGCTCCTCCTCCCCGAG
>TTN-216,ENSE00003810121,1,102,589214,589315,CTGAAGTCTCTAAGAAAACTGTTGTAGAAGAAAAGAGATTTGTTGCTGAAGAAAAACTATCCTTCGCAGTTCCTCAAAGAGTGGAAGTCACGCGGCACGAAG
>TTN-216,ENSE00003805410,1,114,589316,589429,TATCTGCAGAGGAGGAATGGAGTTACTCAGAAGAGGAGGAAGGTGTGTCCATTTCAGTTTATAGAGAAGAAGAAAGAGAGGAGGAGGAAGAAGCAGAGGTTACAGAATATGAAG
>TTN-216,ENSE00003801264,1,81,589430,589510,TGATGGAAGAGCCTGAGGAATATGTTGTGGAAGAAAAGCTGCACATTATTTCTAAGAGAGTGGAAGCTGAGCCAGCTGAAG
>TTN-216,ENSE00003805756,1,78,589511,589588,TGACAGAGAGGCAGGAGAAGAAAATTGTACTGAAACCAAAAATTCCTGCTAAAATAGAGGAGCCTCCACCGGCTAAAG
>TTN-216,ENSE00003808334,1,84,589589,589672,TTCCTGAAGCACCTAAGAAAATTGTGCCAGAAAAGAAAGTTCCTGCTCCAGTTCCTAAAAAGGAAAAGGTGCCCCCACCTAAAG
>TTN-216,ENSE00003808052,1,84,589673,589756,TGCCAGAAGAGCCAAAGAAACCAGTTCCAGAAAAAAAGGTTCCTCCAAAAGTCATTAAGATGGAAGAACCTCTCCCAGCCAAAG
>TTN-216,ENSE00003803067,1,84,589757,589840,TGACTGAGAGGCACATGCAAATTACCCAGGAAGAAAAAGTTCTTGTTGCTGTAACTAAAAAAGAGGCGCCTCCAAAAGCAAGAG
>TTN-216,ENSE00003808806,1,84,589841,589924,TGCCAGAGGAACCGAAGAGAGCTGTCCCAGAAGAAAAAGTTCTGAAACTCAAACCTAAAAGAGAGGAGGAACCACCAGCTAAAG
>TTN-216,ENSE00003805330,1,81,589925,590005,TGACTGAATTCAGAAAAAGAGTGGTTAAAGAAGAAAAAGTATCAATTGAAGCTCCAAAAAGAGAACCTCAACCCATCAAAG
>TTN-216,ENSE00003807878,1,207,590006,590212,AAGTAACTATAATGGAAGAGAAAGAAAGGGCTTATACCCTAGAAGAAGAAGCTGTTTCAGTACAACGGGAAGAAGAATATGAGGAATATGAAGAATATGATTATAAAGAATTTGAGGAGTATGAACCAACAGAAGAATATGACCAATATGAAGAATACGAGGAGCGGGAGTATGAACGATATGAAGAGCATGAAGAATACATCACAG
>TTN-216,ENSE00003806244,1,78,590213,590290,AACCAGAGAAGCCTATCCCTGTAAAGCCTGTCCCAGAAGAACCAGTTCCCACAAAACCAAAGGCCCCACCGGCTAAAG
>TTN-216,ENSE00003810594,1,75,590291,590365,TGCTGAAGAAAGCTGTCCCTGAAGAAAAAGTACCAGTGCCCATTCCTAAGAAACTCAAACCTCCACCACCCAAAG
>TTN-216,ENSE00003809388,1,93,590366,590458,TGCCTGAAGAACCAAAGAAAGTTTTTGAGGAAAAAATACGTATTTCAATTACCAAACGTGAAAAAGAGCAGGTGACTGAACCCGCTGCTAAAG
>TTN-216,ENSE00003807405,1,78,590459,590536,TGCCCATGAAGCCCAAGAGGGTTGTCGCAGAAGAAAAAGTACCTGTCCCTAGAAAAGAAGTAGCACCACCTGTTAGAG
>TTN-216,ENSE00003810081,1,162,590537,590698,TGCCAGAAGTGCCTAAAGAACTTGAACCAGAAGAGGTTGCCTTTGAAGAGGAAGTTGTAACCCATGTAGAAGAATATCTTGTAGAAGAAGAAGAAGAGTACATTCATGAAGAAGAGGAGTTCATAACTGAGGAAGAAGTGGTGCCAGTGATACCAGTCAAAG
>TTN-216,ENSE00003806496,1,84,590699,590782,TGCCTGAGGTACCCAGGAAACCTGTTCCAGAAGAGAAGAAACCTGTTCCTGTTCCCAAGAAGAAGGAAGCTCCACCGGCAAAAG
>TTN-216,ENSE00003802498,1,78,590783,590860,TGCCTGAGGTTCCTAAGAAGCCAGAGGAGAAAGTTCCTGTGCTTATTCCTAAAAAGGAGAAGCCTCCGCCAGCAAAAG
>TTN-216,ENSE00003809653,1,84,590861,590944,TTCCTGAAGTGCCCAAGAAACCTGTGCCAGAGGAGAAAGTACCAGTACCAGTTCCTAAAAAGGTGGAAGCTCCACCTGCCAAAG
>TTN-216,ENSE00003810862,1,84,590945,591028,TGCCAGAGGTACCCAAGAAGCCTGTGCCTGAGAAGAAGGTGCCAGTTCCTGCTCCTAAGAAAGTGGAGGCTCCACCTGCAAAAG
>TTN-216,ENSE00003805059,1,84,591029,591112,TGCCAGAGGTGCCCAAGAAGCTCATCCCAGAAGAAAAGAAACCAACACCTGTTCCGAAAAAAGTGGAAGCACCACCACCCAAAG
>TTN-216,ENSE00003801382,1,297,591113,591409,TGCCAAAGAAACGTGAACCAGTTCCAGTTCCTGTAGCTCTACCTCAGGAAGAGGAAGTTCTATTTGAAGAAGAAATTGTTCCTGAAGAGGAAGTTCTACCTGAGGAAGAGGAAGTTCTACCTGAGGAAGAGGAAGTTCTACCTGAAGAAGAGGAAGTTCTACCTGAAGAAGAGGAAATTCCACCTGAGGAAGAGGAAGTTCCTCCCGAAGAAGAATATGTACCTGAGGAAGAAGAATTTGTACCTGAAGAAGAAGTCCTTCCAGAAGTTAAACCTAAGGTGCCAGTACCTGCACCAG
>TTN-216,ENSE00004025982,1,87,591410,591496,TGCCTGAAGTGCCAAAGAAACCTGTACCAGAGAAGAAAGTCCCTGTTCCCGCCCCTAAAAAAGTGGAACCTCCACCACCACCCAAAG
>TTN-216,ENSE00003805240,1,75,591497,591571,TGCCTGAAATTAAGAAGAAAGTGACAGAGAAGAAAGTGGTCATTCCCAAGAAAGAGGAGGCTCCCCCTGCCAAAG
>TTN-216,ENSE00004025997,1,84,591572,591655,TGTCTGTGGTACCTAAGAAACCTGAGCCAGAAAAGAAGGTCCCTCCTCCTGGTCTTAAGAAAGCAGTGGCCCCTCCTGCCAAAG
>TTN-216,ENSE00003804875,1,75,591656,591730,TTCCTGAGGTGCCTAAGAAGGTGGAAGAAAAACGAATCATTCTCCCTAAAGAAGAGGAAGTTCTACCAGTTGAAG
>TTN-216,ENSE00003801552,1,96,591731,591826,TGACTGAGGAGCCTGAAGAAGAGCCTATTTCAGAAGAAGAAATCCCAGAAGAACCACCTAGCATAGAGGAAGTTGAAGAGGTGGCACCACCTAGAG
>TTN-216,ENSE00003804385,1,78,591827,591904,TGCCTGAAGTGATTAAGAAAGCAGTACCTGAAGCACCTACTCCTGTTCCTAAAAAAGTGGAGGCACCACCAGCTAAAG
>TTN-216,ENSE00003805135,1,69,591905,591973,TGTCAAAGAAAATTCCTGAGGAAAAAGTACCTGTTCCTGTTCAGAAAAAAGAGGCACCCCCAGCCAAAG
>TTN-216,ENSE00003808243,1,75,591974,592048,TGCCTGAAGTACCAAAGAAAGTCCCAGAAAAGAAAGTCCTTGTGCCTAAAAAGGAAGCTGTTCCCCCAGCTAAAG
>TTN-216,ENSE00003808353,1,297,592049,592345,GGAGAACTGTCCTTGAAGAAAAAGTATCAGTTGCCTTCCGCCAAGAAGTAGTAGTAAAAGAAAGACTAGAATTAGAAGTAGTAGAAGCAGAAGTGGAAGAAATTCCGGAAGAAGAAGAGTTCCATGAAGTTGAAGAATATTTTGAAGAAGGCGAGTTTCATGAAGTAGAAGAATTCATCAAATTAGAACAACATAGAGTTGAAGAAGAACACAGAGTTGAAAAAGTTCATAGGGTAATAGAAGTTTTTGAGGCTGAAGAAGTGGAAGTATTTGAAAAACCAAAAGCTCCACCTAAAG
>TTN-216,ENSE00003807571,1,81,592346,592426,GGCCTGAGATATCTGAGAAAATCATCCCTCCAAAAAAACCGCCCACTAAAGTTGTTCCTCGAAAAGAGCCACCAGCTAAAG
>TTN-216,ENSE00003808118,1,78,592427,592504,TACCGGAGGTGCCTAAGAAAATTGTGGTAGAAGAAAAAGTACGTGTTCCTGAAGAGCCCAGAGTTCCACCAACTAAAG
>TTN-216,ENSE00004025978,1,84,592505,592588,CACCCGAAGTACCCAAGAAAATTGTCCCAGAAGAAAAAGTTCGTGAAGCTGTTCTGAAAAAGCCTGAAGTTCCACCAGCTAAAG
>TTN-216,ENSE00004026002,1,75,592589,592663,TTCCTGGGATGCCTAAGAAAAGTGTTCAAGAAGAAAAATCACCTATTGTTATTTCTGAAGACACAGAGATGTACA
>TTN-216,ENSE00004025998,1,84,592664,592747,TTTATGAAGCATCTGAAGAAGCAGTCCTAGAAGAAAAAGTACTTGTGACTCAACCTCAAAAGACAAAACCCAAACTAGCAAAAG
>TTN-216,ENSE00004025971,1,84,592748,592831,TGCCTGAGCCACCCAAGAAAGTTGTTCCAGAAGACAAAATATATGTGACTATTCCTAAAAAGAGAGAAACACCAGCAACTAAAG
>TTN-216,ENSE00001725280,1,84,592832,592915,AACCTGATACAACCAGAGGCATTTTTCCAGAGGTGGAGCCACCTGAGGCTATTCCTGAAATTCCAGAACATCCTCCAACTGAAG
>TTN-216,ENSE00004024308,1,78,592916,592993,AGTTTGAAGTCTTCAAGGAAGTCATTCCAGAGGGAGAAACTCCTATTGTTAAAAGAAGAAAAACACCATCACCAACAG
>TTN-216,ENSE00004025995,1,84,592994,593077,TGCCTGAATCACCTCGAGAAATTGTCCCTGTAAAGGAAACACCCATGGCTGCTCCCCTTGAAATTGAAATACCTCCCACTAAAG
>TTN-216,ENSE00004024272,1,84,593078,593161,CACCAGAAGCTATGAAAGAAGTTGTCCCTGAAATGAAAATATTTGAGGATGTACCTGAAGAGCCAGAAACTCCACGTATGAAAA
>TTN-216,ENSE00004024280,1,75,593162,593236,CGCCCGAAGCTCCTCAAGAAATTATTCCTGCCAAGACAGTTCCTTCCAAAAAAAGAGAACCCCCATCAGTTAAAG
>TTN-216,ENSE00004024279,1,84,593237,593320,TGCCTGAAGCTCTCCAAGAAATTGTCCCTGAAAAGAAAACGCTTGTGGTTCCTCTCAGAAAGCCTGAAGTCCTTCCTGATGAAG
>TTN-216,ENSE00004024286,1,78,593321,593398,TGCCGGAGGCTCTCAGAGAAGTTGTCCCGGAAAAGAAAGTGCATCCTCCCCAAAGGGCTGAAGTTGTACCTGTCAAAG
>TTN-216,ENSE00004024310,1,84,593399,593482,TGCACGAAGCTCCCAAAGAGATTATCCCTGAAAAGAAAGTGTCGGTGGTGCCTCCTAAAAAGCCTGAAGTCCCACCTGTTAAAG
>TTN-216,ENSE00004024305,1,84,593483,593566,TGCCAGAAGCTTCCAAAGAGGTTATCCGCGAAGAGAAAGTGCCCTTGGCTCCTCCTAAAGAGCCTGAAGTCCCACCTGTTAAAG
>TTN-216,ENSE00004024294,1,84,593567,593650,TACCAGAGCCTCCCAAAGAAGTAGTTCCTGAAAAGAAAGCGCCAGTGGCTCCTCCTAAAGAGCCTGAAGTCCCACCTGTTAAAG
>TTN-216,ENSE00004025974,1,84,593651,593734,TGCCTGAGGCTCCCAAAGAAGTTGTTCCTGAAAAGAAAGTGCCAGTGCCTCCTCCTAAAAAGCCTGAAGTGCCACCCACAAAAG
>TTN-216,ENSE00004025967,1,84,593735,593818,TCCCAGAGGTGCCAAAGGCAGCTGTCCCAGAAAAGAAGTTGCCTGAAGCTATTCCTCCCAAACCGGAAAGTCCTCCCCCTGAAG
>TTN-216,ENSE00003807304,1,90,593819,593908,TGCCTGAAGTGCTGCCACCGAAGGAAGTGGTCCCAGAAAAGAAAGTACCGGTGCCTCCTGCCAAAAAGCCAGAAGCTCCACCTCCTAAAG
>TTN-216,ENSE00004026001,1,84,593909,593992,TTCCTGAAGCTCCTAAAGAAGTTGTACTTGAAAAGAAAGCATCTGTGGCTGTGCCCAAAAAACCGGAAGCCCCACGTGCAAAAG
>TTN-216,ENSE00004025988,1,84,593993,594076,TGCCTGAAGCTGCTCAAGAAGTTGTCCCAGAAAAGAAAATTCCCAAGGCACCAATCAAAAAACCAGAAGCCCCCGCAGTTACAG
>TTN-216,ENSE00004025983,1,81,594077,594157,TGCCAGAAGTTCCTCAAGAAGCCACAGAAAAAGAAATTCCCGTGGCTCCACCCAAAAAACCAGAAGCTCCAATTGTCCCAG
>TTN-216,ENSE00004025976,1,81,594158,594238,TGCCTGAAGCTCAAGAAGTTGTCCCAGAAAAGAAAGTTCCTAAGGCTCCTCCCACAAAACCAGAAGCCCCACCTGCCACAG
>TTN-216,ENSE00004025986,1,81,594239,594319,TGCCTGAAGTCCCACAAGAAATTGTGCCAGAAAAGAAAACACTGGTGCTTCCTAAAAAGCCAGAAGTTCCACCTGTTACAG
>TTN-216,ENSE00004025969,1,84,594320,594403,TGCCAGAGGCTCCCAAAGAAGTTGTCCTTGAAAAGAAAGTGCCCTCGGCTCCTCCTAAAAAGCCTGAAGTCCCACCTGTTAAAG
>TTN-216,ENSE00003802745,1,84,594404,594487,TGCCTGAGGCTCCCAAAGAAGTTGTTCCTGAAAAGAAAGTGCCAGTGCCTCCTCCTAAAAAGCCTGAAGTGCCACCCACAAAAG
>TTN-216,ENSE00003809569,1,84,594488,594571,TCCCAGAGGTGCCAAAGGCAGCTGTCCCAGAAAAGAAGGTGCCTGAAGCTATTCCTCCCAAACCGGAAAGTCCTCCCCCTGAAG
>TTN-216,ENSE00004025984,1,90,594572,594661,TGCCTGAAGTGCTGCCACCGAAGGAAGTGGTCCCAGAAAAGAAAGTACCGGTGCCTCCTGCCAAAAAGCCAGAAGCTCCACCTCCTAAAG
>TTN-216,ENSE00004026000,1,84,594662,594745,TTCCTGAAGCTCCTAAAGAAGTTGTACTTGAAAAGAAAGCATCTGTGGCTGTGCCCAAAAAACCGGAAGCCCCACGTGCAAAAG
>TTN-216,ENSE00004025966,1,84,594746,594829,TGCCTGAAGCTGCTCAAGAAGTTGTCCCAGAAAAGAAAATTCCCAAGGCACCAATCAAAAAACCAGAAGCCCCCGCAGTTACAG
>TTN-216,ENSE00004025973,1,81,594830,594910,TGCCAGAAGTTCCTCAAGAAGCCGCAGAAAAAGAAATTCCCGTGGCTCCACCCAAAAAACCAGAAGCTCCGATTGTCCCAG
>TTN-216,ENSE00004025979,1,81,594911,594991,TGCCTGAAGCTCAAGAAGTTGTCCCAGAAAAGAAAGTTCCTAAGGCTCCTCCCACAAAACCAGAAGCCCCACCTGCCACAG
>TTN-216,ENSE00004025981,1,81,594992,595072,TGCCTGAAGTCCCACAAGAAATTGTGCCAGAAAAGAAAACACTGGTGCTTCCTAAAAAGCCAGAAGTTCCACCTGTTACAG
>TTN-216,ENSE00004025970,1,84,595073,595156,TGCCAGAGGCTCCCAAAGAAGTTGTCCTTGAAAAGAAAGTGCCCTCGACTCCTCCTAAAAAGCCTGAAGTCCCACCTGTTAAAG
>TTN-216,ENSE00004025993,1,84,595157,595240,TGCCTGAGGCTCCCAAAGAAGTTGTTCCTGAAAAGAAAGTGCCAGTGCCTCCTCCTAAAAAGCCTGAAGTGCCACCCACAAAAG
>TTN-216,ENSE00004025989,1,84,595241,595324,TCCCAGAGGTGCCAAAGGCAGCTGTCCCAGAAAAGAAGGTGCCTGAAGCTATTCCTCCCAAACCGGAAAGTCCTCCCCCTGAAG
>TTN-216,ENSE00004025987,1,90,595325,595414,TGCCTGAAGTGCTGCCACCGAAGGAAGTGGTCCCAGAAAAGAAAGTACCGGTGCCTCCTGCCAAAAAGCCAGAAGCTCCACCTCCTAAAG
>TTN-216,ENSE00004025975,1,84,595415,595498,TTCCTGAAGCTCCTAAAGAAGTTGTACTTGAAAAGAAAGTATCTGTGGCTGTGCCCAAAAAACCGGAAGCCCCACGTGCAAAAG
>TTN-216,ENSE00004026003,1,84,595499,595582,TGCCTGAAGCTGCTCAAGAAGTTGTCCCAGAAAAGAAAATTCCCAAGGCACCAATCAAAAAACCAGAAGCCCCCGCAGTTACAG
>TTN-216,ENSE00004025980,1,81,595583,595663,TGCCAGAAGTTCCTCAAGAAGCCGCAGAAAAAGAAATTCCCGTGGCTCCACCCAAAAAACCAGAAGCTCCAATTGTCCCAG
>TTN-216,ENSE00004025994,1,81,595664,595744,TGCCTGAAGCTCAAGAAGTTGTCCCAGAAAAGAAAGTTCCTAAGGCTCCTCCCACAAAACCAGAAGCCCCACCTGCCACAG
>TTN-216,ENSE00004025996,1,81,595745,595825,TGCCTGAAGTCCCACAAGAAATTGTGCCAGAAAAGAAAACACTGGTGCTTCCTAAAAAGCCAGAAGTTCCACCTGTTACAG
>TTN-216,ENSE00004025990,1,84,595826,595909,TGCCAGAGGCTCCCAAAGAAGTTGTCCTTGAAAAGAAAGTGCCCTTGGCTCCTCCTAAAAAGCCTGAAGTCCCACCTGTTAAAG
>TTN-216,ENSE00004026004,1,84,595910,595993,TGCCAGAGGCTCCCAAAGAAGTTGTTCCTGAAAAGAAAGTGCCAGTGACTCCTCCTAAAAAACCTGAAGTCCCACCTGTTAAAG
>TTN-216,ENSE00004025977,1,84,595994,596077,TGCCAGAGGCTCCCATAGAGGTTGTTCCTGAAAAGAAAATGCCCTTGGCTCCTCCTAAAAAGCCTGAAGTCCCTCCTGTTAAAG
>TTN-216,ENSE00004025991,1,84,596078,596161,TACCAGAGGCTCCCAAAGAGGTTGTTCCTGAAAAGAAAGTGCCCTCGGCTCCTCCTAAAAAGCCTGAAGTCCCACCTGTTAAAG
>TTN-216,ENSE00003806373,1,84,596162,596245,TGCCAGAGGCTCCGAAAGAAGTTGTTCCTGAAAAGAAAGTGCCAGCGGCTCCTCCTAAAAAGCCTGAAGTCACACCTGTTAAAG
>TTN-216,ENSE00003807489,1,84,596246,596329,TGCCTGAGGCTCCCAAAGAAGTTGTTCCTGAAAAGAAAGTGCCAGTGCCTCCTCCTAAAAAGCCTGAAGTGCCACCCACAAAAG
>TTN-216,ENSE00003805050,1,84,596330,596413,TCCCAGAGGTGCCAAAGGTAGCTGTCCCAGAAAAGAAGGTGCCTGAAGCTATTCCTCCCAAACCGGAAAGTCCTCCCCCTGAAG
>TTN-216,ENSE00003808824,1,84,596414,596497,TGTTCGAGGAGCCTGAGGAAGTTGCCCTAGAAGAGCCTCCTGCTGAAGTTGTGGAAGAGCCAGAGCCAGCGGCGCCTCCACAAG
>TTN-216,ENSE00003807203,1,84,596498,596581,TGACCGTACCACCTAAGAAACCTGTCCCAGAAAAGAAAGCACCTGCTGTCGTTGCCAAAAAACCTGAACTACCACCAGTGAAAG
>TTN-216,ENSE00003811260,1,84,596582,596665,TGCCCGAGGTGCCCAAGGAGGTTGTTCCTGAAAAGAAGGTGCCTCTGGTGGTTCCCAAAAAGCCAGAAGCCCCACCTGCTAAAG
>TTN-216,ENSE00003806229,1,78,596666,596743,TGCCTGAAGTTCCAAAAGAAGTTGTTCCAGAAAAGAAAGTAGCTGTTCCCAAAAAGCCAGAAGTCCCACCAGCAAAAG
>TTN-216,ENSE00003807893,1,84,596744,596827,TGCCAGAAGTGCCAAAGAAACCTGTCTTGGAAGAGAAACCAGCTGTTCCTGTTCCAGAAAGAGCGGAGTCTCCTCCCCCAGAAG
>TTN-216,ENSE00003809515,1,108,596828,596935,TATATGAAGAACCTGAGGAAATTGCTCCTGAAGAGGAAATTGCTCCTGAAGAGGAAAAGCCAGTTCCTGTTGCAGAAGAGGAGGAACCAGAGGTTCCACCTCCAGCAG
>TTN-216,ENSE00003804845,1,78,596936,597013,TGCCTGAAGAGCCCAAGAAGATCATCCCAGAGAAGAAAGTTCCTGTCATCAAAAAACCAGAAGCACCGCCTCCTAAAG
>TTN-216,ENSE00004025992,1,78,597014,597091,AACCTGAGATGCCAAAGAAAGTTGTTCCAGTGAAGAAGGTCCCAACTGTTAAGAAGCCAGAAACACCAGCAGCTAAAG
>TTN-216,ENSE00004025972,1,84,597092,597175,TGCCTGAGGTGCCCAAGAAACTTGTTCCAGTAAAGAAAGAACCTGTGCCTGTTACCAAAAAACCAGAAGTTCTTCCAGAAAAAG
>TTN-216,ENSE00004025968,1,84,597176,597259,TGCCCAAAGTGCCTGAGAAAATCATCCCAGAAAAGGAAGTGTCTGTGCCTATCCCTGCAGAGCCAGAAGTTCCACCTGCTGAAG
>TTN-216,ENSE00004025985,1,81,597260,597340,TTGAAGAGACTCCTGAGGAAATAATATATGAAGAAAAAGCATCTATAACCATTGGTAGAAAAGAGACTCCCCCTGTTGAAG
>TTN-216,ENSE00004025999,1,75,597341,597415,AACGTGAAATTGAAAAGTATATTAAACCTGAAGAGCCCGAACCTGAACCACAGCCTGAAGAAATACCAGTAAAAG
>TTN-216,ENSE00003806702,1,111,597416,597526,AACCTGAACCTGAAAAGGTTATTGAGAAGCCAAAACTCAAACCAAGACCCCCACCTCCTCCACCTGCTCCACCTAAGGAAGATGTGAAGGAGAAAATATTCCAACTTAAAG
>TTN-216,ENSE00003809179,1,69,597527,597595,CTATTCCAAAGAAGAAAGTTCCTGAAAAACCTCAGGTTCCAGAAAAAGTGGAGCTTACACCTCTGAAAG
>TTN-216,ENSE00003804802,1,81,597596,597676,TGCCTGGAGGTGAAAAGAAAGTTCGCAAATTACTTCCGGAACGTAAACCTGAACCAAAGGAAGAAGTTGTTCTGAAAAGCG
>TTN-216,ENSE00003811452,1,75,597677,597751,TTCTAAGAAAAAGACCTGAAGAAGAAGAACCTAAAGTAGAACCTAAAAAACTAGAAAAAGTTAAAAAACCTGCAG
>TTN-216,ENSE00003807205,1,90,597752,597841,TACCAGAACCACCACCTCCAAAACCTGTTGAAGAGGTTGAAGTACCTACTGTTACAAAAAGGGAAAGGAAGATTCCTGAACCAACAAAAG
>TTN-216,ENSE00003806747,1,63,597842,597904,TGCCTGAAATCAAGCCAGCAATACCTCTCCCTGCACCTGAACCGAAACCAAAGCCCGAAGCAG
>TTN-216,ENSE00003810755,1,90,597905,597994,AAGTGAAAACAATCAAACCACCTCCTGTGGAACCTGAACCAACCCCCATCGCTGCCCCAGTAACAGTGCCAGTGGTTGGAAAGAAAGCAG
>TTN-216,ENSE00003806122,1,51,597995,598045,AAGCCAAAGCACCTAAGGAAGAGGCTGCCAAGCCAAAAGGTCCTATCAAAG
>TTN-216,ENSE00003804858,1,402,598046,598447,GTGTACCCAAAAAGACTCCTTCACCAATAGAAGCCGAAAGGAGAAAGTTAAGGCCAGGAAGTGGTGGAGAGAAACCTCCTGATGAAGCCCCGTTCACCTACCAGCTAAAGGCTGTGCCACTGAAGTTTGTGAAAGAAATCAAAGACATCATCTTGACAGAATCAGAGTTCGTTGGCTCTTCAGCAATCTTTGAATGTTTGGTCTCCCCTTCCACTGCAATTACAACCTGGATGAAAGACGGTAGCAATATCCGTGAGAGTCCCAAGCACAGGTTTATTGCAGATGGTAAAGACAGAAAGCTGCACATCATTGATGTTCAACTTTCCGATGCTGGTGAATACACCTGTGTTTTACGTTTGGGAAACAAAGAAAAGACCTCCACGGCTAAACTTGTTGTAGAAG
>TTN-216,ENSE00003803996,1,279,598448,598726,AACTTCCTGTGCGTTTTGTAAAAACACTGGAAGAGGAAGTCACAGTGGTCAAAGGACAGCCATTGTACTTGAGCTGCGAGTTAAACAAAGAGCGTGACGTGGTCTGGAGGAAGGATGGCAAGATTGTGGTGGAGAAACCTGGCCGAATTGTGCCAGGCGTCATTGGCTTGATGCGGGCTCTGACCATCAACGATGCAGATGACACAGATGCTGGAACATACACAGTTACTGTGGAAAACGCCAACAACCTGGAGTGTTCATCTTGCGTAAAAGTAGTAG
>TTN-216,ENSE00003807976,1,276,598727,599002,AAGTCATTAGAGATTGGCTGGTGAAACCTATACGAGACCAGCATGTGAAACCCAAGGGGACAGCTATTTTTGCCTGTGATATAGCAAAAGATACTCCAAACATTAAGTGGTTCAAAGGATATGATGAAATCCCTGCGGAACCAAATGATAAGACTGAAATACTGAGAGATGGAAATCATCTGTACCTCAAAATTAAGAATGCTATGCCAGAAGATATTGCTGAGTATGCAGTGGAAATTGAAGGAAAAAGATACCCTGCAAAGCTGACACTTGGAG
>TTN-216,ENSE00003804328,1,140,599003,599142,AGCGTGAAGTTGAACTGCTTAAACCAATAGAGGACGTTACCATTTATGAGAAAGAAAGTGCAAGCTTTGATGCAGAAATCTCAGAGGCAGACATTCCTGGACAATGGAAACTGAAAGGAGAACTTCTAAGGCCCTCACCT
>TTN-216,ENSE00003802254,1,127,599143,599269,ACTTGTGAAATCAAAGCAGAAGGTGGAAAACGCTTCTTAACTTTGCACAAAGTCAAACTGGACCAAGCTGGTGAAGTCCTCTACCAGGCCCTTAATGCAATTACAACTGCCATTTTGACAGTAAAAG
>TTN-216,ENSE00003811410,1,264,599270,599533,AAATCGAACTTGACTTTGCTGTGCCCCTGAAGGATGTCACTGTTCCAGAAAGGCGACAGGCTCGATTCGAATGTGTCCTCACCCGAGAGGCAAATGTTATATGGTCCAAAGGACCTGATATAATTAAGTCATCTGACAAATTTGATATCATCGCTGATGGAAAGAAACATATTCTTGTTATTAATGATTCTCAATTTGATGATGAAGGGGTCTATACTGCTGAGGTGGAGGGCAAGAAGACCTCAGCTCGGTTGTTTGTCACAG
>TTN-216,ENSE00003805150,1,267,599534,599800,GTATAAGACTGAAATTCATGTCACCTCTTGAAGATCAAACAGTAAAAGAAGGTGAAACAGCAACTTTTGTTTGTGAACTTTCTCATGAAAAAATGCATGTAGTCTGGTTCAAAAATGATGCCAAACTCCATACAAGCAGAACAGTACTCATCTCTTCTGAGGGCAAGACTCACAAATTGGAAATGAAAGAAGTGACATTGGATGATATATCTCAGATAAAAGCTCAAGTCAAGGAGCTGAGCTCCACAGCACAGCTGAAGGTCTTAG
>TTN-216,ENSE00003801907,1,264,599801,600064,AGGCCGATCCCTACTTCACTGTGAAATTACATGACAAAACTGCAGTGGAGAAGGATGAGATTACTTTGAAGTGTGAAGTGAGCAAAGATGTACCAGTGAAATGGTTCAAAGATGGTGAAGAGATTGTCCCTTCACCCAAATATTCTATCAAGGCAGATGGCCTGCGCCGCATCTTAAAAATCAAAAAGGCGGACCTTAAAGATAAAGGCGAATATGTGTGTGACTGTGGCACAGACAAGACCAAGGCAAATGTTACTGTTGAGG
>TTN-216,ENSE00003802031,1,140,600065,600204,CTCGACTAATAAAAGTGGAAAAGCCTCTGTACGGAGTAGAGGTGTTTGTTGGTGAAACAGCCCACTTTGAAATTGAACTTTCTGAACCTGATGTTCACGGCCAGTGGAAGCTGAAAGGACAGCCTTTGACAGCTTCCCCT
>TTN-216,ENSE00003811443,1,127,600205,600331,GACTGTGAAATCATTGAGGATGGAAAGAAGCATATTCTGATCCTTCATAACTGTCAGCTGGGTATGACAGGAGAGGTTTCCTTCCAGGCTGCTAATGCCAAATCTGCAGCCAATCTGAAAGTGAAAG
>TTN-216,ENSE00003811384,1,267,600332,600598,AATTGCCTCTTATCTTCATCACACCTCTCAGTGATGTTAAAGTCTTCGAGAAAGATGAGGCTAAGTTTGAGTGTGAAGTATCCAGGGAGCCCAAAACATTCCGTTGGCTAAAAGGAACCCAGGAAATCACAGGTGATGACAGATTTGAGCTTATAAAGGATGGCACTAAGCATTCAATGGTGATCAAGTCAGCTGCTTTTGAAGATGAAGCAAAATACATGTTTGAAGCTGAAGATAAGCACACAAGTGGCAAACTGATCATTGAAG
>TTN-216,ENSE00003801954,1,267,600599,600865,GAATCCGGCTCAAATTCCTCACCCCTCTCAAAGATGTAACTGCCAAAGAGAAGGAAAGTGCTGTATTTACTGTGGAGTTATCTCATGATAACATCCGAGTTAAATGGTTCAAGAATGACCAGCGCCTACACACCACCAGGTCGGTCTCAATGCAAGACGAAGGGAAAACTCATTCGATCACATTCAAAGACCTGTCTATTGATGACACCTCCCAAATTAGAGTAGAAGCTATGGGGATGAGTTCAGAAGCTAAACTCACTGTGCTTG
>TTN-216,ENSE00003809996,1,267,600866,601132,AGGGAGACCCATATTTTACAGGAAAACTTCAAGATTATACTGGTGTAGAGAAAGATGAAGTTATTCTACAGTGTGAAATTAGCAAAGCAGATGCACCAGTGAAATGGTTTAAGGATGGGAAGGAAATAAAGCCATCCAAAAATGCTGTTATTAAGGCAGATGGCAAGAAACGCATGCTAATCCTAAAGAAAGCCTTGAAATCAGATATTGGACAGTACACCTGTGACTGTGGGACAGATAAGACCTCAGGAAAACTTGACATTGAGG
>TTN-216,ENSE00003804589,1,140,601133,601272,ATCGGGAAATTAAACTGGTGCGACCCCTGCACAGTGTGGAGGTGATGGAGACTGAGACAGCACGCTTTGAAACCGAAATCTCTGAAGATGATATCCACGCCAACTGGAAACTCAAGGGAGAGGCCCTACTCCAAACACCT
>TTN-216,ENSE00003805931,1,127,601273,601399,GATTGTGAAATTAAGGAAGAAGGCAAAATACACTCCCTTGTTTTGCACAACTGTCGCCTGGACCAGACGGGTGGGGTGGATTTCCAAGCTGCCAATGTTAAATCTAGTGCCCACCTCCGAGTTAAGC
>TTN-216,ENSE00003811344,1,143,601400,601542,CACGAGTAATTGGTCTTCTGAGGCCTTTAAAGGATGTCACCGTGACTGCAGGGGAAACAGCCACCTTCGACTGCGAGCTCTCCTACGAAGATATCCCAGTGGAATGGTATCTCAAAGGGAAGAAACTAGAGCCCAGCGATAAG
>TTN-216,ENSE00003802375,1,124,601543,601666,GTGGTCCCACGTTCAGAAGGAAAAGTTCATACACTTACTCTGAGGGATGTAAAGTTAGAAGATGCTGGGGAAGTCCAACTAACAGCAAAAGATTTCAAAACTCACGCCAACCTCTTTGTGAAAG
>TTN-216,ENSE00003806733,1,267,601667,601933,AACCCCCAGTTGAATTCACTAAGCCTCTTGAGGACCAGACGGTCGAAGAGGGAGCCACTGCAGTGCTGGAGTGTGAAGTCTCCAGAGAAAATGCTAAGGTGAAATGGTTCAAAAATGGGACAGAAATCCTCAAAAGCAAGAAGTATGAAATTGTTGCTGATGGCAGGGTCAGAAAACTTGTTATACATGACTGTACCCCAGAGGATATTAAAACATACACTTGTGATGCTAAGGATTTTAAGACTTCCTGTAACCTGAATGTCGTGC
>TTN-216,ENSE00003807497,1,98,601934,602031,CTCCTCATGTGGAATTCTTAAGACCACTCACCGACCTTCAAGTTAGAGAAAAAGAAATGGCTCGATTTGAGTGTGAACTTTCCCGAGAAAATGCTAAG
>TTN-216,ENSE00003802530,1,169,602032,602200,GTTAAGTGGTTTAAAGATGGTGCTGAAATTAAAAAGGGCAAAAAATATGACATCATATCCAAGGGAGCAGTGCGCATTCTTGTCATCAACAAATGTCTACTGGATGATGAAGCTGAATATTCCTGTGAAGTAAGGACAGCGAGAACTTCTGGCATGCTGACAGTTCTGG
>TTN-216,ENSE00003811387,1,267,602201,602467,AAGAAGAAGCTGTCTTTACCAAAAATCTTGCCAACATTGAAGTTAGTGAAACAGACACTATAAAACTGGTTTGTGAAGTCTCCAAACCTGGCGCAGAAGTGATTTGGTATAAAGGGGATGAGGAGATCATTGAAACAGGAAGATATGAAATACTGACTGAAGGACGGAAGAGAATCCTGGTCATTCAGAACGCTCACCTTGAGGATGCTGGCAACTACAACTGTCGACTCCCAAGCTCTCGAACCGATGGCAAAGTCAAAGTACATG
>TTN-216,ENSE00003802653,1,267,602468,602734,AACTGGCTGCTGAATTTATCTCAAAGCCTCAAAACCTTGAAATACTTGAAGGAGAAAAGGCTGAATTTGTCTGCTCTATATCAAAAGAAAGCTTTCCAGTCCAGTGGAAGAGGGATGATAAGACACTTGAATCTGGAGATAAATATGACGTTATTGCTGATGGTAAAAAGAGGGTCCTAGTTGTGAAAGATGCCACATTACAAGATATGGGCACTTACGTTGTCATGGTAGGGGCCGCCAGAGCAGCAGCTCACTTGACAGTCATTG
>TTN-216,ENSE00003802540,1,279,602735,603013,AAAAACTCAGGATCGTAGTTCCTCTTAAGGACACCCGGGTGAAGGAACAACAGGAAGTTGTCTTCAACTGTGAAGTCAATACTGAAGGTGCCAAAGCCAAATGGTTCAGAAATGAAGAAGCTATATTTGATAGTTCAAAATACATCATTCTCCAAAAAGACCTAGTCTACACCCTCAGAATTAGAGATGCACACTTAGATGACCAAGCCAACTATAATGTGTCTTTGACCAATCACAGAGGTGAAAATGTTAAAAGTGCAGCCAATCTAATAGTAGAAG
>TTN-216,ENSE00003802874,1,409,603014,603422,AGGAAGACCTTAGGATTGTTGAGCCTCTTAAAGATATTGAAACAATGGAGAAGAAATCTGTCACATTCTGGTGCAAGGTGAATCGTCTCAATGTAACACTGAAGTGGACCAAAAATGGTGAAGAAGTGCCTTTTGACAACCGTGTCTCATACAGAGTTGATAAGTACAAGCACATGTTAACCATTAAAGACTGTGGCTTCCCAGATGAAGGTGAATACATTGTCACTGCTGGACAAGATAAATCTGTTGCTGAGCTTCTCATCATAGAAGCCCCGACAGAATTTGTGGAACACTTGGAAGATCAGACAGTCACTGAGTTCGATGACGCTGTCTTCTCCTGCCAGCTCTCCAGAGAGAAAGCCAATGTAAAATGGTACAGAAATGGGAGAGAAATCAAAGAAGGCAAAAA
>TTN-216,ENSE00003804130,1,125,603423,603547,ATACAAATTTGAAAAAGATGGAAGTATACACAGACTCATTATAAAAGATTGCAGGCTGGATGATGAGTGTGAATATGCTTGCGGGGTAGAAGACAGGAAGTCTCGTGCTAGACTTTTTGTGGAAG
>TTN-216,ENSE00003807647,1,267,603548,603814,AAATTCCTGTTGAGATCATCAGGCCTCCACAAGATATTCTTGAAGCCCCTGGTGCTGATGTTGTCTTTTTAGCAGAACTCAATAAAGATAAGGTGGAAGTCCAATGGCTAAGAAATAACATGGTTGTTGTCCAGGGTGATAAACACCAGATGATGAGTGAAGGAAAGATACATCGACTACAGATTTGTGATATTAAGCCCCGTGACCAGGGTGAATACAGATTTATTGCCAAAGACAAAGAAGCCAGAGCTAAGCTTGAACTGGCAG
>TTN-216,ENSE00003802353,1,270,603815,604084,CTGCACCAAAAATCAAGACAGCTGACCAAGACCTTGTGGTTGATGTTGGCAAGCCTCTGACAATGGTGGTGCCATATGATGCCTACCCCAAAGCAGAAGCTGAATGGTTTAAAGAAAATGAACCTTTATCTACAAAAACCATTGATACTACGGCTGAACAAACTTCTTTCAGAATTTTAGAAGCCAAGAAAGGAGACAAAGGGAGGTATAAAATTGTGCTTCAGAACAAACATGGAAAAGCAGAAGGATTCATCAATTTAAAAGTTATTG
>TTN-216,ENSE00003809195,1,303,604085,604387,ATGTTCCTGGGCCAGTACGTAACTTAGAAGTGACAGAAACATTTGATGGTGAAGTGAGCCTTGCTTGGGAAGAACCTTTAACTGATGGTGGAAGCAAAATCATAGGTTACGTTGTTGAAAGACGTGACATTAAGAGAAAGACCTGGGTTCTGGCCACAGACCGTGCAGAGAGTTGTGAGTTTACTGTCACTGGTCTACAGAAAGGAGGAGTTGAGTACCTATTCCGTGTGAGTGCAAGAAACAGAGTTGGCACTGGTGAGCCAGTAGAAACTGACAATCCTGTAGAAGCAAGGAGTAAATATG
>TTN-216,ENSE00003803170,1,303,604388,604690,ATGTTCCAGGCCCTCCTTTGAATGTAACCATCACTGATGTGAATCGATTTGGTGTCTCACTGACATGGGAACCACCAGAGTATGATGGAGGTGCTGAGATCACAAACTACGTCATTGAATTAAGAGACAAGACTTCTATCAGGTGGGATACTGCCATGACTGTGAGAGCTGAAGACCTGTCTGCAACTGTTACTGATGTGGTAGAAGGACAGGAGTACAGTTTCCGAGTGAGAGCCCAAAATCGAATTGGAGTTGGAAAACCAAGTGCAGCCACACCCTTCGTCAAAGTTGCTGATCCAATTG
>TTN-216,ENSE00003806295,1,188,604691,604878,AGAGACCAAGTCCTCCTGTAAACCTAACTTCCTCAGATCAGACTCAGTCATCAGTTCAGCTCAAATGGGAACCTCCTCTGAAAGATGGAGGAAGCCCAATATTAGGCTATATAATTGAGCGATGCGAAGAAGGAAAAGATAATTGGATTCGTTGCAATATGAAACTTGTCCCTGAACTGACTTACAAG
>TTN-216,ENSE00003810732,1,115,604879,604993,GTTACCGGATTGGAAAAAGGAAATAAATATTTATATAGAGTATCTGCAGAAAATAAAGCTGGTGTTTCAGATCCATCTGAAATTCTTGGTCCTCTCACCGCTGACGATGCATTTG
>TTN-216,ENSE00003809985,1,285,604994,605278,TTGAACCAACAATGGATTTAAGTGCATTTAAAGATGGTCTGGAAGTTATTGTCCCAAATCCTATCACGATCCTGGTTCCAAGTACAGGCTATCCAAGGCCAACTGCAACCTGGTGTTTTGGAGATAAAGTACTAGAAACAGGGGACCGGGTGAAAATGAAGACCTTGTCTGCCTATGCCGAACTTGTCATTTCTCCAAGTGAACGTTCAGACAAGGGCATTTATACACTGAAATTAGAAAACCGTGTGAAAACAATTTCTGGGGAAATTGATGTCAATGTAATTG
>TTN-216,ENSE00003808828,1,152,605279,605430,CTCGCCCAAGTGCACCCAAAGAATTGAAATTTGGTGATATAACCAAGGACTCAGTACATTTGACTTGGGAACCACCTGATGATGATGGAGGAAGTCCGTTAACTGGATACGTTGTTGAAAAACGAGAAGTCAGCCGGAAAACATGGACTAAA
>TTN-216,ENSE00003803811,1,148,605431,605578,GTTATGGACTTTGTGACTGATCTAGAATTCACAGTTCCTGATCTTGTTCAAGGAAAAGAGTACTTATTTAAAGTTTGTGCTCGTAACAAATGTGGCCCTGGAGAACCTGCATATGTTGATGAACCTGTAAATATGTCAACTCCTGCAA
>TTN-216,ENSE00003803944,1,178,605579,605756,CGGTACCTGACCCACCAGAGAATGTTAAATGGAGAGATCGAACAGCCAATAGCATCTTCTTAACATGGGATCCACCTAAAAATGATGGTGGTTCACGCATCAAAGGATATATAGTTGAAAGATGTCCACGTGGTTCTGATAAATGGGTTGCCTGTGGAGAACCTGTTGCAGAAACAAA
>TTN-216,ENSE00003802090,1,122,605757,605878,AATGGAAGTGACAGGTCTTGAGGAAGGCAAATGGTATGCCTACCGCGTGAAGGCCTTAAACAGGCAGGGTGCTAGCAAACCAAGCAGACCCACAGAGGAAATCCAGGCTGTGGACACACAAG
>TTN-216,ENSE00003809522,1,288,605879,606166,AGGCCCCAGAAATCTTCCTCGATGTGAAGCTCCTTGCTGGTCTCACTGTAAAAGCTGGGACCAAGATTGAACTTCCTGCCACCGTAACCGGAAAACCTGAACCTAAAATAACTTGGACAAAGGCTGATATGATTCTGAAGCAGGACAAAAGAATTACCATTGAAAATGTCCCTAAGAAATCCACAGTGACTATTGTTGATAGTAAGAGAAGTGACACTGGCACATATATCATTGAGGCTGTGAATGTGTGTGGCCGGGCCACTGCTGTGGTGGAAGTGAACGTCTTAG
>TTN-216,ENSE00003804879,1,297,606167,606463,ATAAACCCGGACCACCAGCTGCCTTTGACATCACAGATGTAACCAATGAGTCATGTCTTCTAACATGGAACCCACCACGCGATGATGGTGGATCTAAGATCACAAACTATGTTGTGGAGAGACGAGCAACTGATAGTGAAGTGTGGCACAAGCTCTCATCCACCGTCAAGGATACAAACTTCAAGGCCACCAAATTAATCCCCAATAAAGAGTACATCTTCAGAGTTGCTGCAGAAAACATGTATGGTGTTGGTGAACCAGTTCAGGCCTCTCCAATAACAGCCAAATATCAGTTTG
>TTN-216,ENSE00003809410,1,187,606464,606650,ATCCACCTGGTCCTCCAACTCGCCTAGAACCTTCTGATATCACTAAAGACGCAGTGACTCTCACATGGTGTGAGCCAGATGATGATGGTGGCAGCCCAATCACAGGATACTGGGTTGAAAGACTGGATCCTGATACAGATAAATGGGTTAGATGCAATAAGATGCCAGTAAAGGACACAACATACAG
>TTN-216,ENSE00003808827,1,116,606651,606766,AGTGAAAGGTCTCACTAATAAGAAAAAATACAGATTCCGTGTGTTGGCTGAAAATCTTGCTGGACCTGGAAAACCAAGCAAATCAACTGAACCAATCTTAATAAAGGATCCCATAG
>TTN-216,ENSE00003806136,1,300,606767,607066,ATCCTCCATGGCCCCCTGGAAAACCAACTGTAAAAGATGTAGGCAAAACATCAGTAAGGTTGAATTGGACAAAACCAGAACATGATGGAGGTGCAAAGATTGAGTCTTATGTCATTGAAATGCTGAAGACTGGAACAGATGAGTGGGTCAGAGTGGCGGAAGGGGTTCCCACCACTCAGCACTTGCTCCCAGGGCTCATGGAAGGACAGGAATACTCATTCCGAGTTAGAGCTGTGAATAAGGCTGGGGAAAGTGAACCCAGTGAACCCAGTGACCCTGTGCTTTGCCGGGAGAAGCTAT
>TTN-216,ENSE00003804290,1,300,607067,607366,ATCCTCCATCACCACCACGCTGGCTTGAAGTTATTAATATCACAAAAAATACAGCAGACCTAAAATGGACAGTTCCTGAGAAAGATGGAGGGTCCCCCATCACCAACTACATTGTGGAAAAGAGAGACGTCAGGCGAAAAGGCTGGCAAACAGTGGATACCACTGTCAAGGACACCAAGTGCACAGTCACCCCACTGACTGAGGGCTCTTTATATGTGTTCCGAGTTGCTGCAGAAAATGCTATAGGACAAAGCGACTACACCGAAATTGAGGACTCTGTGCTGGCCAAAGACACCTTTA
>TTN-216,ENSE00003803723,1,106,607367,607472,CCACTCCTGGACCACCCTACGCCCTGGCAGTGGTTGATGTGACAAAACGACATGTTGACCTAAAGTGGGAGCCACCTAAAAATGATGGTGGAAGACCAATACAGAG
>TTN-216,ENSE00003805819,1,197,607473,607669,ATATGTCATTGAGAAGAAAGAAAGGTTAGGTACCCGTTGGGTGAAAGCTGGAAAGACTGCAGGACCTGACTGTAACTTCAGAGTAACTGATGTCATCGAAGGAACAGAGGTCCAGTTTCAGGTTCGGGCTGAAAATGAAGCTGGAGTTGGCCACCCAAGTGAACCCACAGAAATCCTATCCATTGAAGATCCAACAA
>TTN-216,ENSE00003806467,1,306,607670,607975,GTCCTCCCTCACCACCCCTTGACCTACATGTGACTGATGCTGGGAGAAAACACATTGCCATTGCTTGGAAGCCTCCAGAGAAAAATGGTGGAAGTCCTATCATAGGATACCATGTTGAAATGTGTCCAGTAGGCACTGAGAAATGGATGAGAGTTAATTCTCGCCCAATAAAGGACTTGAAATTCAAGGTTGAAGAAGGTGTTGTTCCTGACAAAGAATATGTCCTGAGAGTGAGAGCAGTCAATGCTATTGGTGTCAGCGAGCCATCTGAAATCTCTGAAAATGTGGTTGCCAAAGACCCAGACT
>TTN-216,ENSE00003808061,1,279,607976,608254,GCAAGCCAACAATTGACCTGGAGACTCATGACATTATTGTTATTGAAGGTGAAAAGTTAAGCATTCCTGTTCCCTTCAGAGCTGTCCCAGTTCCAACTGTTAGTTGGCATAAAGATGGCAAAGAAGTTAAAGCAAGTGATAGATTAACAATGAAGAATGATCACATCTCTGCACACCTTGAAGTTCCCAAGAGTGTCCGTGCAGATGCCGGAATTTATACCATTACACTGGAGAATAAGCTCGGCTCAGCAACAGCCTCAATCAATGTCAAAGTCATAG
>TTN-216,ENSE00003811164,1,300,608255,608554,GCCTACCTGGACCATGCAAAGATATTAAAGCAAGTGACATTACCAAGAGTTCTTGTAAGTTAACTTGGGAACCTCCAGAATTTGATGGTGGAACCCCAATTCTTCATTATGTCCTGGAGCGCAGAGAAGCTGGGAGGAGAACATATATACCAGTCATGTCTGGTGAGAACAAACTGTCATGGACTGTGAAGGATCTCATACCAAATGGTGAATACTTCTTCCGTGTTAAAGCAGTCAACAAGGTTGGTGGAGGAGAATATATTGAACTGAAAAATCCAGTCATTGCTCAAGATCCAAAGC
>TTN-216,ENSE00003805132,1,303,608555,608857,AACCCCCTGATCCACCTGTAGATGTAGAGGTTCATAATCCTACAGCGGAGGCAATGACTATTACATGGAAGCCACCTTTGTATGATGGAGGGAGCAAGATAATGGGCTACATCATAGAGAAGATTGCTAAGGGTGAAGAAAGGTGGAAGAGATGCAATGAACACCTGGTACCAATCCTGACCTATACAGCAAAAGGACTTGAAGAGGGGAAAGAGTACCAATTCCGTGTGCGAGCAGAGAACGCCGCGGGTATTAGTGAACCTTCTCGGGCTACTCCTCCAACCAAAGCTGTAGATCCCATTG
>TTN-216,ENSE00003805056,1,363,608858,609220,ATGCCCCCAAAGTCATTCTGAGAACAAGCCTAGAAGTGAAACGAGGTGATGAAATAGCACTTGATGCAAGTATTTCTGGATCACCTTACCCAACTATTACATGGATAAAGGATGAAAATGTTATTGTACCAGAGGAAATTAAGAAGCGTGCAGCACCCTTGGTTAGGAGAAGGAAGGGTGAAGTTCAAGAAGAAGAACCATTTGTCCTGCCTCTGACACAGCGTTTGAGTATTGACAACAGCAAAAAGGGAGAATCTCAGCTACGCGTCCGAGATTCTCTCCGACCTGACCATGGTCTGTATATGATCAAAGTTGAAAATGACCACGGTATTGCAAAAGCTCCTTGTACTGTCAGTGTGTTAG
>TTN-216,ENSE00003811138,1,303,609221,609523,ATACACCGGGACCACCAATCAACTTTGTATTTGAAGATATCAGAAAGACCTCAGTCCTTTGTAAATGGGAACCACCCCTTGATGATGGTGGCAGTGAAATCATAAACTACACTTTGGAAAAGAAAGACAAGACAAAACCCGACTCAGAATGGATTGTTGTCACTTCAACACTTAGACATTGCAAATATTCAGTAACAAAACTGATTGAAGGAAAAGAGTACCTCTTCCGTGTAAGAGCTGAAAACAGATTTGGGCCAGGTCCACCATGTGTTTCAAAGCCACTTGTGGCTAAAGATCCATTTG
>TTN-216,ENSE00003809346,1,300,609524,609823,GACCACCTGATGCACCAGATAAGCCCATTGTGGAAGATGTTACCAGCAACAGTATGCTAGTGAAATGGAATGAACCAAAAGATAATGGAAGCCCCATTTTGGGTTACTGGCTTGAAAAACGTGAAGTTAACAGTACACATTGGTCTCGTGTCAACAAAAGCCTTCTGAATGCCTTGAAAGCCAATGTAGATGGCTTATTAGAAGGACTCACCTATGTCTTCAGAGTATGTGCTGAAAATGCAGCTGGACCTGGAAAGTTCAGTCCACCTTCAGATCCCAAAACAGCACATGATCCAATCT
>TTN-216,ENSE00003806782,1,297,609824,610120,CTCCTCCTGGGCCACCTATCCCAAGAGTCACTGACACAAGCTCTACAACTATTGAACTAGAATGGGAACCCCCAGCTTTCAATGGTGGTGGGGAAATTGTTGGCTATTTTGTTGATAAGCAGTTGGTTGGCACAAATGAATGGTCACGCTGCACAGAGAAGATGATCAAGGTCCGTCAGTACACCGTCAAAGAAATCCGAGAGGGTGCTGATTACAAACTTCGGGTGAGTGCTGTCAATGCCGCAGGGGAAGGACCGCCTGGAGAAACACAACCTGTTACTGTGGCTGAACCACAAG
>TTN-216,ENSE00003804121,1,285,610121,610405,AGCCTCCAGCTGTGGAACTGGATGTTTCTGTCAAGGGTGGAATACAAATAATGGCTGGGAAGACTCTTAGAATTCCAGCTGTGGTGACTGGTCGCCCTGTACCTACAAAAGTATGGACCAAAGAAGAAGGGGAGCTGGATAAAGACCGTGTTGTAATAGACAACGTTGGAACCAAATCTGAACTAATTATCAAGGATGCACTGCGAAAAGACCATGGCAGATATGTGATTACAGCTACAAATAGCTGTGGTTCCAAATTTGCAGCAGCCAGGGTAGAAGTTTTTG
>TTN-216,ENSE00003804454,1,294,610406,610699,ATGTCCCTGGTCCAGTTCTTGACTTAAAACCTGTTGTAACAAACAGAAAAATGTGTCTACTTAACTGGTCTGATCCAGAAGATGATGGAGGAAGTGAAATAACAGGCTTTATCATTGAAAGAAAAGATGCCAAGATGCATACTTGGAGACAACCAATAGAGACTGAGAGATCTAAATGTGACATCACAGGTCTGCTTGAGGGACAAGAATATAAGTTCCGTGTTATTGCCAAGAACAAGTTTGGCTGTGGCCCTCCTGTTGAAATAGGACCAATTCTTGCAGTTGATCCACTAG
>TTN-216,ENSE00003803420,1,300,610700,610999,GTCCTCCAACATCTCCAGAGAGGCTCACATACACTGAAAGGACAAAGTCCACTATCACACTTGACTGGAAAGAGCCCCGCAGTAATGGTGGCAGTCCCATCCAAGGATATATCATTGAAAAACGGCGTCATGACAAACCTGACTTTGAAAGAGTTAACAAGCGACTCTGCCCAACCACATCTTTTCTGGTTGAAAATCTTGATGAACACCAAATGTATGAGTTCCGTGTCAAAGCTGTCAATGAAATTGGTGAAAGTGAACCATCCCTACCTCTTAATGTAGTCATACAAGATGATGAAG
>TTN-216,ENSE00003809028,1,309,611000,611308,TGCCTCCAACTATTAAGTTGCGTCTGAGTGTTCGAGGAGACACTATCAAAGTTAAGGCAGGAGAGCCTGTCCACATCCCTGCAGATGTGACAGGCCTTCCAATGCCTAAGATTGAATGGTCCAAAAATGAAACTGTAATTGAAAAACCCACTGATGCACTTCAGATAACCAAGGAAGAGGTATCCCGAAGTGAGGCAAAAACTGAGCTTAGCATTCCCAAAGCGGTCCGGGAGGACAAAGGCACTTACACAGTTACTGCTTCCAATCGCCTTGGCTCAGTGTTCCGAAATGTTCACGTTGAAGTATATG
>TTN-216,ENSE00003801894,1,191,611309,611499,ACCGCCCATCCCCACCAAGAAATCTTGCTGTTACTGACATTAAAGCTGAATCTTGCTACTTGACATGGGATGCCCCTCTTGATAATGGTGGCAGTGAAATCACCCATTATGTTATTGACAAACGTGATGCAAGTAGGAAGAAAGCAGAATGGGAGGAAGTCACCAACACTGCTGTAGAGAAAAGATATGGG
>TTN-216,ENSE00003809851,1,430,611500,611929,ATCTGGAAACTTATCCCCAATGGTCAGTATGAGTTCCGAGTCAGGGCAGTGAATAAATATGGAATCAGTGATGAGTGCAAATCAGATAAAGTAGTCATTCAAGATCCTTATCGCCTTCCTGGACCTCCAGGAAAACCAAAAGTTTTGGCACGCACCAAAGGATCAATGCTAGTGAGCTGGACTCCTCCTTTGGACAATGGTGGCTCTCCAATTACTGGCTACTGGCTGGAGAAAAGAGAAGAGGGAAGTCCTTATTGGTCACGTGTTAGCCGAGCACCAATAACCAAAGTGGGATTGAAAGGCGTGGAATTTAATGTTCCTCGTTTGCTTGAAGGCGTTAAATACCAGTTCAGAGCCATGGCAATAAATGCTGCAGGAATTGGTCCTCCCAGTGAACCATCAGATCCAGAGGTTGCAGGAGATCCCATAT
>TTN-216,ENSE00003808594,1,309,611930,612238,TTCCACCGGGGCCACCTTCTTGCCCAGAAGTTAAAGATAAAACGAAGTCAAGCATCTCACTAGGATGGAAACCTCCAGCCAAAGATGGTGGCAGCCCAATCAAAGGATACATTGTAGAAATGCAAGAAGAAGGTACTACTGACTGGAAAAGAGTAAATGAACCAGACAAACTTATAACTACCTGTGAATGTGTGGTGCCTAATCTGAAAGAGCTCAGGAAGTACAGATTCAGAGTGAAAGCTGTCAATGAAGCTGGTGAATCTGAACCAAGTGATACAACTGGGGAGATCCCTGCCACTGATATTCAAG
>TTN-216,ENSE00003810473,1,149,612239,612387,AGGAACCAGAAGTTTTCATTGACATTGGAGCACAGGACTGTCTGGTTTGTAAAGCTGGCTCACAGATTAGGATTCCTGCTGTCATCAAGGGACGCCCAACACCAAAATCATCTTGGGAATTTGATGGAAAGGCAAAGAAAGCAATGAAG
>TTN-216,ENSE00003801625,1,33,612388,612420,GATGGAGTTCATGACATACCCGAAGATGCACAG
>TTN-216,ENSE00003802643,1,130,612421,612550,CTGGAGACTGCTGAAAACTCCTCAGTAATTATTATTCCGGAGTGTAAACGATCTCATACAGGCAAATACAGCATCACAGCCAAGAATAAAGCAGGACAAAAGACTGCAAATTGCAGAGTTAAAGTCATGG
>TTN-216,ENSE00003804239,1,300,612551,612850,ATGTACCAGGCCCACCCAAAGATCTGAAAGTCAGTGATATCACAAGGGGTAGTTGCAGACTTTCATGGAAGATGCCAGACGACGATGGAGGAGACAGGATCAAAGGCTATGTTATTGAGAAGAGGACTATTGATGGAAAAGCCTGGACCAAAGTCAATCCAGACTGTGGAAGCACCACATTTGTAGTGCCTGATCTCCTCTCTGAACAGCAATATTTCTTCCGTGTGCGAGCAGAAAACCGTTTTGGTATTGGCCCACCTGTGGAAACCATTCAGAGGACCACTGCCAGAGATCCGATAT
>TTN-216,ENSE00003806278,1,318,612851,613168,ATCCTCCTGATCCTCCTATTAAACTCAAGATTGGCCTCATCACAAAGAACACAGTGCATCTGTCATGGAAACCCCCGAAGAATGATGGGGGCTCCCCTGTTACCCACTATATTGTTGAGTGCCTTGCATGGGACCCTACTGGGACAAAGAAAGAAGCCTGGAGGCAGTGCAATAAGCGTGATGTGGAAGAACTGCAATTTACTGTTGAAGACCTAGTAGAGGGTGGGGAATATGAATTCCGAGTCAAAGCTGTCAATGCTGCAGGAGTCAGCAAGCCTTCAGCCACTGTTGGCCCTGTGACTGTCAAAGACCAGACAT
>TTN-216,ENSE00003801391,1,297,613169,613465,GCCCACCATCAATTGATCTAAAAGAATTCATGGAGGTTGAAGAAGGAACCAATGTTAACATTGTGGCCAAAATTAAAGGTGTGCCATTCCCGACACTAACCTGGTTTAAAGCTCCTCCAAAGAAGCCTGATAACAAAGAACCTGTTCTCTATGACACCCATGTCAACAAACTGGTGGTAGATGATACTTGCACTTTAGTTATTCCGCAGTCTCGCAGGAGTGACACTGGCTTATATACCATCACAGCTGTAAATAATCTGGGAACAGCATCAAAGGAGATGAGACTGAATGTCCTGG
>TTN-216,ENSE00003806021,1,300,613466,613765,GTCGTCCTGGCCCTCCAGTGGGACCCATAAAATTTGAATCTGTTTCAGCAGATCAAATGACACTATCTTGGTTTCCACCTAAAGATGATGGTGGGTCTAAGATTACAAACTATGTAATTGAGAAAAGAGAAGCTAACAGGAAGACATGGGTCCATGTCTCCAGTGAACCTAAGGAGTGCACGTACACGATTCCCAAATTGCTAGAAGGCCATGAATATGTATTCCGAATCATGGCCCAGAATAAATATGGCATTGGAGAACCTCTTGACAGTGAACCTGAAACAGCAAGAAACCTCTTCT
>TTN-216,ENSE00003803442,1,315,613766,614080,CTGTCCCTGGAGCACCAGATAAACCAACAGTTAGCAGCGTGACTCGTAACTCCATGACTGTCAACTGGGAAGAGCCAGAATATGATGGAGGCTCTCCTGTGACAGGGTACTGGCTGGAAATGAAAGACACCACTTCAAAGAGATGGAAGAGAGTTAACCGAGATCCTATCAAAGCCATGACTTTGGGTGTTTCTTATAAAGTGACTGGTCTTATTGAAGGTTCCGACTATCAATTCCGGGTATATGCAATCAATGCTGCTGGCGTGGGTCCAGCAAGTCTGCCATCAGACCCAGCGACTGCTAGAGATCCAATTG
>TTN-216,ENSE00003801787,1,149,614081,614229,CCCCTCCTGGTCCTCCATTTCCCAAAGTGACAGATTGGACTAAATCATCTGCAGATCTGGAGTGGTCTCCCCCACTAAAAGATGGTGGATCCAAAGTAACTGGATACATCGTTGAATATAAAGAAGAAGGAAAAGAAGAATGGGAAAAG
>TTN-216,ENSE00003802004,1,151,614230,614380,GGTAAAGATAAAGAAGTGAGAGGAACAAAGCTTGTTGTGACAGGATTAAAGGAAGGAGCATTCTACAAATTTAGAGTTAGAGCAGTCAACATTGCTGGCATTGGAGAACCTGGAGAGGTCACAGATGTCATTGAAATGAAGGACAGACTTG
>TTN-216,ENSE00003808790,1,282,614381,614662,TTTCACCTGACCTTCAGCTAGATGCCAGTGTCAGAGATAGAATTGTTGTCCATGCTGGAGGGGTGATCCGAATCATTGCCTATGTGTCTGGAAAGCCTCCTCCAACCGTCACCTGGAACATGAATGAAAGAACCTTACCTCAAGAAGCCACCATTGAGACCACAGCCATTAGCTCATCCATGGTCATCAAGAACTGCCAGAGGAGCCATCAAGGCGTCTATTCTCTTCTTGCCAAAAATGAAGCCGGAGAAAGAAAGAAGACAATTATTGTTGATGTATTAG
>TTN-216,ENSE00003807896,1,303,614663,614965,ATGTTCCAGGTCCCGTTGGAACACCATTCCTAGCTCACAACCTAACCAATGAGTCCTGCAAACTGACATGGTTTTCTCCAGAAGATGATGGAGGCTCTCCAATCACCAATTATGTCATTGAAAAGCGTGAATCTGACCGCAGAGCATGGACCCCAGTGACATATACAGTTACCCGACAAAATGCTACTGTCCAGGGTCTCATTCAAGGAAAAGCCTACTTTTTCCGAATTGCGGCTGAAAATAGTATTGGCATGGGTCCATTTGTTGAGACATCAGAGGCACTTGTTATCAGAGAGCCAATAA
>TTN-216,ENSE00003801753,1,303,614966,615268,CTGTACCAGAGCGTCCTGAAGACCTGGAAGTCAAAGAAGTTACTAAAAATACTGTAACTTTGACTTGGAATCCTCCTAAGTATGATGGTGGGTCAGAAATTATTAACTATGTCCTAGAAAGTCGGCTCATTGGGACTGAGAAGTTCCACAAAGTTACAAATGACAACTTGCTTAGCAGAAAATACACTGTTAAAGGCTTAAAAGAAGGTGATACCTATGAGTACCGTGTCAGTGCTGTCAACATTGTTGGACAAGGCAAACCATCATTTTGCACCAAACCAATTACTTGCAAGGATGAGCTGG
>TTN-216,ENSE00003807039,1,282,615269,615550,CACCCCCAACGCTTCACCTCGACTTCAGAGATAAGCTCACGATTCGAGTTGGTGAAGCTTTTGCCCTCACTGGCCGTTACTCAGGCAAACCAAAGCCTAAGGTTTCCTGGTTCAAAGATGAAGCTGATGTGCTGGAAGATGATCGCACTCATATAAAGACTACACCAGCAACACTTGCTTTAGAGAAGATCAAGGCCAAACGTTCAGATTCCGGCAAATACTGTGTGGTTGTGGAGAACAGTACAGGCTCTAGGAAAGGTTTCTGTCAAGTTAATGTTGTTG
>TTN-216,ENSE00003804106,1,300,615551,615850,ACCGTCCTGGACCACCAGTAGGACCAGTTAGTTTTGATGAGGTGACCAAAGATTACATGGTTATCTCTTGGAAGCCTCCTTTAGATGATGGAGGCAGTAAAATCACCAATTATATTATTGAGAAGAAGGAAGTGGGTAAAGACGTCTGGATGCCAGTGACATCTGCAAGTGCTAAAACAACATGCAAAGTTTCTAAACTACTTGAAGGAAAAGATTATATTTTCCGGATACATGCTGAAAATCTGTATGGAATAAGTGATCCTCTGGTGTCTGATTCAATGAAAGCCAAAGATCGTTTCA
>TTN-216,ENSE00003801817,1,303,615851,616153,GGGTTCCTGATGCACCTGATCAGCCAATTGTTACAGAAGTTACCAAAGACTCTGCATTAGTAACCTGGAATAAGCCACATGATGGAGGAAAACCCATCACAAACTACATCCTGGAAAAGAGAGAAACTATGTCTAAACGATGGGCTAGAGTTACCAAAGATCCTATTCATCCATACACTAAATTTAGGGTTCCTGATCTTCTAGAAGGATGTCAGTATGAATTCCGGGTTTCTGCAGAAAATGAAATTGGTATTGGAGATCCAAGCCCACCATCCAAACCAGTCTTTGCTAAAGATCCAATTG
>TTN-216,ENSE00003810564,1,309,616154,616462,CTAAACCAAGTCCACCTGTTAATCCTGAAGCAATAGATACAACATGCAATTCAGTCGATCTAACTTGGCAGCCACCACGTCATGATGGTGGGAGCAAGATTCTGGGTTATATTGTTGAGTACCAGAAAGTTGGAGATGAAGAGTGGAGAAGAGCCAATCACACCCCTGAGTCATGTCCTGAAACTAAATATAAAGTCACCGGTCTTCGGGACGGTCAAACCTATAAGTTTAGAGTGTTAGCAGTCAATGCAGCTGGTGAATCAGATCCAGCTCATGTTCCGGAGCCAGTCCTAGTAAAAGACAGGCTTG
>TTN-216,ENSE00003807476,1,282,616463,616744,AACCCCCTGAGTTGATTCTTGATGCCAACATGGCAAGAGAACAACACATTAAAGTTGGTGATACTCTAAGACTTAGTGCCATCATCAAAGGAGTGCCATTCCCAAAAGTAACTTGGAAAAAAGAAGACAGAGATGCTCCAACTAAAGCAAGAATTGATGTGACTCCAGTTGGTAGCAAGCTTGAAATTCGTAATGCTGCCCATGAAGATGGTGGAATTTATTCTTTAACAGTGGAGAATCCAGCTGGTTCAAAAACTGTCTCAGTAAAAGTACTTGTATTAG
>TTN-216,ENSE00003807363,1,300,616745,617044,ATAAACCTGGGCCACCTAGAGATCTGGAAGTCAGTGAAATTAGGAAAGATTCATGTTACCTTACTTGGAAAGAACCACTGGATGATGGTGGTTCTGTTATTACCAATTATGTGGTTGAGAGGAGAGATGTTGCCAGCGCCCAGTGGTCACCTCTCTCAGCTACATCAAAGAAAAAGAGTCACTTCGCTAAGCATCTGAATGAAGGCAACCAGTACCTCTTCCGAGTAGCTGCGGAGAACCAGTATGGACGTGGTCCTTTTGTTGAAACACCAAAACCAATCAAGGCTTTGGATCCTCTCC
>TTN-216,ENSE00003808994,1,294,617045,617338,ATCCCCCAGGGCCACCCAAGGACCTGCACCATGTAGATGTTGACAAGACTGAAGTCTCCCTAGTCTGGAATAAGCCGGATCGTGATGGTGGTTCTCCAATCACTGGATATTTGGTAGAATATCAAGAAGAAGGCACCCAGGACTGGATTAAATTTAAGACTGTGACAAACTTAGAGTGTGTGGTTACTGGACTACAACAAGGAAAGACCTATAGATTCCGTGTAAAAGCTGAAAACATTGTGGGTCTTGGTCTCCCTGACACAACTATCCCGATAGAATGTCAAGAAAAACTAG
>TTN-216,ENSE00003810188,1,2967,617339,620305,TGCCTCCATCCGTGGAGCTAGATGTGAAATTAATTGAAGGTCTTGTGGTAAAGGCTGGAACCACAGTCAGATTCCCTGCTATTATAAGAGGTGTGCCTGTTCCTACTGCAAAGTGGACAACCGATGGGAGTGAGATTAAAACCGATGAGCACTACACAGTTGAAACAGACAACTTCTCATCAGTACTTACCATTAAGAACTGCTTAAGGAGAGACACTGGGGAATATCAAATCACAGTTTCCAATGCAGCCGGTAGCAAAACAGTAGCCGTACATCTTACTGTTCTTGATGTTCCTGGGCCACCAACAGGTCCTATTAATATTCTGGATGTTACTCCTGAACACATGACTATCTCATGGCAGCCACCTAAGGATGATGGAGGAAGCCCTGTGATAAATTATATTGTTGAGAAACAAGATACAAGGAAAGACACGTGGGGTGTTGTCTCTTCCGGAAGCAGTAAGACAAAGCTGAAAATCCCACATCTGCAGAAGGGCTGTGAATATGTTTTCCGAGTTAGAGCAGAGAATAAGATAGGTGTTGGTCCTCCCCTTGACTCCACACCTACTGTTGCTAAGCATAAATTTAGTCCTCCGTCTCCTCCTGGTAAACCAGTGGTTACTGACATTACTGAAAATGCAGCAACAGTGTCTTGGACCCTGCCAAAATCTGATGGTGGCAGTCCAATAACTGGCTACTATATGGAACGTCGAGAAGTAACTGGCAAATGGGTGAGGGTCAACAAAACACCTATCGCTGACCTGAAGTTCAGAGTGACTGGACTCTATGAAGGAAATACATATGAGTTTAGAGTTTTTGCTGAAAATCTTGCAGGACTAAGCAAACCATCCCCAAGTTCTGATCCAATAAAAGCTTGCCGGCCCATCAAACCACCTGGACCACCTATTAATCCTAAACTGAAAGACAAGAGCAGAGAAACAGCTGATTTGGTGTGGACAAAGCCTCTCAGTGATGGTGGTAGCCCCATTCTAGGATATGTAGTGGAATGTCAGAAACCTGGCACAGCACAATGGAACAGGATTAATAAAGATGAACTCATTAGGCAATGTGCCTTTAGGGTACCTGGACTAATTGAAGGAAATGAGTACAGATTCCGTATAAAGGCAGCTAATATTGTAGGAGAGGGTGAGCCAAGAGAACTAGCAGAATCTGTGATTGCAAAAGATATCCTTCATCCTCCAGAAGTAGAACTTGATGTTACTTGTCGTGATGTTATTACCGTGAGAGTAGGCCAAACTATCCGCATTCTAGCTCGAGTCAAAGGCAGACCTGAACCAGACATAACTTGGACTAAGGAAGGCAAAGTATTGGTCCGAGAAAAGAGGGTGGACCTTATTCAGGATCTACCTCGTGTTGAGTTACAAATTAAAGAAGCTGTTAGAGCTGATCATGGCAAGTATATCATCTCAGCTAAGAACAGCAGTGGACATGCCCAAGGTTCAGCCATCGTTAACGTCCTTGACAGACCTGGGCCTTGCCAGAATTTGAAGGTTACCAATGTAACCAAAGAGAACTGTACAATTTCTTGGGAAAACCCACTAGATAATGGTGGCTCAGAAATAACAAACTTCATAGTAGAATATCGCAAACCAAACCAGAAAGGCTGGTCAATTGTTGCATCAGATGTCACTAAACGATTAATCAAGGCCAACCTTTTAGCCAACAATGAATACTATTTCCGAGTTTGTGCAGAGAATAAAGTAGGTGTTGGGCCAACCATCGAAACAAAAACTCCCATTCTGGCTATTAACCCTATTGACAGACCAGGTGAGCCTGAAAACCTTCACATTGCAGATAAAGGAAAGACATTTGTCTATCTAAAGTGGCGGAGGCCTGACTATGATGGTGGCAGTCCAAATCTGTCATATCATGTTGAGAGAAGGCTTAAGGGCTCCGATGACTGGGAAAGAGTGCATAAAGGAAGCATTAAAGAAACTCACTACATGGTTGACAGATGTGTTGAAAACCAGATTTATGAGTTCAGAGTGCAAACAAAGAATGAAGGTGGGGAAAGTGACTGGGTGAAGACAGAGGAAGTTGTTGTGAAAGAAGACTTACAAAAACCAGTACTTGATCTGAAATTAAGTGGGGTCCTAACTGTCAAAGCAGGGGACACCATTAGGCTTGAGGCAGGGGTTAGAGGCAAACCATTCCCAGAAGTTGCATGGACCAAGGACAAAGACGCTACAGACTTAACAAGATCACCAAGGGTCAAGATTGATACCCGTGCTGATTCATCTAAATTTTCTCTTACTAAAGCAAAGCGAAGTGATGGGGGTAAATATGTAGTTACGGCAACTAACACGGCTGGCAGTTTTGTGGCCTATGCCACTGTCAATGTTTTAGATAAGCCTGGTCCTGTGAGAAATCTGAAAATTGTTGATGTGTCCAGTGATAGGTGTACTGTTTGCTGGGATCCACCAGAAGATGATGGTGGCTGTGAAATCCAAAATTATATTCTAGAAAAATGTGAGACAAAGCGAATGGTTTGGTCTACCTATTCTGCTACTGTCTTGACACCTGGTACTACAGTAACACGTCTCATAGAAGGAAATGAATATATTTTCAGAGTCCGTGCAGAAAATAAAATAGGCACAGGGCCTCCAACAGAAAGTAAACCAGTCATAGCCAAAACCAAGTATGATAAACCTGGTCGCCCTGATCCCCCAGAAGTCACTAAAGTAAGCAAAGAAGAGATGACTGTGGTTTGGAATCCACCTGAATATGATGGTGGAAAGTCTATAACTGGATACTTTTTGGAGAAAAAGGAAAAGCATTCAACACGATGGGTCCCTGTCAACAAGAGTGCAATCCCTGAGAGACGTATGAAAGTACAGAATCTCCTCCCAGACCATGAATATCAGTTCCGTGTCAAGGCAGAAAATGAAATTGGAATTGGAGAACCAAGCTTGCCTTCAAGACCGGTGGTGGCAAAAGACCCCATAG
>TTN-216,ENSE00003811401,1,321,620306,620626,AGCCACCTGGTCCACCAACCAATTTCAGAGTGGTTGATACAACCAAACATTCCATAACTCTTGGGTGGGGAAAACCAGTCTATGATGGTGGTGCACCGATCATTGGATATGTTGTGGAAATGAGACCAAAAATAGCAGATGCGTCTCCTGATGAAGGCTGGAAACGGTGTAATGCTGCAGCACAGCTTGTACGCAAGGAATTCACTGTTACCAGCTTGGATGAAAACCAGGAATATGAGTTCAGGGTGTGTGCCCAAAACCAAGTTGGTATTGGGCGCCCTGCAGAGCTAAAGGAAGCTATCAAACCTAAAGAAATACTAG
>TTN-216,ENSE00003805661,1,285,620627,620911,AACCTCCGGAGATTGATTTGGATGCCAGCATGAGGAAACTGGTCATAGTGAGAGCAGGATGCCCTATTCGTCTCTTTGCTATAGTGAGAGGACGACCAGCCCCTAAAGTCACTTGGCGAAAAGTTGGCATTGATAATGTGGTCAGAAAAGGACAAGTTGATCTGGTTGACACTATGGCCTTCCTTGTCATCCCCAATTCTACCCGTGATGACTCAGGAAAATATTCCTTAACACTTGTGAACCCAGCAGGAGAAAAGGCTGTATTCGTAAATGTCAGAGTATTAG
>TTN-216,ENSE00003804742,1,300,620912,621211,ACACTCCTGGGCCTGTGTCTGATTTAAAAGTTTCAGATGTCACTAAAACATCATGCCATGTGTCCTGGGCCCCTCCTGAAAACGACGGTGGGAGCCAAGTGACACATTATATCGTGGAGAAACGTGAGGCAGACAGAAAGACATGGTCGACCGTTACCCCAGAAGTTAAGAAAACAAGCTTCCATGTAACCAATCTTGTCCCTGGGAATGAGTATTACTTCAGAGTAACTGCTGTCAACGAATATGGCCCTGGCGTCCCAACAGATGTCCCAAAACCAGTGCTTGCATCAGATCCTCTAA
>TTN-216,ENSE00003810357,1,303,621212,621514,GTGAGCCGGATCCCCCAAGGAAATTAGAAGTGACTGAAATGACCAAGAACAGTGCCACCTTAGCCTGGTTACCTCCCCTACGTGATGGAGGTGCTAAAATCGATGGCTACATCACTAGTTACAGAGAAGAAGAGCAGCCTGCAGATCGCTGGACAGAGTACTCAGTGGTAAAAGATCTGAGCCTTGTTGTCACTGGCCTAAAGGAAGGAAAGAAATACAAATTTAGAGTAGCGGCCAGAAATGCTGTTGGAGTCAGTTTGCCAAGAGAAGCTGAAGGAGTGTATGAAGCCAAAGAACAACTGT
>TTN-216,ENSE00003801707,1,276,621515,621790,TGCCACCAAAGATCCTTATGCCAGAGCAAATAACTATCAAAGCTGGGAAAAAACTCCGAATTGAAGCCCATGTGTATGGAAAGCCTCATCCCACCTGTAAATGGAAAAAAGGAGAAGATGAAGTTGTCACATCCAGCCACCTGGCAGTGCATAAAGCAGACAGCTCTTCAATTCTGATCATAAAAGATGTGACTAGGAAAGACAGTGGTTACTACAGCCTCACAGCAGAGAACAGTTCTGGGACAGACACTCAGAAAATCAAAGTTGTAGTCATGG
>TTN-216,ENSE00003810399,1,300,621791,622090,ATGCCCCCGGCCCCCCTCAGCCTCCATTTGACATTTCTGATATAGACGCTGATGCTTGCTCCCTGTCATGGCACATCCCTCTGGAGGACGGAGGCAGTAACATCACCAATTATATAGTGGAGAAGTGTGATGTAAGCCGAGGTGACTGGGTCACGGCTCTAGCTTCAGTCACAAAAACTTCCTGCAGGGTTGGAAAGCTGATCCCAGGCCAGGAGTACATCTTCCGGGTCCGTGCTGAAAACCGATTTGGCATTTCAGAGCCTCTCACATCTCCAAAGATGGTTGCGCAGTTCCCATTTG
>TTN-216,ENSE00003810448,1,303,622091,622393,GTGTTCCTAGTGAACCAAAGAATGCACGAGTCACCAAAGTCAACAAGGACTGTATTTTTGTTGCTTGGGACAGACCAGATAGTGATGGAGGGAGCCCCATTATTGGTTATCTGATTGAACGCAAGGAAAGAAACAGTTTGCTGTGGGTGAAAGCCAATGATACTCTTGTCCGGTCAACTGAATATCCTTGTGCTGGCCTTGTAGAAGGTCTTGAGTATTCATTCAGAATCTATGCCCTAAACAAAGCTGGATCCAGCCCACCCAGCAAACCCACAGAATATGTAACTGCAAGAATGCCAGTTG
>TTN-216,ENSE00003802505,1,300,622394,622693,ATCCTCCTGGGAAACCTGAGGTTATTGATGTCACCAAGAGTACTGTATCTCTGATCTGGGCTCGTCCAAAGCATGATGGAGGCAGTAAAATTATTGGCTATTTCGTAGAAGCTTGCAAACTTCCTGGTGATAAATGGGTACGGTGCAATACTGCACCTCACCAGATTCCCCAGGAAGAGTACACAGCTACTGGCCTAGAAGAGAAAGCTCAGTATCAATTTAGAGCTATTGCCAGGACCGCGGTAAACATTAGCCCACCTTCTGAACCTTCTGATCCAGTGACTATCCTCGCAGAAAATG
>TTN-216,ENSE00003806397,1,288,622694,622981,TCCCTCCCAGGATAGACCTGAGTGTGGCTATGAAATCTTTGCTTACTGTGAAAGCTGGAACTAATGTCTGCTTGGATGCTACTGTTTTTGGTAAACCGATGCCAACAGTTTCTTGGAAAAAAGATGGCACACTGCTAAAACCAGCAGAAGGCATAAAGATGGCCATGCAGCGGAATCTGTGCACCTTGGAGCTATTCAGCGTGAACCGGAAGGACTCAGGAGACTATACCATTACTGCTGAAAATTCAAGTGGTTCTAAATCAGCCACCATTAAGCTTAAAGTGTTAG
>TTN-216,ENSE00003807889,1,297,622982,623278,ATAAACCGGGTCCTCCAGCATCTGTTAAAATCAACAAAATGTATTCAGATCGTGCTATGCTTTCTTGGGAACCGCCTCTTGAAGATGGAGGCTCAGAAATCACCAACTATATTGTTGACAAACGTGAAACAAGCAGGCCCAACTGGGCTCAAGTCTCTGCAACTGTGCCTATCACCAGCTGCAGCGTGGAGAAACTTATAGAGGGCCATGAGTATCAGTTCCGTATTTGTGCTGAAAATAAATATGGAGTAGGCGATCCAGTCTTCACTGAACCAGCAATTGCCAAAAACCCATATG
>TTN-216,ENSE00003811290,1,303,623279,623581,ACCCACCAGGACGCTGTGATCCTCCTGTTATTAGCAACATAACCAAAGATCACATGACAGTCAGCTGGAAGCCACCAGCAGATGATGGGGGCTCACCCATCACTGGCTATTTGCTTGAAAAGCGGGAAACCCAGGCTGTTAACTGGACTAAGGTCAACAGAAAACCTATTATAGAAAGAACATTAAAAGCAACAGGTCTTCAAGAAGGTACCGAATATGAGTTCCGTGTTACAGCTATAAATAAAGCTGGACCAGGCAAACCCAGTGACGCATCCAAGGCCGCTTATGCTCGGGACCCTCAGT
>TTN-216,ENSE00003808853,1,306,623582,623887,ATCCTCCTGGCCCACCGGCTTTCCCTAAAGTATATGATACAACTCGCAGCTCTGTGAGTCTATCTTGGGGCAAGCCAGCCTATGACGGCGGCAGCCCTATCATTGGTTATCTCGTTGAAGTAAAACGGGCTGACTCCGATAACTGGGTGAGGTGCAACTTACCACAGAATCTACAGAAAACCCGCTTTGAGGTTACTGGCCTGATGGAAGACACACAATATCAATTCCGTGTGTATGCCGTTAATAAGATTGGATACAGTGACCCCAGTGATGTGCCAGATAAACACTATCCCAAGGACATCTTAA
>TTN-216,ENSE00003807542,1,288,623888,624175,TTCCACCTGAGGGAGAACTTGATGCGGACTTAAGGAAGACACTCATATTACGTGCTGGAGTTACTATGAGACTATATGTACCAGTAAAAGGACGCCCACCTCCAAAGATTACTTGGTCTAAACCAAATGTCAATCTAAGAGACAGGATTGGACTGGACATAAAGTCAACTGACTTTGACACTTTCTTGCGCTGTGAAAATGTGAACAAATATGATGCAGGAAAATATATCTTAACCCTGGAGAACAGCTGTGGTAAAAAGGAATATACCATTGTTGTGAAAGTGCTTG
>TTN-216,ENSE00003810775,1,291,624176,624466,ATACTCCTGGGCCACCTGTCAATGTGACTGTTAAGGAAATATCCAAAGACTCTGCTTATGTTACCTGGGAGCCTCCCATTATTGATGGCGGAAGCCCCATCATAAACTATGTGGTACAAAAACGTGATGCAGAGAGGAAATCCTGGTCTACAGTGACAACTGAGTGCTCCAAAACAAGCTTCAGAGTAGCTAATTTGGAGGAGGGAAAATCCTACTTCTTCCGAGTGTTTGCTGAAAATGAGTATGGCATTGGTGATCCCGGTGAAACTCGTGATGCTGTCAAAGCTTCCC
>TTN-216,ENSE00003811210,1,288,624467,624754,AAACTCCTGGACCAGTTGTGGACCTGAAAGTGAGGTCTGTATCTAAGTCATCCTGTAGCATTGGCTGGAAAAAGCCTCACAGTGATGGTGGAAGTCGGATTATTGGATATGTAGTTGATTTCCTGACTGAAGAAAATAAGTGGCAACGAGTTATGAAATCCTTAAGCCTACAGTACTCTGCAAAAGATTTGACTGAAGGGAAGGAATATACCTTCAGAGTGAGTGCTGAGAATGAAAATGGAGAAGGAACCCCAAGCGAAATCACTGTTGTGGCAAGGGATGATGTTG
>TTN-216,ENSE00003805436,1,588,624755,625342,TGGCTCCTGATCTTGACTTAAAGGGTCTACCTGATTTGTGCTACTTGGCTAAAGAAAACAGCAACTTCCGGCTTAAGATCCCCATAAAAGGCAAGCCAGCTCCATCAGTCTCCTGGAAGAAAGGGGAAGATCCTCTAGCAACTGACACTAGAGTCAGTGTTGAGTCATCTGCGGTTAACACAACTCTTATAGTGTACGATTGCCAAAAATCTGATGCTGGAAAATACACAATCACACTTAAGAATGTTGCTGGCACCAAGGAAGGAACTATCTCCATAAAGGTTGTTGGCAAGCCTGGCATCCCCACTGGACCAATCAAATTTGATGAAGTCACAGCAGAAGCCATGACCTTAAAGTGGGCTCCTCCAAAGGATGATGGAGGTTCTGAAATCACCAACTATATCCTAGAGAAGAGGGATTCTGTGAACAACAAGTGGGTGACGTGCGCCTCAGCTGTCCAGAAAACCACCTTTAGAGTAACCAGACTTCATGAGGGCATGGAATATACCTTCAGGGTCAGTGCCGAAAATAAATATGGTGTAGGGGAAGGCCTGAAATCGGAGCCAATTGTTGCGAGACATCCATTTG
>TTN-216,ENSE00003808777,1,105,625343,625447,ATGTGCCTGATGCTCCCCCACCTCCCAATATTGTGGATGTCAGACACGATTCAGTATCTCTAACTTGGACTGACCCCAAGAAAACTGGTGGTTCTCCAATTACAG
>TTN-216,ENSE00003806939,1,198,625448,625645,GGTATCATCTCGAGTTCAAGGAAAGAAACAGCCTTTTGTGGAAGAGAGCTAACAAGACTCCGATAAGGATGAGAGACTTTAAAGTGACAGGATTAACTGAAGGTCTTGAATATGAATTCCGAGTTATGGCAATCAATTTAGCAGGTGTGGGCAAGCCAAGCCTACCATCAGAGCCTGTTGTGGCACTGGACCCAATTG
>TTN-216,ENSE00003811024,1,297,625646,625942,ATCCTCCTGGAAAACCTGAGGTTATTAACATAACAAGGAATTCAGTGACTCTCATTTGGACTGAACCTAAATATGACGGTGGTCATAAGTTAACTGGATATATAGTGGAGAAGCGAGATCTACCTTCGAAGTCTTGGATGAAAGCCAACCATGTTAATGTCCCAGAATGTGCCTTTACTGTAACTGACCTTGTTGAGGGTGGAAAATATGAATTCAGAATTAGAGCAAAGAATACAGCAGGTGCTATCAGTGCTCCATCAGAAAGTACAGAAACCATTATTTGCAAGGATGAATACG
>TTN-216,ENSE00003803896,1,588,625943,626530,AGGCACCAACAATTGTCCTTGATCCCACAATAAAAGATGGGCTAACAATTAAAGCAGGGGATACCATTGTTTTGAATGCCATTAGCATTCTTGGCAAACCCCTTCCAAAATCAAGTTGGTCCAAGGCAGGAAAAGACATTAGACCATCAGATATCACTCAGATAACTTCAACCCCAACATCTTCCATGCTTACTATCAAGTATGCCACTAGAAAAGATGCGGGTGAATATACCATCACTGCTACCAATCCTTTTGGCACGAAGGTGGAACATGTGAAGGTAACAGTCCTTGATGTACCTGGTCCCCCAGGTCCTGTTGAAATCAGTAATGTTTCTGCTGAAAAAGCAACACTTACATGGACACCTCCCTTGGAAGATGGCGGCTCACCAATTAAGTCCTATATACTTGAAAAGAGAGAAACCAGCCGACTTTTGTGGACAGTGGTTTCTGAAGATATTCAGTCTTGCAGGCATGTGGCAACCAAACTTATCCAAGGAAATGAGTACATCTTCCGGGTCTCAGCTGTAAACCACTATGGCAAAGGAGAACCTGTACAGTCTGAACCTGTCAAAATGGTAGACAGATTTG
>TTN-216,ENSE00003807419,1,303,626531,626833,GTCCCCCTGGCCCTCCTGAAAAACCAGAGGTATCAAATGTCACTAAGAACACTGCCACTGTCAGCTGGAAAAGGCCAGTGGATGATGGTGGCAGCGAAATTACAGGATATCATGTAGAAAGGAGAGAAAAGAAAAGCCTGCGATGGGTGAGAGCAATAAAAACACCAGTTTCCGATCTCAGGTGCAAAGTAACAGGACTGCAAGAAGGAAGCACCTACGAATTCCGTGTCAGTGCAGAAAACAGAGCAGGAATTGGTCCACCCAGTGAGGCTTCAGATTCTGTTCTGATGAAAGATGCAGCAT
>TTN-216,ENSE00003811193,1,17106,626834,643939,ATCCTCCAGGACCACCTTCAAATCCGCATGTCACTGATACTACCAAGAAATCTGCTTCTTTGGCATGGGGCAAGCCTCATTATGATGGTGGACTTGAAATCACTGGCTATGTCGTGGAGCATCAAAAAGTAGGAGACGAGGCCTGGATAAAAGATACCACAGGAACCGCCCTCAGAATCACTCAGTTCGTTGTTCCTGATCTTCAGACTAAAGAAAAATACAACTTCAGAATCAGTGCCATCAACGATGCAGGTGTTGGGGAGCCAGCGGTGATTCCAGATGTTGAAATCGTAGAACGGGAGATGGCTCCTGATTTTGAACTAGATGCCGAGCTTCGAAGAACACTTGTTGTTAGAGCAGGACTCAGTATTAGGATATTTGTGCCAATTAAAGGTCGTCCTGCTCCTGAAGTGACATGGACCAAAGATAACATCAACCTGAAAAACCGAGCCAACATTGAAAATACGGAATCATTTACTCTTCTGATTATCCCAGAATGTAACAGATATGATACCGGTAAATTTGTCATGACCATTGAAAACCCGGCTGGGAAGAAAAGTGGCTTTGTGAACGTCAGAGTCTTGGACACGCCAGGCCCAGTCCTCAACCTGCGGCCTACAGACATCACAAAGGACAGTGTCACCCTGCACTGGGACCTCCCTCTGATAGATGGAGGCTCACGTATAACAAACTACATTGTAGAGAAACGTGAAGCAACACGGAAATCTTATTCCACAGCCACCACTAAGTGCCATAAATGCACATATAAAGTTACCGGCTTGTCTGAAGGGTGTGAATATTTCTTCAGAGTGATGGCAGAGAATGAATATGGAATTGGTGAGCCAACAGAAACTACAGAGCCCGTAAAAGCCTCTGAAGCACCATCTCCACCAGACAGCCTTAACATCATGGACATAACTAAGAGCACCGTCAGCCTGGCATGGCCTAAGCCCAAACACGATGGTGGCAGCAAGATCACTGGCTATGTGATTGAAGCCCAAAGAAAAGGCTCTGACCAGTGGACCCACATCACAACCGTGAAAGGGTTAGAATGTGTTGTGAGGAATCTAACTGAAGGAGAGGAATATACCTTCCAAGTGATGGCAGTGAACAGCGCGGGGAGAAGTGCCCCTAGAGAAAGCAGACCCGTCATTGTCAAGGAGCAGACAATGCTTCCAGAGCTGGATCTCCGTGGCATCTATCAGAAACTGGTCATTGCCAAAGCTGGTGACAACATCAAAGTTGAAATTCCAGTGCTCGGTCGACCGAAGCCCACAGTGACATGGAAAAAAGGAGACCAAATTCTTAAACAGACACAGAGAGTTAATTTTGAAACCACAGCGACTTCAACCATTTTAAATATCAATGAGTGTGTCAGAAGTGATAGTGGGCCCTATCCATTAACAGCAAGGAACATTGTAGGAGAGGTTGGTGATGTCATCACCATTCAAGTCCATGATATCCCAGGGCCACCTACTGGACCAATCAAATTTGATGAAGTTTCATCTGATTTTGTAACCTTCTCTTGGGACCCACCTGAGAACGATGGTGGTGTACCAATAAGCAACTATGTAGTGGAAATGCGGCAGACTGACAGTACTACCTGGGTTGAGTTAGCAACCACCGTTATACGTACTACCTATAAAGCCACCCGCCTTACTACTGGATTAGAGTATCAGTTCCGTGTAAAAGCTCAGAATAGATATGGAGTTGGACCAGGCATCACATCAGCATGCATAGTTGCCAACTATCCATTTAAGGTTCCTGGACCTCCTGGTACCCCTCAGGTAACTGCAGTTACCAAGGATTCAATGACAATTAGCTGGCATGAGCCACTTTCTGATGGTGGAAGCCCCATTTTAGGATATCATGTTGAAAGAAAAGAACGAAATGGTATTCTCTGGCAGACTGTGAGCAAAGCTTTAGTACCAGGCAACATTTTCAAATCAAGTGGACTTACAGATGGTATTGCTTATGAGTTCCGGGTGATTGCAGAAAACATGGCAGGCAAAAGTAAGCCAAGCAAGCCATCAGAACCTATGTTGGCTCTGGATCCCATTGACCCACCTGGAAAACCAGTACCTCTAAATATTACAAGACACACAGTAACACTTAAATGGGCTAAGCCTGAATATACTGGGGGCTTTAAAATTACCAGTTATATCGTTGAAAAGAGAGACCTTCCTAATGGACGGTGGCTGAAGGCCAACTTCAGCAACATTTTGGAGAATGAATTTACAGTCAGTGGCCTAACAGAAGATGCTGCATATGAATTCCGTGTGATCGCCAAAAATGCTGCAGGTGCCATCAGTCCACCATCTGAGCCATCTGATGCTATCACTTGCAGGGATGATGTTGAGGCACCAAAGATAAAGGTGGATGTTAAATTTAAGGACACGGTTATATTAAAAGCAGGTGAAGCATTCAGACTGGAAGCTGATGTTTCAGGCCGCCCACCTCCAACAATGGAATGGAGCAAAGATGGAAAAGAGCTGGAAGGCACAGCAAAGTTAGAAATAAAAATTGCAGATTTCTCTACTAATCTGGTAAACAAAGATTCAACAAGAAGGGATAGTGGTGCCTATACCCTTACAGCGACTAATCCTGGTGGCTTTGCTAAACACATTTTCAATGTCAAAGTTCTTGACAGACCAGGCCCACCTGAAGGACCTTTGGCTGTAACTGAAGTGACATCAGAAAAGTGTGTACTATCATGGTTCCCTCCACTGGATGATGGAGGTGCCAAAATTGATCATTACATAGTACAGAAACGTGAAACCAGCAGATTGGCATGGACAAATGTAGCCTCAGAAGTCCAAGTAACAAAGCTAAAGGTCACTAAACTCTTGAAAGGCAATGAATACATATTCCGTGTCATGGCTGTAAATAAATATGGAGTGGGAGAGCCACTGGAATCAGAGCCTGTGCTTGCAGTGAATCCTTATGGACCCCCTGATCCGCCCAAAAACCCTGAAGTGACAACTATTACTAAAGATTCGATGGTTGTCTGCTGGGGACATCCTGATTCTGATGGTGGAAGTGAAATCATCAATTATATTGTGGAACGGCGTGATAAAGCTGGCCAACGCTGGATTAAATGCAACAAAAAAACTCTTACTGATTTAAGATATAAAGTGTCTGGACTGACAGAAGGACATGAATATGAGTTCAGGATTATGGCTGAAAATGCTGCTGGAATTAGTGCACCAAGTCCTACCAGTCCATTTTACAAGGCTTGTGACACTGTGTTTAAACCTGGACCACCAGGTAACCCACGTGTTCTGGATACAAGCAGATCATCCATTTCAATCGCTTGGAATAAACCTATCTATGATGGTGGTTCAGAAATCACTGGGTATATGGTTGAGATTGCCCTGCCAGAGGAAGATGAATGGCAGATTGTCACTCCACCAGCAGGACTCAAGGCAACTTCGTATACTATCACTGGCCTCACAGAGAATCAGGAATATAAGATCCGCATCTATGCCATGAATTCCGAAGGACTTGGGGAACCTGCCCTTGTTCCTGGAACTCCAAAGGCTGAAGACAGAATGCTGCCTCCAGAAATTGAACTGGATGCTGACCTGCGCAAAGTTGTTACTATAAGGGCCTGCTGCACCCTGAGACTTTTTGTTCCCATCAAAGGAAGGCCTGCACCTGAGGTGAAGTGGGCCCGGGACCATGGAGAATCTTTAGATAAAGCTAGCATCGAATCCACAAGCTCTTACACCCTGCTTATTGTTGGAAATGTAAACAGATTTGACAGTGGCAAATATATACTAACTGTAGAAAATAGTTCAGGCAGCAAGTCTGCATTTGTCAATGTTAGAGTTCTCGATACACCAGGCCCCCCACAGGATCTGAAGGTAAAAGAGGTCACTAAGACATCTGTCACACTCACATGGGACCCACCTCTCCTTGATGGAGGTTCAAAAATCAAGAACTATATTGTTGAAAAGCGGGAATCAACAAGAAAAGCATATTCAACTGTTGCAACAAACTGCCACAAGACTTCCTGGAAGGTAGACCAGCTTCAAGAAGGCTGTAGCTACTATTTCAGGGTTCTCGCAGAAAATGAATATGGCATTGGGCTGCCTGCTGAAACCGCAGAATCTGTGAAAGCATCAGAACGACCTCTTCCTCCAGGAAAAATAACTTTGATGGATGTCACAAGAAATAGTGTGTCACTCTCTTGGGAGAAACCAGAGCATGATGGAGGCAGCCGAATTCTAGGCTACATTGTGGAGATGCAGACCAAAGGCAGTGACAAATGGGCCACGTGTGCCACAGTCAAGGTCACTGAAGCCACTATCACTGGATTAATTCAGGGTGAAGAATACTCTTTCCGTGTTTCAGCTCAGAATGAAAAGGGCATCAGTGATCCTAGACAACTGAGTGTGCCAGTGATCGCCAAAGATCTTGTCATTCCACCAGCCTTCAAACTCCTGTTCAATACTTTCACTGTACTGGCAGGTGAAGACCTAAAAGTTGATGTTCCATTCATTGGCCGCCCTACCCCAGCTGTAACCTGGCATAAAGATAATGTACCACTGAAGCAGACAACTAGAGTAAATGCAGAGAGCACAGAAAATAATTCACTACTGACAATAAAGGACGCCTGCCGAGAAGATGTTGGCCATTATGTGGTTAAACTGACTAACTCAGCTGGTGAAGCTATTGAAACCCTTAATGTTATCGTTCTTGACAAACCAGGGCCTCCAACTGGACCAGTTAAAATGGATGAAGTGACAGCTGATAGTATTACTCTTTCCTGGGGCCCACCCAAGTATGATGGTGGAAGTTCTATCAATAATTACATTGTTGAGAAACGGGACACTTCCACAACCACCTGGCAAATTGTATCAGCTACAGTTGCAAGGACAACAATAAAGGCTTGCAGACTGAAGACTGGATGTGAATATCAGTTTAGAATTGCAGCTGAAAACAGATATGGGAAGAGTACCTACCTCAATTCAGAGCCTACTGTAGCCCAATATCCATTCAAAGTTCCTGGTCCTCCTGGCACTCCAGTTGTCACACTGTCCTCCAGGGACAGCATGGAAGTACAATGGAATGAGCCAATCAGTGATGGAGGAAGTAGAGTCATTGGCTATCATCTAGAACGCAAGGAAAGAAATAGCATCCTCTGGGTTAAGTTGAATAAAACACCTATTCCTCAAACCAAGTTTAAGACAACTGGCCTTGAAGAAGGTGTTGAATATGAATTTAGAGTCTCTGCAGAGAACATCGTGGGCATTGGCAAGCCGAGTAAAGTATCAGAATGTTATGTGGCTCGTGACCCATGTGATCCACCAGGACGGCCAGAGGCAATCATTGTCACAAGGAATTCTGTGACTCTTCAGTGGAAGAAACCCACCTATGACGGTGGAAGCAAGATCACTGGTTATATTGTTGAGAAGAAAGAATTACCTGAGGGCCGTTGGATGAAAGCCAGTTTTACAAATATTATTGACACTCATTTTGAAGTAACTGGCCTAGTTGAAGATCACAGATATGAGTTCCGGGTTATAGCCCGAAATGCCGCAGGAGTGTTTAGTGAGCCTTCAGAAAGCACAGGAGCAATAACAGCTAGAGATGAGGTAGATCCACCACGAATAAGTATGGATCCAAAATACAAAGACACAATCGTGGTTCATGCTGGTGAATCATTCAAGGTTGATGCAGATATTTATGGCAAACCAATACCAACCATTCAGTGGATAAAAGGTGATCAGGAGCTTTCAAACACAGCTCGATTAGAAATAAAGAGCACCGACTTTGCCACCAGTCTCAGTGTAAAAGATGCAGTACGTGTCGACAGTGGAAATTACATACTGAAGGCCAAAAATGTTGCAGGAGAAAGATCAGTTACTGTGAATGTCAAGGTTCTTGACAGACCAGGGCCACCTGAAGGACCTGTTGTTATCTCAGGAGTTACAGCAGAAAAATGCACACTAGCTTGGAAACCCCCACTTCAGGATGGTGGGAGTGACATCATAAATTATATTGTGGAAAGGAGAGAAACCAGCCGCTTAGTTTGGACTGTGGTTGATGCCAATGTGCAGACTCTCAGCTGCAAGGTTACTAAGCTTCTTGAAGGCAATGAATATACTTTCCGTATAATGGCAGTAAACAAATATGGTGTTGGTGAACCTCTTGAATCTGAGCCAGTAGTTGCCAAGAATCCATTTGTAGTACCAGATGCACCAAAAGCTCCAGAAGTCACAACAGTGACCAAGGACTCAATGATTGTTGTATGGGAAAGACCAGCATCTGATGGTGGTAGTGAAATTCTTGGATATGTTCTTGAGAAACGGGATAAAGAAGGCATTAGATGGACAAGATGCCATAAGCGTCTGATTGGAGAGTTGCGCCTGAGAGTAACTGGACTCATAGAAAATCACGATTATGAGTTCAGAGTTTCTGCTGAGAATGCTGCTGGACTTAGTGAACCAAGCCCTCCTTCTGCTTACCAAAAGGCTTGTGATCCTATTTATAAACCAGGACCCCCAAACAACCCCAAAGTCATAGACATAACCAGATCTTCAGTATTCCTTTCTTGGAGCAAACCAATATATGATGGTGGCTGTGAAATTCAAGGATACATTGTTGAAAAATGTGATGTGAGTGTTGGTGAATGGACAATGTGCACTCCACCAACAGGAATTAATAAAACAAACATAGAAGTAGAGAAGCTGTTGGAAAAGCATGAATACAACTTCCGTATCTGTGCTATTAATAAAGCTGGAGTTGGAGAACATGCTGACGTCCCTGGACCTATTATAGTTGAAGAAAAATTAGAAGCACCAGACATTGATCTTGACCTAGAACTAAGGAAAATCATAAATATAAGGGCAGGTGGCTCCTTAAGGTTATTTGTTCCTATAAAAGGTCGTCCTACACCAGAAGTTAAATGGGGAAAGGTGGATGGTGAAATCCGAGATGCAGCTATAATTGATGTCACTAGCAGTTTCACCTCTCTTGTTCTTGACAATGTCAACCGATATGATAGTGGAAAATATACGCTTACATTAGAAAACAGCAGTGGAACAAAGTCTGCCTTTGTTACTGTGAGAGTTCTGGACACGCCAAGTCCACCTGTTAACCTGAAAGTCACAGAAATCACCAAAGACTCAGTATCAATTACATGGGAACCTCCTTTGTTGGATGGGGGATCCAAAATAAAAAATTACATTGTTGAGAAACGTGAAGCCACAAGAAAATCATATGCTGCTGTTGTAACTAACTGCCATAAGAATTCTTGGAAAATCGATCAGCTCCAAGAAGGTTGCAGTTATTACTTTAGAGTCACAGCTGAGAATGAGTATGGTATTGGCCTTCCTGCCCAGACTGCTGATCCAATTAAGGTTGCAGAAGTGCCACAACCTCCTGGAAAAATAACTGTGGATGATGTCACCAGAAACAGTGTCTCTCTGAGTTGGACAAAACCTGAACATGATGGTGGCAGTAAAATCATTCAGTATATTGTGGAAATGCAAGCTAAACACAGTGAGAAATGGTCAGAGTGTGCTCGAGTAAAGTCTCTTCAGGCAGTAATTACCAACCTAACTCAAGGGGAAGAATATCTTTTTAGAGTTGTTGCTGTAAATGAAAAGGGGAGAAGTGATCCTCGGTCCCTTGCAGTTCCAATAGTTGCCAAAGATCTGGTAATTGAGCCAGATGTAAAACCTGCATTCAGTAGTTACAGTGTACAGGTTGGCCAAGATTTGAAAATAGAAGTGCCAATTTCTGGACGTCCTAAGCCAACCATTACCTGGACTAAAGATGGTCTCCCACTGAAGCAGACCACAAGAATCAATGTTACCGATTCACTGGATCTCACCACACTCAGTATTAAAGAAACTCATAAGGATGATGGTGGACAATATGGAATCACAGTTGCCAATGTTGTTGGTCAGAAGACAGCATCCATCGAAATTGTAACTCTAGATAAACCTGATCCTCCAAAAGGACCTGTTAAATTTGATGACGTCAGTGCTGAAAGTATTACATTATCTTGGAACCCTCCATTATATACAGGGGGCTGCCAAATCACCAACTACATTGTTCAGAAAAGAGATACAACCACCACAGTATGGGATGTTGTTTCTGCTACTGTTGCTAGAACTACACTCAAAGTGACCAAACTGAAAACTGGTACAGAATACCAATTTAGAATATTTGCCGAAAACAGATATGGACAAAGCTTTGCCTTAGAGTCTGATCCAATTGTAGCTCAATATCCCTACAAAGAACCAGGCCCTCCAGGTACACCATTTGCCACAGCCATTTCCAAAGACTCCATGGTCATACAGTGGCATGAACCAGTCAACAATGGTGGAAGCCCCGTCATAGGTTACCACCTGGAGAGAAAAGAAAGAAACAGTATTTTGTGGACAAAGGTCAACAAAACTATTATTCATGACACCCAATTCAAAGCACAGAATCTTGAAGAAGGCATTGAATATGAATTCAGAGTGTATGCTGAAAATATTGTTGGTGTAGGCAAAGCAAGCAAGAATTCTGAATGCTATGTAGCCAGAGATCCCTGTGACCCACCAGGAACCCCAGAACCAATAATGGTTAAAAGAAATGAAATCACTTTACAGTGGACCAAACCTGTGTATGATGGTGGAAGTATGATTACAGGCTACATTGTAGAGAAACGTGATTTGCCTGATGGTCGTTGGATGAAAGCTAGCTTTACAAATGTCATTGAAACTCAATTTACTGTGTCAGGTCTTACTGAAGATCAAAGATATGAATTCAGAGTCATTGCAAAGAATGCAGCTGGTGCAATAAGTAAACCCTCTGACAGTACTGGACCAATAACTGCCAAGGATGAGGTTGAACTCCCAAGAATTTCAATGGATCCAAAATTCAGAGACACAATTGTGGTAAATGCTGGAGAAACATTCAGACTTGAGGCTGATGTCCATGGAAAGCCCCTACCTACCATTGAGTGGTTAAGAGGAGATAAGGAAATTGAAGAATCTGCTAGATGTGAAATAAAGAACACAGATTTCAAGGCTTTACTTATTGTAAAAGATGCAATTAGAATTGATGGTGGGCAGTATATTTTAAGAGCTTCCAATGTTGCAGGTTCTAAGTCATTCCCAGTAAATGTAAAAGTATTAGATAGACCAGGACCTCCAGAAGGGCCAGTCCAGGTTACTGGAGTCACTTCTGAAAAATGCTCTTTAACATGGTCTCCACCACTTCAAGATGGTGGCAGTGACATTTCTCACTATGTTGTTGAAAAGCGAGAAACCAGTCGACTTGCCTGGACTGTTGTTGCTTCAGAAGTTGTGACCAATTCTCTGAAAGTTACCAAACTCTTAGAAGGTAATGAATATGTTTTCCGTATAATGGCTGTCAACAAATATGGTGTTGGAGAGCCTTTGGAATCTGCACCAGTACTAATGAAAAATCCATTTGTGCTTCCTGGACCACCAAAAAGCTTGGAAGTCACAAATATTGCCAAAGACTCCATGACCGTCTGTTGGAACCGTCCAGATAGTGATGGTGGAAGTGAGATTATTGGTTACATTGTAGAGAAAAGAGACAGAAGTGGCATTCGATGGATAAAATGTAATAAACGCCGCATTACAGATTTGCGTCTAAGAGTGACAGGATTAACAGAAGATCATGAGTATGAATTCAGGGTCTCTGCAGAAAATGCTGCTGGAGTTGGGGAACCAAGTCCAGCTACAGTTTATTATAAAGCCTGTGATCCTGTGTTCAAACCTGGCCCACCTACCAATGCACACATTGTAGACACCACTAAAAATTCAATCACACTTGCCTGGGGTAAACCCATCTATGATGGCGGCAGTGAGATCTTGGGATATGTAGTAGAAATCTGTAAAGCAGATGAAGAAGAATGGCAAATAGTTACTCCACAGACTGGCCTGAGAGTCACTCGATTTGAAATTTCAAAACTCACTGAACACCAAGAGTATAAAATACGAGTCTGTGCCCTCAACAAAGTTGGTTTAGGTGAGGCTACATCAGTTCCTGGTACTGTGAAACCAGAAGATAAACTTGAAGCACCTGAACTTGACCTTGACTCCGAATTAAGAAAAGGAATTGTTGTAAGAGCTGGTGGATCTGCCAGAATTCACATTCCATTCAAAGGTCGTCCAACGCCTGAGATCACTTGGTCTCGAGAGGAAGGTGAATTCACAGATAAGGTCCAAATTGAAAAGGGAGTAAACTATACCCAACTATCAATAGATAACTGTGATAGAAATGATGCTGGAAAATACATTCTTAAGTTGGAAAACAGCAGTGGATCAAAGTCTGCTTTTGTAACTGTGAAAGTTCTTGACACTCCAGGACCACCACAGAATTTGGCAGTCAAAGAAGTGAGAAAAGATTCTGCCTTCCTGGTATGGGAGCCACCCATCATTGATGGAGGGGCAAAGGTCAAGAACTATGTGATTGACAAACGTGAGTCAACCAGAAAAGCGTATGCTAATGTGAGTAGTAAATGCAGCAAAACAAGTTTTAAAGTGGAAAACCTTACAGAAGGAGCCATTTATTACTTCAGAGTCATGGCTGAAAATGAATTTGGAGTTGGTGTTCCAGTGGAAACTGTTGATGCCGTGAAAGCTGCTGAACCTCCTTCCCCACCAGGAAAGGTTACACTCACTGATGTGTCCCAGACCAGTGCATCACTTATGTGGGAGAAACCTGAACATGATGGCGGTAGCAGAGTCCTGGGGTACGTTGTTGAAATGCAGCCCAAAGGAACTGAAAAATGGAGCATTGTGGCTGAATCCAAAGTCTGTAATGCAGTTGTTACTGGTTTGAGTTCTGGACAAGAATATCAGTTCCGTGTCAAGGCTTATAATGAGAAAGGAAAAAGCGATCCAAGAGTGTTGGGTGTTCCTGTCATAGCCAAGGACTTGACTATACAGCCTAGTTTAAAGTTACCATTTAACACATATAGTATCCAAGCTGGAGAAGATCTTAAAATAGAAATTCCAGTTATAGGCCGACCAAGACCTAACATTTCTTGGGTCAAAGATGGTGAGCCTCTTAAACAGACAACAAGAGTAAACGTTGAAGAAACAGCTACCTCAACTGTTTTGCACATTAAAGAAGGTAACAAAGATGACTTTGGAAAATACACCGTAACGGCAACAAATAGTGCAGGCACAGCAACAGAAAATCTCAGTGTTATCGTTTTAGAAAAGCCTGGACCTCCAGTTGGCCCAGTTCGGTTTGATGAAGTTAGTGCAGACTTTGTAGTCATATCTTGGGAACCTCCAGCCTATACTGGTGGCTGCCAAATAAGCAACTACATTGTAGAGAAGCGAGATACAACCACCACCACTTGGCACATGGTATCAGCAACAGTTGCAAGAACAACAATTAAAATAACCAAACTGAAAACAGGCACGGAGTACCAGTTTAGAATTTTTGCTGAAAACAGGTATGGAAAAAGTGCCCCACTGGATTCTAAGGCAGTTATTGTACAATATCCATTTAAAGAACCTGGACCACCTGGAACTCCTTTTGTGACATCAATCTCAAAAGATCAGATGCTTGTGCAATGGCATGAGCCAGTGAATGATGGAGGCACCAAAATTATTGGCTACCATCTTGAACAGAAAGAAAAGAACAGTATTTTATGGGTCAAGTTAAATAAGACCCCCATTCAGGACACCAAATTCAAAACAACTGGGCTTGATGAGGGCCTTGAGTATGAGTTCAAAGTTTCTGCTGAAAATATTGTTGGCATTGGCAAGCCTAGCAAAGTGTCAGAATGCTTTGTTGCTCGTGATCCATGTGACCCACCTGGTCGCCCTGAAGCCATTGTTATTACAAGAAACAATGTCACACTGAAATGGAAGAAACCTGCCTATGATGGTGGTAGCAAAATAACAGGTTATATTGTAGAAAAGAAAGATCTACCTGATGGCCGCTGGATGAAAGCCAGCTTTACCAACGTATTAGAAACTGAATTTACAGTGAGTGGACTTGTAGAAGACCAAAGATATGAATTTAGAGTAATTGCAAGAAATGCAGCTGGAAACTTTAGTGAACCATCTGATAGTAGTGGTGCCATTACTGCAAGAGATGAAATTGATGCACCAAATGCCTCTCTGGATCCAAAATATAAAGATGTCATCGTTGTTCATGCAGGAGAGACTTTTGTTCTTGAAGCCGACATCCGTGGCAAACCTATACCTGATGTTGTTTGGTCAAAAGATGGAAAAGAACTTGAAGAAACAGCTGCTAGAATGGAAATTAAATCTACTATTCAGAAAACAACTCTTGTTGTCAAAGACTGTATACGGACTGATGGAGGACAATATATTCTGAAACTCAGCAATGTTGGTGGTACAAAGTCTATACCCATCACTGTAAAGGTACTTGACAGGCCAGGGCCTCCTGAAGGGCCTCTGAAAGTTACTGGAGTTACTGCGGAAAAATGTTACCTGGCATGGAACCCACCTTTGCAAGATGGTGGTGCTAATATTTCACATTACATCATTGAAAAGAGGGAGACAAGCCGACTCTCTTGGACCCAGGTTTCAACTGAGGTACAGGCCCTTAACTACAAAGTTACTAAACTTCTTCCTGGTAATGAGTACATTTTCCGTGTCATGGCTGTGAATAAATATGGAATTGGAGAGCCCTTGGAATCTGGGCCTGTTACGGCCTGTAATCCTTATAAGCCACCAGGTCCTCCCTCAACACCTGAAGTCTCAGCAATCACCAAAGATTCTATGGTAGTAACATGGGCACGCCCAGTAGACGACGGAGGTACCGAAATTGAGGGCTACATTCTTGAAAAACGAGATAAGGAAGGCGTTAGATGGACCAAGTGCAACAAGAAAACATTAACGGATCTGCGGCTCAGGGTAACTGGTCTTACCGAAGGCCATTCCTATGAATTCAGAGTTGCTGCTGAAAATGCAGCTGGTGTGGGAGAACCTAGTGAGCCATCTGTTTTCTACCGTGCGTGTGATGCCTTGTATCCACCAGGTCCCCCAAGCAATCCAAAAGTGACGGACACTTCCAGATCTTCTGTCTCCCTGGCATGGAGTAAGCCAATTTATGATGGTGGCGCACCTGTTAAAGGCTATGTTGTAGAGGTCAAAGAAGCTGCTGCGGATGAATGGACAACCTGCACTCCACCAACAGGATTACAAGGAAAGCAGTTCACAGTGACCAAGCTTAAAGAAAACACTGAATATAACTTCCGTATTTGTGCCATCAATTCTGAAGGTGTAGGTGAACCTGCAACTCTACCTGGCTCAGTGGTTGCTCAGGAGAGGATAGAGCCACCAGAAATAGAACTCGATGCTGATCTCAGAAAGGTGGTCGTTCTGCGTGCAAGTGCTACTTTACGCTTATTTGTCACTATCAAAGGTCGACCAGAACCCGAAGTTAAATGGGAAAAGGCAGAAGGCATTCTCACTGACAGGGCTCAGATAGAGGTGACCAGCTCATTTACAATGTTGGTGATTGATAATGTTACCAGATTTGACAGTGGTCGGTATAATCTGACATTAGAAAATAATAGTGGCTCCAAAACAGCTTTTGTTAACGTCAGAGTTCTTGACTCACCAAGTGCCCCTGTGAATTTGACCATAAGAGAAGTGAAGAAAGACTCAGTGACGTTGTCCTGGGAACCACCACTTATTGATGGTGGAGCTAAGATTACAAACTACATTGTCGAAAAACGAGAAACTACAAGAAAAGCCTATGCTACCATTACAAATAATTGCACTAAAACTACTTTCAGAATTGAAAATCTACAAGAAGGATGTTCTTACTACTTCCGAGTCTTGGCTTCCAATGAATATGGGATTGGTTTGCCAGCTGAAACAACAGAACCCGTTAAAGTGTCTGAACCACCCCTCCCACCTGGAAGAGTAACTCTTGTTGATGTGACCCGTAATACAGCTACAATTAAGTGGGAGAAACCAGAAAGTGATGGTGGCAGCAAAATTACTGGTTATGTGGTTGAAATGCAGACTAAAGGGAGTGAAAAGTGGAGCACCTGCACACAAGTTAAGACTCTAGAAGCAACTATATCTGGCTTAACTGCAGGAGAAGAGTATGTCTTCAGGGTAGCTGCAGTTAACGAAAAGGGAAGAAGTGATCCAAGACAACTTGGAGTGCCAGTAATTGCAAGGGATATTGAAATAAAGCCTTCAGTTGAGCTTCCTTTCCATACTTTCAATGTAAAGGCTAGAGAACAACTTAAGATTGATGTGCCATTCAAAGGAAGACCTCAAGCTACTGTGAACTGGAGAAAAGATGGTCAGACTCTTAAAGAGACAACTAGAGTCAATGTTTCTTCTTCAAAGACTGTAACATCACTATCTATTAAGGAAGCTTCAAAGGAAGATGTTGGAACTTATGAATTATGTGTTTCAAACAGTGCTGGATCCATAACAGTTCCTATTACTATAATTGTCCTTGACAGACCAGGACCTCCAGGTCCTATACGTATTGATGAGGTTAGTTGTGACAGCATAACCATTTCTTGGAATCCTCCAGAATATGATGGTGGCTGCCAAATTAGCAATTACATTGTTGAAAAGAAAGAAACCACCTCTACAACATGGCACATAGTTTCACAAGCAGTTGCAAGAACATCCATTAAAATAGTTCGCCTGACAACAGGAAGTGAGTATCAGTTCCGTGTTTGTGCAGAAAACCGCTATGGAAAGAGCTCCTACAGTGAATCTTCAGCTGTTGTTGCAGAGTATCCATTCAGTCCCCCAGGTCCTCCTGGTACTCCTAAAGTTGTGCATGCCACAAAATCTACCATGCTTGTAACCTGGCAAGTGCCAGTTAATGATGGAGGAAGTCGAGTAATTGGCTATCATCTTGAGTATAAAGAAAGAAGCAGCATTCTTTGGTCAAAAGCAAATAAAATCCTCATTGCTGATACTCAAATGAAAGTCTCCGGCCTTGATGAAGGACTGATGTATGAGTATCGTGTATATGCTGAAAATATTGCTGGAATTGGTAAATGCAGTAAATCTTGTGAACCAGTCCCTGCAAGAGATCCTTGTGACCCTCCTGGACAACCTGAAGTCACAAATATCACAAGAAAATCAGTGTCACTTAAATGGTCTAAACCACATTATGATGGTGGAGCTAAGATCACAGGATACATTGTTGAACGCAGAGAACTACCAGATGGCCGGTGGCTGAAGTGCAATTATACTAATATACAAGAAACATACTTTGAAGTAACTGAACTTACTGAAGATCAGCGTTATGAATTCCGGGTTTTTGCAAGGAATGCTGCTGACTCAGTTAGTGAGCCATCTGAATCCACTGGGCCTATTATAGTTAAAGATGATGTTGAGCCTCCAAGAGTTATGATGGATGTCAAGTTCCGAGACGTTATTGTTGTCAAAGCTGGAGAGGTCCTTAAGATAAATGCAGACATTGCAGGGCGACCTCTGCCAGTAATTTCCTGGGCCAAGGATGGTATAGAAATTGAAGAAAGAGCAAGAACAGAAATCATCTCAACAGACAATCATACTTTGTTAACAGTTAAAGACTGTATAAGACGAGACACTGGGCAATATGTACTAACACTGAAGAATGTTGCCGGCACTCGGTCTGTGGCCGTTAATTGCAAAGTACTTGATAAGCCTGGTCCACCAGCAGGACCACTTGAAATAAATGGCCTCACTGCTGAGAAATGCTCTCTTTCCTGGGGACGTCCCCAAGAAGATGGTGGTGCAGATATCGACTATTACATCGTAGAAAAACGTGAAACAAGCCACCTTGCATGGACAATATGTGAAGGAGAGTTACAGATGACATCCTGTAAAGTAACCAAGTTACTCAAAGGCAATGAATATATATTTAGAGTAACTGGTGTTAATAAATATGGTGTTGGTGAGCCCCTAGAGAGTGTAGCTATAAAGGCACTAGATCCATTTACAGTTCCAAGTCCACCCACGTCTTTGGAAATTACTTCTGTGACCAAAGAATCTATGACACTTTGCTGGTCAAGACCCGAGAGTGATGGAGGTAGTGAAATATCTGGATATATAATTGAAAGGCGAGAGAAAAATAGCCTAAGATGGGTGCGTGTAAACAAAAAACCAGTTTATGATCTAAGAGTGAAATCAACAGGACTTCGGGAAGGATGTGAATATGAATATCGTGTTTATGCAGAAAATGCTGCTGGCCTAAGTCTTCCAAGTGAAACCTCTCCCTTAATTAGGGCAGAAGATCCAGTGTTCCTACCATCTCCTCCATCCAAACCCAAAATTGTGGACTCAGGCAAGACAACTATAACTATTGCCTGGGTTAAGCCGCTGTTTGATGGTGGGGCCCCGATAACTGGATATACTGTAGAATACAAAAAATCTGATGACACTGACTGGAAAACTTCCATTCAGAGCTTACGAGGGACAGAATATACAATAAGCGGACTAACAACAGGAGCTGAATATGTTTTCAGAGTAAAATCTGTCAATAAGGTTGGTGCTAGTGACCCCAGTGATAGCTCTGACCCTCAGATAGCAAAGGAAAGAGAAGAAGAACCTTTATTTGATATTGACAGTGAAATGAGGAAGACCTTGATTGTCAAGGCTGGTGCCTCATTTACCATGACTGTGCCTTTCCGAGGAAGACCAGTACCCAATGTCTTGTGGAGTAAGCCAGACACTGACCTCCGTACTAGAGCTTATGTTGATACCACAGACTCTCGTACATCACTGACCATTGAAAATGCCAACAGAAATGACTCTGGAAAGTACACATTAACAATTCAGAATGTTTTGAGTGCTGCTTCACTGACCTTAGTTGTCAAAGTTTTAGATACCCCAGGTCCTCCAACCAACATTACTGTGCAAGATGTAACCAAAGAGTCTGCAGTGTTATCCTGGGATGTTCCTGAAAACGATGGTGGAGCACCAGTGAAGAATTACCACATAGAAAAACGTGAGGCCAGCAAGAAAGCATGGGTCTCTGTGACCAACAACTGTAACCGCCTCTCCTACAAAGTTACCAATTTACAAGAAGGAGCTATCTATTACTTCAGAGTCTCTGGAGAAAATGAGTTTGGTGTTGGTATACCAGCTGAAACAAAGGAAGGAGTAAAAATAACAG
>TTN-216,ENSE00003802597,1,297,643940,644236,AAAAACCAAGCCCACCTGAAAAACTTGGAGTAACAAGTATATCCAAAGACAGTGTTTCCCTGACCTGGCTGAAGCCTGAACATGATGGCGGAAGCAGAATTGTACACTATGTCGTTGAAGCACTAGAAAAAGGACAGAAAAACTGGGTTAAATGTGCAGTGGCAAAGTCAACCCATCACGTTGTTTCCGGTCTGAGAGAGAATTCTGAATACTTTTTCCGAGTGTTTGCTGAAAATCAAGCTGGCCTGAGTGACCCGAGAGAGCTTCTGCTTCCTGTTCTTATTAAGGAGCAACTAG
>TTN-216,ENSE00003802941,1,588,644237,644824,AACCACCTGAAATTGATATGAAGAATTTCCCAAGTCACACTGTATATGTTAGAGCTGGTTCAAACCTTAAAGTTGACATTCCAATCTCTGGAAAACCACTTCCCAAAGTGACCTTATCAAGAGATGGTGTCCCCCTTAAGGCAACCATGAGATTTAATACCGAAATTACTGCTGAGAACCTGACCATCAATCTCAAAGAAAGTGTTACAGCTGACGCTGGGAGATATGAAATCACTGCTGCCAACTCCAGTGGTACAACCAAAGCTTTCATTAACATTGTTGTGCTAGACAGGCCTGGTCCTCCAACTGGCCCTGTTGTTATTAGTGATATAACTGAAGAAAGTGTGACTCTCAAATGGGAGCCACCTAAGTATGACGGTGGAAGTCAAGTTACCAACTACATTCTACTCAAAAGAGAAACAAGTACTGCAGTGTGGACTGAAGTGTCTGCAACAGTTGCAAGAACCATGATGAAAGTCATGAAACTGACCACAGGAGAAGAATACCAATTCCGCATCAAGGCAGAAAACCGCTTTGGCATCAGTGATCATATAGATTCAGCTTGTGTGACTGTCAAACTACCATACA
>TTN-216,ENSE00003808789,1,303,644825,645127,CAACACCTGGACCACCATCTACACCATGGGTCACTAATGTTACTCGAGAAAGCATCACTGTGGGCTGGCATGAACCAGTGTCAAATGGAGGCAGTGCAGTCGTAGGCTATCACCTGGAAATGAAAGACAGAAACAGTATTTTATGGCAAAAAGCCAACAAACTGGTCATCCGCACAACTCACTTCAAAGTCACAACAATCAGTGCTGGACTTATTTATGAATTCAGGGTGTATGCAGAAAATGCTGCTGGAGTTGGAAAACCTAGCCATCCTTCTGAACCAGTCTTGGCAATTGATGCTTGTG
>TTN-216,ENSE00003806587,1,297,645128,645424,AACCCCCAAGAAATGTTCGTATCACTGATATTTCAAAGAACTCTGTCAGCCTTTCATGGCAACAACCAGCTTTCGATGGAGGTAGCAAGATTACAGGCTACATTGTTGAGAGACGTGACCTTCCAGATGGCAGATGGACCAAGGCCAGCTTCACCAATGTTACTGAAACTCAATTCATCATCTCTGGCTTGACTCAGAATTCCCAGTATGAATTCCGTGTCTTTGCTAGGAATGCTGTTGGTTCCATTAGCAATCCATCTGAGGTTGTAGGGCCCATTACTTGCATCGATTCTTATG
>TTN-216,ENSE00003807681,1,288,645425,645712,GTGGTCCTGTAATTGATTTGCCTCTAGAATATACAGAAGTTGTCAAATACAGAGCAGGTACATCTGTGAAGCTCAGAGCTGGCATTTCTGGCAAACCTGCGCCTACTATTGAGTGGTATAAAGATGATAAAGAATTACAAACCAATGCACTGGTGTGTGTTGAAAATACCACGGACCTCGCATCTATACTCATCAAAGATGCCGATCGCCTTAATAGTGGATGCTATGAATTAAAACTAAGGAATGCCATGGGCTCAGCCTCAGCCACCATCAGAGTACAGATCCTTG
>TTN-216,ENSE00003811102,1,300,645713,646012,ACAAACCAGGCCCACCTGGTGGACCAATTGAATTTAAGACTGTAACTGCTGAGAAGATCACCCTTCTCTGGCGGCCTCCAGCTGATGATGGTGGTGCAAAAATCACTCACTACATTGTGGAAAAGCGTGAGACAAGCCGCGTTGTGTGGTCTATGGTGTCTGAACATTTGGAAGAGTGCATCATTACAACCACCAAAATTATCAAAGGAAATGAATACATCTTCCGGGTCCGAGCCGTGAACAAATATGGAATTGGCGAGCCACTGGAATCTGATTCCGTTGTAGCCAAGAACGCATTTG
>TTN-216,ENSE00003802386,1,303,646013,646315,TTACACCTGGGCCACCAGGCATACCAGAAGTGACAAAGATTACCAAGAATTCGATGACTGTTGTATGGAGCAGGCCAATTGCAGATGGCGGTAGTGATATAAGTGGCTATTTCCTTGAAAAACGAGACAAGAAGAGCCTAGGATGGTTTAAAGTACTAAAAGAGACTATCCGTGACACCAGACAAAAAGTAACAGGACTCACAGAAAACAGTGACTATCAATACAGAGTTTGTGCTGTAAACGCTGCTGGACAGGGTCCATTTTCTGAACCATCTGAATTCTACAAAGCTGCTGATCCTATTG
>TTN-216,ENSE00003809908,1,306,646316,646621,ATCCTCCAGGTCCACCTGCTAAGATAAGAATCGCAGATTCAACCAAGTCATCCATCACCCTTGGCTGGAGTAAGCCTGTCTATGATGGGGGCAGTGCTGTTACTGGGTATGTTGTCGAGATAAGACAAGGAGAGGAAGAGGAATGGACTACTGTCTCTACCAAAGGAGAGGTCAGAACTACAGAATATGTGGTATCCAACCTGAAACCTGGAGTCAATTACTACTTCCGGGTATCTGCTGTAAACTGTGCTGGACAAGGAGAACCTATAGAAATGAATGAACCTGTACAAGCTAAAGATATACTTG
>TTN-216,ENSE00003808993,1,1767,646622,648388,AGGCACCAGAGATTGACCTGGATGTGGCTCTCAGAACTTCTGTTATTGCCAAAGCTGGTGAAGATGTACAAGTGTTGATTCCCTTTAAAGGCAGACCTCCACCTACTGTCACATGGAGAAAAGATGAGAAGAATCTTGGCAGTGATGCCAGATACAGCATTGAAAACACTGATTCATCCTCATTACTCACCATTCCTCAAGTTACTCGCAATGATACAGGAAAATATATTCTCACAATAGAAAATGGAGTTGGTGAACCTAAGTCTTCAACTGTGAGTGTTAAAGTGCTTGACACACCAGCTGCCTGCCAGAAACTACAGGTTAAACATGTTTCTCGAGGCACAGTCACTTTGCTCTGGGATCCTCCTCTCATTGATGGAGGATCTCCAATAATTAATTATGTCATTGAAAAGAGAGATGCCACCAAGAGAACATGGTCTGTCGTGTCACACAAATGTTCTAGCACATCCTTCAAGCTAATAGATTTGTCGGAGAAGACTCCATTCTTCTTCAGAGTTCTTGCAGAAAATGAAATTGGAATTGGGGAACCCTGTGAAACTACAGAGCCAGTGAAGGCTGCTGAAGTACCAGCTCCTATACGTGATCTCTCAATGAAAGACTCAACAAAGACATCTGTCATCCTCAGCTGGACCAAACCTGACTTTGATGGTGGTAGCGTCATCACAGAATATGTTGTAGAAAGGAAAGGTAAAGGTGAACAGACGTGGTCCCACGCTGGCATAAGTAAGACATGTGAAATTGAGGTTAGCCAACTTAAGGAGCAGTCAGTCCTGGAGTTCAGAGTGTTTGCCAAAAATGAGAAAGGACTGAGTGATCCTGTCACTATTGGGCCAATTACAGTGAAAGAACTTATTATTACACCTGAAGTTGACCTGTCAGATATCCCTGGGGCACAAGTCACTGTGAGAATTGGGCACAATGTGCACCTTGAATTACCTTATAAGGGAAAACCCAAACCATCCATCAGTTGGCTGAAAGATGGCTTGCCACTGAAAGAAAGTGAATTTGTTCGCTTCAGTAAAACTGAAAACAAAATTACTTTGAGTATTAAGAATGCCAAGAAGGAGCATGGAGGAAAATACACTGTTATTCTTGATAATGCAGTGTGTAGAATTGCAGTCCCCATTACAGTCATCACCCTTGGCCCACCATCAAAGCCCAAAGGACCCATTCGATTTGATGAAATCAAGGCTGATAGTGTCATCCTGTCATGGGATGTACCTGAAGATAATGGAGGAGGAGAAATTACTTGTTACAGCATCGAGAAGCGGGAAACTTCACAAACTAACTGGAAGATGGTGTGTTCAAGTGTTGCCAGAACGACTTTCAAAGTTCCTAATCTAGTCAAAGATGCTGAGTACCAGTTTAGAGTGAGAGCAGAAAACAGATACGGAGTCAGCCAACCACTTGTCTCAAGCATTATTGTGGCAAAACACCAGTTCAGGATTCCTGGTCCCCCAGGAAAGCCAGTTATATACAATGTGACTTCTGATGGCATGTCACTAACTTGGGATGCTCCAGTTTATGATGGTGGTTCAGAAGTTACTGGATTCCATGTTGAAAAGAAAGAAAGAAATAGCATCCTCTGGCAAAAAGTTAATACATCACCAATCTCTGGAAGAGAATATAGAGCCACTGGACTGGTAGAAGGTCTGGATTACCAATTCCGTGTATATGCTGAAAATTCTGCTGGCCTAAGCTCACCTAGTGACCCAAGCAAATTTACCTTAGCTGTTTCTCCAGTAG
>TTN-216,ENSE00003811205,1,294,648389,648682,ACCCACCTGGCACTCCTGACTACATTGATGTCACCCGGGAAACCATCACACTTAAATGGAACCCACCATTGCGTGATGGAGGCAGTAAGATTGTGGGCTATAGCATTGAGAAACGGCAAGGAAATGAACGCTGGGTGAGATGCAACTTTACTGACGTCAGTGAATGTCAGTACACAGTTACAGGACTCAGTCCTGGGGATCGCTATGAGTTCAGAATAATTGCAAGAAATGCTGTTGGAACTATAAGCCCGCCCTCACAGTCTTCTGGCATTATTATGACAAGAGATGAAAATG
>TTN-216,ENSE00003808021,1,288,648683,648970,TTCCACCAATAGTAGAGTTTGGCCCTGAATACTTTGATGGTCTCATTATTAAGTCCGGAGAGAGCCTTAGAATTAAAGCTTTGGTACAAGGAAGACCAGTGCCTCGAGTAACTTGGTTCAAAGATGGAGTGGAAATCGAAAAGAGGATGAATATGGAAATAACCGACGTACTTGGATCCACCAGCCTATTTGTTAGAGATGCTACTCGGGACCATCGTGGTGTATACACAGTGGAAGCCAAAAATGCATCTGGTTCTGCAAAAGCAGAAATTAAAGTGAAAGTACAAG
>TTN-216,ENSE00003804355,1,300,648971,649270,ATACACCAGGAAAAGTAGTTGGGCCAATAAGATTCACCAATATTACTGGGGAGAAGATGACTCTGTGGTGGGATGCCCCACTCAATGACGGTTGTGCTCCCATAACCCACTACATCATTGAAAAACGGGAAACCAGCAGACTTGCCTGGGCACTAATTGAGGATAAATGTGAAGCCCAAAGTTACACTGCCATTAAACTAATAAACGGCAATGAATACCAATTCCGTGTTTCTGCAGTTAACAAGTTTGGTGTTGGCAGGCCACTTGATTCTGATCCAGTGGTTGCTCAAATACAATATA
>TTN-216,ENSE00003807046,1,2067,649271,651337,CTGTTCCTGATGCCCCTGGCATTCCAGAACCTAGCAACATAACAGGCAACAGCATTACCCTGACATGGGCAAGGCCAGAATCAGATGGTGGCAGTGAAATTCAACAGTATATCCTTGAAAGAAGAGAAAAGAAAAGCACAAGATGGGTAAAAGTGATCAGCAAACGACCAATCTCTGAAACAAGATTCAAAGTCACTGGTCTGACAGAAGGCAATGAGTATGAATTCCATGTCATGGCTGAAAATGCTGCAGGAGTTGGACCTGCAAGTGGCATCTCAAGACTCATTAAATGTAGAGAGCCCGTCAACCCACCAGGTCCTCCCACAGTGGTCAAAGTAACAGACACATCAAAGACAACTGTGAGCTTAGAATGGTCCAAACCAGTGTTTGATGGTGGCATGGAAATAATTGGGTATATTATTGAAATGTGTAAGGCCGACTTAGGAGACTGGCACAAGGTGAATGCAGAGGCATGTGTGAAAACAAGATATACAGTCACTGATCTACAAGCAGGTGAAGAATACAAATTCCGAGTTAGTGCTATCAATGGTGCTGGAAAAGGCGACAGCTGTGAAGTGACTGGCACAATTAAAGCAGTTGACCGGTTAACAGCTCCTGAGTTAGACATAGATGCAAACTTCAAACAGACTCATGTTGTTAGAGCTGGGGCCAGTATTCGCCTCTTCATTGCCTACCAAGGTAGACCTACTCCTACAGCTGTGTGGAGCAAACCAGACTCTAACCTTAGCCTTCGGGCTGATATCCATACAACAGATTCCTTCAGCACCCTCACTGTGGAAAACTGCAACAGAAATGATGCAGGGAAATATACCCTTACTGTGGAAAACAACAGTGGTAGTAAGTCAATCACATTCACCGTGAAAGTGCTAGACACTCCAGGCCCACCTGGCCCAATTACCTTCAAAGATGTGACCCGGGGATCTGCTACATTGATGTGGGATGCCCCTCTTCTTGACGGTGGTGCCCGAATCCATCATTATGTGGTAGAGAAACGAGAGGCAAGTCGCCGTAGTTGGCAGGTTATCAGTGAAAAATGCACTCGTCAGATCTTCAAGGTCAATGACCTGGCCGAAGGTGTTCCGTACTATTTCCGTGTTTCTGCAGTAAATGAGTATGGTGTTGGTGAGCCCTATGAAATGCCAGAACCAATTGTAGCCACAGAACAGCCTGCTCCACCTAGGAGACTTGATGTTGTTGATACTAGCAAATCCTCCGCAGTCTTAGCTTGGCTTAAACCTGACCACGATGGAGGCAGCCGGATCACTGGCTACCTGCTTGAAATGAGACAAAAGGGATCTGACTTCTGGGTTGAAGCTGGTCACACCAAACAGCTAACTTTCACAGTAGAGCGTCTTGTTGAGAAAACTGAATATGAATTCCGTGTGAAGGCCAAGAATGATGCTGGCTATAGTGAACCCAGAGAAGCCTTCTCTTCTGTCATCATTAAGGAGCCTCAAATCGAGCCCACTGCTGACCTCACTGGAATTACCAATCAGCTTATAACTTGCAAAGCAGGAAGCCCATTTACCATTGACGTACCAATCAGTGGTCGTCCTGCCCCCAAAGTAACATGGAAACTGGAAGAAATGAGACTTAAAGAGACAGATCGAGTGAGCATTACAACAACAAAAGACAGAACCACACTGACTGTAAAGGACAGCATGAGAGGTGACTCTGGAAGATACTTCTTGACCCTGGAAAATACAGCTGGTGTTAAAACATTTAGCGTCACAGTTGTGGTCATTGGAAGGCCAGGTCCAGTAACCGGCCCCATTGAGGTCTCATCTGTCTCAGCTGAATCGTGTGTCCTGTCATGGGGAGAACCTAAAGATGGAGGAGGCACTGAAATTACTAATTACATAGTTGAAAAGCGTGAATCGGGTACAACAGCTTGGCAGCTTGTCAATTCCAGTGTCAAGCGCACTCAAATTAAAGTCACTCATCTCACAAAATACATGGAATATTCTTTCCGTGTCAGTTCAGAGAACAGATTTGGTGTCAGCAAACCTCTAGAATCAGCACCAATAATTGCTGAACATCCATTTG
>TTN-216,ENSE00003810611,1,303,651338,651640,TCCCACCAAGCGCTCCTACCAGACCTGAGGTCTACCATGTGTCTGCCAATGCCATGTCTATTCGTTGGGAAGAACCCTACCACGATGGTGGCAGTAAAATCATTGGCTACTGGGTTGAGAAGAAAGAACGTAATACAATTCTTTGGGTGAAAGAAAACAAAGTGCCATGCTTAGAGTGCAACTACAAAGTAACTGGTTTAGTAGAAGGACTGGAATATCAGTTCAGAACTTATGCACTCAATGCTGCAGGTGTTAGCAAGGCCAGCGAAGCTTCAAGACCTATAATGGCTCAAAATCCAGTTG
>TTN-216,ENSE00003803222,1,306,651641,651946,ATGCACCAGGCAGACCAGAGGTGACAGATGTCACAAGATCAACAGTATCACTGATTTGGTCTGCCCCAGCGTATGATGGAGGCAGCAAGGTTGTGGGCTACATCATAGAGCGTAAGCCAGTCAGTGAGGTAGGAGATGGTCGCTGGCTGAAGTGCAACTACACCATTGTATCTGACAATTTCTTCACCGTGACTGCTCTCAGTGAAGGAGACACTTATGAGTTCCGTGTGTTAGCCAAGAATGCAGCAGGCGTAATTAGCAAAGGGTCTGAATCTACAGGCCCTGTCACTTGCCGAGATGAATACG
>TTN-216,ENSE00003801213,1,291,651947,652237,CTCCACCCAAAGCCGAACTGGATGCCCGATTACACGGTGATCTGGTTACCATCAGAGCAGGTTCTGATCTTGTTCTGGATGCTGCAGTTGGTGGCAAACCTGAACCCAAAATTATCTGGACCAAAGGAGACAAGGAGCTAGATCTCTGTGAAAAAGTCTCTTTGCAGTATACTGGCAAACGAGCAACTGCTGTGATCAAGTTCTGTGACAGAAGTGACAGTGGAAAATACACTTTAACAGTGAAAAATGCCAGCGGGACCAAGGCCGTGTCTGTCATGGTCAAAGTGCTTG
>TTN-216,ENSE00003809128,1,297,652238,652534,ATTCCCCTGGCCCATGTGGAAAGCTCACCGTCAGCAGAGTAACACAGGAGAAGTGCACTTTAGCCTGGAGCCTTCCGCAGGAAGACGGAGGAGCAGAAATCACTCACTACATCGTGGAAAGACGCGAGACTAGCAGGCTCAACTGGGTGATTGTTGAAGGCGAATGCCCAACCCTATCCTATGTCGTTACCAGGCTCATCAAGAACAATGAGTACATATTCCGAGTGAGGGCAGTAAACAAATATGGCCCTGGTGTGCCTGTTGAATCAGAGCCAATTGTAGCCAGAAACTCATTCA
>TTN-216,ENSE00003803385,1,306,652535,652840,CTATTCCATCACCACCCGGCATACCTGAAGAAGTTGGGACTGGCAAAGAGCATATCATCATTCAGTGGACAAAACCTGAATCTGATGGTGGCAATGAAATCAGCAACTACCTAGTAGACAAACGTGAGAAGAAGAGCCTGCGCTGGACACGTGTCAACAAAGACTATGTGGTGTATGATACCAGGCTGAAGGTGACCAGCCTGATGGAGGGTTGTGATTACCAGTTCCGGGTGACCGCAGTGAATGCAGCTGGTAACAGTGAGCCCAGCGAAGCTTCCAACTTCATCTCATGCAGAGAACCATCAT
>TTN-216,ENSE00003807140,1,306,652841,653146,ATACCCCTGGACCACCTTCTGCTCCAAGAGTTGTGGATACCACCAAACACAGCATTAGTTTGGCATGGACCAAACCCATGTACGATGGTGGTACTGACATTGTAGGATATGTTCTGGAAATGCAAGAGAAGGACACTGATCAGTGGTACCGAGTGCATACCAATGCCACAATAAGAAATACTGAATTCACTGTGCCAGACCTTAAAATGGGCCAGAAATATTCCTTCAGAGTTGCTGCCGTGAACGTGAAGGGTATGAGCGAATACAGCGAATCAATTGCTGAAATTGAGCCCGTGGAAAGAATAG
>TTN-216,ENSE00003809946,1,282,653147,653428,AAATACCAGATCTTGAGCTTGCAGATGATCTAAAGAAGACTGTGACCATCAGGGCTGGGGCCTCCTTGCGCTTGATGGTGTCTGTATCTGGAAGACCACCTCCTGTCATAACGTGGAGCAAGCAGGGCATTGACCTTGCAAGCCGGGCAATTATTGACACCACTGAGAGCTACTCATTGCTAATAGTGGACAAAGTTAATCGGTACGATGCTGGAAAATACACAATTGAAGCTGAAAACCAATCTGGCAAGAAATCAGCAACAGTCCTTGTTAAAGTCTATG
>TTN-216,ENSE00003810384,1,594,653429,654022,ATACTCCTGGTCCCTGTCCTTCAGTGAAAGTTAAGGAAGTATCAAGAGATTCTGTGACTATAACTTGGGAAATTCCCACGATTGATGGTGGAGCTCCAGTCAACAATTACATCGTTGAGAAGCGTGAAGCTGCTATGAGAGCATTCAAAACAGTAACTACCAAATGCAGCAAGACACTTTACAGAATTTCTGGACTTGTAGAAGGAACCATGTACTATTTCAGAGTGCTGCCAGAAAATATTTATGGCATTGGAGAACCTTGTGAAACATCTGATGCAGTACTGGTCTCAGAAGTGCCTTTGGTGCCTGCAAAGCTAGAAGTGGTCGATGTCACCAAATCCACTGTTACCCTTGCCTGGGAAAAACCACTCTACGATGGTGGTAGCCGACTCACTGGATATGTTCTCGAGGCCTGCAAAGCTGGCACAGAGAGATGGATGAAGGTTGTCACCTTAAAACCCACAGTCCTAGAGCACACTGTTACTTCCTTAAATGAAGGTGAACAATACTTATTTAGAATAAGGGCACAAAATGAGAAAGGTGTGTCAGAACCAAGAGAGACTGTCACAGCCGTGACTGTACAAGACCTCAGAG
>TTN-216,ENSE00003802641,1,288,654023,654310,TGTTGCCAACAATCGATCTTTCTACAATGCCTCAGAAGACCATCCATGTCCCAGCTGGCAGACCAGTAGAGCTGGTGATACCTATTGCTGGCCGTCCACCTCCTGCTGCTTCCTGGTTCTTTGCTGGTTCTAAACTGAGAGAATCAGAGCGTGTCACAGTTGAAACTCACACTAAAGTAGCTAAATTAACCATCCGTGAAACCACTATCAGAGATACTGGAGAATACACACTTGAATTGAAGAATGTTACCGGAACTACTTCAGAAACCATTAAAGTTATCATTCTTG
>TTN-216,ENSE00003806194,1,300,654311,654610,ACAAGCCTGGTCCACCAACAGGACCTATTAAGATTGATGAAATTGATGCTACATCAATTACCATTTCCTGGGAACCACCTGAATTGGACGGTGGTGCTCCACTGAGTGGTTATGTGGTAGAACAACGTGACGCTCATCGTCCAGGATGGCTGCCCGTTTCTGAATCAGTGACTAGGTCCACGTTTAAGTTTACCAGACTCACCGAAGGAAATGAGTATGTGTTCCGTGTGGCTGCAACAAACCGCTTCGGGATTGGCTCTTACTTGCAGTCTGAGGTCATAGAGTGTCGCAGCAGCATCC
>TTN-216,ENSE00003805894,1,303,654611,654913,GTATTCCTGGACCCCCAGAAACATTACAGATATTTGATGTTTCCCGTGATGGCATGACACTTACTTGGTACCCACCAGAGGATGACGGTGGCTCCCAAGTGACTGGATATATTGTGGAGCGCAAAGAAGTGAGAGCAGATCGATGGGTCCGTGTAAATAAAGTACCTGTGACAATGACACGGTACCGCTCCACTGGCCTTACTGAAGGCTTAGAATATGAACACCGTGTCACAGCCATTAATGCAAGAGGGTCTGGGAAACCAAGTCGTCCTTCCAAACCCATCGTTGCCATGGATCCAATTG
>TTN-216,ENSE00003808643,1,303,654914,655216,CTCCTCCAGGAAAGCCACAAAACCCAAGAGTTACTGATACAACAAGGACATCAGTCTCCCTGGCCTGGAGTGTTCCAGAAGATGAAGGAGGATCTAAAGTCACAGGCTACTTGATTGAAATGCAAAAAGTAGATCAACATGAATGGACCAAGTGTAACACCACTCCAACCAAGATTCGAGAGTATACTCTAACACACCTACCTCAGGGTGCAGAATACAGGTTCCGCGTCCTAGCTTGTAATGCTGGTGGACCTGGTGAGCCTGCTGAGGTACCAGGAACAGTCAAAGTCACTGAAATGCTTG
>TTN-216,ENSE00003805779,1,585,655217,655801,AATATCCTGATTATGAACTTGATGAAAGATACCAAGAAGGTATCTTTGTAAGGCAAGGTGGCGTCATCAGACTTACCATACCAATCAAAGGAAAACCATTCCCAATATGTAAATGGACCAAGGAAGGCCAGGATATTAGTAAGCGTGCCATGATTGCAACATCTGAAACACACACTGAGCTTGTGATCAAAGAAGCAGACAGGGGTGATTCTGGCACTTATGACCTGGTTCTGGAAAATAAATGTGGCAAGAAGGCTGTCTACATCAAGGTCAGGGTGATAGGAAGTCCCAACAGTCCAGAAGGGCCACTGGAATATGATGACATCCAAGTCCGCTCTGTGAGGGTCAGCTGGAGACCTCCTGCTGATGATGGTGGTGCTGACATCTTAGGCTACATCCTCGAGAGACGAGAAGTGCCTAAAGCCGCCTGGTATACCATTGATTCCAGAGTCCGAGGTACATCTCTGGTGGTAAAAGGCCTCAAAGAGAATGTAGAATACCATTTCCGTGTTTCAGCAGAAAACCAGTTTGGCATAAGCAAACCCTTGAAATCTGAGGAACCAGTCACACCAAAAACACCATTGA
>TTN-216,ENSE00003806836,1,306,655802,656107,ATCCTCCAGAACCTCCAAGCAATCCTCCAGAAGTACTCGATGTAACCAAGAGTTCTGTTAGCTTGTCCTGGTCCCGGCCCAAAGATGATGGTGGTTCTAGAGTCACAGGCTACTACATCGAACGCAAAGAGACATCCACTGACAAGTGGGTCAGACACAACAAGACTCAGATCACCACCACAATGTACACTGTCACAGGGCTTGTTCCCGATGCTGAGTATCAGTTCCGCATCATCGCACAGAATGATGTTGGCCTGAGTGAGACCAGCCCTGCTTCTGAACCAGTTGTTTGCAAAGATCCATTTG
>TTN-216,ENSE00003810204,1,300,656108,656407,ATAAACCAAGCCAACCAGGAGAACTTGAGATTCTTTCAATATCCAAAGATAGTGTCACTCTACAGTGGGAGAAACCTGAATGTGATGGTGGTAAAGAAATTCTTGGATACTGGGTTGAATATAGACAGTCTGGAGACAGTGCCTGGAAGAAGAGCAATAAGGAACGTATTAAGGACAAGCAATTCACAATAGGAGGTTTGCTGGAAGCTACTGAGTATGAATTCAGGGTTTTTGCTGAGAATGAGACTGGGCTGAGCAGACCTCGCAGAACTGCTATGTCTATAAAGACTAAACTCACAT
>TTN-216,ENSE00003805486,1,576,656408,656983,CTGGAGAGGCCCCAGGAATACGCAAAGAAATGAAGGATGTTACCACAAAATTGGGTGAAGCTGCTCAACTCTCATGCCAGATTGTTGGAAGGCCTCTTCCTGACATTAAATGGTACAGATTTGGTAAAGAGCTCATACAAAGCCGGAAATACAAAATGTCTTCAGATGGACGCACACACACTCTTACAGTAATGACAGAGGAACAGGAAGATGAAGGTGTTTATACCTGCATAGCCACCAATGAGGTTGGAGAAGTAGAAACCAGTAGTAAGCTTCTCCTGCAAGCAACACCGCAGTTCCATCCTGGTTACCCACTGAAAGAGAAATATTATGGAGCTGTGGGTTCCACACTTCGGCTTCATGTTATGTACATTGGTCGTCCAGTACCTGCCATGACTTGGTTCCATGGTCAGAAACTTTTGCAAAACTCAGAAAACATTACTATTGAAAACACTGAGCACTATACTCATCTTGTCATGAAGAATGTCCAACGTAAGACTCATGCTGGGAAATACAAAGTCCAGCTCAGCAATGTTTTTGGAACAGTTGATGCCATCCTTGATGTGGAAATACAAG
>TTN-216,ENSE00003801306,1,306,656984,657289,ATAAACCAGACAAACCTACAGGACCAATTGTGATCGAAGCTCTATTGAAGAACTCCGCAGTGATCAGCTGGAAACCACCCGCAGATGACGGAGGCTCCTGGATCACCAACTATGTGGTGGAAAAATGTGAGGCCAAGGAGGGGGCTGAATGGCAATTGGTGTCTTCAGCCATCTCAGTGACAACCTGTAGAATTGTGAACCTCACAGAAAATGCTGGCTATTACTTCCGGGTTTCAGCTCAGAACACTTTCGGCATCAGTGACCCTCTAGAAGTGTCCTCAGTTGTGATCATTAAGAGTCCATTTG
>TTN-216,ENSE00003808123,1,594,657290,657883,AAAAGCCAGGTGCTCCTGGCAAACCAACTATTACTGCTGTCACAAAAGATTCTTGTGTTGTGGCCTGGAAGCCACCTGCCAGTGATGGAGGTGCAAAGATTAGAAATTACTACCTTGAGAAGCGTGAGAAGAAGCAGAATAAATGGATTTCTGTGACAACAGAAGAAATTCGAGAAACTGTCTTTTCAGTGAAAAACCTTATTGAAGGTCTTGAATACGAGTTTCGTGTGAAATGTGAAAATCTAGGTGGGGAAAGTGAATGGAGTGAAATATCAGAACCCATCACTCCCAAATCTGATGTCCCAATTCAGGCACCACACTTTAAAGAGGAACTGAGAAATCTAAATGTCAGATATCAGAGCAATGCTACCTTGGTCTGCAAAGTGACTGGTCATCCAAAACCTATCGTCAAATGGTACAGACAAGGCAAAGAAATCATTGCAGATGGATTAAAATATAGGATTCAAGAATTTAAGGGTGGCTACCACCAGCTCATCATTGCAAGTGTCACAGATGATGATGCCACAGTTTACCAAGTCAGAGCTACCAACCAAGGGGGATCTGTGTCTGGCACTGCCTCCTTGGAAGTGGAAG
>TTN-216,ENSE00003808212,1,5609,657884,663492,TTCCAGCTAAGATACACTTACCTAAAACTCTTGAAGGCATGGGAGCAGTTCATGCTCTCCGAGGTGAAGTGGTCAGCATCAAGATTCCTTTCAGTGGCAAACCAGATCCTGTGATCACCTGGCAGAAAGGACAAGATCTCATTGACAATAATGGCCACTACCAAGTTATTGTCACAAGATCCTTCACATCACTTGTTTTCCCCAATGGGGTAGAGAGAAAAGATGCTGGTTTCTATGTGGTCTGTGCTAAAAACAGATTTGGAATTGATCAGAAGACAGTTGAACTGGATGTGGCTGATGTTCCTGACCCACCCAGAGGAGTCAAAGTTAGTGATGTCTCACGAGATTCTGTCAACTTAACATGGACTGAGCCAGCCTCTGATGGTGGCAGCAAAATCACCAACTACATTGTTGAAAAATGTGCAACTACTGCAGAAAGATGGCTCCGTGTAGGACAGGCCCGAGAAACACGTTATACCGTGATCAACTTATTTGGAAAAACAAGTTACCAGTTCCGGGTAATAGCTGAAAATAAATTTGGTCTGAGCAAGCCTTCAGAGCCTTCAGAACCAACCATAACCAAAGAAGATAAGACCAGAGCTATGAACTATGATGAAGAGGTAGATGAAACCAGGGAAGTCTCCATGACTAAAGCATCTCACTCTTCAACCAAGGAACTCTATGAGAAATATATGATTGCTGAAGATCTTGGGCGTGGTGAGTTTGGAATTGTCCATCGTTGTGTTGAAACATCCTCAAAGAAGACATACATGGCCAAATTTGTTAAAGTCAAAGGGACTGATCAGGTTTTGGTAAAGAAGGAAATTTCCATTCTGAATATTGCTAGGCATAGAAACATCTTACACCTCCATGAATCATTTGAAAGCATGGAAGAATTAGTTATGATCTTTGAGTTTATATCAGGACTTGACATATTTGAGCGCATTAACACAAGTGCTTTTGAACTTAATGAAAGAGAAATTGTAAGTTATGTTCACCAGGTCTGTGAAGCACTTCAGTTTTTACACAGTCATAATATTGGACACTTTGACATTAGACCAGAAAATATCATTTACCAAACCAGAAGAAGCTCTACCATTAAAATCATAGAATTTGGTCAAGCCCGTCAGCTGAAACCAGGGGACAACTTCAGGCTTCTATTCACTGCCCCAGAATACTATGCACCTGAAGTCCACCAGCATGATGTTGTCAGCACAGCCACAGACATGTGGTCACTTGGAACACTGGTATATGTGCTATTGAGTGGTATCAACCCATTCCTGGCTGAAACTAACCAACAGATCATTGAGAATATCATGAATGCTGAATATACTTTCGATGAGGAAGCATTCAAAGAGATTAGCATTGAAGCCATGGATTTTGTTGACCGGTTGTTAGTGAAAGAGAGGAAATCTCGCATGACAGCATCGGAGGCTCTCCAGCACCCATGGTTGAAGCAGAAGATAGAAAGAGTCAGTACTAAAGTTATCAGAACATTAAAACACCGGCGTTATTACCACACCCTGATCAAGAAAGACCTCAACATGGTTGTGTCAGCAGCCCGGATCTCCTGTGGTGGTGCAATTCGATCTCAGAAGGGAGTGAGTGTTGCTAAAGTTAAAGTGGCATCCATTGAAATTGGCCCAGTTTCTGGGCAGATAATGCATGCAGTTGGTGAAGAAGGAGGACATGTCAAATATGTATGCAAAATTGAAAATTATGATCAGTCTACCCAAGTGACTTGGTACTTTGGCGTCCGACAGCTGGAGAACAGTGAGAAATACGAAATCACCTACGAAGATGGAGTGGCCATCCTCTATGTCAAAGACATTACCAAATTAGATGATGGTACCTACAGATGCAAAGTAGTCAATGACTATGGTGAAGACAGTTCTTATGCAGAGCTATTTGTTAAAGGTGTGAGAGAAGTCTATGACTATTACTGCCGTAGAACCATGAAGAAAATTAAGCGCAGAACAGACACAATGAGACTCCTGGAAAGGCCACCAGAATTTACCCTGCCTCTCTATAATAAGACAGCTTATGTAGGTGAAAATGTCCGGTTTGGAGTAACTATAACTGTCCACCCAGAGCCTCATGTAACATGGTATAAATCAGGTCAGAAAATCAAACCAGGTGACAATGACAAGAAGTACACATTTGAGTCAGACAAGGGTCTTTACCAATTAACAATCAACAGTGTCACTACAGATGATGACGCTGAATATACTGTTGTGGCAAGGAACAAATATGGTGAAGACAGCTGTAAAGCAAAGCTGACAGTAACCCTACACCCACCTCCAACAGATAGTACCTTAAGACCCATGTTCAAAAGGTTACTGGCAAATGCAGAATGCCAAGAAGGCCAAAGTGTCTGCTTTGAGATCAGAGTGTCTGGCATCCCCCCACCAACATTAAAATGGGAGAAAGATGGTCAGCCACTGTCCCTCGGGCCTAACATTGAAATTATCCATGAAGGCTTGGATTATTATGCTCTGCACATCAGGGACACTTTGCCTGAAGACACGGGTTATTATAGAGTCACAGCCACTAACACAGCTGGGTCCACCAGCTGCCAGGCTCACCTACAAGTGGAACGCCTGAGGTACAAGAAACAGGAATTCAAGAGTAAGGAGGAGCATGAGCGACACGTACAAAAACAAATTGACAAAACCCTCAGAATGGCTGAAATTCTTTCTGGAACTGAAAGTGTACCACTGACACAGGTAGCTAAAGAGGCTCTGAGAGAAGCTGCTGTCCTTTATAAACCGGCTGTAAGCACCAAGACTGTAAAAGGGGAATTCAGACTTGAGATAGAAGAAAAGAAGGAGGAGAGAAAACTCCGGATGCCTTATGATGTACCAGAGCCACGCAAGTATAAGCAGACTACCATAGAAGAAGACCAACGCATCAAGCAGTTCGTGCCCATGTCTGACATGAAGTGGTATAAAAAGATACGTGATCAGTATGAAATGCCTGGGAAACTTGACAGAGTTGTACAGAAACGACCCAAGCGCATCCGCCTTTCAAGATGGGAACAGTTCTATGTGATGCCTCTTCCACGCATTACAGATCAATACAGACCTAAATGGCGTATTCCTAAACTGTCCCAAGATGATCTTGAGATAGTGAGACCAGCCCGCCGGCGTACACCTTCTCCTGATTATGACTTTTACTACCGACCTAGAAGACGTTCTCTTGGGGACATCTCTGATGAAGAATTACTCCTCCCCATTGATGACTACTTAGCAATGAAAAGAACAGAGGAAGAGAGGCTGCGTCTTGAAGAAGAGCTTGAGTTAGGTTTTTCAGCTTCACCCCCAAGTCGAAGCCCTCCACACTTTGAGCTTTCTAGCCTACGTTACTCTTCACCACAAGCTCATGTCAAGGTGGAGGAAACAAGAAAAGACTTCAGGTATTCAACCTATCACATCCCAACGAAGGCTGAAGCTAGTACAAGTTATGCAGAACTGAGGGAACGGCATGCCCAGGCTGCGTACAGACAGCCAAAGCAACGGCAAAGAATCATGGCTGAGAGGGAGGATGAAGAGTTGCTTCGCCCAGTTACGACCACCCAGCATCTCTCAGAATACAAAAGCGAACTTGACTTCATGTCAAAGGAGGAAAAGTCTAGAAAGAAATCAAGGCGACAAAGAGAAGTGACAGAAATAACAGAAATTGAGGAAGAATACGAAATCTCAAAACATGCTCAAAGAGAATCATCCTCATCTGCGTCTAGACTACTGAGACGACGGCGCTCCCTGTCTCCAACTTATATTGAGTTAATGAGGCCAGTGTCTGAGCTGATCCGGTCACGTCCACAACCGGCTGAGGAATACGAAGATGACACAGAAAGAAGGTCACCTACTCCAGAGAGAACTCGCCCACGATCCCCCAGCCCTGTGTCTAGTGAGAGATCACTCTCGAGATTTGAGAGGTCTGCAAGATTTGATATCTTTTCCAGGTATGAGTCCATGAAAGCTGCTTTAAAAACTCAGAAGACATCAGAAAGGAAGTATGAAGTTTTGAGTCAGCAGCCTTTCACACTGGACCATGCCCCTCGAATCACACTGAGAATGCGCTCGCACAGGGTACCATGTGGCCAAAATACACGTTTTATTTTAAATGTTCAGTCTAAGCCAACTGCCGAGGTTAAATGGTACCACAATGGTGTGGAACTCCAAGAAAGCAGTAAGATTCATTACACCAACACGAGTGGAGTCCTCACCCTGGAAATTCTGGACTGTCATACTGATGACAGTGGAACCTACCGTGCTGTGTGCACCAACTACAAGGGCGAAGCTTCTGACTATGCAACGTTGGACGTGACAGGAGGGGATTATACCACCTATGCTTCCCAACGCAGAGATGAAGAGGTCCCCAGATCTGTTTTCCCTGAGCTGACAAGAACAGAGGCGTATGCTGTTTCATCATTTAAGAAAACATCTGAGATGGAAGCTTCGTCTTCTGTCAGGGAAGTGAAATCACAGATGACGGAGACAAGGGAAAGTCTCTCCTCATATGAACACTCTGCATCTGCAGAAATGAAAAGTGCTGCATTAGAAGAAAAGTCACTGGAAGAAAAATCCACAACCAGAAAGATCAAGACGACTTTGGCAGCAAGAATTCTAACAAAGCCACGGTCCATGACCGTCTACGAGGGCGAGTCTGCAAGGTTTTCTTGTGACACCGATGGTGAGCCGGTACCAACTGTGACCTGGCTGCGTAAAGGACAAGTGCTAAGTACTTCTGCCCGCCACCAAGTGACCACCACAAAGTACAAATCAACCTTTGAGATCTCTTCAGTCCAGGCTTCCGATGAGGGCAATTACAGCGTGGTGGTAGAAAACAGTGAAGGGAAACAAGAAGCAGAGTTCACTCTGACTATTCAAAAGGCCAGGGTAACTGAAAAGGCTGTGACATCACCACCAAGAGTCAAATCCCCAGAGCCTCGGGTGAAATCCCCAGAAGCAGTTAAGTCTCCAAAACGAGTGAAATCTCCAGAACCTTCTCACCCGAAAGCCGTATCACCCACAGAGACAAAACCAACACCAACAGAGAAAGTTCAGCACCTCCCAGTCTCTGCCCCACCAAAGATTACTCAGTTCCTGAAAGCAGAAGCTTCTAAAGAGATTGCAAAACTGACCTGTGTGGTTGAAAGCAGTGTATTAAGGGCAAAAGAGGTCACCTGGTATAAAGATGGCAAGAAACTGAAGGAAAATGGGCATTTCCAGTTTCATTATTCAGCAGATGGTACCTATGAGCTCAAAATCAATAACCTCACTGAATCTGATCAAGGAGAATATGTTTGTGAGATTTCTGGTGAAGGTGGAACGTCTAAAACCAACTTACAATTTATGGGGCAAGCCTTTAAGAGTATCCATGAGAAGGTATCAAAAATATCAGAAACTAAGAAATCAGATCAGAAAACCACTGAGTCAACAGTAACCAGAAAAACTGAACCAAAAGCTCCTGAACCAATTTCCTCAAAACCAGTAATTGTTACTGGGTTGCAGGATACAACTGTTTCTTCAGACAGTGTTGCTAAATTTGCAGTTAAGGCTACTGGAGAACCCCGGCCAACTGCCATCTGGACAAAAGATGGAAAG
>TTN-216,ENSE00003811220,1,157,663493,663649,GCCATTACACAAGGAGGTAAATATAAACTCTCTGAAGACAAGGGAGGGTTCTTCTTAGAAATTCATAAGACTGATACTTCTGACAGTGGACTTTATACTTGTACAGTAAAAAATTCAGCTGGATCTGTGTCCTCTAGCTGCAAATTAACAATAAAAG
>TTN-216,ENSE00003801641,1,692,663650,664341,CTATAAAAGATACTGAGGCACAGAAAGTCTCTACACAAAAGACTTCTGAAATTACACCTCAGAAGAAAGCTGTTGTCCAAGAGGAAATTTCCCAAAAAGCCCTAAGGTCTGAAGAAATTAAGATGTCAGAGGCAAAATCTCAAGAAAAGTTAGCCCTCAAAGAGGAAGCTTCAAAGGTTCTGATTTCTGAAGAAGTCAAGAAATCAGCAGCAACCTCCCTGGAAAAATCCATTGTCCATGAGGAAATCACTAAAACATCACAGGCATCAGAAGAAGTCAGAACTCATGCTGAGATTAAAGCATTTTCTACTCAGATGAGCATAAACGAAGGTCAAAGACTGGTTTTAAAAGCCAACATTGCTGGTGCCACTGATGTGAAATGGGTACTGAATGGCGTAGAGCTTACCAACTCTGAGGAGTACCGATATGGTGTCTCAGGCAGCGATCAGACCCTAACCATCAAGCAAGCCAGTCACAGAGATGAAGGAATCCTCACCTGCATAAGCAAAACCAAGGAAGGAATCGTCAAGTGTCAGTATGATTTGACACTGAGCAAAGAACTCTCAGATGCTCCAGCCTTCATCTCACAGCCTAGATCTCAAAATATTAATGAAGGACAAAATGTTCTCTTTACTTGTGAAATCAGTGGCGAGCCATCCCCTGAAATCGAATGGTTTAAAAACAACCTGCCA
>TTN-216,ENSE00003801638,1,154,664342,664495,ATTTCTATTTCTTCAAATGTCAGCATAAGCCGCTCCAGAAATGTATACTCCCTTGAAATCCGAAATGCATCAGTCAGCGACAGTGGAAAGTACACAATTAAGGCCAAAAATTTCCGTGGCCAGTGTTCAGCTACAGCTTCCTTAATGGTCCTTC
>TTN-216,ENSE00003805382,1,303,664496,664798,CTCTAGTTGAAGAACCTTCCAGAGAGGTAGTATTGAGAACAAGTGGTGACACAAGCTTGCAAGGAAGCTTCTCGTCTCAGTCAGTCCAAATGTCTGCCTCCAAGCAGGAGGCCTCCTTCAGCAGTTTCAGCAGCAGCAGTGCTAGCAGCATGACTGAGATGAAATTTGCAAGCATGTCTGCCCAAAGCATGTCCTCCATGCAAGAGTCCTTTGTAGAAATGAGTTCCAGCAGCTTTATGGGAATATCTAATATGACACAACTGGAAAGCTCAACTAGTAAAATGCTTAAAGCAGGCATAAGAG
>TTN-216,ENSE00003809884,1,1319,664799,666117,GAATTCCGCCTAAAATTGAAGCTCTTCCATCTGATATCAGCATTGATGAAGGCAAAGTTCTAACAGTAGCCTGTGCTTTCACGGGTGAGCCTACCCCAGAAGTAACATGGTCCTGTGGTGGAAGAAAAATCCACAGTCAAGAACAGGGGAGGTTCCACATTGAAAACACAGATGACCTGACAACCCTGATCATCATGGACGTACAGAAACAAGATGGTGGACTTTATACCCTGAGTTTAGGGAATGAATTTGGATCTGACTCTGCCACTGTGAATATACATATTCGATCCATTTAAGAGGGCCTGTGCCCTTATACTCTACACTCATTCTTAACTTTTCGCAAACGTTTCACACGGACTAATCTTTCTGAACTGTAAATATTTAAAGAAAAAAAAGTAGTTTTGTATCAACCTAAATGAGTCAAAGTTCAAAAATATTCATTTCAATCTTTTCATAATTGTTGACCTAAGAATATAATACATTTGCTAGTGACATGTACATACTGTATATAGCCGGATTAACGGTTATAAAGTTTTGTACCATTTATTTTATGACATTTTACAATGTAAGTTTTGAAACTAACTGTTGGTAGGAGAAAGTTTCTTATGGAACGAATACCCTGCTCAACATTTAATCAATCTTTGTGCCTCAACATACTGTTGATGTCTAAGTATGCCTCAGTGGGTTGAGAAAATCCCCATTGAAGATGTCCTGTCCACCTAAAAGAGAATGATGCTGTGCATATCACTTGATATGTGCACCAATACCTACTGAATCAGAAATGTAAGGCATTGGTGATGTTTGCATTTACCCTCCTGTAAGCAACACTTTAACGTCTTACATTTTCTCTGATGATGTCACACAAAATTATCATGACAAATATTACCAGAGCAAAGTGTAACGGCCAACACTTTGTTCGCTCATTTTACGCTGTCTCTGACATAAGGAGTGCCTGAATAGCTTGGAAAAGTAACATCTCCTGGCCATCCCTTCATTTAACCAAGCTATTCAAGTATTCCTATGCCAGAGCAGTGCCAACTCTTGGAGGTCCCAGAGTGCAGCCAATGCCTTTGTGTGGTAGTTCTAAATTTTAATTGCACCTGAAAAACCTGGGCACCTAAGCAATGAGCCACAGCAAAAAGTAAAGAACAACAACAAAATAAAGCTGTTGTTAAATTTTAAACAATATTACTAATTGCCCAAAATGTCAATTTGATGTAGTTCTTTTCATGCAAGTATAAATTCAATTGTTAGTTATAATTGTTGGACCTCCTTGAGATAGTAACAACAAAATAAAGCAAGCTATCTGCACCTCAAAA
>TTN-216,,0,2556,666118,668673,GTGAGCAGCAACTTTTCTTATTTTAATAGTAGAGTCACTTTCTTATTGATCTCTGGCTCTGGATTATTTGTGTGTGCTAAATGCCTATGTACAAGTGTTTGTATGACTATTTCTTGCCAGTGCTGACCCATTATTTAAATCTGCTTGTTAAATTCTATTTTAAAATGTCTGAACATTTTTCCTTAAAAAGTTGAAAGCTTTATTATATCAGCTAAATGATTCCATGATTCAAATTGTTTAAGTTCACTTAATATTCTAAAAGTTGAGGTCTGAAATGTTGAGAGAAATGTTTACTTCTTTTCTAGACTCTCTTTGCCTGTTGAGAATGTTCAAGGTTATATTACTCAATGATAAAGTTAAGCACACCAAGAATAGCTCTGATAAAATGCATGTGGTATCAGCTACACCCTGATGACTTTTTAAGGGAATCAACTGCTGAGGTATCAGTTGCAGGACAGTGACAGAACACTTGCCTGCTGTCAGTCAACCTTGGAGAGTTTAGGAGAGTTTATTTTAAGAGCATGACATTTTAGACGCATACCTTCAGCCCCAGTTAGACAAAGGCCTGTGAAGAGCAAGTGCTAAGGCAATAAAATTTACCTAGACAATAGGAATGTAAGATCAATTTAAGCTGGTTAATTGCAACATAGTTGGAGATTTGGAATAAAATGATATAATTGTTTTCTAAAATATTCAGAATCTCTTCATGCATTTTAACTCAGCACACAGTCCAATTATATATTTTGAGATAAATGTTGACACTAAGAAGGGTAAGAAATAATGTTTAAAGGAAAGGTTTCTTACTTCTAAATACACTTTGATTTCTCATCTTCCTAGAATTTGATTACTAATTGTCAATGCCTGTAAATACATAGATATATAATTAGGTATTCTATGTCTAAGAGGACAGCTATTTTTAGATATACTAACTTATAAACAGACAAAGTTAGACACAGAAAGTTGTTCATCCCAAAGATAATATGCTACAAAAAGGAGTTTCTGACAAAAAAAATTTATGAAAGCTTTTGGATATTATCTGATTTTTCCAAATATAAATTTTATTGTCTCAGAGAATGCTGGTTTCATTTTTTTAACTAAGTAGAAGGTTACAGTAAGGAACAGAATTATCACTAAGAAGATTATTGCTCCATGAAGTTTTAGTAAACAAAGAATTTAATGAAAAATAGTAATGAAGTGATTGACAATTCAGAAATGTTCTATTTCAGAACAGAATAGTCATGTTGAATAATTAGGTATTTATGCATCAGAAAATTCTTCACATAATGTCTCTGAAACTGATAGGCAAAGTACTTTCTTGCACTTAACAAAATGACTTAACTGCAAATTTTATATTCGTTTCTTTGATGTTGAATATTTTACTTTATGAAAGCATAGGCCTTTTCACTTCATCTACATTTTACACCAGCCTTCCATTATTCAAAGTTTGCAAATTGTTCCATATTAAGAACTCAAGCCAGCATTTTTCTTTCAGAACTATAATAAACTTTGGCCTGTTCACTAAAATTTAAATTTTTCTGAATATTTACTTCAGCAGTAACAACATTTACTGCACAGTTACAGTATGAAGAAATGTTAAGAAATAGAAAGCACCGTATGCCGTCTACAAAAAGCTTGCATATTTGATAAGGCTTGCCAAAGCTTCTCCAGTCAGGAAAGAGATTACAAAGTTCAGATTTTTACTTCTGGCAACTATTTTAAGTAATCAGATAATGTCTGAATCAATGTCAACTTTATAAATATAGAGTGAACGAAAAATATTGGGGAGAAGGAAAATTTTTAAAATAATTTTCACTTACTAAGCTGATGCAGAGGTTTATTTATTTTAATTTTTTTTTTTTTTTTTTTTTGAGACAGAGTCTCATTCTGTCACCCAGGCTGGAGTGTGGTGGCACCATCTTTGCTCACTGCAACCTCCACCTCCTGGGTTTAAGCAATTCTCATGCCTCAGCCTCCCAAGTAGCTGGGACTACAGACATGGGCCACCACGCCTGGCTAATTTTTGTATTTGTAGTAGAGACAGGGGTTTCACCATGTTAGCCAAACTGGTCTCAAACTCCTGACCTCAAGTAATCCTCCCGCCTCGGCCTCCTAAAGTGCTGGGATTACCAGCATGAGCCACCACGCCAGGCCCAGAGGTTTATTTTACATTTATCACATGTCTTGTCTCTCTAATTACACTTCACTAACCCTGCATTGCTGTGGTTTTCTTCTTCAACTCTGAACCTGGTTTTCCACCATTGGTAAGACTGTATATTCCCTCTTTGACCACTAGGGTTCATTCCTTGTTCTGTTTGGCTAATACTTTTTTCCATTTCCCCTTACACTTGCTACTTTGGGTTAGGCTTTAAGTCAACTCAATGATGAACTATGCAAAACTGTTCAAGCCACAAAAGAGAAGACCTGCCCATCACTCTAGGCCCACAGATGACCTATGGAGCAATCCATTTGGAGAAACGTGTGTCTCTGCTATCTGCAAAGCAGCTCCAGAGTGACCCTTAGCTGGGACACCCTAATTTATTTTCTCTTCTTTTTCAG
>TTN-216,,0,2210,668674,670883,GTAAGCTCACACATTCACACTTTTGTTTTTTTTTCCTTTGCCTCCTCTCCAGTAAGTTAACGTTGCTGCAGGACTTGACGCCAAGTTTAAGCCCTGCTTTCACTTCGGAAAATTAGTCCAACACTATGGAAAGGTCATTTTAAGGGTATACCATTCACAGAGTACTGACAAAATCTGACAATATAATGGCTTGAAATGTTTTATTCATATTTATTATTCCACAAAGCAAAAATAATTAGTGTTGGATTAAAATTGCCGTTAGAATCCAGCAACTAAATAGGACCAAATTTAGTCATTCTATATTTGGGCTCAGCTGCAGAGCCAGACTGGAAGCCAAGAACTCAAGCCCAATAGAAGCCAGCCACAGAGCCATGGGGTAGGCAGTCTGGGCTGCCTGCTCTGGACACCTGAACTTCAGTTGGTTCACACGCAAAATAACAGTGCATCTAATTTTCCTCAGAGGCAGAGCTGTTCAGTAATTAACCAACTCCTCATTATTTTATTATTTTATTTTCAATCTTTATTGAGTGATTCTAATGAATTAAAAGACTTTCCAATCGTTTTGAAATGACAGAAAATAATATGCTTCTCGGGTGTCTCTATTTAAAAGGAAGCAAACACTAACCCTAGAATTTTATCTGAAAGGAAGTTCATCTCTTTTTTGCCTTCTTTTTCTTCCTCATAACTCAGTTTATGGATGGTTCAAAAAAATGCATGGTATCATCTTATGAAAAAATGGAGAGTAGTGTATGAACTATATTGTAAATAATTTTAAAATTAATCAATATTTTCTCTTTCTGTAGTATTGTAACGAGCCATGTAAGATGGATACGGATTAAAAAAAATCATGCTTAATTCTTAATTTAGTGCACTTCCATGGTTCATTGCCCACTTCTTTTTTAAAATTTTATGGCTTATAATAAAGATATAAAATAAAATTTCTTTTTTTCTCTTTTTTTCTATTATATGCACCAATCTTATTCATAACTGGATAATACTTTCTTTTACATTGTACAAATATCATATAATCATTGCTTATTTTCTATTGTACATATATAGACCAATGAAATTCCCTTTTCATTGGTCTATATATGTACAATAGAAAATAAGTCTTACCGACTTCCAAATAATTTACCTATTTATCTGGTAACACTCAGTAACTTCTGAACTGAGCAGAACACATATGACTTCAGTGGGAATTTGCCTCCTTGAGAAGTAGTGGAATCTGGCTACTTCATATCTTCTTGTTCCTTCAAACTATATGCAAATAAATTATTACAAAGACACTACTGAAAATATCCAATACCCATAAATCAGTCCAATAAACTATTTAATTGGCCATAGTGGGAGATGGGCTAATGTATAAACAACAAAATAGACTTTCTCTAGATTATCTTTACCTACCAGCGTAAGTAGATAGAGCATCAACCTTTATGCCAAGTGTGAAATAAATCATGCCCTGAATGTGCCTCGTACATTCTCAATGTACAGAGTTTTAATATATTTAAAACATCAAACCATGGACATGTAGTTCTTGGCTCTACAATTTATGGCAGATAAAGAGAATTTGGCTTTCTACCTGCAATTCCAATGATCCATGTTGTTCTGGAAGACTAGGTTTGGATTAGTCTCTTATGAGAAATTGCTTGTCCATGTTACAATGTTTTTACTGATTGCACTTGTGAAAGCAGAAGAGTCCAAGAAGACAGTGTCCCTGTAACCACAGAGGAGGGAGGAGGGCATGCCTCCTGGGCTTGTCAGGCAGAAACTGGAGATCAGTTTGCTGCTTTTGTTCTTCACTTGCTCTCAAAGAGGACAACAATCACTCTTTATTTCAAATTTTCCTTGGTTCTTCATTTTTATAAGTCCCTTTCATGATTTTAATGTTGTCTATTAAATTGCATCAGATAGAGCCCTAGGCAGGCAGGCAGGAGATGGAAATTCTAGTCCCCTCTGTGTCACTGCTAGCTGAAGGACCTTGGAAAAATCATTAGGCCTCTTTTGGTCTCAGTTTCCTCCCTTCCTGCCTTCCTAATGGTCTGCAGGTTTACACACTGATCATGCAACTGTAGGGTTTTCCCTATCATTAAGTGGCATTCCATGCTGGAAAGCTTTTACAGATTCGGACAAGGCAGTGAACATGATGGGACAGAGCAGAGGACTTTGTGGTGCCCATTCAAACATAAAGGTGAATTGTTCTTGCTCTTCAG
>TTN-216,,0,1455,670884,672338,GTAGGCTGCTGGGGACCTGCCAATCCTCTGCTCCCCCAGAGGACATCTCCAGCAAATTGGGAAAGGAGTCCAGAAAAAGCTATGGGCAGAGGTAGATGCAGCTCTTAAACTACAGAAGGGTCTACTGGAGGCTGAATTATTTATAACCAAGTTGTTTGCCTTTTGGAATTTAATTTTCCTCTAGAGTACATCGTAAAAGTGACTGAGAATCAGTTTCTCAATACACATATTAAACACTCAAAAGTATGTTAAGGAAATATTAAAAATCATGTTTCTCAGCAAGTAGAAAAGCTTGGAGCCTTGTTTATAAGTCCTTTAAGGAATAAGACATATTCTCCAGGGAAGTGTGAATCTCCAGGAATTCACACTTTAACAAGCATCCAGATAATTCTGATGCCGGTAGTCTACAGACCACCCATTTAAGAGGCATGTAAACATACCCAGAAGAAAATAAATGCTTGTTTATTATTCAAATGCATGACACTGTTTCCCCAGAAAACTTATCACCAATCTTAGTGGCCTCTGTTGTTTTTCTCTATCCTTTACTACCTAGTGAGACATTAGTATACAGAATATTGCATGCCTTTACATGTTTTATAACAATATCTTACATGAGCTACGTAAAGTTACATATGCTTATCCAATAAACTTTACCTTCAATGATGTTCAATTATAGGGCTATAATTGACCTAAGCAGAAACCACATCAAGTAACATCAGGTAGAACTTTAGCATGCACCCAGAAAATTCACAAATGGAAAATGCACAGGGTTGGCAGCACCTGCTGTTGTTTATTACTCAAAATCATGTCAAAGTTAATTCCACTCACTCCTCACACTTATAAAAAATTTCCTTCAACATAACCAAAAAAATCCCCTTTCTGTAACACAATTAAAATGAAGTAATGTTATTATTGGGATTAACGTTTTAAATGCAAGTAAATATTTGGGTTATTTGAATACCTATCAAGTTGGAGAAGGTTTAGAATTTTAAAAATTAAATTAAAAATGTAATGATTCTTTAAGTAACAGGTACACCCATCGTAGCAACCACTGGAATTCATTTTAATGCAACTTACTGGAATATGCAACATGGCTTTCACATATTAATAGAGCGCTAGATGTGAGGTAGAGGGGGAAGTACCAGAAAGATTCTCAAGAAATGTTATAACAAAATCTAGAGCTTTTATTTAAAACAAAGAAACAAAAGGTGGTGGCCTAAACTGCTCAGCAAAACAAAGCAAATAAAATAAAATATGGTGGTGAGAAAGCCTTCTGTAATCTCCTGGCTCCCATTCTTGCTGTCATTGCTGGGTGAGCTGGGTTCAAGGACATTCAAGGATGTTTAGATTGGCGAGTCATCACCTGGTTTTGGAATTGGAGCTGTGATTATTTAAAAATACCTTGTAGGGAGCACCCTGGCTCTCACTCTTGACTTTGTTCTCTTGTCCCCGCAG
>TTN-216,,0,484,672339,672822,GTACGTGCTGGAGGTTGAGGAACAGAGAGAAGGGGAGAGAGCTGGTTTGTGTCTAAATGGGGCCAAGCGTCCACTTGCCACCTCTCACAGCCCTGGGAAGAATGCTGTGAGCTGATATAAAAGCTGGCTTTTCGACACCCATGAAAAGTCCCTGAGATTCTAGTCAGGAGCGCAGAATAGAAGCAATCTGTGCTTATGAATCTCATTATAAACTGGAAAGGGTTTCAATTAAGTGATCTACATTTCCAAATTATTGGCAAATAATGAAATTTTAAAAAATCATTCTAAGTAAATTTTTATCTTGTAATGAACATTTTCTATTTTTAAACCTAATTTATATTCATGCAAAATCCAAAACTTTCTGCAATTTTCTCCATTGGGATATCCAGAAAATCTTTTTGACTTTGTAGTCAGAATTAACAGAATCTCTTTTAAAATGGGTCATTGTGCCCCCTCCCAAACATTCATCTTTCCCTTCCCACAG
>TTN-216,,0,93,672823,672915,GTATTTTTCTATACTGTTGGTTTTCAAGCCTTTCAGGCTGTTGCGTCCCCAGCTATTCCTCCTCAACGTGGGCTTTGTTTTAATCTTTTACAG
>TTN-216,,0,4234,672916,677149,GTAAAGCTGCCATAGAGAGAGCAGATTATTGCACATTTTGGAACTAGGTTTTGAAACGAGAAAGATTCCCTTGTCCCCCTCGCAGGGCATGCGACGCGGAGAGTGGTTCGCTTCTTCAGTGTCCCGCTGCTCAAACCTCTAGGGGAGCATACAAACGGGCAGGTTGTGGGGCTCCGTGTTCCTCTGGACATCCAGCCGCTTGTGTGTCTGCCTACTAGGGTCTCAGGGGTTTTTATAGGCATAGGGTGTGGGCGTGGCAGGTCAGGGTGATCTTGGGAAATGCAACATTTGGGCGGGAAGGCAGGAGTGTTTGTCCTCACCTAGGTCCATGGGCACAGGCCTCGCTAGGGACCACGCACTTCTCTTCCCAGCACTTCCCTGCCCTCCTCCCGTGTAAGTTTCATGCACTCAAAAATGTAGCAGGTGACAAAGGAGGTAAACCAAGAAGTTACTGAATATGATTTTCACAAATCCTCACTGTCCACAGGTAAATTGAAGACCCTTATAAACTTCTGAATTCTTATTTATATTTCATGTAATAAATATCTACTTTAGGGGCCAAAATATGGCACAGTGAAAGGAGAAGAGCACAGAAGTTAGAGTTCAAAGCCCTAAGGACAAATCAGCCTGATCACTTAACAGTTTGATTTAGGGCAATAAGTATAAATAATAAAATAATTGTTATTATATATGGATCACTTCCTCTATCAGATTGGAACTATACATACATTATCTCATTAAATGTTCACAACCTGTAAGAATTATTATCCTCAATGTTATTGATAGGTAACTGGAATTAAAGAAGTTAAGCAGTTTATTTAAGGTTTCAGTTGTGTCATCTGTAAATTAAAGAGAGTCACAATAAGAATGATCTCAAGCTGCATTTTGGGGCTTCAATGAGATAATTAGTTGAAAGTGCCTTGTAAATAGAAAATAATTATGCCAATATTCTTATATTCAGATGGTAAGTAAAACCTTTTAAATATTTTGCATATGCTTGTGTTATTTTATCTAGAAAATAAAATGGACTTCTATGCTTACTTAATATGGAAGTATTTTAGAAGGTGATCATGTATCATGATCAGGGCTCAGAAATTATATAATCAAGTGTAAATTGTCCACAACAGTTTTGAAAGTTTGGGATTTAGTTTATCATGATGAAACTTTTAATATGATGAAATGAAAAATGTACAAAATTTGAGCAAAGAAGTGTTTATTGATCAATTTAAATGAAATAAAAAACACATGGATGTTCCCTGCCAAGAAAATTTTTTATAAAAGAATAATAAGGAGATAGTTGACCTAAATAATATTCAAACATACTGTAAAGTTACTATAATCAGAACAGTATGGTATTGGTAAATGAATAGAAAAATACACCAGGGGAACAAAACAGAGAGTCCAGAAAGAGATCCAAGTATAATAGATCCAAGTATATAGGGAATTCAAAAAGCAAAGTGGCCTTTCAATTCAGGGGAGGGAGAGGTATTTTAATAAAGAATGCTGGTCCAATTAGCTATCCATCTGGAAGCAAACAAACATAAACCTCTGCCTCTCACTATTTACAGAATAAATTTCAGCTTGATTAAATAGTTAAAAAATGAAAAAAAAAGAGAAGACAATCTGCAAAAGCATTTATGGGTGAAAGCTTTTAAAAAGACAGTTACAGATTCAACTACATAAAAATCAACATGTATGTATGGCAAAAGCAAAAAGTCATTTCTAAACCAAACAGCACTTGTGAAAAAATTTTAAGACCTTTCTCCTCCTCAAGGTACTTCATTGCCTCTGCCATAAAAGTATCACAATAAACATAAAATGGCTACAAGGTAGACAACACCAGCCTAGAAACAGTATATAACATACAAAATTACGTAAGCTTATGCTGGATAAGACCCATAAACAAGCAAAATATTGAAATGGATTAAAAGAAATGGATCTGGGGGAATGTTTGCAACACTTACGACAAATAACCAATAAATGCACTAAATGCATTAAAAATCATCCACAAATTAATTTTTAAAGGAAAAAAATGCAACACAAAAAAAGACAAAAGATACAAAAAAGTATTTAACATAAGAGGCAATGTAAAAGTCCAATAAACATGTGAAAAAAAATGCTAGATGTTTTCCAATTTTTATTGTTTTAGCCACAAAAATGTAAAGATATTGGCAAACACTAACATGAAACCTTGAACAAAAAGCTTACTTTAAAAAACATGTCTAGCAGTCGAATAAAAAAAAATGTTCAGTCTCAGGCTAAATCCAAGTTTGCACACCATGAAATCACAACACAAGCCAAATGCAATTTCTTGAGGAGATAACAACCTAACTATATTTTAAAACCCAAGCCTAAGGGTCATTTAGAATCATGGAGTGTCCCTGATCCCATGGAGCATTTTGACCATCTTAGCAGTTTTGAAAGTTCATTAATAACCATCCAAATTGCCCCAAAATTTTGCTTTCCAATAATTAAGAAATAAAATGCCAATTTGCAGAGAAAATAATGGTTATCAAAGATAGACTGCTTCCTAAATATCTCATAGTTTAATCTTGATTTTTGTTGTAGAGTAAGGCAAACATATTTCATTGAATAAGGTGCATTGTATCTCGCTGTGACCAGGTGATTATTTTTTGTTGTAAGTACAGAAATAAGCACTCTCCTATAATGACCAAAATTACAATGATTTTCACAGTTATGGGCTTACCTGTGTCCTGCTGTTAATCAGTCATGTCATGCTAATCATGTCTTTAACTCTTTTTGAATTAAACCCATTTACTAAGTACAGCAAGAACAAGGCACAGGGTGAAACTTAAAAGCACATGTCTCTTTGCTTTTCTTCAGTTAGTGGAAACCACACATTATTCTAACTTGGTTTTTGTTATATTTCAAAGGCAGTCATGTTCAGAAAAGAGGCTTATTCCCTAGATTTCCCTTTAGTTTGATTACAACTTCATTTACAAAATGTAAATGGATTTTCACACAAAAAAAGCCATTCTTCGAGAAAATAAACATTTCTTCGTGAAACTGGTTAATGTTGTAATGTACTGTTAGGGTACTCTGTAAGTTAGAGAAAATATCAACTGTACCTTGAGCTTAATTAGAATAATCATTTCATGTATGATCAGTGTAAGCTAAATATCCTAGATAGTGACAAGATGCATTTATAAACATTTTCTTATATGCAGAATTAATAAAATGCAATGATAGGGCAATACTGCCACCTAGAGAGGAAAATGTAATAAGCCTTATTAAGAATTAAATCAGTTCTGAAAAAAATTTTACCTTACAATAGTTGGCCAATCCCCAGAATTATTGCTATAGATCAGAAATAGTCTTTTTTGGCCATCAGTGCTGGGATTTAGCACCCAAATTCTTCAACTGATGCTACTTGCACTTTGGATACACCTAAAAAGCAAACAATGAAAACTATTCTGGAAGAAGCAACTTTATCAATTTACCCAAAAATCACAGAATCATTAGTTTTTAAGTTAGTCAATTCCCACAATAACTCTAAAGATATTTAAAATAAGTCCAGAGTGCAATACAAGGGGGGCGAGTGTAAACAAATATGGAGGAAATTAAAAGTAGCTGTCCACAAACACTTCGGCTAAAGCAGCAATTTGCAAAGTGCACTGCACAACCTGTACCCAGCAACATGCTGCAGAAAGCTTCCTGAGGATGTGTCCCCCTGTCCTGGAAATTCACAAGGCATACTGACATAGTAAAGGCTGTGGGAAGTCCTGCAGGGGAAAAAAAAAAATGGCTTAAGCTGCTTAGTCAAGAGTGGCACAAGCATTTTGATTACAGAAACCTTTCTTCTTATAACACCTATTTGACATCCTCTAACCCCCCCAGAATTGGAATACAGAGATGAATTTGGAATACAGAGGTTGCTGGATTTGACATGTCTTTCCTTTGGCTGCATATTAAAGAAGTAGCTTTTTCTGTTGTGATTTTTTTTTTTTTTTAATGTGAGAAGGTGCAAGGCACAAAATCTCCAGCTTATTTGGAATTAAAGCTGATTCTCTTACAGGGTTACAGCAGATAAGAATAGGTTTATTGAGATTTAAAACAAATTACTTCCAAGTACATTATTTACCCTCTGAATGGGTTATGGAGGCACACATTTTAAAACTCTGCCTTAAAGCACTTCCAGCTTTTCATCTCATGATTCACATCCAGTTACCCCTCCTTGCTTTGACATTCTTGACCTCTGCCTTTTGGTTTTCAG
>TTN-216,,0,370,677150,677519,GTACTGTCAGAATGGTTTTGTTTTTCCTTATTTCACATTCTAGTTTCTCCAACTGGATTTCTGCCATGAAACTCAGTCTGTATAAATTGGAGGAAAAATGCATATGAACATAAAAATATAGCAGCAACTGAAGACCAAATTCAGTAGTCATGCTTTGTAAAACCATTTTTAATTAGGACAAAAGCTCCAATCTGTGAAGTTTCCATAATATACAGGTTTTAATGATACAGTCTCTGTATTTCTTGGCAATAATAAATGCTTATGTATGAGTGTATTTTGCTCTAGGTGGCTCAGTTTTCCAGTATGCTTTTTTATTTTCTACTGGGCATGTCATTTAAAAAAGTAATCTACTTGGTCATTTCTAATCTAG
>TTN-216,,0,857,677520,678376,GTACGTGCGAGGCTGCCATGGGGCACCCGCAGAGCCACGTCCTTCAGTGCACATTAACTCAACCACCATCCACTGAGCTTGGCATGCAGCTGTGCTCAATTCATTCTGAAGACAGCCTTGAGCCCAGCAGGGCCCAGACTTTTAGAACTTTCTGAGCAAAAGGTGGTCGGAGATGTCAAAGGTGTTGACAATGTGAGTATCACAAGAGCAGAGTAGGCCAGAAATACCTGGGCTATATGAGCAGGCAAAAGTCAACTATGGTATTCAAGGTAGGAAGGCAAAGAGTGGCCAGAGAAACAGAGACCAGTCAATTCCAGAGCTCAGTCACTGCACACACTGGATGTGGAAACTACTATTTCAGGGAAGGCATTACATTTCTCTAAGTTTCCCCAAAGGACTTTTGTTTTTACTTTTCTCAAAACAAACATGACACTTGATTCATAGCTGGAACAGTGTCATAAATCCAGGATAATGTCCCACCTCGCATTTGAATAGATTTTCTGTTACAGTTTAAAATCATTCCAGCTTTCCTCCTTATCCTCTTGTGTGACATTTATGTCTAAATCCTGACAGATTATTGTAACTTTTTTTTCTTTTCTGAGACAGAGTCTCGCTCTGTCACCCAGGCTAGAGTGCAGTGGCATGACCTCCGCTCACTGCAGCCTCCGCCTCCTGGGTTTAAGTGATTCTTGTGCCTCAGTCTCGTGAGTAGCTGGGATTACAGGTGTGCGCCACCACACCCAGCTAATTTTTGTATTTTTTAGTAGAGGATTTCACCATGTTGGCGAGGCTGGTCTTGAACTAATTTTTATGTAAGATGCATTAAGGTGTTTTCTTCCTTTCTCTATGAAAAGCAG
>TTN-216,,0,1206,678377,679582,GTGAAAATGGGTTTGTATTTTAAATTCACTGAGGTTCTTACAGGGGTCAACACAGATAATCACCTTTACCATGAAGAGTGTTGTTCCTTGGGCCACATGGTTGTTAGCATACTAATAAGATCCCCTTGTTGTATGTGTAAATTTCTGGGTACTGGATACCAAAGTTTGGTAGTGTCCCTGAATGCTCCCCTTGTGAGTATGAAAAAGAACTCTGTGAACATACACCAGGAGTAGAAACAGGGGTCTCATCACATTGATCTGGGGATGCACTAAGTATAAGACTATAGGGAGAGGACAGATGGCTAAAACCAGGAGGAAGAAATAGATGCTGAGGCAGGAATGGGGAAAAGTGGAGGAGACACTGAACTCACTTTGCTTTAGAAATCTTAGCAACTGCTTCCTGGCTCCTTCGGAAGACATTTGCACATGAGTTTGAAGTGGAATGGACAGCATGGCTTTAACAAGCCAAATGACCAGAAAAGGTGAAAAGGACAGCCCCATGGTTGGCGGCATTTGGGGACAGATTGGAAAATGCCAGTTAGTAGAGCTCTTGGCCAGTGGAACCAGTTGGCAGTTGGGTGGTTTGAGAAGATGAATTTCAAGTCCCTTTCAGCCTTGAGATCCTGTGTTTCAGTGATGAGATATTTGAGAATGGCAAAGAGGCAAATAGAGAAAACTGTCCCCCTACATACGCATATACCTTAGGTGCCCAGATGGAAACAGCATTCTTCACAGTATTTAGGAAAACTGACAAAACAAAAATATTGTATAAATGCAGATTATAAATTATCCATGCTTGATTTCTCACATGTAAAATAAAAAGATCAGACAAAATTACTTCTAAAGTCTTCCATTCTGATATATATTCTAAGATTACCTTTAGATGACAGAATTAGTACAGAATAATATTGCCATAGATCTATTTGTAAACATTGGAAGTCATTTTAAAGAAGACTACAATTCTGCTGTTCAAAACAAAGTGTTGAATTCAACTTTGTTTTCTCTAAGCAGCCTACATAATTTACAGTTTAAGGAGAGAAAGAGCATGATCTTATTTATGAACATGGGATTATTTATTTTATTTAGTGACATCTGCAGAAAAGGGATTTTACATCTTCAAATTCCTATGTTGTTATATTTAATAAACACCATATTATTTCATTGGGCATCAGGAAATAAAGTTTTTTCTTAAATCATTCTTTGCAG
>TTN-216,,0,5930,679583,685512,GTAAGTCTGATTTTCTAAATATTTTGTAGTTTGTTGACAATATCACATTACAGCCAGCTGCAGGTAGCTTATAGTCAAAACCCTTAAATGGAGAAGTCTTTGGTTGTATATTTTTTGTTATTGTTCCTCTATGTCTAGTATTGAAACTCAGGATGGAAATTATGTTCACATTGCACTATTTTCCACTCACTTGATCAGTTTTCAGGAGATTGTCTACAGAACAGTTTAGGGCACATCTATGAACTTTCTAGAACATACATAAATGGATGATAGATATCATGCCAGTCCAGTTACCCACCGGGACAGTTGGTTTCTTCGTGCATAGCCTAAGCCCTCAGTCACTTAGATTGTAATGCACAAACTTTACATGCACACACACATGCACACACACACACACACACACACACATATACACATACATCAGCCATAAACACCCCGAATAAATAGCAAGGGAAAGTGAGGATATGCCAGACATCGGAGAAAGCAAATACTTCCTCAAAAAAAAAAATTCCTTCAATTCACGGTTGATAAACAGTGACCTAGAAGCATTTGCTGCTGTTGTGCCGTAGAGCTGTGTGAGGACAATCTCAGTGTCACTAAAATCCACATCTCTCCCGTATGTGAAATCAAACCTTTAAGTGTCAGGAGAGAGGCATTTATCTTGAATTCTTCCATGTCAAAGAGGGCGCCTGTGCTCATCCTCCTTGAACTCAAGCTCTTTGCTGATCTTAGAGCTACTTTCTTTAAAGGTCCAGTTGAGAACCTTGTACACTTAAAAGGCTGACCAGAGGCTGCTGACTGAATTTCCCTCTCCTTACTGTGAGTGAGACATTTTGAAAGCAGCAAGAACCCTACTTAGGATAATCAAAGGCATAGAAATCCCCATTGCCATTGCAATGCTGGTGACTGGCAAGTTCAGCTGGCCTATGGTTTTCCAGCCACTTGTCAGCAGCCACCCACCGGGTTCCCTAACACGTTGACATGTCTCAAGATGAGATATGTTCAGTTCTAGGACAATTTGCTAAGGCGCATGTGGGCAGAAAAGAAGCCCATTCCTCAGGAAAGCAGTCTATGTATTAAGCACAAGTGTAGGCCCCTGAAATGGAAATCTGACATTTTATCGTTCACCACTAAGCATCCTGTATTTTCCTGAGTGTTTCAAGGATGTCTTCCCATTGCTTTTGTATCTTTTGAAACTCAAATCTTTATTTTACTCTAAACATCAGATAAGACAGGAAACTGAGATAACTGCTGCATCCATGGTGGTAGTTGCCACTGCAAAGTCCACAAAACTAGAAACAGTCCCGGGAGCTCAAGAAGAAACTACCACACAACAAGATCAAATGCACCTAAGTTATGAAAAGGTGATGACTTCCTGCCAATGTGAAAGTCACTCTTGCACCATTTCATTTGCAAATCACCTACATTTTCATCATGGATCTTAATCATCACTTCTTCACTTCCACCTCTTCTTATAATGCAAATAGAAAATTTCTTTTCCCACACAGCTACCTTTCACTGTCAATTCATTCCTAACTTTCAGACTTTCTTTGGCTTGTTACTAATATAATATAATAATTCACTTTAATATCTTCCTATTGAAGCAGATGTCCGTAAACAAGTCAATTCATAATACAAAAAATTATGTGCTATTTACAGTGCTACTGAAATGTCTCAGAGATTGCAGTTTTAAAAAATGTGAAAAGTACAAAATAGCACTCATTAGTCTTTTATTGCTAATCACATTTTTTTCTTTTAAACTGGACTTATTGTTTTGATATTTTTGCCAGTGAAACAGTATGGATGATCAAAGTAACTCAAATGATATATTTTAGTGCAATTAAAATTTCCTTGAATAGGAAGAAATTTTGCCTCCTTTCTTTTTGACTTACGTTTCTTTTATTAAAGATTTATGGAATTTAATGACTATTTTCTTACTTTCTTTTGTATGATCAGATAATGAAGGAAACTAGGAAAACAGTTGTACCTAAAGTCATAGTTGCCACACCCAAAGTCAAAGAACAAGATTTAGTATCAAGAGGTAGAGAAGGCATTACTACCAAAAGAGAACAAGTGCAAATAACTCAGGAGAAGGTGAATACAGATATTTGAGCTGTGAAAAGTTCATCTTTAAACTAATTTCTAGTAAACTATTAACTACAATATGGTATGAATTATTAATCTGTATTTGCCTTTTAAAATCCCTAACTAAAAACAAAATGGTAAATATGAGACTGATTATCATTAATTTTATCTGCACATTTGATTTTCATCCATCTGTAACATTTATAATTCATTTTATTCACCATTATTCTTTGCATGAAGATTAGCATTTTTTAGCTTAATTTTTAAAAAGTGACACAGGGACTCATCTAGAGGTTTTTTAATAGCTAACATTTCTAAGTTTTGTGATTCTCAGTCAGTATATGTAGACATTGCCGGTGAAAGTTTATTTCTCTTGTGTATTTAACCCTGAATAACCATCTTGCATCCCCATGAGGAAGGGGGAAGGGTCATACTATGTGTGTTTGAAGCCCTGTTCAACTTAAATCTTGATTTTACTGTAATAATCAGATGAGAAAGGAAGCCGAGAAAACTGCCTTGTCTACAATAGCAGTTGCTACTGCTAAAGCCAAAGAACAAGAAACAATACTGAGAACTAGAGAAACTATGGCTACTAGACAAGAACAAATCCAAGTTACCCATGGAAAGGTGACTATTGTTGTTCCAAGTGTGAAATCCCCTATTATAATACATTAATACCACATATCATGTGAAATTCCTTATTGTAATACATTAATATCAAGTCTCTGAATTTCTTATGTATGAGTCACTATTAACCAAATTTATTTTTTAGACAATTAAATAATTGGAAACTAAAAAAATTTATTATTGTTAATATTACTACATATCCCTTTCTCCACTTATCTCTTCACCATTATTGTCAACATTTTATTAACATCTGGGAATCTTCCAGAAGTTGATTAAAATTGCATGCAGGCTAATTTTAAGAGGCCCATGAACATTTTTTAAAAACACGGAAGATGTATAAGTAAATGATGACTCTTACTCACTGTCAAGAAGATGTGTGTTTTGAAGGGTCATAAATTCAGTATATTATGTTATGGAGTATGACTTATTTCAGTAAATTACCCATAATTTTCTTTGTATGAAACTTTATCTTTTTTCCCTCCTGTAAATATCAGAGGAGAAGATAAGCTGAAAAAATTATAATGCATGCTGTAGCAGCTCCCACTAAAGCTAAACAAGATGCATATTAAAATCTAGAGAAGGAAGTATCCAAACAGAACAATTACACATAAGCCATGAAAAGATTACCGTATCTATTTGTAGCTATGAAATATCCATGAATTAAACTGTTTCCCATGACTCTGTCATTTACTCCAAATGAGCCATTTACCTAATTGTATTCTTTATTGCTAATATACCACTTGAAAATTAGCAACTAAAGTTTTTCCATTTCATTAGCAGGATGGCCTGAATCCTATTTGTATTTCCCTCAGTGTCATTTTCTGACTCTACATCTTTTTTTTCTAAGATATGATTTAAGATAAACTTTTTAAACCTTTACTCAAATCTAACATTTAATGGCATATCAGCCTTTCAGAAGTCTCATAAATGACAGAAATTCCACTATGCAACATACTTCATGAGTGATTAACTTTTTACTTTTGTTTCCATTCAAATTTTGTCATGAATTGACTATCTTGTTTTTGTTAAAAATTAGCTAAGGATGGAAGCTGAGAAAATGTTTATACCTGAAGTAGTAGTTACCACTGCAAAATCTGCTGAACCAGCCACACCGCCAATGACTAGAGAAGGATTCACTATTAAACAAAAACAAATACATCTTTTTCGAGAAGAGATGAAAACTGATGCTATGGAGGTGAAAAGTATTGTTTCATCCCATTTCATCATCAACTCTCATAACTTTTCATCCGTCGTGAATTGTGCTTCTAGTGTTCCATCTAATTGTTTAACTGATCAATAAAACAATAGAGATGGTTAGATTCAGTCCATCCTCCAGTTGAACAGTGAGCATTTCTAGTAGTGAAAAGTCAGACCAAATAATACTCTTCTTTATGTCTCCTAAATTTATTCTCAGCATTTAACTCGTATGAATTGGAGTATTCTAGTCCAATTTGTCTTCCTGCTTCTCTAGGTTACAAACATGTGAGAGATATCAAAGTCCACTAAGAAATAAAAGCGGTTACCAGCATACTCATTTGTAGTCCACCAATAAGTGTGTGTATATAAATCTGATATACAATAATTCAAGGAAAAAACAGACAGATGCTTCCTCAATTTAAAATATTTTACCATGATTAAGATTTTTCCATATGTTTAAAATCAAGAACAAAATTTAAATATTTCAGTTGTGTGATATTTAGTCATATGACAGTTTCTTTGACAGTTTCTTTTATCATTGTTAAAATAAAATTAAGACTTAAGCTGACTACTTCATAGCAGACTGGCTAAAAGGTTCAAATGAGATATAGTGGAAATGTGATCACACTACAATCAAAATAATATTTATTTATTTAGTGTTATCTGTCGAAGATGTTAACATTTTAAAATGTCTATACAATTAAAGTCAGCTCATTGCCAATATAGTTTTTAAAAAAGAAAAAAATAAATGGACAAACTTAACTCACCTAAGCCTCATGTGTATTTTATGTTTTTTTCTGAGATGATGCAATCTAAAGTGAAGATGGTATTTGCAGTCCTTCGAGGCAGATGAAATTGTTTGTGTCTTCCTAAAAGGAAGCCCTGGATAAAGCCCATGATCACTAAAGACCCAATTCCATCTCAGAAAAATCTCATTTATATCTTGAATGGTTCAGAGAATAATTTTTAAAGATATGCAGGTAGCATAGTTGAAGAATGTTTCTGATGCATTCTAGATTCTATTCACAGGTATAGAAAACTGAATATTAATAAAATTTTCCAATCTTACTTTTAAAATGCACTTTTAAAATGTACTTTTAAAATGAACATGGCTATGTGATTTTTGAGGTATGCTGTTTCCAAGTATCACATAGAATCATAATATCTAAGCCACATCAGCTAGTTTGCCTTCTTTAAAAGAGAACCTCCTCTGCAAATTGTATTTCCATTAATGTTCATCAGACTCAGAAACGAGAAAATAATATTTGTTTCATTCTTTGCTTTAACTCTCCATAATAATGAAAGTAAATTAAACTTCAATGTGAAAGGTTGTTCTCTTGAATCCAAACATGATAACACTTTCATTTTAATCACAATATTTTTATTTGCACGGGGTTCTCTTTGTCATCTGTGTGTTTTAAGAAAGGTATTTTCTGATAGATTAAACAATCTTACCCTTAGGGAATCATAAGTAAATTCATATGCTCACTCTGTGTTTGTGAGCTTTCATGTTATGTCCGATTTGCATGCAACCATATAACTCTGTAGTCACTGATTTTTCTGGACAGGATGATGACGGTATTTGAGTGCACTTATATCATCACTGTCACTGCATTAATACCAGACTAAATGGTCAACAAGATAATAAAAATAATCAGTGAAAAGAACCAGCTCCAAAATTCTGATTTTCCAATTGCTGATTGATTGTCTGCCTGGAAAAATTCTAGAAAATTTCAAAATCTTCTTGTGATTTTATGTTCATATTGTGATTGTCCTATGTTGTGTATATGTGATTTAATGTCTAGTATAATTAAGTAGGTGTACAGAGAGTATATCTAAATAGATGTCTGTACAATATAATAATCAATGAAATAGTCCCTAAAAGTGTTTCTGAGATACATTTCTAGACACGTTAACACTGCTGTATAATGTGGACGCCATCTGCCTGTCCTGATGCCCAGGAGATATTCCAGCCTGATCTCGATATTCCTATGTATTAATTCTGGAAACCTTGTCTCCAG
>TTN-216,,0,105,685513,685617,GTGAGTCTATACCTGCTGATTTTTCACCTTGTTCATGGTAAAGCAAGCCTCACTGCTGTGGTCATCTGGTGATCAATGGTATCACTGAGTTTCATTTCAATGCAG
>TTN-216,,0,1268,685618,686885,GTAAGAAGTTACAGAGCATGATACAGAAATGTTTAAAGGAAATAAGTATCTAACCTGTGAAACAGAGCATCTCTGGGGTAGGCCAATGGAGGATTCTTTTTTGGTGATGTGTGTGTGCGTGTGTTTGCATTCACAGTGGGCCCAGACACCCTAAAGATTTGGTTTCTGAAACTCGCCCAGGGGAGTGAGCCTAGAGTCACAAGTGGTTATCTTATACCTCTGAGGAGAGACAAATCCACACAGGCTTCTCTCTAGTTCACATTTCAGGGACAGCTCAAACTCAATTGTTTTGATTACTATTGTTCTAATGATTTTGTGAAAGGTAGTGTGTTACACAGCATAGTTTTACTTATGCTGTGAGACATTTCAGAGTAACTTAACTGTGAATGTGTTTCAATAATAAAGACAGACATTGAGAAATCATATATTTATATACTCAATATAGCAAGATGGAGAGGTGGTACTGTATGGTGGTCGGGTTGGATTGTGGAATCAAATAGCTCTGGATTAGTGCCCTATCTTCTCCCTTATAATCTCTGTCATCAGGAGAAAGTAAGCATACATGTAAAATGCAAGTAAAAAGGACATAAAAACCTGCAGTTGTCAGCATGTAATAAATCCTTGATATTAGTCACTATTGTTATTATACACATCCAAGAAATAGAACCCAAACCTTCTATGCCTTCAAAGAACTGTAAGTTACATATAATGCCTATATTTGATTTAGTCCCAAATTACAAAACAAATAACCATAGACCACAACAGAATAAAAGCAGTAAGGAAACCTTTAAAATATTTTTTCTGAATGTCTTCATGTTTACCTTTCACATAGATTTGTGGCTAAAACCCAAATGTACTATTGCAAAGTAGTTCTTAGGCATTTACCAACAATTTCAATAATTTCTTAATTTTGAATCTCCCACTGTGGTATTTTCAAAAGTGGCATTCATCGGAATGGTTAAGTGAAAATTCGTGACTAAGCTTTAGAAGATCCTGTCCTTTTATGATAAAAGCTGTAAAATAAGGAGTTCTGAATACAACTCTTTAAAAAAGATATTTTAAAATTTGTTTTACAAACTAACAGGCATGACAAGGAGCTTTATAATTGGCTTATCTCTAAATGACTTTTCATTAACTGTGTGATAATGAGTGCTAATGAGAACATTAAAGAACAGACCTTATAGAAAATAGGCTCAGACTCAGTCCAAGAGGGCTAGCCATCGGAGGATGGTTAAATGACTTTATTTTCTGACTCTGTTTCCATGTAG
>TTN-216,,0,284,686886,687169,GTTGGTCACTGGTTACCCGCTGTTACATGGTCCACTCCCATTGAGCAGGGCCAGGTGGTTGGCTAGTTTGTACTGAAAAGTAGCCAGTGGAGTCTTGCCTTTCTCCTTTGCCATACTAAGACTTGATTTTTATGGAGCATAGTATGGGTCAGAGATCATTTTCTCAAATTATTTTTATAATTATTTTTATATTTTTATAATTATATAATGTTGCATGAGCTAAGAGTTTATGAGATTTCCCTTAATTTCATGAGCATTTTGTAATATAATTTGTAAAAATCTAG
>TTN-216,,0,655,687170,687824,GTGAGTAAAGAAGTTGATAATGCTGGACCCTATTCATATCTCCTCAAATCATTTTAATACACGTTTGCAAAGATCAGTTTCTCAAATTAATACAAAAATGACATTAGTGAGCTTACAGATGCTCATTTTAAGACCGTATTTGGTCTGGAAGACCATATTTGACCATATTTGGCAAGGAAGAAGGGAATTCTATGTGGTACATCATTCATGGATTCAAAAGATTTAATGAGCTTCTAATATGCAGAAGGCATTATTGCAGGAGCTGTGCAGACATAAAGACCAATCCATCCCTCTTTGAAATATTTTCTTTGCCATCAGAGAAAATGTACACAAACAAGCATAATAAAATATATAAGGTGATAAACATCACAACAGAAGGAGAATCCATGGGAGGCATAGATTCATTCCAGTTGGTGATACCATGGCAAAGCTTTGTTGAATAGGTAGCATTTGCTATTGAGCCTTACAGCTCTTTACTAATATATTAGTATATTATATAAATATTAGTTTCTCTACTACTATTTCTGGAGTCCTGATTAAAAGGCCATTTTGTGGCAGTTGAAATGCATAAGTTCAAACTCTACATTTGTTACAAAACAGAAGTGATTAATGAATATGCACACGTATCATTATTTATTTTTTCTCCTCTCTTCAG
>TTN-216,,0,203,687825,688027,GTTAGTGGCCACCCTCCCACAGTCCTAATGCACATGCCATCACTTTCATCTGACACTCTTTTCCACAATATGGTTTCTGTGCACCTTGAAATGATGTCCCTTTTTGGAACTTGGGGGGAGATTATATGGTCAATTTAACTGTCAGTGCTAAGCAGGGGTCACTAAACATCTCATCTCAATGAGAAACTTTTGTCTTCTTTTAG
>TTN-216,,0,111,688028,688138,GTAAAATATTTTGCTAATTAGTAGCTGTTCTAGTACCATTTTGACTTTCAGCCCCACCAGTATTGGCAAATTGCAACCCGGAAGCTAATATGAGGGGAATTCTCTTTCCAG
>TTN-216,,0,948,688139,689086,GTATTTTGATGGCTGAATATAGAGTTCTCTGTGACTTGTATAATACGTGCATGAAGCCTAGAGTAGAATTTACTCACCCCACCGACCCTGAGCATAGGCTCTTTCATTGTGGAGCCTTCTTAGTTTGTTTTGAGGTATTTTTACATTTTTTTTGTGCAAAGTCTTCCTAAGAAATAAAGCTATGTGACAAAAGTGGATGGAAGATATATTTCTTTACATTATAGTTTAATTCATTGAGTTTGTGAAAGTAGAGAAAATATGGATTTTCACACAAACACACCCACACACACACACACACACACACACTTCCAGAAAAGATTTGAGACAATTTTCAATAAAAACATGTAATAACTAAGTGACTAAAAGATAGAAGAATAGCCATGTAATGAAGAAGAAAGCTAGTTATGCACAAAAATCTATGCTAGTAATTTTTCTTCAATTCAATATAAAATTTAGCTCTGAATATTTTGCAATTTAAGATAAAAAGAGCAACCTGGTAATCTAAAAATGTAGGTGCCGTACCTTCATAATAATAAATATAATGTACCAGAGAGTTAATACTGAAATATTTGAAGGAATTTATTGTTTTAATTATTCATTTGATCTCTGAATGAAATAATGAGAAAAATAACGAACAAAGAGAAAATACCTGTTGTTTAAGTGACCTGATCATTTGCTAACATAAACACTGAAAACCACTTAATTTCATGACTGATTCTAGCAATAAATATTCTTTAAAATGAATATTTTAACTTATTTGGCCCTAATTACTCATGTTCTTGCATTTTTCTCAATTTTCAGCAATCTTATAATCTATTGTGGAGCTTAGTCATATGTTTAGGGTCATTGAATTTTATACCACAGATCCACTCACAGATAAGTCCAATTATTTTACCCACAGAAGAGTTGTTGATAACTGATTTTTAAATTTTGTACATTTACATAAAG
>TTN-216,,0,915,689087,690001,GTAAGTGCAACTCCAGTTTCTATGTGCATGATAAGAACTGAAATACAAGGAGATAGCAGTGCTGTCCGTTTGCTGAAAAACCTGTTGCCACTTACTGGTTCTGATACTTTGCCCCAGTGTCTTTGCCTCAGTTGTATGGAAAATGTTTTAGACCACATGGCCTCAAAAACTATACTGTCATTAAACTTCTGAGGTTCTAGCAATAGTTTCTTTTTGTTGTATTTGTTTCTAGGCATATCATGCCTCTGAAAATGCAGAGATTCTAAATCCGGTTGCCTTCCAGGCCCAGGCAGGTAACAGTGAGCTCAATGAAAACAGTAGCAAACTGGAGAGTAGGTGCCCTGCCTCAAAGAGACAGTAGCTGTGTTGTTGCCAGGCATGCACCAGGCTGTTACCAGGCTCAGTGTTGCTAGAGCTCCTGATATCTTAAAGAAAACCTGGAAGTCAGGATTTTCAATGTTTATAACTTGAAAACAAATGTAACAGCTTTCATGCTAGACTGTTCACATTTACAGTGAACTGGCTCACACTCTGTTTCACTTGACCTACACAGTATCCCTTAGAGGAAATTACAATATTATCTTCATTTAGCAGATAAAGCACTCAATATTCAGGAAGGTAAATGAATTGTTAAAAGACACACAGCAAATTAGGAAGTCCTCCGTGGTAGATCCCCCCAAAACTGACTGCTAATATAAAATTCTTTCTACAATTGTAATGGCTGGTTGGATTTGTTAGTGTTAGTTTGGTTTCCAAATTCCATCTAGAAAATATTGAGCACTTCAATAGTAGATATTTGGAAAATTTGGTTTTTGGTTATCAACTTTCCCCAGTGTAGAGTTTACCTGAATGCATAGTGGTATGACTGTTTTCTAATAAGAGCATTAAAAATTAACTGATGTTCTTAACTCTTAG
>TTN-216,,0,537,690002,690538,GTGAGTATAAAAGTAATGACCAACCAAACAATTTCATAAATTATACTTTCCTTTTTTTATTTGATATTTTCATTTTCAAGTGATGAGCTCGGGGTTAGACAGCTATTAGAAGGTCCAAGTTCACTGTTGCTAAGTTTCCTTAATCTTCATGGTATGTTGCACCTGTGAGTTTAGAAATAGAGATTACATATAGGCCATAAATGTGACTTTAAAAATAGGGCTTATAATATATTAAGGAAAACACCAATATTAGCACAGCTGAGTTCATTCATGCCAAGATCTCTTCATCTGTGTGATAAGCTAATGTAACCTCTAACCCAAATCTAACTCCTGCTTTTGGAATACCTTTCTACCCAAGATGCCACAACATTCACTGGGAAAGATGACCATAATGCAGATTAAAACAAACAAACCAAAAAGTCCTCTAGATTCTTCTCCCAGCTAAAAACTTCAACAGTCTAGCTCAGATACATCTCCTTAAATAATTTATATCAGTAAGGATATGTATTTTTAACAGACCATAATCTTTTTGCATAG
>TTN-216,,0,110,690539,690648,GTAAAATATAAACATTTATCATAGCTCCTTGCCACAGTAAAGATACAAATTGGTTAAAATATAACTATTTGATGTAAATTTTATTCATACATGCATGGTATTCTTTGCAG
>TTN-216,,0,898,690649,691546,GTAAGACTTGTAATAATTTGGGTTATTTAGTATGTAAATTGTTTTCAAAACATCAAATAGTAGCAAATTGCTATTGTGTAAGAAGAAAATCGAGGGCTAAAATGGCACAGAAACTTACCATTGGCAACACCAACAATTGCCAGAAGTTTTTATTTCTTGCCCCTGTGTAAGATGAGCAAAGAATTTTCATCAGTGTAACATACTGTTTATTTTCCTAGTGCTATAGCTAATATCACAATAGCTCTTATTTGACACCTGATTTTTACATATGTAAATTTATACAACAGCCCTGCAATAAAAAGATGACTATTATTGGTTTGGAAATAGGAACACTGAGGCCCTGGGAATCTATGAAAATTGTCTTAATTCATCCAGCCTGTAAGCGGTGGTGCCAGCATTCAAACTCCAAGTCAGTCTGGCTGCAATGTGTAGATGGAGTCTTGTTTTGCTTTGTTTTGTTTCCAAATTCATTTCTATGTTTTCCTCCTCTGAGATAAAGAATGTGTATTTTTTATTTTTCCATAAATGTATTCATTGGTTTACTTATCCAACCAACATTTATTAGGATGTTTTAGTAGTTAAATCAAAAAAGTCTAGTGACTGATTAAATCCAAGTGGTAAGGAAAAGAGAGTATTGAGGATTATTCCAAGATTTTTGAGCCTGGGTACCTGGATATACTGAATGACTACCAGCTAAAATTGAGAATATAGGAAAAACATAGTTGTGGGGGCAACAATAATATATTCTATTTTAGATCTGAATGAGTTTGAGGTGCCTTCTAATACGTGCAAGAAGTAAATTCTAAAATAACATGAATAATGAATAAGACAAAATGAAGTTTGTTTTGCTGAGTTTTCTTTATGCCTCACGAAAGTATTGTGTGTCTTTGTTTTGCAG
>TTN-216,,0,119,691547,691665,GTAAGCGTGATAAGTTTTTGCTCATGAATCATAAAAACACAAAAACAAGCTTATGTATGCATCTAACAATTTTTAAAAACTATTTTAAAATCTACTTTCTTTTAAACATATTTTCACAG
>TTN-216,,0,102,691666,691767,GTAAAATGAGATAAAATAAAAATAAATGAATTTTCTTATCACTTGGGTTATAAACAGGTATTTCAGCCTTACTCCCTCTAAATCATGACCTTTCTCTTTCAG
>TTN-216,,0,99,691768,691866,GTAAGTATGGAAATAATAAAGCTAAGCTCATTATACAAATCCAATAACCAGGGAAGCTATACCACTATATTGATTATTCCCTCCCCCAACTTTTTATAG
>TTN-216,,0,153,691867,692019,GTAATTTGCATGTCTTTCCTTTGATGGACCTGTCTTTGTATTCAAGAATATCCATGAGTGTGTTTACTTTTATTTTCTTTCCCCATTCCTCAGGTTGAGAATTTAATTTAATATAATGTGCTCTCCCCTTTTTCCCCCACCTTTTTCTTGTAG
>TTN-216,,0,447,692020,692466,GTATTCAACAACGAAGGATTTCATTGTTTACCTAAGCTCTAAAGTCACCCTTAGCATGTGGTAAAATTAGCTATGCAATTTTTCTTTCATGAAACAATTATTTGGAAATTGACTATAAGTTTCATAGCCAGAATCATAAATTTATGTTCGTAATTAAGAATGTTAACAATTTGACCATTTGGATTTTTTAAAGTAGTATTATCTTGATTTTTAGCTTTTAAGTTTTTTATTGAAGCATAATTCTTTACTTTCAAAAATATTTAAAAATTAAAATAAAATAACTGCTTCTTATTGAAAATTTATCTCTCAGCCCATCAGCGGGTAGATATTAAGAATACACCTGATAGTATGGGGGAGATAAAAGACATACAAGACATCATCTCTATCCTAAGTCTAGATGCATACCTCTCCAAAAAAATTGATTTATCTTTCTGTTATACACTTCAG
>TTN-216,,0,96,692467,692562,GTAAGTCCTCCCATTCCTGTCAGCCTGCAGTGAGCATCATTATGGTTTATTGATAAAAAATGATCATAACATTCTTTTTCTCCCCATATTTCACAG
>TTN-216,,0,112,692563,692674,GTGAGTCCTAATTATAAAATTTTATGTTTACACTATTAAGCAACATAAAGAACTTCAAGGAGCAGACAATTTCAACAAAATTCATTCATCTTGTGTGTGTATGATTTTGCAG
>TTN-216,,0,92,692675,692766,GTAAGGATTATTCTACCTATCTAATAATTACTTTAAGCATTCTACTTTCCCAGTGTAACAATAACCAAGAGATTATTTTATTTTTTCCCCAG
>TTN-216,,0,1637,692767,694403,GTTGGTATATTTATTAACCTAAATTCTTACGAGGAGTGATTGTTATTTTAAGAAATTATTATTCATTTCCCCCAAAATTCCTTTCAGTTTCCCACTTCCATGCCTCTGCTTATGCTGTTCCCAAAGCCAATAGTACTTGCAACACCATTCCCACCAGCCTAAATTACAAATGTTCTTCTAGGCCTACCTCAAACGTCACCTTCTCCATTAAACCTTCCTTAATCTCTCCATTTGTATATGATCTCTTCCTCATCCAACCCCAGGATCACTTTATATGTGCCTCTTTCCTAGTGTTTATTATGCACTTGTCTTATTCCCCATTTCCTCTTTCAATATCAGTGTATAAACTCCTGAAATCTGGAATTCTATTTGTATATTCCAATATATTGCAAATGACAGATAATCAATTGGTGTTTGCTGTATTGAGCTTTATTTAAACTTCCTTACTCTAAAGAATTATTTCCTTTTTTAGCCATTCTTGCTTCTTTAGCCTTTGTGCCTTTTATTTTCTTCCTACTTTTTAATGAAATCAATAAATATTTTCAAAATACAGCTTAATGTAACTGTATTTCTTATGATATCATGTAGAAATAAGACCATCATTCAGTAGAATTTCTTAGCTTTACAATGAAGAATAAAAAATGTAAATCAATTGCCAGAAAAAACTAGAAGTCATCATTAATTTGTTTGGTTCATTACAGTTTAAATTTTGAGGAGTTGAGATGTTACATTCAGATCGTGTTGTCCATTACATCTAGTATTGAAGCAAGTCATATGGTAATGATTTGTCTTATTTGGTATGAAAGTTTCATGGTTTATACTTACTTACGTTATAAGATTTCTTCAGAGATCGGACCATGAAAAGACTTGTAAAACAAAATTTCAGATTCAGCATTTTTATACATTTAATATAAATTACATGTTTTAAATGTGTGGAAACAGGAATAAACTATGAACTCCTCTGTGATTTCACCCAGTGTTTTTAAAGTACCTACCATTGGTCAGACACTTGTAGAAACTCAGGACACAAAACTAAATAAGAAATGATTTTTTTCTTGAGAAATTCATAATTTAGAGAGGACAGATACATAAGCAACTAGCTTGTTAAAGCAGTAATTATTTCTGCTAATGGATGATAAGAGTGGAGGCAATGGGGTGAAACTTCATAGAATGGGCGACATTTGCCAACACAGTGATTTTTAATATATAGAAATCCTCAATGTAGTAGAAACATTGATGACTCGTACATTTTGTTTAGCAAATTTTTATGTAGTCAAAATATCAGATTCCCAGGAAATAATCATTAAAAGACCAAGTAAAATGCTTTTGAAGAAGAAGGAATTGGGTTAGAGACTATCCTGGTGGTATACTGTTCTAAGAATTTCCTATTAATTCAACAGTTATTTTTTCTTCACAAAACTTTTCTGATTCCAGTATTTCTCCTAATTATCAGTTATGCATACTTAGAATAAGGGATTTCTTTGGTACCTTCTCAATATGGGTAAAAACAATCATAGACATTTCATGATTTCAAAATCATGTTCTTAAATTTGATATTTTATATTTACTTCTGCAAAGATTTTCCCATTGTGTGAATATGTTTAAAGGACTCATACTGTACATCTCTTGTTCCAAAG
>TTN-216,,0,535,694404,694938,GCAAGTAACATAGGATTTGTCCTTTTCAAATCATATTACAATCTTGATCGTTATCGTTTTAAAAGACAAACGATATGGCCATTTTGGATACCATAAATTTTCATTTCATAAAGTCATTCTAGATCCTCTAAACCTTCCTGAGACACATTCCACAAGGTACAAAATTGCTTATCAAATGCGTTTATGCAAAAAAGCCATTTCTTAGGTTAAAGCTCTGTGAAACAGCTAAATCAGACACTGATTCTCCATTCGTCTTTCACCCTTCTCCAATCAGTCTATTATGCTGCTAATACATAGCTATGCAAACTTCATACTACTAAAGCATAGAAAAATCATTTCACGATGTACATGTCCAGTTGGATCCCAGGTTCCCCTAAATAATCTCAGGTGTTTTTTAAAACAGAGGTGCTGCATAACTGTAAAATGTTTGGTAGCCATTCTTTTGCAGGGTGAGTAAGCAATGATCTTGTTCAGGACTTCTTTTCCTTGATGATGTCATCTATATTTTCTAACCCAATCATAAATTTGTCTTTAG
>TTN-216,,0,91,694939,695029,GTAAGTTGATTTAGAAACACTTTTCAAGCAGTCAGCCCATGGTTACCATTAAGTTAACCCTATCACTGAATTGCTCCAATTTTCCTCTTAG
>TTN-216,,0,120,695030,695149,GTAAGTATCAGGCAGCCCCCTACAGCCCTTTCCTTAATGAACCCCATGTATCTATTTGTTTGGTTTCATCTACTTTTTAAACAAATTGTATTAACTGAAGTGCTCTTTGATTTTACCAAG
>TTN-216,,0,745,695150,695894,GTAAGTTAAAAAATATATATATATATATACACATATATATAAAATATCAAATATTCAGTAGATTCATTGATATTCTATATCCTACACTTTGCTGACCACTCAAAAATCCTTGATTGGGTGGGCAGGGTGGCTCAAGCCTGTAATCCCAGCACTTTGGGAGGCCAAGGCAGGAGAATCACTTGAGATCAAGATTTTGAGACCAGGCTGGGAAATACAATGAGATCCTGCCTCTAGCAAAGACAAAAGGAAAAAAAAAAATTAGCTGGGCATGGTGGCACACACTTGTAGTCCCAGCTACTCAGGAGGCTGAGGTGGGAAGATCGCTTGGGCCCAGAAGGCCAAGGCTGCAGTGAGCCACAATCACGGCACTGCACTGCAGCCTGGGCGACAAAGTGAGAACCTGCCTCAAAAAATAAAGAAAAAAAATTGTTAATTGAAACATCTAGTATGTGGTTACACTGAGTAAAGCACTAGTATCTCCACCTGGATAAAATGTTCCAGTTAGAGTAGCATTGAAAGGCTACCTGGAAAGATGCCTCAGTGTCTATCACTTGATCTTTCTGTTCCTCTGTGAGTTGGCACTGTCCTGTATAGTACATGGAAGGTATCAAAGCTTATATCTCTAAACTGTAATCTCCTCAACAGACGCACTAAAAACATTCCAAATTTTTATTCTGCACCTGTTATAACCCACATCATATTTACGTAAAGTCTCCTTGGGTGTTTTTTCTTTTCTCCTTTGCAG
>TTN-216,,0,517,695895,696411,GTATGGTTTCATACATATTAGATCCATAGAAAAAATGTCATACATGCTTTATAAAATTTAGTGTATCAATTAATGAATGGATAAATAAAATGTGGGATAGCCATACGATGGGATATCATTCAGCAATAAAAAGGAAGCACTACGATATGCTACAACATGGATGAACCTTTAAAACTTTATGCTAAGTGAAAGAAGCCAGAGACCATACAAAGACCACATATTGTATGATTCCATTTATATGAAATGTCCAAGATACACAAATCTATAGAGATGTAGATTGGTGGTTGCTTAGGTCTACAGGGGAGACAATAGAAAAGTCCTTGGGGTGATGGCTAAGGGTTACATGATTTCTTCTTGGGGAATGAGAATGTTCTAAAATTATGGTGATGGCTACACAATGATGAATACATGGAAATTCATTGAATTGTATACTTTAAATTGGTGGATTGTACAGTATGTGAATTATATCTCAATAAAGCTGTTAAAAATGTTAATTTTTCTACATGCTATTTTCCAG
>TTN-216,,0,89,696412,696500,GTCAGTTGTTTTGTCTTGCTACATTCCAGTAATTCCCAGTTTCCTCTGAATCACCATACGGTAAACTCGAATTTCCATTTCATCCATAG
>TTN-216,,0,1146,696501,697646,GTATTGTCTACATACTAAATGTTTTGAAAAATCATCAGTAGTCCATAATCTATCATTTTATATTTTAATGTTTCCCTTTTACATTTTCTAACCACCATCCTTTAAAGAATTAAATCAGCTCATTCTTACTTGGCTTAGACTCTCTTATGCTGACCTCAATTTAGTCACAGTTTCCACTCAGGGAATAAGGGTGTCCCTAGCAGCTGTCTAAATACGTTAATTAAAGCAGCTGTAGAAATTTCACTGTCTAATAAATGGCTGCTTGCCAAGCAGCACCAACCAGAAAAGAATTAAAATGTAAATCGTGAGGTTCACACATCAATTAGAATTAAGGAAATTTAGAACAAGGTGATATTTTCTCAGAAGGTTTCTATCTGTGGAGAGGCAAGTGTCAAGGAACTTAGTGGCTAGAAATACTTTCTGTGAAGTCTAAGAGAAAGCCCTGTCCAAGCCGTGCTGGGTTCCTGGCAAGGATGCTGGGCACTCTTGCTGTCGGCTGCATTTACAGAGCTTGTCCTCATAAGTGTCCACCATCCCAAATGATATAATGGAGGAAACATGTCTAGAGAAATACCAGTTGAGTTCAGCTTTATCATATTGCTCATCCAAAGAAAACCAGGCTTTACAGACTGTGGACTATAATGAAAAAGGCTTCAATGAGGACTCAGATAACCTGGAGATGTCTTCCATCATTTATTTGCCAATTCTGAACCTCAGTGTTCTCACTCTTAAAATGAGGATAATAATTCCTACCTAGCCCACAAAGTTATTATTCATATAAAATGAAATCAAATTAAGTAATAACTTTTTAGACAATAAAAAGCCCCCAAAGGTAAAGCATCATTATATCCCTTATTAGTAAATAAGAAGCAAACATTTAAGGATGAAATAATTGTCTCTTTGGGGCAGCTCCTTTCCTCCATGCAGCTGTAAACACAATTCTCTACAAGAGAAGTTTATGTACCATTTGTCCAATACTAGGCAGGAAAAATTAGAGAGTGCTATAATCAGCCAACTTATTACATTATAATATATTGGTTTCACATGCCATTCATTGACCAGTTTTAGAAATTGATTAACTGGGAGGAAACCAGAGCTTCAAGTTTTTGTTGTTGTTGTTGTTTTTTTATGTTGTTCCATCAACAG
>TTN-216,,0,1569,697647,699215,GTATGTAGGGACAGATTTCAGCATATTTTGTGGATCCATCAGAAATAATCCTCCTGTTTAAGTCACTAAATTCTTGTAACTTGAAGGAAATTTCTAAAGAACCTATGGTATTCATGTGGTTCCAGCTACATTTTTTTTCACATTATATCTATGGAAAAGGGAGGGCAGCTGTTAAAAGACCTATTGAGAAGTTATTTTCAGAAAGCACCTGATGGCCAGATCCTCATCTGGTTGCTCAAAACTATTGAACACCCATTGGGTGTCCATTTTCATATACCCCAGATGAGCTTCTAGATTCGCTGTTAAACTATTTTAGTTCTCTGCCCTCTGCCTGAACTGCTCAAGTCCTAGCAGCACTACCAAGTGAAAGGGGTGTTTCCAGCCTCTGATATGGAGTGCCTGGGAGAACTCAAAAGTCCTCTTTGAGACCCTGGAAGGCCTAGAGAGCCTCAGGCAATGTGGAACTCGATCCTCTCTACCCCAAGCTCTAAGAACAGGGGCTCTTACTTTGGACAGGGAATTCCACATGCTACCAAGCACTCCTGAGGAGCCTCTGAGCAGTCCCCAGGGAAGTGCTGTTAAACCTCTGCTCTCCTCATTAGAAATCTTAAGGCTGAATCTCAAGCTGACCTTGTTTTGAGTCTAACCTAGATGCAAGAGAAAAATGGAACCTCCCTTCCTATTCTCATCCTAGGCCATATCTCTTTGAATAAAATACCCCTGAGGCAGATGCAGGAACTCCAGGGGTAATCTCAAGATTCACAAAGATGAACCATATCGCCAGCATTCCCTAGGTTCCTAGAAGACCAAATGGTCATGGCATCCAGTTCTTATTATCTCTGTATTAGTAGTGGAGAAACTGAGGCACAGAAAAGTAAAGATCTTTTCTATGATAGTGTCAGAAACCAGCCTCACAGAAGTCATTTCTTCTAATTTCTGGGTTCCATGAACTAACCAGGTCCCCTCACTCATCACAGCACTGAGAATATGCTTTAGTTAGCAAAACAGGAAAGCTGAATTTGTTAAGTCTACCTAATGGCATTTAACTAGATCTGAAATAGTGTTAATTCAGTCATTCATTCAATACTTACTGATTGCATTTTACTGGCACTGGTACATAACAAAATGACTATGACATAAACACAAATACTTGCAAAACAAACAAACTGGAATGATATGAGCCTCTTCACCACATGATTTGTCCAAATGAATTTTAAAAATAGGTAGCACACGGAAGTTATTGTATAATTCATTCAGGTGTCCATCGCTAAGCCCCCACCACAAACAGAAACTGGGATAATCAGGTTAACTCGGCACTCTCAGCATGCCCCCCAAATATCAAAAATATCTTTCTGAAGCTATTCCCTCTGCATGTGGACAAATTCCAAGTGCTTTCTTCATTCTTAGCACAAAGAATGTTCTAATATTCTGAGGCAAGTAAAAATACCACAATTCCAAAATTTTGTCTCTGGATGTATAACTAGCCAGCAACAAATTAATGTAGAGTTTTGCATGCTCTCTTGTGTTTTTACACTTTTTCATGGGCTATTTGTCAACATTTACTCCTAG
>TTN-216,,0,224,699216,699439,GTAGGAATGCCTCGCTACTTCCAGCTGAAAATAAAACCTAAGAAGCAGGCTTTTGTCCTTTCCCAGTGCATTTAAAAATACAATTTGGAGCTCATAAAAGTAGATTGCTACCCAACTTTGAAAGCACTCTGCAGTGAAATAAATTAAGATAAACCTACATGCTCCCTTCTGTGAGGTCTCTATGGTGACTTAATCATGACAAATCTTGTGGTTTCTTTCTTTAG
>TTN-216,,0,5004,699440,704443,GTAGGTTTAAGAACAAAAGGTGTCATTGCCAATACTTACAAATAATTACATGGGAAAAACATTCTGTCAGCTTCTCCTCCATCACAAACATCTCTCATGCATAATTTGAAGCTTAATGGAAATCTAACAGAAAACTTATTTCAATTATTAAATTAAGAATTAGATAAGTGTTTTTCACTATTTTGTGCCCTTAATAATGGTTGTTTATGTTATGTTATGTGTTCTTTATCACAATAAAAAAATTAGTGTTTTTCACTAATATTAAAAAAGGTCATGTTCCCTTTATGATTGTAGCTGCACTTTAATTTCTTCATTGATAAAATACAATGACAAAACTAAAATTATTAGATTATAATAGCATCTACATATAATTCAAAAGAATAATACATTTATATAAGACATTATTCAGTCTATGGACAATGCTTGTGTGAAAGGTATCCTTTGGAAGACAATATCCTATAGTGGTCAAAAGTCGGGGCTTCATTGTCAAAGATGCTGAATTTGAATCTTGCCTTCAATATATATCATGTCTCTCGTTCTCCTTCTGTCATGAATACATTGAGTATATGATTGCATTCAATCCTAGAAAATATATTTTATGAGGCTAGGAATTCCGTTTTAGTGCCTAGAATTTGGCATCTGAAAAATAGTACCTGCTAGAAGGTAAGCTCTATGAAAACAAGAGTGGATGGTTGCCCCAGAATATCACCTGATACATAGTAGATACTCCATAAGTAATTGTTGACTGGACTAATTAATGATGGTTAAATGACTGTTACCAAACACTTAAGATTATTATCAAGATTAAGTTAGGTAACTCAAGTCAGCACATAGCACAGTGCTCATCATACAGTAATCAATCAGAGTTAGCTGCTACCATTTTTAATTGGGGCATGCTTCTCAAGTACCACCAGCCAATTTCCTCATCCCAGGAATCTGATCTTGGTAGAATGAGACAATATATGTGGAACCACTTCAAGTCATAACTGATTGTCTATAATCACAATTATTTGAGAGTTTCCCAGCCAAAGGGAAACTCTCAAAGCTTGGGCATCTCCCAGCCCTCTTATTAGGCTGATGCAAAAGTAATTGCAAAGTTGTATTGTTTTGTTTATTATGCTTCTCCCATTAGTTTATAATCCAATCTCTACCTTGTCAAGATTTATTTTTCTCAACAGGTTAGTACTTCAGTTGGTCTTCTGACCCAATTATTTCCTCCTCAGGAATGGAGATGGTGATCTAGAAATCTAATAGACCTATTTGATTTTATGAGCATAATTAAAAGATATAATGTATGTAAAGCACCTATAGGCATGGCTGCCAGGTAACTGGGGCTCAATACATTCATTTTATTATAGCCATAGAGAGGAATTATATAAACATCAATGTTTAGTATTGTATGGCCAGTATGGACAAATACCATAGACTGTATATTTGAGGGATAGTGTTCAAGAAATGCTAAATATTAATAAATGAGGACTGATTTGATAATATCCTACTAACACAATAATACAAAATATATTTTAAAAGCAAGTTCATTAAAGCTACACTAAATAATTTATCCATTTATTTAATTTTTAGAGGAATTTTTTAATATAAACATATATGTACATCATTCAAAGTAGTAATATTTGTCTTAACTATATTGGTATAGTGCTTTTAAGTCTATAACATATTAACATATGGTAGTATTGCCTTTAAAGTGTTGTAGAAATACACCTGAAGCACTCTACAAGACACCAATTGGGGTAGAAAGAGAAAAATTTCACTATCTTTTCTGCATAACCAATGTCTTTAAAAAGGTTTGAATAGGCTTTGTAAACTGAGAAGATCATTAACTTCCTATGTGTGGTAATATCTGTACACATATAGTGGTTTTAGCATCCTCTTATAAATTTGTTTTCTATATGAAAGAAATTAAATTCATTAAATAGAATGACCCTTCAAAAACTTGCCAACTCACATAGTTTCATACCACTGGGACTAAAAATATTTACAGAACTTCCTCTGGCCAGGTATTGCCTTAAGTAAGTGTAGCCCTGCTTTCCACAAATTGGAAAGAAATTGGGAGTCTTCAGAAGCTCCCATGTTCTTGGGGGTTGTAATACTTTCTGAAGCATGAAACGTGGCCCTGAGCAACCAGGTGCTGTTTCTAACAGCGAAAATGTTACCTATTGAAGGTCTCCAGTGCCACCTACTGGTAGAGGAGTAATTTGGAAAAGCAGAATCTTAAAATGTAAAAAAGCTATTTTTTTGCTGTTTATTCTACAGATGATGAGTCAGTGTCATTTGGAGGCTTACAGAGTGACAGCTAGCTAAACAGAAATGATGAATAATTAGTTTAACAATGATATTGTCTGTTATTCATTTAAGCATCTGTGCAATTTTAATTCTACCATTTATTGTTTCCCTGCTATTGAGATATTACCCTAGGTGCTGGGGTGCAGATCTTGCTCTTGCCTTTAAGGAGCTTGACATGTAGGTGAGGAGATGCATGCACACAACTATATCCCAAGGTTGTAAGTGCTATTAACAGGCCCACGTACTCATCATTCTCTGTCTGGGAGAGAGCCAGAGAAAGATGTGTGAACTGAGCATTGAAAAATATGTAGGATCATTGAACACAGTGGCATCCTATGATGAGAAAACAACATCTCCAAGTCATCAAAACTTGCAATAATGCTTCATGTGCTAGAAGCAAGTGGTTTAAGTACAGTTGGAAAGTGATATCATGAGTGGGTAAGAAGGCTGGATAATACAGCAAAGGCCGTGCTAAAGTTTTTGGTATTCTATGCTGAAGATTTTGGAATTGATCTTGTTTACATTTAGGAGACACTGCAGGATTTTTAAGCCCCTGGGTACCATGATCAGGTTTACTTTTTAGAAGTGATACTGTGATAGGGAAAGAAGGGATGGACAGATGTGGGAGGCAAGACTGGCAGTCAGGAACTGGAGAGAGATTATTACAATAGGCCTGGAGAGCGTGGATGAGGCCCTCAGCCAGGGCAGTCAGGAGAGACAAGTGGGGTATTGCAGAAGTAGTAATATGGGAGAAGAATGGCCTCAAAGAAGACACGAGAGGCTAATGAGTAACGCAGATCATGGCATCACAGCCACAAGCACCAAGTCCACTACCAAGAAAAGTTTTACCTGTTAACTCACTTATTGTGTGCAGTTCATGTCCAGTGGCAGTTCATGTGTATCCTGGTGCCTCATTCAGTTCACCAAAGGAAGAAGCTGTCAGTAGAAATAAGCAGAGAACCTTGTAAGAGGATGTACCATTGATGATCTCACACACACACACACACACACACACACACACACACACCCCTTCACACAAACTAAATAGGGGTGGTGTTTCATGTTATATCACATGGCACTGTCTTTTGGCGTGTTATTGAAGACAACGTTGCTTCCATCTGTGATGTTAGATATTCTTGCTATAATGACTGACTTGTGCCAGTGGCTTATAAAGCCCTTCCATGTGTGTTATATCATTTAATTCTCACAGCAATTATATGCAACGAATAGCCCATAAATTATTACGCATGCCATTTTACAAATGAAAAGACTAATCCAGAAAGCTTAAATGACATTTCCAAGGCCACACAGCTGACAAGTTGTAGTGTCAAGATTTCATTTTCTTTATATGTATATATTTTGATGGAGTCTTGCTCTGTCACCAGGCTGGAGATCTCGGCTCACTGCAACCTCCCCCTCCCGGGTTCAAGCTATTCTCCTGCCTGAGCCTCCTGAATAGCTGGGATTATAGGTGTGTGCCACCACACCTGGCTAATTTTTGTATTTTCAGGAGAGACTAGGTTTCACCACGTTCGTCAGGCTGTTCTCGAACTCCTGACCTCGTGATCTGCCCGCCTCAGCCTCCCAAAGTGCTGGGATTACAGGTGTGAAGCACCGCGCCTGGCCAGGATTTCATCTTCTACTTTACCTTACTATCTAAGGAACTGAACAGATTTGTTACTCTAAGAGGAGAACCTGCCATTTATACACATCTACCATCATGGGCAGGAGAGTAACTTTTATAGACAAGTATTGGCATTAAAATGCAGACAAATGCTAGATGATTGGACTATTAGAAGATCATCTTGGATGGTTTTGAGACCAAGAAGTGGTATAGTGACTGTGCTCCAAAAACAAGATGGCTTTGATTTTGGCTATTCAAACAGTTAACTAAAATTAAAGTGCATATCACCTACAATTATTACAACACAATAACCTGCTACTTTACTGTAATTTGGGTTTTTACTTTCTATTATTTTAAGATGGTTCAAATCCTTATATAGAAATAGCTAGCTTTATTATAATGTCTTATAACTGCCACTCTGAAAAGAGTCAAATGTATCTAAGATGCTCAAATACCATAATAAATCACCCTCTTTATTTAAAAAATTATTTTCTCTACAATTATTTGTGCCATATATACTGCGTACTGAAACCTTTTGCTCATTAGTAACAAAGATAGAGATTTTTTTTCTACAGCCTTCAAAGGTATCTATTTTAGACTTTTCATATCTTGATCTTCTCAGCTCTCTTTTTGATTGATTTTTCTGCAAACCAAAAGTGGAGATTTTTCTCATTTCCTGTCCCAGAAGGCAACTACAAGCCCAGATCAAACCTTTCCTGATGACTCTTCTTAGGACTGTCTTTTTCTCAAAGTCACTGAATATGTCAAAATCTTGTCTCTGCTTCCACTGCATGACATGCAAATGTCTAAAGAGAATGTAACTGAAGTTCTATCATTTTAAACATTACAACCAGTTCAACCTTAGGACAAGCTATATTTTTCTATCATTACATTTCCTTCTTGAAGATGAAAGGAAATCATTTAACAATAGTAGATATGGCATGCCCAGAGAAAAGTATCATGTTATTAAGTCAAATATGAAATGTAGGCACTAGTATTATTAACATTGTGTTTGCAGGTAAATTGTAAAAATCCACTCATTTTTGTGGTTGAAGTATCTCTTTTCTTTTGTGTCGCAG
>TTN-216,,0,1067,704444,705510,GTAAAGTAAAACAACTTTCAGAACCCCATTTAAATATAGATCGAATCTTAACAATGTCTGTAACAATTACTCAAGAGTTCATGTAAATCATTGTTGTTCCTACCATTCTCTTCTAATTCAACTAATTATTTCCCTGTTATATGCCATGGTCTCGCCTCTCCTTTACCACTTTTCATTGTGAATCATAGACCATCACGTTTCATTTGGCCCCGCTTTTTCTCTGTAACAATTTGTAATGTATTGCTGCTGTCACCAGCTGTCATGCTTCCTAATCAGCATGAATCAGAAGGGGGCGAAATATGCTGCATAAATAGGTAGATTTGTTTTCTCAATTGGCTAAGATAAAAATTAAATTTTAAAAACATCTAAGAGTGTTATCATCCTCCTATCATGCTGACACAATTTTGATTTCACAAAAGCTAGACCGTTTCAGGTCTGTACACCAGCGAGCTATATTCATCCTCCTCTCAAGAATGTCTTAGTGTTAAGAAGTCCAGTCCTAAAGTGGTTTAACATTTCTGTTAGTTGGGGCTCTTAAATTGTAATCAGAAACACTTCCTCAGTAACATGGGGAATTTGATTCAAACAAGGATAGCATTTTTATATAGTGGTACTATTTTTCCTGAGCAAATATAGTCTATGTAGTATTAAGTACATACAAATACATAAGGATTTAGAGAAACTATTTTTTTCTTAACCTTATGCATTAACTGTAACTAGATGTTTTTTTAAATAATGAATTTAAAGTGGTTTAAAATTAAAAAGTTGACTTTACAACAAGAGGAAGAAAGAAAAGAATATCCAAAACCCTGTTGGGTACTCCACTATTGCCTTCATGAACAATGTAGTGAAGTTCCTTAGCCCATTCATGTCTCAGCTTGCTTCTCTGGGAAATGGAAGTGAACTTGTGTGACTTCGAGTCAATAGTGACATACAAGGACAAGGCAGTAGGAGTGGACTGAATTCTAGTCCATTATTGAAATTTGTGACAAATCTGTAGACAACTCCAAATGAGTTCTGGTTTCAGTGCAAGGTAAGACATTAAAAATTGGTATGCTTCTTTTCAG
>TTN-216,,0,744,705511,706254,GTAAAGCCCATCTTGCTTCAAGGACTTTGATTTGCTGTATACCTCTCAGTCCCACTGTTACTAATGAGAGTCTCTGCTGTTTGTTTTATTGCATACTGTGGTCAGTCCATAACTTACTAATAAAATAACATGCAATAACTCCCGCTAGGTCCTCAATTATGGGTTAACCTACATACTTTAAATTTCACTGAAGTATGTGTTCTATGCACTAGAGAACCAATAATTATTTTATTAGGCACCACCTTTGCTTGGCTTCTTTACTCTTCTAAGCAATATTGTATCATTGCATCATTAAATGATCTATTTGCTGATTATTACTTACTGTACTTAAAGTAAGTACAGTATTACTTACTGTACTTAAAGTAAGTACAGTATTACTTACTGTACTTAAAGCATACAGTGGACGGAGAGCAAATGCTAACCCAAATACAGTCAGCTAGAGGGAGAGAGAGAAAGACAGACTGGGTCACTTTGGATAGCTGAAATGACAACAGAAAGAAGGAACCAGATACTGCATGGCATCTGCATGAGTCTTCATCAACCACTCAGCACTGAATCACCAGGAATGAATTTTCTTTTGTGTGATCCTGACATCTAGATCATATTGCATCTGGCATGCTGCTTTCAAGTGACAACTACGTCTTTCATCTTCATCTTCCATGCCATTTTGTGTTACTAACATGGGCAAGTGACAAAGCTTAGATCTTAATATTCTTTTCTTTTTCTTGTCACTTGATTATACAG
>TTN-216,,0,3041,706255,709295,GTTAATTGATTTTTAGCTATGACTTGCTTCATTTCATCCTCATCGCTTTATGCAGCTTTTCTGCCATGCAAATTCAATCGACGAATATATTAATTAGAATATCTCTAAATTAGCACCCTATTCATAAGTGACTTCTGAAAGTCAGCCAAGTCATTGGCCATGATTATCCTGAAAATTTAACTTACCAGTCTAGATTCAGAAAGTTTAATTTTTAAACGTAGGTTCGGGAAGCAAAGGTTTATTTCCTATGTGCTGCATTTTCTAATATTTACCAACGCACTACCAAGAAAGTGTAGCAAAGTTAAAATGTTGTATTCTGAGAAGTACTTATTGGGTATTTATTATTGTGCCAGATACTGTGGTAAATTTCAGTTTAATTGTTTTAATAGCAAGAGGTTCAACAATTCTTATCTCCTCTTTATTTTCACATCTGGAGGTTCTAGTTGTTTACAAAGGGGCCATGAAAATAGAAAATTGGGACCAAGTACAGTGACTCATGCCTGTAATCCCAGCACTTTGGGAGGCCGAGGCAGCCAGATCACTTGAGGTCAGGAGTTTGAGACCAGCCTGGCTAATATGGTGAAACCCCATCTCTACTAAAAATACAAAAATTAGCCAGGCATGTTGGATGTTGGTGCATGCCTGTAATCCCAACTACTCAGGAGGCTGAGGCCAGGAGAATCGCTTGAACCCAGGAGGCAGAGGTTGCAGTGAGCCGAAATAGGGTCACTGTACTCCAGCCTGGGCAACAGAACTAGACTCCATCTCCAAAAAAGAAAAATAGAAAATTGAAAATTGGGCACTGAAAATAACAAAGCTCTCTCTGGACCAAAATTAGAAGTCTCTAGATATTTCTCCATAAATGATGCTGCTTTTACAGGCTTAAAATCCTCCTGGAATTGTATAATTTTCTCATGGCAAGATCACAATTTTTGTCGTTATTGGGCTTGATTCTCCATTATGTCTGGAAGAGCAGGAATAAACTTGTCTGGGCAAGTAATAACTTCTTCCTCTTATCCATGGACTTTCCTTTTGGATATTAATGAAATGAGAAAAATATTTTTCAGGTGCCATAAGCCTGTGTTGTGTGCCCGTAGTCAAAACAGCTTCACTGAGTCTCATGGAAGGAAGCTGGTGGAATAAATTCAGGCATCTCCAGGGGTCTGTGGAAAGCTCTGGCCTCAAGTTCCTCCCTGATCCTGGCCATAGTGGTGTTAGGGATGAAAAGGGGGCAATGCAGTGCTATGTAGGTGCACAGCCATCTCTGCACAGAATTTTGAAACAGTGGCCTTTCTTCCTACCCAGTACAGAGAATACAGTTTATTGATTCATATAATGTATCCGCAACACCTACTCACCAAAAAGAGGTCTTATTCTTTCTTAATGAGATTTTGTTCTATAGCTATCTCTCATTCTGTCACCGTAGCCTACAAAGGCAATATCTCAAGAACTGAGGTCTAGTTATGTAAATTAGATAGAAAATTCCACCAGCCAGAGAGTTGACCCTCAATTTCACTACAGCTGCTGGCTAGCACAGTAATCACACAGAGTCACTATTTATTTGGAGGTGTTGTCTACAAGTCCTGTAGGTGACAGTGTGACAATTTTTTCAGTAATGTAATTGGGAGTTGGCTGTGTTGTGAAGGTGGGAGAAATGTAGATCTCTTAACTCACTTCCTAAAGAATCTAGTGCTATAGTGCGGTGTTTGACTGTCATATTCCCAGAATTGATTTGAACTCGGCTCTTTTGCCCTAGGATCTCCAGTTCATTCAGTTCCAATTGATAATATTATTAAAGTGTTCTTGAAGCAAAAGAATTTTTTTGAACATCCAACTGCCTTACTTGTACCTAAGAAAGTTGAAAGATAAGACATTTTTAGATGTTTGAAGAGTGAAAGATCAGGCACAGTTGTCTAATTATTTGACATAGGCCAGTCTTTATATGTTCCTTTTTTATTTTGGCTTAATAAGTTCATATAGGCTACAGAGTTATCCACCAAGATCAAGTAGGAATGTCAAACCCCTGGAAGTCTTTTTGAATACAGTTATTATGTGCATAATAAACATAAACATATCATATATAAGTTTCATGACTAACATGCTGCCTTTCCTTCTCATCCTAATGACATTCCATCTTCTCCACATTCAGCATGTTTTTCATTCTTACAAACACAGCTAATTTATGCCTTTCCCTAACTTTATTCTTACCTAGCAAAAGAATCGCAAGCCAGAGCACTTACAAAAATTACTCTGGGTTCTGACACTAAAAGTATTAAAACACTCAGAGAGTCACAAATTAAAACAACCCGTGAAGTAAAAAGAGAATCGTCAAAGAAAACATCAAGTTTGTCATTAACTTCATGCCAAAAACCGTAAGAAACTGAGAACAAGGGAATAAAGTCTACTGACAGGATACCACGTGGACTGAAGACTGAGAGTGATACGAGAGCCCCAGCCTTTCCCAAGGAGCTGCCCTAGATATGACTGTGTCTAAAAGCTGTGCATATTCCTTGTGGAATAAAAACAGTTTTGATAAGTCTTTGTTTTGTTTCTTAATATGTAATTTGGACTTCATGTAGTTCAAAGTTTGAAAGGTGATTCAAATCAAAGGAGTGTTTACTAGCAGGAAAAACTGAGAATAGCCCTCTGCTAAAGTAGCAATTTAGAAAATGCATGTTCTTTCTAAATGTGATTTCATCTCTTAGCAAGTGTTTAGTCAATAGGACATTTTTTAGAAAATAATATTCCTTCGGTTTGTAGATTGCTTTCTGCATGCATGTAAAGGCATGGGGAATTATAGAACTAAAAGTGGAAATTTCATGAAGAACCTAAAATAAAAATGTTTTAAATCTTTCTGTCAACATTGTCATGTGTTTTATCAGCTCAATAGTTTGTTTGGCATGGACTTTTTGGTAAATTTGGGGAATGTAGTTTTCTGTTGTTATAATAAAAAGAAAACTTTAATCATACAAGTCATGAATTGATGCAGAAAATATATGCAATTAATCACTAAAATCTCTTTATATGTTTTTCTATTTTAG
>TTN-216,,0,11202,709296,720497,GTATTGTTATAATGGATGTGAGATTTAAGTAGAAATTCTAAAGGATTAATAGGATCCTTGAGTTGCCTTCTTTCTCTTAGTATTATTGAGAAAAAAATGACATAGATATACAAATATATCTCTTAGAGTATATATTACTATGTCGCATGCTTGGTTTAGAATTTTGATGGTTACATGCATTTCACAGTAATTTATTGTAAGTTAATTTAAAATTTTGTATTTAAAATTTATCAGCCAAATTCAACTTTATGTTTGCAGTCATTTCCAAAAGTGTATATTAGGAGAAGTTGTCATCTTAATGCATGAAATCATGAAGTAGAAGTTTGTTTTCAAAATCACGGTGAATTACATTGAAAATAGACAATAACCTAGCTGTCATTCTCAGAATGCAATGTCATGAATGAATTATGATTGAAATGCTACTTTACTGAGGTTGTGTGAAAACATTACATTCCCATCTGGTTTACACTTCATTCACATATATCATTTTAACATTGATATGTCTCTTACACTGGCTTGCAGATAGCTGCCTTATGTGATCCTTATTGCCTGCTTTTCTTTGCATAACATTGTGACTTTATGGCTGTATTAGTTCGAATAAACGCCTTCTCATTTTATTTTAGCTAATTATTTATGGTTATAGTTCTTGTATATACTCTTTAAATAGTTGATTCTCAAAAATATAATAATTTAATCTACAATCAAAAGAATCAGAAAGGGCGTTTATTCCACTCTCTGCAAGTCAGGTAAGATTTTCCACTTAGCCATCAAAAGAACAAAGTTTTCCTGCTCTCAAAACAAATATGCACAGGAACATGTTATTTTGAAATGCATTTTTGCTTGTTCAAGAAGAAATTTCAACAGTTTGAAGAAAAGACCAGACAACGAACGATTTTCGTGTCAGAATCTTTTAAACAGAGCATGGTGTTGCGTTTATTCGAACAAATATGGTGAGTGAATTTTTCTATGGATTTGTGAGATCTGTAGCATGCAATTTATTTCATTTCCTATTTTGCAATTTTATTTACTTTCAACTTTTTCAAGTTCTATGGAAAATAGTAAAGGTTTTTTTTTTTTTTTCCAGAATTATTCTCTGAGGGGGAATCTGAACATTCAGAAAGGGATACACGTGACGCCTTTTCAGATTCTGAAGACATAGACCACAAATCCATGGCTGCTAAAAGATATGCAAGTAGAATATCATCTACAAGCTCCTGGCCTGAATATTTTAAGCCTTCTTTTACCCAGAAACTTACATTTAAATATGTTTTAGAGGGTGAACCGGTTGTTTTTACATGTAGATTAATTGCCTGTCCAACTCCAGAAATGACTTGGTTTCATAACAATCGGCCCATCCCAACAGGTCTTCGTCGGATTATAAAAGCTGAGAGTGATTTACACCATCACTCTTCCAGCTTAGAGATTAAAAGGGTCCAAGACAGAGATTCTGGAAGTTATAGGTTACTAGCAATTAATAGTGAAGGGTCTGCAGAATCAACTGCATCATTGCTTGTTATCCAAAAAGGGCAAGATGAGAAATATTTAGAATTTCTGAAAAGAGCAGAACGGACACATGAAAATGTGGAGGCTTTAGTTGAAAGGGGAGAAGATAGGATAAAGGTTGACCTGAGGTTTACTGGCTCTCCCTTTAACAAAAAACAAGATGTGGAACAAAAGGGAATGATGAGAACTATACATTTTAAGACAATGAGTTCTGCCAAGAAAACAGATTACATGTATGATGAAGAATATTTAGAAAGTAAATCTGACATAAGAGGTTGGCTTAATGTAGGTGAAAGTTTCCTGGACAAGGAGACCAAAGTGAAGTTGCAACGTTTAAGGGAGGCTAGAAAAACATTAATGGAGAAAAAGAAATTATCTCTTTTAGATACGTCTTCTGAAATAAGCTCAAGAACTTTGAGAAGTGAAGCTAGTGATAAAGATATTCTGTTCTCTAGAGAGGACATGAAAATCAGATCTATGTCTGATCTAGCTGAAAGTTATAAGGTAGATCATTCAGCTGAGAGTATTGTGCAAAATCCACATGCCCTTTCTAATCAAATGGATCAAAATATAGAATCTGAGGAACTTCCCACAAGCTTTCAAACTATTGTTGATGAAGAAATTTTCCAGACTGAAATAAGAATGAGCCAAGAAGCACTGGTAAAGGAAAGTCTACCAAAAGACCATTTATATGGTGAAATTCTAGTAAATGAAAATACCCAAGCAAGAGGACAGCTGGAAGAAATTATGGCCAATACTACAATTGGAGAGTCATCCACATATATCACTAATGTATGTGAGAAGGAGGAAGTATATGAGACTCCTGAAAATGTGTCTCAAGCTATTACACCACATGCCAGCGAATCTTTTGGTACACTTGTAAATGTTGAAGAAAGTGAAGAAATAGCTAGTGAAAGAATAAAAAAGGATGATTTGAGAGAATTACAACTCTCTGCTTCTACACGAATTGATGAATTCAAAACCGAACAGAAGGAAGAAAACATGAGATTTTTTGAAAATTCTTTTCGAAAACGCCCACAACGTTGCCCACCTTCATTTCTTCAAGAAATTGAATCTCAAGAAGTTTATGAAGGTGACAGTTGTAATTTTGTGTGTCATTTTCAAGGATATCCTCAACCTATAGTGACGTGGTATAACAATGACATGCCAATCCCACGTAATCAAAACTTTATCATTCATTCGTTGGAAAACTATTCAATATTAACTCTTTCATCTGTTCATCATCAGAATGAAGGTTCTATTACTTGTGTGCTATTTAACCAATATGGAACAGTAAAAACAACCAGTATGCTTAAAGTGAAAGCAAAACAAAAACATGATGTCAAAGCACATAAAGTCCCAGTGTTCCATGACTACTTGGATGAGGAAGAAGAGTTAGCATTGGTGTTTGACCAAGCAAAAGGCGCCCATCCATCTATGAGTCAAGAGGGCCAAACAAATCTTCATTTGTTAAAAACTAACCCACCAGTTCCTCCCTCTGGAGACACAGAATTGCTTTCCTTTCCTGTAGAAATTCAGGTAACAGCAGCTACTCCTATCCCAGAACAGGATAAAGAGTCTAAAGAAGTGTTTCAAACTGAGGAGCTGGAACCTAAAGCAATGCCTCAAGATCAAGTTACTCAATCACCAAAACACAGATTTGTATTTTTGTCTGATATTACTAATGAACCACCAAAAATGTTACAAGAAATGCCAAAGCATGCCAGGTGTAGAGAAGGGGATTCCATCATTCTTGAATGTTTAATATCTGGTGAGCCCCAGCCAGTTGTAACATGGTTTCAAAATGGAGTCCTTTTAAAGCAGAACCAGAAGTTTCAGTTTGAAGAAGTTAATTGTAGCCACCAATTATATATTAAGGATGTTAATTCTCAAGATTCTGGAAAATATAAATGTGTTGCTGAAAACAATTCAGGGGCAGTTGAAAGTGTTTCAGATCTAACAGTGGAGCCTGTCACTTATAGAGAAAATAGTCAATTCGAAAATATTGGTGAAATTTATGGAAAATATTCCAGAGATCAGCAACTGCAAGACCAGGGAGAATCTGTAAGGGCACATTTTTATGATTATCCAGCTGGTCCCTTTACTCCCTGGACAAATGTAAAAGAATATTCAGTAAGGGACTATTTTCAAAGCCTTGAGACTATTGAGCAAATAGACCAGAAAGAGCAGGTGCGTTGCATACCTTCTAGAGAAAAAATTCCCAGATTTGTGCATGGTGCTTCAAGAACCATAAAAATCAGCAAGCCCATCAGGGCTGAATTCATACAATGTCAGGCTGAAGGGAAAGAGAGACATGTAAGTGAAAAATCAAAGCTGCACCAAGCAGAGGGTACTGTTTATCCATTTGTTGATGATTTCAGTGATGTCACTATTAAGAAAGAAATAAGAAATAATTTTGGAAAACTTGGTAGATCAGAAAAGGAAAATGTACAAGAATGTGCCCAAAGTGACTATTTACCAAATATTCACTCTGAGAGAATTTCTGACAGTTACAATACAAAAGATTCATCTGCCATTGTATATGAAGAATCCCTTGGTGAAGAGATACACTACCCGGGGAAAAAGGTGAAGCATAGAATTATCGAATTTGAAAAATTACATGTAGAAAAAGGAGTTCTAGAAAAAAGACCTACCAGAACATCAATTGTTAATCCTCCTCAAAAGAAGATTGATGACAAAGCCTTTTCATTAAAGCAAAGAGAATCAAGATCAAGCAATCTAAATGCAAATATGTATCAGGCAGAGAAAATGTCTCCAAATACTGAATCAGATTCATCTAACATTGCAATAAATTTAAAGCTGCTTTCCTCTCAAACTCATAAAGAATTTGACGCACAAGAAAGGGAACAACAGGAAAAAATAAGTCTTATAGATAAACCTGCAATTTCTAAAAGAGCTGAACATGAATCACCTATTACATTTGACTTAAAGCAGTTTCACACTCAAATAAAACACACAGATGTGAAATTCCAAGAATTAGATAGTGGTCAACCAGAAGAAGCTTATTTTAAAATCCAACATCCTGCTGACACTGAGAACATTGTATTTGATCTAAAACAAATGTATTCTCATATAGGAGATCCAGCTCTGGAGTTCCAAGGGCAAGAAACTAGGGAACAGCAGGAAATACATTATAAAGAAAAAATTCCTAGCCCTGAAACGTTACAACCTGACACACACAATATCTCTAAAAGTGTGCAAAATAATGTATTTGCCAGTCAAGAAATTTCTTCCAGTCAAGAGCTTTCAAATAGAACTATGGTGGAGAAAAGTAGTATTGATGAAAATTCCATTTCTTTAGAAAAAGAAGTCCGACATGTACAGGAACAAAACTTAGACATTTTAAAAACTGATCTTTCTCTTAAATCCTTTTCTGAAGAAATCTATAGTGAATCATGTGCCCTACTTCCAACCTCATCTGCAGATATAGAAGAAACTGATCTTTCTGAGAAAAGTTGTCCTCTAGAAAATGGAGGCAGAAGTTCCATCTCACATTTGAAAAAAGCAGCAAGTGAGGAAAAGCCTTTAGGGGTTGGTGAAATGGAAGAAGAATGCACTCTAGAACCAGAGTTGGCAGCATTTCCAAAGCAGGATGGTGGGACACAGGAATATACAGATGCCACTTTGGAAGACCACAGAGGTGATGTTCAGGAAGCTGACACACTCCATAGACAGCTCTCCCTGAGTCAGTGCTTCCCACTCTTGATGACTGAAGAACAACAGAATCCAGGTGAACAAATAAGTACAAACATTCATGCCTCTGGAGAAGAAAAATGTTATGAAGAAGTTCAAGTTCAGAATGAAGCTTCTTTCTCCACTTTAGAAGGAGAAATGATAGAAACTAGTTTTTCTCAAAATATTCCTAAATTAGATGAGGCACATACCACTGAGGCAGCAGAATCTGAGACCTCCCTAACACAATATTTACTTGCTGCTGGAAAGCGTGAGGTTCCTGAAACTAAAGACACCAGAGACCAGGCAAAGCTTGTCCAGAGTGAATCAATCACTTCAATGGAGGTGGAAGAAGTAACTTTCAACACTGTGTATGAATACTACAACCAGAAACAGGAATCACTAGGTCGTCCACTTTCTCCTGAGTCTGACATTTCCATTGGTGTGGGAAGTACAACCAGTGAAGAAATATCTGAGTTAGATCAGTTTTATACCCCACCATCATCTGTTGAATATTTTGAATCTCCAAAGTCCCCTGACTTATATTTTAATCCTTCAGATATAACTAAACAATCCTCAATACATTCAGGAGGTGAGACAGTTGAAAGATATTCCACACCTTTAGGGGAAGTTGCTGAAAGATATTCAACACCTTCCGAAGGTGAGGTAGGAGAAAGATACTCCACACCCCCAGGGGAGACACTAGAGAGATACTCCACACCTCCAGGAGAGACTCTAGAGAGATACTCCACACCCCCAGGAGAGACTCTAGAGAGATATTCCACACCCCCAGGAGAGACTCTGGAGAGATACTCCACACCCCCAGGAGAGACTCTAGAGCGATATTCCACACCCCCAGGGGAGGCACTAGAGAGATATTCTATTCCTACTGGAGGACCAAACCCCACTGGTACTTTTAAAACATATCCATCAAAAATAGAAAGGGAAGACGGTACACCAAATGAGCATTTCTACACACCTACAGAAGAGAGGGGTTCAGCTTATGAAATATGGCGTTCCGATTCATTTGGTACACCCAATGAAGCCATTGAGCCAAAAGACAATGAAATGCCTCCATCTTTTATTGAACCTCTGACCAAAAGGAAGGTATATGAAAACACAACACTAGGCTTCATTGTTGAAGTTGAAGGTCTTCCAGTTCCTGGTGTGAAATGGTATCGAAATAAATCTTTACTAGAGCCAGATGAAAGAATCAAAATGGAAAGAGTGGGTAATGTGTGTTCACTGGAAATTTCTAACATTCAAAAAGGAGAAGGGGGAGAGTACATGTGTCATGCTGTAAACATCATAGGGGAAGCAAAGAGCTTTGCAAATGTAGACATAATGCCCCAGGAAGAAAGAGTGGTGGCACTACCACCTCCAGTAACACATCAGCATGTCATGGAGTTTGATTTGGAACACACCACATCATCAAGAACACCTTCTCCTCAAGAAATTGTCCTGGAAGTTGAATTAAGTGAAAAAGACGTTAAAGAATTTGAGAAGCAGGTGAAAATAGTGACAGTTCCCGAATTTACTCCTGACCATAAAAGTATGATTGTGAGTCTAGATGTTCTTCCATTTAATTTTGTAGATCCAAATATGGATTCAAGGGAGGGAGAAGACAAAGAACTAAAAATTGATTTAGAAGTATTTGAAATGCCTCCTCGCTTTATAATGCCTATTTGTGATTTTAAAATTCCAGAAAATTCAGATGCTGTATTCAAATGTTCAGTCATAGGGATCCCGACTCCCGAAGTTAAGTGGTATAAAGAATATATGTGTATTGAGCCAGATAATATTAAATACGTGATTAGCGAGGAGAAGGGAAGTCACACTCTTAAAATTCGAAATGTCTGTCTTTCTGATAGTGCAACATACAGGTGCAGAGCTGTGAATTGTGTAGGAGAGGCTATCTGTCGGGGATTCCTCACCATGGGAGATTCTGAAATATTTGCTGTGATAGCAAAGAAAAGCAAAGTGACTTTAAGCAGTTTAATGGAAGAATTGGTCTTAAAGAGCAACTACACAGACAGTTTTTTTGAATTTCAGGTGGTGGAAGGGCCTCCCAGGTTTATCAAAGGTATTTCTGACTGTTATGCACCAATAGGTACAGCAGCATATTTTCAGTGCTTAGTTCGTGGCTCTCCAAGACCCACGGTTTACTGGTACAAAGATGGAAAATTAGTCCAAGGAAGAAGGTTCACTGTTGAGGAAAGTGGCACAGGGTTCCATAACCTGTTTATAACAAGCTTAGTAAAGAGTGATGAAGGAGAGTATAGGTGTGTAGCTACAAACAAATCAGGAATGGCTGAGAGCTTTGCAGCACTCACCTTAACTTAAAATGTAATGTTTTAGTGCCTCAGTAATTATTAGCATTGATCTGAGTGCTTTCATATTTTCCAAATTATGTGGATCTAATAAACTTCCAAACAGGTCCACCATATTTGAATTCATTACCTTGGAGACCCCTAAAGAAATAATCTCTATGTAGAAATCTCATCTTTGTAATACATGTAAATATTTTGTTATCTGAACTGTGGAATCATCACTTGTGTCAATCATGCTGTGTAATATCAAACACAATTAAATCTCTCCTTGGCTACCTAATTGTTTGTACTTCTATTTACCCTCATGCCTCCTCCACAAAGTGTTTCAGTGGAATGGACTCTCTTTTAGCAGATAAACCATATATGCAAAAGTACAATGTAAAAGTGGAGACCATATCAGATGACCACGCAGACAAATTGGTAAGGGCAAATCTCTCTGCTCCCATTCTAAGTTATTTTTGGAATTTTAACCCCTTTGCATCCAAACTCATGTTTATTTACTTTGACTTAGAATAGGCAAAACAAACAACAAAAACCAGCTTCTCCCAATTGGCAACTAACTCTATAATCTGTTTGACATTTCAATCTTAATATATTAACTTCATCTCTTTTAAAAATGTTTTCGTTATTAATATTCCTCTTCATAAGTGCTTTAATTCTCACTGGCTTCAAGGGACCAATTGTGCTCTTTGTGGGCAGGGTTCACCTAGACATTTGCAAAATAAGCAAATAGATCTTTCCACTTTTGGAGATACCTTATTTTTCTCCATTTTTGAGATGACATCAAGTGTAAAATGCAGCAATAATTTAGTATTGGCCTGGGGAAAAAAGGGAAACTATCATATTGTGTTTACATATAGATTTTAAAACTGTATTCTGATTTCAGAATCTTTAAAATTTAAAAAAAGGTGGGATATTTTTAGAATTGAGACAATATGGTAATTTGTATTTCAGATTATATATAAATAACAAGATAACAAGCTTTCCTATCAGTTTCACTGAATTTCATCTTTAAAACGAATATAGCTTAATAAGCATTCAATTTTTATTGTGATGTTTATGTTTCTAAAGTAACTCTTTAATTTTGTCTTTTAAAATTAAAATAACAGTAAATTAACATACTCCTTAATATCTTACCTATATACTAATGTGGACCCAAGTCTTCTCATATAAGACTCGACAAATATAAAAAATTCTGAAAATGAAGGGTAGGACCAAAAGACCTTAGAGGTGATCATTCAACAATACAATTCTGTGTTAAGCTAATAGTAATTATTCTTAATACAATTTAGAATAAACTTTAATTTTGTAACAAAGGACGAGAGAAATAATATTACAATGAAAGATAAATTTTATCTCCCTCCACCTCTTAAATTACTTATTGTTACTTAATGGCTACATTTGTCACCTGCATTTAGCAATATTTAAGTACCATTATCATATTTAAAATGCTAATTTTAATTAGAAATGTAAACAATTTAAATTTAATTTTCAAAAGAATTCATATCCAATTATGTTTATTATGTTTCTTTCATCTATCAGTCTTTATTCTCAACATGGGAATTCTCTAACAGCTATCCAAATTAAAGAAGCAATAGAGACAATGTACAGAAAATAGGCAGAGCAGCCAGGCCTCCCCTGCCTCCCTCACAAAAAAAATTTTGAATTATCTGTTTGAGCCACCATAACTCATCAGCATAGATACACTATTGTAGAACAATCATTCCTGTTCCAACCAGTGAGCACACAATATCTGTGATAATAATTATAGACATAATGTAATATATCACATCACAAATTCCTGAAATAAAACTAATTCTATAGATTAGGAACTTAGAGATTTATTCTGCACTTAGTCACATAATGGATGTTAAAATTAACGAGAAACTCAGATTGAGGCAAACATGACAAGCATGCTTTACTCAAACATCATACAGCACAGCAACAGTTCAAACCTTGTTTCTTAAAAAAAGAGAAAGAGAGAAATAGAAAAATGTTTTTATGTCCTACTGGATTTCAGGAAGAGCTGAAAAACACTCTTATTCATATAGTAAAGAGGGCTTTGTTTGGTTTTGCTCATTAGAATTCTGTAATTCTGTTAGTTTCAAGTATGGTGAGCTTGAGTATACGCAGAATAACAGTGACTGAATAAAGAAAAGTAAGCCTTGGCTTACTTTAATTGTCATAGATAATGAAATGGAATTTTTTATTTTCTGACTCAATGGCACGTAACATAAAACCCCAAAATATTAATTTCTCTGATTCTGGATAAAGAATTTATTGTATTGCACATAGTTGAGTTTAGACAATTAATAGCTGCTACCACAACATGTAATTTTTTAAACTATGCCTTTCAAGTTTCAGCACATTTGAATTTCATTTACTATCCTTTTTATGGCTAATAATACCATGGCTTGAAGTAAAATATTTGCAAATAGTTCAACATAGTAGTGAGTAAGGGTATTTTAACTGTATTCACATTCACTCCCTTTACAGATATTTTGTGAGTTCAAGTGAAGGGAAAGGTAACGCGAATTATGTATTGTAGATTAAATGCGAAGTTAAGTGATCACCATTAATATGTAAAATTATCAATGGTTTTATGGTTTACTTAAAATAATAAATACCTGAATATGTATTCTGCATGCTATAGATGAGTTTCTCCAGTATTTTTACAGCCAGCAGACACTTGAGTCCTGTCTTCTAATGCTTATATGCTAGAACAGAAAGGAATTAAGGTGTAAGTCTATTTCATGTGATGCAAGTGAAGTCACCAAATAAAATCATAAAACTGCCTTTTGCTAAGGCAATAAAACTACTAATAACAGGCCTGTTCTACATAGCTAAGAGGTTTAATAAAAAATCGAATTCCTTGTTTAAAATTACATGTCTTTCATCCTGTCATCCAGGATACTGTTTAAAGAGTCTCTGTTATGCACTGCTTTGTTTCTTGCTCAGTGGTTCTGTATAGGTTTTCTTATACAATAAAATACAATGAACTTTTAATATTGGAGTTGTTTTCTCTTATTTTTGATTATCTTATTTTCTTGGCTAATGCCTTATTACAAAGGCTTTGTTCAAGTAATATGGTGATTTACATAGATGAAAGAAGGCCTGCATTTCTAGAAACTGAAAACAGTGGTTCTCTTACAAATCCAAATTAAACATTTCCTGTAGCCTCTTATTTTTAATAATGACTTTAGAGGCAGTAATTAGAACATCAATGGTTTATTTTGGAAATAATCAGTCTTTAACAAAGAAGATTATTCTTAACCTCAAGAAAACTCTAAATATAAATAACAATTCTGGATCTTTTTAGAAGTTGATTTAAATAATGCTGGATTATTATAACTATTTAATTAGCAGTTTTTCAAACTTTAAAATTGGAATTATATCTCAAGAAAAACTCATGAGAGCATTTTTAAAACATGAACTCTATCACAGATGAAGTGGATCAAAAATTGCTTTTGTACAGTATCTATAATTTTGCATAATTTTATATGTTAAGCTAAGAAAAATTTAGAAATGTGCTTTTTGATACATTAATCTTGGAATAATCTAATCATTCCAGGAATAAAGCAGAAGAAGGCCATCAACTGGTGTCTAATTCTTTGATTTCTATTTTTATATTAAATAAAATTTTATAGTAAAATAATAATCATTTTTCCCCATACAG
>TTN-216,,0,780,720498,721277,GTTGGATTTTAAGGATAAAATAGATCAAATGCTAACATTCACTGGATTGTAATGATTTAGCTTGCATCACTTAAATTTTCACTTATCTGCCACTTCCAGAATGTAATTTATTTAGAGTAAGAATGAAATCACAGACATAATCATGGTTATGAACTCACCTTTTCCCTTACTGCCCTGTTGGGTGCTATGCTATCATATCCATGGTACTATTTATTTTAAAAATAAAACATATTTTCATATGTTTCATAATACCAATAGATAAGCTTTTAGTTAATTTTCATATGAAGATAACTTTCATAATATGTAATAAAAAGTATCAGTGAACACCTAGCCACTCTGAAATCACTGGTCTCACCCTTAGATTTAAAATAACCATGATTAGTTGTCTGTTTCTTTTTTCTGTTTATTTTTTGTTGTTGTTTCACTTCATCACTTTATTTAGTATATCATGTTTCTTCACATTATTTTCAGTGTTCCCATTCAGCATGGTATATTTAAAGAATATATCATGTTGTTATGCATATAATCCAATAGCATCACATTTTTTCACAATTCACTGCAAAGCAATGATTGAATAGGTTTTTTTTAAAAAAAGCTTATTGTCTTCTTTTGCCTTCAATGATCTTTCTCATTTTCCAGTCACTTGCCTTAAACTGCTGTAATCCATCTCACCAATTTCAACTGTTTTACTCCATTAACAGCAACAAAAGTTAGAAGAAAAACAAAAATGTCATATGCCTGATAAGGAGGCATGTTAATGGACTCTACTTCCCTTTGCAG
>TTN-216,,0,2007,721278,723284,GTAAATGCCATACATTGGCACAGATGTTGTCACTTCATTTCATATTGTTGTCCTTTTTGCTTTCTGTACATGTGTGGGAAATGCTTGTATTACCAACTGGAGAGACCAACAACCAAGACAGTAACATGGTAGGTAGGTACTGCAGAGCCTATATGGGATAAGAAATCATTATTTACAGTCACATTTCTACTACTGACCAAAGAAAAAATAATTTATTATTTGAGAACAAAGTTAAGTAATCAAATGAGCTCAGCTTGGCCCTTCATATAAAACATATCAGGACAGTTTGGTGCCACTAAAAAAAAATAATGTCTCAATGTATTTAAAAATTTTAAATCAAATAACCAATTAAGAACAGAATTACAAACTTAAAAAAGTCAGTGTCTAAGTCTAAAATTAAATCCTAATGTAAGACAGGGAGCTAGTATAGGACTGAAAACTAGGATTCTCTCTAGGCATTTTTACTAATTTAAAAATAAGACGGCTGGGCACGGTGGCTCACGCTTGTAATCCCAGCACTTTGGGAGGCCAAGGCAGGCGGATCACAAGGTCAGGAGATCGAGACCATCCTGGCTAACACAGTGAAACCCGATCTCTACTAAAAATATAAAAAATTAGCCAGGCGTGGTGTCACGCACCTGTAGTCCCAGCTACTTGGGAGGCTGAGGCAGGAGAATTGCTTGAAGCCAGGAGGCAGAGGTTGCAGTAAGCCAGGATTGCACCACTGCTCTCCAGCCTGGGCAACATAGCGAGACTCCACCTAAAAAAAAAAAAAGAAAGAAAGAAAATAAGACAACTACACAAATATCCTATTCCCAATTTTCTAATTGATATGTAGGGTGACTTTCAAATAGTTAACACTCATCAAATACTTGAATGCCTTCATTAACCAAAATATTAGTAGCAAGCTTTTCTTCCTTTCTTCCTACCTTCTTTCCTTCCTTCCTTCCTTCCCTCCTTCCCTCCCTCCTCTCTATCTTTCTTTCTTTCTTTTCTTTCTTTCCCTCTTCCCAAGAGAAAGTGTGAGTATGAACTGTGGTTTGAGGACAGGGGTAGAGGTACAGTCAAGCCATACTTGGACTGTTGGGGAAGGCTGTCCCTTGGTCTTCTTTGTCAATGAGAATATCAAGGGGAAGGGCAAATGCAGCACATCTCTTGAATGTGAAAACGATGAGGTTCCCTATAGCTTCCTCTTCTCTACAATCCTTTTACGTGATCCTAAGAAAAACCCAGGCCCATGATGACCCAACCAGTGCTTTTCACTCTGGTCAAAATGTCTCCATAAAACCAAGTACATGATATTATTCATACTGACGCGTTTGGAAGTTTCTTTACTCAAATTAGGTCAATTTAGGAATGCGACTAATATTGAAGCTTCAGATAATAAGAGGAAAGGATAAGGAGGATGACTTAAAAAAATTAAAAAGAGAGGTTCTGAAAGTCTGGCTTCAAGATGCAGAATGGAAAGGGGAAGTTGCTGCTATTAAATATTTTTACAAGTTTGAGTTGGCCTAGAGGATGCATTCATAGTTAAGCCATATAAGAATTTCCAGGCAGTTGACATGAGGGTTAGAAAGACATTACAAAACTACTTCAATCTTCTTATCACTTAATATCCCTACTCTTCAGAAGAGTCAAATACATTTTCTTTATCTTCCTTACATAATCTTCTAATTTGCAGAATTAAAGTATCAGCTCAATAGCTTATCAAATAATTAAACAAGCAGCCACTAAAATGGACAAATCTTTAGTAATGTTACTTAATAAAGGAACGCTTGTCTTTTCTTTGATAGAGACAAGTAAAGTGATGTCTTGCTCCCTTATAAAGAACACTCTCATCCCTTTCCTTTGACAATCTTTTGTTCTTATTAACACATTACTCCATTTTAAATTATGGCTCATGTCTATCTAAAGACTTAACTCATCTTTTCTCTGTCTTGGAATATATAATTACAGCAAGTGCTTTGGTGGGGACTAAATGTAATGCTGGAAAAATTTCTTTTGCAG
>TTN-216,,0,522,723285,723806,GTAAGAAACGTGTGAATGTATTTTCTAGTCCCTTCTCTGCAAGGAATCCTCAGTAGAAAAACTGTTGGCAAACAATTCAGTCAGTACACTTTGTTATTAAAATAATGTCATTCAGCAAACATTATGGTTTGGGAAAGTCCTGGCATTGTTTGATTTTATTTTTTTAATCCTCTTCAAAGTTCACTTAACTTTTGTTCTTTTAAATTGTCTGCTATTAACAAAGCTTGCTTAAAATTTCTTCTAAGAAAAAACTCCAAGTGTCTGAGCAATTCTTAACTATCTTCTTTTATAAAATTCTTCTTTGTGTAGGTAGTCTGTTTATTGTTGTTTTATTTTAAATCAAGAGACTGGGAAAGTGTCTTAGAATGATAGGAACCTATTAAATGCACCACAGCTTTTACAGAAATTTTGTGGAGATATTTTATGTGTGTTGGGTCTCTTTGTTGTATATGTCTACTTTTCTTTTGCGGAGTTTATGTTTCAGATATCTTCTCCTTTTTCTTTTTTGTAAACTTCATGTAG
>TTN-216,,0,100,723807,723906,GTTTGTTTACTGAGTTTCCATCCAGTATTTTTCTGAGAAAAGATTTCCCTTTTAATTACTTATTACCCATTACTTACACAATGCTTTCATGCTTTTGTAG
>TTN-216,,0,435,723907,724341,GTTAGTGCTTGAAAAACTAATGTCTCTTTAATAAATTGTCAAACTAGCTTTCTTACCCCATGGAAGAAAAACTGGTACTTTCTTCTCTTGTCCTATCCTTTAAATTTGTTTTGTCTTGGTTTGACCTGGGACCTTGGGAACAAAGTCAGTAACTTTCACCTGGTCTTTTTCCCGAGACTAGTGTAAATATCTATTATCTGATAACAAAAGGGAATAATAAGCCATTTTGTCAGCTGACAAACATGTATCATCTATGCCTCTGTCTCTTGGATGGAATTATAATTATTCTTAACTTTTATTTCTTCTTCTAATTAACACTATGAAATAGTAGTATTGGGACAAGATAAATATAATCTTGAAAAAACTCTTAAATATAGATGGTGTTGAAAGTGTTTGGGAATTGATATGTTTTATATGCTCTCTTTCCTTAACTAG
>TTN-216,,0,96,724342,724437,GTTTGTGTAGGAACATTTAAACCTCAAATTGCTATTTAGAATTAAAGTGAAACCCTAACAAGCATTTAGGGTGCTAACTATTTCATACCATTGTAG
>TTN-216,,0,117,724438,724554,GTTAGTATTTTTAGAAAATGATGCTACATATGCATTTGAAACCCAACAAATGGCCTAAAGTCAATCACTGAGCACTCTTCTATATTGACCTTTTCTCCCTTCTTGTGCAACACACAG
>TTN-216,,0,115,724555,724669,GTTGGCTGGAGACTTTGCATTTTATCCTTATTAAAGATTATGTTCAAATTAAGTCATCTTCCCTTAGATCAACCCTCTTAACTCTTTGAAATTCTTTCTTATACCCCTTCTTCAG
>TTN-216,,0,92,724670,724761,GTTTGCATTGTTTTCTTGACATCTTTGTGCTAACCTTGTTATAAATTCTTTCCTCTTTCTCACATTTCTTAATAACTTCCTTCCTTCCACAG
>TTN-216,,0,94,724762,724855,GTTTGTGTTCACTTTGCCTCTTGTGTTGCCAAAGTTATGGCCCATGGCACAGACCCCTCCTCCCTTAATGCAAATCATTCCTTTTTTACTGTAG
>TTN-216,,0,109,724856,724964,GTTAGTGTTGGTTCCAGTGAGGGACTGGCTTTTCTGAAGAGTCAATTCTTTTTTTTAAGCCACTTTTGCTATAGGGATAATATTGATTGAGAATTCATTCTTCTGTTAG
>TTN-216,,0,101,724965,725065,GTTGGTTCAGAACGTTTGCCTTGGGTTTGAGGAAGAAATGCAGATGTAAGCCTTTCAGCAGGGTAATGCACAACCCACATCTATCCCTTTGTTTTCTACAG
>TTN-216,,0,132,725066,725197,GTTGGTATTGTTCTTCTACAGAGAGGATTGGGCATTTCCATGCTCCTTCTTCCCTTAAAATTTAAAAAAAAAAACAAAAACAAATTAGTAGATTGACCTTTTTTTGTTGTTGTTTGCTTTTTCATTGAATAG
>TTN-216,,0,133,725198,725330,GTTGGCAAATTTTATTTCCACTTATCAAGAACTTACAAAATATTTTTGTTTCATTTCTAAATTTTCACCTTTATTGCTAAGTTATAAAATAAAACTTCCTATTTTCTTTTGCTTGTTTTTTCTTTCACCTCAG
>TTN-216,,0,147,725331,725477,GTCTGGTCTCTACATCTCCTCACTTTCTTGCTTGTCTAGATTTTCTTGCCTGGGGTGGGCCGGGGCGGGGGACGCTTAAGACAGCAGTTTTGCCCAGTGACCTGTTTTTAAAAATATTCAACATCACAATTCTTTTTCCATCTTTAG
>TTN-216,,0,97,725478,725574,GTTCGTGAATGGAATCTATTCTCCATTTTGGCTGTGCTGCCTGATAAGTTTGGGGTCTTCCCTTGAGTAAGCTACTGTCTTCCTTTTGAATCTTTAG
>TTN-216,,0,118,725575,725692,GTCAGTTATACAAGAAGCAGCCTATCAAATAAAAATTCTGTAACGCTTTTAAATCTTATCATTATGGGTAGGAGTTACAATATGTTTCTTCTTTTCACACTCTCTTATTTAATCACAG
>TTN-216,,0,112,725693,725804,GTTTGTAAGCTATTCTCTTTCAAAGATAGTCTATAGCGACAGTTTCATTAGCAGACATTATTTCTAGTGGAGTTACCAATGTAACTCATCCACATTTTCATTTTTACTACAG
>TTN-216,,0,102,725805,725906,GTTTGTATCTTCACCCCAGTCAGCTTCCCTTATTTATAGTATGTCCTTTGTAAACAAATAGCAAGAGATTAATGGATGTGTTTTGCTGTTTGCATTGGACAG
>TTN-216,,0,246,725907,726152,GTTAGAATTTCTTTACCTCTTCTTGATTCTTCCTTGCGAATGCTTCTTAAATGTATCACTCTTGCCTTTGTATCCTTTAGAGCTAAAATCTCTATGATTCTGGTTCTTTAGATACATATTCATTGTGTTCAAGAAATATTCAGCCATTGCCTCTTTCCAAGAGTGTTTTCTTAAATGTCCATAAAACTGTCACAATAATTCAACTGCAAGCAATTTAATTAAATATATCTCTCTTAAAATCTATAG
>TTN-216,,0,213,726153,726365,GTGTGCAAATTTGATTCCTTTATGTTTCTGTCTGACTGTGTCTTTGGTTCTCTGTATTCAGTTACAATGTCTCTAAACAATCAAGAAAGTAGTATTCTTTCTAACATAGTAAACAGTATTTGCTCATGTTTTTCTCTTGCCTGTATACTATCTAATTTAACTATTGTTATTTATTTCTGTTCCCTGATACTCTCCTCTTTCCTGACTCTTTAG
>TTN-216,,0,1043,726366,727408,GTAGACATCTTGTTCTTGTGTTTCTCATTAAATGAAAACCACCTTCTCCCCTGGGTATTATAGCTCTTTATTCATTTACTATCATTTTAGTTTCCATTTGAGATCATAGAATATTTTTCTGAGCTAGTATTATTTCCCTTTTTAGATGGTTTCCTTCTTGAATTTTGCTTACATGTAACTAGTCATTATGAAATATTTTTGTTATTCCAGTGTCATAATTCTGATTACCTCAACACATTTGCCAAACATCAAACGTGATGTTTCAAAACTGCACAAAAAAATGAAGTAGGCATTTTAAAATTAGTCTTTTGCTTTCAATCAACTTACAGATATATCATTCTCACTATAATCTATATCATTAATAACAAGCACTTTTACTATATCTATGCAAAGTGAAAGCAATACAGGTTTTAAACTTATGTTTAAAACAGGACAATAATATTTTTTCCTTCTCTCTCAAGGATCACTTCCTATCCTTTAAAAATTATATGACTATACCTTGGTACAAATAGTATCTGTGTTTTTTTGCTGCAATTTTCCAGTGCTTTTTTTTTTTGTCACAAAGGCCAAGTTTGTCTTGTTTTAAGACAATTATTGCAGTAATCATTTGCTGAAATGGAAGACTTAGATCACGGATGTTGTGATGACTTCCAAGTGTCTGTTATAGAACATATACAAAAAAAATCATCCTTGAAATTAGAATTCCATACTTCATGCAAATCATTATTTATTGCTATACTTGCTTGTTTGCAATTTTTGTATCAATCTTTGTAGCCTAAGATACATCAGTAAGGTGTAGTAGATAGAATGTTGAACTGTTCAGTAACGACATCTAGGATCTATCTGGGTTCTCTGCCCATCTAGCTGGTTATCTTGTGAAGGCAAATGGCTTCTGAGGCTGTTATCCCATGAGAGTGTTAGTGCTGGACTCTACTTACCCATTAGAATATCTTAAACCTTTCTTCCAATTTAAAGACAAATAAAAAATTTTCATTTTGTGAAATTCAGTAGCCCAATTCATGAGAAATTCTTGTTTTTTGCAG
>TTN-216,,0,118,727409,727526,GTAAATATAGTTCATCCACATGGCAGAAATGTCATAAATGTGCAAAATCCTACTTTTTTCACTCTCGCATGATCTGGACAATCTTTTCAACAATTTCCATCCATCTTTTCCTGTTCAG
>TTN-216,,0,829,727527,728355,GTTGGTACAATAGCCCACGATAGAAACTGGTGCCAAATGCTGGAATGAATTACTAAGAGTTACTGGCAGATTCTTTTTCTGAGTTTCTTCTAGAACTATATTTATCCTCATCTATTTGAAAGGTCTAGAGGAAAGACATAGTTGATCTTTCAAACACTCTTTTCTGTTTCTGTGATTCTAACAAAAATTAGACATCTGTTTTATTGTTTAATAACTACCTGTCTATATCAATTAGCAGATACAATCATGACTCTCTTTGATTAAGCATGAAAGAATACAGAGCCCAGCATGTGCTACAAGAGTAATTGTTAAAACTAACAAGAACTCCAAAGGTTGGCATTTGATAGCAAAGCTTCCACATAAAATTAATGACAATTAAACAATTGTTTGAATAACAACTTTCAAAGAATTGTCTTTAGCACCTTAAGGTAGAGCAAAAATACCAAGTAATTCACAATAACCTGTAGACTTTGATCTACAGAGGGTCAAGTGGAAATCAATATATACTATCTAATGCACATTGTTTAAATTGTTTTGAAGTTGAGTCATGCACGAACATATATTTCTTAAGAATAATTGCTACATAAGACGACAGCAAGAGTGGTGGGAAAAACAAAAAATAAAGAAAAAACTGAAAAGAAAAAATATTAAAATAAAAAATAGCTATAATTCTATGACTGCATGTAATTATGGAATCACACTTTAAAGTCGAGAGAGAGAGCACCCTAACATAACCATCTCACTGGGAGAAACAATCTTAGTGAATGTGATAGTAGAGACAGAGTAAAGATCCCAGACTTTGACAGATGGATATCACGTTTTATTTCAG
>TTN-216,,0,116,728356,728471,GTTAGTTCTGCTGTTTTCTTCTGGTTGCTTATGCAAATTCCTTTTACAAGTTTCCTTCTTTCAAGTCTCTTCTATTCTTTCAAATCATGATGAGTCTCTTACCTTTCCTCACACAG
>TTN-216,,0,159,728472,728630,GTCAGTAGACAGTCAAACTTGTAAGGAATTTCTTACAAATTCCTCTTCAGGTGCACATCTATGTTGACAAACATTTGAAAGTGCTCTAATGTTTTATTCAAAATTGCAACTCCATCTGAAGCTTACAGGATCTTTTAATTGTTCTCCATGTCTATATAG
>TTN-216,,0,93,728631,728723,GTTTGCTCAAGTGGATTCACTTTTTCTGTTTTCTGTATACCGACATCCTTGTGTTTTTCTTGTGTTTAACTGCTGTGCTTTGTCACTTACTAG
>TTN-216,,0,108,728724,728831,GTGTGTTGTCTTATTGTCTCTTAAATCATTTGCATTCTTCTAACATGTAGCATAGTTTCTTTGATATTCATTAATTCCAGTTGCTAACTGTGAGCCTTTCTTCCTTAG
>TTN-216,,0,112,728832,728943,GTGATGATATTTTACAAATTAAAAAAATTCTTTTTTCCTTAACTCTTGTATCTTTATGGTGAACTTCTCATTTCATCTCCTAACACCTTAAGTATTACATGTCTCCCTACAG
>TTN-216,,0,124,728944,729067,GTTTGTTCACACGTCACTCTTTTTCTTTGCAAACTGTGGCTTCATATTTCATTGTCAAAGTAGAAACGACCAATGGCAAAAAAACAAACAAAAAATACACATTGCCTTTCTTCTCATCCTCCAG
>TTN-216,,0,644,729068,729711,GTATCATTCCATGACTTTTGACAATATTTGTTCCTTACCATATTTGCATAATTGTCTTATAAAAGTTTCTTTGGTTTTTAAATGTTTGAGAGAAACTAACTGGACATGTTAGAATTTGTGTATTAGTGTTGGAGGCAACATTAATCAAAGTTGTGTTTTCTCTTTATATTGTTCTTTACATTAGTGTAACTCTAAGTGTAATCTTATCAAAAAGTATTGTTTAATTGAAATTTGTTAAATGTTGTTTTAACTATCTAGTCCATTTTTTAATGCTTTCTTGTTATATGGCATTCTGATTTATCATTACTAAATGTTGATCAAATACATCTATAATACATTAACTTTTATGTTTTAACTTACATAGTCAAACTAAAAAAAAGAATCAACTAAATTCTCTATTAAAAATGCACATGTACCCTAAAACTTAAAGTATAATAATAATAAATTTTAAAAAACTAAAAAAAAAATGTTATGAGATTATTTAACTTAAAAGATAACTTATTTTACTGTAAAATCCTCAGAAAGTATATTCTTAATAACAAACCAGTTTAAATATAAATTTATGGGATCTTCAGCTACAAAAACAAGCTCTTTTAACATGTATAATAAATATCCCTTACTGACTGTTTTGTTTGGTTTACTAG
>TTN-216,,0,257,729712,729968,GTTAGACACACTAAGCTTCTTTGTTTCTTTATTCTCCTCTGATTTGGGCTCTTAGCAAAGTTATGAGTTCCAAAATAAAAGGATAATTAAGGTTATTTGGTTGCAATTCTTCAACAAGTTTTAATGAATTGTCATTTCTTGTGTCAGCATGTATTGTCATATGATCACACCAGTCACTCTTCAAGGTTCTAGATTTAATTTTTTTTTCCTTTATAGTAAGCAAGTGTTCTCATTGTTTATCTCCTTTTTTCTGGTAG
>TTN-216,,0,120,729969,730088,GTTTGTATACATGGACACAAAAATATATGCCCCTTCCTCCTATCTGTTCTTGCCTAACTAATAACTTGTGTGGCCATGATTCTCACATTTTTTCCTCTAACCACAAATTTCTTTCATCAG
>TTN-216,,0,150,730089,730238,GTTAGTAGCAAAGCACAGCCAGAGAAAAAATCAATTTACTTGATCCATGATCATTTTCCTCAAATATTCCTCTTATCCAGTAATTCAGTGATTGCACTCTTGAGTTTGAAAGGTTACTTTGTTTTCAATGCAAAATACTTCTTCTTTTAG
>TTN-216,,0,102,730239,730340,GTGAGTAGAATGAGATTTTTATGAATATACAATATTTCCAGGGGGTGGAGGGGCACAGAATAAAACTTCTCTTTAAACGCAAAACTACCCTTCCCCACATAG
>TTN-216,,0,190,730341,730530,GTCAGTGTGCAAGGATAAAGCTGCTGCTTCTCTAACACCTCTTTCATGTGGACGTGGTGCCTGCCTTCCCTGGAGTTTCTTTATTTTGTCTTCATGTTTAGTCTTAGCTCCCTTTTTTTAAGGAGCAAAAGCACTTCTCACTTGGATTTCTTTCTTCTCTTTATCTCCCCTTCCGCCTTGCAATATCTAG
>TTN-216,,0,94,730531,730624,GTTTGCTCTTTCCCCCAATATATACATCTTTTAAAATTTCTCTTAAGTCTTCATTAGAAGGCAAGAATTTTACCCACATGTTTTCTCCTTATAG
>TTN-216,,0,100,730625,730724,GTGTGTTGACAGCTACCTCTTTTTATTGCTCTCTTTCTTTTCAAACATCCTCTTTTACATGGCATGACTGACTTGCTGACTACCATCCTTTGTACCATAG
>TTN-216,,0,132,730725,730856,GTGATGGTGTTGTTTAACCTAGTGTGTGTGAACAGATTCATTTTCTTAAAAACGTTAAAACTTTTATGAATTGAAATATGTTGTGGATGCCTTCTCACCTGTAAATAAGGATTATCTGTAACTTCTTTACAG
>TTN-216,,0,140,730857,730996,GTGAGTAACTCACAGTACCCTCTTCATTGTAAAGCAGCTTCACTGCTCCAGGCCACCAAAAGGCTGGTGCCATTTAGTTTCTGCTCTGTATGTGAGAGCATGGAAATAAAAATCACCATGTTGGTCTTCATTCTTTTCAG
>TTN-216,,0,1320,730997,732316,GTACTTGTTAGAGTGAAGGAGCAAGATCTCTTTTACATTTTCAGTATCTTAAAATATAGGAGGGTGGGTGTGCTTGAGAGAGAGCTATGTTTAGGACCAGGGTCTAGTGATGAAAATGGATCAAGTGGATCAAGGACCTTCCAAATGGAGACAAGTATTTTTTAATTACTTTAAAAAAAAAATTTAAAACTAGGAAAACATGGACCAAAAGTCCATTTTAAGAGACTAAAAATAGAGACTAGAGAGAGATAACCGAAACTCTACAAAATTGCAAGAAAATCCTAGTTTGAAAGACGGTATCATAGGACAAAAGCGAAGTTATTGCAAATGACTTTTTTCCCACAGTACTTAGTAAATGAATGGATTTTGTCCCTCTAAGGCATAGCAAAGAGCCAAACTATCAAGCCCTTCAAGGAGAATTCAGATGAGAATGATAAGTTCAACTTACTTTCCTCCACTAGCCCCACTTAAATAATAGTGGAGGTCAGGGGCTGGGGAGTAAGTAGATCAGTATCTGCTATTATGGAAGGCAGTCATGTGTTTCTGCCACATGTTTATCGCTGCTACTGTCAGAAATTAAATAGTTCACTCAATGGACTGCTAGTCTAGTCCATTAGAGTATTTTTAAGGGTTTTTGTAGTGGTGGTTTATAAATATCTTGAAATTAAAATATAATTAGATTTAGCAGCCCATTTGCTCTATGACATATAGCTAATCACTTTTACTTCCCTATGCCTGAATTTTTTGCTTCAGTTAATGAGGAAATCATTACTCTCACACACTTCAAAGGAAAATTATGAAGGTTGAGGAAATACCCATTTAACACCTAAAAGAGGAAAATGGCATTTTAAAAATATTAAGATATCTGACCCACTTTGCCATTCCGGCTCTTCATGCTATGTAACTGATAGCATTGCAGCCTTAGGAAATAGTTCTCCACTGGTTCATATACAAGACAGTAATCAAATTCTCATTCCCCGTGGACCTCAGAGGGCTTCCACTGACAGATACATGCTATTATCTCTGATCTTGGCACTAGAGAAGGGACTCTTTTGCTGGGGAGAGGATGGCACAATAAAGAGTAATGTCTTTTTCTCCTTCTTTTAGTAATAATACTTGATGTGGATGCTTACAAAAACAAGCATATTTTATTTTAGAAATTTTCTATTTAGGTTTCATTTAACTCTTCTTCCTTGAACTGCATAAATTTGTTTTCCAGAGCTAAAGACCTCTCTAGCAAAGATTATTTTTTCCACCTCATCTTGAATTATATGCATCTGTTCCATCCCTTACCCTGTGTTTTTCCTCTTGGTTCCATAG
>TTN-216,,0,228,732317,732544,GTCAGCGCTCTCCCCACCTGTGTGTTTTTCACATTAGCCTCCTCTTTAATTGTCCTCTTAACTTCCTGTTTGACTCTTCAACGATGTTTTAAAATAGGGAAAGGACACAACAAAGAATTGAAAGTGTTTTTTTCACTCTCTATCTCTCTGATGGAGTGGAAGATTGATTCTTACTTTTAACTATATACTTACAGAATACATCCGTATTTTCCTTTTTTCCAATTTTAG
>TTN-216,,0,412,732545,732956,GTTAGATGGACTGCATTCACTTCTGCTCACTACTTCCCTTCTAATTGTAATACTCTGTTGCCCCCTCCACCCCAGCCCAGTCTTATCACTAGCAGCCTATTCCACTTTCCCTTTGTTTCCTCTCCAAGTCCTTTTCTGTTTAGTCTGCTTCCCTTTTCCAAATCCTACTGAATATCCTTTTAGATAATGTTGTAATTAGGTTTTGATTGGATTAAGAAAGCTGGAGTAGATGAGATATTCAACTTTCCTACTGAATACAAACTTTAATGTGTCCCTGCTCGCATCCACCAAAAATGCCTCTTAAATGGAAATAACACATTATCACTAGTTTGATTCCCGGCATTCACGATTTGAGCAAAATGCTGTCAGTCTCACAAATTTTAAAACCCAGGCTTTCCTCCTTTTTCATCAG
>TTN-216,,0,116,732957,733072,GTTAGTAAAAAGATGATGTTATCACAGATACAAGGCACACACTCACCAGGATCTGTATTTTCTTTAGTTTTTCAATTTGAGTTTAAAATATGGATATCTTTTACATTTCATTCCAG
>TTN-216,,0,524,733073,733596,GTTGGTTGATTTCTTGGGCTTTTCCTTCATCATTATAATAATGTAGTTCCTGATTTTCATAAATGTATATGGGTTGTTACATCTTCTATAGGATAACATGAGTCCGACATCTTCTGAATCAGCAAATTCAGAGGCAATACCATCTGTAGAATTAGAAGAAAACCATGTTCAAAAGTTATATCCCTTTCTTTTTGAGGAATTTCCAAAATGATGATAGGAATGAAAAATAGTCCCTGGATAAGGTTAAAGCAGTCTTCATTTATGCTGAAATAATTCACCACATAATTCTTCACGGCAAAGAGAGAACAAAATCCCTAGCAAGTCAACCATCACATTCTGCCCACTGATTCTCCAAGCTTTTGATAGTGTGAACCCATAGAGGAGTTTTTAATACCGTCACAAAAGAGCCAAATGGATCTAGGGATAGTCCATCAAAAAGACAGTTCTCTCTTCAAGTCATTTTATAATTGTTGTCCTTTGTTTTTTTTGTTTTGTTTTGTTTTGTTTTGTTTTGTATCATTCAG
>TTN-216,,0,109,733597,733705,GTCAGTTTACAAAACAGTAAAATGAATTGCATTTCATAGTTTATTAAGCATGTTTGTCATAACAATTCACAAATACTAAACCTTTTCTGATATGTGCTTTTGTGTTTAG
>TTN-216,,0,103,733706,733808,GTTTGTCAGACTGCTCTTCTAGATTTATACGATTAGTAATTAGATGTGTCTTTGTCTGTATGTATATGTGTTTGATTTTATATTTTCAATTTGGTCACTTTAG
>TTN-216,,0,92,733809,733900,GTTTGTCATGATTGCACATTTTTATCTTTGTATACAATCGATGATCTGGCATGTCTCCTTCATGACTGATTGATTATCTCTCTTGGCTGCAG
>TTN-216,,0,594,733901,734494,GTGATTGCAATATTTTTAAAGTGAACGAATTTGTGTTTCTTTTGAACAAGATTTAAAATGTCTGGGGAGGCCTATTTTTTAGGAAAATCTTTCCAAAGGCTTAAAATTCTGCTTAAGTAATCCTATTTACAGTTAGTGGCTTATCTTTTTCTATGGATTCTACAGAGAGATAATATGACTAAATCTTTAATTGGAAGGATTATGCAATCATTTGCTTCTATAATTAAATCTTTTTTAAAAAGTGACCATATATTTTTAAATTCCACCCCGTAAGTATCTCATGCAAATTGCTAGAAGGCAGTCTTTAAAATTACAGGAATCTGCTGCTTGCCCAGAGACATGCCTTCAGCCAACCAATTGCTTTATTGGTTTTCATACTGTTTTGCACCTACTGTGCATTAGGGTTGGTCTCAGAGTGATACTTTTGCTCCAGAAATCTATATGCTTTTCTTTATCTCCAAGTTAATTCAAGAGACATTAATAATTCCTGATTTTTAATAGAAATTGCATATATACGTGCGTTTGTATATATATAATTGTGAGAAGAGCATTTAGTAAATTAAAGTATTTGTTACTTTTATTCTGTTCCTACAG
>TTN-216,,0,139,734495,734633,GTTTGTGGATTCTTAAACTTTCATTTCTAGAATTAAAGTATTATAATCAAATATGAACTTAGGGAGAAATTTCTATTTCAGTAAACTGACATGGTCCAGATATTGAGCCTGAAACCTTGTCTTTCTGCTCTACTATTAG
>TTN-216,,0,778,734634,735411,GTATCGTTTATTTTGCAAGTGGTCCAACAAAAGTGTAATCATTTTGTAGTATAGCCTGAAGGTGTCGTTTTTATGATGATGAATGCAATTTAGGACATTTTTAAACAAATGAAAAGAAAATGTTTAAGAGGAAATAAGTTTATCTAGAGAAGAAGTCATTTTTTAAATCTGTATTTCTTTCTTTCCTCGAGACAGGATCTCATTCTGTCGCACAGGCTGGAGTACAGTGGCGTGATCTCAGTTCACTGCAACCTCTGCCTCCTGGGTTCAAGTGATTCTTGTGCCTCAGCCTCCTGAGTAGCTGGGATTACAGGCGCCTGCCACCATGACCAACTAATTTTTGTATTTTTTGGTAGAAACGGGGTTTCACCATGTTGGCCAGGTTGGTCTGGAGCTCCTGACCTCAAGTGATCCACCCGCCTTGGCCTCCCAAAGTGCTGGGATTACAGGCATGAGCCACCACACCCAGCTTATAATCTATATTTCTAAAACTTTATATATTCCCTATGATACTGAGACTACCCCTTCTTTTTACAAATTTGTGATTCTCTAAATGGCCATGAGTTACTTCTTATCATCCACCTTGTAAGTCAAAGAACAGTTTAGAATAAGCTCGTAGAAGGAGGCTGAAATGTTTAGGAACATATTCTGATATAGTGTATTTAGTTGGTTAGCCTTGATTTTTAACTAAAAATATGAGGGTTTTTTTTCTTGAAAAGCTTCATATTAGTAATCTGCTTCTAGCTTCTACTTCATATATCCTTGCAATTTCTTATAG
>TTN-216,,0,1752,735412,737163,GTGAGTTATCCTCACAGCCCCAACCTGTTGTGTTTTTCTTCACTGCCTGTTATATATCCATGAGCATTTCTTATGATATCTTGACCAAGTAAGTTATAACAAATATAAATACACATTATTTAACTGTGTATTTATCACTCCATATGTTTACTAAAAATATAAATTATTGTAATTTAATTATGTGGCTTCCCGAAGGAGGTGTCATTTAACGGACTAATATCTTAGGTTTCTAAATCATATCCTAAAATTCCTTTAGGTAGTTAGAAGTTTCAGCGTACTCTGAAATGTGTGCATATGTGACATATATTTTTATGAAGCACATTTGTTTTGAAATTTTTTTAATGTTCATCACCAAATATCACATTAACTTGACTATTATTGAGTTATATATTATATCACAGTCTGAAACTTTCTCCTTTCCAAGTGTATTTCTAAAGGATTATTGTTTAATGTATATTGCCCAAAGCGTTTGACCTGCAAACAAATATTAATCCCAGACAAAAGGGTAACATTTGCCCAAAAAGAAAAATAATGGGTAGAAAACATTGCATATCATTATGGAAGACATATTTAAATACACAATCATCGCTTGAGAAAATGAAATAGACCATGTTGTTTAAGGATATCTTTATCTGTTTCTCTTCACTGTAATGGCTTCCAGTAATTACAACATAGCTTCATCAAAATCACATTAAAAACTAACCTCCTAGAGCAGCCTGGAATTAATTACCAACTCTTATGATCTGGTTAGTTATCTCACAGTGCACAGGTAGTAAGTTATTATTAATAGGCTGATATCACTAATAAGTAAATATCACTGAGTTGTCTTAAAATTCCAGTTTCACCACTCATTTTGTGGAATTTAGATGCATTTAGTTTTAAAACACATTTTATAAAATGAAAAATATATACTTAGCAGTGGCTTATCTTCATGATTTACACTCATGATGGTTTTACCATGGGCAGATAAATGCTTTCTATAGAATTCTGAAGCTATTTATAAAATGTTTTTAAAGGATAGACATCAGAAGTTTTAATCTTTGCAATAACAAAAAAAATGGCCTTATTCTTTCTAGGTACAGGTCTCAGAACCATTGAACAAAATCATTACATAATACTGAGTTGTACATTGCCTTCCTATCATGTTACTCATCAATGTCTTCATCATTGGTCTTCAGTTAAACACTGAGCCTCAACTCCTAATTCCCTTGGGCTAAGATTGGATTTTAAATGCTACTGTGGCTGCATTTAATAGCTAAAGATGAACATCAGAGAAAATCACATATAAATATGTGGGCTCATGTATTACTCAAATGCTAGCTTTCTTTCCTAGAGGGTAGCAATCATTGCCGCTGGAGATAAGCAGAATTCCCAAATAAGCCCTTCATTTTCAGGGTTCAGCAAAAACACCGCTGTACACAGGTTTGAGAGAATTAATAGTGTGCTATATGGCAAAGAAGTTCATAGTAACTGCCAATGTCTGCAGTGCTTAGTAAGGACACAGAGGCTGGGGCAATTTGTGGGCAGCATGTGATGTGTTCTTTGCTTGTTTTTAAACCTTTATCTTTTTAAAAAATCCAACAAATTTAAACTATTGTCTTTAGAGAGGAATAAACCAGGCACATAATTCTGTCCTACTACAGCAACAGTGTTACCTGTTAGAGGCCAGTTTTTCTCTTTATTTGTTTCTCTTGTGGAATTTAATACTTTTTTGCCTTTATGTTCCTCATGAAAATACCTTTTCAATTCCAG
>TTN-216,,0,571,737164,737734,GTACAGACACCTCAAAAGTATTATGCAGCTCAAGCCAGCAACCACTCATGTTTATTTGCTTATTATGATTTCCCTAGAAATGGAATTAGATTTTTAGAAATATCAGTTGTTGCTCATCTGCAATTTGTAGGCTCCTTATTATAATTGAAATATTAGGTAATTTAACAGAAATAATGTCAATACAAAGTATCTGAAATTACTACAAGTTTACCACCCTATTTCTTGAACTTCTTTTCACCATATCCATTAAGATGTAATTAACGCAGTTCCAAAAATGATGCTATAATAATGCGATAGAAAGTAGGCTGTTGTGATACACCTGGAAAAAATAAAACCAAGTCTAAAAATATTGACACTACTAATATGATTATAGTTCAACCTTTGATAGCTATCATTAGCATAAATGTCTGAGAAGCTGCTTTATCTTCTGTAACCCACCCTTACATAGAAAGAGAATTCTGCAGTACTTACTTATCAAACTGCCAACCTCCTAAGGCTTATTTTACAAAGGGGGATATGTATTGTAATTCTGAGGTGATTGTAGTAACAAAACATGTAAATGTTTTTTCAG
>TTN-216,,0,122,737735,737856,GTAAGTGCACTTCATGAGAAGTACATCTTCATCTATCTTATACCTTTTACTTATGATTTAATTTTGGAAGAACTGATTTTAGAAAATTAAATTTTTATTCACTTGTTTTCATTATTCCTTAG
>TTN-216,,0,1096,737857,738952,GTGAGTTCAATAAAAACCACAAATCGTACAATCAGCCCTCCATATAAGTGGGTTCCGCATCCACAGTCAACCAGCCCCAGTGGAAAGTATTAAAGAACAAAAAATTTAAAAATACAAATAAACAATACAGCATAACAACCATTTACACAGCACTTACATTGTATTAGATATTATAAGTAATCTAGAGATGAAGCATATGGGAGGATGTGCATAGGTTACATGCAAATACTATGCCATTTTGCATCAGGGACTTGAGCATCTGGCCACAGGCCTCCTGAAGCCAATCTCCCAGGCATAGAGAGGGATGACTGTAATGTCCCATTCACAAAAAGAATCTCTCAAGAGTCATGGGCCATCCATCTCAAGATTCAGATTGTTAAAGAACATAGGCATATAGACATTTTCACAGAAGCAGATAAGCAAATACACAACATCTGGGTGTTCTTGTTTCATTAGAATCAATTTCCGAATTTAAGAGAAAGTTTTAAGAATGAGGTGAATGTCTATTAAGATTTTTAAACAAAAAGAAATGGCCTATAAAGAAACCCCAGTATTGTCTGTGCCTAGGTATGAAACTTTTTTTCTATATATGATTTCTTATGTTATGAATGGTTCTCTAAAACAACTGTTTTAAACATTTTCCATAATTATCATTCATTTCAATATGGTTCATTTTTCAACATAATTATTAAATTAAATCCACACTCAATTTCCACACATCGTTTCCGTGATATGTATACTATTCTATTATTAAAGTTTTCCATTGCTATTATTATTTTTTCTGATATTATAATTCATTAGCTAGGCTCTTTGGTTATAAAGTTTACAGAAATACTTCTATTATCCTTTCCCTTCTTAAAATTTTCATTCCTACATCTATATTTTATTACAATGGTCCTAATCCATCTGATCTTAATCGACTCCATCTCCAAACCCACATTTTTAAATTGTTTCACAGCTAACATGGTAAAATTAATATTTATTGAATAAAGAACATAGAAAACCTTAATGAAGTATATAATCTTTGAATGATGATAGACAATTAAAAATAAGTAGAAGACAGGTGTTTTATCCTTACTTTTTAAATTTTATTTAG
>TTN-216,,0,207,738953,739159,GTATGCTCCTTCATATATAGCATCATGCTAAAAAAGTCACATTTAAAACATCTCACATATTCCCTTTGAATTACCAGAATCCTATAGTTATATGACGTCATTTAATATGACCTAACCAGCATCCAGAATGGAAGCTGAATATAGTCATGCGTCCTCTAAATCAAATTTTGTTTCATCTGTAATGCCTATCATTTTTGTTCTTCTCAG
>TTN-216,,0,99,739160,739258,GTAAAAAGAATTATGTTGATAATAAAATGAACAAGTTATTATTGAGTATTATTATAAGGGAAGGAGTAACAAATGTGTTTTAATTCTTTATTCTCCTAG
>TTN-216,,0,102,739259,739360,GTAAGTTAGAAAAGGCTTATGAAATACTTGTGAGATTTAAATTACTGTTGAGCACATCTGCGTGTGATATTGAACAAAATGCGTGTTGTATCACATGAACAG
>TTN-216,,0,1483,739361,740843,GTGCGTGAAACACTATGGAGTCCTTGTGGGTACAGCATAGGTCAATGGCAAATGTTGTGCAGGACCCCTGCAACCCTACCTGTAGACACACACCAAAGTGGTCATGTGTTCTTATTTCCCAACACACGTTCTCATAGTATTCATCTCAAAGTTCATACAAAAGCACAAGGGAAATATTCAAATGAGTGTCAGTTCTTTTGCATCGTTCTTTTAGATTTTAATCTAGTCTAAGACATAATCTTTAACAGTTATTTCTGTCTAAAGTCTAAATTTCATGATTCTCATATCTAGGATTGTAGAAAGAAAGCTAGGAAAGGACAAGATCTCATAGATGTAAATCTGGAGGATCTTGGCTAGGAATTGATATTTTGTTTATAGGACTTAGTCTGACTTTCTCTGTACAAAATTATATAGATAACATAAACATGTCATGTGCAATTAGCAACTATTTTTCAAAAATATTTATTTCATTTTCAGATCATGTTTCAACCTTCTGAATCTCTGAAATTAAGTGAAATCTCAGAATTTAGGAGTAACAACATTCATTTCCTAATTGATTATACACATTTTCCAAAGACACCCTCAAACTGTATTGAGAAAAATTTTGGCTATGATAATAGCATCTGCTTTCAGCTATTGGTGCCCATTCGTAGTTGCTGAAACACAAATATATGACATTGGATTTACATAAGCATGTCAACTTTTCTGACTTACCTTACAATGAATATCAGTGACTGGTTGTATTTTAAATGGTTTTCAAATTAAAGGGCCAGCTGCAAGTACTAATTATTTTTTAAATAATTGATATTTTTAATATAATTCTTTAGTAAATAGAGCTCACCAGAGTACTGTGATTTCTAAGACTTTATGGTACTGTTATACATATAAGACCCTCCCCTCCAGCCTCTTCTAGAAAGCACTCCTGCCATCCACACACATACTTTGTTTGTGCCCATATGTACTTAGCAGATTTCTGAACTCTAAAATTTTTCTTTTTGAAATTTAGAAGTGCAGATTTCCGATTGCGTTTGAAATTATTTTACAGGAAAAGTTATACATATTAGATAAACAATTATAGATCCTGAATAGCAAAAATTATTTTACTGAGGCAAGAAAGAATTTCACAGAGGAATAAGTTGTAGAGTACAATCAAGTTTGTGTTCCCTAACACTTTTAAAATTTAATTTGACTTTGGGTCATTAGCTCTCTTTAGTATGTTCTTTATATAAATATTTTAAGAACTCACAATAATTTCTTTACACTTTGCTACATTCGACCAGCATGAATACACTTAAGAATTGGGATACTTTTTTGTTAGTGATGCAAAGAAGAGTGCATTTCTTCTCATTTTGGATTTTTGAACTTTTCTTGCTATTTTATAACTGGGTACAAAGATGGAGATTTTAAGTATCTGAGGTAAAAGCAAGTAAAAGAAATTCCTCTCTATATAATCTAACTTTGAACCCTCTTTGTACTTAAACAG
>TTN-216,,0,208,740844,741051,GTGATTTCATTGACAGTTTTCCAGTGAATGTATAATTTAAGCCTCGTCTGTTTTCTGTATTTCTACCCTGTATGCGCTCATGCTCTCATTCTATCTAGAATGCTTTTTTAGAAAAGACAAGTGTAAATAAACACATACGTATATTGAAGTAAAGAAGTGTTATTTGCAACATATCAGAAAACAAAAGTTGGATGATTTTTCACCCTAG
>TTN-216,,0,101,741052,741152,GTGAGGTAGCGCCATCAGAAAGCCACCCTGCCATCTTCGAAACACGTAGCCTACCTATACCATTCTGAACACAAAAATATCATTTTTTTTTTATTTTGCAG
>TTN-216,,0,452,741153,741604,GTAAGTTGTTTTGTAAAAATCAATCCTTGCTTACAATAAATTTGGCATAATTTTGTAAATCACAGAAGCCAAACTAAAATGTATAAGATATCTTTCTCTTTTGGGTAAAATATTTTTCAATAAAACTGTTATGCAGTAGAATTACTTTCAGTCAAATAATAAAATGTTAAACCTTGTGAGTCTGGCAAATTAGAGATAATAAGGTCTCACTCAGCTGATGCTAGAATCATGTTAAATAGAATAGCCACAGAATGAAACAAATTTTGACAGTGAACAAAACTTACCTGCGTGGTTGCATACAAAAGAATACTAATATTATTTTGTCTGTATATTAGATTCTGCCATTAGATATGCCTGACATATCTCAGGATCTAATAAATCAAACACACCTTAGTTTTCTAATAAATAGCTTGTTCTCAGTCTCTCTATGCTTATTACATGTCCCTTTCCAG
>TTN-216,,0,324,741605,741928,GTAAGACCCAGAACCTCAACATCTGAGCTTGGAGCAGCAATATTCTAGCACTAGGAATCTGTACGAAATTTTATACCAGCGACCAAACTGCAGCAGAGTCAGAACAAAACCTTCCATGTCATATTCTTCAGTGAGCAATTAGAAATTAAAGTAAAAAAAAAAAGTAGTTCCAGTTATAAATAAATGCTACTTTTATTTGTTCCGACTGATGAATTCGTACTATAATACCTATGAAGTACTGAAAGAAATGCATGAGACTTTTCATTATATTTTACGCAAAATAAGAAACTAAAACATGTTACTAACGGCATTTATTTTCTTCAG
>TTN-216,,0,2205,741929,744133,GTATTATACCTCATCTACCTAGATGTCGAAATAAGAATTTCACTCTGCTGACCCGAAAAATGTTGCTTAATACAACGCATTGGCCCTCTAGTGGTCAAGAGGTGGAATTGCCTTTCAAAATGTAAATTACTTTCTCAAAGTATTAGCTAACTAAATGTGTAAGTTATGTGCTTAAAACTCTGAAAATCATCAAACAAAATACTATTTTGGTATTAAAATATTTTATTTTAATGAAATTACTGAAACATTAATAGAGAACTAATTTAATGTTTCATATTTTCCTAACTACTATGTATAACAAAAAGAATAATGGAACCAATTTCTAGTGCAGCTTATAGAAATAAACCATAGTAGTTTACAGCCAAATTGCAAATTATAGCTTGTGGCTTTTCTCAATTTATAGTATTAACTACTCTTAAAAATTTACTATTTTGTCACATAAAATATGATTTAGAATACTTATGAAATATTTGACTTCTTTTGTACCTAAGGCATGATCTCACCAATAAAGAGATCTTAAGTGTTCCAAGGAATTGCTCCTCTCAAATACTCAGTAGAGAAGTTGTAGTATTTGTGTCCCAAAGCTTCTCAACTAAATTAGACAACAGATTTCCTGGGACTTTCTGGAGTTATAGGGAGTTCAGAAATGCTGTCAGAATTCTCCCAGCATGGTCAGAAAAAATTCTGTATGTCAAAATCACATTTTTCTATAGCTAAGTCACTACTACTGTATTAGATTCAAGGGGTGGAAATGGTAGGCCCTTAACACCCGCTATAATTGGCATTAAACGCTTGACCTATTTTTCAGCCAGCCTTAGAGGAAATTCAATTAGAAACTTCCAATTTTGTGACTAATGCAACCTCATTAACAAAGAGAAGCATTTTTATGATTCATACGAACATAAGCATTTTATCTAGCTGTGAGAACAGAGAGGAACAAGAATCAACAATCATAAATTGGATTTCCATTTCTATTTCTGTTGTCAAAAATAATAACTTATGTTAATGAATGATTTGTTCTTTGACTGGTAGTATCAACATGGCTAAGTTTGGTACTCACTGTGAAACTTGAGAAGTTAAATAATGTTTTAAAAATTAAAAAAGAGGCCTGGCGCGGTGGCTCACGCTTGTAATCCCAGCACTTTGGGAGGCCGAGGTGGGCGGATCACGAGGTCAGGAGATCGAGACCACGATGAAACCGCGTCTCTACTAAAAATACAAAAAATTAGCCGGGCGTGGTGGTGGGCACCTGTAGTCCCAGCTACTCAGAGAGGCTGAGGCAGGAGAATGGCGTGAACCCGGGAGGCGGAGCTTGCAATGAGCCGAGATCGAGCCACTGCACTCCAGCCTGGGTGACAGAGTGAGACTCCGTCTCAAAAAAAAAAAAAAAAAAAAATTAAAAAAGAGTGGGCTGGGCGCGGTGGCTCACGCCTGTAATCCCAGCACTTTGGGAGGCCGAGGCGGGCGGATCACAAGGTCAGGAGATCGAGACCATCTTGGCTAACACGGTGAAACCCCGTCTCTACTAAAAATACAAAAAATTAGCCGGGCGCGGTGGCGGGCGCCTGTAGTCCCAGCTACTCGGGAGGCTGAGGCAGGAGAATGGTGTGGACCTGGGAGGCGGAGCTTGCAGTGAGCCGAGATTGCGCCACTGCAATCCGGCCTGGGCTAAACAGCGGGACTCCGTCTCAAAAAAAAAAAAAAAAAAAAAAAAAAAAAAAAAAAAAAAAAAAAAAGAGTGTTATTTATTCATGAATACAAAAGGCCATAATCAAGTATGATTAGGAACCGTGGTTAAGGTATAACAGCTGCACAACAAAGGACTTTAAACCCACTTGTTACTCTTCCTCCTAACATATTTGTGTTCGTCCCTAAGGATGAAGCAAAGATGAAAATGTGTACTTTACTATTTATGATATCACTTAGATTCACACTCCATGTTCTGAAAACTTTAACTCTCAGCAGACATAAAATCAGTGAAGATGTAAGATCACAGTACATTTTCTATATCCCTCCAAAACAATTTTTTTGCATCTAGTCCTAGATCTTTCCAAAACAAATATCTTGTAGTAATATGCAGAATCTCGCTACTATCAACATATGGAAAAATAAAATATTTCAATAAAATTCCTAGTTTCCTGAAAGCATTTTAGTTACTTACACCAGAAATATTTTTTCTTTTTTTTTCTTTTTTTTTTTTTTTAG
>TTN-216,,0,1674,744134,745807,GTATTATAATTAATCAAAAAGCAGTCTTAACACTTTTTTCTTGGCCAAAACTTTTAAATTCTAAACAGTGGAGGGTGAAGGAAGGGTAAGAGTTTGCAATCACAAAATGGTACCTCTCCCTTCACTCACTTTCGCCCTCGTCTTTGACTCAGTCCTCACTCTCTCAACTCCTTTTTTCCCCCTTTTCTCTTTCCTGTCCTCCTGAGCCCCTGGGAACCAATGACAACACCAGTGTATTCTGGTTATTTCTGGATGAAAATTTAAAGAAGGTCTTGCCCAGAAATCCAACAGCTATTCTTTTTTTTTCTTTTTTATTTTATTGTAAATTGACTATTTACTATTGTGTATATATTTATGGGGTACAAAGTGATGTTATGATCTGTGAATACAATATGGAATAATTAAATCAAGCCAATTAACATATCCATCACCTCAAATACTTAACATTTTTGTGGTGAGAATATTTGAAATTTACTCTTAGCGATTTTGAAATGTACAGTACACTATTATTAACTATATTCACCACTCTGTGCAACAGATCTCAAGAAAAGCCATGTTTCTTCTGTCTAAGATTTTGTACCCTTTGACCAACATTTCCCCATTCCCTCAAATCCCCAGCCTCTGTAACCATCATTCTACTCTTTATGAATTCAACTTTTTTAGTTCCACATCTAAGTGAGAACTTACAGTCTTTGTCTTTCTGTGCCTGGCTTATTTCACTTAGCATAATCTCCAGTTCTATCCATGTTGTCACAAATGACAAAATTCCCTTTTTTTATAAGGCTGAATAGTATTCCATTGTGTATTTATATACCACCTTTTCCTTATGTATTCATCCATTGATGGACACTTAGGGTGTTTCCATAACTTGGTCTTTGTGAATAATGCTGCAATGAACATGGAAGTACCCAACAGCTGGTCTTGATAAAGTCACATCAATGTAAGATCAAGGGTTGCTGCTAATTTTAAGAGGTTGCTGCAACCCACCTCAGTATCTTTCCTGATTTAGGTGATCTAAATATCAATATTTGAAGAAAAAATACTTTATGAAGGAGGATCAATTCAAATCACTTTAACTTTCAATATATCCTCGAAGATTTTTAGGAAAACAGTTGGATAACTAAATTTAAACAAATAGTTTTAACTCATTTGACTAAGATTAGAGTACAGCAACCTCCATAAAGAAGGAAAATATGGAAACACAAGGCATCATTCATCATTCAGACTTTTCTGAGTGGTCATTTGTGAAACATCATGGAATAAGAGGACACTCAAAAAGCATGGATATTTCATGAACTTCATAGTTAATAATTGAAAAAGTCTAATGTGTTATTTTTAGCATTGGACATATTAAACATTCTCTTCATGCTTAATGTTAACTTATTAGAAATCAATCTAAACTAGAACCAATTTAAATGATCTTAAATCAATCTAAACTAGAATCAAACTTTGGCCTTTTGCATGTTTGATTTTTGTTAATATGGCCTTGCATAGCATTTCTAATGAGCTAGATTTGGAAATTATAGAAGCATTATTATGATTCCTGGAAGGGCTGGTGTATGAGTAGTAGTCATAGCTCCTACAAACAACTAACAATGATGTGGAGGATTAGTAAACATTAATAATAATGTAATCTAAAAATAAACACACATTTTTATGTTTTTAAACTCCCAG
>TTN-216,,0,851,745808,746658,GTAAATAAAGATAAATTATTTTTATTCTGTTTATTCCTGAGATTTGCACTTCTGCTAACTATTCTTATTTTAAATATTAGGCTTCCAACTTATTGAAAGTTGTGGAGTCTCCTCTGCTGTGTTAAATTTAGCATTAGAAATGATGGCTATTTCATATTGCCCCTTTCCCAGGAAAACAAACCCAGGCAGATGTTTATGCTGCCTCTGTGCAATGGTCTCAGAGAAAGAAGAAGTGAGGGCTAGAAAGGAAGGGCCATTCCTTATTTTTTTATTGTAGTTAACACAAATGTTAAGAGTCATATAAATAATGAGAGCCCTTAAGAACTTTAAAAATCTGTTATCTAAAAGTACCTAATTAACTTGGTTACATAATTTTAAATGTTGTTTTTATGAAACTGACTAAGGGATCATATGCAATAGTCAAAAACCTAGGTTTAAAATTAGAAATGTTTTTGAAATAATAATCAGAACTTTTTAAAAAGGTTAACTGTATAAATATGAAATATAAATTCCATGAACTTATCGAATATTAAAACTATTCCACTGGAAGAAACTAGGGGTTCTGCAAACTGGAGCTCTCATGGAATAATAGAAGGTGTGTCCATTTGATAATATTTATTGAATCCATTTTTTCATACTGGAAAAATCCTCAAATCAAGAGTAGAATGCATCTTGATACTCTACTATGTTCCATAGTCAAAAATTTAAATGGAACCAATACAAAAAAAAAAAACAAATTATCAATAAAATAGATCTGAAATACTGATGTTGTTTAACTAGGTAGATTTTTGTTTAGTGAAGCAGTTGGATGGATAGAATTAATATGCTAATAGTATCTTTATCTATTTTAG
>TTN-216,,0,454,746659,747112,GTATGTATAAACTGAATGACTTGTTTCCCTCTTTTCTTCATTTTTGCTCAGTTCATTAAATTTTCAATGCTATGAACCTGATTTGCAGTTTATGTGAAATAGTTAAAATGATCTTAGATTTTTTTAAGGTTAGAAATCTTTTAAAAGTTATTTTCCTCAGAGTTACTTTCATGCTTTGACATTACAAGCTAAATCATTTAGTCTTATTACTAACACTAAATTCCAAGTGCTAATTTCTAATGCAGAAGTTCAAGTTTTACTTTTACTGCCTTGTTGCATCTCTGCTTGATCCTGCTTCAAATCCTAGCACTAAGAATTGTGTTGGTAATAACGATCCCAAATATAATACTTCACACGATTATATATTATCCTTACCTTATCTCATTTGCAATTAACAACCTAAGAGAACTTACCTATTTAAGCATCCCTTCTTATTCCTGTGTTTTTATTTCAG
>TTN-216,,0,441,747113,747553,GTAAGTAATTAGAAATATTTAAATAGACTAGAGCATCAACATCATTATCATGGCTTGTTTGGCAGCAATGTATAAATCAGCAGTTCAATCCAATAGGCACAACTTCTTCTCTAAGCTTTATTGTGAATGATTTTTTTTTCTTAAAATTTCTATCTAATTGATTTCATTAAAAAATCAAAAGATGATAAAAATTGTAATGGTAAACTTAAATATAACCAAAATATGTTAAGTACAGAAACTTGTACCCAGAGTTCAAAGTTGTGCGTAAAGGTCAAAGAAAAAAAAACCGAACTCATCTCTCTCTTTAAAAAATGATACATGTATCTGCATATACACTTATAGGTGTGTATAAACACATATACACAGAGAGAGAGAGATAGAGAGAGAGAGAATTTTAATAGGAATTCTAAAAGTACTGCAATTTCTCTAAAATGCTTGCAG
>TTN-216,,0,152,747554,747705,GTATTATTTAAAACATTCCTAGCACCCATGTACACAAGTAATATGTTTACTGATCTATACTCACATTAGTTATTTATATAATCAAATACTTTTAAATTTTGTGCAAAGCAATATTCTTCAAAATACAAATATATTTGTACATATTTTTAAAG
>TTN-216,,0,590,747706,748295,GTATACATCTTTGTGTTTCAGCTACAAGTTCAAAATTTTTTTATTTATGTGTATGGACATGTGTACATATATTGCTAAGTAACTCACAAATCTGAAACGACCAAAAACAGCACATTTTTACATAATACAAATTTTATGTTGAGTTGCACATATGTTTAATTTAAATAGTAACATTATCTACTTTGTTTCTAGTTCTGCTTAAAAATTACATTTTTTTATTATAAAGAAGGTTTGTGTTTAATTAGTAGTTTGCTAACTTCACTATGCAATGCATTCCATTGCATATAATATTCCCTGTCCTCTTATTTATAGAAATAGACCCTAACAGATTTGGAAAAGCACAACATTGTGTGTGAAGAAGTTGTGTCTATTTGATTCTCATTTAAGAATGTTTGATGAAGGCTGCATGCATTGTTTGTCCCTATAGATCAAAACATGATTTGTTTTCTTGTCAATACTGAATTTGTTCTCAAGCTACCATATTAACCCACTCATTCTGTGTCTAAATACTTGAGTATAAAATCCATGTGTTTGATCTGATGTCTTGTACTAAAAAAAAGGAATACTAATGTGAAATACTCTCTTTAAAG
>TTN-216,,0,232,748296,748527,GTATAAGGCAAACTGGAATGTGGGGGCTCAAATGGAAGGGTTTTAGGCAGATTTTTATCCCTCTTGTTGTCTAATTTGTGATCGTGTAGACATTTCTGTCTCCTTGTAAATTCTGTCATCTTTTTCATTTCATGTTTGTCTCTGTTTTCATTTTTATTTTAATGTTCTTTGTAAATTACAATTACCACCCACAACATGGCATATCAGTAATTAAAATGTACATTTTTTTAAG
>TTN-216,,0,1028,748528,749555,GTATTAGTAATTCATTCTAAGTTTAAACTCTTTTAATAAAAATTAGTACAAATACCATAGTAAAACATTTATGTTAGTATTAAATAATAGATTTAGTCACAGTGTGCATACCTATAGCCACTATGTACAAAGGATGTGATGGGGGACGGGAAGAACCATGAGGAAGGCACAGGGGGAAAAAAGTGAAAATTATGGGAGGCTCCATTCCCTGCTTCAGAGAGTTTGCAATCTCGTAACCTGTTACTTGGAAATACAGTGTCCTGGAGCCAGTTCATGCTAGCTCACCAGAGCCTATGGTTACATTTTCAGGAATTTTGCCAGTCAGTAGTTTAACACCACCATTATTAAAAATTAGATTATGTAAATTTACAGTCCAATAAAGTATATTTTTAAATATTAATAAATACTCAAAACTCCTATTTTACTGCATTTTGTTCTTATCTGTGTTTCTGAGATTGTTTCCATCTTTGTGTCTGTGTGGTGGAAATGCCATATAATGTACTACTGCACATCTCTTTCCAACTCCAGGACAATGACATCACCTTGACAGCCAGGGTGGGAGGGAGTGTTTATACCACCTTGGAAATCGGAAATCTGCAAGCACTATAGATCAAGGCTCCACCCCCTCCATCCCACCCAAATTGTTAAACATTTAAGACACAAAAAAATCTAATGCAATTGTATTTATGAAACTGCTTTATAAAAGTAAAGGTTACAAAAAAAAAAACTAACTTCATAGTTATCGATGTTCATAAAAAGCTGGTTTCTGAGGAACTGACACAGGCACCTCCGAGGGAGGATTGCTCCTACCTGTTCCTGACAAAGTAGAGGCTTCTGCAGTTAAAGGTGACAGCAGTCACATTTTCTAATTAGCCATTCAGCCATCTTCATTTACTCTCATTTCTAAAGCATAATTTTCTTGCATTCAGTTGGTATAAAAAGGGAATCTCTATTTAATTCTAAGTCTTACAACAACATATGCCTTGTCAAATGCACACTTTCTCAAAAATGGCACTTTTCTTTTAAAG
>TTN-216,,0,397,749556,749952,GTAGAATAATATTTGTGAAAAAAATAATTCTTAGCATCCATCTTGTATCTTTTTCTATAAGATCTGTGTATTAACAAAATAGCATCTGTAAACCATCTATAATATATTTAATTCTGTGTATATTGATTTCATTTATTTGTGGTGATGTGTTATACAAGTATTGGTAACATTTCTAAACTCCAGATCACGCTAACTGGGTCTTTGTCTGCTTGTGTAATGTATGTAATGTCTATATGGTGTTGAGGTATTTAGCTTTCATTTCTACCACAAGTAGGCATATTTAAATTACTTCCTAATTCTCACACTGTTAGTGAAGATTTATGCTTTAATGTAATCTTAGATGTCTCAGAAGGTGACTAGAATATTCCACATTATTTCAACAATTGTATCTTTAAAG
>TTN-216,,0,2119,749953,752071,GTACGCCAGAGCCAATGATGGGGAGACTCTTTGCTCCAAGTGCCAGCCTTTTGCTTTCTACGATCTTCATATGTACTATGCTGCCTTTGTCTTTTGTCTCTTTTACATTCTTCTTGTGTTTTTACTGTTTGTCAGCTTCCGTGCCATGCTCTTGACATACTTTATTTATTATACTGAATATTCCTAAGACATCACCAAAAAGTATTGTTAAAGGAAGTAACTATGTCAAACTGCTATCTTACATTTTTAATATCTTCCCTCTTTTAGAGAAAGAGGAAATGTTTGTGAAACTTGTTTTCTACTGACATGTTTCTAGGAAAAAACCTTTCATCCTTCATAAATGTAACTTTTTCTTAATAAAAGCAGTTTCATGCATTATGAAGAGGTGGAGACAGGCAATGACAACTGGAGAGTGTCTGGCAGAACTGAATGTTAATTACATAAAGACGTACATAGTACCACGCTTCTTAAAAGTCAATAGTGGCGAGTCTTCAATAGTGGGGAACATACAGATTTTTTGAAGTTTACTTTCACCATTTTCTTGAGACCTTAACTGAGCTTCAGTATTTGCCATAAATGTTTCCGTTATCTAATTAGCTAGTCAAAGTACCTTTCACAGAGGTATGTTTGAATGAAAATGTGCTGCTGTGGTATATCACAAATCCCTTGCTTTGGTTTGTTTGGGATTTTTTTGGCGATAAAAGGCACTATCTTATTGAAGCACTGAAGCTACAATTGCACGCATCCATTCAGTTATAGAGAGACTCAGCAAGAATTCAACATTATCCAATTTAGGAGAAACCAGACCTAACTAAAATAGTACATTTTGAATAGTGTTCCCTTGGCCTGACTTTGCAATGTTTCTATTTTCTTCCTGAATCAAATATGCTTCTCTCTTTCTCAAACTCTTGGCTCTTTCAAAATTCTTTTGATTATCTAACCATTAAATACAAAGGTCATGTTAGTAAAACCAATACTAATACTAAAGCTACTTGAGACAGATCGTCTTAGATAAATTAAATCCATTGTTATTATGTACTACATTTCCCCATACAAAGCATAAAGAACCTTTTCTATATACTATCTGAACATTCTTGACTGTTTGTGTAATCACTAATTCGTTTTCAGCAAAGTCATATATGTCTTCTAAAGGAGACACAGAGGCATCTCTCATTTACTCATAAAAACAAATACACATAGTATAATAGCACGTATATATATATAAATACTGCATGTATATATAGCATAACATATACATATATAAATTAACAGCTATATAATTGCACCAAAATATTACAAATGCACGTGCAGAGGTGCAGGGATTCACAAAAGCTGCCAATATTGTATTTAAAATGAGAACAATTATTGCCAATAATGCATGCTGTTAAAATTCATCTTCCAATTAAAAAGTCAACATTATCCATTCTTAGAATAGATAAATCAAATACACTGTAAACATTTTTTAGGTTGAAAACCCTGTTCAAAACTCTAGAGCCCCTTAGAAAAAAAAAGCACAAATACACATACCCACAAAATTCTGCACACAAAGCTCTGTAAAGTCATTAACACATGGGTATCAGATTGAGAGACCTACTCTAGAGTGTTTCCTGAGTTTTGAATTCACTACAGGCACACCCCCCAAAAATGAGAGGAGAAATGTGGGGAAGAGAAGTAAGTTACACATATTCAACTATTCTAAGACTTCTTAGTCTTAGTCTAAAATAGTCTTAGATAAACTAAAGCCATTGTTATTAAGTACTCCATTTCTCAATACAAAGCGTAAAGAAGTTTTCTATATACCATATCCACATTCTTGATTGTTTGTGTCATCACTAATTTGTTTTTAGCAAGGTCATACAATATATAAAGGATGAATTCTGTGCACAACTTTGTTACATAACTCATTTTTGCCTAAATGCCTCTAAAACATTATTTGTGATATTTATCACATTGTGATCCTTGGAATAGTATAGTTAGTTTAATTTTCTGGATAATTTTGCTGATGCATAGATAATCCATAACAACATTAATGTACTACATAAAGATTTGTGCATGTGCCTATGTTCTTTCATAAAAGTGATATATGTCTGAACTAACATTGTGTTTCAAAAACTTTAAG
>TTN-216,,0,217,752072,752288,GTACAGTGGCTTTCGACGTAAAGCCCTATCTTTTATCTTTGATACAAAATATGTTGTGTTTAATTATCTGTTCATTGAGTTAGTTTAATTCTAAATGAATGTTTTGTGGTGAGAACTGAACAAAAGTGTCTGTCCACCCGTCTGCTTTCTTAAAAAAAATAACTGTGCATAGCTACTTTAGAAAATATAAAGTCAATTCTAAAAATGTCTCTTCAAG
>TTN-216,,0,141,752289,752429,GTACTTAATCCCATCTCCATGAAATAACCTTGTCTTTCCTTCAAGCCTCTTTAATTGCATGTCTTCTTTAATTGCCACTTCTATGTTGCTCATTTATTTGGCCTTTTTGACAAATTTTAAAATTCAATACTATCCTTTAAG
>TTN-216,,0,153,752430,752582,GTATTGTTTCTCCATCTTCCCAAGAACTGTCTTTATGTTCCAGTGATTTTGTTAGTTTTGTGATATGAGTGCACTGTGGGTGTATTTCTTTGTTTTGCACTGGGCTTCAATGAGATCACATTAAATTTCTAAAAGTGCATAATGTCTCTAAAG
>TTN-216,,0,274,752583,752856,GTAGGATTTGCCTCAATCCTCTGACAAAAAAAAAAAAAAAAAAAAAAAATCTTCGAGTGTGTTAAATTCTTGCTTTTTCCATCTGGTCTGTGCTTATACTGATCCATTGTCTCACTTGCAGTGAAACTTTTGTGTTTATGTCCTTGTGATATGTAACTTGTTTTCCCATTTTGCTAGTCAAAGTGGTGTACTGTGCAACTCTTCCCCAAATTCTAGAAAGTGAGAATTGTTAAAATTCTTGATTTTAAACTTCAACTTTAACACTTTCTTAAAG
>TTN-216,,0,452,752857,753308,GTATATAATCGGAAGTCAGGGGATAAATGAGTTTGTGTGTGTTTCCTCAAAGTCTCTTCTTCTTCCACATGTGATTGTTTACTTTAGAACATGTCCTCATCAGTTATTTCTCCTTATGTTGGTATTAGAATGTGTCTACCTTTTGTAGCCTTCTGGGACTGAGTCTTTTGTGTCTATGTTGGCCTTGAATCATTCGAAGGAAGTGGATGAGTCCCGAAAATGTTATAATTTTGAAAGTGGCCACACTTGGACATAACTCAAGTATCATTCTCAGTCTTGGGCTGTACTTGCCCTCATCTTAAATTAGCTTCCTCCTTCTTATAGTGAGGAAGTACCATGAAGCTATGTCCTAAGCAGATAGAAGAACAGTTATCCATCTGTAGTGACCACATGGCTGTATATACATCTGTATCTCAGCAGGCTGAATTTAAATGAAACCTTATCTTTTAAAG
>TTN-216,,0,2512,753309,755820,GTAAACAATGCAAATAAGCTAGAGATGATCTGGGGTTTTGATGAGGTGTTTTCTTTCACAAATTGTCTACAGACCAATGAAAAGAGACAGAAAAAAGTGACACAAATTCAGTGAACATCTACCAGTCTCATTAAATGAATATTTTGATCAAAACACAAGATTCAGGAGGATTATACTAGATTAGAGAAATCCAGTGTATTTCTTCTGCATCCCTTCTTACTTGCCTACATAGAATAAAAGAGGCTTCATATTTATATATAATTAATCAGGGCAGGTATCTCCATATACATATATCCTTTCATTAAACAGGACTTGGCTTCAGCATGGTGGGCTGGCATAAGCTTTACCTTAGTAGCCTAATGCCTAATTGGTGTTTCTCAAACATTGCTTGTACCACAATCCACAGACAGAAATATATTTTATATTATAATCCTTTAATTTTTTTATTCTAGGCATTTAAAAAATACAAGTTATAATCCATTAAGTCAATTGCAGAAGTCACTATAATGTCTTAAAATGTTTTAAAATGAGCAAGAAAATATATTACCTCATTACATTCCAGGAGTCAATGCCATATTTGTGAGTCTGAAGCCCTGAACACATAAGGCTTTCCTGTATTTTACATATGGAGAAAACCATTGTGTTATATATGGGATCAGACTGACTTGTTACTCAGATCTTTTCATACCTATAATGCTAATTATCTATAGTTTCTTAAGGACAGAACCAACAAACTATTCCATTGGGATATTTTTTCAATGAATTAAGGCAGCACCAGGTTTCCAACTAAAATCCAGCATTCTGGCTAGAGCCATGTGGCCAAAAGAACTTTCCTAAGAAAGTTCCTAAGGTCTGCTTTTAAAGAGAAATCAATAAGCTCCTTAACCAAACTAACTCTCTCCCCAGTGAGAAGATGAGTAGAATTGAAGTACATTTAGATGTCCCAAGTATCTGTTTTTATCTGTCTAATAAAAGATGGCACACCATGCCCCTTTTTTCACTTGGAACAAAAGCCCATGTAAAAATCCAAGGTGCCATAGTCTTAGTGGAATGCCTTGGAATAGGCCAAGATGGGACATGACTCCCAGGAGGAAATCCATTAACTCTGTTGTGCTTCCTGGAAGAGGCCATGATGGTGGACATAAGTCAGGAAGCTGGTAGATTTGAAGACGACTCCATCTTTTCTAAAAGTGTTTGTAAAACCAAACATAGTCTGATTTCAACTTTTGACACTATAAACTTCCTGTAGTACTCCAGACTCTAGTTAAAAGGAGAAACACTGTGATTATTTTTATGTTCTCATTATGCCCCAAAGATGGGTGGCTTGTTAGGTTTACTTTCAGCGTAAGGAGCAGATATGTTTTTAACCAGACACTTCTATTCCTTATTTAACTTTGACCAGGCATGGTGGCTCATGCCTATAATCCCAGTGCTTTGGGAGGCTGAGAAGGGAGGATTGCTTGAGCACAGGAGTTCAAGACCAGCCTATGCAACATAGCAAGCCCCATTCTACAAAAATTAAAAAAACAGCTAGGCATGGTGGCATGCACCTCTAGTCCCAGCTACTCAGGAGGCTGATGCAGGAGGATCATTTGAACCCAGGAGTTCGAGGTTACAGTGAGCTGTGATTACACCACTGCATTTTAGCCTGGGCAACAAAGCAAGACATTGTCTTAAAAAAAATTAAAACTGGCCGGGCGCGGTGGCTCACGCCTGTAATCCCAGCACTTTGGGAGGCCGAGGCGGGTGGATCACGAGGTCAGGAGATCGAGACCATCCCGGCTAAAACGGTGAAACCCCGTCTCTACTAAAAATACAAAAAATTAGCCGGGCGTAGTGGCGGGCGCCTGTAGTCCCAGCTACTTGGGAGGCTGAGGCAGGAGAATGGCGTGAACCCGGGAGGCGGAGCTTGCAGTGAGCCGAGATCCCGCCACTGCACTCCAGCCTGGGCGACAGAGCGAGACTCCGTCTCAAAAAAAAAAAAAAAAAAAAAAAAATTAAAACTGTATACACTTAGGCTCAAAAATCATGTGAAGCCTCCTGCCTCTTCTACCATACCTGCCCCACAAAACTGGCGGGGAAAACAATATGGAATATTATCTTACAATTCACTTAAATCCTCAAGTATGTTTCTGCCCTGTGGCCTTCAAATCTACAGTGCTCTGCTATTTGTGAAACTCATCTTCAAATTCTTCTGTTCTTATTAACTCAGCTATTATAATCGTTTCTTGTCCCGTACTTGTCCTGTCGTTGCTGTGGATATAAGCATTATTATCTGTATGACACATTTGAAAATTAAGTTAATGAAACCTATTTCCCATTTCCCATACTCTTCATTAACGCATGTGCTTTGATTAAAATGCTCTTTGAGTATTTTAAATAGGAACAAGCAGGGGTTTGGCAAGGGTTAAACTTTTGCTATTTTGATTACTCTTTGAAGTGATAAATTAAAGCTAAAAATAAACATGAAAAACACTGTAATTTATCTTCTTTAAAACTGCTGTCTTTAAAG
>TTN-216,,0,187,755821,756007,GTATGCTGACTCTTTAATTAGTTTTATCCCTATGTTAGCTTGTCTCCTTCTTTATGTTTCCTTATAGCTAATTTGTCATCCATATTGCAAATATTGATAAATATCATGTCTAATAAAAAGATCCCTTACACTTTTATCGAAAAGAAATCTAGACATTTCTACAAACATATTTTATAATCTTTTCAAG
>TTN-216,,0,263,756008,756270,GTATGATTTCTTTCAAAGAAATGCAACACTATTTATTTTAATGTATATAATAATACCTTCACATTTGCATAACTGTCTTATGCATAACAATTTGCATAACTGTCTACGTTTTGTCAGAACACATGTATGAACGTATTTACTGAGTATAGTCATTAACGTTTGTATATATGTGCAATCTTTTCAAAAAGTGAATGCTAAGCCCCACAACTGTGTCACTTCATATGTAAGGCAAACTCATATTCTTAAACCTAATCTTTCTAAAG
>TTN-216,,0,156,756271,756426,GTATATTGGATTTTATTTTATTCTCAAGACTGTCTTTTTTTAATCTTAAATTGATACATTCTTCAGATTTTTTAAACATTAACCAGAAAATAAGTGTGCCTGTGTTTAGTGTTTTCCATATCGTATGTTTGATGGTATTGCCTGGTATCTTTTAAG
>TTN-216,,0,252,756427,756678,GTAAACAAACCTCCCCAGCAGAAAAACTAGGAACATATGGCTTGTCTTTCTTTCTCTCTGCTGCTGTTCTTTGGGTCATACTGTTTATATGTTGGTGGGTGACAATGGTGTCTTTGGGTAGAGTATTACTTGTGATGTTTTTGTGTGTGTGCCTTGTAAATTCTTCTATTCTAAAATCACAGTACTTTCTGGCTAGTATATTTTTTACGTCCACTTTGATATAACTCCCTAATCCTAAAATTATCTTTTAAG
>TTN-216,,0,247,756679,756925,GTACATCCGCCCTTCCATTATGCACAATATTGTACTTGCCCTACTCTCTTTACCAAATACACTGGTTATGGGGGCTGGTTTTTGTTGTTGTTGTTGTTGTTGATGTTGTTGTTGTTGTTACAGTTGTTGTTTTATGTTTGAAATAATGAAAATGTCAAGTGTTTATGTTTGGGCTACTACTTTATGGCTGCCTTTTTGTGGTTTGAAAGAGGGAAACAATACTTTAAAGTGAAATCTCTCTTTAAAG
>TTN-216,,0,707,756926,757632,GTATACTGACTCTTAAAAAAAAAAAAAAAATCAAAATAAGCATCCAGACACTAAAACTAATCTAGTGGAATAGGTTCCATTAGAAAAAAAAAGACATAGTATAAAGTAAGCAATATAAGTTTGTTAATGCATATCACTTCAAAACTAAACATTTTTGATAACAGAAAGTACTTTTTTCTTAAAAAAAAGTGAGGCTTCTTCTAAACGTATGTGAATAATTTTCCTTAATCTGTATTTGTCTTCTAATGTCTTTTCCATATACTAAACTCATCTGCCTAGATGCTTGCTTTATGTGGCAATCTCTGATGAAATTTTTAATTTTTTCAATTCTGAATTTTCTACATTGTACCAATAGAGCTAAGGAAAATGTCTTAGAAGTGAGGTGAAGAAACTATTCATGTAACATAGGTTTCTGTCTAATGCTTCTACTTAGTTTGATAGTCATTATTTATGCTGTTTAGTTGTCTTTTTAAACTTTTATAAATACTACTTGATTTTCCTAAAATTATTCAATGTCTTTGACGTACTTCATATGTATATTAGAGTAAGTTTATTTCCAAGTCTATTGATTTTCTTGCTTTTTAAATGAAAGTTTAATCAGGCACTGTTATGGTTGTCTTTGTCCTTGAATTGTTTGAACAAAATTTCTCTTCACACACACATTTTCAGAATCTTGCAATTCACTTTTAATAATTACTCCTTTAAAG
>TTN-216,,0,307,757633,757939,GTATATTGAACTTTGATTAAGTAATGTGAGGCATGAAACTATCTGGCTCTTTGCCTTCTAGTTCCCAATCTGACTCCTATACTTTATTAGCTTATTGTTGATTAAGGGCAGGGTATATAACATTTGAAATCACAATTGCTAAATATACTCTATGATACCTTGACTGGCCAAAAAAGAACAGTCAGGGTCTCCCATAATCAGTGCATGAAACAAACGCAAAAGAATAAAATCAAAGCACATTGTTACTATCAGTCATCCTTAAAAGTGCTTTAAAGTAAAGTGCTGCCTGTTGTTAATATTGTTTCAG
>TTN-216,,0,958,757940,758897,GTATGAGCAAAACTGCAAACTCAAAACCACACTAAATATGTGCACACTCAAACAAGATAAAACAAGATAAATCATAACAAGATAAAAATTTGGATACCCAAAGAAATTTGGAAAGAACTTTGTTTCATTTCGCAAATGCGGAATTTTCTTCTTTGATAACTTCTAGAAAAAATTTTAAAAACCCTCTATAAATCTTAAGGTTATTGTTAGACTTTTGTTCCGGGAATAATCTAATACCCCCCTCATTTTTGCTCGTATGCAAAATAGCAAATGTCCCTAAGTTTCTTTTTCAAAAAGGTTACAAGTTTATCTTCAAGTGCCCGTGATCATTCTAGTACATGGTTAAAAATTTCTGAACATCCTTTATTCTAAAACTTGCTATTACGGAGTATGATAGGCTATTGAGAAAATGTATTTACCCACAGGGTTCCCATTATCAAAACTTGACAATGACTGCTTCAAAAGTTAAGATAGAGATGTAAGCTAACACAAGCTGTTGTGTTTTACCTAATGAAGGTCAAATTTGTTGGCATATAGTTTGGGCTTCAAATTGTTTATTTTACTCAAAGAATAAATCTCTATTGAAATTTTGAAATGAATCAATCTTATTTCACTTATTCAGTCTCTGATGTTTCATAGCCCAACTTTGAGAACATTCTACATAGTCTTACTGATAGCTTTAAAAAAACCATATTATAGGGGAGTTTCAGCCAGGAATTTATCTACCTGAAATGAAATGAGAATTTTAATATGTAAGAATTACCTAATTAAAGAAAATAGCAAGAAGGAAAGGGCAATATGAGCTTGTTCTGCTTGGATCTCTGATTCTTGCCTACTTCAATAGGCTATGGCTATACTGTAGATAAAAGATATTATTTCAATTATTTGATTCCTTTTAAGAAATGTTTAAACTTATATTCTAAGTCTAACATGAAATACCTTGTATGTACTTTTAAAG
>TTN-216,,0,210,758898,759107,GTAGAGTGAAAAAAACATTATTACCTGTAAGAGATCTTTGTTTCCTCCATGTCTGTCCTACTATAAAAATATATGTAAAAGTGGCAGTGTACAAATTATGTGTGTGTTTGGGAATATTATGTTGTATTTGTCTTTCTTAACTTTTTGTTCTTGCTAGCCTTGAGAAACCTGTTTCAATTTTTAAAATCTCTTAATATTGATATTTTGAAG
>TTN-216,,0,204,759108,759311,GTACATTACTGAGTAATAATCACCAAAAACAACTTTGTTATGTATGTTCTAAAATCATGTCTTCCTAGCCCGTCTGATGGTCTGTGTTTTTGCTGAGTAGGATGTTCTTGTCCTGATTCTTACATTTCAGTTTTTTATGTGTATTTATTACATAGTATTCAAGGAGTTGGTTTTAATGCTCTTTAATAATTAATATCTTTAAAG
>TTN-216,,0,747,759312,760058,GTATAATGATTTCCTTCCTCGATTGTGATCTTTTCTGATGCCTCTTTTGAAATTAATGTAACTATGATTCATTTCATTTTGTTGTTTCATGTCTTTTAAATTAGTTGTCAGCAGAATGTTGGATGTAAAAATGTGTAAATACAGGATAAGAAGATAATGCCTTTAAAAGGAAAAATTATTTCTAAATACATCCATAGCCTGTTAGCCAGTGGCTGTGTCCTGCCACATGGCTACAATACATATAAAATAGAATGTTTGGGTTTAAAATCAGTGACCGTTTGGCATATTCCTGATTTACCTAAATGATGTAATGATACCATAATATTCACCAAGCTTTGGTAACTGTTTATTCATTCTAAATTCATTTTGAAGATTTTTTTTAAAGCTAACCAGTTTCCAGTCATTTTCCCCCTGATTCATACTAAGTATGAAGTATACTAATTGAGAAGTAAATTTCACTTTTCAGGAAGGATATTTCTTTCAAGCAGAGATATTTGAACACTAAACCTCATTTCACATTTGGGCTCTGCTACTTCATGTTTACTTGGGTACTTCTGTGTACTTGTATTTATATGAAGCTCAGAATCCTTTCCACAGAGAGTATATAGTTTCTTAAAGATGAACAATCGCATATGTATCTCATTAAAGGAAGATACATTATTCTATCTGCTTAAAGTACAGCAAAACAAGCATTGGCTGGGTGGCCTTTTACTGACAATAAAATTTCCTTATACTTCATATTTCAAG
>TTN-216,,0,198,760059,760256,GTACCTAATGGCACTCATTTTAATGTTTTGTTCGTCTTTTGCTGTTGAATTCCTCTTCAGTTCTGTGTGTGAAAACTTCTTTTGTGGGAAAAGTAAATCTTGTCCTTTCTTCTGTTATAAATGGGCCTGTGTTTCTAAGGTGTCTTAATTTTGTTGAGTCATTGGCAAATGTCCAACTTAAAGATAATATCTTTAAAG
>TTN-216,,0,211,760257,760467,GTAGATGATGCCTCCTGCAAAGGGCTGTGCAACAGCATCTTTGGAGTTTGGGGGTCTGATTTGGTCAGATTCTGGGGGTTATTGGCAGCACCAATGATTGCTTACTTTAAAGCAGATATTTTTAGATGCTGAAATATGATTTCTACAGGTGCTTTTCACATTTTATTTCTTTCCTGCAAAATTTCCAACATTCTTAATAATATCTTTAAAG
>TTN-216,,0,182,760468,760649,GTACACCACCATTCATTGACGGGTATCTAAGAGACTTCATCTGCCTAGAAATAGTTAACTTTCTTCTGAGTTCAAAACCTTGTGTGTGTGTCACTGTCCGTTGTTAAAAAACATTAGCTGTGTTTTATATGGATGTGTTGTTACTAGTAGTTAGAACTTAACAATAAACAATATCTTTAAAG
>TTN-216,,0,508,760650,761157,GTACATCCTTATAATCCATCAGTGGAATAGCATGATAATTCACCCATGCAGCATAACTTGGTGAGCCATAGCAGATCTTTCCCCATGACAATATTAACAACATTAATGCCATGACAAGCGCCTCTCAACTGGCCACAGGAGCAGTTTACCCGGTATTCATCTCTGAATTTTACCATCAAATTATGCTTATGCTCAATGGTTGGCTCCTCCTCTTTAGTGGAAAGTTCTTCAAGTAAAATACATTCCTTTTGCATATCAAAATGGACAAAACCATCATTTACCAGGCATTGTGTCTTGTCTTTATCACCAGTCCACGTTTTTTTCGGTGTTTTTTATTTTAATTTTTGTGTATTTTCTGGCCTTTGTTTTGTGGCTATTATAATTTTCAGTCTTAAAGTGAAATTGATAGAATATCTATGCTGCTTCAGTTAAGGCCTTACATTGCCAGCCTTAAAATCTTAGCTATGGGTAAAAAATGTGACACTAACTCTATTTGATATCTTTGAAG
>TTN-216,,0,249,761158,761406,GTACATGAACTTGCAATGTTGCAATATTTTTATTTCACATTTGCATATGGGTAAAAATTAATTGGTTTAATTCTGTACTCTTTGGGATGCAACTCTTTAGAGAAAATTAAATATTTTATTTTAAAAATAAAATGCTTCTTGGAATACCTTTGTCATACTTTTATTACCTTATCTTAATCTTTTGAAACTATGCTTGGAATCAGTATTTTTATGTCGTATAAAATTTTTCTCTAAATCATTTCGTTAAAG
>TTN-216,,0,205,761407,761611,GTACATAATTTCATCACTTAGAGTACTTGGGGGAAAAAACTCACATCTATGTATACTCACATACAAATTTCCCCATTACATTGTACATTTTTAAAGTGTCTATCTGGTTAGAAATATGTCAGATATTTTGTGATTCTTTTTCATATCTATTGCTCTAAGACATTTTAAAAGAACATATTCCTAAATATAAATAATATCTTTAAAG
>TTN-216,,0,207,761612,761818,GTACATTAATCTGTAACAGAGCCATGGTAAAAGACAAAACTAACTGGTGTTATACAGCCTTACTAATTATAATTAATGCTTAGTATTTATGTTGATAATAATTGATGCTTTGTGATCACAGAATATTTGCCTTTCATAAGCTTCTTCATTGTTGTGAATATTTTACATAAAAGTGATGTTTGTACCCTTGAATAAATATCTTTAAAG
>TTN-216,,0,333,761819,762151,GTATAGCAGCTCTTCTTGGAATCATCAAGGCCTCTTTTGTGTTGAATTCTGCTTTCCCATCCTTTTGTTCATCTCCAGTTTTATCTATAATCCTTTACCCTCTGTGATTGACCACCTAAATCTTAGAAAACATTCCAGACATGTGTGTTCTTATTGTGTATCTGCCTTGTGTATCTGTCTATTGTAAATTATCTAAATGTCTTTTCAAATCACATATTATGTTTACATGTTTGTGGTCTTATCCTCACGTGTCTCTTTCATATATATATATATATATATATATATGACCATGTATATGTGGTTTTTAATGCCTTCAAATGAAATGTTTTTAAG
>TTN-216,,0,1205,762152,763356,GTACACCTCCCCAAAGTGAATACACATTGTTCACCCATAGCTTGGTCACATAAATTATGATGAAACTGGGTTTTAGGAAAATTATATTTACAAAATGGATAATCACACAGTTACATATTTACTTCTAACGATGTTCAGGAACACTGATATCTACTTTTTTCACTGATACAAAGCAGTATTCAAGAACAAAGATGAAAGGAAGCATTGTCCCAGAACTGATACAAAAGTTCTGATTTCATATCATTTGATTAAACATCATAGTTTTCATGGAGATATATTTAAATATATATGAATAAGTATACTATATATTTAAATGTATTGAAAACTATTATGAATAAATATTCTTAAATTTCTTCCTTCAACCATTTATATTAAATGCCTTTTTAACACCAGGCTAAAAAGAAAAAAAGATGAATGTATTTATCAAAACACAGAATAATAGTTATGTCTTCTAATACATATATATAAAGGGCAGCCCAACAGGTTTTGATTTTAGCGTTGACTTTACACCTTGTTGTATTACTCTCAGCGAGTCCTTTAACCAACCTGAGCCTGAAGTTATTTTCCTGTAAATTGGGGATGCTAATATCAGTCTTAATGGGCTCAGCTATTATGGTGAGAATTAAATAAAGTAAGGTATTAAAGTAGTCTATCATTGAATGAATAGTATCCAGATTTAACATATTCAATCAGCTCATAGTACAGGACAGAATTAATATATTTGTGCTTTAAAGCTCAATAATATTTTCTACAAAAGATGCTGGCATGGCTGCTTAAAATCAGCATAACCCTCGCATCAGGCCATATAGTTATATAATCAAATGAAATAGTAAAGCTGATCTTTTATTGGATATCAACGATTCAGAAATACTTTCTAGACAATAAATTACTAGTGAAATTTAAATGTATGAAATGATATTAGGTTGGTGCAAAAGTAATTGCGGTTTTTAGCATTAAAAGTAATGTCAAAACCGCAATTATTTTTGCACCACCCTAATAGCATCTGTCCTCTGATAATGACATATGCTGCTGGTCCCTTGCTTTACAAATCCCAATTACATTATAATATCTGGGCTCCCAACTAACATGACAGACCTGTCTTGAGCGACTGTTAACACATTGGTCTTTCTGGGTGTGGGGTCTTCTTGGTTTCTCTTTTTTTGTCCTTCAAAATAAATCCTTATCATGAAATGATGTCTTTAAAG
>TTN-216,,0,166,763357,763522,GTATTGCTATTCCGAAGTAAATTAGACTATGCCATTTCCTTCCTTCTCCTATAAAAGTCAAAATGTCCTGTTTCCGTATTTGTTAATACAACTTATATTACTGCTGTGTCTACTTGTCTTTGTGTGTGTGAAACTGAACTTATAAAATAAAATAATATTTTTAAAG
>TTN-216,,0,557,763523,764079,GTACATCATCCCATAACAGGGATATGTTTGCTGCACCGATGTTGAACTGTGGTTCTATCCACACAGGACACTCAACATAAATGTGTGCATTGTATGGTCTGTCATTCACATTCGTCATTTCTGACTCTTTTGCACCCAAGTTTGTGTTGTGTCCATTTTTTCACTTGGTGTTGGTGTGCTTTACATCGTTTCTCTATGTATGTTGTTTCTAAAAAATAAAAATATATCTTTAAAGAGCCAAAAATAACTAAGGAACTAGTCCCTGAAATACCCATTTCTTCATACCCATTTCTTCCTACAAAAAAAAAAAAGACAAAAGAAAAAAGAAATAGAGGCTCCAGCAGTAAAAAGTAGAATTTCTCTTTAATAAACCCTAAATCTTAAACCACAAACCTTTTTATTCTTTTCTCATTAACCGATTCTGTGAAATGTCAATGTTTCATCTTGTGTATGTGCCTTGTGATATTTACTCTCTTATGTTGGAAACTGGAAACGTGGTCTTTATTCTTCTTTGGTTCTTGCATTTTAAGTGTCTAAAATAATCAATGTCTCTCAAG
>TTN-216,,0,629,764080,764708,GTAGATAACTTTCTAAGAAAATAACATTTCAAAGTCATCCTTGTCTTATTATTGTCTAATATTTGAAGTAGGTAAATGTAAAATTTACCCCAGGAAATCAACATATTCAGATTCTAAAATAAATTATTATTAACCTAATAGAAATTGGGCAGGCAAATTAATATTATTTGAATCTCTTTGCATGTTCAGCCTGTTTGTCTGTTTGCTATTTGTTTTATTTTAATTAGAATTCATGAAGGGAAACTGTATTTGCTGTGGGAAATTTTTCATCAAATGACTTAGTAGGCAACTGTAAAATAAGCTTATCCAAGAGAAATTCCAGTTAAGCCTGAGTAACTGGTGCAGAAAATCTGATTTCTACCCCAAGTGGCTGTTTGACTTCAAACAAGTCTTTCATTAAAAAAAAAACAATAATAATTTTTTTATTATTATAAATTATCTGAAGTCCTTTCCAGTTCACAAATGCTGGGATATGCCTAACATATTTTGAAGACCCAGTAGAGATTTTTTAAGGACTAGTGAGTTTACACAAGCGTTTCGAAGGCTGAGCAGTTTTCAGATATTATCACTGTAGTCTAATATTCAAAATAATTATAAAAATAATTTACAAAATAATAATCTTTTTAAAG
>TTN-216,,0,603,764709,765311,GTATAACCGCTTTTAAGGATTGAACATTTAAAATTCCTGGTGTTCCAAATCTTTCTCAGTAGCTAAATCTAAGATTCACCAGTATGCTTTTCTTATATCGTATCCATGATAAAGTGAAGATTAATTATTCCTGGCACCTGAATCTATGTGTCCTTTTTTTACCCTAAATTTTTCTACAACATCTGCAATACAACTAAGAATGAGAGATTACTATTTTGTTATTGGCGATTGAATTTTTTTCTGACCAGGCCCTACTATAATAGTTTCTCCTAGATTTCAATCCTTAATTTTGTTTTTAATATTAATATGGGGGGAATCTATTTCTCTGGTGAAAGTGTTCATTTTTTAAGAAAAATCTTTAATTTACTATTCCTGAAGAGTGTGATAATATTTTGCATAATTGGTATTACATTTGCTTATAGGATTTCTAAGTAATATCCTTTACACCTCTAGGGTTCCTACTCCACATTTATTATTACCATTTAGGTTGCTAATATCTTTTAAAAATAAGTCAATGTTTTGTGATATTTATTTATTGGTATATGGGTGGTGTTCTGCTCATCACATGCCACTTTTCAAAATGTTCATAAAATTTCTTTTAAG
>TTN-216,,0,929,765312,766240,GTATATCAAATCCTCATTATTAATATCTTTAACTTCCCATTAATTTTCTTTCTTAAAAGCAACATTTTCTTTTTTGACTGCCTTCTTATAATCATTTAGATAGTGAACTGATTAAGGACCAGTAAAAATATAACTCATTCCATTTCTTTAATCTTTTCTAGGATGTTAACGAATAATTGTGTGCATGTGTTTACGTATGAATTATTCTAGAAGCTTCTTAACTGAGAATTTTAATATATTAGTATGTCTCTATATACTTATACACATAGCAATGGATCCCTCTTCCCCACATTTTAGATTTTATTCCATAAGTGGAACGGAGTTTTCTTCTGTGTTATAATAATTATTTTACTATATTTATTATTTTATGGAACAAACCTAATGCTTGGATAATAACTATTTTAAAGAGCCTCACGTCCCTTTTGTAATGTTTAGCCCAAGCATTCAAGGTTATTACAAAATGTCTACTTTTCCCTGCTTCCTAATTCACTTAATGCTTCAGACAGTGCTCTTAAGCAGTTAGATTATGCTGTCCCTGTCATAGTAGACTCCTCAGCTAATAGAAGAGTGCACAGCAGAAAGTGAGGCCAGTGTCAGGGCTTAAATACTCTACAATGGTAATCACTTCAAAAAAGTCTTCATCAAGTTAAAAATAGTAAAAGTGAGTCCATATTGGTAATCCCTGTTATTAAAAGAAAAAAAAAAGAATGGCACAGGTACTTTGTGGACATTTCTTCTTCTATAGGAATGTTAGAACAAATGAGTGATTTGAGAAAGTATCTTTATTGCCTCTAAAATGGATGTCCCACAGTACAGAGTGACTTCTGAAAAACTTTAATTATTGTAATGTTGGCGTTGTCTCTGGTGTTTTTATTTCATGTGTGTTATTGAACATTCTCAGCTAACTAAAACACCTAATATCTTTAAAG
>TTN-216,,0,153,766241,766393,GTACATCTTCTCTTTTAAACCTGACTTCCTCTTCTGTCTTTTTTCGTTAAGACTTTTATGTTTCATGTCTCTGTGTCTTGATTGTTTTTGATGATTTTTGTCTATGAAAGCTTGCTCTCGACAGTCCTAAATATTAAAACTGTATCTTTAAAG
>TTN-216,,0,139,766394,766532,GTATTTTTGGAAAGATCCTGGATTTTCGTGTATTGTTGCATGCAATCCTTTATTCAGTTTTAAAAATATATATTTTGAATGTACATCTTTATTTCTTCAGTGTTTAAAAAAATAAGTCTTAAAATAGATGCTCTTTCAG
>TTN-216,,0,800,766533,767332,GTATAGGGAATTCTTCAAATACTACAAATTCTTATATCTTGCTCTAACTTTCCTTTGAAAGTAAATTTTGTGTTCAGTTTGGAAGATTAGAAACCCCATGAAATACTTTAAACATGAGTTTAAACTAGTTGACACAAAGATTAATATCTCTTAACCACACGGAGTATAATTTTAGTAGATGATAGTAATATTTGATATCTACTTATCTAAGGAGGTCACTGTATGAATTTGGGGATTATTTTTTAAATCTGACTAAGAATGTTACACAATTGTTACAGGTACCAAAATAACTGACCAGTGTCATTGGTTAAGTGAAAAAGAAACTCCTCAGTTCACTGAGGAATTTACATGTTCAGGCAAAATAATCACTGCTTTAACATTTTAGTCAACTGTTCACAAACTGAGAAATACTTACCAAAAGCTTTTGCCAGTTTATGATACTTTCATTAGAGAAACAACATTAAGGAAGTGAAGTATTGTTAATGGCACCTGTATTCTAGCATACTGTGAAGACAAGCCATAGCACAAATAAGTTATCTGCAATACCACTCTAGATCTTGCACAAATTAACAATATATGTGTAATATGAAGGAATGTGTGTGTGTGTGTGTTTAGCATATATAGCAAATTACAATATACATGATATTTAGCAAATCAAATCTCTTTTGGAAATAAGTGTGTTATAAATTAAAAAAATATAGATAAAGAATTTTGTGACCCCTCATTGTACTAACGTTAGTAGTAGTGCTCCAAAATACTTCAAGAGTTCATTCTAAACCAAAATACTAATATCTTTGAAG
>TTN-216,,0,794,767333,768126,GTATCTTCTTTGTGAAAAATTACTACTTAACTTTACATACAATAGCACCTTGGTTGCTTTATAAGCACAAGTTTGCATTCCACTTGATGTCTTTCTTCTGTATTTCTTGTTTCTGACATGTCTAAAACAAACTAATATCTTTAAAGCAGCTGAGGGTCCAAGGGAAGTTCTACCAAAAAAAGACAGTCACTGTTGTTATACCTAAAACAACCAAAGCAAATATCTCTAGTAACCAAATAGTGAGCCCAAATTTCCTCCTTTGGTGCTATTTGGTTATATATTCACTAACATGCTTACTGATAAACACATGTTTTTCTATTTATTATTAATTATATTAACCTGGCAAATATAAATACATAGTGAATATGTGTTTAATGTTCTTGCTTTGTTCATTTTTGCAAATCTCTTAAATTTCACAATAGAAATAAAAACAGTATCTAATAAATAATATAAACTTATTTCTTTAAAGTCTCTGAAGCATGTGCGTAAGTTATCACTGAAGAGAAGGTAGCAACTCTTCCACAAAAACAAACAGTAATAGCACCAGCTGAAGGTGTACTGTTAATTTTTCTTCTCAAGTTCTTACCATTCTAACATGGGAAATTTCCCTGGATTTTTGTTATTATATATTTTTTAAATTCAATGCATTTGAAATACTGTAATGTATTTGATAAAGTGTTGTCTGCATTTTATATTGTTGCTGTGTTCTGTTCTGTGTTTATATCTCTCATGCTCTGCTTGTTAAAAAATTGTATATTTAAAAATAAAAGAAATTATTACTATTATCTTTAAAG
>TTN-216,,0,542,768127,768668,GTAACTGGCTTTTCTCATTCATCATTAATATAAAATCCTTTTTTATTCACTTACTATGTAAGAGAGACCTTTCTCTTCTCAATGCCACAAGATGGCTATGAATGACATAAACTTCAATTTATGTTCTATAACATAATCCTGCCTTTTGAGGCAATGTTTTAGGCGTAAAGACATAAGCCCAAAGTTATCATTTGTATTGATCCTCTTATTTAATAACTAAATAATATTGATCCCTCAACTTCTCTTTCAAAAATAATTCATTTTGGAAGCTCTTCTGAAGTAGCTCTGGAAAAAAAAAAGTGTGCTCTAAATGGCAATAGAAAATGATACTATCTCCAAAGAGCAAAGTGTTTCTGATATAATGAATCAAGAACTCATCGACAAAGCAATTCAGAGAAATGCAATGACTACATTTGACTTATAGTTGACTTATAATTGAGGGGTTTTTGGCGTTCATCTTGTTAGATGCCCCTTCTAGGCTTGCTATGTTTACACCCAACTATAATGTTCTGAAAAAATAAGATAAATAAATATCTTTAAAG
>TTN-216,,0,144,768669,768812,GTATACAGTGATGCTAATCAGAACATGAAATAATTCTTGGTTTAGTTTTTCATGGTTTAAAGTGAATGTGTGTGACATTAAATCCTTGTATTTCGTATCTTATATTTGTTATCTGTAACAATTAATATACTAATATCTTTAAAG
>TTN-216,,0,1651,768813,770463,GTGAGTGTAGAAAAATTAGTGGTTCTTTTTCGTTTCATTTATGTCCTTAAATTCACTATGTTTGTCTTTTTAGCTTTGAAAAGTAAATATACTAAACTCTTATAAAAGCCTAACATGCCACAAATATATGACTCAAATAATCTTAGTGTCTATTATCCTCAGACAAGTTATATTTCCTCACCAATTTAAAAAAGAAATACTCTACTTATCAGAGTGTATGATTTCAGAAAAGTCAGTTGTCTTGTTAAATTTTCCTAACCTATTCTGTATACAAGTGTCTTTTGCTTTGAAGCAATTTATTTTCTCAGATCATGAAGTAACTTAACTCCATAATATTTTAATTGGATTTTATAAAATCAAAATGTTTCACCATTATTTTTTTTTTTACTCTTGATAACCATAATTGGAAACATTTTGGCAAAACTGCTCAAAGGACCCTAGGTTTACAAGGCCACTCAAACCTCAAAAGAATTCTCACGACCTTTTTTTTTGGGGGGGGGTTTCATACAAAATTAGGTTTAAATAATTTGAATTATGAAATAATCCAAATAGTAAAATATTGTGAATAGAATACTGTTCAACAACCTGAATAGTAAAAGTGACAGTAGTCAAAATATTCTTCCTTTTTTTTTTTTTTTTGAGATGGAATCTCACTCTGCTGCACCCAGGCTGCAGTGCAGTGGCACGATCTTGGCTCACTGCAACCTCCGTCTCCTGGGTTCAAGCTATTCTCCTGCCCCAGCCTCCCGAGTGGCTGGGATTACAGGTGCCTACCACCAGGCCCGGCTAATTTTGTGTATTTTTAGTAGAGACAGGGTTTTACCATGTTGGTCAGGCTGGTCTCAAACTCCTGACCTCAGGTGACCCGCCCACCTCAGCCTCCCAAAGTGCTGGGATTACAGGCATGAGCCACTACACCAGACCCGCTTCCATTTTTTTTAATCTAAAAAATTTCCTGTTGAAACTCAACTTTCTTGTTGTTCATCCTGTTATACTAAGTTGGGATAAAATAATATAATCACTTCCTCCTTTGAATATCCTTTCTATTCTTGACTTTAGTTATTGTTTTCAGACAGTTTTTCTTTCTAAAGGCTGGAGAAATTTTTGTTGTCTTTATTTGCCTTATTTTCTAAGTATTTAATTTTTTTAATTTTCTGCCTCCAAACCCTAAATGGCTTTTACATTCATATTAAACTGTGAAACCATATATTAGATGTGATTTGAAAATATAGATAATGAGGCTTCTAGAAAGGGAAAAGACTTACATGAATTTCTAGTAGGTCAAATATCGGAGAATTCTCAATGTGCAATTCAGCATCTTCCCTGTTCTTTATAGACAAATCCATTAAAAATAAGACCAATAGGACAATTTTACCAATAACTTTCTTAAGGCAAAATGAAGAATTATATAGTCCTTGCCTGAACAATTCCTCCATTTTATTATCATCATCATAGAGAAATGCTTAGAGTCTTACATCATGAAACTGGGAGTGAGGCTATCCCCAGCCAATGCATTCTAGCCACTAATTTGCCTCTATGTGCTACTATTAATTTTGGTGATGAATGTGGTATTATATATTATATTTTTCTTAATACACTTCTTTATCCACCTTGAAACATCCTAATTATTTAAATACTAATATCTTTAAAG
>TTN-216,,0,112,770464,770575,GTATATAACACCAATGATCCACTCTGAAGAAAAATTATTTTTTGGCCCCTTTTAAAAAGCTCAATATTTTTCTTCACCATTTATAAATATAACTATACTCATATCTTTTAAG
>TTN-216,,0,122,770576,770697,GTATATTTCAAATACATCAAACCCAGATGAGTATCTTTAGCTTTATGACTCAAACATTGCATGCTTTTTATAATTTACTGTTTTTACAACTTTTAAATGTAAACCTACTAATATCTTTAAAG
>TTN-216,,0,334,770698,771031,GTATAATTCTCTAGTTAGGAAAATCTAAAGAAGAAAATATACTGTCTTCAGTCTGCAAAATATTTAATGTTTAATATACATTCTCACAACCTCTAATGTTAAAATACTGTGTTTAAAGGATCTGATATACCCACAACAAAGAATGACCTATGACTTGCCCCCAAGAAAGTCAAGTCCCACACATATAATATACAAAGATAAAATATTAGAACAAAAATAACATTTCTAACATAAAGATATCTGAAATGATATTAACATATCTAACTTTCTTAGTATGTCATGTCTTTATGCCTTTGCCTTTTCTCAATTAAAAAAAATACTAATATCTTTAAAG
>TTN-216,,0,1032,771032,772063,GTACAAGTTGGAAGAAAGTCACCTTTTTAATCTCATGTTTGCAGTTGTACTTAACACATGTAAAAATACTAATATCTTTTAAGCCAAAGTGGCTACAGTGGAAATCATTTCAGAGATGGATCCCCCAAGTAGAAGCTCAACCAAATGTATTCATGTCCCAGTGAGTCACTCAAGAGACAACAGAGGGAAAAAATACCTTTAGCTTATACACATGAAAGATAGTTGAGTCAGTGTATTTTTATGAGGACTCCAAAGAAAATATATATACACATATTATGATCAAAACATGTCTTAAAGAAAATATTAATTCAGTGTGAAGCTGATCTGTAATATCTCTACAAGATTAGAGCACCTGAGACCCTCCCAGAATATCCTCCAACCTAGGGAAAAATAATTCCAGTTAAAGCTGGAAATCTCCCCTCCATGTTCATTTGCTCCTCTCATAGCCTATCTTTTATTTTTCAAGCATCATTTTTTTTCATTTTGAATATCTTTAGATAAGTCAAAACATGAAAAAGCTTTAAAACCTCCAGAACAATAATTTCATCATAACACCCATGGTATTCTGTAATTTGAAGAATATCTGAATATTTTGATATTTTTTCTCAGTCTGGAATCTTTTGGTTGTTCTCCTCTCTCCTAAACTTGAAAAACACTCACCTTTTTAAGGTGCCTGAGGTGTGAATACAAAAAAATGCCGACCTAGATTTTTCGAAGTGGCTGTAATTTGTTTTTCTCAACATAATAGCTAGAGGTATAGCATTAATTATAATCAATGTTTCCACTTTCCATGATCTAGTTTTCTATGCATCTACCATTCCAAGAAATAAAATTACTAATACTGATAGTGCCTGAGGTGACCAAGAAAACAGCCGCTTATAACCAAATACTCACACTGCTACAAAAGATCCGATTCTGGGGGCGGGGAGTGGGAGAAGGTTCCCATCTGGAATGTTCTGTATGTGCAGTTAAGATGGGAACTCTTTACTCCTCTTCATAACTCCAAAGTACAATGCATTCATATCTTTAAAG
>TTN-216,,0,247,772064,772310,GTATCGTTCATCCTGCCATTCCTTCCTTCATTTATTAGAGTGCTTAGCATGTACAGGGTGCTAGGGAACTGGAGAATAATAAACAAAGACAATTAATATGTGGTTCCTCTCCTCAAGATTGTATACCTCCTCAGATTCTTTAAAGGAATCATCTTTTTAGCCATAAATATCACTTTGGTTCAGCTCATTTAATTAATGTCTCCACTGATCCTTTTAACCTCTAACCATAATACTAATATCTTCAAAG
>TTN-216,,0,450,772311,772760,GTACGTTACCTCTGAACAAATGTGGAAGAAGAAATTATCTGTCCTCTGCTCTTAAAACTATGGTTTCTTCCTAATACTCTTCATAAATTCTAAATATAAACATACTAATATCTTTTAAGTGTCTGAGGTTCCACAGGAAGTTTCCTCTAAAAAGAAATTATTTATGGCTGTTTCTGCCAAAACAGAAAACACTCCTGCTGGAAGTATTCATTCAACAAATCCTTTATAATGAGAGTGTAGAGTGTCGCGAGAGCTCTGTGAGGTTCTGGAGGAGGGGGAGCACCTCCTCTCAAGGATCCACTAACCCCTTAAAAGACTTAGCCTATTGGTGGAACAAAGGGAGGATGGAGGAAAGAGAAGAAAATGTGGTTATATTTCCTAACTTATTGTGGTTACTGTTTTCCATTAATCATTTTAACTCTTAAATGTGAATTGCTAATATCTTTCAAG
>TTN-216,,0,114,772761,772874,GTACAAGTCACCATGCTCTCAGGGTCAAGAACTAGCTCTTGTAGTTTTGAGAATATTTTTGCTATTCCTAGTTATCTGCATAACACTAAACATAAAACTACTAATTTCTTAAAG
>TTN-216,,0,116,772875,772990,GTATATCTTGCTGGAAGCTTAGAGGGGTGGGAACATGTCTTTTCTTGTATAAATGTTTTTCCTGATTGTGTTGATTCTTGTAACTTCTAAATGTAAAATTATTAATATCTTCAAAG
>TTN-216,,0,361,772991,773351,GTACATTCTTAACTGTCTTTTTATGGTGGGATAGTGGGTGGGGCGATAGAAAGGACCACCTTTCTAGTTTTGAAAATTATTTTGATGTGTACATGTGAATCATGTCTGTGTTGACTCTTGCAACTCAAGTGTAAATGTATTAATATCTTCAAACTGCCTGAAGCTCCCAAAGAAATGGCTACCAAAAAGAAAATACCGGAAGTTCCTCCTCTAAAACCTGAAACACCACCTATTATGGGAACTTGTTACCACTGATCTCAGCTCAGGAGAAAAAAATAGCTCTTTTGTTCTTGAAAATGTCTTTGTATCTATCTAGTAATCTCTGTATTTTCTGAGTGTAAAAATACTAATATCTTTCAAG
>TTN-216,,0,112,773352,773463,GTATTTGTCACTGACTTTAGGCTTCAGAAGACCTAATTCTTCTGCTCTTGACAATATTTTTTTCTAGCGGTCTTCATAACACCTAAATGTAATTTCACTAATATCTTTCAAG
>TTN-216,,0,108,773464,773571,GTAGTTGCCACTGACCTTAGGCTTCAGATCTCATTCTTTTGCTCTTGAAGATATTTTTTCCAGTGGTCTTCATAACTTCTGAATGTAATTTTGCTAATATCTTTTAAG
>TTN-216,,0,110,773572,773681,GTATTTGTCACTGATTTTAGGCTTCAGATGATGTATCTCTTCTGCTCTGGAAAATATTTTTCTAGTGGTCTTCATAATGCCTAAATGTAATTTCACTAATATCTTTCAAG
>TTN-216,,0,83,773682,773764,GTAGACACCCTCTTGTTGCTGTGTTTGATATTGTTTGTTTGTCTTTACTTTGTCTAATAATGAAAATACTAATATCTTTAAAG
>TTN-216,,0,210,773765,773974,GTAATGCCAAAGCTATACAAACTATAGGAGAAAAATAACTGTTATTTTAACTAGGAAATTACATGTTAAAAATCCTACTACATAAAGATGATATAATTCTAAAGAAAACAAATGTCAATCGCTATCCAAAATATCTTGGTGGGTGTTTATATGCAAAAGGCATCCATCATTTTCACCTTTTCTAAACACAAATTACAAATATCTTTGAAG
>TTN-216,,0,153,773975,774127,GTAGGTATCATTACACATTGTCAGTCGGGGGGCCCTGGGGAAAGACTGCATAGAAGTGTCCGCCGATCTCACAAGTTGTATTTGCTTGGGTAAATGTGGAGTCGATATTCCCCCTTTATAGCTTCTAACTAAAAGATACTAATATCTTCAAAG
>TTN-216,,0,112,774128,774239,GTATTTATTCCCTCTCCTCTGCTAAGAAAAACTTATCGTCTGTACCCCTCACAATCACTGTAATATATACCTTCACCATTCATAAATTATAAAAATACTAATATCTTTCAAG
>TTN-216,,0,114,774240,774353,GTACATGTCAGCTCAACCTTATCCTGCAGAAGAAATCTCTCTTCCATTCCTGAAAACAATTTTAGTCCATTCCTCTTCATTAACCTAAGTATAAAACTACTAATATCTTTCAAG
>TTN-216,,0,115,774354,774468,GTACACTTTAGCCCTGACTTCATTCTGCAGAAGAGATATCTCCTCTCCTACTGTAAACAATTTTAGCCCATTTCTCTTCATTAACTTAAGTCTAAAACTACTAATATCTTTCAAG
>TTN-216,,0,113,774469,774581,GTATTTTTTACCCCTGTCCTTTTTCTGCAGAAGAAATATCTCTTCTGATCTTAGAAATATTTTACTCCATTTGTCTCATTAACCTAAGTGAAAAACTACTAATATCTTTCAAG
>TTN-216,,0,105,774582,774686,GTACTTGTCATTTGACCTTAAGCTTCAGAAGATCCAATTCCTCTGCTGTATATTTTGCTAGTAGTCTCCATAGCTCCACATGTAACTTTACTAATATCTTTTAAG
>TTN-216,,0,2503,774687,777189,GTATTTGTCACTGATTTTAGGCTTCAGATGATCTATCTCTTGTGCTCTGGAAAATATTTTTCTTTTTATATATATATATATTTTTATTATACTTTAAGTTCTAGGGTACATGTGCACAACGTGCAGGTTGTTACGTATGTATACATGTGCCATGTTGGTGTGCTGCACCCACTAACTCGTCATTTACATTAGGTATGTCTCCTAATGCTATCCCTCCCCCATCCCCCCACCTCACAACACACTCCGGTGTGTGGTGTCCCCCTTCCTGTATCCATGTGTTCTCATTGTTCAATTCCCACCTATGAATGAGAACATGCAATGTTTGGTTTTTTATCCTTGTGATAGTTTGCCAAGAATGATGGTTTCCAGTTTCATCCATGTCCCTACAAAGGACATGAACTCATCATTTTTTATGGCTGCATAGTATTCCATGGAGTATATGTGGAACATTTTCTTAATCCAGTCTATCATTGATGGACATTTGGGTTGGTTCCAAGTCTTTGCTAATATGAATAGTGCCGCAATAAACATACGTGTGCACGTGTCTTTATAGCAGCATGATTTATAATCCTTTGGGTATATACCCAGTAATGGGATGGCTGGGTCAAATGGTATTTCTAGTTCTAGATCCCTGAGGAATCGCCACACTGACTTCCACAATGGTTGAACTAGTTTACAGTCCCAGCAACATTGTAAAAGTGTTCCTATTGCTCCACATCCTCTCCAGCGCCTGTCGTTTCCTGACTTTTTAATGATCACCATTCTAACTGGTGTGAGATGGTATCTCATTGTGGTTTTGATTTGCATTTCTCTGATGGCCAGTGATGATGAGCATTTTTTCTTGTGTATTTTGGCTGCATAAATGTCTTTTTTTGAGAAGTGTCTGTTTGTATCCTTCGCCCACTTGTTGATGGGGTTGTTTTTTTCTTACACGTTTGTTTGAGTTCATTGTAGATTCTGGATATTAGCCCTTCGTCAGATGAGTAGATTGCAAAAATTTTCTCCCATTCTGTGGGTTGCCTGTTCATTCTGATGGTAGTTTCCTTTGCTGTGCAGAAGCTCTTTAGTTTAATTCGATCCTATCTGTCAATTTTGGCTTTTGTTACCATTGCTTTTGGTATTTTAGACATGAAGTCCTTGCCCATGCCTATGTCCTGAATGGTATTGCCTAGGTTTTCTTCTAGGGTTTTTATGGTTTTAGGTCTAACATTTAAGTCTTTACTCCATCTTGAATTAATTTTTGTGTAAGGTGTAAGGAAGGGATCCAATTTCAGCTTTCTACATATGGCTAGCCAGTTTTCCCAGCACCATTTGCTAAATAGGGAACCCTTTCCCCATTTCTTGTTTTTGTCAGGTTTGTCAAAGATCAGATGGTTGCAGATGTGTGGTATTATTCTGAGGGCTCTGTTCTGTTCCATTGGTCTATATCTCTGTTTTGGTACCAGTACCATGCTGTTTTGGTTACTGTAGCCTTGTAATACAGTAGCGTGACGCCTCCAGCTTTGTTCTTTTGGCTTAGGATTGACTTGGCAATGTGGGCTCTTTTTTGGTTCCATATGAACTTTAAAGTAGTTTTTTCCAATTCTGTGAAGAGAGTCATTGATAGCTTGACGGAGATGGCATTGAATCTATAAATTACCTTGGGCAGTATGGCCATTTTCACGGTATTAGTTCTTCCTATCCATGAGCATGGAATGTTCTTCCATTTGTGTCCTCTTTTATTTCGTTGAGCAGTGGTTTGTAGTTCTCCTTGAAGAGGTCCTTCACATCCCTTGTAAGTTGGATTCCTAGGTATTTTATTCTCTTTGAAGCAACTGTGAATGGGAGGTCACTCACGATTTGGCTCTCTGTTTGTCTGTTATTGGTGCATAAGAATGCTTGTGATCTTTGCACATTGATTTTGTATCCTGAGACTTTGCTGAAGTTGCTTATCAGCTTAAGGAGATTTTGGGCTGAGACGATGGGGTTTTCTAGATATACAATCATGCCATCTGCAAACAGGGACAATTTGACTTCCTCTTTTCCTTATTGAATACCCTTTATTTCTTTCTCCTGCCTGATTGCCCTGGCCAGAACTTCCAACACTATGTTGAATAGGAGTGGTGAGAGAGGGCATCCCTGTCTTGTGCCAGTTTTCAAAGGGAATGCTTCCAGTTTTTGCCCATTCAGTATGATACTGGCTGTGGGTTTGTCATAAATAGCTCTTATTATTTTGAGATACGTCCCATCAATACCTAATTTATTGAGAGTCTTTAGCATGAAGGGCTGTTGAATTTTGTCAAAGGCCCTTTCTGCATCTATTGAGATAATCATGTGGTTTTTGTCGTTGGTTCTGTTTATATGATGGATTACGTTTATTGATTTTTGTATGTTGAATCAGCCTTCCATCCCAGGGATGAAGCCCACTTGATCATGGTGGATAAGCTTTTTGATGTGCTGCTGGAAAATATTTTTCTAGTGGTCTTCATAATGCCTAAATGTAATTTCACTAATATCTTTCAAG
>TTN-216,,0,83,777190,777272,GTAGACACCCTCTTGTTGCTGTGTTTGATATTGTTTGTTTGTCTTTACTTTGTCTAATAATGAAAATACTAATATCTTTAAAG
>TTN-216,,0,210,777273,777482,GTAATGCCAAAGCTATACAAACTATAGGAGAAAAATAACTGTTATTTTAACTAGGAAATTACATGTTAAAAATCCTACTACATAAAGATGATATAATTCTAAAGAAAACAAATGTCAATCACTATCCAAAATATCTTGGTGGGTGTTTATATGCAAAAGGCATCCATCGTTTTCACCTTTTCTAAACACAAATTACAAATATCTTTGAAG
>TTN-216,,0,153,777483,777635,GTAGGTATCATTACACATTGTCAGTCGGGGGGCCCTGGGGAAAGACTGTATAGAAGTGTCCGCCGATCTCACAAGTTGTATTTGCTTGGGTAAATGTGGAGTCGATATTCCCCCTTTATAGCTTCTAACTAAAAGATACTAATATCTTCAAAG
>TTN-216,,0,112,777636,777747,GTATTTATTCCCTCTCCTCTGCTAAGAAAAACTTATCGTCTGTACCCCTCACAATCACTGTAATATATACCTTCACCATTCATAAATTATAAAAATACTAATATCTTTCAAG
>TTN-216,,0,114,777748,777861,GTACATGTCAGCTCAACCTTATCCTGCAGAAGAAATCTCTCTTCCATTCCTGAAAACAATTTTAGTCCATTCCTCTTCATTAACCTAAGTATAAAACTACTAATATCTTTCAAG
>TTN-216,,0,115,777862,777976,GTACACTTTAGCCCTGACTTCATTCTGCAGAAGAGATATCTCCTCTCCTACTGTAAACAATTTTAGCCCATTTCTCTTCATTAACTTAAGTCTAAAACTACTAATATCTTTCAAG
>TTN-216,,0,113,777977,778089,GTATTTTTTACCCCTGTCCTTTTTCTGCAGAAGAAATATCTCTTCTGATCTTAGAAATATTTTACTCCATTTGTCTCATTAACCTAAGTGAAAAACTACTAATATCTTTCAAG
>TTN-216,,0,105,778090,778194,GTACTTGTCATTTGACCTTAAGCTTCAGAAGATCCAATTCCTCTGCTGTATATTTTGCTAGTAGTCTCCATAGCTCCACATGTAACTTTACTAATATCTTTTAAG
>TTN-216,,0,2502,778195,780696,GTATTTGTCACTGATTTTAGGCTTCAGATGATCTATCTCTTGTGCTCTGGAAAATATTTTTCTTTTTATATATATATATATTTTTATTATACTTTAAGTTCTAGGGTACATGTGCACAACGTGCAGGTTGTTACGTATGTATACATGTGCCATGTTGGTGTGCTGCACCCACTAACTCGTCATTTACATTAGGTATGTCTCCTAATGCTATCCCTCCCCCATCCCCCCACCTCACAACACACTCCGGTGTGTGGTGTCCCCCTTCCTGTATCCATGTGTTCTCATTGTTCAATTCCCACCTATGAATGAGAACATGCAATGTTTGGTTTTTTATCCTTGTGATAGTTTGCCAAGAATGATGGTTTCCAGTTTCATCCATGTCCCTACAAAGGACATGAACTCATCATTTTTTATGGCTGCATAGTATTCCATGGAGTATATGTGGAACATTTTCTTAATCCAGTCTATCATTGATGGACATTTGGGTTGGTTCCAAGTCTTTGCTAATATGAATAGTGCCGCAATAAACATACGTGTGCACGTGTCTTTATAGCAGCATGATTTATAATCCTTTGGGTATATACCCAGTAATGGGATGGCTGGGTCAAATGGTATTTCTAGTTCTAGATCCCTGAGGAATCGCCACACTGACTTCCACAATGGTTGAACTAGTTTACAGTCCCAGCAACATTGTAAAAGTGTTCCTATTGCTCCACATCCTCTCCAGCGCCTGTCGTTTCCTGACTTTTTAATGATCACCATTCTAACTGGTGTGAGATGGTATCTCATTGTGGTTTTGATTTGCATTTCTCTGATGGCCAGTGATGATGAGCATTTTTTCTTGTGTATTTTGGCTGCATAAATGTCTTTTTTTGAGAAGTGTCTGTTTGTATCCTTCGCCCACTTGTTGATGGGGTTGTTTTTTTCTTACACGTTTGTTTGAGTTCATTGTAGATTCTGGATATTAGCCCTTCGTCAGATGAGTAGATTGCAAAAATTTTCTCCCATTCTGTGGGTTGCCTGTTCATTCTGATGGTAGTACCTTTGCTGTGCAGAAGCTCTTTAGTTTAATTCGATCCTATCTGTCAATTTTGGCTTTTGTTACCATTGCTTTTGGTATTTTAGACATGAAGTCCTTGCCCATGCCTATGTCCTGAATGGTATTGCCTAGGTTTTCTTCTAGGGTTTTTATGGTTTTAGGTCTAACATTTAAGTCTTTACTCCATCTTGAATTAATTTTTGTGTAAGGTGTAAGGAAGGGATCCAATTTCAGCTTTCTACATATGGCTAGCCAGTTTTCCCAGCACCATTTGCTAAATAGGGAACCCTTTCCCCATTTCTTGTTTTTGTCAGGTTTGTCAAAGATCAGATGGTTGCAGATGTGTGGTATTATTCTGAGGGCTCTGTTCTGTTCCATTGGTCTATATCTCTGTTTTGGTACCAGTACCATGCTGTTTTGGTTACTGTAGCCTTGTAATACAGTAGCGTGACGCCTCCAGCTTTGTTCTTTTGGCTTAGGATTGACTTGGCAATGTGGGCTCTTTTTTGGTTCCATATGAACTTTAAAGTAGTTTTTTCCAATTCTGTGAAGAGAGTCATTGATAGCTTGACGGAGATGGCATTGAATCTATAAATTACCTTGGGCAGTATGGCCATTTTCACGGTATTAGTTCTTCCTATCCATGAGCATGGAATGTTCTTCCATTTGTGTCCTCTTTTATTTCGTTGAGCAGTGGTTTGTAGTTCTCCTTGAAGAGGTCCTTCACATCCCTTGTAAGTTGGATTCCTAGGTATTTTATTCTCTTTGAAGCAACTGTGAATGGGAGGTCACTCACGATTTGGCTCTCTGTTTGTCTGTTATTGGTGCATAAGAATGCTTGTGATCTTTGCACATTGATTTTGTATCCTGAGACTTTGCTGAAGTTGCTTATCAGCTTAAGGAGATTTTGGGCTGAGACGATGGGGTTTTCTAGATATACAATCATGCCATCTGCAAACAGGGACAATTTGACTTCCTCTTTTCCTTATTGAATACCCTTTATTTCTTTCTCCTGCCTGATTGCCCTGGCCAGAACTTCCAACACTATGTTGAATAGGAGTGGTGAGAGAGGGCATCCCTGTCTTGTGCCAGTTTTCAAAGGGAATGCTTCCAGTTTTTGCCCATTCAGTATGATACTGGCTGTGGGTTTGTCATAAATAGCTCTTATTATTTTGAGATATGTCCCATCAATACCTAATTTATTGAGAGTCTTTAGCATGAAGGGCTGTTGAATTTTGTCAAAGGCCCTTTCTGCATCTATTGAGATAATCACGTGGTTTTTGTCGTTGGTTCTGTTTATATGATGGATTACGTTTATTGATTTTTGTATGTTGAATCAGCCTTCCATCCCAGGGATGAAGCCCACTTGATCATGGTGGATAAGCTTTTTGATGTGCTGCTGGAAAATATTTTTCTAGTGGTCTTCATAATGCCTAAATGTAATTTCACTAATATCTTTCAAG
>TTN-216,,0,83,780697,780779,GTAGACACCCTCTTGTTGCTGTGTTTGATATTGTTTGTTTGTCTTTACTTTGTCTAATAATGAAAATACTAATATCTTTAAAG
>TTN-216,,0,210,780780,780989,GTAATGCCAAAGCTATACAAACTATAGGAGAAAAATAACTGTTATTTTAACTAGGAAATTACATGTTAAAAATCCTACTACATAAAGATGATATAATTCTAAAGAAAACAAATGTCAATCACTATCCAAAATATCTTGGTGGGTGTTTATATGCAAAAGGCATCCATCATTTTCACCTTTTCTAAACACAAATTACAAATATCTTTGAAG
>TTN-216,,0,153,780990,781142,GTAGGTATCATTACACATTGTCAGTCGGGGGGCCCTGGGGAAAGACTGTATAGAAGTGTCCGCCGATCTCACAAGTTGTATTTGCTTGGGTAAATGTGGAGTCGATATTCCCCCTTTATAGCTTCTAACTAAAAGATACTAATATCTTCAAAG
>TTN-216,,0,112,781143,781254,GTATTTATTCCCTCTCCTCTGCTAAGAATAACTTACTGTCTGTACCCCTCACAATCACTGTAATATATACCTTCGCCATTCATAAATTATAAAAATACTAATATCTTTCAAG
>TTN-216,,0,114,781255,781368,GTACATGTCAGCTCAACCTTATCCTGCAGAAGAAATCTCTCTTCCATTCCTGAAAACAATTTTAGTCCATTCCTCTTCATTAACCTAAGTATAAAACTACTAATATCTTTCAAG
>TTN-216,,0,115,781369,781483,GTACACTTTAGCCCTGACTTCATTCTGCAGAAGAGATATCTCCTCTCCTACTGTAAACAATTTTAGCCCATTTCTCTTCATTAACTTAAGTCTAAAACTACTAATATCTTTCAAG
>TTN-216,,0,113,781484,781596,GTATTTTTTACCCCTGTCCTTTTTCTGCAGAAGAAATATCTCTTCTGATCTTAGAAATATTTTACTCCATTTGTCTCATTAACCTAAGTGAAAAACTACTAATATCTTTCAAG
>TTN-216,,0,105,781597,781701,GTACTTGTCATTTGACCTTAAGCTTCAGAAGATCCAATTCCTCTGCTGTATATTTTGCTAGTAGTCTCCATAGCTCTACATGTAACTTTACTAATATCTTTTAAG
>TTN-216,,0,113,781702,781814,GTATTTGTCACTGACCTTAGGCTTCAGATGATCTAATTCTTTTGCAGTTGAAGACATTTTGTTCCAGTGGTCTTCATAACCCCTAAATGTAATTTTACCTAATATCTTTTAAG
>TTN-216,,0,109,781815,781923,GTATTTGTCACTGGCTTTAGGCTTCAGAAGACTGAACTCTTCATTTCTTGAAAATACTTTTCTAGTGGTCTTCAAACTTCTAAATGTAATTTCACTAATATCTTTTAAG
>TTN-216,,0,111,781924,782034,GTATTTGTCACTGGCTTTAGGCTTCAGAAGATCAAACTCCTCTATTCTTGAAAATATTTTTTCTAGTGGTCTTCATAACCCCTAAATGTAATTTCACTAATATCTTTTAAG
>TTN-216,,0,111,782035,782145,GTATTTGTCATTGAGTTTAAGCGTCAGAAGATCTATCTCTTCTACTCTTGAAAATATTTTTCCTAATGGTCTTCATAACTTCTAAATGTAATTTCACTAATATCTTTTAAG
>TTN-216,,0,110,782146,782255,GTATTTGTCACTGATTTTAGGCTTCAGATGATCAAACTCTTCTGCTCTGGAAAGTATTTTTCTAGTGGTCTTCATAATGCCTAAATGTAATTTCACTATTATCTTTCAAG
>TTN-216,,0,84,782256,782339,GTAGACACCCTCATGGTGCTGTGTTTGATATTGTTTGTTTGTCTTTACTTTGTCTAACAATGAAAATAATAATATCTTTTAAAG
>TTN-216,,0,128,782340,782467,GTAATAATGAAACTATTCAAATTAGTGTTTTTTAAAAAAATCTTTCCTTAGTGTTGTAAAAACATTTTTTTGCAAACTATCTCAGTTTTAGTCAATTCTGGCATTAAAATGAGCTCATGTCTTTAAAG
>TTN-216,,0,134,782468,782601,GTACATGGCAAGAAAGCTGCTAGGACACCTCGGCCACTCTTTCCCCTTCCTGCCCTGATAATTCTGGGTGCTCTGAGCTTTTGTCTTGTTTCTCAATCTTCGTTCTTTCTAAAACATACCTTCTAATTCTTTAG
>TTN-216,,0,129,782602,782730,GTATTCCTCACTGCCACTAACTCCCTAACAAAAAACTTTCTTTGAAGTGTCATATTCTACTGTTCTGCTTCATGATTTTCACATTTCATTGAAACCATGAGCTTAAACAACTACTAATATCTTTTATAG
>TTN-216,,0,132,782731,782862,GTATATGTGGCTGTCCACTGTTTGATGGGGGCGGATGGAGCCCCCAGCTTCTAAAAGGGTTTTGTTCTGTGTAAATGTGATGAATGTTTACTGGTGATTGTTTCTAATGTTAAAATACTAATATATTTGAAG
>TTN-216,,0,408,782863,783270,GTACATGTCACTAATGAGATTCTGCAGAAAAGCACTCACCCTTGTCTAATAAGTCACCTATTATCAAACCTTTTGTTTGCGAGTCCTCTTAAATTTGCAACTACAAAACTGTCATTCTGGATTTTTAGGGTCTGAATACTTTTTAATAATTTTTTCATTGACTTTAAAAAGTGATATATTTACTTATTACAAGCATTGGAAAAGTTTACTAACTTGGTTCTTTTATTCTTAATAGGCCATATTTTCCTCCCCACTATATGAGGGTCCAAAGACAGATCACTGACCTTATTGTGAAATTTGTTCTTGGATCTGTCCCTGGGTTATTTGAGCAAAATGTGAAGTCGATGTGGTATAAATTTAATATACTTCTCAACTACTCATAAGAAAAATGAATTAATATCTTTAAAG
>TTN-216,,0,479,783271,783749,GTACACGTGAGACCGGTGATTAATGACCTTGCCACTTGCGACTATTTCTAATTTAAGCTTTGTTCTTCTTCCTTCCTAACTCATTATTTCTTGGTCATTTTCTAACCTTTAATTATTTGTCTTAATTCATCATTCTAAATTAGCTCCAATCTCAAATCTATTTTGGGTTATTGGTCCACAGTATCTACATAAGTCATAGTAAGCTATATTAAACAAAGCTTCTCCAATGTACATAGAAAGTAAGGCAGGAGAACTAATGATTATAAATGACATTAAACACTAAAAGGGCTTTGCAAGCATTTGAATCAATAGACAAAGAAGTCAGTGCAAATGAGATAGATTTTATCTAAACAAAAATAAGAGAAGGTATCAATTGAAACAAAGGAAGAAATCAAGATTACTATTTATCGTGTTTAGTGTTTGTCCATCTTAGAATATTGTTCCATACATTGAAATAAAATTAACTAATATCTTTAAAG
>TTN-216,,0,269,783750,784018,GTACAAAGCAGAATCCACTGTATGGGAAAATACAGTCATTTCATTTTTCATGTCTATATATCTTCCTTAAGGCAAAATATCAGTCTTGTATCTTGTTGCCTGAAATCTGACTACATTAAGAACAAAAGTTATTTCTACACATAAAACTTTGGACCCACAGAATTTGGTCCCACATATACCAAGAAATATGTGTGGTTTTTAATTCATTCATTAGCATTAAATTTTTCATTGTAATCACCTAATTCTAAAAGAAATTCCTATTATTCAAG
>TTN-216,,0,185,784019,784203,GTACTCATGTTAAAATGAATACTTCATTTTTGTGGTGTCTACAATTTTACACTCTTCTTATTGTGTGTTGTGTTGTATTATATGTTTGTTAACTCTTACCTATATGTTACAGTGTTGAATAAACTTGTATGTATATCTTACATCTCACAACTTTGTATTATTAAATGCTACTGATATCTTTAAAG
>TTN-216,,0,222,784204,784425,GTATTCACTTCATCGTTGGCATCATAAAAAAGAAAGTATTCTGATATCTTAAAGTGGAATCCAATAAGTTGTCCTCATTGTTGTTGCATAACTAAGGACAAAAATTTCCTTATTTTGCTTTCATTAATTTTAATGCTGCTCCAATAAATACAGGTTTTTTATTCTTAATATTTTAAAATGTTTTTAAATACTATTTTTAAAACAAAACTAATATCTTCAAAG
>TTN-216,,0,1783,784426,786208,GTACCTACCATGAAGAAAAAATAGATTTCTCTAACTGCTATTTAAGCATGTTAATAATAGGTCTTAGAGAAAAACATACTGAATGTGAATTTATGTTAAAACCATATTGCACAGAAAAAAGGGAAATAATGAAGGGAAAAAAATGAAACAGACAAGCAGGAGTGAAAAAATGAGTGGGATTCAGTTGTGCTGTGATATATCACATGGCTACAACTAGTAGAAAAGAACCTTCTCTCATTCAATGTGTAAAACAGCTCAATTCAACATATTTTGTTGAATGTTGACCATTAACAAGACATCATATTAGAAAAATTAAGGCCTGATTCTGTCTTCAAATAAGTTAAATCTGGTGAGAGGATAGAAAGATAACAGGACTCTAATACAGACAGGAAGTGATTACACATAGCAAGTGAATACAAAAGGGCTGCAGAAACACACGGCAAGAAAAGATTAAGTTCAGGCAGAGGCATCATGGGAAGCTGTGTTAAACTGAATTTAAATTTTGATGGACTTTTACATGTAGAAATTGAGGAAATAAGGCCGGATGTGGTGGCTCACGCCTGTCATCCCAACACTTGGGGAGGCCAAGGTGGGTGGATCACTTGAGGTCAGGAGTTCAAGACCAGCCTGGCCAACATGGTGAAACCCCGTCTCTACTAAAAATACAAAAATTAGCTGGGGGTGGTGATATGTGCCTGTAATCCCAGCTACTTGGGAGGCTGAGGCAGGAGAATTGCTTGAACCCAGGAGGCAGAGGTTGCAGTGAGCTGAGATAATGCCACTGCACTCCAGCTTGGGTGACAGAGTGAGCCTCTGTCTCAAAAAAATTAAAAAAAAGAAATTGAGGACATGATATCCCATGGAAAGGGAAGAGCATATTGAAAGGCACAGAGATAGAAGGGTCTAGAATGTTCAAGGATTGTCAAGTAAACTTATGTCAAGTAAACTCAATTTGAGTATGGATTGGCTGTGGAATGTCTTGAAAGATAATACCAGATATAAAGATGGGGTCATATTTTGGAGTACTTCAAATGCCAGTAAAAGGCTTGTACTTTTTTCTGTAGGCAATAGGAAGCTTCAAAGATTTTGAAGCAGGCTTACATATTAATAGGATTTGGGCTTTAGAAAGATAACTGGCAGCAATTTCAGCTACTAAATAGTAAAGACCCATTGCAATTATTTAAGGTCTTTAAGAGTTGGACAAGATCCGTGGCGGCAGAAATGGAAAGGGGGACTGGGTTTGAAAGAGATGGAGACTTAGTGGCCTCTGACCATTATCAAAACCATTAGGGAAATTGAGGAGCCCAAGATCATTGTAAGGTTTAAAGCTAGATGGCCAAAAGAATGGTTCATTGGGTCTCTGAACTAACGTTAGAGGAAAATGGTAGATGTGCTTTTCACCTTTAAAGCATAAAAGTTGGGAGTGTGTATCAGGAGCTTAAGAAAGAGATCAGGCCTAGAGATGTAGATCTTAAAGTCATTCACATGTAAATAAGAATTGAGTGTGCAGGAACAATTACTCAGAAAATGTAGAGCAAATTTTTTTAAGTGTCAAAGTTAGACCACCTTCATTTAAGTGTACACAGAGGACTAGAAGCAAATGAAGAAAGCTGAGAAGATTCATATATAAAATTAGGATGTCCAAAATGGTGCCATGTCTCAGAAGCCATTTTCCCCATGAAATCTAAGATGAAGCTCTTGCCCCTGCATTCTTTGCCTGCTCTTTAGACAATCTTGCATGTCTTCTAAATTCTTAATAGTAAACAAAATCATATCTTTAAAG
>TTN-216,,0,236,786209,786444,GTACACGGCTTCTCCATAAATCTTGGAAAGATGACAATTGTCTTCATCCTCTTGCTTTGATTGTAGATGAATCTTACGTATTTGTCTGTCTGTATTGAAGTTATTGATATTTGGGGGGTCATCTGAATAATCTGTTATAGAGTGTTACTTAATGTAACTAGGTTGATATGTTAGAATAGTAGTTGCAGTATTCTGTTCTAAATATAGTCTAAAATAAAATACTATGTTTTTTAAAG
>TTN-216,,0,504,786445,786948,GTATATATATATATATATATATACATTTTTTTAATCTCCTGAAGATTCCTGTTAGAATTACAAAAGCATTTACAGGACAATATTCCTTCTTGAAATTATATACAAGAGCAGTCTAGCATGTTTGACTGCTTTATTTTTGAAATAGTTACACTTCTTTTAAGTTAGAATCTTTAATTTAGTTACTGTTGTTGGTAATTACAATTTCCAAAAGGTACAGTTTACTGAAGCAAAATGGAATAATTGCCTTGGATCCTCAAATGATAACACGGTATCAAATTTTAAAAGTCATCTCATTTGCCATCAATATACATTGAATAATCTAATTAATAGGCAGTTCAAGTAAAAGAACTTTTTCTTATACGTGAATTTTTCTATACATGAATTTGTATGAATTGTATATTTTTATTTTGTGACTGTAATCTTTGCATCAATGTGAAATTTGTATGAGTCTTTTTGAAGAACTTTACATTGCAACCTCATCTCCTTTGTCAACATTCTTTAAAG
>TTN-216,,0,454,786949,787402,GTATTCAATCCAGTGGACTTAAATCTTCTTTATCATATTCTTTCTCTTGAAATGTATATGGTTTATGTTGTTGTACATATGTAGTATGTCTGTTCCCATTTGTATGTAAAGTATTCTTTGTTGTAAATGTGAGCCTCATTCTTAGGTTTCCATGTAACTTGTACTGTTTCTCTCATGTCAACTGTGGCTTGTCTGGATGCTTTGTTTGTTGTTGTTATTGGTGCCTTTGCTGTATTTCTCATCATCTTTGTAAAGGGTTGATATTTTTATGTTTTATGTTCTGTGTTTTATGTTGGATACTGGTATTACGTACCTTAAAAAGTAAACTTTGTACTTCATATATATATATATATATATATATATATATATATATATATATAATTTCTATTAAATATACTACATATCCACATGCTAACATATACATATACTAACACCTCTGAAATACTCTTTCAAG
>TTN-216,,0,1303,787403,788705,GTAAAAAATGCCACTTCCAAAGTTTTATTAGCCTGCTTCAAACTTCTATCCAGCCATCTGAAATGATGCTTGCAAGAAATGTATGACTTTTAGAAGTGTGTACTTTCAGACATGATTGTACTGTGAGATTGCATAGAGCTGTCTCTTCTGCTGCCCCATGGTTCCTGGGTTGCTTGTCATGCCATGCCTGCTGCTGCAAAAGTCAGAAAGTACATTGATAGCGTCATCCGGGATATCTGAATGCAGGCACTGTCCAATTAACTTTCTTTTGTGGAGTGGGGAGAAAGAGTTTTCTGATTTCAAAGCCTGATTGCTATACATATCATTGCGATCTTATGCTTAAGGAATGTATAAGAAATCCTTGCAAGATATTTTTAATATTGCAGTAACACATTTACATAAAAGCCAAAACTTTGTTCTTAAAGAATTGCATGTGCTTTTAAATATATTACAAGTAATATAGTTATGATTTCCAGTAGCTGATATGTGCCTATATATCATGAAAGGAAAGCATATGAATGACTTGTTACAGTTCCCCCATCTCTTTTTTTTTCTTGCAACTTAAAGAAGTGTTCTGTGTGGTTCTCAGGGGAGCTGGAAAGAGTGGTTATGAAGACATTTGGTATCCAGCATTTATTATTAAACTTCCCTTCCCCCTTCTTATATTTTGATTTTTCTATGAATTGACACAATGTTACTTAATTTTAAAAATATCAGTTTCTTTAAAAGCTGAAATAAACTGGCAGAAACATATTATTCTTATTTTAATAAAAAGTTGTCTTGTGACGTCATATGATTCCCCAATCTAAAATTATCTAGATATAATCTTAGATATGCACTTTCCCTATACAGACCTATGTATCTTCAAACCACAGTCTTCCAGCATAAGACATTGCTGCTGGTGATTCTTGCCCTCTACAACCCTCATAGCCATTAGGGGGACCTTCTGGCACCTCTTGAAAGGCCACCCATCTGTTAATTGACACTCCATGAAGACACACACATAAATACATTTCCCTTAATGTAAAATATATGCTTAAAGGAAAATTTCTTCCTCCTGCCAATAACAAAAATTGTCTTCTTTTTCTGCTGGTCTTTAATTAACTACTGAACTTTGGAGTAAAACTGCAGTCTGTTTTCATGGTTCGAATGCTGCTTGTATGTTCTTTGAAGGCTGTTCTTGGCTGTTATTAATGCTTTCTGGTTATAAGCAAAGCTTGGTTTTGATTCTTGGAGTAGAAAGTTAATCACTTGCTTCAGATTAAATATACAAATAACAAAAGTAAAATCATATTCTTTAAAG
>TTN-216,,0,2230,788706,790935,GTATTTCACAGGCTGAAAAATACATACTTATGTAGTACCCCTTTACCTGACTCCTTGCTCTTTCTGCCTCCATCGAATGTTCTGTCTCTCTTTTTCAATGATCAGAGAGTAGTCCCATTCATTTCTTATATTTCTGTGGCTTTTATGGTCCTGGCTCATGAGTGTTGCTTCCTTTGTCTCCCATCCATTTCATACATGTATAGACATGGTCTATCTTTGTCTCATCTACATATGTCTTCTTGCATTTTCCTAAACTTAAAAATAACAAATTTTACTGGTTAGCCAAAATTGATATCAAGAGACATATGAGATTAAAATGCTGAGAGCTAGTAGTAAACTGTTTTGACATTTCACCTGACATAAAAATTTTAGCCAATGTAATAAGCACTAAAAATAAGTCCTATCTTCCTTTTATATTATTAAGGTTATTTGTAGGGATTTCCTTAGGACTTTCATGTCACTCTCTTCTCACTGGCTCTAAGTCATTCTCTGAGGGGTACGGAACTCACATTTCAGAAAAATTTCCTTATTACTGTAGGTAATTTTTCAAAATGTATTTTTCTGTAAACAATATTTTCCCTAATAAGGTCTCATCTAAAATTAGACCCTAAAGAAAACTAAATGAATTATAAGAGTCTAGAAAACATCTATCAAAAATAAACATAATTTTTCTAATGGGTAGTAGTGTTCTGTTCAAGTAATCAACACATTCAGACCTAGAAATTAAGACTGTTTCTGGTCACTCTGAAATTTTGGGGAAAAAAGTCACCCATATAAATATACATTTCCTGATTTCATAAAGAGGCAATTACAAAATAATGTTATCATGGATATTGATCATAAACATTAAAATAGCATATAATCACATATAATGACTTTAAAAATAATAGCTACAATGTTGGGTTCTCAAACATCAATAAGATTTTTAAAATCAAATAATAATATAAAAAATGCACAGATATATTTTCACTATGTTCATTATATCAGTAAAGAAAATCTATATTATGCCTCCTCACTTTACATTAATTAGATGCATGTGCTTCCTTCTGGGTTTGAGCAATAAAAATAGTTATTAAGAAGATTGGTACCTCTAAAATAGTATTGAAGGCCAACACAATTTATCCTGGATAAAATACGTAATGTTTAACTTTAAAATTTTTACTTAAAATATTTGACATTAAAAAAATGATTATTCAAAACGAAATACATATTTGCCTATTGTAGGTTTAAATTTTTGAAATAAGAGTTAAGCAGTTATCTTTATCACATAAAAAACCATTTAATGAATTGCAAATATCTTGTTTAAAGCCCTAAATAGGAAGTTTTATAGAAATATCTAAAAATTCAGATTCCTAATAGCAAATAGTTACACAATACAAATAAATACTGTTTTAAATTAGATTTTAATTGACATTAGTAGAGAGGAAAATGGTTTAATAATCACCACGTGTTCCTTTCTTTCACCATTCAAATCTATGAGGGCCATAATAGCAAAAGAGGCTGCTCTATAAAATAGCATCATCCACCATGCTCAGTATTCACTGTAGACGCAACAGGAAATTTTGAATTCCTTGCGTTCCTTAATTTGAATGAATTTAAGAACATTTTCTTATTCATGAAAAACGAGCTTCCAACACCAGCTTTGAAATTTTATAATTCTATAATTTTAAATATTTTATCCAGCATTATTTCAAAAAGGAAATCTTAAGAAAGGCTACTCTTCTTCTGTTCAGAAAGTGAGATATGGCCCTTCCCCAGCATCAAAGTCACAAACCGGAACTCTTGGCCACCTTCTTCCCTCAGTGGAGAAGACTGAATGATGGCACTAACACTTGCCAGTATCATTTTCATACATTTAGTGGTTGGGTAGATAACATCGTAGATTTGGACAATCTACAATTGCAGTTTGGGACAAAGATGCTGTCAAGAACCCTGTAATTTGATGAAAGATTCATAAAGTCAGTATGGAGCAACATCCTCTACATGCATTTAAAATGAATACATTTGCCTGCAGTTAATGGAGTTGAATTTCATCACAAGGCTGTATAGATATTTGCAGAGGAGATAACTTGAAATGTATCATTTAAACTTAAATTCTGTGGTATTTATATGCAGCGAAAATTGTTACTTAATGCACTACAGTTAACTAGTTTTAGGAGAGACATTTTTCTTGTTGAAATTCCGTTTTTATATAAATTCACTTCAAAATTTGAAATCATATTCTTTTAAG
>TTN-216,,0,921,790936,791856,GTATAGTATTTTTCAACCATTCTGTCAGCGTTAAGTATATTTTAAAAATGAACTTGAAAGCTTACAAAATGTTTCTGTCCTTTGGTTTTCTTTGAATTGGTTCGCTATTTATCAAAATTTGTTTGTAGTTTCATTGAAAATTAAGAAAAATGTCATTTCCAGATCTTTTTTTTTAAAAAAAAAAGACAGAAATTTTGTGAGCATTCACAGTATTTTGAAATTTAAAATGTTAATAGACATAACTAAGTTGATAATATTCTAAACTAACAACAACTATGACTGCCATTTTCATAACCAAATTATGTAGTAAAGTACACTAAACCTATTAAATACCTTACATGAAACTACTTTAGCTTAAATTCAATATTCAGTTTTAAAGTGTGACACAGGATCACCACAACTAATAAATAACATTTTTAAAAAACTGAACATTTCTTTCTGACTAATAAAATATTAAAGAATGAGAAACAAGATAGTCAAATGAAGAATTAAGTTCTAACATTGTCTTCACATAGAATTACTGATTTTTAGGCTACATTTCTTCAGATATCTCTGCTTAAGTAAACTTTCTACTTATTTACATACTCATTAAATCATTAACATTTAATTATTATTATAATTCGTTGCTATTCAAATTATTCATTTTGTGTTGGAGCTGTTTCTCCCACAGACTTGTCTCAGAATAGACCCTCTATCTAGATAGAAACAAAGTAACTTTGAGTGCTATTATAATTGACAACCTTTGATTTTAAAAAAAACAAAACAAAAAACACTTTCGGTGTAAATGCTTACTTTCCAGAGTGCTAGGTAGCATGCTTTTTTTCATTTTCCTTGCTTTGTACATTATTTGCATTTGTCAAGCTTATTCAACATCTTCATTAGTTTGTCTTGGTTTACATATAAACCTTTTTGTCTTTAAAG
>TTN-216,,0,610,791857,792466,GTAGGAATCTCAGTGACAATTTGTAAGATTATCTTTTAACAAAATGGACATTTAACAAAAGGTTTATCTTGTAAACATAAATGAAGTTAGATGTAAACATGGCTTCATATTTCATCTGTGATGTAGTCTCTGTTTTCCATTGTCTGCTTTCTGTTTAAATATTTTTATAGTAATTCCCAAATCCATTCATGTATTTCCCTGCACTTCATTCTTATCATTACTTTGCAACTTAAGTTCTTCCAGTAGAAATGACTGAAATAATCAAGTGGCTATTCATGGGAGGGTGTCAGCAAAGGTTTCATAATCTGGGGGCTTTTAAATGGGTTGGTTTTTATCATTAGCCTATTCTCAAAGGGCAAAATTATTGGGAACTATTATAGAAGTGATTTAGAAGGAGAGAGCTAAGGGGAGTGGAAGATAAGTGGATGGAATAAAAGGAAGAAAAATAAATGGAAGCAGAGTCAAGAAAATAAAATAGAAATTACTTGATAAACTATAAGGTTTTTTAAAAAACCATCCATAGAGTTTTTGAAAAATAAATTGATATTTCAGATGAGGTGCTTCCTAAATATTCAAATATTAACACTGAAAAAATAATCTTATCTTAAAG
>TTN-216,,0,430,792467,792896,GTACAAATCTACTGTCATTCTTAGTTGTCTCTAAAAATGCAAATATGTATCATTTAAAATATCATTACACTGACATCAAGATTTGAACACATGACCTTAATCTGTTAATCACATATGGCTTAATTTTCTTTACCATCTCACTCTCCTATGCAATTGGCTAATGATTACTCAGTTGCTAAATAAGTTACCTGAAAAAAAATTGTATTTATGGGCAATGAGATAAATAACAACATTAAAACCAAGAACATTGCCTTACTATATTTTCCAAATATTTTGTTTAAAATGAAAACTAATCAAATACTTGATTTGATAATTATATGTATATAAATTCTAATATCTTCCAAGATACGTGGGCTTAATTTTAGTTTTGACTTTGTGAAAAACTTCAAAAATCCTGTAATAATCTGCCCTCTACTCTAAATTATTTCAG
>TTN-216,,0,259,792897,793155,GTGAGCAAGCTTATCCTCAATGTCAACAGCATATTCTTTCTGTATTCACACACATAACATGTACTTAATAAAAGATAGTAGGTGAAAGTCAGTATGTATCAAATGATTTCTAACGTCTCAAAATGCTTAATATACTATTCTCTTAAAAACTAGTTATTTGAAGATTTCAAAATTATATCAGAAGAGGCAAATAAGCTACCAAATAAGTTTTTAGGAAGTGACAAATTGATACACTAATGCAATGGACTTCTCTCTACAG
>TTN-216,,0,2279,793156,795434,GTATTTATCCTGTAGCTTTCTTTTTGCTAGTTTGTTTTGGTGACTTAATAAAAGTATTCACACTTGATTAAAATTCAAGCCCTGTTTATGCTGCAACATAGGTATCATTTCAACTTCGGAGGTTTATGGTAAGTTTCTACCTTTTCTTCATGTGATATCCTTTATCCACCTTGTCTCTTGCCCAGTGGGTGAATATTGTGCCTTAACTGGAATGTACGTTCCTGGGTTGCACCATTTCTTTCATATGCTTTGGAGATTAAGTAATGAATATGTTTGGGGCTGATAAAAACTAAGGAGACAGGCAGAGACCCTGTAAGGGTATACATATAAGAATCCCATGAAGCTTCAAATTTCCCTTATACCCTATTGGAACAATTTCTCTTTTTTAAAAAAGTGTGTATATTGGGATAATGTAAAAGTTCTGGAAATGGATAGTGTTGATGGTTGTACAATATTGTGAATGTATTTCATGCAACTGAATTGAATACTTAAAAATGGCTAAAATGGTAAATTTTATGTTAGGTATATTTTACCACAATAAGAAAGAAAAAGAAAAAAGAGACTCCATATTTCAGTCTTTTAATCTGTATAAGGAATTAGATCAATAATAATTTTCTTAAATGTTCTAACTTAATGATATAGGTATCTCAAGTCCAAACTTAAAGCACCTATTAATTGTATATGAACTATTTAGTATAGTTCATCATTTAAGTGATAATTTGAGATATAATTGATCAAAACTGATTTGATGTGTAATTGATAGTCATTGATAAACATACACATCCTGACTATTTGCCCTTTGGCTCACTATCTGGGTGATGAGATCACTCATATCCCAGACCTCAGCATCATGAAATATATCCACATAACAAAACTGCACATGCATCCCATGAGTTTAAAATAAAAGTTGAAATTATTTTTTTAAAAAAGAAACAACAAAACCAAAAATAAAACAAAGTAAATTTAAAGCGGGGGCGGTGGTGGTGGGGTGGGGAGAAGGCATGTATTGATAATTTTCTAAGATGTGAAGAATCTAAGATATTCAATATAATGCCTTGACAATTTGTTCCTATGGAAAAATGATCATCTCCACTGATAAAGCACAAAATAAAAAATTCAGGGTGAATTTAAAAAAAAAAAAAGAGAACTATTTGTTACATTCCACAGTGAGATGTGCATAGGCCCCGGGAATAACATTTAGAAATGTCCATAATAGTTTGACAGAGAAATTTTTTAATTTAATTTTCTGAACCTAATAATAAAAATTGGCTTATATCTTTAATAAATCAATAAATAAAACTATTTGGAAAAATTATATTATTTTAGATTATTAATTCAATAATTAGTCATTTTATATTTGTTTATATATTTTTATATAAATTATTTAGAAATTTTTTTATTTAAAATTATCTCAAAATATTTGGACATTACCATGTTTAATGACATAAAAAAATACACTATATTCTTTTGACTGTAGTTTAATTTTTAATATTTGTGTTATATTTTGTTGCTGATGTTTATGATTTGGGCATATTCTTTTAAACTTTTATAATGTCAACGTAGTACTTTTATTATTCAGAAAAAGGTGATGAACTGCTCTTGTCTAATTAAGTATGTATAAAAATAAAGCTATTCTCAGTTATCCTGGGGGCTGAAGCTAGAGAACTCATTCCACAGTTTATACTGTCCCTGTATTAATAATGGAATCAAACTCTAAATGTCAGAACTCTCTTGCTTCTGCCTTACTTCATTGTCTAAAGGAAATCTTCAAAGAAACTCATGCATGTGTGGTACATGGACTCTTTTTCCTTAGTCTTCCCTGGATTTGTTTGTCTGCCCAATTTAGACATAAAAAGAAAGGCTTTTGGTAACCTCTCAGCCATTTCCCTTTTCCCTACACTGATTTATTGACAAAACCTTATTTCCTTGGTTCACATAATCAGGACTTACATAAACATATAAAATATTTTGCACAGCTAGGCAGGAGCAAAACTTTTCCTCACAAGGCAACAGTAAGCCTTCCAAAAATGGGAAGATAATAAGGCACTTGCTGAAAGAAGTTGTTAATCCTAAATATGTTGGCAGTTTAGCTTGAGCTCTTCAGTCTCAGAATATGCCTTCCTGGAAATGTGATTATCCATAGAAGTCATATAAATGAAACCAATTTCTCTTTATGCGTTAATATTTATAATGGAGCATGACTCACCCTCCATGGTTTACTATTAAACATGAAATAAGTCCGAAAAGTGTTTAAATGCTGAGTTTTATTTTTATTTCAG
>TTN-216,,0,569,795435,796003,GTGAAATTCATTTTTCTAGTACTTGCATTGTAACCTTCCACTCTGAATTTCCAAAGTTCATATTCAAGGGGAAAAAAATTTCAAAATTCATAACAATTTTTATTTTTTCTAATTGATTCTACTAAAACTAGCATGTTTTCTGATATTTCAAATAATACTTTTAGTATTATGCAAGGAGATATATATATATATATATATATATATATATATATATATATATATCCAACTATATTTTAGCATAGTGAATCCCATAAGTTCTTAGCTTCATTTTTCATATGCATGGTATTTATACATGGCAGATAAAATAATTAGACATTAATCTGGCTATTTTATACTTCAGATTAAAACTTGAGAAAAGGGACATTTATTATTCATGGATTCCTTATACCATCTCATTTTCCTGCCTGAAACAAGGCAGTATAAACTCAATTGGCCTTTCAATTGCCTGGTCTTTAGTTTTCTCGTCTTCTAATTGCTTTACGGCTGGTTTTATCCAGCAGGCAGCCAAGTATGAACTTTCTGACTCCTAAGGAGATGCCAAATCAACTTTTTATTTTACTTTGAATTAG
>TTN-216,,0,156,796004,796159,GTAATTTCTAGTCTTCTGAACATAATCTATATTAAACTTTAATGTAACAAACCTTAGTAGCAACTTGCATTGTAGTTTTACAAAACCTCTTATTTCCAAGTTTTATTTCATTGAAAATATTGTATTTATTGAAATATATACTGAAATTCTCCATAG
>TTN-216,,0,247,796160,796406,GTTAGTACTTTCCTGGGAGATTTCGTTCTGCTTATTGTTACACTAAGAAAATGGAAGAAAGGACCTCGTTTCCCAGTATTACAATATCAGAAATCTTGTACCTAAGAGGGGAATAACAATATATCCTACAGTGGATTAATTATGCCCAGTATTGTGAAATTTTTCCTATTCCTGAAATTTACTAAGGAAGCTATGTATATTACTTGTTCAGACCTTAATCATTTTTTCTGATCTTATTTTCATATAG
>TTN-216,,0,135,796407,796541,GTATAAAATCTTACCTTTTATTCAAATTATAAGTTTTGCGTATGTGTAAAGCCAAATAACACACCAAAACACATAAAAGCAAAGCATCGTTGGGTTGTCTAAAGCATTATGTTACTTCATCCCTGACCAATACAG
>TTN-216,,0,315,796542,796856,GTGAGTAATTTCACATTTTAAATTGTTAGTCATATAAAATAACCACATCCAATATTCAGGATCTATATCCTAGATTCGGGTTGCTTTAATAATAATGGAGTTAATGGAGTCTTCTAAAGTCTCCAAGAAGGAAAGAAATTTTACGTATCATTTGGGGACAACTTGAACAATTTGTGTAAAATGTTATGACAGGGAATTCTCTGCTTACTTTTATTAGTAGTAATTTTTAAAACTCTATAGAAATTTGTATCTGAAACACTTCTCCTATAGGGAATTTATCTCTTTCAAATGGTTACTAAAACTATTGTTTTTCAG
>TTN-216,,0,93,796857,796949,GTATGGGGCTTTTAGAATTTGGGGAGGGGTCTCAACTTTATTTCACTTCCCTGTGCATTCTGAAAAGCCTCATTCTTAATGTCTGATTTTCAG
>TTN-216,,0,282,796950,797231,GTAAGCGAGCTAATGAGATCTGTGACATCCCATAAAGGCATGCAAATATATGACTTTAAAGATAGGACGCCAAGTTCTAAAAGCTGTGATAATGCATCACTAATTAACTTTCACAGTGTTACCAAAACAACCCCCCTTAATTTGTTTTTAGTGGAGCTCTATTTGGAAAGATGAATAAATAAGTGCCATGTGAAATGGGTCCCTTTTACTCAGGCAGATTAGAATGGAATCTTTCTGAAGGTGAATTGTGTTTCTGAGGCATTATCTATGCTTGCATTTCAG
>TTN-216,,0,140,797232,797371,GTAAATGTAACCAAGTATAACCAGATAGCCAGTTTCTGAATCATGGGAGTGGGGAGTAATAAAATATTTTGCAACCTTTTACTCTTTAATAAACTTTAATTTTCACATTCTTCTAATTTTATGCTAAATGTCTTTTACAG
>TTN-216,,0,86,797372,797457,GTGAGTTGCTCAACAATGTAAAATTTACCCTATCTGAATCTGCAGTTTATTAGTTCAGTCATGCTAACAAAACTGTATCATTTCAG
>TTN-216,,0,142,797458,797599,GTAAGTCAAGATTAGCTAATTATATAGGAGAGGGGTTGCTTGGTTGTGTAGGGTGAAAAAAGGCATAAAATATCTTGATGATTTGTAGGAATAACTATATAAATGATGTTCTTTCTTTCCTTCTAACCCTCACTCCAAACAG
>TTN-216,,0,125,797600,797724,GTATGCTCTACTTGTCAGCCACGTTTTTGTATTTTCTCTGCAAGACTTCCTGATACACCCCTGCATTGATCAAGGGTCATCAATGGAAACGTATTCTGACTTCATCCACTGTCCACTTCTTTCAG
>TTN-216,,0,112,797725,797836,GTAAATAGTTTTATCAAATAGTCCACCCCAAAATCATTTTTTTTGCCTTTAGTTTTATATTTCTTCTTTAAAGTGCTTCAATTAATAAGTTCTTTCTTTTTTTTCTTGATAG
>TTN-216,,0,846,797837,798682,GTAAGTGCTTTTTAAATTTTAATTTTACTGCATTAAATTCAACAGAAATTTGTGGAGTATCTATTCTATAAAATAGTCTTCTAAGTGTTATATTGCATGAAAGCAGCCCAACTCCTTAAGAAGCTATCACATATGTAATCAGGCTTATTTCTAAAACACTTTACCTTCATTACTATAAGTTAATGAAGATTCTAGCTTACACCCACAAAATAGCCAATTAAAAGCCAACTTAAAATTCTTCATTAATTATTGAGCCCTGTCATGTTTAAAATAGGAGTATATAAATACTTTCTATCTCTTCATTTTATCAAAATTATTTCAGAGGAATGTTTTTCAAGTTTCCCATAAGAGAAGATATTACATAATTTACATTAATAAGCCTCATTGTTTTTCTTGGCCACCTAATATCAACAAGATTAAACATGAAGGCTAACATATATAGACATGATTAAAGGCAAACTATTAATTGATTAAGAAAAACTAACAATGTGAACCTGAAAGCTTAAAAGTAAACTAGACATAATAGAGTTGCTAAGAATTAGAAATTTACCCAAATAATGGAGGAACACAAAATTGTATTTGAAGCTAAATTTCAGTCTTTTTAGCTACTGTTAATAAAATGTTTCAAAATTCAATATGAATGGATTAGATCTTGATAAATCCCACACACTGATTCCCTTCCTAATATTTAGAGAACTTTTGAACATAAACAGGTTAAATGATTGAACACTTGACACAATTTTAAAAGATACTCAGAACTCTGTGAGTTGTGTCTTAAACTTTCCAAGAGATTGTCATTTCCCTAAGGTGATTAATAAAAGCTTTTCACTTATACTTTACTTGCAG
>TTN-216,,0,90,798683,798772,GTAAGGAAATTTCCATGAGTTTCACTCTTGAAGCATTGGGGTTATTTGTGCCAGAGGCTAATGACCCATGCTGGCCCTTCACTTTTCTAG
>TTN-216,,0,436,798773,799208,GTAAGGCTATTTCTGAACTTGTCAACACCTAAAGGAGCTGTGTGAATTAGAAAAGAACAGGTGAAAGTCAGAGTGGATGCAGGACATTTAAAACATGATAGCAGTTTCTCTATCAGACCCTAAGCCAAAGAGAGATGTCAGGGTCTATGAATGGGCTCAGACTGGCACACTTGCATTACTTTTGATCCAGCAGAGTGAGTATAAGGTTGTAGATACTCTGTGATGCTGCTAGTTGGCTCAGAATTATACAGCTAAAATAAATGTGGCTTTCCTCTTAGTACTTGTAAGCTTTACTTCCTAAAAAAAGAGCTCAAAGTTATATAAAGTTTCATCACCATTTATTTGTTGCATTCCTTTAATTAAGATAATCTATCCTTAGAACAAAATTTCAAAGAAAATTATTTTCTATGAAAGTTTTTCTGTTTTGTTGGTACAG
>TTN-216,,0,797,799209,800005,GTAAGTATTGTATATTTTTCAGGGAAATTAAATAAACACTTTTTCAGAAAATGAATGTGAGTGAAATTAATTGGACCTATTTTATTAGTTAGAAAATATTATTAAAACACAAAAACTGGCTCTCTTGTATTTGCCACTTTGACATTCCAATACAGAAGTGGTTCAAATCGTAAAGTTTTGGAAATTTTGTTGACCTTGCCATTTGAACAAAAGAAAATTTAGCAAATCAGATTTTCCTGCTCTGTAGTCCTCTCATTGAAAGTAGATACACATACAATGAGAATCTAACTCAGAACCCTTAAAGACCACTTCCCTCAAGTGGCTGTGCAACTAGAGCACCAGAAAGACAAGCTTTGCTGTGTGGGCATTTTAGATTCAAGAAAGAAGGTGGGAAGCATTAGGCTAACGTTTCTGGAAGGTGCAAAGTGTTTGATGGATAGGGACAGCCTCTGATTGAGGGCCCCTTGTCCTCTCCCAATCAGAGTCTTAGTTATTTTGGAAGTCACATACCTTATGTAGCAAGAAGAACTTGACGCCTGGCAGAGAGACAGATGCAGCACAGATTTCTCGCTGACCTTGTACGTCAGAACGAAAGGGCCCCTACATATACTCGCTCTCTGGCTACCAGCTCTCCCCTTCTCAGCGCCGTGGGGCCACGTTCACGTGGGAGTTAAAATAGTGGCCAGTCCTGTGGCTTCTTGAAGAAAGCAACCATGAAGATTCATATCTAAGTCTCTATTTATTCTTTTGGGATTACAAAATGAGTAACGCAAAGCTGTTTCTTCCCTCTCGAAAAG
>TTN-216,,0,3904,800006,803909,GTAAAAAGCAGGCATGCCTTGTCTTTCCCGTTCTTTTTCTGGAGTTCTTCCACCTTCACTTGTATGTTCCTTATTCTTTGCTCTTTCTAATGTCTCTTCCTCTGTCTTTGCCTTTCTCTTTCCGCCTTTAGCCTGATTTCTGCTGAAACTGTAAAGCCAATTTTTTGCATTTTTTCTTAGGTTTAACCTGATGATTTTTTTATTGAAATTGAAATAAATTTAAAGTATGATCATGTTTTAGTTTTTTGAAGAAAAGACAAGACTCATTGACTATGAATGATAGTTTGATTAACCAGAAGGCAGGAAGGATCAAAAAGGCTTTCTGATTGCACGCTCTGCAGCCATGGTGCACATTAAGTTTTAAGACTAACGCTCTCCATCCTATTTAGTGTTCTGCATATAAGGGGATTAAGAGGAGAAGACTGAAATTCCATTTCGGGCAGTTGATCAAGTAGTTGAGATAACTTCTGGGCAGATTTGCTCTTCAAGCATTTCTCCAAAGCTATTTTTAACCTTCAAGTGCTCTGGGCTGTGCGATATCTGGAATGCAAGTGGACTATTTAAAGTGCAACTGATGGTACTGACAAGAAAGAAGGGCTCTGTGGTTATCCACATATGTGGATGAAATATTTTTTTTAAGCTTTGGTAAATAACTAGCTCCTGCTTTTAGCTTTTACTAACATTCTTTATGCCCAAGATTTTACCCATAAGTAAAAACTAAGGGATTATTCAGATAGGCCCACAATACAATTTGCCTAAATTGATCTATATGTTTTGTCCCCAGAAACAACATATGTCTTTAAATTATCTTGACAATCCATCATTAATTTTGAATTCTTAAAATAAAATATATGGAATATGTCCAGCCTGGGTTGGAAATAAAGCACAGGACAGTACATTGTTCTGTGACATATTCCCCCAATATTTCAGAAATACTATTAAATGTGCTATAAAGATCTCAACAAAAATCAAACTTTGAAGACTTAAAGGAATATAATTAAAAAGTGATTCAGTTTAACAAAAAGCCACAGCATTGACTGAAGTATTTGAAAGCAATGCCTTCAAGTAACTGCTTTGAAACAAACAAACAAACAACAACAACAACAACAAAACTAGTATTCCACTAAAGTGATTACAGGGTAATTCACCAGCAGTCATCTGATAGGTAACGCCTGCCTGTTATACAGATAATAAGATCTTCTTGGTCTCCTTTTCCAGTGACCAGAAAAAGCAGCAGTACATTCCATTTGTAGCATGGGAATTAAGTTACATATCACAAAACCTTCCTTACAATGAGGTCTTCTAAATATTGAACTGAGGGAGGCACCTCTACCTTCAAGCTTATTGTTTGAAAAAATATATTTTGCCTATCATGCATGATTTAATTAACTTCATGTCTAAAGGCAGAGAATTGGTTGCTTTTTCAAGATTCTTTCTAGATCTGCAAATTCATGATTTATATATAGGAACACTGCTTAAAGACAAATGATATTATTTTTTCATTACCAAATATCTTTTTGTCATAGTAAGAGCTTCTTATTAAAAGATCAGTCTCAGTTCTAATACAAAAACTGCACTATTTTAATTCAAATGTAGACTCCTAAAAATCTTATTCACATTTTATTTTTAAAAAATTCTCATTGTAACTAAAATTTTTTCTAGGGTTAGAAAGGATCAGTTTACTATAATTCTATAGGGCCCCTTTACATCTCTTTTGGCATAGGAATTTTAATCCTTTACTCTAGGCACCCGAAATACCTTAGCCTTTTGTGAACTTGCTCTTGCATTACTTAAATGTCTCTTTTCAAAAAGAACTTAAATATAAACTTTGAAGTAATAAAATCATTTTGTTACATGTGGCAGATTTTGTTTAAATTAAGTCTGTCAGAACAAACTTGCTCTTGTCAATGTAATTCCGAACTTTAATACTCATTTTATGTAAAAATTTTCGCCTTCAAAACTACAATAACCAAACAAGCAAAAACAAGCTGTAGGAATAGGAAATATGAAGAGAAACTTGTAGACATGAGTTGTTTGCATTTTTTCTTTGTTGTTGTAGTTGTTTTTGGCTGTCAGTTTAAGAAAGGACTGCCAAGTTCCAAATGGCATTTGATAATTTTAAAGTTAAATTTTAAATTTGATAAAATTAAAGTTTAAATACAAAACTTTAATAGTTTTGTCATGGTCATAAGCCTACCGTATTATATTAATATGCTTCCACTATAAATAAATATTTTTAAAATCTCTAACATTATTCTTACAATCTACTGCAAAATCTTCAACATTCATTTCATTGGTTTATTTTTATAAGGCACCTACCAGTTTTCCTTTTTTTTCTTTTAACATAGTGGAGGTAGATTGTATACAAGCTGTTTATTGAGACATACTGCATTCTGAGCAGTGTCCTAGAGTAGCTACAGAGGAACTCAGATGATAAAGCAACATAATATTAATAGATAAAATATATCTGTGGGTGGGTTAGAAACTGAGACACCTTTTCAAATAGCCAAAAGTTGCATGCCAAAATTTATACTGAAATGTTATTAAAAAAACAAATTTTTCCCATTTCAGCACCATGCCCTCGGATAAGTAGCTCTGTTCCAAGGGCATATTTAACTACCCCCTCCTAGCTGTTATTTTTCCTTATTATGTTTTTTGGCCACTCTCAATTATTAAGATAATTATGTGACTAACCATGCCCAGTTCTTAATTAAAGAAAACACTTTTAGATGAAACCTTATTTCTGATTCTTTTCTTTACACTAGCATAACAAATAGTTCCACTGGTGAAAAACTTTACATTATTTTTAACGCTAAGTAAACTCTTAAGCAGTGCAAAATCAGTCTGGATGACAGGGCACAGCTTCTTAGGAATTTTATATCATAGAACTGGAAGAACCCCCAAGTCTCTTATCTTTGCTGTCAGAATGACCCCTATCTGTCGCACCATTGACATCTGATTTTCCCATTCCTGATGCTTAGACACATGAAAAAGGAAGAAGAGTCCAACTTTCATTTGCAGTTTTGAACAAAATTAATAGGTTGTACAAATTATTTAATCACAGGTTTAATTGGTTTGCAAAATAAGTTTAATTGCTAAAATAAATGGGAAGAAGAGTTATAGCTTGTTGTTGCATGGCAAACACCTTACATACAGAACATAAGGTTTACTTTTAGCTTGCCATAGCTGATATTTTCTTTCATCCTTTCATGAATTCGCTTTTCTAAGTTCTTCCTTTATATGTATATAAGCCCAGGGGCAGAATGGGGGCACACATATATATACACATATACGTATATACTATATGTGCTGTATATCTACGCATATGCAAAAAAGACCACAAATGTAAACAGAAACTGGCCTGGGCAATTTCAATGTGAAAGGCCACCTAGTAATTATATAAAGGTAACTATGAAACCCTAAAATTTTCTTGAAAGATCCCAAACTGCATAGTATTCCATGGTGTATATGTGCCACATTTTCTTAATCCGGTCTATCATTGTTGGACATTTGGGTTGGTTCCAAGTCTTTGCTATTGTGAATAATGCCACAATAAACATACGTGTGCATGTGTCTTTACAGCAGCATGATTTATAGTCCTTATACCCAATGCTAGATGATGAGTTAGTGGGTGCAGGGCACCAGCATGGCACATGTATACATATGTAACTAACCTGCACATTGTGCACATGTACCCTAAAACTTAAAGTATAATAATAATAAATAAATTTAAAAAAAAGATCCCAAACTATTGGTTGAAATGATTTTTGAATGCATACGTGCTAAATAGATGATTATAAAACAACTTGGAAAGCTCTATTTCCATTTATTTTTATCTAAATGAATTAAATGCACCCATATACTAGATTGCTGTTTCATGTATTCTTTTTTTAAAAACAACTAG
>TTN-216,,0,541,803910,804450,GTAATTACAAGGCTTATTTTAAAAACATGTATAAGGCAGAGGCTCATGAACAATGCCAACTCTCAATTATCTTTATATGATGAGTACTATAGATGTTTAAAATCAACCAAATAATCAAAAGTCTGATTTTACTTTTTAGCATAACAAAATAATTCACAGACTATCTTTTTAAAGAGCCAAAATTGACTAGCATAGGTTTTACTTCCTCCTTCCATCTCTATTGTTTTTATTGCACATCCTAGATTTTCAAAAGCCAGCTGGAGGAAGAATTATTATCAAGCTAGGTATCCATCACTTTATTAACCAAGAGTTGGCTGTTATTTCCTTAATGTTTCCTAGTTTTTAAAAATGATTTTCCTCTTGTCTGTACAAATAATGATAAAATATCATTTTTAGAGGAAAATGTCTGAGTGTAATCAAAACTTGAAAATAAAACTTAGGACAGAACAAAGCCCTGGAGATGGCAGGGGAAAGTTGAGAAGGTACCAAAACTCTTGGAGAAGGAAAGGAGTACCTTGGCTAATGAGTATGATTCTTTCAG
>TTN-216,,0,1697,804451,806147,GTAAGTATTCTTCTTACAAAGGACTTTTCATTTGCAATTCTTTAATAACTACAACAACAAAACAACACAACACTTTTTGCATGCCCTTCTTGGCCTAACTGCATTTCTTGGCAACTTCTAGTATTGACACTGACCTAACCTGATCCTTTATGTGTTTAAAGAAAAAAAGAAAAGAAAAGTCTTATTCTATGTCTGGTCTGATTAATGATGGAGCAATCACTTTTCCCTATGCTTCTTTTCTCTCACTGAGTAGTGAGTAGATGTGCTCTTTGTCTACATGGGGTCAGCCTACTGTATGGATATCCTGATATGGATGAGGAGAAACTGAATTTTAAAGATAAGTAGGGAGTCCTAATTTTAAAAACAAAGTAAAAGTGATTTCCATGTGGAAGGAAAATGAATTTTCAGGTGTGGGGAACAACTAGAAAATGAGCATGAAATTTCAGTCTGAATAGGAGCATACTAGAGATCTGCTGTAATATGACAAAGCACATTCACATGATTCAATCTCTGAGAATAAGAATGGATAAGAAGATGGAGTGAGGCCCTGGATCTTTTGAGTCCTGGACTCTTTGAATGAAGAGAACTCTAATGGTTTTTAACATTACTTCTTCCTCTGGTGAAAAATGTAATGTCTTTTTTCAAAATGCCACATACTAGCTTATTTGTTTCATTCATTCCTTTGTCCAGTGATGACATTTTTCTGCAAATTTTTTGTGCAATATTTGTTTGTTTGGTTTGGTTGCTTCCCATCTGTCAACAGCTACAACCTAGTGACTCTGTGCTTCATGCATCTTGTACCATGTTTTTCTTACCACTTTGTGGTTGCTCTGCTCAAGCTTATGTCAAAGTAGCTTCTTGGGTCTCCTTCTTCACCTTGACATCTACCTTCACTCCAAGAAGGCTCAGCTGCAAGGAGCATATTTTCAAACCTATTAGACAGCATTTGTCTCAGAATCTTATTGCTCAAGAATGGTCATCTTGGGAAGGACTCACAGGGAGCTCTGAAAGAAGGAAGGGCAAGGGGGCAGCTCCCTAATCCTATACACCAGCTGAATTAATTCTACAGATGAATGAAATAACAGATGTAAAATCCTAATCACCCTCCCATACAAAACACATTGCTTTATTGCACTAATAGATGTTATGCCTGACTTATATGTGACGTCTTCAAAGCTGATTTTTTTAAAAAGCTAAATGTATGTTTCAATTACAGCCTCATGCCTCTTAGCCATACACAAGGCTGGCCATAGTGCTTCACGTGTTCTATCTTTGAATTCTGCTAATTTCTCAAAGATTGTGCTAAGTGCCTTAAATAAGACAATGTTTCTTTGCCACTGGTGTCTGAAGTTTCCTTTGACATTATCTTTCAAGTCTGGTGCAGTGCAAATGAAGATTTTTCCTCCAGCTATTATTCAAAAGAACTGAGATGGCTCCCTAGTATATATACTGTACACACACACATGCACACTAGTTGAACATATAGAATGCCACATAATTTTATGTAAACTAAAGAGATATCTAAAAAGCAAAGCATCATACCTGATGGGCAGCTTCAAGTGATTTCAAAGTCAGTTGTAGTCTATTAAGATGGAAAATCCCTAAAAAAGAGTCACTTTTTCTTAATGTATACTATGGTAATGTCAGAGTAAATTTCCAGAAACCTCATTTTGAATTCTGATGACATTCTCTTACAG
>TTN-216,,0,661,806148,806808,GTCTGTGACTGTATACCTGTCATCTTGTACTGTCAAATAACTTTATATTTACTTTTGGTCTAGCCAAAATGGAAAAAAAAAAGTTAGTCACAACTTCTCTGGTCACCACTTTACTTTTAAAGATAATTGTAGTATAAAATGTATTCTTGACTTTAATTGCTCTCTTTTTAGTATTATTAATTTACTATTACTTGAAAAACACTGGACTCACAATCAGGAGATTTAGATATTAGTTTGAACCATATGAAAGTGCTGTTTTCTTAGATCAGAAAGTCAAATATCAGCAATTATATTTCTTTCAACTAAGTACCTCCTGTTGCTATTAACTACCATTGGCAAGTTTCTTCAAGTCTGAGCCTTAGTTTACACATCCAAGAAGTTAGTCTGCATAATGTCTAAGGCTCACTATAGCTCTAAACTTATATGATCCCATTGTTTTTAATAACTGATAATAGTATCACAGCAGCTAACTTAACAGTAATTGGTAAGATTGTTCTTGCTTTTGGGGTTTGTTTATATTTGTGTCTGCCACCTTGGTTCTTCTTCACACTATGAAGTCTTGTTGGTTGCTTTCAGAAAAACTCAGGATCATAGTTTTTCTTAAGGACACCTGTGTGAAGGAACAACAAGAAAACTGATAATCTATTTATCTTAAATATAG
>TTN-216,,0,98,806809,806906,GTAAGAGTAAAGTCATTCTTTGTGAAGTATATGTGTTGGGAAAAAATAATAATTTCCAGCTTAACTCAATGTGGTTTTTGTTTTTTCAATGCTTGCAG
>TTN-216,,0,106,806907,807012,GTATGAAAACTACAGTGAATAATCTTTTATTTCTAACAATTCACACTTGCTAGATTTAAAGTACAAAGACATATGTTTCTAATATCTTGTAACTTTTTCTTCCCAG
>TTN-216,,0,108,807013,807120,GTAAGTTTGTTCTTGCTTTTAGGGTTTTTTGTTTGTTTGTTTGTTTTGTATTTGTATTTACCACTTTGATCATTATTCATACTATAAAGTCTTGTCGGTTGCTTTCAG
>TTN-216,,0,89,807121,807209,GTAAGTAATTTATATACCACTAGAGATTTTTTCATCAGTTTCTGTTATAAAAATAATTAAAATCAACATATTTTTCTCCTTTACAACAG
>TTN-216,,0,104,807210,807313,GTAAGCAAGATCTTTTTATTCTCTATTTCTGTAGCTATATATACACTTTTGACAATTTAGTGGCCATCATTGCAAGCTAACTGATAATCCAATGTCTCCTTTAG
>TTN-216,,0,100,807314,807413,GTACATATTAAGTGAAAAAACAATTCTAATGTTACCAATTTTTTAAAATTGTTAATCAAAATGTAAACATATTTGTATTTATTTCACATTTTCTTTCCAG
>TTN-216,,0,767,807414,808180,GTCAGTCCCTTTATTTTAAAATATCCTTCCAATATCACAGAGTTTAGATTTCAGATTTCACAGTTATTTAATGAGGTAATCCTTGTGAGGGTCTTTCATTTCTAGCAAGCCCTACCCACATGTTAACAACTCTAATTTTGCTCACTACAAAGTAAGTGTCTTGAGTAAGAGGAAATTAATAGCAATAATCTTTACATGCCAGAGCCTTGGACAGTTGCTAGTACATGATGACTATTTATGAACTTAGGCTACAACTAAGCTATCACCCTGAGAGTCTTGGCAAATCTAAAGACGGTCTTATACTCTCCTACTTTACAAACCCCTGTGTGCCTTTTAGGTATGTTCTCATCCTGACCCAGGACATCCTTATACACTGTCCTTATGAAAAAGCCATTAGTGTACCTCTCATTCATAAGAAAAAAGTTTCTCTGATTTATTGAACTAAGTATGCAGTGCCTACTCTATCAAAAAACAAAACAAAACATGTTTTGCACTACACTGAGTCCTATGTTACTATTTTTGGCAAGGAATGCATGTCTTATGATTTTATGCCATTCTCAATCCTCTACTCTCCAATCTAATTTGCACGCACAACAACAACAAAAAGCTATGAGAACTCTAAGCCACTTAGTTTTCTCTGCTATAAAGTTACTGTAGCTTACTTCCAAGGTTATGTAACCAATATTTTCTAATAAATGCATAATAACATGATGTAGCTTGGCTACGTTTAATAGTCGAAAGCGTTCACATGTTATCTTTCTCACTAG
>TTN-216,,0,92,808181,808272,GTAAGCCCTTGGGTCTCTCAGACTTAATTGGCAAAGCACAATTTAAAAGCAAGACAGCACACTAAAAAAATTCCTCTATATGTGAATTTCAG
>TTN-216,,0,107,808273,808379,GTAAGAAGTTTTAAGTAAATTCAAGTTAGCTTTTAAGTAAATTGCAGTCTTTGCCTTCATCATCGTTACCCCAAACTCATATTTTCTTCTTCTGTGGTGAAATCCAG
>TTN-216,,0,266,808380,808645,GTAAGCCCATCAAAAAAGGGAAATAATTACTGCATGAAATCCAGATATTAGGCCTATCAATTAAAATAAATCAAGTTAAATGAAAGTTAATAAAAAGGTAGAATATCATAAAAATTTGGATAAAGTTTTAGAAACCCAGACTGTGCCTACTTTACTTAGTGAATTTGATAAACCTGTTAATGAGGATGATATAATTGATTACAACACTGTTTTCATAAATTGTCACTAACGTAAATGGTATGCTCCAACTCCTTCTTTTATTCCAG
>TTN-216,,0,90,808646,808735,GTAGGTCATTTGCATATAAAAAAGAATATTCAATGTGGATCATGGACATAACTGTATGTGTTTTTTACAAATATTAATTCATAATCGTAG
>TTN-216,,0,106,808736,808841,GTAAATAGATATTTTATTTTTAGATCGGGGAATAGCACATAGCTACTTTGGGGCAACAGGGACTTAAATATGGCACTGCAAACTCATTAACTTTTCTTCTTTGTAG
>TTN-216,,0,98,808842,808939,GTAAGGAACAAAACATTTATCATCTAAGGTGATTTGGCAGTATTAACAAATATTAGTTCAGACTATTAACAGTGACTCGTGAGTGCATTTTTTTTCAG
>TTN-216,,0,690,808940,809629,GTGAGTTTTGAGCAGCACTGCATCAATGCCAAAAATGAGAGTAGGGGAAATCCCAGAAGGTTGGGATGCCATACAAAAGTCTTATGTGCTACAACTTCTTACCTTTACCTCACTGAAAATGTACAAAAACTTTTTAAGAATGCATCGGTGCTAATGCTTCCTGAGGTAGCTCAACCAAGGATTGTATAATTGTAATTGTCTTGTCTTGTGAGCCTTACCAAATTTGTAATAAAAAAAAAAATTCCCTACTGACTTGGTACCTGCTAAGTACCCAATATGTACCCATTAAGCTAGAAGTGGAAAGTAAATATTTATTTCCCTGGTGGTCACACTTCTTATTCCACTAGAATACCTTAGTTGACCTAATCAGCCATTATTTCCTTGTGTTTATATTAGTTACTATTCTTTACCCTGAATTAAAATCATATTTCTGATAAGCAAACTGGTAGAATCAACACCTCATTTGCCATCTTTTTTCATGTGTACAAACTATGAAGCAGTTTTTCTTATATTGAGTCAAATATTATCATGTATCCTACTTTGCAATTTTCCCTAATATGAAATTAATGTAAGAATAATCCCTAGCATTCAAAACAACTGCAGTTTGTATCCCTGGTCATGGTAAAAATCTTTTGGGTTGGCGAAAGGGTTTTTTGGAAATAACTGATTAACTGTATTTCTTTGTCCCAG
>TTN-216,,0,156,809630,809785,GTGAGTACATTCTTGATGATTTCTTACCTAATCTTGTTGCCTGTTTTTGCTTTTAGACCTAGAGTTGAAGTTATGGGGCAAGGCAGGGGTTGGCAATGTGAAGAGAACTGCATAGGTGGCCTGTGTAAGACTGACTCTCTCTTCCAAATGTTGTAG
>TTN-216,,0,338,809786,810123,GTAGGTTTTTAATTTGGCATGAGAGTAAATGTGTACTCCTAGTCACTAAAATGGGCTTTGTTGGGGAAAATTTAAATGTTTGTCTTTTTTCATTGAGAATCCTATGCTGCCGGTGTATCTGTCTGATTTTTAAAGGTGCTGCTGAATGTACTGCCTGCTCAGGGTTTTCATGACAGTATTGAAATGAAAATGTATTCAGTTATAGTGTTGAAGTAATCCAGGTTTAATTTAAAGACTAGTATTATACCAGGGGTTTGAATTTTTGAAAGATTATGAGTACTACACAATGAAACGATTATCGACATCACAGTAAAACATCCTATTCTGTTTTCTGACAG
>TTN-216,,0,93,810124,810216,GTATCTATTTTTGATTTTTGTCTTATCAAATAGGCCTCTGACCTTAAATCTGCTTGAACTTGATAACATCATAAATAATCTTTTCCAATTCAG
>TTN-216,,0,117,810217,810333,GTAAGGAAGGTTCTCATTTTAAAAGGGGATAAACTCTTTGCAGTTACTTTCTTGAAAGAAAAAAATAAAAAAAATGGTGAACAATTTTTTTTTCTGCATCTGTAATGCCATACACAG
>TTN-216,,0,114,810334,810447,GTAAGTTTCTCAATCAGCTGATAAAAAAAAAAGGATGCTTATGTCAAACTTGCATTTTGGTGTCATATTTATATACAGGACATATAACATTTTACACCATTATCCTGTCTATAG
>TTN-216,,0,474,810448,810921,GTATGCTCAGAATCCCCATCAAGATGTTAAGACAGCAGTATATTCAAATGTTTACTCTTTAGTATTCCTTGGGATTACAGATGATTATATATTACTAAAAAAATTTTAAACTACTTTTACTCATATTTTCTATTACCTCATAATTTGAAAAATTATATAAATTCCATTCAAGGGCACATTTCTTAGTTTACTCTAAAATATTAACCTTCAGGAAGTTTCAAAGTGTTTGATCCCCCAGTATATTATGATAATGACCACTGTCATAGATATTATAATTAGATTGGTATGTTTGGCCCAGTCTAAAGTGTGTGGCAGTTAAAAAGCAATTTTTAATTTATATTGAAGTGCTTTTCAGTTAAATTTCCAAATCACCTTTTCACAATTTAAATAAATTAGTCTCTTCTGTGTAAAATAAACATAGGCTTCTTCTGCTTCTTACCATGATGATACACATGCACTTTGTTCCTAATTCAG
>TTN-216,,0,88,810922,811009,GTATTATTTATATAATTTTTGTGGTTATTTCGAAGTTCATATGAACTCCTTTTTGACAAACCTAAACAATGATTTCATTGGCTTGCAG
>TTN-216,,0,196,811010,811205,GTAAGTCACTCTTGATGTCTGGGATATATAAATTCTTCTAATATCTGCCTGTGAGCTACGATATGAGAAAATATGAAAAATTCATTACTATTATTTCCTCCTGGCTACATTACTTCTTAATGACTGCCTGCACTTTCAGACTGACTATTGGGTAATAAAAAAAAAAATGAATTTGTTTTCCTTCCTTCTTTTTCAG
>TTN-216,,0,114,811206,811319,GTATGCTCTTGCACTTAATCTTTGTGACAATAAGTGCTCTCGCACTTAATTTTTGTGACAGGAGATTATCACCTTTCCTCTGGTTTTCCTAATCATTGTTTATTTTATTTTCAG
>TTN-216,,0,102,811320,811421,GTAGAATTTGAATTAATTCATAAAGAATAACTTACACTTGGCTGCAAATTCTTAACTGTGTTTTTTCATTAATGCTAATGAAATGCTTTGTTGTTTCAATAG
>TTN-216,,0,80,811422,811501,GTAAGTAGTGCTGATTATACACAAGATATTGTCTAGAACTTGATGAGACTGTGGATATGAATATTTCACTCTTTTCTCAG
>TTN-216,,0,100,811502,811601,GTAAGAGCACAAGGTCTTTTATAGTTAATAAAATACCCTTTATTCATGCATTGCATTTTGACATACTCTGTTTTTTGCTCTTTTGAATGATATCTTACAG
>TTN-216,,0,603,811602,812204,GTAATCATTCTTTGAAGAAAAACCAGACATTCTTCACATGTAGAGGAAATTAGTTAACTTTGCAGTGCTATTAATAATATAATTGGCTTCATGAACTGGCCACTTGTAAACTAAATGTCACTTCTGATTATGTCTTTCCATAGGAGAAGTAAAACAATTCTAAAGAGATGAAATCGCTAAACGCTTATTAGACTAATTTATACTAGTTTTAGTTAATTGCATGTGAAATACTAATTTAAATAACAGATATTAGCATACCCAAAGAGCATTGAAATGACCACAATTTTTTAATTGCACAGCTTCACATTTTCCCATAGTGTTCTTAACCAGGGATAGTAACATTTTCTGCATTCCCCCCAGCCCTGCAAATAATGTCTGGAAATTTGTGGGGCCATTTTTGCTTGGCACACAGACTTGAGGTAGATACCACTGACATTTAGTAGTTGGGAGCCAAGGATGCTAAATGCTCTGCAGTGTGAATGACACTCCAGCACATCAAAGATTATCCTACCCAAAATACAGATAGCCCCACTTAGAGACAAGTGCATTATTAAAATGCTGATTTTTCAGGATTACTAGAATAATTATCCATTTTTGTAATAG
>TTN-216,,0,103,812205,812307,GTAAGTTTGGACATGGATGCACTATGGCTAAGAACTAATAAACCATAGTTTTGTTTTAAGAAGGTGGTTTTCCTGATACTAACATTTTTTTCTTGTTCTTCAG
>TTN-216,,0,113,812308,812420,GTAAGTTTTGTTTCATGGAGTTGCCACTTTCCCATTTTGAAATAAATGAAAATAATGTTTTGTCAGTTATTTTCATCAGAATTGAAAACATTTATTGGTTATGATCACTATAG
>TTN-216,,0,299,812421,812719,GTGAGTCATTAAAACTACACTTTCCAATGGAAAAAGGTTTTAGTAAAACATAAAAATAAAAAGTTTGGGAGAGAGTTAAAAGAAATGGGACATAGCTTCAGCAAGTTATCCTCAATCATATTTTATCTGCTGGCCATGTAAAAGAAATCACCTGATCTTGTTATTTATTAGCTAATGGAATACAAAGATAGATGTGGGAAAACCACAAATCATGTCAGAGGAGCATGCTCACATTTATATTTTCCATAGCAACCCTTCCCACACAAATTTTTGATTACTGTTCTCTTCTGAAATATTAG
>TTN-216,,0,128,812720,812847,GTAAGTTTCCTTTGGCATCTAAAGTTTGCCTTTTTACCATGTACTTTGGTATATAATTACTACAGCTTTTAAAATTGCATTTTTATGTCATACTGGGAAATTTACTTCAAATGTTATTTTTTTATCAG
>TTN-216,,0,96,812848,812943,GTAAGTAGTTCCTTAAGAAGAAGGTGGAGTAGAACAAGCTATTGTACATTTTAAAACCATCAGGGAGTTTGATTTGTCTATCTTCATTCATTCTAG
>TTN-216,,0,99,812944,813042,GTACTTAACGTTATTGGAATAAAATTATGGATATTTTCTCTATATGGGACTATTTTTTAATCTTTCATGGGCTAATGCATGACTGTTCTCTTTCAACAG
>TTN-216,,0,86,813043,813128,GTAAGGAATGTTGCACTGATTTTCACAGGATTTTCCCAAGTGATACTATCTTATTACATTGATTTTTGGCTTTGTTTTGTTTTCAG
>TTN-216,,0,1307,813129,814435,GTAAAAGAGAAGGTTTCATTGTGTTTATAGAGTAATGTTTTGCTTCTAGTTATATTATTTACTGAGCTTTATGGCTTCAAACTCCCAACAGTCTCAAAATCTATAGCTAAAGAGTAATAAGAAAAGTAAATCAAAAAACTATTAGCAACATTAAAGATATCATATTTCCTATAATTTCAATGTAATTTGTGGCTGTAAGTATATTAATCATGCATGGTTTCTTGTACTGAAAAACTTGGATCTACAGGGGCTTAATAATAACCTAGAAGTAGTTTAGACATATTATATCTCTCCAGTAGAACACATTGGAAGTCGGGTTTTTAAAACTTACTAGCGTAGTAGTTAAAGAGAATTCAATGTTCTTCTAAAAGATTAGACAATTCCTGAGAATAAATGCCTTAGTCTTCCTCTATATTCAAAAAGTCCCCATACTGGAAGGATAGAGAGGCCCAAAACCAGAAACAGCCTCCAAAGAATAGAAAACCAACCAGAGGGAATCTCCCAGAAATCAATACGAAACACTAAAATTGCACACACAGTAATGCACACTGACATCCCATCTAAGAAAGCAAAGGCTTTGAGGAAGACCCATTCCTCAAGAGACAGAAGAACTTATTCCTTCACCATCACCCCCTGAAAAAAAAAAATACATCCTATATCACTGCTGCAGCTCATCTATGAACGTCCAATATACCACAGGCTGTGCCAGAGGCACCAGAACAGAGCTGAGCTTCCACTCCTTCTGGTTGCAATAACAGTCAACAAGTATGGATTGGGTCTAGTTTTACCACTGAAAGCTTAACTCTTAGTTTGGTCCTTCAGGAAAGAAAACTTCAGCAGCATTACATACATCCTCTTTCCACCATATTTTGAACCCACATGTGAGGCAACATGACTCAAAGTATGTTCATAGACATATCCACTATCTGTTAATAAAAGAAAAAACACTTTGCTCTCAGCTGGTCATTCAAAGCAAAGCTTCACAGACTTACTTTCCTAGTTCAGTAGAATTAGAAGCATCCCCAGTTACAAAGGTAAACAATCTAAAATGTTAAATTAAAAAAGCATACGTGCCCTTGATTTATTTTTCACTGATAATCTTGATGAAAAGTTTGCTAAGAAAAATTCTGTCTACATGAATGTCTATAATTTTGGCAACTGACAAGTTTTAGGAATGATTTTAAATAAGGATGTAAGGTTATGCCAAACAGAAGGCTATTTTTTACATAATTAAGTTGAAGTGAAATATTATTTCTTACATGAATATTTATCTCATGCTAATCATTTTCACTTGCCTCTGGCTAAAG
>TTN-216,,0,118,814436,814553,GTGCGGAATCTGAATATAATAATAATTTTAATGCATTTTACAGTGTGCCTTTATCCCATAAGTTGAAAAAAACATCCTTATGACTTTGTTACTGTTTTTCTTTCTCTTCTCTTTGCAG
>TTN-216,,0,88,814554,814641,GTAAGTGACTTGCTTTCTTACATCAAAAAGGCATCCAGTGTCTGTTTAAGAATTGCCTTCTCAATATTCTCTGTTGATTCCTTTCCAG
>TTN-216,,0,402,814642,815043,GTAAACTCTTCTGAATATTTTCTTATACACATTAAAAGTACATGACTCTGGTTTGATGCCATTTTAATATAACCTTGGAATTTGATAATTAAACTCAAAACCACACACGATAAGCTGTTATTTTGTTATTGTAGTGTTTAGCCCCACACACATAAGGCTCCTTAGTACATAGCGTTTGATACACAGATACTCTTTTAATTGAGATCCACTATCAGGTACAATACATCTACATATTTTTATTTTAAAAAAAGCTTTCTCCTTTTCTCTGTCTTCCCATGTTTTGAGTCTATATATTTATTTCTTCTTACAGTCATCCCTCCCAAAATAAGTTGAATTTTTAAATGAGTGAAAACCAACATAAGTATATTCTCTTCAATAAATTTCTGTTTTTCTAATTTCTAG
>TTN-216,,0,1285,815044,816328,GTAAGTATGCTTCCGTTTCTGGGGACTAATTTCTAAAGCACAAAGTCACTAAATGGATAATTCTGCCTTAAATTTCTTATATTTTTCTATGCCAAATTATTTTATTTATTAAAATAAAAAAGGTTCATGTTCACATAGACTATCGGAAGTATATATTTATGTGTGTATACATACATGCACAGATATATACATACACACATACATAAAATCATACAGTTTGTAAACTCTTGGATTAAACCAAATATTTTATGAGGAATCACAATAATAAAGACCTGGACTATAAACTCCTATGTCTTCTGATACTTTAAATAAATTTCTATCTCATTAGATACTGGGGAAATCATCTCTCCCACTAAACAGTCAGACCTTCCAGTAGGAATTCAACAAAAAACAGAATGTTGTTAGCTTTTCTATAATATTATTGAACAAAGATTTAGGATTCTCAGGCATAGTCTGTGAGGTCAAATAAGAGAGAAAAATTCTTCTAAAAGATCTGTGAGCAGATTCGTTCAAAAATTAAAAAATACTGTGGCCATAATAATTCATCCTATTTGCTACATATCTGATTAGATTCTCTATAGAAGAAAAATTCAATTATTTGTTAAAAAGAAAATTTTAAATACTCAAGTGCTATGTGGAGCATATATACCTATATAATGAGGTAGTTATTCATTCATTTGCAAACTAGTATTGAACATGTGCTTTGTGCAAGGATCTATATTAACCACTGGAGGGGGAAAAGTTAAGATTAAAAAGACAAGTACAGTAAAAGAATTTCTGTAATTGTAAAGCACTTTCAGAAAGGTAAAGGATTGTTATGGGATTATTGTAGACACTGATCCTGTCCCTAAAGGGCATTAAGATTAGTTTGTGTTCAAAGGTTTACTAGCTATTGATGGAATCCTTTTTAAATTTTCATATTGTGGCAAATTAAATTTAAATCATGTTTTCAGTAAAGGCTATTGTAGAATTTCTTCAAAGGGATCTCAAAAGTAAAGTAGTTTTTTACCAATCATGTATAAATAGAATGTAAATCTAACAAGATAGGAAGTAGTCTTTCTATTCCCAGTTAGTTGTTTGCTTTCTCTGTTTTTGCATTAATGCTAAAGGAAAATAGACCATTTCCTTTATTTCTCTTCTCTAGAAGGCAACTGTATTTCCTTTTAGCATTTCTATTTTAATATTTTAATAGATTAAAATAATATATGATCATGTGTAGTAAAAGACTCCAGCACTTCATCAGCTTCAAAATCTGATGAAGCTTTTTTTTTTCTTTTGTTATTAG
>TTN-216,,0,131,816329,816459,GTACTAGTACTTACTCAGTTTATGTATTCCTCTTTTGATCTTATTATGAAATTGATTAATTTACTGAAGATATTTCAATTACTTTTGACAAATATGAGCTAAATCCTGTTAAATTGTATGTGGTATTACAG
>TTN-216,,0,87,816460,816546,GTAGGAAAATAACCATTCTCCTCTTTTTTCCACTGAATCACTATAAGGAGTATTTATACTACAACTGACTGTCTCCTTTTCTAATAG
>TTN-216,,0,94,816547,816640,GTAAAAAAATAATAATTAAAATAATTCAGAATATGGTTGACTTCAATATTGCTATGATTTCATTCAATGTATGACTACTATTTTCTTTGTACAG
>TTN-216,,0,93,816641,816733,GTAAGAAAGACTTTGAAAGTTGCTACAGAATAAAAACAAATTATTTTTAAGCATTTAAGGAACGTTGCTTATATTGTGATTTACATCCAACAG
>TTN-216,,0,93,816734,816826,GTAAGCTTTAAAATCTAAATTTAAAATATCTTCTCAAAATTGAAGTATATTATTATAAACAACGCTTAATACTTCCTTTAATTATTTTTACAG
>TTN-216,,0,1003,816827,817829,GTAAGTACCAATGTACTGACAAAGAATGTCCTCCTTACAGCTGCCTTCCTAGGTGTTCAATAATAGTTCACAATTAAAAGAGCTATATCTGTACCTTAGGAAGCTACTATGGCTTGAATGTAGACATGGGCACATTACTTAATTACTCATTCCTTCAATTTCCACAGAATTTTCACATTCCCTTACCTGTTACCTTTTCCCTGTTCAAAGGAGATGATGTCTGTAATTTCCTCGCTGTAATTTTCCTCGCAGTCTGTTTTATTTATCAGAGGCTAAAGCAATTTCTCTGCATGCTCCTCAAAAGGGACAGAAAGTAACCAGTCATTTTCTTAGCAACTGCTGAGACCCATTTATCTTCACAATCAAGTTTTTATTTCTCTATATGAGAAAAGATATATCCATTTTAATGAAGTATATATATATATATATATATATATATATATGGTAATAATTCTTCCTCTGATAATTACCATCACTACTGTTGTGTATTTGTTTATTCTCTCATCTAAGTGTGAAGAAACTGTAGTCACTACCCTCTTTGAATATTTCTGTCCTAAATTTGTGCAAAATGGAAAATTGCTTTCCTTTTATTAACAGTTATATTTCTTAAAAGGGGAATTCACCTTCTTGTGTATCCCTTCATAATTCTGTGTAAATATTAAAGAGAGTATCCCATGATACTCTCCTACTACAATCTCCTCTCTTCCCTTTTGTCAGGATATGAGAATATAATAATACACATCATTACATGCATAATGATGCCAAATAAAGTGAGGCAAGCACAGATACATAGCCACATGTAGATCCAATAAAAGATGCTGACCCCGTGTACCTGCTCCCCAAACTAGCGTAATAGTGTTAAAGACAGAACCATTCTTTATATTGGGCTGAGCTACAAAGTCTGCCTACAGTGGATCCAAACAACTTTATAGTAACTGTGAATTCTACTTTCTATCCCTCAATGCTTTTTGCTCCTAATGACAACTTTTTTTAAATAATCTAG
>TTN-216,,0,108,817830,817937,GTAAAGACTGCATGGTTTGGTTAAAATTACTTGTTTTTCTGTTCATAAATAACATTTGGCTTTAAAATCATCTGAGTGATAAAGGGTTCCTTCTTTAAACCATTTTAG
>TTN-216,,0,83,817938,818020,GTAAGTAGGAGAACATTTTCACATACAAAGCCATTTTTACTTTTTTTTTAAATTTCTTATAATCAATATGATCTTTTTCACAG
>TTN-216,,0,93,818021,818113,GTAAGCCTGGAAACCATTCCTTTTTTTTAAATCTTATTTTCCAAAAGTGCCTTGGAAAAGTCAAGAATACTAACGTATACTGGCTCTTTGCAG
>TTN-216,,0,447,818114,818560,GTAGGAAAACTTGGCACTAAGGAAATGCACTATGAATAAACTAAAAAATGTCATAGTTATTCTCAATCCCATTAACTTCTGTCTATACTTTTTGGATTAAGAAATCAGGAAAATAGCATAATTTTAACTCACATTCCAAACATCTGTTAATGTCAGAAATCGAATCAAAAGTTAAGTCATGTTATTACTAATCTTTTGGTTATAAACCCTGGAATGTGGAATAAATAAATCAAGGTTTAATCATTTGACAATAATTTTAAAGCATAACTCCTGCCAAGTTATTCCATTCAGTGTTGCCTGTAATATCTGATCCCTAAAACCTAAACCAGCAACAATTTTCCCAGAGTAAACAGTTAAATAGGCTGCTGGTGATGCTTTAGGAAGCCATTAAAGCAAGAAGCTACAAAGAACTATTCTAATTATAAAATGTCTATGATTTCTCCCCAG
>TTN-216,,0,88,818561,818648,GTAATTATCAATCCTTCCTTATGCCATCAGTATTTATGTTTCAGATTGAAGGGGAAAAATCACATTTGTAATTTTCAATTGCTTCCAG
>TTN-216,,0,1728,818649,820376,GTAAATACTTTCAATTTGTCTGTGCAACTTTTTAAACCAACATTCTTATTATATTTACACAAAGCTATGCTGTATGCTGTGTAACAAACATTTTGGAAAATAAGAAAAATCACCCATAATCATGTTGAACATTATTAGAATTTTTAAAAATTTCCTCCTTACTTTTTTATTCTATGTGTATTCTGTATGGTGGGTGTAAGTTTACAAATTATATAATTGAGAAAACAGATGCTAACAAGAAGACATGCATCCATGTTTCCAGTGAACCTAAAGAGTGCATGTACACAATTCTCAAATTGCTAGAAGGCCATGAATATGTATTCTGAATCATGGCCCAGAATAAATATGGCTTTTTTATAGAACTTGCCCCCATAGTGTCTATTATGTTGTTATATAGTTTTCATAGAAGCAACTTTCCTTAAACTGTACATGAATGTTTAACAATCTGCAACTTTCCTTAAACTGTACATGAATGTTTAACAATTTGCCAGTGCTGACCATTTCACATCATGAGACTCTACCCCTATCGCTAAATTATCATAATAATGCAAAAACCTGTTTGAAGGGTTTCAGTATTCTAATTGAAGAGAAGCATCATAGTTGGTTATCAATATTGCATTTCTAGTCACTGAATATAGAGTTGAACTCTATGAGGCTTTTTCATGGCTCTCACTGGAGGCTTTAGTCCAGTGATTTGCTCAGAACACGAAGCCTTTCCACTCAGGGCTCTTTCTAAGCATGTCTCTAGGCACAACAATACTCCAGCCACAGTTTTTATGTGAAAATTGCCAGTTCTATGTTGAATATAATTAATATAAGAATGGCATAAGGAAAAATATTTCATTAAGCAGTAGCCCCACAAACTTTCAGGTTAGTTTCAAGCACCTAAAGCTCTTTTGCCTAATGGTTATTACTTTAATTTGAGAACTGGTACATTTCCACGTTAATTATTTGCAACCTCCTCAAAGTCATTCTGAAATTTGGGGCCTCCTATGCTGCTTGTTGATCCACTGGTCATCCAGAAATAAACCATCTCTCTCTCCGTTTCCCCTGCAGAGGAAACTGGACATAGAAACTGACTATGCCACTCTTACCCATCTCTTGTATCCCTCTGCATGCTTGCCTCCCAGCTCCCTCCTGTCCAACTCACAAATTGCTTTTAAAAAGCATTTTTATTTTCCCTTCAGCCTCTACTAAAACCATGGTAACCAATAACTGTTGCAAACCTACTTCATTAACAAATATGGGGCTTGATGCTATGGCTCACACCTGTAATCCCCTGACTTTGGGAGGCCAAGGCAGGTGGATCACTTGAGGTCAGGAGTTCGAGACCAGCCTGACCAACATGGTGAAACCCTGTCTCTACTAAAAATGCAAAAATTAGCCTGGTATGGTGGCACATGCCTGTAGTCCCAGCTACTTGGGAGGCTGAGGCAGGAGAATTGCTTGAACCTGGGAAGCGGAGGTTGCAGTGAGCTGAGATTGTGCCACTGAACTCCAGCCTGGGTGACAGAGCGAGACTCCCATCTCAAAAAAAAAAAAAAAAAAAAAAAGTGGTTGACTGTTTTTGTATTGACTAGATAGCAGAAGGAAAAACTAACTCAATTAGTAGACACAAAACCTTACTTTCTTCAAAACAACATTTTTGTCTCCTTTTAAAAAAACAAGTGTTGAGCATTATCTTTCATTGAAGGCAAACAGCTTGAATTATTTTCTTCTTATTTCCAG
>TTN-216,,0,860,820377,821236,GTAAGTAAAAAAAAAAAAATGTATACTTAATCACTTCTTTACTCATTTAGTACAAGACTATGGTGAAAAAATATGTGTATAAATGCCGTACATTTCATTCACTTGACAAGCAGTTATCACACAACTACTCAGTATCTGATTTGGTAGTATTTGGACAGTGATTGTGAAAGAGATTTTACAAATATGTATAATTCATTGAATTTCTTTTTGTTTTTTTTTTTCTTTTTGGTTTTGTTTTGACACATAGTCTTACTGTTACCGAGGCTGGAGTATAGTGTCATGATCTTGGCTCACTGCAACCTCCACCTCTGAGGTTCAAGTGATTCTTGTGTCTCAGTCTCCCGAGTAGCTGGGATTACAGACATGCACCACCATGCCCAGCTAATTTTTCTATTTCTAGTAGAGGCAGGGTTTTGCCATGTTGGCCAGGCTGGTCTCAAACTCCTGGCCTCAAGTGATCCACCTGCCTCGGCCTCCGAAAGTGCTGGCATTACCACTCCTAGTTCATTTATCAAATTTCTTCCATCTATACCTCACAGATTTTTTTTTAATTTCCCACTTAATGGCATTAATAGAAACTGAATTATTTTCCTACTTCTAAAACTACCAATTCTGAAGACCTTTCCTAAATTATTTTGCCTCAACAAACCTCTATTTCCTCATCTGTCAAGTGAAGAAATTCAATTGTATTGGGTCCTTTTTAACTCTAATAGTTTTATGATGAGATCTCTTTTGCTATTTATGGGAGCAGAGAGTTTAATGTTTAAATGCAATCTTCAGAAAAGGAATATTCACTACATCCTACTACATTCTTAATGTGACATTTTTTTCTACCACAATTCCTATACTTATATTCGCAG
>TTN-216,,0,101,821237,821337,GTATGTGTCTACTACAATTTATACTTCTGAAACTTGCACATTTGTAGATTTGTAATAAGACATCAATAAAAATGACTTGCCTTTATAATTACAAATTTTAG
>TTN-216,,0,93,821338,821430,GTAAGTCTTATTTAGTGGAAAGAATAGATCTTCTGTTCTTTCAAAAGCAGAAATGGCAATAACATTTTGTGCCATGATTTTTTTTTTCTGCAG
>TTN-216,,0,92,821431,821522,GTATGCATTATGTTTCTTTTTAGTGATTCAATGCTTGATAAAACTAATATAAAGAAATAAATTTCTAACGCATTTTCCAACATTTGTTACAG
>TTN-216,,0,89,821523,821611,GTATAGTATTAATGGATTTATTCAGTTTTCATGTTATCTAACTTTGTTTTCAGCTATATGCTAATTCGTTTTTTACTTTTATTTTTTAG
>TTN-216,,0,114,821612,821725,GTGAGTAAAATGCTCTCACTTGTGTTTGCAAGGAAAATAGATGTCTGATTGTATGTGTTTAATTGTAATCTGCATTATGGATCAAATCTGAGTGTTCTGTTCTCTTTATTCTAG
>TTN-216,,0,101,821726,821826,GTAAGAATTTTACTACTTAGGCCATTAAAAATAAATTTTGATAATTTTGAGCTCTTATATGGATAAAATTACTTATCAAACTGTTATTTAACACTTTTTAG
>TTN-216,,0,85,821827,821911,GTAAGTTGCTTTCTCTGAATACAAAACTATTGTTTGACTGTCTTTAAGAATATTACTTTTTCATCATAACTTCTTCTTTGAAAAG
>TTN-216,,0,94,821912,822005,GTAATTTTTGGACTAGCAGTATTACCTTATTTCTTTTTAAAATTATTCATATAGGTGAAAATCAAAATCTAATTTTTTCATGTTTACTTTTCAG
>TTN-216,,0,318,822006,822323,GTAGGATGTCCTTGTTTTTTCTGATATTACAGCAACTCTTAATCTCAAGCACAGAAGTATTCGATAAATAAGTTAATGTAACATCTAAATCTGTAACATCCAAACTGTATTTAGCAAATATTTTTCCAAATAGACCTTTTACCAAAATACCTAAAAGGTACAAACAATAGTAGATTCTCATTTTTATGAAGGAAAATAAAGAGGACACTAATTGAAAAATTGGATGACCTATATTTGATTAACTGAGAATAGGCTATATAAAATTACACATTGAAGTATCACTAGTAGTAGTTAACTATATGTATATTTTACTTTCAG
>TTN-216,,0,98,822324,822421,GTAAGTCCTTCCCTTAGCATGTGATTCATTCACACTTAATTTCTTATGATTTCCCCACATTCTGAAAAATCAATTAATGACCTTAATGTCATTTGCAG
>TTN-216,,0,98,822422,822519,GTGGGTTACTAAAATGCTTCTCCCTCCCACTTCAAAAATGAATTTGTTAATAGGGATGCTGAGGAGACATGTATATCTGATTTTATGATTCTTTACAG
>TTN-216,,0,310,822520,822829,GTAAGTATTATGCTTTCTTCCTCCTTTTAACCCCAGTCTCCTATTTTAGCAAGGTCAAGATACTAATACCATTTTAATCCACTTCTGAAAGAGATTTCATTTGTAGAGACCGAAATAGTGTAATAAATATCTATCTCACTCATGAAACACTTTTTTGATCTGTCTCATCTTATATGTTTTGCTTTTAATGTACTGAACTACAGGTTCTATGTACATTGGAGCAAATCCATACTAAAACTCTTATGTACATTAACAAAGGGGATTTGATTAGGTTACCTAGGTAATCTTCTAAATTATGTTTTTCTTCTAG
>TTN-216,,0,1157,822830,823986,GTAAGTAGTCTTTGCTTCATTTATGTCATGTGGTAAGTTTATTAGAATTTCTTCTTTTATATGTAGACATTTCTCCCTGAGGAATCTAGCTCTAGAAATTCTTGAAAAACAGTAGAGAACAGTGGCTTTCAAACACATGAGTGGGCCAAAAACACACAGTAAATAAACTTATACAAACACATATATAACTAAAAAACATTTCCTGAAACAATACCCATTTATTATCATGTGCATTCTTATGTTTTCTACCCTATTCTGTGTTTTTAAAAATATTGGCTGTACAACAAACATATGAAGAAAAGCTCATCACCACTGGTCACTAGAGAAATGCAAATCAAAACCACAATGAGATACCATCTCACACCAGTTAGAATGGTGATCACTAAAAAGTCAGGAAACAACAGGTGCTAGAGAGGATGTGGAGAAATAGGAAAGCTTTTACACTGTTGGTGGGAGTGTAAATTAGTTCAACCATTATGGAAGACAGTGTGGCGATTCCTCAAGGATCTAGAACCAGAAATACCATTTGACCCAGCAATCTCATTACTGGGTATATACCCAAAGGATTATAAATCATTCTACTATAAAGACACATGCACATGTATGTTTATTGTGGCACTGTTCACAATAGCAAAGACTTGGAACCAACCCAAATGCCCATCAATGACAGACTGGATAAAGAAAATGTGGCACCACATTTACACCACAGGATACTACGCAGCCATAAAAAAGGATGAGTTCATGTCCTTTGCAGGGACATGGATGAAGCTGGAAACCATCATTCTCAGCAAACACAAGAACAGAAAACCAAACACCACATGTTCTCACTCATAAGTGGGAGCTGAACAATGAAAACACATGGACACAGGGAGGGGAGCATCACACACTGGGGCCTGTCAGGGGTTGGGAGGCTAGGGGAAGGATAGCATTAGGAGAATACCTAATGTAGACGATGTGTTGATGGGTGCAGCAAATCACCATGGCACATGTATACCTATGTAACAAGCCTGCACATTCTGCATATGTATCCCAGAACTTAAAGTATATATTAAAAAAAATTGGTGGTAATACAAGCATTAATTTGCACCAGTATAGCTCTCCACCAGAAGAAACTTATCCACCTTCCCAAAATTAATATCTTTTCATTTTACTTTCAG
>TTN-216,,0,103,823987,824089,GTAAGTTAAGTATTAGACAAATGGCCATCTAAATATGAAGCTCAGAAATATTTTTACGTATCAAATCCTTGTTCTTACATTTCTTTCCTCTTGGTTCATGTAG
>TTN-216,,0,90,824090,824179,GTATGTTTTTGTGAAGGAGAAAAAAAGTTGTTTTCTTTCTAGTTTGTTACTTAATGTAGAAACTGACATCTTCCTTGTCTTCATCTCCAG
>TTN-216,,0,369,824180,824548,GTAAGTTTTGGGGTTTTTTTATTGTTGTTGTTGTTTTAGTATTATGGAGGCACATTTAAATCTCGGAGTCTAAGATTTGGACTCCAAGACACAGAGAGTAGTAGAGATCTGAAGATTACAACTCCCATTTAAGAATATGTTCTATCTCTTACAATGAAGATGACATATTAAAAAAAGAAAAGGACATATAATTTCCTTTAAAGCATACAGCAAGGACTCAAAAGTGCATACTAGTTGGACGGTTATTAAAATGGGATAATTGTCTTCCTGTTGAGCTTGTTACTTAGCAGCAGGGATGATAATGTGAAATATGGAAGTTTAAACTTCTGCTGGTAAGATAAATGGTGAGTGTACCTCTTTTTGTTTTAG
>TTN-216,,0,379,824549,824927,GTAAGATTCTGCTGAGTATTATAGGCAAAGATGTAACAGCATTCATGATGGTCATTTTTCCTAATAAAAAACTAAATATACACCTAAGGAAAAAAGGAAAATTAAAATGATGTTTTGTATATAGACACAAACATTATGATTATGGAGAATCATAATAACATGCTAAATTAAAAAGCAAGATACACAACTGTGGCAACTATATAATTTCAATAGTTATTCAATAGTGCAGTTATTATTTGTCTATTAAAAATAAACAAAATGAAATAACACTAAAATTCCATTCTTGAAAGAAGCAGCATATGAATTTCCCACTATTATTAATAAGGATTACATAATATAGCTTTGCATACATTAAGTCCTTTATCTTATTTCTTTCCAG
>TTN-216,,0,347,824928,825274,GTAACTAATAAACTTCATTGGAATCCCATATTTTACTTTGGATAATGGGATGTAAATAGGATTTACAGAATAATGTGGGAGAAGACATTCATATTCTAATGTGTATTTCCTATGCACAGAATTATTCTTATGACAGAACCACGTTTTAGAGTTAAAAAGAGCTTTAGAAATCACATATTTCAATTACCTAATTTTACAAGTGAAGAAACTAAGATTCTAAAAAATTAACTAACCTCCTAGGTCATATAGGAAATTGACAATAGAAAGACTGCAGCCCAGGTCTCCAGACCTCTACTCTATACTCATTCCCCATTCCACATATTCACTCTTCTTCCTTATTCCTTCAG
>TTN-216,,0,87,825275,825361,GTAGGAACATTTCCCGGTGGTTTTTCATTTTATTTTTTAAAATTATCTTTTAGCCTGGGAAATTAACTTTTCAATCAATTTCTGCAG
>TTN-216,,0,101,825362,825462,GTAAGTGTTCATGAACGAGTTCCATATCCTGTGTTAAAAGCAGCATTAAACACCCAGGAAGGAAGTTTTCATGAAAATTTCCTATCATTATTTATTCTCAG
>TTN-216,,0,889,825463,826351,GTAAGTATTACCAGGGGGAGTACATAAGGCTTTTCCTATTAATCATATTCTAAGAGGGAGACTAGAACTCCCTTAGGTAGATTAATTTATTAACAAGGTGTAGAGCTGGTAACTCCAAGAGTACTTTTTAGGAGAGCTGGGTGGGTACTTTACGGTATTGTGGAACAGGCAAATCAAATGCACATGATTTGTGGTTTTGAAAAGCTTTTCATATATATAAGAATTTCCTGTCTTCAAAAGACATGAAATGAGAGAATTTTATTGGAATGTAAGAATTTTATTTTAGGAATAAAGAGGCCTTTTAACTAAGTAGTGAGCTATTTACTATTCTTAGGGTTTCTGTTTTCCAATCCACCATCTCCCTAAGTATGTGACTGGTGGGCTCTCCATCTTAATTTCCCTTCTTCTTATTTCTTCTATTTGCTTATCCTCCATGATAATTTCCCCTTTATTTGAATTACTTGATATTATATGTCACCCTCCAGGTACTTTTCTTCCTACTATGAAATAATAAAGAGAGCTAGAATATGTGGCAGAATACCTTCATGGAATATAGAAAGGAAAAAACAAGAATGAAAGGGAGCCAAAAATCAATCGTCTACTTTCCTTTTAATATATGTAGCATTTCAGAGTACATAAGGCTCATGAAAGAGGAGGTACAGATCCTCCGGGGGGAAAACCTGGTTAAGCCTAAAGCATAGTGGAAAATGGAAAGATCAACAATTAGTACAGAACAGAAAAATGATTTTGAGGATTGTATTAAGGAAGTTTTAAAGAACAAGAAATCAGCTCTAGAAAATAAATGTATTTTAGGAGTGACAAGGCCAGTCCCTGGAAATACATTTGACTATTAAATTTTTATTTAACTTCTTCACCCAAAATTAAACAG
>TTN-216,,0,92,826352,826443,GTAAGTCTATTTCAAAAAAGAATCATATATATTTTAAAATAGCTTATGTATTTTTTACACATTCATTTCTTATTTACCTACTATTTATCCAG
>TTN-216,,0,90,826444,826533,GTAAGCAAATGAACCATCATCCCATCATTTTGAGTTATATCCTTCCTTTGTTATATGGGGCTTACACTTATCATTTCTCCTTTGCTTTAG
>TTN-216,,0,167,826534,826700,GTAAGGCTCTATGCACACATCTTCATTTTTCCTTTATTGTCATCGAAAGTGCACTCTTGTGTCCCACTCACTAGCTTATCTAAAAATCCGTTAAAAGCTAGAACTATTTGAAAAAGTTAATCGCCTGGCCTTAAAAATAACAGTAATTTATCTCTGCTATTTTACAG
>TTN-216,,0,90,826701,826790,GTAAGTGTCTTAAATTCAGAAGACGTAAAGCAAAACACGGTTTTGAGGAGGCTTCTTATTATAAATCTTGCATTATCTACTTTTTTCTAG
>TTN-216,,0,425,826791,827215,GTATTTTGTTTGTTCTTATCCTACAGCTTTTACATCAAGATTCCTCACAAATATTTCCCTGAGAACAGTTGAACATGTGCTTATCGATAACATTATCTGCTTATACAGAAATGTGTTTTTATTTCAGTACATATGGTTAATGTTTAATTTTATTGAAAATATCCTAATGTAATAGTTAATAAAGTATTTCTTAATTATAATATCTATTTTTGTAAGTTAAAATTGTTCACCAAAAAAGACAACAACTATGCATATTCCAAGAGGAAAAAAAAAATGGCACTATGCTTGGGTAATAAAAGTATAGATACTAGCAAGAATGACTACTTGTTCAATATATATGGATATGTATAAATAATTTGGGCAACACATATATATTGTAAAATCAAGCTGCATTTATACTTGATACATCCCTGGGTCTTTTGTAG
>TTN-216,,0,89,827216,827304,GTAAGTCATTATATGAAGAAAAACCCAGGTGCATGTTTTACATGAAGAAAACTGGTATTTGTTTGACTGGTTTTGCTTTTATGTTTTAG
>TTN-216,,0,91,827305,827395,GTAGGTCCATTTTACTTTTTATGTACTTTTTTTTTTAAAGCAAATTAAGCCTCCTTCCTTTTCTGATTAAAATGTATTTTTTTCTTTGCAG
>TTN-216,,0,91,827396,827486,GTATGTAGAGCATGTGAGGGAATTGACATGGAAACATTTATAGCAGAGTTTAGGAAATCATGGATTTCTAATAAATTTGCTTCCTTTTCAG
>TTN-216,,0,112,827487,827598,GTTAGTATTTGTCTTTTTCAACACCGTTCATTCCAGAGTGCCAATATTTTATCTAAATTACCCAAAAGCCAAACTCTGAATATATACTTTTGTGTCTTTGTTTCTTTCTCAG
>TTN-216,,0,673,827599,828271,GTATGTTTTAAGAATAAGGAAATTCTACATATCCACGTTAATTTTGCTAGAATAGTGTGAGTCATTCTAATTAGTCGTTATTTCATCTTAAATGCTTTTGGGTTCACACCCTTCACACCCCAAACTATTCATACTATGGCACAAAATGGAATCTCTAGTGAAGAGTCTTTCATTGATTAAAAAAACAGAAATTTACGTAGCTAAAATTGGATAATATATGTTGAATTTAAGTATTATTGAATCTAACTGTATATATATGTAGGTATACATGTTTATATATATATATACACAGATTATATATATATAGTATGTGTGTATGACATATATCATATGTGTGTATGTGCGTGTGTACAGAAATTGTATATAAAGTTTTTTAAAAGATTGTTCATCTTGTTCCTCTTTTTTATCCCCATGGTGAATTTGGAGTAAATTTTATCATTTAATCTGGTCATTTTACCCTTAATTTGGATTTGAATGCTATAGCATGTAATGACATAGCTTGTGGGAGCCTTGGTTGGTTCAGAAGCAAAATGGGTTATGTAAAAAGGAAGACTAAAATCAACATAAAAATATGGCCTTCATTTAAAAGTTTTCTTTTGACAATACATGAAGAGTGCACATTTAAAAGTGCTGTAATAATTATTCACTTTCTTTTGATGCTTTGTTTTCTTAG
>TTN-216,,0,105,828272,828376,GTATGTCTAATTTTGTGTAGAAGCAAAATTTGAAATTATTTGCATTGATTTATGTTAATTTTCAGAAACACTTTTTCACTTTCACTTTCTATACTCATTTTTCAG
>TTN-216,,0,92,828377,828468,GTAAGTTGTCCAACTTTTCAAAGATCCAGGTTTTCTTTTACCATAAATGTGTTATTGTCTGTACTAATCTATAGGATTTCTCTCTTTTGTAG
>TTN-216,,0,108,828469,828576,GTACGTATTTGTCATGGGAAGGGCAGTTCTGATAACAAAAATGCAAATCTTACTTCTGCGAAGCAAAATATTATAAGTGCCGCTAATCTGCTTCTCTTATTACCACAG
>TTN-216,,0,1695,828577,830271,GTAAGCATGCTTAGCACTTTGAATCAAAATTGCTATTTAACTCAGTATTTCCGCATACCTTTTCCTGGTTCTAATCCTATAGAATAACTTTTACTCTGTGCCTTAATGGGGTTTTTGGAAGAAATTATGGACTAGCTGGGAGTCTGAGGAAAATTCCTTAAATACCTTTCCAGCCCTCTTGACTTGACTGTAAAGTGAGAGATTTAGACCTCAGGATATCTATGGGCCTTTCCAACTTCAACCTTTTATGATTGATTGTATGAGTTGGTGCTTTCATTCTGTTTTAAATTATCAGAGTCAATAATTAAACCATGGTTGAGTTCCTAGAGAATATTGCTCTTAAATAAGCCACAGACTAAACAGAGACTTCATTTTTTGGTTTTTTTTTTTTTGTTTGTTTGTTTGTTTGTTTGTTTTGAGACAGAGTCTCACTCTGTCGCCCAGGCTGTAGTGCAGTGGCACGGTCTTGGTTCACTGCAACTTCCGCCTCCTGGGCTCAAACGATTCTCGTGCCTCAGTCACCTGAGTAGCTGGGATTACAGGCATGCCCCACCACACCCAGCTAATTTTTTGTATTTTTAGTAGGGACGGAGTTTCACCATGTTGGCCAGGCAGGTCTCAACCTCCTGACCTCAGGTGATCCACCCACCTCGGCCTCCCAAAGTGTTGGGATTACAGGTGTGAGCCACCATGCCTGGTCTAAACACAGACTTTGATGATGATAGTATTAGCAGCAGCTAACATTTATTGAGGAATTTTCATGAATTCTTTCCCTTAGTTCTCACAGCCCTCATATTAGCCATCTTATAGAAGGGAAACTGAGGCTGAGAGTGCTTTTGTAACTTCCCCGTTAGGGATGGAGTGGGAATTCAGACAGACAGACTTCAGAGCCCTCTCTATCATGGTTAGTCCAAAATGCGTATTCTTCACCATTCTGGAAAATAAGTGGCACATTCAACTCAACAATGTTTTGAAAATTAAAACGTCATGAGAGTCAGGTATCCTGTGACACTTTACCTAAAAGATCTCCATTTGCTAAGAGAAAATTGAGCCACTGTAGTGTCTGGGCAAAAGTATCCACTTCCATCTTCATGCTGAGAATCTCAGGGCTGTTCATTATTTATGAATCAGGCTTTGTGGATACTGAATCAGTGTTTATGAGAGTATAAAGCAAGTCGAATTTAGTTATCTTTCTTGATAATTCCAAACAGCATGGCAGAAAATCTGTCCAGTAATTATGTAGCTCTGTGGGTAGAGAATTCAGACTTTAAGTGTCTGACATGAACCATCCACACTTGGATATCAGTGAACTGGGATGGGAAAAGAAAAAGAATAGGAGGTGCGTAGAAGAAAAGGAAAGAAAAGCTAAAGTGAAAGGAAATGTTTTAACAGCTTCTTCCATGATGTTCTCACTACCATATCCCATTTCTTCACTGGAATAAAGCAACTAATGGACTTTAAAACACATGTAAAAGGTGCTTAAGTCCCTGCACAACTCACAGTCTTTCTACCCCATCTGAGATAGAAGAGTGGCCTATAAATTTTTAATTTTTAAATAATAATTGCATAGAATTATAATGATGGTGTGTGTGTATAATTTAATAATGGCCAATGACCTTACTTTAAGGTTGGTGCAACTATTTTTTTTTCCATCCTTATAATATTTTAAATATTTCTCATCTGTTTTTCTTGCAG
>TTN-216,,0,112,830272,830383,GTAGGTGCTGAATACAGACCACTGTCATATTACATTTGCCTAAAGCTTAGTAATTTTGAACAAGTAGGCTTTAAAGAAGTACTAACATCGTGTTTTGTCCTTTCACTGATAG
>TTN-216,,0,236,830384,830619,GTGAGACATGATTTCATTAGAAAACTGAAACGTGAAAAATTTAAAAATAAACTACGCTAACCTGTGCATATGCTTTAATTTTCTTTTATATAACACCTGTCTCATTACCATCCTTTTCACAAGGTGAAAAATATAAAAAATAAAACCAATGTTCTTGGAAAGAATGCGAACATCAAAGGTATAATTTATCAGTAATGTGGATTCTTGTACCTTGTTTTCCCTTCCTTTCTAAATAG
>TTN-216,,0,106,830620,830725,GTAAGTGCTCATACCTGCAGCATCTTCACCTGTGTCTTCTATATTCACCTGTGTGACTAAATTGTACATGATTGTGTAATTATTTTATTGTGAATGGCCATTCCAG
>TTN-216,,0,105,830726,830830,GTATGTACCTACTGGTTTGATTATGTTTTTTAATAAGCATACTTCCAGGAAATCACTCTTTTTTGCTTTTAAAATTCACTGTATGTATCCATTTTATGTCTACAG
>TTN-216,,0,369,830831,831199,GTAAGTGATTATTATTCAAATACATTTAGTTTAGCAATTGAACATATTAGAAACAAATATATCAAGGAATGCTTTTCTTCTCTGCATCACCTTCTTACATATCTTCTTGTCACTAGAGAACTGGTCATGTAAAGCAAGAGGAATTATTTTAAGTCAGTCTAATAAACTAATTTGAAGTTCATTTTAAAGACTATGAAATGGAAAGTTGAAATTAATGACCAATATGAGTTTGGGAGATTGAATAAATTACTTATTATAAAAATTTTACTTATTTATTAAAATTATAGAATAATTGTATTGTTCTTCCATGGATGATTAAGACCTGGTTACAAATGTAATGATGCATTTACCTTCCTTATAATTTTTTAG
>TTN-216,,0,693,831200,831892,GTAAGCATTTACAACTTATTTCCAATGAGACTAAGAGCATTCACATTTTTAAAAAACACATTTGGCCCCTGGCCTGTAAAATGGTAACAGAAACAAATTACCCAAGGTTGCTAAGTGGATGAATTATGTCTTTCTACCTTTCAGATGAAAAGAAGAAAAAAATAATTGGCATCAATTATTTTTTCTATTATTTCACTCCATTCCCATATAAAGAGCATGCAGCAAGTGGGAATGAGTTTTTAGCTTTGTAATTTTCGCCACTTAACAGTACATAAAGAAAAGGTTCTCGAGAATAAGTGTCCATCTTTACTGAAGTTATTAAAATACAACATACATCCAACAACACAATCATCCCCTTGCTTGAATGCAGCTGATGGCCTCTTAAAAGAACTTGTGTGACTGTGCAGCAGTATTAGGAAGTACATGATCTGTAAATGTTTCACTTTCCTTTTTACAAAGAGCAATGCAAAATTAAAAACATGACAGGCATTACAAAGGGAATAATAATAGGCAAATATTTAACCCCATAGTCCAAATTCTCAATTATCAATCCTACTTTCAAAATAGGCTTTGGTAGCACAGTAGAAGTCACTACTCTTCCTGGCCTTGTGATATGGCACTACTGAAAAATATATATTTATGTATGTCTTTATTAAGCCAAACTAATACATAGTATTTCTCTTTCTTTTATAG
>TTN-216,,0,116,831893,832008,GTACTTTTAAAATAGCTTCTTAATGCTACAATTTATGAACTTGGATTAGAGACATGCCTAGTTGTATTTTAATGGACAAGGAAAAAGAAACTAACTCTAGAAACTTTTTCTTATAG
>TTN-216,,0,96,832009,832104,GTAAGTTTGCGTTTTTACTAAGCGGTACTATGTCAAAAGTTTAACCTTCCAAGCAAATGCATCTAATTGATTTGGGGTTTTGTTTTTGTTTTACAG
>TTN-216,,0,101,832105,832205,GTAAGAAAAATAAAAATCCTATTTCAAAGTCTCTATTATTAAATGTTTCCCCTGAATTTTATAAAATTGTATTCATACTTAATACCTTTGTTTATATTTAG
>TTN-216,,0,97,832206,832302,GTATGTATCACAATTTAAGGGCATATTTGTTTATTATTACTGATTCTAGTAGAACTCAGAGTGGTATATTTTAACCTTATTTTTGCATCCCTTCCAG
>TTN-216,,0,97,832303,832399,GTAGGAAATAGTCAACATTCTCCTTTTTAAAATTATCTCAATTTATGTGAAAATAAACTCTCAGATATTCATTCATATCTGTTTTGCCTACTGACAG
>TTN-216,,0,95,832400,832494,GTAAGCATGTCAAATGTTCTCACATTTATATAGCATTTTCCAGTGTGGGCAGAAAGAATGATCTTCATCATGGCTTGTCATTACACCTGTTTCAG
>TTN-216,,0,126,832495,832620,GTAAGTATTAACACTTTTAAATAATTTGACAGTTGAAATGTAATAGAATCAGGGGGAGAAGGGAGAAGGGCAGTCTTATCAATAGTAATTTTGTGCAATTCTCATCATCCTTATTTTCATAAACAG
>TTN-216,,0,881,832621,833501,GTGAGCTCCAAGAATCATACATAAATACAATGCTCCTCAAAACTATATGACAGATAATTTTCCAACACACAATCTCTAAGAATTTTTAGAATTTATGAATGGTCTAGAAAAGCACATGCTTATTTGCATGATCATAAATATAGCTTAAGTCAGAGAACATTTTAACTATTACATCTGTTAAGTTAGCAATTAGAATTGCTAAAAGTTGTACAGCATTTTCCAATTAATGAAAAAATATTCTATCAATATGAAAAGAATCTATTTTATAAATTTTCCTTAGAGAAAAATGCATTGTACTGTAATAACTGAAAAGAAAAATGGCAAAACTCCTTTTAAGAAGAGGTTTAGCAGGAACATACAGTTTCTAGTGGTTTCATAAGTTACTGACAAAGTAATTGTGACAAGAGCTTCAAAAATAAGTGGCAAATCCTTTTACAGAGTCTGAGCCCAAGAACTATAAAGGAATAGTCACTGGGACTGAATTGGGGAAGCTAAGGAAACCAATTCTTGTATTCATTAGAAATGTATTGGTGGCAAGTGATACTAACCCAGTGAAAGATAAGCAACTAAAGAAAAGTCCCTAAGAATGGGTACTTTAAGTAATGAGCTTAGCTAATAGAGAACACACAGTAAAGCTGGCCAAAGAAGTAGGGAAGAAATATCTACTTTCCTAAAGCAATTTAATTCTTAAGATAATAATATTAAATTATAATGTGGCACTCTGTGCTGTCCTATAATATCAGGAGCCCAGTTAATAAAGATTATCTTGGTGAGTGTGGACAAGAGCAATAATGCCTTTGTGAGTCTTGAAAACAAAAAATACAAATCTCAACATTTCCTTATTTGCCTAATATCTGCATCTCACTTTTTAAATTCCACAG
>TTN-216,,0,85,833502,833586,GTATTTATCACAGAAGCTTTTAGGTGAATTATTTTCTTCTCACACCTGTCCATGAATTAATTAAATTTTGTCATTAACTTTCCAG
>TTN-216,,0,171,833587,833757,GTAAGCATTTTACTTAAAATTGGCTATACAATGAGTAGATCCTCTAAAACAATATAGCTTGACCTATGATTGATCACCTCTCTAGAAAGGAACTATGTTGATTATATTTCCCCAAGAAAAAAAAAGCTATCAGGCAAATAGGAAATATGAATCTTTCATTCTGTTTTTCAG
>TTN-216,,0,119,833758,833876,GTATGTACCAAATAGCCAAAAAAAAAAAAAAAGTAAAGTAAAATGAAAACATTCAGAATTCGTAACAATTTACCATAAAAATAATGCTTAAGAATAAATGCCTGATTTCTTTCCCATAG
>TTN-216,,0,98,833877,833974,GTAAGGATGTGTGACAAAGATACAAGCAAGTTGATGTTCAGTCACCCAATTTTGATTTGAAGTAAAAATTAATTTCCTGTATTTCTTCTCTTTCATAG
>TTN-216,,0,679,833975,834653,GTAAGTCCACAGGCCCTTCCACCACTCTCCCCACCTCTGATTCTGAATGTTAACAAAAAAGAATTTGTTTTTAATATGCCCTAATGTAAATAAAAATAGGTCACAAAATTAACCCTGTGGTCTTTCTAAGGTTTCTAAACCTCCTTTTCTCAGGTTTCTAAACCTCCTTTTCTCAGAGGTTTTCAACACACTTAGGCTTGATTTTTTTTTTAATATCTTCACTCTTATGAAAGAGAAGAGGAGGGAGTTAGGAAGAAAGGAATGGAAGGAAGAAAAGAGAGAAGGGAAGGAGGAAGAGAGGAAAGGAAGGAGGACTGGCAATGTTATAGTGAGAAAAAAATACAGAGTGCATGCTTAATAAATGTAGAATTGAAGAAAATGAGGAACAGCAAGGAAAGTACAAAATTAAACCTCAGCATCATGCAATATACCCATGTAACAAACTGCACATGTACCCCTGAAGCTAAAAGTCAAAAATTTTTAATAAAAATAATTAAATAATTAAATGATTTAAATTAAAATTTACAAATAGTACAAAAGTGAAACTATTGGAAAAATAGTCATGTGCCTTATGTACCTTTTAAAATACCAACCAAAACCTAAGGAAAACACAAATATATGAGTCATTGTTTTAACGTATTCATATTGCCATATCGTGTTAACCTCTGTCTTGCTGCAG
>TTN-216,,0,911,834654,835564,GTAAGGACATTTTGTATCAGTCAAATTGATTGAGTTACAATTTATATGTGGGAAAATTCACCTTTTTGAAATATATAGTTCTATGACTTTTGAAAAATGTACTGTTTTGTAATCACCACCACAATCAAAATGTGGAATATTTTTATTACCCCGTAAAGTTCCCTTGTGTCCGTTTGTAATCAGTCCCTTCCCCACCCCAGCTGCTAGCGATTTCTGGCAAATAATTTTTAATATTCTTCTCTGGAGTCAATTTCCACTTCTTTAAGATGAGATTCATAATATATGCTTTCTATCACACTTAAAATTTTAAAACAAGTTAATATTTCTGGAAGCACTTTAAAAACTGCTGATAAATGTAAGATAATAATAGTGATTACAAATGAAGCACATTTAAGAGAAAGGAAAGTGAAAAAATGTTAAGTATTTTTAGCTGATAAAATGAATAAAATTTTCTTTTTTCTTTCTTTTGTTTTTTTGTGTTTTTTTGAGACAGAGTCTCACTCTGTCACCCAGGCTGGAGTGCAGTGGCATGATCTTGGCTCACTGCAACCTCTGTCTCCCAGGTTCAAGCAATTCTTCTGCCTCAGCCTCCTGAGTAGCTGGGATTACAGGTGCCTGCCACCACGCATGGCTAATTTTTATGTTTTTAGTAGAGACGCGGTTTCACCATGTTGGCCAGGCTGGTCTTGAACTAACTCCTGACCTCAAGTATCTGCCCACCTTGGCCTCCCAACTTGCTGTGATTACAGGCATGAGCCACCACACCCAGCCATGAATAAAATTTTCACAAGACAAAAAAACAGGCTAATGTTAACAGTCCGTTTCAACAACTCATTGAATTTGTTAGGTGGCACAGCTAATTTTCAACTTTGCAGCAACTTTAACCAGTATATTCTTATTCTTATTCTCAG
>TTN-216,,0,101,835565,835665,GTGAGACATATGATCATTTGCTTTCTGCAATAATTGCCATAGACTTATTTCTTAGTCCCCCTACCCCAAATGCTAAATTGAAACCCTACCTTTTTTTCCAG
>TTN-216,,0,130,835666,835795,GTAAGTGCCCTTTCAACCACAAAATTATAAACATTATTTCAGCACTTTTCTGTTTTTAAATGAAAGTCATTGGCTTATAATACTTGGGACTGTATTCTAATACATGTGTGCTTTCCACTTATATTTACAG
>TTN-216,,0,106,835796,835901,GTAAGGAATTCAGAAGAAGGGGTTAAATTAAAGAAGCAAGCCATGTTTGGTCCTTTTATTTCACCAGTAAAGCTGACTCCCTTTTCATTATTTTAAAATATTTCAG
>TTN-216,,0,622,835902,836523,GTAAGTAGCCTTTGGTTCTCTACTTATGATTTACAAACTAAACAAGTTAAGGCTAATTCCCCCTCTATACTAAGTAGAACCCTGGAAAGCTTTATTGGAGAGCAAGTGTTAAGAAAGAAAAGCAAGTACACACACAGGAAATATGACAAGTTCTACAGGAAACCATTCCAAGCACACAACCTCAGCAGATGTTAGATGGAGTGAACTGAGCACTTTCCTTGAGTAATTCCCTCTAATGCAATGGTTTCTTTTTAAAAATATTTCCCAACAAGATTTGAAAGGTCAACAATTGTATGCCACTTCAATGAACCTAAGTAAGGGCAAGAATACTACAGAATTATAGAGAGAATTTACAGTCCCTTAAAAGCCTATACATTATTAATCCCCTTCCAATCATAAAGAGAAAAAAACACTCTACATAAAATGTGACGATGTGCTCATTGAATCCCTATTTACCATATGATCCTAGGAAAATCACTTCAAAGAGTTTTTAAGAATTAGGCTAATATGTAAATCATGGTATGTGTCAGTAAATAAGGTAAATTCATTCCTGATATACAAGGACAAAGGATTACAGATTGAGTATTAACAGTCACTTAATATTATCTTTCATATTGTTCAG
>TTN-216,,0,98,836524,836621,GTATTTTATTTTTATTTTCAGTGCTTTTTATTTTTAAAGAAAAAAAAATCTCAAAAACACACTATGAAAACCACCACAATTGTATTTTCCCCCAACAG
>TTN-216,,0,362,836622,836983,GTGAGTACAACTTGATTTCTGTATCTTCCTATGGTAAAGTTCCATCTTTGCATAAAATTCTTTTAAACAGAAAGAAATTTTGAAAGGAAATAGCAAAGATTCAGATAAAGTACAAGTGCCTTTTCTTTCACTTTAATTGAATGTTTGCATATCTAAAAGGAGAAATATATATCCTAACCCCATTGTAAAAATAGAACTTTGGTTTTTGATATGTCTTAGTATAAAGTAACCAATTTCATCTTTCTGGAATAGCTATTTTTTAACAAAATTTTGGACTCATATAACATTCTTTTTTAAAAAAATAAGCTTTAATAAAGCTGCCTGTTTCATCTCATGACTCAAATCTTTTTTTTGTTTAATAG
>TTN-216,,0,132,836984,837115,GTAAAAATAAATAAATTATCATCAAGTTGAGGCTAAATGAGTTATTAACTTGGGGGTGGAGGCTATTGCACTTAAACACATACTGTTAGATGTTGCTAAATTATATTCTTTTTTTTTTTTTTTCTGATACAG
>TTN-216,,0,124,837116,837239,GTAACCAGTTCTTAAATGTCTCTTTCTTTTATCTTCTAAAATATTTTATCTTCTAAATTCAGCTTCCCAAAAAAAGCTTAAAATGAAATCACTTTTTAAAACACAAATCATTTGCATTCTACAG
>TTN-216,,0,740,837240,837979,GTAGGTTGGCTTTTGTTTTTACCCACATTTCTTCAGAAGATAATATTAGGGAAATATTTTCAAACATCCCCCCTTATATACACATACAAGAAAGTATTAAAATAAAATTATTTTCCTAATTCCAGAATACAATTTGTACACCAAAGCAGAAACACACATTTGAAGTTAGCATATGCTTTTCTATGAGCATAAAAAGCAGTTATTAAGTACCTAGTTATATGTGGTATTATATAAGATTCCATAGTGTCAGCCCCTGCTCCCAGGAATATTTAAGAATAAAGTCAGTGAATATACAAAATGGCACTACTTGCCTAAACCTTCACAGTTGCTAATTTTCCAAAGCAGTGCAAAGTTAATTAAAGAACTATTTCTATTTTACCAATTAAAATTAGTTTGCTTTCATTTCAATCTTCTGAAAGATAATTTAATGTTTTGGTTACTCAAAATCTCCCAAATCCACTTATCTCCTAAATCCGTTGACTATTCTTTTCAAGACTTTTTTCCTTAAGTCATATGAATCATCTTTGGCTCAGTTTAGTTTAAGGAATCATTACAGTGATCTCAAAAGTCACACATGATAATTTTCCAAAAGTGGAACTGAGAAAGTATTAGGTATTACCTACATTGCATGAAGAAGTTGACTTTTTTTCTTTTTATGTTTTTCACACGCAGAATCTAGAAGAGTAAAAGGTGGGGGTCTCTTTCTAATTAAGTTTGCCTTACAGAGGTTTCTTTTTTAG
>TTN-216,,0,100,837980,838079,GTAAGTTTAATTATGAATATATTATTGAAGAAAAACTAAAATACCATGTCTTCCACATCTGAAGAACTTCAACATTTCTTTTCTTTTTCCTTTGTCTTAG
>TTN-216,,0,525,838080,838604,GTAAGTATCTCCTCACCCTTCTTCCTTACATGTTTAAGGCCTTTAGATCGTTTTTTTGCCTCTCTTTCAAGCACAGAAAACTCTAAGAAGCCTTATTAAATTCCATGTGAAAGAGGGACAGCCAACTGATGTGAATTCATTCTTGTAGTCAAACTTTCTTTATAGCTACACAGAAACTTGGATAGATTACATTTCAAAGTAAAGCTACCAACTGCCGTGTAACATTTATTTGCAGGATGCACAATATGTCAATTACTTTCTATATGACTAATCATTTTTCTCCTAGTGATTCCTAGCACCTGCATGTAATGTAATGATAGAAATATAAGGATTCATGTTTTGGAGACATTGAGCTAGCTCTTGACAAATGTATGTATATATGTATTTGCTTATGCTTCAACAGCAAATTGTTTGGGTTATGCTGCTGTGTGTGTGTTGAAGTTTCCATTTCTGTAAGTCAGCGTCATATGTCATCAATTAACCAGATGTCATTGATGTTCACTGTGTATCTGCTATGCTCCACAG
>TTN-216,,0,138,838605,838742,GTGAGCAATAAAATTACTGGTAGAGGTAGACAAGCCAAGTAACATGGTGTAGTCTTTAGTACACACAATTCAGTAGAAAGCAAATCTTTATTTTTTTCAGTGATTCTAAGACCTTTTTTTTGTCATTGTTCCATAAAG
>TTN-202,ENSE00001465556,1,212,838743,838954,GAGCAGTCGTGCATTCCCAGCCTCGCCTCGGGTGTAGGGATTGCATAGAAAAGCAAAACTACACAGTCTTGACTGTGTAGTTTTGTTTTTAGGATTAGAGGCTCACCGATTCATGTCGGAGATGGTCAGAAAAACCAACTCTCCATAGGACGTCGTTTCAGAAGCAACCTTGGGCTTAGTCCCACCCTTTTTAGGCACTCTTGAGAAATCAG
>TTN-202,ENSE00003502146,1,104,838955,839058,AGTGCCTAGAAAGATGACAACTCAAGCACCGACGTTTACGCAGCCGTTACAAAGCGTTGTGGTACTGGAGGGTAGTACCGCAACCTTTGAGGCTCACATTAGTG
>TTN-202,ENSE00003807606,1,204,839059,839262,GTTTTCCAGTTCCTGAGGTGAGCTGGTTTAGGGATGGCCAGGTGATTTCCACTTCCACTCTGCCCGGCGTGCAGATCTCCTTTAGCGATGGCCGCGCTAAACTGACGATCCCCGCCGTGACTAAAGCCAACAGTGGACGATATTCCCTGAAAGCCACCAATGGATCTGGACAAGCGACTAGTACTGCTGAGCTTCTCGTGAAAG
>TTN-202,ENSE00003810976,1,288,839263,839550,CTGAGACAGCACCACCCAACTTCGTTCAACGACTGCAGAGCATGACCGTGAGACAAGGAAGCCAAGTGAGACTCCAAGTGAGAGTGACTGGAATCCCTACACCTGTGGTGAAGTTCTACCGGGATGGAGCCGAAATCCAGAGCTCCCTTGATTTCCAAATTTCACAAGAAGGCGACCTCTACAGCTTACTGATTGCAGAAGCATACCCTGAGGACTCAGGGACCTATTCAGTAAATGCCACCAATAGCGTTGGAAGAGCTACTTCGACTGCTGAATTACTGGTTCAAG
>TTN-202,ENSE00003809662,1,86,839551,839636,GTGAAGAAGAAGTACCTGCTAAAAAGACAAAGACAATTGTTTCGACTGCTCAGATCTCAGAATCAAGACAAACCCGAATTGAAAAG
>TTN-202,ENSE00003809782,1,245,839637,839881,AAGATTGAAGCCCACTTTGATGCCAGATCAATTGCAACAGTTGAGATGGTCATAGATGGTGCCGCTGGGCAACAGCTGCCACATAAAACACCTCCCAGGATTCCTCCGAAGCCAAAGTCAAGATCCCCAACACCACCGTCTATTGCTGCCAAAGCACAGCTGGCTCGGCAGCAGTCCCCATCGCCCATAAGACACTCCCCTTCCCCGGTCAGACACGTGCGGGCACCGACCCCATCTCCGGTCAG
>TTN-202,ENSE00003805863,1,331,839882,840212,GTCCGTGTCTCCAGCAGCAAGAATCTCCACATCCCCCATCAGGTCTGTTAGGTCTCCATTGCTCATGCGTAAGACTCAGGCATCCACCGTGGCCACAGGTCCTGAAGTGCCTCCCCCTTGGAAGCAAGAGGGCTACGTGGCCTCCTCATCTGAGGCTGAGATGAGAGAGACAACGCTGACAACCTCTACTCAGATCAGGACAGAAGAGAGATGGGAAGGGAGATACGGTGTCCAGGAGCAAGTGACCATCAGTGGTGCTGCGGGTGCTGCCGCCAGTGTGTCGGCCAGTGCTAGCTACGCAGCAGAGGCTGTTGCCACTGGTGCTAAAGAG
>TTN-202,ENSE00003803639,1,153,840213,840365,GTGAAACAAGATGCTGACAAAAGTGCAGCTGTTGCGACTGTTGTTGCTGCCGTTGATATGGCCAGAGTGAGAGAACCAGTGATCAGCGCTGTAGAGCAGACTGCTCAGAGGACAACCACGACTGCTGTGCACATCCAACCTGCTCAAGAACAG
>TTN-202,ENSE00003810843,1,138,840366,840503,GTAAGAAAGGAAGCGGAGAAGACTGCTGTAACTAAGGTAGTAGTGGCCGCCGATAAAGCCAAGGAACAAGAATTAAAATCAAGAACCAAAGAAGTAATTACCACAAAGCAAGAGCAGATGCACGTAACTCATGAGCAG
>TTN-202,ENSE00003803899,1,126,840504,840629,ATAAGAAAAGAAACTGAAAAAACATTTGTACCAAAGGTAGTAATTTCCGCAGCTAAAGCCAAAGAACAAGAAACTAGAATTTCTGAAGAAATTACTAAGAAACAGAAACAAGTAACTCAAGAAGCA
>TTN-202,ENSE00003808716,1,138,840630,840767,ATAAGACAGGAAACTGAGATAACTGCTGCATCCATGGTGGTAGTTGCCACTGCAAAGTCCACAAAACTAGAAACAGTCCCGGGAGCTCAAGAAGAAACTACCACACAACAAGATCAAATGCACCTAAGTTATGAAAAG
>TTN-202,ENSE00003809802,1,138,840768,840905,ATAATGAAGGAAACTAGGAAAACAGTTGTACCTAAAGTCATAGTTGCCACACCCAAAGTCAAAGAACAAGATTTAGTATCAAGAGGTAGAGAAGGCATTACTACCAAAAGAGAACAAGTGCAAATAACTCAGGAGAAG
>TTN-202,ENSE00003805623,1,138,840906,841043,ATGAGAAAGGAAGCCGAGAAAACTGCCTTGTCTACAATAGCAGTTGCTACTGCTAAAGCCAAAGAACAAGAAACAATACTGAGAACTAGAGAAACTATGGCTACTAGACAAGAACAAATCCAAGTTACCCATGGAAAG
>TTN-202,ENSE00003801659,1,294,841044,841337,GTGGACGTTGGAAAAAAGGCTGAAGCTGTAGCAACAGTTGTTGCTGCAGTAGACCAGGCCCGAGTCAGAGAGCCCAGAGAGCCTGGGCATCTTGAAGAATCCTATGCTCAGCAGACCACTTTGGAGTACGGATATAAGGAACGCATTTCCGCCGCAAAGGTAGCTGAGCCTCCCCAACGTCCAGCCTCAGAACCCCACGTTGTCCCTAAAGCAGTCAAGCCTAGAGTAATCCAGGCTCCTTCTGAGACTCATATCAAAACTACTGATCAAAAGGGAATGCACATATCATCACAG
>TTN-202,ENSE00003804455,1,123,841338,841460,ATCAAGAAAACTACAGATCTAACAACGGAAAGATTAGTCCATGTGGATAAACGCCCCCGCACAGCTAGCCCTCACTTTACTGTTTCAAAAATTTCTGTTCCTAAGACAGAACATGGATATGAG
>TTN-202,ENSE00003810306,1,282,841461,841742,GCATCAATAGCCGGTAGTGCTATTGCCACATTACAAAAAGAGTTGTCAGCCACATCTTCTGCTCAGAAGATCACCAAATCGGTGAAGGCTCCTACTGTGAAGCCCAGTGAGACTAGAGTAAGGGCAGAGCCCACACCCTTGCCACAGTTCCCCTTCGCTGACACACCAGATACTTACAAGAGTGAAGCTGGCGTTGAGGTGAAAAAGGAAGTAGGGGTGAGCATCACTGGCACCACCGTCCGTGAAGAGCGCTTTGAAGTACTGCACGGACGCGAAGCCAAG
>TTN-202,ENSE00003805296,1,66,841743,841808,GTAACAGAAACAGCAAGAGTACCAGCACCTGTTGAAATTCCTGTTACTCCACCAACTTTGGTCTCG
>TTN-202,ENSE00003806123,1,259,841809,842067,GGCTTAAAAAATGTGACTGTCATAGAAGGTGAATCTGTCACCTTGGAGTGCCACATCTCTGGATACCCATCCCCGACAGTGACATGGTACAGGGAAGACTACCAAATCGAAAGTTCCATTGACTTCCAGATAACCTTCCAGAGTGGAATTGCTCGTCTTATGATTCGCGAAGCATTTGCGGAAGACAGCGGGCGATTTACTTGCAGTGCTGTAAATGAGGCTGGAACCGTCAGCACATCCTGCTATCTGGCTGTGCAGG
>TTN-202,ENSE00003808554,1,64,842068,842131,TGTCAGAAGAATTTGAAAAGGAAACCACAGCCGTGACTGAGAAATTTACTACAGAAGAGAAACG
>TTN-202,ENSE00003804962,1,216,842132,842347,CTTTGTTGAGTCAAGAGATGTGGTTATGACTGATACTAGCCTCACAGAGGAACAAGCAGGGCCTGGAGAACCTGCCGCGCCTTACTTTATTACAAAACCAGTGGTCCAGAAACTGGTGGAAGGTGGGAGCGTGGTGTTTGGATGCCAAGTTGGCGGCAACCCAAAGCCCCATGTATACTGGAAAAAATCTGGTGTTCCTCTAACCACTGGATACAG
>TTN-202,ENSE00003804165,1,143,842348,842490,ATACAAAGTGAGTTACAACAAACAAACCGGTGAATGCAAGCTGGTGATTTCTATGACTTTTGCTGATGATGCTGGAGAATACACTATTGTTGTTCGCAATAAGCATGGAGAAACTTCTGCATCTGCTTCCTTGCTTGAAGAAG
>TTN-202,ENSE00003802603,1,206,842491,842696,CTGATTATGAGTTACTGATGAAGTCCCAGCAAGAAATGCTTTATCAGACACAAGTGACTGCATTTGTTCAAGAACCTAAAGTTGGAGAAACAGCACCTGGATTTGTATACTCTGAGTATGAAAAAGAGTATGAAAAAGAACAAGCCTTAATTAGGAAGAAAATGGCCAAAGATACTGTAGTGGTCAGAACTTATGTAGAAGATCAG
>TTN-202,ENSE00003807963,1,234,842697,842930,GAATTCCATATTTCTTCCTTTGAAGAGAGACTTATTAAAGAAATTGAATATAGAATAATAAAGACTACATTAGAAGAACTTCTTGAAGAAGATGGAGAAGAAAAGATGGCAGTTGACATTTCTGAATCTGAAGCTGTTGAATCAGGATTTGATTCAAGAATCAAGAATTATAGAATTCTTGAGGGGATGGGTGTCACTTTTCATTGCAAGATGTCTGGATATCCATTACCAAAG
>TTN-202,ENSE00003808968,1,245,842931,843175,ATTGCTTGGTACAAAGATGGCAAGCGCATCAAACATGGAGAAAGATACCAAATGGACTTTCTACAAGATGGCAGAGCTAGTCTGCGTATACCTGTTGTTCTTCCAGAAGATGAAGGAATCTACACTGCATTTGCCAGCAATATTAAAGGAAATGCAATTTGCTCAGGGAAATTGTATGTGGAGCCTGCTGCACCACTTGGAGCTCCGACTTACATTCCCACACTAGAGCCAGTGAGCAGAATCAG
>TTN-202,ENSE00003802614,1,272,843176,843447,ATCTCTCTCTCCACGTTCAGTGAGCAGGTCTCCTATACGCATGTCTCCTGCACGGATGTCACCTGCAAGGATGTCTCCTGCACGGATGTCCCCTGCAAGAATGTCCCCTGGACGTAGGCTGGAGGAGACAGATGAGTCACAACTTGAGAGACTATATAAACCAGTCTTTGTGTTAAAACCTGTTTCTTTCAAATGTTTAGAAGGGCAAACTGCCAGATTTGACTTAAAGGTTGTTGGTAGACCTATGCCAGAGACGTTCTGGTTTCATGATG
>TTN-202,ENSE00003811446,1,165,843448,843612,GCCAGCAAATTGTCAATGACTATACCCATAAAGTAGTCATTAAAGAAGATGGTACTCAATCACTAATTATTGTCCCTGCCACACCCAGTGATTCTGGGGAATGGACTGTGGTTGCCCAAAACAGGGCAGGCAGATCTTCAATTTCAGTGATTTTAACTGTGGAAG
>TTN-202,ENSE00003805710,1,169,843613,843781,CTGTGGAACATCAGGTAAAACCGATGTTTGTAGAAAAACTGAAAAATGTCAATATAAAGGAAGGTTCCCGACTTGAAATGAAAGTCAGAGCTACGGGTAACCCCAACCCTGACATTGTATGGTTGAAAAACAGTGACATCATTGTGCCTCATAAATATCCCAAAATCAG
>TTN-202,ENSE00003809358,1,1694,843782,845475,AATTGAAGGAACCAAGGGAGAAGCTGCCCTTAAAATCGATTCCACTGTCAGCCAAGATTCTGCCTGGTATACTGCGACTGCTATTAATAAAGCTGGCAGAGACACTACAAGATGCAAAGTAAATGTTGAAGTTGAGTTTGCAGAGCCTGAGCCAGAGAGAAAGTTAATCATCCCACGGGGGACATATAGAGCAAAGGAGATTGCAGCCCCAGAACTGGAGCCCCTCCATTTGCGATATGGCCAAGAGCAATGGGAAGAAGGTGATCTCTATGACAAAGAGAAACAACAGAAACCATTTTTCAAGAAAAAACTCACTTCCTTAAGACTTAAGCGCTTTGGGCCTGCCCACTTTGAATGCAGGCTAACACCCATTGGTGACCCAACGATGGTGGTGGAGTGGCTCCATGATGGAAAGCCACTTGAAGCAGCCAACAGGCTCCGTATGATCAATGAATTTGGGTACTGCAGCCTTGATTATGGCGTTGCATATTCTAGAGACAGTGGTATCATTACTTGCAGAGCCACTAACAAATATGGAACAGATCACACATCTGCTACCCTTATTGTTAAAGATGAGAAAAGTCTTGTGGAAGAATCCCAATTGCCTGAGGGGAGGAAAGGCTTACAGAGAATTGAAGAATTAGAGAGAATGGCTCATGAAGGTGCACTTACAGGTGTAACAACAGATCAGAAAGAAAAGCAAAAGCCAGACATTGTCTTGTACCCAGAGCCAGTTAGAGTACTTGAAGGGGAGACTGCAAGGTTCCGCTGCAGGGTAACAGGCTACCCTCAGCCCAAAGTCAACTGGTACCTCAATGGACAGCTCATCCGCAAAAGCAAAAGGTTCAGAGTTCGCTATGATGGTATCCATTACCTGGACATCGTGGACTGCAAATCATATGACACAGGTGAAGTGAAGGTCACCGCGGAAAATCCTGAAGGTGTGATAGAGCATAAAGTGAAGCTTGAGATTCAACAGAGGGAAGATTTTAGGTCTGTCCTTAGGAGAGCTCCTGAACCAAGGCCTGAGTTTCACGTACATGAACCAGGAAAGCTTCAGTTTGAAGTACAAAAAGTGGATAGACCTGTTGACACCACTGAAACCAAAGAAGTTGTGAAGTTGAAAAGGGCTGAAAGAATTACCCATGAAAAAGTGCCTGAAGAGTCGGAAGAGCTGCGCAGTAAATTCAAGCGCAGAACAGAAGAGGGCTATTATGAAGCCATTACCGCTGTGGAGCTCAAGTCTCGAAAGAAGGATGAATCCTATGAGGAACTCCTCAGGAAGACAAAAGATGAACTTCTCCACTGGACCAAAGAGTTAACTGAAGAGGAAAAGAAAGCTCTTGCCGAAGAAGGCAAAATCACGATTCCAACTTTTAAACCTGACAAGATTGAACTAAGTCCTAGTATGGAGGCTCCAAAAATCTTCGAAAGAATCCAGAGCCAAACAGTGGGCCAAGGATCTGATGCACACTTCCGGGTCAGAGTCGTGGGGAAACCAGACCCCGAATGTGAATGGTACAAAAATGGTGTCAAAATTGAACGGTCTGACCGGATCTACTGGTACTGGCCCGAAGACAATGTTTGTGAATTGGTCATAAGAGATGTGACTGCTGAGGACTCTGCCAGCATCATGGTAAAAGCCATCAACATAGCTGGAGAAACCTCCAGTCACGCATTCTTACTTGTCCAAG
>TTN-202,ENSE00003809440,1,282,845476,845757,CCAAGCAATTGATCACTTTCACACAGGAATTACAAGATGTTGTTGCTAAGGAAAAAGACACTATGGCAACCTTTGAATGTGAAACTTCAGAACCATTTGTCAAAGTGAAATGGTATAAAGATGGTATGGAGGTTCATGAGGGAGATAAATACAGGATGCACTCTGACAGAAAGGTTCACTTCCTCTCCATACTGACCATTGATACGTCTGATGCTGAAGATTACAGCTGTGTACTTGTGGAAGATGAAAATGTCAAAACGACTGCTAAACTTATTGTTGAAG
>TTN-202,ENSE00003802960,1,267,845758,846024,GTGCAGTTGTTGAGTTTGTGAAAGAACTTCAGGACATAGAAGTTCCAGAATCATATTCAGGAGAATTAGAGTGCATTGTATCCCCAGAAAATATAGAAGGAAAATGGTATCATAATGATGTGGAGCTTAAATCCAATGGCAAATATACAATTACATCTCGTCGTGGACGTCAGAACCTCACGGTCAAGGATGTAACCAAGGAGGACCAGGGAGAATACAGCTTTGTCATCGACGGGAAAAAGACAACCTGTAAATTAAAGATGAAAC
>TTN-202,ENSE00003804241,1,273,846025,846297,CCCGCCCCATTGCTATCCTACAAGGACTTAGTGACCAAAAAGTCTGTGAGGGTGACATTGTTCAGCTTGAAGTTAAAGTCTCCTTGGAAAGTGTGGAAGGCGTCTGGATGAAAGACGGCCAAGAAGTGCAGCCCAGTGACAGGGTTCACATTGTGATAGACAAACAATCTCATATGCTGCTCATTGAAGACATGACTAAGGAAGATGCTGGAAATTACTCTTTCACCATTCCAGCCCTTGGCCTCTCCACCAGTGGGCGTGTCTCTGTCTATA
>TTN-202,ENSE00003806988,1,264,846298,846561,GTGTGGACGTGATAACACCTCTAAAAGATGTTAATGTGATTGAAGGCACCAAGGCTGTGCTTGAATGTAAGGTGTCAGTCCCTGATGTGACTTCTGTTAAGTGGTACTTAAATGATGAACAAATCAAGCCTGATGACCGTGTACAGGCCATTGTGAAAGGTACTAAACAGCGACTAGTCATTAACCGAACTCATGCTTCAGACGAAGGACCTTACAAGCTGATAGTTGGCAGAGTTGAAACCAACTGTAATCTCTCTGTAGAAA
>TTN-202,ENSE00003804968,1,261,846562,846822,AAATTAAAATTATCAGAGGTCTTCGTGACCTTACCTGTACAGAAACTCAAAATGTGGTGTTTGAGGTTGAGCTGTCCCACTCTGGAATTGATGTCCTGTGGAATTTTAAGGACAAGGAAATCAAGCCCAGTTCTAAATATAAAATTGAAGCACATGGAAAAATATATAAATTGACAGTTCTAAATATGATGAAAGATGATGAAGGAAAATACACATTTTACGCGGGAGAAAATATGACATCTGGAAAACTTACTGTGGCAG
>TTN-202,ENSE00003809850,1,261,846823,847083,GTGGGGCCATCTCCAAGCCACTCACAGATCAGACCGTAGCTGAATCCCAGGAAGCTGTGTTTGAATGTGAAGTTGCCAACCCAGATTCCAAAGGCGAATGGTTGAGGGATGGCAAACACCTACCACTGACTAACAACATCAGAAGTGAGTCTGATGGCCACAAAAGGAGACTTATCATTGCTGCCACCAAATTAGATGACATTGGAGAATATACCTACAAGGTGGCCACCTCCAAAACATCTGCCAAACTCAAAGTTGAAG
>TTN-202,ENSE00003806479,1,264,847084,847347,CTGTCAAAATTAAGAAGACTCTGAAGAACCTCACAGTGACAGAAACACAGGATGCTGTTTTCACTGTCGAGCTTACACACCCTAATGTCAAAGGTGTCCAGTGGATCAAAAATGGAGTTGTGCTGGAATCCAATGAAAAGTATGCTATCTCTGTCAAAGGAACAATTTACTCTCTGAGGATTAAAAACTGTGCCATCGTGGATGAGTCTGTTTATGGCTTCAGGCTTGGAAGGCTTGGAGCCAGTGCCAGACTGCACGTGGAGA
>TTN-202,ENSE00003804523,1,261,847348,847608,CTGTCAAGATCATTAAAAAGCCAAAGGATGTGACAGCCTTGGAAAATGCCACTGTTGCCTTTGAAGTTAGTGTTTCCCATGACACTGTTCCAGTAAAATGGTTCCATAAGAGTGTGGAAATTAAGCCAAGTGACAAACACAGACTGGTCTCAGAAAGGAAAGTCCACAAGCTGATGCTGCAGAACATCTCCCCCTCAGATGCTGGGGAATACACAGCTGTGGTCGGGCAATTGGAATGCAAAGCAAAACTGTTTGTGGAGA
>TTN-202,ENSE00003807378,1,261,847609,847869,CATTACATATTACAAAAACCATGAAAAATATCGAGGTGCCTGAGACCAAAACTGCCTCTTTTGAGTGTGAGGTGTCCCACTTCAATGTCCCTTCCATGTGGCTGAAGAATGGTGTGGAAATTGAGATGAGTGAAAAGTTCAAGATAGTTGTGCAGGGAAAACTCCATCAGCTGATCATCATGAACACCAGCACAGAGGACTCGGCAGAATACACATTTGTCTGTGGCAATGACCAAGTCAGTGCCACCCTGACAGTCACCC
>TTN-202,ENSE00003807271,1,261,847870,848130,CAATCATGATTACTTCCATGCTGAAAGACATCAACGCTGAAGAAAAAGACACTATTACTTTTGAGGTGACAGTGAACTATGAAGGCATCTCTTACAAATGGTTAAAGAATGGTGTGGAAATCAAATCAACTGACAAGTGCCAGATGAGAACCAAAAAGCTCACACACTCACTGAACATCAGGAATGTTCACTTTGGGGATGCTGCTGACTACACCTTTGTGGCTGGAAAAGCAACATCAACAGCCACACTTTATGTGGAAG
>TTN-202,ENSE00003808172,1,142,848131,848272,CTCGTCATATAGAATTTAGGAAACACATTAAGGACATTAAGGTACTGGAGAAGAAGCGAGCCATGTTTGAATGTGAAGTTTCTGAACCTGACATCACTGTACAGTGGATGAAAGATGACCAGGAACTGCAGATCACAGACAG
>TTN-202,ENSE00003808223,1,166,848273,848438,AATAAAGATTCAGAAGGAGAAATATGTCCACCGCCTTCTGATCCCATCCACCCGGATGTCTGATGCTGGGAAGTACACAGTGGTGGCAGGAGGCAACGTGTCAACTGCAAAACTCTTTGTAGAAGGCAGAGATGTTCGCATCCGAAGTATTAAAAAGGAGGTTCAG
>TTN-202,ENSE00003810851,1,232,848439,848670,GTCATTGAGAAACAGCGTGCTGTTGTTGAATTTGAGGTCAATGAAGACGATGTTGATGCCCACTGGTATAAAGATGGCATTGAAATCAATTTCCAAGTTCAAGAACGACACAAATATGTAGTGGAAAGAAGAATCCACCGAATGTTTATCTCTGAGACCAGACAGAGCGATGCAGGAGAATACACCTTTGTGGCAGGAAGGAACAGGAGTTCTGTCACTCTCTATGTCAATG
>TTN-202,ENSE00003802092,1,285,848671,848955,CTCCTGAACCGCCCCAAGTTCTGCAGGAGCTCCAGCCTGTCACTGTGCAGTCTGGCAAGCCTGCCCGCTTCTGTGCCGTGATATCCGGAAGACCACAGCCCAAAATTTCCTGGTACAAGGAAGAGCAGCTGCTTTCCACTGGCTTCAAGTGCAAATTTCTTCATGATGGGCAAGAATACACGCTTTTGCTAATTGAAGCCTTCCCAGAGGATGCGGCAGTCTATACCTGTGAAGCCAAGAATGACTATGGTGTTGCCACAACATCAGCTTCACTCTCAGTGGAAG
>TTN-202,ENSE00003807103,1,126,848956,849081,TTCCAGAAGTTGTGTCTCCTGATCAGGAAATGCCTGTTTATCCACCTGCCATCATCACCCCGCTTCAGGACACTGTCACTTCTGAAGGGCAGCCAGCCCGTTTTCAATGCCGGGTTTCTGGAACAG
>TTN-202,ENSE00003801355,1,189,849082,849270,ATCTAAAAGTGTCGTGGTACAGCAAAGACAAGAAAATCAAGCCATCTCGGTTCTTTAGAATGACTCAATTTGAAGACACTTATCAACTGGAAATTGCCGAAGCTTATCCAGAAGATGAAGGAACTTACACGTTTGTTGCTAGTAATGCTGTAGGCCAAGTATCAAGCACAGCCAACCTGAGTCTGGAAG
>TTN-202,ENSE00003810791,1,57,849271,849327,CTCCTGAATCAATTTTGCATGAGAGGATTGAACAAGAGATTGAGATGGAAATGAAAG
>TTN-202,ENSE00003805227,1,279,849328,849606,CTGCCCCAGTGATCAAGAGGAAAATCGAACCCCTGGAAGTAGCACTGGGCCACCTAGCCAAATTCACCTGTGAGATCCAAAGTGCTCCCAATGTCCGGTTCCAGTGGTTTAAAGCTGGCCGAGAAATTTATGAGAGTGACAAGTGTTCTATTCGATCTTCAAAGTATATCTCCAGCCTTGAAATCCTGAGAACCCAGGTGGTTGACTGCGGCGAGTATACATGCAAAGCTTCCAATGAGTATGGCAGTGTCAGCTGTACAGCCACACTAACTGTGACAG
>TTN-202,ENSE00003808619,1,564,849607,850170,AGGCATATCCACCAACCTTTCTCTCCAGACCTAAGTCCCTTACAACTTTTGTGGGTAAGGCAGCCAAGTTCATCTGCACAGTGACAGGGACTCCTGTGATAGAAACCATTTGGCAGAAAGATGGTGCTGCACTCTCACCTTCACCTAACTGGAGGATTTCCGACGCAGAAAACAAACACATTTTAGAACTCTCAAACCTTACCATTCAAGATAGAGGAGTTTATTCTTGTAAGGCTTCCAACAAGTTTGGAGCAGACATCTGCCAAGCAGAGTTGATCATCATTGATAAGCCACATTTCATTAAAGAATTAGAGCCTGTGCAGTCCGCTATCAATAAGAAGGTCCACCTTGAGTGCCAAGTAGATGAAGACAGAAAAGTCACAGTTACGTGGAGCAAAGATGGGCAAAAACTCCCCCCAGGGAAAGATTATAAGATCTGTTTTGAAGATAAAATAGCAACACTTGAGATTCCTTTGGCCAAACTGAAAGATTCAGGAACCTATGTCTGTACAGCTTCAAATGAGGCTGGAAGCAGCTCCTGCTCAGCCACAGTCACTGTCAGAG
>TTN-202,ENSE00003811334,1,282,850171,850452,AGCCACCATCCTTCGTGAAGAAGGTGGATCCCTCTTATTTAATGCTCCCAGGTGAATCAGCACGCCTCCATTGCAAGCTGAAAGGCTCACCTGTGATCCAGGTTACTTGGTTTAAAAATAACAAAGAACTCAGTGAAAGTAACACAGTCCGAATGTATTTTGTCAATTCTGAGGCTATACTTGATATTACGGATGTAAAAGTTGAAGACAGTGGGAGTTACTCATGTGAAGCAGTGAATGACGTCGGCAGTGATAGCTGCAGTACTGAAATAGTTATCAAAG
>TTN-202,ENSE00003807496,1,279,850453,850731,AACCTCCTTCTTTCATCAAAACTCTTGAGCCTGCAGACATAGTGAGAGGAACAAATGCTCTACTTCAGTGTGAAGTCTCAGGCACTGGACCATTTGAAATTAGCTGGTTCAAAGACAAGAAACAAATTCGAAGTAGTAAAAAATACAGATTGTTTTCTCAGAAGTCTCTTGTGTGTCTGGAGATCTTTTCGTTTAATAGTGCAGATGTTGGTGAATATGAATGTGTTGTTGCTAATGAAGTCGGCAAGTGTGGCTGCATGGCAACCCACTTACTCAAAG
>TTN-202,ENSE00003806831,1,279,850732,851010,AACCTCCAACCTTTGTAAAGAAAGTAGATGATTTGATTGCACTAGGAGGACAAACCGTTACCCTGCAAGCTGCTGTGAGAGGGTCAGAGCCCATTTCTGTCACATGGATGAAAGGTCAAGAGGTCATCAGAGAAGACGGAAAAATCAAAATGAGCTTTTCCAATGGTGTTGCAGTCTTGATAATCCCTGATGTTCAGATTAGTTTTGGAGGCAAATACACGTGCCTGGCTGAAAATGAAGCTGGAAGCCAAACATCTGTTGGGGAATTAATAGTTAAAG
>TTN-202,ENSE00003801788,1,279,851011,851289,AACCTGCCAAAATCATTGAGCGAGCAGAACTGATCCAGGTGACAGCAGGAGATCCCGCCACACTGGAGTACACAGTGGCAGGCACGCCAGAACTGAAGCCCAAATGGTACAAAGATGGGAGACCCTTGGTCGCCAGTAAAAAATACCGAATAAGTTTTAAAAACAATGTTGCCCAGCTCAAATTTTATTCAGCTGAGCTGCACGACAGTGGCCAATACACATTTGAGATTTCCAATGAAGTGGGCAGCAGCTCCTGTGAGACTACATTCACTGTATTAG
>TTN-202,ENSE00003804186,1,288,851290,851577,ATCGAGACATTGCTCCATTTTTTACCAAACCCTTGCGCAACGTGGATAGTGTTGTTAATGGTACCTGCAGACTGGACTGCAAAATTGCAGGCTCCCTCCCCATGAGGGTGTCCTGGTTTAAGGATGGCAAAGAAATAGCTGCTTCTGACAGATACAGGATAGCATTTGTGGAAGGCACAGCCTCTTTGGAGATCATCAGAGTAGACATGAATGATGCAGGGAATTTCACTTGTCGAGCCACAAATTCCGTGGGAAGCAAAGACAGCAGTGGAGCCCTGATTGTGCAAG
>TTN-202,ENSE00003805178,1,279,851578,851856,AACCACCCAGTTTTGTAACTAAACCCGGCTCAAAGGATGTTCTGCCTGGCTCAGCAGTCTGCCTGAAGAGCACTTTCCAAGGATCTACTCCTCTCACAATCAGATGGTTTAAGGGCAACAAAGAGCTGGTTTCTGGTGGAAGCTGCTATATTACCAAAGAAGCTTTAGAGAGTTCCCTGGAACTCTATTTAGTAAAAACCTCTGATTCGGGCACGTACACATGTAAAGTCAGCAATGTCGCTGGAGGGGTGGAATGCAGTGCAAACTTGTTTGTAAAAG
>TTN-202,ENSE00003806856,1,282,851857,852138,AACCTGCCACATTTGTTGAAAAGTTAGAGCCATCACAGCTGTTAAAGAAGGGAGATGCCACCCAGCTAGCCTGCAAAGTAACTGGTACCCCTCCAATTAAAATAACATGGTTTGCAAATGATAGAGAAATTAAGGAGAGCAGCAAACACAGAATGTCTTTTGTGGAGTCTACTGCAGTTCTAAGACTGACAGATGTTGGCATCGAAGACAGTGGTGAATATATGTGTGAGGCCCAAAATGAGGCTGGCAGTGACCACTGCAGTAGCATTGTAATAGTCAAAG
>TTN-202,ENSE00003804074,1,279,852139,852417,AGTCACCTTATTTTACCAAGGAATTTAAGCCAATTGAAGTCTTAAAGGAGTACGATGTCATGTTGCTGGCTGAGGTGGCAGGCACTCCTCCCTTTGAGATCACTTGGTTCAAAGATAACACAATCCTGCGAAGTGGTAGAAAGTATAAGACTTTCATTCAGGATCATCTGGTTAGCCTGCAGATCCTCAAGTTTGTAGCTGCAGATGCTGGCGAATACCAGTGTCGGGTGACCAATGAGGTGGGCAGCAGCATCTGCAGTGCCAGGGTGACTTTAAGAG
>TTN-202,ENSE00003807057,1,279,852418,852696,AACCCCCATCCTTCATAAAGAAGATCGAGAGTACCAGCTCCCTCCGGGGAGGCACAGCTGCCTTCCAGGCCACTCTGAAGGGCTCCTTGCCAATTACGGTGACTTGGCTAAAAGACAGCGATGAAATCACTGAAGACGATAATATAAGAATGACCTTTGAGAACAATGTGGCCAGTTTGTACCTCAGTGGCATTGAAGTCAAGCATGATGGGAAATATGTCTGTCAGGCCAAAAATGATGCAGGAATACAAAGATGTTCTGCATTACTCTCAGTAAAAG
>TTN-202,ENSE00003807032,1,279,852697,852975,AACCTGCAACAATCACCGAGGAAGCTGTGTCTATAGATGTCACCCAAGGAGACCCAGCCACTTTGCAGGTTAAATTTTCAGGGACTAAGGAGATTACAGCCAAATGGTTTAAAGATGGCCAAGAACTGACCCTGGGCTCAAAATATAAAATCAGTGTCACTGATACAGTCTCAATACTGAAGATTATTTCTACAGAAAAGAAAGATAGTGGAGAATATACTTTCGAGGTCCAAAATGATGTTGGGAGGAGCAGCTGCAAGGCTAGAATTAATGTATTAG
>TTN-202,ENSE00003810010,1,288,852976,853263,ATCTTATCATACCTCCTTCATTCACCAAAAAGCTGAAGAAAATGGACAGCATTAAAGGTTCTTTCATTGATTTAGAATGTATAGTGGCTGGGTCACATCCCATAAGCATCCAGTGGTTCAAAGATGACCAAGAAATATCAGCTAGTGAAAAGTACAAATTCTCTTTTCATGACAATACTGCCTTCTTGGAAATCAGCCAGCTGGAAGGTACAGACAGTGGGACATACACTTGTTCTGCCACAAATAAGGCAGGGCACAACCAATGCAGTGGGCATCTGACAGTCAAAG
>TTN-202,ENSE00003805733,1,279,853264,853542,AACCCCCTTACTTTGTGGAAAAGCCACAGTCACAAGATGTCAATCCCAACACAAGGGTACAGTTAAAGGCTCTTGTGGGTGGCACTGCACCCATGACAATAAAGTGGTTTAAAGATAACAAAGAGTTACACTCAGGAGCAGCCCGCTCAGTTTGGAAGGATGACACCTCTACCAGTCTAGAGCTCTTTGCAGCCAAAGCTACCGATTCTGGAACCTACATTTGCCAACTAAGCAATGATGTTGGCACAGCAACCAGCAAAGCCACTCTCTTTGTAAAAG
>TTN-202,ENSE00003805836,1,282,853543,853824,AACCTCCTCAATTCATTAAGAAGCCCAGTCCAGTCTTAGTGCTGAGGAATGGACAGTCAACAACATTTGAATGCCAAATAACAGGCACTCCTAAAATCCGAGTGTCTTGGTATCTAGACGGGAATGAAATAACAGCCATTCAGAAACATGGCATTTCCTTCATTGATGGTTTAGCCACTTTCCAGATTTCTGGTGCCAGGGTAGAAAATAGTGGGACTTATGTGTGTGAAGCTCGAAATGACGCAGGCACGGCGAGCTGCAGCATTGAACTCAAAGTGAAAG
>TTN-202,ENSE00003802637,1,279,853825,854103,AACCCCCCACCTTTATCAGAGAGCTGAAGCCTGTGGAGGTAGTAAAATATAGTGACGTGGAGCTGGAGTGTGAAGTTACGGGAACACCTCCGTTTGAAGTCACTTGGCTGAAGAATAACAGGGAAATTCGAAGCAGCAAAAAATACACATTGACCGACAGAGTGTCTGTGTTTAACCTCCATATAACCAAGTGTGACCCTTCAGACACTGGGGAATACCAGTGCATTGTATCCAATGAAGGCGGCAGCTGCTCATGCAGTACTAGAGTTGCCCTGAAAG
>TTN-202,ENSE00003809504,1,279,854104,854382,AACCACCATCATTCATTAAGAAGATAGAAAATACCACTACTGTTTTGAAAAGTTCTGCCACCTTTCAGAGTACCGTGGCAGGTTCTCCTCCTATTTCTATAACCTGGCTAAAGGATGATCAGATTCTTGATGAAGATGATAATGTCTATATTTCATTTGTGGACAGTGTGGCCACACTTCAAATCAGAAGTGTGGATAATGGACACAGTGGGAGATATACCTGTCAAGCCAAGAATGAGTCAGGAGTTGAGAGGTGTTATGCTTTCCTTTTAGTACAAG
>TTN-202,ENSE00003802968,1,279,854383,854661,AACCAGCTCAAATCGTAGAGAAAGCTAAATCAGTTGATGTTACGGAGAAAGATCCCATGACCTTGGAATGTGTTGTGGCTGGAACACCAGAACTCAAAGTGAAATGGCTTAAAGACGGGAAACAAATAGTTCCCAGTAGATACTTTTCAATGAGTTTTGAAAATAACGTGGCCAGTTTTAGAATTCAGTCAGTAATGAAGCAGGACAGCGGTCAGTACACTTTCAAGGTGGAAAATGACTTCGGAAGCAGTAGCTGTGATGCCTACTTAAGAGTGCTAG
>TTN-202,ENSE00003810612,1,288,854662,854949,ATCAAAATATTCCTCCATCATTCACCAAAAAATTAACCAAAATGGATAAAGTTCTGGGCTCTTCTATTCATATGGAGTGCAAGGTGTCTGGTTCACTTCCCATTAGTGCTCAGTGGTTTAAGGATGGAAAAGAAATATCTACAAGTGCAAAATACAGACTTGTGTGCCATGAGAGATCTGTGTCTCTGGAAGTTAATAATCTGGAATTAGAAGATACTGCAAATTACACATGCAAAGTGTCAAATGTAGCAGGAGATGATGCATGCAGTGGCATCTTAACTGTGAAAG
>TTN-202,ENSE00003806423,1,279,854950,855228,AACCACCAAGCTTCCTAGTGAAACCTGGGCGACAGCAAGCCATACCTGATTCTACAGTGGAATTTAAGGCAATACTAAAAGGAACACCACCATTTAAAATAAAATGGTTTAAGGATGATGTGGAACTTGTCTCAGGTCCTAAATGTTTCATTGGCTTGGAAGGGTCGACTAGCTTCTTAAATCTCTACTCAGTGGATGCTTCTAAGACTGGACAGTATACTTGCCATGTTACCAATGATGTTGGTAGCGACTCTTGTACTACGATGTTGCTTGTGACAG
>TTN-202,ENSE00003805536,1,282,855229,855510,AACCACCAAAGTTTGTAAAGAAATTAGAAGCCTCCAAAATTGTGAAAGCAGGTGACTCTTCACGACTTGAATGCAAGATAGCTGGATCCCCAGAAATCAGAGTTGTGTGGTTCCGAAATGAACATGAACTTCCAGCCAGTGATAAGTACAGAATGACTTTCATTGACTCAGTGGCCGTCATACAGATGAACAATCTCAGTACTGAGGACAGTGGAGATTTCATTTGTGAGGCTCAGAATCCCGCTGGCAGCACAAGCTGCAGTACCAAGGTTATAGTAAAAG
>TTN-202,ENSE00003807762,1,279,855511,855789,AGCCACCTGTTTTTAGCAGCTTCCCTCCTATAGTAGAAACCCTTAAAAATGCTGAAGTCAGTCTTGAATGTGAACTTTCGGGAACACCACCGTTTGAGGTGGTATGGTACAAAGACAAGCGGCAACTCAGAAGCAGCAAGAAATACAAGATTGCATCCAAAAACTTCCACACAAGTATTCACATTCTCAATGTGGACACTTCAGACATCGGTGAATACCACTGCAAAGCACAGAATGAAGTGGGAAGTGATACTTGTGTTTGTACTGTAAAATTGAAAG
>TTN-202,ENSE00003809887,1,282,855790,856071,AACCACCAAGATTTGTCTCCAAACTGAACAGCCTCACTGTTGTAGCCGGAGAGCCTGCTGAATTACAAGCATCCATAGAAGGCGCCCAGCCTATTTTTGTCCAGTGGCTTAAAGAGAAGGAAGAAGTGATTAGAGAAAGTGAAAACATCAGGATTACATTTGTGGAAAATGTTGCAACTCTACAGTTTGCAAAAGCAGAGCCAGCTAATGCTGGAAAGTATATCTGCCAAATCAAGAATGATGGTGGAATGAGGGAGAACATGGCCACACTGATGGTCTTAG
>TTN-202,ENSE00003811356,1,279,856072,856350,AGCCCGCAGTCATTGTTGAGAAGGCAGGACCGATGACGGTGACTGTAGGAGAAACGTGCACTCTGGAGTGTAAGGTGGCTGGCACTCCGGAACTCTCTGTTGAATGGTACAAGGATGGAAAGCTGTTGACCAGCAGCCAAAAACACAAATTTAGCTTCTACAACAAAATCTCTTCCTTAAGGATTCTCTCAGTTGAAAGGCAAGATGCAGGCACATACACTTTCCAGGTTCAAAATAATGTTGGGAAAAGCAGCTGCACAGCTGTGGTTGATGTTTCAG
>TTN-202,ENSE00003804298,1,288,856351,856638,ACCGAGCAGTTCCTCCCTCTTTCACACGAAGACTGAAAAATACTGGTGGGGTGTTAGGTGCTTCTTGCATCTTGGAATGCAAAGTAGCTGGATCATCACCTATTTCAGTTGCCTGGTTTCATGAGAAAACCAAGATTGTCAGTGGAGCAAAGTACCAAACCACATTTTCAGATAATGTCTGCACATTGCAGTTGAATTCTCTGGATTCCTCAGATATGGGCAATTACACATGCGTGGCTGCTAATGTCGCTGGGTCTGATGAATGTCGTGCAGTGCTAACTGTACAAG
>TTN-202,ENSE00003807700,1,279,856639,856917,AACCACCCTCTTTTGTGAAAGAACCTGAACCTTTGGAAGTACTACCAGGCAAAAATGTAACCTTCACAAGCGTTATTAGAGGAACCCCTCCATTCAAAGTCAACTGGTTCAGAGGTGCCAGAGAACTAGTGAAAGGAGACCGGTGCAACATCTATTTTGAAGACACTGTGGCAGAACTGGAATTATTTAATATTGACATATCTCAGAGTGGGGAATACACCTGTGTGGTTTCTAACAACGCTGGCCAAGCATCTTGCACTACCCGTCTCTTTGTGAAAG
>TTN-202,ENSE00003803086,1,279,856918,857196,AACCAGCTGCATTTTTGAAGAGATTAAGTGATCATTCTGTAGAACCAGGGAAGTCCATAATTCTGGAGAGCACCTACACTGGAACACTTCCAATTTCTGTCACTTGGAAAAAGGATGGTTTTAACATAACTACCTCTGAAAAATGTAACATAGTCACAACAGAGAAAACTTGTATCCTGGAAATTCTGAATAGCACAAAAAGAGATGCAGGGCAGTATTCCTGCGAGATTGAAAATGAGGCAGGAAGGGATGTTTGTGGAGCTCTGGTATCTACATTAG
>TTN-202,ENSE00003806655,1,279,857197,857475,AACCGCCTTATTTTGTTACGGAACTGGAACCTCTGGAGGCAGCAGTTGGAGATTCGGTTTCTTTACAATGCCAAGTTGCTGGGACACCAGAAATTACAGTGTCTTGGTACAAAGGAGATACCAAATTACGGCCAACTCCTGAATACAGGACCTACTTTACAAACAATGTGGCCACACTTGTTTTTAATAAAGTGAACATCAATGACAGTGGAGAGTACACATGCAAAGCAGAAAATAGTATAGGAACTGCTTCTTCTAAGACTGTGTTCAGAATTCAAG
>TTN-202,ENSE00003805355,1,288,857476,857763,AGCGCCAACTCCCACCTTCTTTTGCAAGACAATTAAAGGACATTGAACAAACTGTGGGGTTACCTGTTACACTCACTTGTCGATTAAATGGCTCTGCACCCATCCAAGTGTGCTGGTATAGAGATGGAGTACTTTTAAGAGACGATGAAAATCTACAGACTTCATTTGTAGATAATGTGGCAACTTTAAAAATTTTGCAAACTGACTTGAGTCACTCTGGCCAGTACTCTTGCTCAGCTTCCAACCCACTTGGAACAGCATCTTCTAGTGCTAGACTCACAGCAAGAG
>TTN-202,ENSE00003804884,1,288,857764,858051,AACCCAAGAAATCTCCCTTCTTTGACATCAAGCCTGTATCTATAGATGTTATTGCTGGAGAAAGTGCTGATTTTGAGTGTCATGTTACTGGTGCTCAACCGATGCGAATCACTTGGTCAAAAGATAACAAGGAGATCCGTCCTGGAGGAAACTATACAATCACATGTGTGGGAAACACTCCTCATTTGAGAATTCTTAAAGTAGGCAAAGGAGACTCTGGTCAATATACTTGCCAAGCAACCAATGATGTTGGCAAAGACATGTGCTCAGCTCAGCTCAGTGTAAAAG
>TTN-202,ENSE00003805805,1,282,858052,858333,AACCTCCAAAGTTTGTTAAGAAATTAGAAGCTTCAAAAGTTGCAAAGCAGGGAGAATCCATTCAACTGGAATGTAAAATAAGTGGCTCCCCAGAAATCAAAGTTTCATGGTTCCGAAATGACAGCGAACTTCATGAAAGTTGGAAATACAACATGTCATTCATTAATTCTGTGGCATTGCTTACGATCAATGAAGCTAGTGCTGAAGACAGCGGGGACTACATTTGTGAGGCTCATAATGGTGTTGGTGACGCCAGCTGCAGCACAGCGTTGACAGTGAAAG
>TTN-202,ENSE00003803146,1,279,858334,858612,CACCTCCTGTTTTCACCCAGAAGCCTTCTCCAGTAGGAGCTCTTAAAGGTTCTGATGTGATTCTCCAATGTGAAATTTCGGGAACTCCCCCATTTGAAGTAGTATGGGTTAAAGATCGAAAGCAGGTTAGAAACAGCAAGAAATTTAAAATCACTTCAAAACATTTTGATACAAGTCTTCATATCCTTAATCTTGAAGCCTCCGATGTCGGGGAATATCACTGCAAAGCTACTAATGAGGTGGGAAGTGACACGTGTTCTTGCTCTGTCAAGTTCAAAG
>TTN-202,ENSE00003806016,1,282,858613,858894,AACCTCCACGATTCGTGAAAAAGCTAAGTGACACCTCAACCCTTATTGGGGATGCTGTTGAGTTACGGGCCATAGTGGAGGGCTTCCAGCCAATTTCTGTTGTCTGGCTGAAAGATAGAGGTGAAGTCATCAGAGAGAGTGAAAATACCAGGATTTCATTCATTGATAACATTGCAACCCTCCAGCTGGGGAGTCCAGAAGCATCTAATTCTGGAAAATATATATGCCAAATCAAAAACGATGCTGGAATGAGAGAATGCTCTGCAGTCTTGACTGTACTAG
>TTN-202,ENSE00003808302,1,279,858895,859173,AACCAGCAAGAATCATAGAGAAGCCCGAACCCATGACTGTCACTACTGGAAATCCTTTTGCATTAGAGTGTGTAGTGACTGGAACACCAGAACTCTCAGCCAAGTGGTTCAAAGATGGAAGAGAATTGTCTGCAGACAGCAAACATCACATTACATTCATCAATAAAGTGGCTTCCCTTAAAATCCCCTGTGCCGAAATGAGTGACAAAGGATTATATAGCTTTGAAGTGAAAAACAGTGTTGGCAAAAGTAACTGCACTGTATCCGTCCATGTTTCTG
>TTN-202,ENSE00003802442,1,288,859174,859461,ATCGGATTGTGCCTCCTTCCTTCATCCGCAAGCTGAAAGACGTGAATGCCATCCTGGGGGCCTCAGTTGTTTTGGAGTGCCGAGTCTCTGGCTCAGCCCCGATTTCAGTTGGCTGGTTTCAGGATGGAAATGAGATTGTTAGTGGGCCCAAATGTCAGTCCAGCTTTTCGGAAAACGTCTGTACTTTGAATCTGAGCTTGTTGGAGCCCTCCGACACAGGCATATACACGTGTGTGGCTGCCAATGTAGCTGGTTCCGATGAGTGCTCAGCAGTCCTGACTGTGCAAG
>TTN-202,ENSE00003809965,1,279,859462,859740,AACCACCATCTTTTGAACAAACCCCTGATTCTGTGGAAGTTTTGCCTGGAATGAGCCTCACATTCACCAGTGTCATCAGAGGCACCCCTCCTTTCAAGGTCAAGTGGTTTAAAGGCAGCAGGGAACTGGTGCCTGGGGAGTCATGCAACATCTCTCTGGAAGATTTTGTCACAGAACTGGAGTTGTTTGAGGTGCAGCCATTAGAAAGTGGAGACTATTCTTGCCTCGTTACAAATGATGCTGGCAGTGCTTCCTGTACCACACATCTTTTTGTGAAAG
>TTN-202,ENSE00003809650,1,279,859741,860019,AACCAGCCACCTTTGTGAAAAGATTGGCTGATTTCAGTGTTGAGACAGGAAGCCCCATAGTTCTCGAGGCCACATACACTGGCACACCTCCAATCTCAGTGAGCTGGATAAAGGACGAGTATCTTATTTCACAATCTGAGAGATGCAGTATTACTATGACAGAAAAATCTACCATACTGGAAATTCTTGAGAGCACAATAGAGGATTATGCACAGTACAGCTGCCTGATAGAAAATGAGGCTGGTCAAGATATCTGTGAAGCTCTGGTGTCTGTCTTAG
>TTN-202,ENSE00003810498,1,279,860020,860298,AACCACCGTACTTTATTGAACCTCTGGAACATGTGGAAGCAGTCATTGGAGAACCTGCAACTTTACAGTGTAAAGTGGATGGAACTCCAGAAATTAGAATTTCTTGGTATAAAGAACACACAAAGCTACGATCAGCTCCTGCATATAAAATGCAATTCAAAAATAACGTTGCTTCCTTAGTAATCAACAAAGTGGATCACAGTGATGTGGGAGAGTATTCATGCAAGGCAGACAACAGTGTGGGGGCAGTCGCTTCTTCAGCTGTGCTTGTTATCAAAG
>TTN-202,ENSE00003807178,1,288,860299,860586,CGCGCAAACTTCCACCTTTCTTTGCAAGAAAACTGAAAGACGTTCATGAGACTCTAGGCTTCCCAGTTGCATTTGAATGCCGCATCAATGGCTCAGAACCTCTTCAAGTGTCTTGGTACAAGGATGGGGTTCTTTTGAAAGATGATGCTAATTTGCAGACATCTTTTGTTCATAATGTAGCAACTCTTCAGATTTTACAAACTGACCAGAGCCACATAGGGCAGTATAATTGCTCTGCTTCTAATCCTCTTGGGACTGCTTCATCCAGTGCCAAGCTCATTCTCTCAG
>TTN-202,ENSE00003808579,1,288,860587,860874,AGCATGAAGTGCCTCCTTTCTTTGATCTAAAGCCTGTATCAGTAGATCTTGCTCTTGGAGAAAGTGGTACTTTTAAATGTCATGTAACTGGGACTGCACCAATCAAAATCACTTGGGCCAAAGATAACCGAGAGATTCGCCCTGGAGGCAACTACAAGATGACTTTGGTAGAAAATACTGCCACTCTGACAGTTCTCAAAGTAGGCAAAGGCGATGCCGGGCAGTACACCTGCTATGCAAGCAACATCGCTGGAAAAGACTCTTGTTCTGCTCAGCTGGGTGTACAAG
>TTN-202,ENSE00003801249,1,282,860875,861156,AACCACCCAGGTTCATTAAGAAGCTAGAACCTTCAAGAATTGTGAAACAGGATGAATTCACAAGGTATGAATGCAAAATCGGTGGGTCTCCAGAAATCAAAGTTTTATGGTATAAGGACGAGACTGAAATTCAAGAGAGCAGTAAATTCAGAATGTCATTCGTTGACTCGGTGGCTGTGCTGGAAATGCACAATCTCAGTGTTGAAGACAGTGGAGACTACACCTGTGAGGCCCACAATGCAGCAGGCAGTGCCAGCAGCAGCACATCCTTAAAAGTTAAAG
>TTN-202,ENSE00003810208,1,279,861157,861435,AACCACCCATTTTCCGCAAAAAGCCTCATCCTATAGAGACACTGAAAGGAGCTGATGTTCACCTTGAATGTGAGCTTCAGGGCACTCCCCCATTTCACGTTTCTTGGTATAAAGACAAGAGAGAACTTAGGAGCGGCAAGAAGTACAAGATAATGTCTGAGAACTTCCTAACCAGTATCCACATCCTGAATGTCGATGCTGCAGACATTGGGGAATATCAGTGTAAAGCCACAAATGATGTGGGAAGCGACACTTGCGTTGGTTCCATCGCTCTCAAAG
>TTN-202,ENSE00003802440,1,282,861436,861717,CACCACCAAGATTTGTGAAGAAGCTCAGTGACATATCTACTGTCGTTGGTAAAGAAGTTCAGCTGCAGACTACCATTGAAGGCGCTGAACCCATTTCAGTGGTGTGGTTCAAAGATAAGGGAGAAATCGTTAGAGAAAGTGACAACATATGGATTTCTTATTCAGAAAACATTGCAACCTTACAGTTTTCAAGAGTGGAACCAGCCAATGCTGGAAAATACACTTGTCAGATCAAAAACGATGCTGGGATGCAAGAGTGCTTCGCCACGCTATCCGTTCTCG
>TTN-202,ENSE00003802351,1,279,861718,861996,AGCCTGCAACAATTGTAGAAAAGCCAGAATCCATAAAAGTTACCACGGGAGACACCTGTACCTTGGAGTGTACAGTAGCTGGCACCCCTGAACTCAGTACTAAGTGGTTTAAGGATGGAAAAGAGCTAACAAGTGACAACAAATACAAAATAAGCTTCTTCAACAAAGTATCCGGCCTTAAGATCATCAATGTAGCACCGAGTGACAGTGGGGTATACAGTTTTGAGGTGCAGAACCCTGTTGGCAAAGACAGCTGCACAGCTTCATTGCAGGTTTCAG
>TTN-202,ENSE00003807933,1,288,861997,862284,ACCGAACCGTTCCTCCTTCATTCACAAGAAAATTGAAAGAGACAAATGGTCTATCCGGCTCCTCAGTTGTAATGGAGTGTAAAGTCTATGGGTCACCTCCAATCTCTGTCTCCTGGTTCCATGAAGGAAATGAGATCAGTAGTGGAAGGAAATACCAGACCACCCTGACAGATAATACTTGTGCTTTAACTGTGAACATGCTGGAAGAATCAGACAGTGGTGACTACACATGTATAGCTACTAATATGGCTGGTTCTGATGAATGTAGTGCTCCTTTGACTGTGAGAG
>TTN-202,ENSE00003804939,1,279,862285,862563,AACCACCATCTTTTGTTCAGAAACCTGATCCCATGGATGTTTTAACTGGGACCAATGTAACTTTCACAAGTATCGTAAAAGGAACACCTCCTTTCAGTGTTAGCTGGTTCAAAGGTAGCAGTGAACTAGTACCAGGTGACAGATGCAACGTGTCTTTGGAGGATTCAGTTGCTGAACTGGAGTTGTTCGATGTAGATACATCACAAAGTGGAGAATATACTTGCATAGTTAGCAATGAAGCTGGCAAGGCTTCTTGTACAACACATCTCTACATAAAAG
>TTN-202,ENSE00003810094,1,279,862564,862842,CCCCAGCCAAATTTGTGAAGAGGCTGAATGATTACAGCATAGAGAAAGGAAAACCCCTGATCCTAGAGGGTACATTCACTGGAACTCCTCCCATTTCGGTTACCTGGAAGAAAAATGGCATAAATGTAACTCCTTCTCAGAGGTGTAATATAACTACGACTGAAAAATCGGCAATCCTGGAAATTCCAAGTAGCACAGTAGAGGATGCAGGACAATACAACTGCTACATTGAAAATGCCTCTGGAAAAGATTCCTGTTCAGCACAAATACTCATACTAG
>TTN-202,ENSE00003811103,1,279,862843,863121,AACCACCGTATTTTGTCAAGCAGTTGGAGCCGGTTAAGGTGTCTGTTGGAGATTCTGCCTCTCTACAATGCCAGCTTGCTGGAACCCCTGAAATTGGGGTATCCTGGTATAAAGGAGATACAAAATTGAGACCCACTACGACTTACAAAATGCATTTTAGGAATAATGTTGCTACACTGGTTTTCAACCAGGTTGATATTAATGATAGTGGAGAATATATCTGCAAAGCTGAAAACAGCGTGGGAGAAGTTTCTGCATCAACTTTCCTTACCGTTCAAG
>TTN-202,ENSE00003801476,1,288,863122,863409,AGCAAAAACTTCCACCATCATTTTCTCGACAATTGAGAGATGTTCAAGAAACAGTTGGACTGCCAGTTGTTTTTGATTGTGCCATAAGTGGATCAGAACCTATCTCCGTGTCTTGGTATAAAGACGGCAAGCCATTGAAAGACAGCCCAAATGTACAAACATCATTTTTAGACAATACAGCCACACTCAATATTTTTAAAACTGACCGGAGCCTTGCAGGCCAGTATTCCTGCACAGCTACAAACCCTATAGGCTCTGCTTCTTCCAGTGCCAGGCTCATTCTCACAG
>TTN-202,ENSE00003808430,1,288,863410,863697,AGGGGAAGAACCCACCCTTCTTTGACATCCGTCTTGCCCCTGTGGATGCTGTGGTGGGAGAAAGTGCTGACTTTGAGTGCCACGTCACGGGCACACAACCGATAAAGGTCAGCTGGGCCAAAGACAGCAGAGAAATACGAAGTGGCGGAAAGTACCAGATTAGTTATCTGGAAAACAGCGCCCACCTGACAGTCCTCAAAGTAGACAAAGGAGATTCTGGACAATATACCTGCTATGCTGTGAATGAAGTGGGAAAAGACTCTTGCACAGCTCAGCTGAATATAAAAG
>TTN-202,ENSE00003809007,1,291,863698,863988,AGCGGCTCATCCCACCAAGTTTCACTAAAAGACTCTCAGAGACAGTAGAAGAAACAGAAGGGAATTCTTTCAAACTTGAGGGACGTGTGGCTGGTTCCCAACCTATAACTGTTGCCTGGTACAAAAATAATATAGAGATACAACCAACTTCTAACTGTGAAATAACATTCAAGAACAACACGTTAGTGCTGCAAGTCAGGAAAGCAGGCATGAACGACGCTGGTTTGTACACATGCAAAGTGTCCAATGATGCAGGCTCTGCTCTGTGCACGTCTTCAATCGTCATCAAAG
>TTN-202,ENSE00003803910,1,288,863989,864276,AACCTAAGAAGCCACCTGTATTTGATCAGCACCTTACTCCAGTAACAGTGAGTGAAGGAGAATACGTGCAGCTCAGCTGCCATGTCCAGGGATCTGAGCCAATTAGGATCCAGTGGTTGAAGGCTGGCAGGGAAATAAAGCCTTCAGACAGATGCAGCTTCAGCTTTGCTAGTGGGACAGCTGTACTGGAACTCAGAGATGTGGCTAAAGCAGATTCGGGAGATTATGTGTGTAAAGCTTCAAATGTGGCTGGAAGTGACACTACCAAATCAAAAGTGACCATTAAAG
>TTN-202,ENSE00003804245,1,93,864277,864369,ACAAACCAGCTGTGGCCCCAGCAACCAAGAAAGCTGCGGTAGATGGAAGACTCTTTTTTGTGTCAGAACCTCAGAGTATCAGAGTCGTAGAAA
>TTN-202,ENSE00003801649,1,286,864370,864655,AAACCACTGCGACCTTCATTGCAAAAGTTGGAGGTGACCCAATCCCAAATGTTAAATGGACAAAAGGGAAGTGGAGACAGCTGAACCAAGGAGGTCGTGTTTTCATCCACCAAAAAGGCGATGAAGCAAAACTGGAGATTAGGGACACCACAAAAACTGATTCTGGGTTATACCGATGCGTGGCATTTAACGAACATGGTGAAATTGAAAGTAATGTTAACTTACAGGTGGATGAAAGGAAGAAACAAGAGAAAATTGAAGGCGATCTTAGAGCAATGCTGAAAAA
>TTN-202,ENSE00003805371,1,184,864656,864839,GACTCCAATCTTAAAGAAAGGAGCTGGAGAAGAAGAGGAAATTGATATCATGGAACTTCTCAAAAATGTTGATCCTAAAGAATATGAAAAATATGCCCGCATGTATGGAATCACTGACTTCCGAGGTCTTCTTCAAGCATTTGAACTGCTCAAGCAAAGCCAAGAAGAAGAGACACATAGACTG
>TTN-202,ENSE00003802112,1,90,864840,864929,GAAATTGAGGAAATAGAGAGGTCAGAGAGGGACGAAAAGGAATTTGAGGAACTTGTATCATTTATTCAGCAAAGACTGTCACAGACAGAG
>TTN-202,ENSE00003810323,1,268,864930,865197,CCTGTCACTCTGATCAAGGACATTGAAAATCAGACAGTTTTGAAAGATAATGATGCTGTCTTTGAAATTGACATTAAAATTAATTATCCAGAAATCAAGCTTTCGTGGTACAAAGGAACTGAAAAACTGGAACCCAGTGATAAATTTGAAATAAGCATTGATGGTGACCGACATACACTCAGAGTCAAAAACTGTCAACTTAAAGACCAGGGCAATTATCGATTGGTTTGTGGTCCACACATCGCTAGCGCTAAACTAACTGTAATTG
>TTN-202,ENSE00003810781,1,261,865198,865458,AGCCTGCATGGGAACGGCATCTTCAGGATGTGACTCTGAAAGAAGGCCAGACTTGCACCATGACATGCCAATTTTCTGTACCAAATGTAAAATCTGAATGGTTCAGAAATGGCAGAATCCTTAAACCCCAAGGTAGACATAAAACAGAAGTGGAACACAAAGTCCATAAATTGACCATTGCAGATGTTCGAGCAGAAGACCAGGGTCAGTACACCTGCAAATATGAAGACCTTGAAACTTCAGCAGAACTCAGAATCGAAG
>TTN-202,ENSE00003805599,1,210,865459,865668,CTGAACCAATTCAGTTTACAAAGCGCATACAGAACATCGTGGTGAGTGAGCATCAGTCTGCCACCTTTGAGTGTGAAGTGTCCTTTGATGATGCCATTGTAACATGGTACAAAGGACCAACAGAACTGACAGAGAGCCAGAAATACAACTTCAGGAATGATGGCCGCTGCCATTATATGACCATCCACAATGTGACCCCAGACGATGAAG
>TTN-202,ENSE00003809461,1,78,865669,865746,GTGTCTACTCGGTCATCGCTCGGCTGGAGCCAAGAGGTGAAGCAAGAAGCACGGCAGAGCTGTACCTAACGACGAAAG
>TTN-202,ENSE00003805821,1,27,865747,865773,AAATCAAACTTGAGCTGAAGCCTCCTG
>TTN-202,ENSE00003803485,1,60,865774,865833,ATATTCCTGACTCCAGAGTTCCAATCCCAACCATGCCTATCAGAGCAGTGCCACCAGAAG
>TTN-202,ENSE00003803812,1,84,865834,865917,AAATCCCTCCTGTGGTTGCTCCTCCTATCCCCCTTTTGCTACCAACACCCGAAGAAAAGAAACCACCACCAAAACGTATTGAAG
>TTN-202,ENSE00003804844,1,72,865918,865989,TTACCAAAAAGGCTGTGAAGAAAGATGCCAAAAAAGTTGTTGCAAAGCCCAAAGAGATGACACCACGTGAAG
>TTN-202,ENSE00003810688,1,48,865990,866037,AGATTGTCAAGAAGCCTCCACCTCCTACTACCTTAATTCCAGCAAAAG
>TTN-202,ENSE00003806388,1,405,866038,866442,CTCCTGAAATCATTGATGTATCCTCTAAAGCTGAAGAAGTAAAAATAATGACTATAACCAGAAAGAAAGAGGTTCAGAAAGAAAAAGAAGCTGTGTATGAGAAAAAGCAAGCAGTCCACAAGGAGAAGAGAGTCTTCATTGAATCTTTCGAAGAACCTTATGACGAACTGGAGGTAGAACCATACACAGAGCCATTTGAACAACCTTATTATGAAGAACCAGATGAAGACTATGAAGAGATTAAGGTAGAAGCTAAAAAAGAAGTTCACGAGGAATGGGAAGAAGATTTTGAAGAAGGGCAAGAATACTATGAAAGGGAAGAAGGCTATGACGAAGGGGAGGAAGAGTGGGAAGAGGCTTACCAAGAAAGGGAAGTAATTCAAGTTCAAAAGGAGGTCTATGAAG
>TTN-202,ENSE00003803093,1,63,866443,866505,AATCACATGAGAGAAAAGTTCCAGCCAAAGTACCTGAAAAGAAAGCACCACCACCTCCTAAAG
>TTN-202,ENSE00003802009,1,78,866506,866583,TTATAAAGAAGCCAGTAATTGAAAAAATTGAAAAGACTTCTCGAAGAATGGAGGAAGAAAAAGTTCAAGTCACCAAAG
>TTN-202,ENSE00003806356,1,78,866584,866661,TACCTGAAGTTTCAAAGAAGATTGTTCCACAAAAACCTTCCCGGACTCCAGTACAGGAAGAAGTTATTGAAGTGAAAG
>TTN-202,ENSE00003803112,1,87,866662,866748,TACCAGCTGTGCATACAAAGAAGATGGTTATTTCAGAAGAAAAGATGTTCTTTGCTTCTCACACAGAGGAGGAGGTGTCAGTCACAG
>TTN-202,ENSE00003811115,1,81,866749,866829,TCCCCGAGGTACAAAAGGAAATTGTTACTGAAGAGAAAATTCACGTTGCCATTTCCAAAAGGGTTGAACCACCACCTAAAG
>TTN-202,ENSE00003810048,1,84,866830,866913,TCCCTGAGCTACCTGAGAAACCAGCTCCAGAAGAAGTGGCCCCTGTTCCTATCCCTAAAAAAGTGGAGCCCCCAGCACCAAAAG
>TTN-202,ENSE00003809302,1,84,866914,866997,TTCCTGAGGTTCCCAAGAAACCCGTGCCAGAGGAGAAAAAGCCAGTTCCTGTGCCTAAGAAGGAACCTGCTGCTCCCCCAAAAG
>TTN-202,ENSE00003811271,1,84,866998,867081,TCCCAGAGGTGCCAAAGAAACCTGTCCCTGAAGAAAAGATTCCCGTTCCTGTTGCAAAGAAAAAGGAAGCTCCCCCAGCTAAAG
>TTN-202,ENSE00003811169,1,81,867082,867162,TTCCTGAAGTACAGAAGGGAGTTGTGACAGAAGAAAAAATAACCATTGTAACTCAAAGAGAGGAATCTCCACCACCAGCAG
>TTN-202,ENSE00003802187,1,84,867163,867246,TGCCAGAAATACCAAAGAAGAAAGTTCCTGAAGAAAGGAAACCTGTTCCTCGGAAGGAGGAAGAAGTTCCACCACCACCAAAAG
>TTN-202,ENSE00003810484,1,84,867247,867330,TGCCAGCTCTGCCTAAGAAACCCGTCCCAGAGGAGAAAGTTGCAGTGCCAGTTCCTGTCGCTAAGAAAGCTCCTCCTCCCCGAG
>TTN-202,ENSE00003810121,1,102,867331,867432,CTGAAGTCTCTAAGAAAACTGTTGTAGAAGAAAAGAGATTTGTTGCTGAAGAAAAACTATCCTTCGCAGTTCCTCAAAGAGTGGAAGTCACGCGGCACGAAG
>TTN-202,ENSE00003805410,1,114,867433,867546,TATCTGCAGAGGAGGAATGGAGTTACTCAGAAGAGGAGGAAGGTGTGTCCATTTCAGTTTATAGAGAAGAAGAAAGAGAGGAGGAGGAAGAAGCAGAGGTTACAGAATATGAAG
>TTN-202,ENSE00003801264,1,81,867547,867627,TGATGGAAGAGCCTGAGGAATATGTTGTGGAAGAAAAGCTGCACATTATTTCTAAGAGAGTGGAAGCTGAGCCAGCTGAAG
>TTN-202,ENSE00003805756,1,78,867628,867705,TGACAGAGAGGCAGGAGAAGAAAATTGTACTGAAACCAAAAATTCCTGCTAAAATAGAGGAGCCTCCACCGGCTAAAG
>TTN-202,ENSE00003808334,1,84,867706,867789,TTCCTGAAGCACCTAAGAAAATTGTGCCAGAAAAGAAAGTTCCTGCTCCAGTTCCTAAAAAGGAAAAGGTGCCCCCACCTAAAG
>TTN-202,ENSE00003808052,1,84,867790,867873,TGCCAGAAGAGCCAAAGAAACCAGTTCCAGAAAAAAAGGTTCCTCCAAAAGTCATTAAGATGGAAGAACCTCTCCCAGCCAAAG
>TTN-202,ENSE00003803067,1,84,867874,867957,TGACTGAGAGGCACATGCAAATTACCCAGGAAGAAAAAGTTCTTGTTGCTGTAACTAAAAAAGAGGCGCCTCCAAAAGCAAGAG
>TTN-202,ENSE00003808806,1,84,867958,868041,TGCCAGAGGAACCGAAGAGAGCTGTCCCAGAAGAAAAAGTTCTGAAACTCAAACCTAAAAGAGAGGAGGAACCACCAGCTAAAG
>TTN-202,ENSE00003805330,1,81,868042,868122,TGACTGAATTCAGAAAAAGAGTGGTTAAAGAAGAAAAAGTATCAATTGAAGCTCCAAAAAGAGAACCTCAACCCATCAAAG
>TTN-202,ENSE00003807878,1,207,868123,868329,AAGTAACTATAATGGAAGAGAAAGAAAGGGCTTATACCCTAGAAGAAGAAGCTGTTTCAGTACAACGGGAAGAAGAATATGAGGAATATGAAGAATATGATTATAAAGAATTTGAGGAGTATGAACCAACAGAAGAATATGACCAATATGAAGAATACGAGGAGCGGGAGTATGAACGATATGAAGAGCATGAAGAATACATCACAG
>TTN-202,ENSE00003806244,1,78,868330,868407,AACCAGAGAAGCCTATCCCTGTAAAGCCTGTCCCAGAAGAACCAGTTCCCACAAAACCAAAGGCCCCACCGGCTAAAG
>TTN-202,ENSE00003810594,1,75,868408,868482,TGCTGAAGAAAGCTGTCCCTGAAGAAAAAGTACCAGTGCCCATTCCTAAGAAACTCAAACCTCCACCACCCAAAG
>TTN-202,ENSE00003809388,1,93,868483,868575,TGCCTGAAGAACCAAAGAAAGTTTTTGAGGAAAAAATACGTATTTCAATTACCAAACGTGAAAAAGAGCAGGTGACTGAACCCGCTGCTAAAG
>TTN-202,ENSE00003807405,1,78,868576,868653,TGCCCATGAAGCCCAAGAGGGTTGTCGCAGAAGAAAAAGTACCTGTCCCTAGAAAAGAAGTAGCACCACCTGTTAGAG
>TTN-202,ENSE00003810081,1,162,868654,868815,TGCCAGAAGTGCCTAAAGAACTTGAACCAGAAGAGGTTGCCTTTGAAGAGGAAGTTGTAACCCATGTAGAAGAATATCTTGTAGAAGAAGAAGAAGAGTACATTCATGAAGAAGAGGAGTTCATAACTGAGGAAGAAGTGGTGCCAGTGATACCAGTCAAAG
>TTN-202,ENSE00003806496,1,84,868816,868899,TGCCTGAGGTACCCAGGAAACCTGTTCCAGAAGAGAAGAAACCTGTTCCTGTTCCCAAGAAGAAGGAAGCTCCACCGGCAAAAG
>TTN-202,ENSE00003802498,1,78,868900,868977,TGCCTGAGGTTCCTAAGAAGCCAGAGGAGAAAGTTCCTGTGCTTATTCCTAAAAAGGAGAAGCCTCCGCCAGCAAAAG
>TTN-202,ENSE00003809653,1,84,868978,869061,TTCCTGAAGTGCCCAAGAAACCTGTGCCAGAGGAGAAAGTACCAGTACCAGTTCCTAAAAAGGTGGAAGCTCCACCTGCCAAAG
>TTN-202,ENSE00003810862,1,84,869062,869145,TGCCAGAGGTACCCAAGAAGCCTGTGCCTGAGAAGAAGGTGCCAGTTCCTGCTCCTAAGAAAGTGGAGGCTCCACCTGCAAAAG
>TTN-202,ENSE00003805059,1,84,869146,869229,TGCCAGAGGTGCCCAAGAAGCTCATCCCAGAAGAAAAGAAACCAACACCTGTTCCGAAAAAAGTGGAAGCACCACCACCCAAAG
>TTN-202,ENSE00003801382,1,297,869230,869526,TGCCAAAGAAACGTGAACCAGTTCCAGTTCCTGTAGCTCTACCTCAGGAAGAGGAAGTTCTATTTGAAGAAGAAATTGTTCCTGAAGAGGAAGTTCTACCTGAGGAAGAGGAAGTTCTACCTGAGGAAGAGGAAGTTCTACCTGAAGAAGAGGAAGTTCTACCTGAAGAAGAGGAAATTCCACCTGAGGAAGAGGAAGTTCCTCCCGAAGAAGAATATGTACCTGAGGAAGAAGAATTTGTACCTGAAGAAGAAGTCCTTCCAGAAGTTAAACCTAAGGTGCCAGTACCTGCACCAG
>TTN-202,ENSE00003805240,1,75,869527,869601,TGCCTGAAATTAAGAAGAAAGTGACAGAGAAGAAAGTGGTCATTCCCAAGAAAGAGGAGGCTCCCCCTGCCAAAG
>TTN-202,ENSE00003804875,1,75,869602,869676,TTCCTGAGGTGCCTAAGAAGGTGGAAGAAAAACGAATCATTCTCCCTAAAGAAGAGGAAGTTCTACCAGTTGAAG
>TTN-202,ENSE00003801552,1,96,869677,869772,TGACTGAGGAGCCTGAAGAAGAGCCTATTTCAGAAGAAGAAATCCCAGAAGAACCACCTAGCATAGAGGAAGTTGAAGAGGTGGCACCACCTAGAG
>TTN-202,ENSE00003804385,1,78,869773,869850,TGCCTGAAGTGATTAAGAAAGCAGTACCTGAAGCACCTACTCCTGTTCCTAAAAAAGTGGAGGCACCACCAGCTAAAG
>TTN-202,ENSE00003805135,1,69,869851,869919,TGTCAAAGAAAATTCCTGAGGAAAAAGTACCTGTTCCTGTTCAGAAAAAAGAGGCACCCCCAGCCAAAG
>TTN-202,ENSE00003808243,1,75,869920,869994,TGCCTGAAGTACCAAAGAAAGTCCCAGAAAAGAAAGTCCTTGTGCCTAAAAAGGAAGCTGTTCCCCCAGCTAAAG
>TTN-202,ENSE00003808353,1,297,869995,870291,GGAGAACTGTCCTTGAAGAAAAAGTATCAGTTGCCTTCCGCCAAGAAGTAGTAGTAAAAGAAAGACTAGAATTAGAAGTAGTAGAAGCAGAAGTGGAAGAAATTCCGGAAGAAGAAGAGTTCCATGAAGTTGAAGAATATTTTGAAGAAGGCGAGTTTCATGAAGTAGAAGAATTCATCAAATTAGAACAACATAGAGTTGAAGAAGAACACAGAGTTGAAAAAGTTCATAGGGTAATAGAAGTTTTTGAGGCTGAAGAAGTGGAAGTATTTGAAAAACCAAAAGCTCCACCTAAAG
>TTN-202,ENSE00003807571,1,81,870292,870372,GGCCTGAGATATCTGAGAAAATCATCCCTCCAAAAAAACCGCCCACTAAAGTTGTTCCTCGAAAAGAGCCACCAGCTAAAG
>TTN-202,ENSE00003808118,1,78,870373,870450,TACCGGAGGTGCCTAAGAAAATTGTGGTAGAAGAAAAAGTACGTGTTCCTGAAGAGCCCAGAGTTCCACCAACTAAAG
>TTN-202,ENSE00003807304,1,90,870451,870540,TGCCTGAAGTGCTGCCACCGAAGGAAGTGGTCCCAGAAAAGAAAGTACCGGTGCCTCCTGCCAAAAAGCCAGAAGCTCCACCTCCTAAAG
>TTN-202,ENSE00003802745,1,84,870541,870624,TGCCTGAGGCTCCCAAAGAAGTTGTTCCTGAAAAGAAAGTGCCAGTGCCTCCTCCTAAAAAGCCTGAAGTGCCACCCACAAAAG
>TTN-202,ENSE00003809569,1,84,870625,870708,TCCCAGAGGTGCCAAAGGCAGCTGTCCCAGAAAAGAAGGTGCCTGAAGCTATTCCTCCCAAACCGGAAAGTCCTCCCCCTGAAG
>TTN-202,ENSE00003806373,1,84,870709,870792,TGCCAGAGGCTCCGAAAGAAGTTGTTCCTGAAAAGAAAGTGCCAGCGGCTCCTCCTAAAAAGCCTGAAGTCACACCTGTTAAAG
>TTN-202,ENSE00003807489,1,84,870793,870876,TGCCTGAGGCTCCCAAAGAAGTTGTTCCTGAAAAGAAAGTGCCAGTGCCTCCTCCTAAAAAGCCTGAAGTGCCACCCACAAAAG
>TTN-202,ENSE00003805050,1,84,870877,870960,TCCCAGAGGTGCCAAAGGTAGCTGTCCCAGAAAAGAAGGTGCCTGAAGCTATTCCTCCCAAACCGGAAAGTCCTCCCCCTGAAG
>TTN-202,ENSE00003808824,1,84,870961,871044,TGTTCGAGGAGCCTGAGGAAGTTGCCCTAGAAGAGCCTCCTGCTGAAGTTGTGGAAGAGCCAGAGCCAGCGGCGCCTCCACAAG
>TTN-202,ENSE00003807203,1,84,871045,871128,TGACCGTACCACCTAAGAAACCTGTCCCAGAAAAGAAAGCACCTGCTGTCGTTGCCAAAAAACCTGAACTACCACCAGTGAAAG
>TTN-202,ENSE00003811260,1,84,871129,871212,TGCCCGAGGTGCCCAAGGAGGTTGTTCCTGAAAAGAAGGTGCCTCTGGTGGTTCCCAAAAAGCCAGAAGCCCCACCTGCTAAAG
>TTN-202,ENSE00003806229,1,78,871213,871290,TGCCTGAAGTTCCAAAAGAAGTTGTTCCAGAAAAGAAAGTAGCTGTTCCCAAAAAGCCAGAAGTCCCACCAGCAAAAG
>TTN-202,ENSE00003807893,1,84,871291,871374,TGCCAGAAGTGCCAAAGAAACCTGTCTTGGAAGAGAAACCAGCTGTTCCTGTTCCAGAAAGAGCGGAGTCTCCTCCCCCAGAAG
>TTN-202,ENSE00003809515,1,108,871375,871482,TATATGAAGAACCTGAGGAAATTGCTCCTGAAGAGGAAATTGCTCCTGAAGAGGAAAAGCCAGTTCCTGTTGCAGAAGAGGAGGAACCAGAGGTTCCACCTCCAGCAG
>TTN-202,ENSE00003804845,1,78,871483,871560,TGCCTGAAGAGCCCAAGAAGATCATCCCAGAGAAGAAAGTTCCTGTCATCAAAAAACCAGAAGCACCGCCTCCTAAAG
>TTN-202,ENSE00003806702,1,111,871561,871671,AACCTGAACCTGAAAAGGTTATTGAGAAGCCAAAACTCAAACCAAGACCCCCACCTCCTCCACCTGCTCCACCTAAGGAAGATGTGAAGGAGAAAATATTCCAACTTAAAG
>TTN-202,ENSE00003809179,1,69,871672,871740,CTATTCCAAAGAAGAAAGTTCCTGAAAAACCTCAGGTTCCAGAAAAAGTGGAGCTTACACCTCTGAAAG
>TTN-202,ENSE00003804802,1,81,871741,871821,TGCCTGGAGGTGAAAAGAAAGTTCGCAAATTACTTCCGGAACGTAAACCTGAACCAAAGGAAGAAGTTGTTCTGAAAAGCG
>TTN-202,ENSE00003811452,1,75,871822,871896,TTCTAAGAAAAAGACCTGAAGAAGAAGAACCTAAAGTAGAACCTAAAAAACTAGAAAAAGTTAAAAAACCTGCAG
>TTN-202,ENSE00003807205,1,90,871897,871986,TACCAGAACCACCACCTCCAAAACCTGTTGAAGAGGTTGAAGTACCTACTGTTACAAAAAGGGAAAGGAAGATTCCTGAACCAACAAAAG
>TTN-202,ENSE00003806747,1,63,871987,872049,TGCCTGAAATCAAGCCAGCAATACCTCTCCCTGCACCTGAACCGAAACCAAAGCCCGAAGCAG
>TTN-202,ENSE00003810755,1,90,872050,872139,AAGTGAAAACAATCAAACCACCTCCTGTGGAACCTGAACCAACCCCCATCGCTGCCCCAGTAACAGTGCCAGTGGTTGGAAAGAAAGCAG
>TTN-202,ENSE00003806122,1,51,872140,872190,AAGCCAAAGCACCTAAGGAAGAGGCTGCCAAGCCAAAAGGTCCTATCAAAG
>TTN-202,ENSE00003804858,1,402,872191,872592,GTGTACCCAAAAAGACTCCTTCACCAATAGAAGCCGAAAGGAGAAAGTTAAGGCCAGGAAGTGGTGGAGAGAAACCTCCTGATGAAGCCCCGTTCACCTACCAGCTAAAGGCTGTGCCACTGAAGTTTGTGAAAGAAATCAAAGACATCATCTTGACAGAATCAGAGTTCGTTGGCTCTTCAGCAATCTTTGAATGTTTGGTCTCCCCTTCCACTGCAATTACAACCTGGATGAAAGACGGTAGCAATATCCGTGAGAGTCCCAAGCACAGGTTTATTGCAGATGGTAAAGACAGAAAGCTGCACATCATTGATGTTCAACTTTCCGATGCTGGTGAATACACCTGTGTTTTACGTTTGGGAAACAAAGAAAAGACCTCCACGGCTAAACTTGTTGTAGAAG
>TTN-202,ENSE00003803996,1,279,872593,872871,AACTTCCTGTGCGTTTTGTAAAAACACTGGAAGAGGAAGTCACAGTGGTCAAAGGACAGCCATTGTACTTGAGCTGCGAGTTAAACAAAGAGCGTGACGTGGTCTGGAGGAAGGATGGCAAGATTGTGGTGGAGAAACCTGGCCGAATTGTGCCAGGCGTCATTGGCTTGATGCGGGCTCTGACCATCAACGATGCAGATGACACAGATGCTGGAACATACACAGTTACTGTGGAAAACGCCAACAACCTGGAGTGTTCATCTTGCGTAAAAGTAGTAG
>TTN-202,ENSE00003807976,1,276,872872,873147,AAGTCATTAGAGATTGGCTGGTGAAACCTATACGAGACCAGCATGTGAAACCCAAGGGGACAGCTATTTTTGCCTGTGATATAGCAAAAGATACTCCAAACATTAAGTGGTTCAAAGGATATGATGAAATCCCTGCGGAACCAAATGATAAGACTGAAATACTGAGAGATGGAAATCATCTGTACCTCAAAATTAAGAATGCTATGCCAGAAGATATTGCTGAGTATGCAGTGGAAATTGAAGGAAAAAGATACCCTGCAAAGCTGACACTTGGAG
>TTN-202,ENSE00003804328,1,140,873148,873287,AGCGTGAAGTTGAACTGCTTAAACCAATAGAGGACGTTACCATTTATGAGAAAGAAAGTGCAAGCTTTGATGCAGAAATCTCAGAGGCAGACATTCCTGGACAATGGAAACTGAAAGGAGAACTTCTAAGGCCCTCACCT
>TTN-202,ENSE00003802254,1,127,873288,873414,ACTTGTGAAATCAAAGCAGAAGGTGGAAAACGCTTCTTAACTTTGCACAAAGTCAAACTGGACCAAGCTGGTGAAGTCCTCTACCAGGCCCTTAATGCAATTACAACTGCCATTTTGACAGTAAAAG
>TTN-202,ENSE00003811410,1,264,873415,873678,AAATCGAACTTGACTTTGCTGTGCCCCTGAAGGATGTCACTGTTCCAGAAAGGCGACAGGCTCGATTCGAATGTGTCCTCACCCGAGAGGCAAATGTTATATGGTCCAAAGGACCTGATATAATTAAGTCATCTGACAAATTTGATATCATCGCTGATGGAAAGAAACATATTCTTGTTATTAATGATTCTCAATTTGATGATGAAGGGGTCTATACTGCTGAGGTGGAGGGCAAGAAGACCTCAGCTCGGTTGTTTGTCACAG
>TTN-202,ENSE00003805150,1,267,873679,873945,GTATAAGACTGAAATTCATGTCACCTCTTGAAGATCAAACAGTAAAAGAAGGTGAAACAGCAACTTTTGTTTGTGAACTTTCTCATGAAAAAATGCATGTAGTCTGGTTCAAAAATGATGCCAAACTCCATACAAGCAGAACAGTACTCATCTCTTCTGAGGGCAAGACTCACAAATTGGAAATGAAAGAAGTGACATTGGATGATATATCTCAGATAAAAGCTCAAGTCAAGGAGCTGAGCTCCACAGCACAGCTGAAGGTCTTAG
>TTN-202,ENSE00003801907,1,264,873946,874209,AGGCCGATCCCTACTTCACTGTGAAATTACATGACAAAACTGCAGTGGAGAAGGATGAGATTACTTTGAAGTGTGAAGTGAGCAAAGATGTACCAGTGAAATGGTTCAAAGATGGTGAAGAGATTGTCCCTTCACCCAAATATTCTATCAAGGCAGATGGCCTGCGCCGCATCTTAAAAATCAAAAAGGCGGACCTTAAAGATAAAGGCGAATATGTGTGTGACTGTGGCACAGACAAGACCAAGGCAAATGTTACTGTTGAGG
>TTN-202,ENSE00003802031,1,140,874210,874349,CTCGACTAATAAAAGTGGAAAAGCCTCTGTACGGAGTAGAGGTGTTTGTTGGTGAAACAGCCCACTTTGAAATTGAACTTTCTGAACCTGATGTTCACGGCCAGTGGAAGCTGAAAGGACAGCCTTTGACAGCTTCCCCT
>TTN-202,ENSE00003811443,1,127,874350,874476,GACTGTGAAATCATTGAGGATGGAAAGAAGCATATTCTGATCCTTCATAACTGTCAGCTGGGTATGACAGGAGAGGTTTCCTTCCAGGCTGCTAATGCCAAATCTGCAGCCAATCTGAAAGTGAAAG
>TTN-202,ENSE00003811384,1,267,874477,874743,AATTGCCTCTTATCTTCATCACACCTCTCAGTGATGTTAAAGTCTTCGAGAAAGATGAGGCTAAGTTTGAGTGTGAAGTATCCAGGGAGCCCAAAACATTCCGTTGGCTAAAAGGAACCCAGGAAATCACAGGTGATGACAGATTTGAGCTTATAAAGGATGGCACTAAGCATTCAATGGTGATCAAGTCAGCTGCTTTTGAAGATGAAGCAAAATACATGTTTGAAGCTGAAGATAAGCACACAAGTGGCAAACTGATCATTGAAG
>TTN-202,ENSE00003801954,1,267,874744,875010,GAATCCGGCTCAAATTCCTCACCCCTCTCAAAGATGTAACTGCCAAAGAGAAGGAAAGTGCTGTATTTACTGTGGAGTTATCTCATGATAACATCCGAGTTAAATGGTTCAAGAATGACCAGCGCCTACACACCACCAGGTCGGTCTCAATGCAAGACGAAGGGAAAACTCATTCGATCACATTCAAAGACCTGTCTATTGATGACACCTCCCAAATTAGAGTAGAAGCTATGGGGATGAGTTCAGAAGCTAAACTCACTGTGCTTG
>TTN-202,ENSE00003809996,1,267,875011,875277,AGGGAGACCCATATTTTACAGGAAAACTTCAAGATTATACTGGTGTAGAGAAAGATGAAGTTATTCTACAGTGTGAAATTAGCAAAGCAGATGCACCAGTGAAATGGTTTAAGGATGGGAAGGAAATAAAGCCATCCAAAAATGCTGTTATTAAGGCAGATGGCAAGAAACGCATGCTAATCCTAAAGAAAGCCTTGAAATCAGATATTGGACAGTACACCTGTGACTGTGGGACAGATAAGACCTCAGGAAAACTTGACATTGAGG
>TTN-202,ENSE00003804589,1,140,875278,875417,ATCGGGAAATTAAACTGGTGCGACCCCTGCACAGTGTGGAGGTGATGGAGACTGAGACAGCACGCTTTGAAACCGAAATCTCTGAAGATGATATCCACGCCAACTGGAAACTCAAGGGAGAGGCCCTACTCCAAACACCT
>TTN-202,ENSE00003805931,1,127,875418,875544,GATTGTGAAATTAAGGAAGAAGGCAAAATACACTCCCTTGTTTTGCACAACTGTCGCCTGGACCAGACGGGTGGGGTGGATTTCCAAGCTGCCAATGTTAAATCTAGTGCCCACCTCCGAGTTAAGC
>TTN-202,ENSE00003811344,1,143,875545,875687,CACGAGTAATTGGTCTTCTGAGGCCTTTAAAGGATGTCACCGTGACTGCAGGGGAAACAGCCACCTTCGACTGCGAGCTCTCCTACGAAGATATCCCAGTGGAATGGTATCTCAAAGGGAAGAAACTAGAGCCCAGCGATAAG
>TTN-202,ENSE00003802375,1,124,875688,875811,GTGGTCCCACGTTCAGAAGGAAAAGTTCATACACTTACTCTGAGGGATGTAAAGTTAGAAGATGCTGGGGAAGTCCAACTAACAGCAAAAGATTTCAAAACTCACGCCAACCTCTTTGTGAAAG
>TTN-202,ENSE00003806733,1,267,875812,876078,AACCCCCAGTTGAATTCACTAAGCCTCTTGAGGACCAGACGGTCGAAGAGGGAGCCACTGCAGTGCTGGAGTGTGAAGTCTCCAGAGAAAATGCTAAGGTGAAATGGTTCAAAAATGGGACAGAAATCCTCAAAAGCAAGAAGTATGAAATTGTTGCTGATGGCAGGGTCAGAAAACTTGTTATACATGACTGTACCCCAGAGGATATTAAAACATACACTTGTGATGCTAAGGATTTTAAGACTTCCTGTAACCTGAATGTCGTGC
>TTN-202,ENSE00003807497,1,98,876079,876176,CTCCTCATGTGGAATTCTTAAGACCACTCACCGACCTTCAAGTTAGAGAAAAAGAAATGGCTCGATTTGAGTGTGAACTTTCCCGAGAAAATGCTAAG
>TTN-202,ENSE00003802530,1,169,876177,876345,GTTAAGTGGTTTAAAGATGGTGCTGAAATTAAAAAGGGCAAAAAATATGACATCATATCCAAGGGAGCAGTGCGCATTCTTGTCATCAACAAATGTCTACTGGATGATGAAGCTGAATATTCCTGTGAAGTAAGGACAGCGAGAACTTCTGGCATGCTGACAGTTCTGG
>TTN-202,ENSE00003811387,1,267,876346,876612,AAGAAGAAGCTGTCTTTACCAAAAATCTTGCCAACATTGAAGTTAGTGAAACAGACACTATAAAACTGGTTTGTGAAGTCTCCAAACCTGGCGCAGAAGTGATTTGGTATAAAGGGGATGAGGAGATCATTGAAACAGGAAGATATGAAATACTGACTGAAGGACGGAAGAGAATCCTGGTCATTCAGAACGCTCACCTTGAGGATGCTGGCAACTACAACTGTCGACTCCCAAGCTCTCGAACCGATGGCAAAGTCAAAGTACATG
>TTN-202,ENSE00003802653,1,267,876613,876879,AACTGGCTGCTGAATTTATCTCAAAGCCTCAAAACCTTGAAATACTTGAAGGAGAAAAGGCTGAATTTGTCTGCTCTATATCAAAAGAAAGCTTTCCAGTCCAGTGGAAGAGGGATGATAAGACACTTGAATCTGGAGATAAATATGACGTTATTGCTGATGGTAAAAAGAGGGTCCTAGTTGTGAAAGATGCCACATTACAAGATATGGGCACTTACGTTGTCATGGTAGGGGCCGCCAGAGCAGCAGCTCACTTGACAGTCATTG
>TTN-202,ENSE00003802540,1,279,876880,877158,AAAAACTCAGGATCGTAGTTCCTCTTAAGGACACCCGGGTGAAGGAACAACAGGAAGTTGTCTTCAACTGTGAAGTCAATACTGAAGGTGCCAAAGCCAAATGGTTCAGAAATGAAGAAGCTATATTTGATAGTTCAAAATACATCATTCTCCAAAAAGACCTAGTCTACACCCTCAGAATTAGAGATGCACACTTAGATGACCAAGCCAACTATAATGTGTCTTTGACCAATCACAGAGGTGAAAATGTTAAAAGTGCAGCCAATCTAATAGTAGAAG
>TTN-202,ENSE00003802874,1,409,877159,877567,AGGAAGACCTTAGGATTGTTGAGCCTCTTAAAGATATTGAAACAATGGAGAAGAAATCTGTCACATTCTGGTGCAAGGTGAATCGTCTCAATGTAACACTGAAGTGGACCAAAAATGGTGAAGAAGTGCCTTTTGACAACCGTGTCTCATACAGAGTTGATAAGTACAAGCACATGTTAACCATTAAAGACTGTGGCTTCCCAGATGAAGGTGAATACATTGTCACTGCTGGACAAGATAAATCTGTTGCTGAGCTTCTCATCATAGAAGCCCCGACAGAATTTGTGGAACACTTGGAAGATCAGACAGTCACTGAGTTCGATGACGCTGTCTTCTCCTGCCAGCTCTCCAGAGAGAAAGCCAATGTAAAATGGTACAGAAATGGGAGAGAAATCAAAGAAGGCAAAAA
>TTN-202,ENSE00003804130,1,125,877568,877692,ATACAAATTTGAAAAAGATGGAAGTATACACAGACTCATTATAAAAGATTGCAGGCTGGATGATGAGTGTGAATATGCTTGCGGGGTAGAAGACAGGAAGTCTCGTGCTAGACTTTTTGTGGAAG
>TTN-202,ENSE00003807647,1,267,877693,877959,AAATTCCTGTTGAGATCATCAGGCCTCCACAAGATATTCTTGAAGCCCCTGGTGCTGATGTTGTCTTTTTAGCAGAACTCAATAAAGATAAGGTGGAAGTCCAATGGCTAAGAAATAACATGGTTGTTGTCCAGGGTGATAAACACCAGATGATGAGTGAAGGAAAGATACATCGACTACAGATTTGTGATATTAAGCCCCGTGACCAGGGTGAATACAGATTTATTGCCAAAGACAAAGAAGCCAGAGCTAAGCTTGAACTGGCAG
>TTN-202,ENSE00003802353,1,270,877960,878229,CTGCACCAAAAATCAAGACAGCTGACCAAGACCTTGTGGTTGATGTTGGCAAGCCTCTGACAATGGTGGTGCCATATGATGCCTACCCCAAAGCAGAAGCTGAATGGTTTAAAGAAAATGAACCTTTATCTACAAAAACCATTGATACTACGGCTGAACAAACTTCTTTCAGAATTTTAGAAGCCAAGAAAGGAGACAAAGGGAGGTATAAAATTGTGCTTCAGAACAAACATGGAAAAGCAGAAGGATTCATCAATTTAAAAGTTATTG
>TTN-202,ENSE00003809195,1,303,878230,878532,ATGTTCCTGGGCCAGTACGTAACTTAGAAGTGACAGAAACATTTGATGGTGAAGTGAGCCTTGCTTGGGAAGAACCTTTAACTGATGGTGGAAGCAAAATCATAGGTTACGTTGTTGAAAGACGTGACATTAAGAGAAAGACCTGGGTTCTGGCCACAGACCGTGCAGAGAGTTGTGAGTTTACTGTCACTGGTCTACAGAAAGGAGGAGTTGAGTACCTATTCCGTGTGAGTGCAAGAAACAGAGTTGGCACTGGTGAGCCAGTAGAAACTGACAATCCTGTAGAAGCAAGGAGTAAATATG
>TTN-202,ENSE00003803170,1,303,878533,878835,ATGTTCCAGGCCCTCCTTTGAATGTAACCATCACTGATGTGAATCGATTTGGTGTCTCACTGACATGGGAACCACCAGAGTATGATGGAGGTGCTGAGATCACAAACTACGTCATTGAATTAAGAGACAAGACTTCTATCAGGTGGGATACTGCCATGACTGTGAGAGCTGAAGACCTGTCTGCAACTGTTACTGATGTGGTAGAAGGACAGGAGTACAGTTTCCGAGTGAGAGCCCAAAATCGAATTGGAGTTGGAAAACCAAGTGCAGCCACACCCTTCGTCAAAGTTGCTGATCCAATTG
>TTN-202,ENSE00003806295,1,188,878836,879023,AGAGACCAAGTCCTCCTGTAAACCTAACTTCCTCAGATCAGACTCAGTCATCAGTTCAGCTCAAATGGGAACCTCCTCTGAAAGATGGAGGAAGCCCAATATTAGGCTATATAATTGAGCGATGCGAAGAAGGAAAAGATAATTGGATTCGTTGCAATATGAAACTTGTCCCTGAACTGACTTACAAG
>TTN-202,ENSE00003810732,1,115,879024,879138,GTTACCGGATTGGAAAAAGGAAATAAATATTTATATAGAGTATCTGCAGAAAATAAAGCTGGTGTTTCAGATCCATCTGAAATTCTTGGTCCTCTCACCGCTGACGATGCATTTG
>TTN-202,ENSE00003809985,1,285,879139,879423,TTGAACCAACAATGGATTTAAGTGCATTTAAAGATGGTCTGGAAGTTATTGTCCCAAATCCTATCACGATCCTGGTTCCAAGTACAGGCTATCCAAGGCCAACTGCAACCTGGTGTTTTGGAGATAAAGTACTAGAAACAGGGGACCGGGTGAAAATGAAGACCTTGTCTGCCTATGCCGAACTTGTCATTTCTCCAAGTGAACGTTCAGACAAGGGCATTTATACACTGAAATTAGAAAACCGTGTGAAAACAATTTCTGGGGAAATTGATGTCAATGTAATTG
>TTN-202,ENSE00003808828,1,152,879424,879575,CTCGCCCAAGTGCACCCAAAGAATTGAAATTTGGTGATATAACCAAGGACTCAGTACATTTGACTTGGGAACCACCTGATGATGATGGAGGAAGTCCGTTAACTGGATACGTTGTTGAAAAACGAGAAGTCAGCCGGAAAACATGGACTAAA
>TTN-202,ENSE00003803811,1,148,879576,879723,GTTATGGACTTTGTGACTGATCTAGAATTCACAGTTCCTGATCTTGTTCAAGGAAAAGAGTACTTATTTAAAGTTTGTGCTCGTAACAAATGTGGCCCTGGAGAACCTGCATATGTTGATGAACCTGTAAATATGTCAACTCCTGCAA
>TTN-202,ENSE00003803944,1,178,879724,879901,CGGTACCTGACCCACCAGAGAATGTTAAATGGAGAGATCGAACAGCCAATAGCATCTTCTTAACATGGGATCCACCTAAAAATGATGGTGGTTCACGCATCAAAGGATATATAGTTGAAAGATGTCCACGTGGTTCTGATAAATGGGTTGCCTGTGGAGAACCTGTTGCAGAAACAAA
>TTN-202,ENSE00003802090,1,122,879902,880023,AATGGAAGTGACAGGTCTTGAGGAAGGCAAATGGTATGCCTACCGCGTGAAGGCCTTAAACAGGCAGGGTGCTAGCAAACCAAGCAGACCCACAGAGGAAATCCAGGCTGTGGACACACAAG
>TTN-202,ENSE00003809522,1,288,880024,880311,AGGCCCCAGAAATCTTCCTCGATGTGAAGCTCCTTGCTGGTCTCACTGTAAAAGCTGGGACCAAGATTGAACTTCCTGCCACCGTAACCGGAAAACCTGAACCTAAAATAACTTGGACAAAGGCTGATATGATTCTGAAGCAGGACAAAAGAATTACCATTGAAAATGTCCCTAAGAAATCCACAGTGACTATTGTTGATAGTAAGAGAAGTGACACTGGCACATATATCATTGAGGCTGTGAATGTGTGTGGCCGGGCCACTGCTGTGGTGGAAGTGAACGTCTTAG
>TTN-202,ENSE00003804879,1,297,880312,880608,ATAAACCCGGACCACCAGCTGCCTTTGACATCACAGATGTAACCAATGAGTCATGTCTTCTAACATGGAACCCACCACGCGATGATGGTGGATCTAAGATCACAAACTATGTTGTGGAGAGACGAGCAACTGATAGTGAAGTGTGGCACAAGCTCTCATCCACCGTCAAGGATACAAACTTCAAGGCCACCAAATTAATCCCCAATAAAGAGTACATCTTCAGAGTTGCTGCAGAAAACATGTATGGTGTTGGTGAACCAGTTCAGGCCTCTCCAATAACAGCCAAATATCAGTTTG
>TTN-202,ENSE00003809410,1,187,880609,880795,ATCCACCTGGTCCTCCAACTCGCCTAGAACCTTCTGATATCACTAAAGACGCAGTGACTCTCACATGGTGTGAGCCAGATGATGATGGTGGCAGCCCAATCACAGGATACTGGGTTGAAAGACTGGATCCTGATACAGATAAATGGGTTAGATGCAATAAGATGCCAGTAAAGGACACAACATACAG
>TTN-202,ENSE00003808827,1,116,880796,880911,AGTGAAAGGTCTCACTAATAAGAAAAAATACAGATTCCGTGTGTTGGCTGAAAATCTTGCTGGACCTGGAAAACCAAGCAAATCAACTGAACCAATCTTAATAAAGGATCCCATAG
>TTN-202,ENSE00003806136,1,300,880912,881211,ATCCTCCATGGCCCCCTGGAAAACCAACTGTAAAAGATGTAGGCAAAACATCAGTAAGGTTGAATTGGACAAAACCAGAACATGATGGAGGTGCAAAGATTGAGTCTTATGTCATTGAAATGCTGAAGACTGGAACAGATGAGTGGGTCAGAGTGGCGGAAGGGGTTCCCACCACTCAGCACTTGCTCCCAGGGCTCATGGAAGGACAGGAATACTCATTCCGAGTTAGAGCTGTGAATAAGGCTGGGGAAAGTGAACCCAGTGAACCCAGTGACCCTGTGCTTTGCCGGGAGAAGCTAT
>TTN-202,ENSE00003804290,1,300,881212,881511,ATCCTCCATCACCACCACGCTGGCTTGAAGTTATTAATATCACAAAAAATACAGCAGACCTAAAATGGACAGTTCCTGAGAAAGATGGAGGGTCCCCCATCACCAACTACATTGTGGAAAAGAGAGACGTCAGGCGAAAAGGCTGGCAAACAGTGGATACCACTGTCAAGGACACCAAGTGCACAGTCACCCCACTGACTGAGGGCTCTTTATATGTGTTCCGAGTTGCTGCAGAAAATGCTATAGGACAAAGCGACTACACCGAAATTGAGGACTCTGTGCTGGCCAAAGACACCTTTA
>TTN-202,ENSE00003803723,1,106,881512,881617,CCACTCCTGGACCACCCTACGCCCTGGCAGTGGTTGATGTGACAAAACGACATGTTGACCTAAAGTGGGAGCCACCTAAAAATGATGGTGGAAGACCAATACAGAG
>TTN-202,ENSE00003805819,1,197,881618,881814,ATATGTCATTGAGAAGAAAGAAAGGTTAGGTACCCGTTGGGTGAAAGCTGGAAAGACTGCAGGACCTGACTGTAACTTCAGAGTAACTGATGTCATCGAAGGAACAGAGGTCCAGTTTCAGGTTCGGGCTGAAAATGAAGCTGGAGTTGGCCACCCAAGTGAACCCACAGAAATCCTATCCATTGAAGATCCAACAA
>TTN-202,ENSE00003806467,1,306,881815,882120,GTCCTCCCTCACCACCCCTTGACCTACATGTGACTGATGCTGGGAGAAAACACATTGCCATTGCTTGGAAGCCTCCAGAGAAAAATGGTGGAAGTCCTATCATAGGATACCATGTTGAAATGTGTCCAGTAGGCACTGAGAAATGGATGAGAGTTAATTCTCGCCCAATAAAGGACTTGAAATTCAAGGTTGAAGAAGGTGTTGTTCCTGACAAAGAATATGTCCTGAGAGTGAGAGCAGTCAATGCTATTGGTGTCAGCGAGCCATCTGAAATCTCTGAAAATGTGGTTGCCAAAGACCCAGACT
>TTN-202,ENSE00003808061,1,279,882121,882399,GCAAGCCAACAATTGACCTGGAGACTCATGACATTATTGTTATTGAAGGTGAAAAGTTAAGCATTCCTGTTCCCTTCAGAGCTGTCCCAGTTCCAACTGTTAGTTGGCATAAAGATGGCAAAGAAGTTAAAGCAAGTGATAGATTAACAATGAAGAATGATCACATCTCTGCACACCTTGAAGTTCCCAAGAGTGTCCGTGCAGATGCCGGAATTTATACCATTACACTGGAGAATAAGCTCGGCTCAGCAACAGCCTCAATCAATGTCAAAGTCATAG
>TTN-202,ENSE00003811164,1,300,882400,882699,GCCTACCTGGACCATGCAAAGATATTAAAGCAAGTGACATTACCAAGAGTTCTTGTAAGTTAACTTGGGAACCTCCAGAATTTGATGGTGGAACCCCAATTCTTCATTATGTCCTGGAGCGCAGAGAAGCTGGGAGGAGAACATATATACCAGTCATGTCTGGTGAGAACAAACTGTCATGGACTGTGAAGGATCTCATACCAAATGGTGAATACTTCTTCCGTGTTAAAGCAGTCAACAAGGTTGGTGGAGGAGAATATATTGAACTGAAAAATCCAGTCATTGCTCAAGATCCAAAGC
>TTN-202,ENSE00003805132,1,303,882700,883002,AACCCCCTGATCCACCTGTAGATGTAGAGGTTCATAATCCTACAGCGGAGGCAATGACTATTACATGGAAGCCACCTTTGTATGATGGAGGGAGCAAGATAATGGGCTACATCATAGAGAAGATTGCTAAGGGTGAAGAAAGGTGGAAGAGATGCAATGAACACCTGGTACCAATCCTGACCTATACAGCAAAAGGACTTGAAGAGGGGAAAGAGTACCAATTCCGTGTGCGAGCAGAGAACGCCGCGGGTATTAGTGAACCTTCTCGGGCTACTCCTCCAACCAAAGCTGTAGATCCCATTG
>TTN-202,ENSE00003805056,1,363,883003,883365,ATGCCCCCAAAGTCATTCTGAGAACAAGCCTAGAAGTGAAACGAGGTGATGAAATAGCACTTGATGCAAGTATTTCTGGATCACCTTACCCAACTATTACATGGATAAAGGATGAAAATGTTATTGTACCAGAGGAAATTAAGAAGCGTGCAGCACCCTTGGTTAGGAGAAGGAAGGGTGAAGTTCAAGAAGAAGAACCATTTGTCCTGCCTCTGACACAGCGTTTGAGTATTGACAACAGCAAAAAGGGAGAATCTCAGCTACGCGTCCGAGATTCTCTCCGACCTGACCATGGTCTGTATATGATCAAAGTTGAAAATGACCACGGTATTGCAAAAGCTCCTTGTACTGTCAGTGTGTTAG
>TTN-202,ENSE00003811138,1,303,883366,883668,ATACACCGGGACCACCAATCAACTTTGTATTTGAAGATATCAGAAAGACCTCAGTCCTTTGTAAATGGGAACCACCCCTTGATGATGGTGGCAGTGAAATCATAAACTACACTTTGGAAAAGAAAGACAAGACAAAACCCGACTCAGAATGGATTGTTGTCACTTCAACACTTAGACATTGCAAATATTCAGTAACAAAACTGATTGAAGGAAAAGAGTACCTCTTCCGTGTAAGAGCTGAAAACAGATTTGGGCCAGGTCCACCATGTGTTTCAAAGCCACTTGTGGCTAAAGATCCATTTG
>TTN-202,ENSE00003809346,1,300,883669,883968,GACCACCTGATGCACCAGATAAGCCCATTGTGGAAGATGTTACCAGCAACAGTATGCTAGTGAAATGGAATGAACCAAAAGATAATGGAAGCCCCATTTTGGGTTACTGGCTTGAAAAACGTGAAGTTAACAGTACACATTGGTCTCGTGTCAACAAAAGCCTTCTGAATGCCTTGAAAGCCAATGTAGATGGCTTATTAGAAGGACTCACCTATGTCTTCAGAGTATGTGCTGAAAATGCAGCTGGACCTGGAAAGTTCAGTCCACCTTCAGATCCCAAAACAGCACATGATCCAATCT
>TTN-202,ENSE00003806782,1,297,883969,884265,CTCCTCCTGGGCCACCTATCCCAAGAGTCACTGACACAAGCTCTACAACTATTGAACTAGAATGGGAACCCCCAGCTTTCAATGGTGGTGGGGAAATTGTTGGCTATTTTGTTGATAAGCAGTTGGTTGGCACAAATGAATGGTCACGCTGCACAGAGAAGATGATCAAGGTCCGTCAGTACACCGTCAAAGAAATCCGAGAGGGTGCTGATTACAAACTTCGGGTGAGTGCTGTCAATGCCGCAGGGGAAGGACCGCCTGGAGAAACACAACCTGTTACTGTGGCTGAACCACAAG
>TTN-202,ENSE00003804121,1,285,884266,884550,AGCCTCCAGCTGTGGAACTGGATGTTTCTGTCAAGGGTGGAATACAAATAATGGCTGGGAAGACTCTTAGAATTCCAGCTGTGGTGACTGGTCGCCCTGTACCTACAAAAGTATGGACCAAAGAAGAAGGGGAGCTGGATAAAGACCGTGTTGTAATAGACAACGTTGGAACCAAATCTGAACTAATTATCAAGGATGCACTGCGAAAAGACCATGGCAGATATGTGATTACAGCTACAAATAGCTGTGGTTCCAAATTTGCAGCAGCCAGGGTAGAAGTTTTTG
>TTN-202,ENSE00003804454,1,294,884551,884844,ATGTCCCTGGTCCAGTTCTTGACTTAAAACCTGTTGTAACAAACAGAAAAATGTGTCTACTTAACTGGTCTGATCCAGAAGATGATGGAGGAAGTGAAATAACAGGCTTTATCATTGAAAGAAAAGATGCCAAGATGCATACTTGGAGACAACCAATAGAGACTGAGAGATCTAAATGTGACATCACAGGTCTGCTTGAGGGACAAGAATATAAGTTCCGTGTTATTGCCAAGAACAAGTTTGGCTGTGGCCCTCCTGTTGAAATAGGACCAATTCTTGCAGTTGATCCACTAG
>TTN-202,ENSE00003803420,1,300,884845,885144,GTCCTCCAACATCTCCAGAGAGGCTCACATACACTGAAAGGACAAAGTCCACTATCACACTTGACTGGAAAGAGCCCCGCAGTAATGGTGGCAGTCCCATCCAAGGATATATCATTGAAAAACGGCGTCATGACAAACCTGACTTTGAAAGAGTTAACAAGCGACTCTGCCCAACCACATCTTTTCTGGTTGAAAATCTTGATGAACACCAAATGTATGAGTTCCGTGTCAAAGCTGTCAATGAAATTGGTGAAAGTGAACCATCCCTACCTCTTAATGTAGTCATACAAGATGATGAAG
>TTN-202,ENSE00003809028,1,309,885145,885453,TGCCTCCAACTATTAAGTTGCGTCTGAGTGTTCGAGGAGACACTATCAAAGTTAAGGCAGGAGAGCCTGTCCACATCCCTGCAGATGTGACAGGCCTTCCAATGCCTAAGATTGAATGGTCCAAAAATGAAACTGTAATTGAAAAACCCACTGATGCACTTCAGATAACCAAGGAAGAGGTATCCCGAAGTGAGGCAAAAACTGAGCTTAGCATTCCCAAAGCGGTCCGGGAGGACAAAGGCACTTACACAGTTACTGCTTCCAATCGCCTTGGCTCAGTGTTCCGAAATGTTCACGTTGAAGTATATG
>TTN-202,ENSE00003801894,1,191,885454,885644,ACCGCCCATCCCCACCAAGAAATCTTGCTGTTACTGACATTAAAGCTGAATCTTGCTACTTGACATGGGATGCCCCTCTTGATAATGGTGGCAGTGAAATCACCCATTATGTTATTGACAAACGTGATGCAAGTAGGAAGAAAGCAGAATGGGAGGAAGTCACCAACACTGCTGTAGAGAAAAGATATGGG
>TTN-202,ENSE00003809851,1,430,885645,886074,ATCTGGAAACTTATCCCCAATGGTCAGTATGAGTTCCGAGTCAGGGCAGTGAATAAATATGGAATCAGTGATGAGTGCAAATCAGATAAAGTAGTCATTCAAGATCCTTATCGCCTTCCTGGACCTCCAGGAAAACCAAAAGTTTTGGCACGCACCAAAGGATCAATGCTAGTGAGCTGGACTCCTCCTTTGGACAATGGTGGCTCTCCAATTACTGGCTACTGGCTGGAGAAAAGAGAAGAGGGAAGTCCTTATTGGTCACGTGTTAGCCGAGCACCAATAACCAAAGTGGGATTGAAAGGCGTGGAATTTAATGTTCCTCGTTTGCTTGAAGGCGTTAAATACCAGTTCAGAGCCATGGCAATAAATGCTGCAGGAATTGGTCCTCCCAGTGAACCATCAGATCCAGAGGTTGCAGGAGATCCCATAT
>TTN-202,ENSE00003808594,1,309,886075,886383,TTCCACCGGGGCCACCTTCTTGCCCAGAAGTTAAAGATAAAACGAAGTCAAGCATCTCACTAGGATGGAAACCTCCAGCCAAAGATGGTGGCAGCCCAATCAAAGGATACATTGTAGAAATGCAAGAAGAAGGTACTACTGACTGGAAAAGAGTAAATGAACCAGACAAACTTATAACTACCTGTGAATGTGTGGTGCCTAATCTGAAAGAGCTCAGGAAGTACAGATTCAGAGTGAAAGCTGTCAATGAAGCTGGTGAATCTGAACCAAGTGATACAACTGGGGAGATCCCTGCCACTGATATTCAAG
>TTN-202,ENSE00003810473,1,149,886384,886532,AGGAACCAGAAGTTTTCATTGACATTGGAGCACAGGACTGTCTGGTTTGTAAAGCTGGCTCACAGATTAGGATTCCTGCTGTCATCAAGGGACGCCCAACACCAAAATCATCTTGGGAATTTGATGGAAAGGCAAAGAAAGCAATGAAG
>TTN-202,ENSE00003801625,1,33,886533,886565,GATGGAGTTCATGACATACCCGAAGATGCACAG
>TTN-202,ENSE00003802643,1,130,886566,886695,CTGGAGACTGCTGAAAACTCCTCAGTAATTATTATTCCGGAGTGTAAACGATCTCATACAGGCAAATACAGCATCACAGCCAAGAATAAAGCAGGACAAAAGACTGCAAATTGCAGAGTTAAAGTCATGG
>TTN-202,ENSE00003804239,1,300,886696,886995,ATGTACCAGGCCCACCCAAAGATCTGAAAGTCAGTGATATCACAAGGGGTAGTTGCAGACTTTCATGGAAGATGCCAGACGACGATGGAGGAGACAGGATCAAAGGCTATGTTATTGAGAAGAGGACTATTGATGGAAAAGCCTGGACCAAAGTCAATCCAGACTGTGGAAGCACCACATTTGTAGTGCCTGATCTCCTCTCTGAACAGCAATATTTCTTCCGTGTGCGAGCAGAAAACCGTTTTGGTATTGGCCCACCTGTGGAAACCATTCAGAGGACCACTGCCAGAGATCCGATAT
>TTN-202,ENSE00003806278,1,318,886996,887313,ATCCTCCTGATCCTCCTATTAAACTCAAGATTGGCCTCATCACAAAGAACACAGTGCATCTGTCATGGAAACCCCCGAAGAATGATGGGGGCTCCCCTGTTACCCACTATATTGTTGAGTGCCTTGCATGGGACCCTACTGGGACAAAGAAAGAAGCCTGGAGGCAGTGCAATAAGCGTGATGTGGAAGAACTGCAATTTACTGTTGAAGACCTAGTAGAGGGTGGGGAATATGAATTCCGAGTCAAAGCTGTCAATGCTGCAGGAGTCAGCAAGCCTTCAGCCACTGTTGGCCCTGTGACTGTCAAAGACCAGACAT
>TTN-202,ENSE00003801391,1,297,887314,887610,GCCCACCATCAATTGATCTAAAAGAATTCATGGAGGTTGAAGAAGGAACCAATGTTAACATTGTGGCCAAAATTAAAGGTGTGCCATTCCCGACACTAACCTGGTTTAAAGCTCCTCCAAAGAAGCCTGATAACAAAGAACCTGTTCTCTATGACACCCATGTCAACAAACTGGTGGTAGATGATACTTGCACTTTAGTTATTCCGCAGTCTCGCAGGAGTGACACTGGCTTATATACCATCACAGCTGTAAATAATCTGGGAACAGCATCAAAGGAGATGAGACTGAATGTCCTGG
>TTN-202,ENSE00003806021,1,300,887611,887910,GTCGTCCTGGCCCTCCAGTGGGACCCATAAAATTTGAATCTGTTTCAGCAGATCAAATGACACTATCTTGGTTTCCACCTAAAGATGATGGTGGGTCTAAGATTACAAACTATGTAATTGAGAAAAGAGAAGCTAACAGGAAGACATGGGTCCATGTCTCCAGTGAACCTAAGGAGTGCACGTACACGATTCCCAAATTGCTAGAAGGCCATGAATATGTATTCCGAATCATGGCCCAGAATAAATATGGCATTGGAGAACCTCTTGACAGTGAACCTGAAACAGCAAGAAACCTCTTCT
>TTN-202,ENSE00003803442,1,315,887911,888225,CTGTCCCTGGAGCACCAGATAAACCAACAGTTAGCAGCGTGACTCGTAACTCCATGACTGTCAACTGGGAAGAGCCAGAATATGATGGAGGCTCTCCTGTGACAGGGTACTGGCTGGAAATGAAAGACACCACTTCAAAGAGATGGAAGAGAGTTAACCGAGATCCTATCAAAGCCATGACTTTGGGTGTTTCTTATAAAGTGACTGGTCTTATTGAAGGTTCCGACTATCAATTCCGGGTATATGCAATCAATGCTGCTGGCGTGGGTCCAGCAAGTCTGCCATCAGACCCAGCGACTGCTAGAGATCCAATTG
>TTN-202,ENSE00003801787,1,149,888226,888374,CCCCTCCTGGTCCTCCATTTCCCAAAGTGACAGATTGGACTAAATCATCTGCAGATCTGGAGTGGTCTCCCCCACTAAAAGATGGTGGATCCAAAGTAACTGGATACATCGTTGAATATAAAGAAGAAGGAAAAGAAGAATGGGAAAAG
>TTN-202,ENSE00003802004,1,151,888375,888525,GGTAAAGATAAAGAAGTGAGAGGAACAAAGCTTGTTGTGACAGGATTAAAGGAAGGAGCATTCTACAAATTTAGAGTTAGAGCAGTCAACATTGCTGGCATTGGAGAACCTGGAGAGGTCACAGATGTCATTGAAATGAAGGACAGACTTG
>TTN-202,ENSE00003808790,1,282,888526,888807,TTTCACCTGACCTTCAGCTAGATGCCAGTGTCAGAGATAGAATTGTTGTCCATGCTGGAGGGGTGATCCGAATCATTGCCTATGTGTCTGGAAAGCCTCCTCCAACCGTCACCTGGAACATGAATGAAAGAACCTTACCTCAAGAAGCCACCATTGAGACCACAGCCATTAGCTCATCCATGGTCATCAAGAACTGCCAGAGGAGCCATCAAGGCGTCTATTCTCTTCTTGCCAAAAATGAAGCCGGAGAAAGAAAGAAGACAATTATTGTTGATGTATTAG
>TTN-202,ENSE00003807896,1,303,888808,889110,ATGTTCCAGGTCCCGTTGGAACACCATTCCTAGCTCACAACCTAACCAATGAGTCCTGCAAACTGACATGGTTTTCTCCAGAAGATGATGGAGGCTCTCCAATCACCAATTATGTCATTGAAAAGCGTGAATCTGACCGCAGAGCATGGACCCCAGTGACATATACAGTTACCCGACAAAATGCTACTGTCCAGGGTCTCATTCAAGGAAAAGCCTACTTTTTCCGAATTGCGGCTGAAAATAGTATTGGCATGGGTCCATTTGTTGAGACATCAGAGGCACTTGTTATCAGAGAGCCAATAA
>TTN-202,ENSE00003801753,1,303,889111,889413,CTGTACCAGAGCGTCCTGAAGACCTGGAAGTCAAAGAAGTTACTAAAAATACTGTAACTTTGACTTGGAATCCTCCTAAGTATGATGGTGGGTCAGAAATTATTAACTATGTCCTAGAAAGTCGGCTCATTGGGACTGAGAAGTTCCACAAAGTTACAAATGACAACTTGCTTAGCAGAAAATACACTGTTAAAGGCTTAAAAGAAGGTGATACCTATGAGTACCGTGTCAGTGCTGTCAACATTGTTGGACAAGGCAAACCATCATTTTGCACCAAACCAATTACTTGCAAGGATGAGCTGG
>TTN-202,ENSE00003807039,1,282,889414,889695,CACCCCCAACGCTTCACCTCGACTTCAGAGATAAGCTCACGATTCGAGTTGGTGAAGCTTTTGCCCTCACTGGCCGTTACTCAGGCAAACCAAAGCCTAAGGTTTCCTGGTTCAAAGATGAAGCTGATGTGCTGGAAGATGATCGCACTCATATAAAGACTACACCAGCAACACTTGCTTTAGAGAAGATCAAGGCCAAACGTTCAGATTCCGGCAAATACTGTGTGGTTGTGGAGAACAGTACAGGCTCTAGGAAAGGTTTCTGTCAAGTTAATGTTGTTG
>TTN-202,ENSE00003804106,1,300,889696,889995,ACCGTCCTGGACCACCAGTAGGACCAGTTAGTTTTGATGAGGTGACCAAAGATTACATGGTTATCTCTTGGAAGCCTCCTTTAGATGATGGAGGCAGTAAAATCACCAATTATATTATTGAGAAGAAGGAAGTGGGTAAAGACGTCTGGATGCCAGTGACATCTGCAAGTGCTAAAACAACATGCAAAGTTTCTAAACTACTTGAAGGAAAAGATTATATTTTCCGGATACATGCTGAAAATCTGTATGGAATAAGTGATCCTCTGGTGTCTGATTCAATGAAAGCCAAAGATCGTTTCA
>TTN-202,ENSE00003801817,1,303,889996,890298,GGGTTCCTGATGCACCTGATCAGCCAATTGTTACAGAAGTTACCAAAGACTCTGCATTAGTAACCTGGAATAAGCCACATGATGGAGGAAAACCCATCACAAACTACATCCTGGAAAAGAGAGAAACTATGTCTAAACGATGGGCTAGAGTTACCAAAGATCCTATTCATCCATACACTAAATTTAGGGTTCCTGATCTTCTAGAAGGATGTCAGTATGAATTCCGGGTTTCTGCAGAAAATGAAATTGGTATTGGAGATCCAAGCCCACCATCCAAACCAGTCTTTGCTAAAGATCCAATTG
>TTN-202,ENSE00003810564,1,309,890299,890607,CTAAACCAAGTCCACCTGTTAATCCTGAAGCAATAGATACAACATGCAATTCAGTCGATCTAACTTGGCAGCCACCACGTCATGATGGTGGGAGCAAGATTCTGGGTTATATTGTTGAGTACCAGAAAGTTGGAGATGAAGAGTGGAGAAGAGCCAATCACACCCCTGAGTCATGTCCTGAAACTAAATATAAAGTCACCGGTCTTCGGGACGGTCAAACCTATAAGTTTAGAGTGTTAGCAGTCAATGCAGCTGGTGAATCAGATCCAGCTCATGTTCCGGAGCCAGTCCTAGTAAAAGACAGGCTTG
>TTN-202,ENSE00003807476,1,282,890608,890889,AACCCCCTGAGTTGATTCTTGATGCCAACATGGCAAGAGAACAACACATTAAAGTTGGTGATACTCTAAGACTTAGTGCCATCATCAAAGGAGTGCCATTCCCAAAAGTAACTTGGAAAAAAGAAGACAGAGATGCTCCAACTAAAGCAAGAATTGATGTGACTCCAGTTGGTAGCAAGCTTGAAATTCGTAATGCTGCCCATGAAGATGGTGGAATTTATTCTTTAACAGTGGAGAATCCAGCTGGTTCAAAAACTGTCTCAGTAAAAGTACTTGTATTAG
>TTN-202,ENSE00003807363,1,300,890890,891189,ATAAACCTGGGCCACCTAGAGATCTGGAAGTCAGTGAAATTAGGAAAGATTCATGTTACCTTACTTGGAAAGAACCACTGGATGATGGTGGTTCTGTTATTACCAATTATGTGGTTGAGAGGAGAGATGTTGCCAGCGCCCAGTGGTCACCTCTCTCAGCTACATCAAAGAAAAAGAGTCACTTCGCTAAGCATCTGAATGAAGGCAACCAGTACCTCTTCCGAGTAGCTGCGGAGAACCAGTATGGACGTGGTCCTTTTGTTGAAACACCAAAACCAATCAAGGCTTTGGATCCTCTCC
>TTN-202,ENSE00003808994,1,294,891190,891483,ATCCCCCAGGGCCACCCAAGGACCTGCACCATGTAGATGTTGACAAGACTGAAGTCTCCCTAGTCTGGAATAAGCCGGATCGTGATGGTGGTTCTCCAATCACTGGATATTTGGTAGAATATCAAGAAGAAGGCACCCAGGACTGGATTAAATTTAAGACTGTGACAAACTTAGAGTGTGTGGTTACTGGACTACAACAAGGAAAGACCTATAGATTCCGTGTAAAAGCTGAAAACATTGTGGGTCTTGGTCTCCCTGACACAACTATCCCGATAGAATGTCAAGAAAAACTAG
>TTN-202,ENSE00003810188,1,2967,891484,894450,TGCCTCCATCCGTGGAGCTAGATGTGAAATTAATTGAAGGTCTTGTGGTAAAGGCTGGAACCACAGTCAGATTCCCTGCTATTATAAGAGGTGTGCCTGTTCCTACTGCAAAGTGGACAACCGATGGGAGTGAGATTAAAACCGATGAGCACTACACAGTTGAAACAGACAACTTCTCATCAGTACTTACCATTAAGAACTGCTTAAGGAGAGACACTGGGGAATATCAAATCACAGTTTCCAATGCAGCCGGTAGCAAAACAGTAGCCGTACATCTTACTGTTCTTGATGTTCCTGGGCCACCAACAGGTCCTATTAATATTCTGGATGTTACTCCTGAACACATGACTATCTCATGGCAGCCACCTAAGGATGATGGAGGAAGCCCTGTGATAAATTATATTGTTGAGAAACAAGATACAAGGAAAGACACGTGGGGTGTTGTCTCTTCCGGAAGCAGTAAGACAAAGCTGAAAATCCCACATCTGCAGAAGGGCTGTGAATATGTTTTCCGAGTTAGAGCAGAGAATAAGATAGGTGTTGGTCCTCCCCTTGACTCCACACCTACTGTTGCTAAGCATAAATTTAGTCCTCCGTCTCCTCCTGGTAAACCAGTGGTTACTGACATTACTGAAAATGCAGCAACAGTGTCTTGGACCCTGCCAAAATCTGATGGTGGCAGTCCAATAACTGGCTACTATATGGAACGTCGAGAAGTAACTGGCAAATGGGTGAGGGTCAACAAAACACCTATCGCTGACCTGAAGTTCAGAGTGACTGGACTCTATGAAGGAAATACATATGAGTTTAGAGTTTTTGCTGAAAATCTTGCAGGACTAAGCAAACCATCCCCAAGTTCTGATCCAATAAAAGCTTGCCGGCCCATCAAACCACCTGGACCACCTATTAATCCTAAACTGAAAGACAAGAGCAGAGAAACAGCTGATTTGGTGTGGACAAAGCCTCTCAGTGATGGTGGTAGCCCCATTCTAGGATATGTAGTGGAATGTCAGAAACCTGGCACAGCACAATGGAACAGGATTAATAAAGATGAACTCATTAGGCAATGTGCCTTTAGGGTACCTGGACTAATTGAAGGAAATGAGTACAGATTCCGTATAAAGGCAGCTAATATTGTAGGAGAGGGTGAGCCAAGAGAACTAGCAGAATCTGTGATTGCAAAAGATATCCTTCATCCTCCAGAAGTAGAACTTGATGTTACTTGTCGTGATGTTATTACCGTGAGAGTAGGCCAAACTATCCGCATTCTAGCTCGAGTCAAAGGCAGACCTGAACCAGACATAACTTGGACTAAGGAAGGCAAAGTATTGGTCCGAGAAAAGAGGGTGGACCTTATTCAGGATCTACCTCGTGTTGAGTTACAAATTAAAGAAGCTGTTAGAGCTGATCATGGCAAGTATATCATCTCAGCTAAGAACAGCAGTGGACATGCCCAAGGTTCAGCCATCGTTAACGTCCTTGACAGACCTGGGCCTTGCCAGAATTTGAAGGTTACCAATGTAACCAAAGAGAACTGTACAATTTCTTGGGAAAACCCACTAGATAATGGTGGCTCAGAAATAACAAACTTCATAGTAGAATATCGCAAACCAAACCAGAAAGGCTGGTCAATTGTTGCATCAGATGTCACTAAACGATTAATCAAGGCCAACCTTTTAGCCAACAATGAATACTATTTCCGAGTTTGTGCAGAGAATAAAGTAGGTGTTGGGCCAACCATCGAAACAAAAACTCCCATTCTGGCTATTAACCCTATTGACAGACCAGGTGAGCCTGAAAACCTTCACATTGCAGATAAAGGAAAGACATTTGTCTATCTAAAGTGGCGGAGGCCTGACTATGATGGTGGCAGTCCAAATCTGTCATATCATGTTGAGAGAAGGCTTAAGGGCTCCGATGACTGGGAAAGAGTGCATAAAGGAAGCATTAAAGAAACTCACTACATGGTTGACAGATGTGTTGAAAACCAGATTTATGAGTTCAGAGTGCAAACAAAGAATGAAGGTGGGGAAAGTGACTGGGTGAAGACAGAGGAAGTTGTTGTGAAAGAAGACTTACAAAAACCAGTACTTGATCTGAAATTAAGTGGGGTCCTAACTGTCAAAGCAGGGGACACCATTAGGCTTGAGGCAGGGGTTAGAGGCAAACCATTCCCAGAAGTTGCATGGACCAAGGACAAAGACGCTACAGACTTAACAAGATCACCAAGGGTCAAGATTGATACCCGTGCTGATTCATCTAAATTTTCTCTTACTAAAGCAAAGCGAAGTGATGGGGGTAAATATGTAGTTACGGCAACTAACACGGCTGGCAGTTTTGTGGCCTATGCCACTGTCAATGTTTTAGATAAGCCTGGTCCTGTGAGAAATCTGAAAATTGTTGATGTGTCCAGTGATAGGTGTACTGTTTGCTGGGATCCACCAGAAGATGATGGTGGCTGTGAAATCCAAAATTATATTCTAGAAAAATGTGAGACAAAGCGAATGGTTTGGTCTACCTATTCTGCTACTGTCTTGACACCTGGTACTACAGTAACACGTCTCATAGAAGGAAATGAATATATTTTCAGAGTCCGTGCAGAAAATAAAATAGGCACAGGGCCTCCAACAGAAAGTAAACCAGTCATAGCCAAAACCAAGTATGATAAACCTGGTCGCCCTGATCCCCCAGAAGTCACTAAAGTAAGCAAAGAAGAGATGACTGTGGTTTGGAATCCACCTGAATATGATGGTGGAAAGTCTATAACTGGATACTTTTTGGAGAAAAAGGAAAAGCATTCAACACGATGGGTCCCTGTCAACAAGAGTGCAATCCCTGAGAGACGTATGAAAGTACAGAATCTCCTCCCAGACCATGAATATCAGTTCCGTGTCAAGGCAGAAAATGAAATTGGAATTGGAGAACCAAGCTTGCCTTCAAGACCGGTGGTGGCAAAAGACCCCATAG
>TTN-202,ENSE00003811401,1,321,894451,894771,AGCCACCTGGTCCACCAACCAATTTCAGAGTGGTTGATACAACCAAACATTCCATAACTCTTGGGTGGGGAAAACCAGTCTATGATGGTGGTGCACCGATCATTGGATATGTTGTGGAAATGAGACCAAAAATAGCAGATGCGTCTCCTGATGAAGGCTGGAAACGGTGTAATGCTGCAGCACAGCTTGTACGCAAGGAATTCACTGTTACCAGCTTGGATGAAAACCAGGAATATGAGTTCAGGGTGTGTGCCCAAAACCAAGTTGGTATTGGGCGCCCTGCAGAGCTAAAGGAAGCTATCAAACCTAAAGAAATACTAG
>TTN-202,ENSE00003805661,1,285,894772,895056,AACCTCCGGAGATTGATTTGGATGCCAGCATGAGGAAACTGGTCATAGTGAGAGCAGGATGCCCTATTCGTCTCTTTGCTATAGTGAGAGGACGACCAGCCCCTAAAGTCACTTGGCGAAAAGTTGGCATTGATAATGTGGTCAGAAAAGGACAAGTTGATCTGGTTGACACTATGGCCTTCCTTGTCATCCCCAATTCTACCCGTGATGACTCAGGAAAATATTCCTTAACACTTGTGAACCCAGCAGGAGAAAAGGCTGTATTCGTAAATGTCAGAGTATTAG
>TTN-202,ENSE00003804742,1,300,895057,895356,ACACTCCTGGGCCTGTGTCTGATTTAAAAGTTTCAGATGTCACTAAAACATCATGCCATGTGTCCTGGGCCCCTCCTGAAAACGACGGTGGGAGCCAAGTGACACATTATATCGTGGAGAAACGTGAGGCAGACAGAAAGACATGGTCGACCGTTACCCCAGAAGTTAAGAAAACAAGCTTCCATGTAACCAATCTTGTCCCTGGGAATGAGTATTACTTCAGAGTAACTGCTGTCAACGAATATGGCCCTGGCGTCCCAACAGATGTCCCAAAACCAGTGCTTGCATCAGATCCTCTAA
>TTN-202,ENSE00003810357,1,303,895357,895659,GTGAGCCGGATCCCCCAAGGAAATTAGAAGTGACTGAAATGACCAAGAACAGTGCCACCTTAGCCTGGTTACCTCCCCTACGTGATGGAGGTGCTAAAATCGATGGCTACATCACTAGTTACAGAGAAGAAGAGCAGCCTGCAGATCGCTGGACAGAGTACTCAGTGGTAAAAGATCTGAGCCTTGTTGTCACTGGCCTAAAGGAAGGAAAGAAATACAAATTTAGAGTAGCGGCCAGAAATGCTGTTGGAGTCAGTTTGCCAAGAGAAGCTGAAGGAGTGTATGAAGCCAAAGAACAACTGT
>TTN-202,ENSE00003801707,1,276,895660,895935,TGCCACCAAAGATCCTTATGCCAGAGCAAATAACTATCAAAGCTGGGAAAAAACTCCGAATTGAAGCCCATGTGTATGGAAAGCCTCATCCCACCTGTAAATGGAAAAAAGGAGAAGATGAAGTTGTCACATCCAGCCACCTGGCAGTGCATAAAGCAGACAGCTCTTCAATTCTGATCATAAAAGATGTGACTAGGAAAGACAGTGGTTACTACAGCCTCACAGCAGAGAACAGTTCTGGGACAGACACTCAGAAAATCAAAGTTGTAGTCATGG
>TTN-202,ENSE00003810399,1,300,895936,896235,ATGCCCCCGGCCCCCCTCAGCCTCCATTTGACATTTCTGATATAGACGCTGATGCTTGCTCCCTGTCATGGCACATCCCTCTGGAGGACGGAGGCAGTAACATCACCAATTATATAGTGGAGAAGTGTGATGTAAGCCGAGGTGACTGGGTCACGGCTCTAGCTTCAGTCACAAAAACTTCCTGCAGGGTTGGAAAGCTGATCCCAGGCCAGGAGTACATCTTCCGGGTCCGTGCTGAAAACCGATTTGGCATTTCAGAGCCTCTCACATCTCCAAAGATGGTTGCGCAGTTCCCATTTG
>TTN-202,ENSE00003810448,1,303,896236,896538,GTGTTCCTAGTGAACCAAAGAATGCACGAGTCACCAAAGTCAACAAGGACTGTATTTTTGTTGCTTGGGACAGACCAGATAGTGATGGAGGGAGCCCCATTATTGGTTATCTGATTGAACGCAAGGAAAGAAACAGTTTGCTGTGGGTGAAAGCCAATGATACTCTTGTCCGGTCAACTGAATATCCTTGTGCTGGCCTTGTAGAAGGTCTTGAGTATTCATTCAGAATCTATGCCCTAAACAAAGCTGGATCCAGCCCACCCAGCAAACCCACAGAATATGTAACTGCAAGAATGCCAGTTG
>TTN-202,ENSE00003802505,1,300,896539,896838,ATCCTCCTGGGAAACCTGAGGTTATTGATGTCACCAAGAGTACTGTATCTCTGATCTGGGCTCGTCCAAAGCATGATGGAGGCAGTAAAATTATTGGCTATTTCGTAGAAGCTTGCAAACTTCCTGGTGATAAATGGGTACGGTGCAATACTGCACCTCACCAGATTCCCCAGGAAGAGTACACAGCTACTGGCCTAGAAGAGAAAGCTCAGTATCAATTTAGAGCTATTGCCAGGACCGCGGTAAACATTAGCCCACCTTCTGAACCTTCTGATCCAGTGACTATCCTCGCAGAAAATG
>TTN-202,ENSE00003806397,1,288,896839,897126,TCCCTCCCAGGATAGACCTGAGTGTGGCTATGAAATCTTTGCTTACTGTGAAAGCTGGAACTAATGTCTGCTTGGATGCTACTGTTTTTGGTAAACCGATGCCAACAGTTTCTTGGAAAAAAGATGGCACACTGCTAAAACCAGCAGAAGGCATAAAGATGGCCATGCAGCGGAATCTGTGCACCTTGGAGCTATTCAGCGTGAACCGGAAGGACTCAGGAGACTATACCATTACTGCTGAAAATTCAAGTGGTTCTAAATCAGCCACCATTAAGCTTAAAGTGTTAG
>TTN-202,ENSE00003807889,1,297,897127,897423,ATAAACCGGGTCCTCCAGCATCTGTTAAAATCAACAAAATGTATTCAGATCGTGCTATGCTTTCTTGGGAACCGCCTCTTGAAGATGGAGGCTCAGAAATCACCAACTATATTGTTGACAAACGTGAAACAAGCAGGCCCAACTGGGCTCAAGTCTCTGCAACTGTGCCTATCACCAGCTGCAGCGTGGAGAAACTTATAGAGGGCCATGAGTATCAGTTCCGTATTTGTGCTGAAAATAAATATGGAGTAGGCGATCCAGTCTTCACTGAACCAGCAATTGCCAAAAACCCATATG
>TTN-202,ENSE00003811290,1,303,897424,897726,ACCCACCAGGACGCTGTGATCCTCCTGTTATTAGCAACATAACCAAAGATCACATGACAGTCAGCTGGAAGCCACCAGCAGATGATGGGGGCTCACCCATCACTGGCTATTTGCTTGAAAAGCGGGAAACCCAGGCTGTTAACTGGACTAAGGTCAACAGAAAACCTATTATAGAAAGAACATTAAAAGCAACAGGTCTTCAAGAAGGTACCGAATATGAGTTCCGTGTTACAGCTATAAATAAAGCTGGACCAGGCAAACCCAGTGACGCATCCAAGGCCGCTTATGCTCGGGACCCTCAGT
>TTN-202,ENSE00003808853,1,306,897727,898032,ATCCTCCTGGCCCACCGGCTTTCCCTAAAGTATATGATACAACTCGCAGCTCTGTGAGTCTATCTTGGGGCAAGCCAGCCTATGACGGCGGCAGCCCTATCATTGGTTATCTCGTTGAAGTAAAACGGGCTGACTCCGATAACTGGGTGAGGTGCAACTTACCACAGAATCTACAGAAAACCCGCTTTGAGGTTACTGGCCTGATGGAAGACACACAATATCAATTCCGTGTGTATGCCGTTAATAAGATTGGATACAGTGACCCCAGTGATGTGCCAGATAAACACTATCCCAAGGACATCTTAA
>TTN-202,ENSE00003807542,1,288,898033,898320,TTCCACCTGAGGGAGAACTTGATGCGGACTTAAGGAAGACACTCATATTACGTGCTGGAGTTACTATGAGACTATATGTACCAGTAAAAGGACGCCCACCTCCAAAGATTACTTGGTCTAAACCAAATGTCAATCTAAGAGACAGGATTGGACTGGACATAAAGTCAACTGACTTTGACACTTTCTTGCGCTGTGAAAATGTGAACAAATATGATGCAGGAAAATATATCTTAACCCTGGAGAACAGCTGTGGTAAAAAGGAATATACCATTGTTGTGAAAGTGCTTG
>TTN-202,ENSE00003810775,1,291,898321,898611,ATACTCCTGGGCCACCTGTCAATGTGACTGTTAAGGAAATATCCAAAGACTCTGCTTATGTTACCTGGGAGCCTCCCATTATTGATGGCGGAAGCCCCATCATAAACTATGTGGTACAAAAACGTGATGCAGAGAGGAAATCCTGGTCTACAGTGACAACTGAGTGCTCCAAAACAAGCTTCAGAGTAGCTAATTTGGAGGAGGGAAAATCCTACTTCTTCCGAGTGTTTGCTGAAAATGAGTATGGCATTGGTGATCCCGGTGAAACTCGTGATGCTGTCAAAGCTTCCC
>TTN-202,ENSE00003811210,1,288,898612,898899,AAACTCCTGGACCAGTTGTGGACCTGAAAGTGAGGTCTGTATCTAAGTCATCCTGTAGCATTGGCTGGAAAAAGCCTCACAGTGATGGTGGAAGTCGGATTATTGGATATGTAGTTGATTTCCTGACTGAAGAAAATAAGTGGCAACGAGTTATGAAATCCTTAAGCCTACAGTACTCTGCAAAAGATTTGACTGAAGGGAAGGAATATACCTTCAGAGTGAGTGCTGAGAATGAAAATGGAGAAGGAACCCCAAGCGAAATCACTGTTGTGGCAAGGGATGATGTTG
>TTN-202,ENSE00003805436,1,588,898900,899487,TGGCTCCTGATCTTGACTTAAAGGGTCTACCTGATTTGTGCTACTTGGCTAAAGAAAACAGCAACTTCCGGCTTAAGATCCCCATAAAAGGCAAGCCAGCTCCATCAGTCTCCTGGAAGAAAGGGGAAGATCCTCTAGCAACTGACACTAGAGTCAGTGTTGAGTCATCTGCGGTTAACACAACTCTTATAGTGTACGATTGCCAAAAATCTGATGCTGGAAAATACACAATCACACTTAAGAATGTTGCTGGCACCAAGGAAGGAACTATCTCCATAAAGGTTGTTGGCAAGCCTGGCATCCCCACTGGACCAATCAAATTTGATGAAGTCACAGCAGAAGCCATGACCTTAAAGTGGGCTCCTCCAAAGGATGATGGAGGTTCTGAAATCACCAACTATATCCTAGAGAAGAGGGATTCTGTGAACAACAAGTGGGTGACGTGCGCCTCAGCTGTCCAGAAAACCACCTTTAGAGTAACCAGACTTCATGAGGGCATGGAATATACCTTCAGGGTCAGTGCCGAAAATAAATATGGTGTAGGGGAAGGCCTGAAATCGGAGCCAATTGTTGCGAGACATCCATTTG
>TTN-202,ENSE00003808777,1,105,899488,899592,ATGTGCCTGATGCTCCCCCACCTCCCAATATTGTGGATGTCAGACACGATTCAGTATCTCTAACTTGGACTGACCCCAAGAAAACTGGTGGTTCTCCAATTACAG
>TTN-202,ENSE00003806939,1,198,899593,899790,GGTATCATCTCGAGTTCAAGGAAAGAAACAGCCTTTTGTGGAAGAGAGCTAACAAGACTCCGATAAGGATGAGAGACTTTAAAGTGACAGGATTAACTGAAGGTCTTGAATATGAATTCCGAGTTATGGCAATCAATTTAGCAGGTGTGGGCAAGCCAAGCCTACCATCAGAGCCTGTTGTGGCACTGGACCCAATTG
>TTN-202,ENSE00003811024,1,297,899791,900087,ATCCTCCTGGAAAACCTGAGGTTATTAACATAACAAGGAATTCAGTGACTCTCATTTGGACTGAACCTAAATATGACGGTGGTCATAAGTTAACTGGATATATAGTGGAGAAGCGAGATCTACCTTCGAAGTCTTGGATGAAAGCCAACCATGTTAATGTCCCAGAATGTGCCTTTACTGTAACTGACCTTGTTGAGGGTGGAAAATATGAATTCAGAATTAGAGCAAAGAATACAGCAGGTGCTATCAGTGCTCCATCAGAAAGTACAGAAACCATTATTTGCAAGGATGAATACG
>TTN-202,ENSE00003803896,1,588,900088,900675,AGGCACCAACAATTGTCCTTGATCCCACAATAAAAGATGGGCTAACAATTAAAGCAGGGGATACCATTGTTTTGAATGCCATTAGCATTCTTGGCAAACCCCTTCCAAAATCAAGTTGGTCCAAGGCAGGAAAAGACATTAGACCATCAGATATCACTCAGATAACTTCAACCCCAACATCTTCCATGCTTACTATCAAGTATGCCACTAGAAAAGATGCGGGTGAATATACCATCACTGCTACCAATCCTTTTGGCACGAAGGTGGAACATGTGAAGGTAACAGTCCTTGATGTACCTGGTCCCCCAGGTCCTGTTGAAATCAGTAATGTTTCTGCTGAAAAAGCAACACTTACATGGACACCTCCCTTGGAAGATGGCGGCTCACCAATTAAGTCCTATATACTTGAAAAGAGAGAAACCAGCCGACTTTTGTGGACAGTGGTTTCTGAAGATATTCAGTCTTGCAGGCATGTGGCAACCAAACTTATCCAAGGAAATGAGTACATCTTCCGGGTCTCAGCTGTAAACCACTATGGCAAAGGAGAACCTGTACAGTCTGAACCTGTCAAAATGGTAGACAGATTTG
>TTN-202,ENSE00003807419,1,303,900676,900978,GTCCCCCTGGCCCTCCTGAAAAACCAGAGGTATCAAATGTCACTAAGAACACTGCCACTGTCAGCTGGAAAAGGCCAGTGGATGATGGTGGCAGCGAAATTACAGGATATCATGTAGAAAGGAGAGAAAAGAAAAGCCTGCGATGGGTGAGAGCAATAAAAACACCAGTTTCCGATCTCAGGTGCAAAGTAACAGGACTGCAAGAAGGAAGCACCTACGAATTCCGTGTCAGTGCAGAAAACAGAGCAGGAATTGGTCCACCCAGTGAGGCTTCAGATTCTGTTCTGATGAAAGATGCAGCAT
>TTN-202,ENSE00003811193,1,17106,900979,918084,ATCCTCCAGGACCACCTTCAAATCCGCATGTCACTGATACTACCAAGAAATCTGCTTCTTTGGCATGGGGCAAGCCTCATTATGATGGTGGACTTGAAATCACTGGCTATGTCGTGGAGCATCAAAAAGTAGGAGACGAGGCCTGGATAAAAGATACCACAGGAACCGCCCTCAGAATCACTCAGTTCGTTGTTCCTGATCTTCAGACTAAAGAAAAATACAACTTCAGAATCAGTGCCATCAACGATGCAGGTGTTGGGGAGCCAGCGGTGATTCCAGATGTTGAAATCGTAGAACGGGAGATGGCTCCTGATTTTGAACTAGATGCCGAGCTTCGAAGAACACTTGTTGTTAGAGCAGGACTCAGTATTAGGATATTTGTGCCAATTAAAGGTCGTCCTGCTCCTGAAGTGACATGGACCAAAGATAACATCAACCTGAAAAACCGAGCCAACATTGAAAATACGGAATCATTTACTCTTCTGATTATCCCAGAATGTAACAGATATGATACCGGTAAATTTGTCATGACCATTGAAAACCCGGCTGGGAAGAAAAGTGGCTTTGTGAACGTCAGAGTCTTGGACACGCCAGGCCCAGTCCTCAACCTGCGGCCTACAGACATCACAAAGGACAGTGTCACCCTGCACTGGGACCTCCCTCTGATAGATGGAGGCTCACGTATAACAAACTACATTGTAGAGAAACGTGAAGCAACACGGAAATCTTATTCCACAGCCACCACTAAGTGCCATAAATGCACATATAAAGTTACCGGCTTGTCTGAAGGGTGTGAATATTTCTTCAGAGTGATGGCAGAGAATGAATATGGAATTGGTGAGCCAACAGAAACTACAGAGCCCGTAAAAGCCTCTGAAGCACCATCTCCACCAGACAGCCTTAACATCATGGACATAACTAAGAGCACCGTCAGCCTGGCATGGCCTAAGCCCAAACACGATGGTGGCAGCAAGATCACTGGCTATGTGATTGAAGCCCAAAGAAAAGGCTCTGACCAGTGGACCCACATCACAACCGTGAAAGGGTTAGAATGTGTTGTGAGGAATCTAACTGAAGGAGAGGAATATACCTTCCAAGTGATGGCAGTGAACAGCGCGGGGAGAAGTGCCCCTAGAGAAAGCAGACCCGTCATTGTCAAGGAGCAGACAATGCTTCCAGAGCTGGATCTCCGTGGCATCTATCAGAAACTGGTCATTGCCAAAGCTGGTGACAACATCAAAGTTGAAATTCCAGTGCTCGGTCGACCGAAGCCCACAGTGACATGGAAAAAAGGAGACCAAATTCTTAAACAGACACAGAGAGTTAATTTTGAAACCACAGCGACTTCAACCATTTTAAATATCAATGAGTGTGTCAGAAGTGATAGTGGGCCCTATCCATTAACAGCAAGGAACATTGTAGGAGAGGTTGGTGATGTCATCACCATTCAAGTCCATGATATCCCAGGGCCACCTACTGGACCAATCAAATTTGATGAAGTTTCATCTGATTTTGTAACCTTCTCTTGGGACCCACCTGAGAACGATGGTGGTGTACCAATAAGCAACTATGTAGTGGAAATGCGGCAGACTGACAGTACTACCTGGGTTGAGTTAGCAACCACCGTTATACGTACTACCTATAAAGCCACCCGCCTTACTACTGGATTAGAGTATCAGTTCCGTGTAAAAGCTCAGAATAGATATGGAGTTGGACCAGGCATCACATCAGCATGCATAGTTGCCAACTATCCATTTAAGGTTCCTGGACCTCCTGGTACCCCTCAGGTAACTGCAGTTACCAAGGATTCAATGACAATTAGCTGGCATGAGCCACTTTCTGATGGTGGAAGCCCCATTTTAGGATATCATGTTGAAAGAAAAGAACGAAATGGTATTCTCTGGCAGACTGTGAGCAAAGCTTTAGTACCAGGCAACATTTTCAAATCAAGTGGACTTACAGATGGTATTGCTTATGAGTTCCGGGTGATTGCAGAAAACATGGCAGGCAAAAGTAAGCCAAGCAAGCCATCAGAACCTATGTTGGCTCTGGATCCCATTGACCCACCTGGAAAACCAGTACCTCTAAATATTACAAGACACACAGTAACACTTAAATGGGCTAAGCCTGAATATACTGGGGGCTTTAAAATTACCAGTTATATCGTTGAAAAGAGAGACCTTCCTAATGGACGGTGGCTGAAGGCCAACTTCAGCAACATTTTGGAGAATGAATTTACAGTCAGTGGCCTAACAGAAGATGCTGCATATGAATTCCGTGTGATCGCCAAAAATGCTGCAGGTGCCATCAGTCCACCATCTGAGCCATCTGATGCTATCACTTGCAGGGATGATGTTGAGGCACCAAAGATAAAGGTGGATGTTAAATTTAAGGACACGGTTATATTAAAAGCAGGTGAAGCATTCAGACTGGAAGCTGATGTTTCAGGCCGCCCACCTCCAACAATGGAATGGAGCAAAGATGGAAAAGAGCTGGAAGGCACAGCAAAGTTAGAAATAAAAATTGCAGATTTCTCTACTAATCTGGTAAACAAAGATTCAACAAGAAGGGATAGTGGTGCCTATACCCTTACAGCGACTAATCCTGGTGGCTTTGCTAAACACATTTTCAATGTCAAAGTTCTTGACAGACCAGGCCCACCTGAAGGACCTTTGGCTGTAACTGAAGTGACATCAGAAAAGTGTGTACTATCATGGTTCCCTCCACTGGATGATGGAGGTGCCAAAATTGATCATTACATAGTACAGAAACGTGAAACCAGCAGATTGGCATGGACAAATGTAGCCTCAGAAGTCCAAGTAACAAAGCTAAAGGTCACTAAACTCTTGAAAGGCAATGAATACATATTCCGTGTCATGGCTGTAAATAAATATGGAGTGGGAGAGCCACTGGAATCAGAGCCTGTGCTTGCAGTGAATCCTTATGGACCCCCTGATCCGCCCAAAAACCCTGAAGTGACAACTATTACTAAAGATTCGATGGTTGTCTGCTGGGGACATCCTGATTCTGATGGTGGAAGTGAAATCATCAATTATATTGTGGAACGGCGTGATAAAGCTGGCCAACGCTGGATTAAATGCAACAAAAAAACTCTTACTGATTTAAGATATAAAGTGTCTGGACTGACAGAAGGACATGAATATGAGTTCAGGATTATGGCTGAAAATGCTGCTGGAATTAGTGCACCAAGTCCTACCAGTCCATTTTACAAGGCTTGTGACACTGTGTTTAAACCTGGACCACCAGGTAACCCACGTGTTCTGGATACAAGCAGATCATCCATTTCAATCGCTTGGAATAAACCTATCTATGATGGTGGTTCAGAAATCACTGGGTATATGGTTGAGATTGCCCTGCCAGAGGAAGATGAATGGCAGATTGTCACTCCACCAGCAGGACTCAAGGCAACTTCGTATACTATCACTGGCCTCACAGAGAATCAGGAATATAAGATCCGCATCTATGCCATGAATTCCGAAGGACTTGGGGAACCTGCCCTTGTTCCTGGAACTCCAAAGGCTGAAGACAGAATGCTGCCTCCAGAAATTGAACTGGATGCTGACCTGCGCAAAGTTGTTACTATAAGGGCCTGCTGCACCCTGAGACTTTTTGTTCCCATCAAAGGAAGGCCTGCACCTGAGGTGAAGTGGGCCCGGGACCATGGAGAATCTTTAGATAAAGCTAGCATCGAATCCACAAGCTCTTACACCCTGCTTATTGTTGGAAATGTAAACAGATTTGACAGTGGCAAATATATACTAACTGTAGAAAATAGTTCAGGCAGCAAGTCTGCATTTGTCAATGTTAGAGTTCTCGATACACCAGGCCCCCCACAGGATCTGAAGGTAAAAGAGGTCACTAAGACATCTGTCACACTCACATGGGACCCACCTCTCCTTGATGGAGGTTCAAAAATCAAGAACTATATTGTTGAAAAGCGGGAATCAACAAGAAAAGCATATTCAACTGTTGCAACAAACTGCCACAAGACTTCCTGGAAGGTAGACCAGCTTCAAGAAGGCTGTAGCTACTATTTCAGGGTTCTCGCAGAAAATGAATATGGCATTGGGCTGCCTGCTGAAACCGCAGAATCTGTGAAAGCATCAGAACGACCTCTTCCTCCAGGAAAAATAACTTTGATGGATGTCACAAGAAATAGTGTGTCACTCTCTTGGGAGAAACCAGAGCATGATGGAGGCAGCCGAATTCTAGGCTACATTGTGGAGATGCAGACCAAAGGCAGTGACAAATGGGCCACGTGTGCCACAGTCAAGGTCACTGAAGCCACTATCACTGGATTAATTCAGGGTGAAGAATACTCTTTCCGTGTTTCAGCTCAGAATGAAAAGGGCATCAGTGATCCTAGACAACTGAGTGTGCCAGTGATCGCCAAAGATCTTGTCATTCCACCAGCCTTCAAACTCCTGTTCAATACTTTCACTGTACTGGCAGGTGAAGACCTAAAAGTTGATGTTCCATTCATTGGCCGCCCTACCCCAGCTGTAACCTGGCATAAAGATAATGTACCACTGAAGCAGACAACTAGAGTAAATGCAGAGAGCACAGAAAATAATTCACTACTGACAATAAAGGACGCCTGCCGAGAAGATGTTGGCCATTATGTGGTTAAACTGACTAACTCAGCTGGTGAAGCTATTGAAACCCTTAATGTTATCGTTCTTGACAAACCAGGGCCTCCAACTGGACCAGTTAAAATGGATGAAGTGACAGCTGATAGTATTACTCTTTCCTGGGGCCCACCCAAGTATGATGGTGGAAGTTCTATCAATAATTACATTGTTGAGAAACGGGACACTTCCACAACCACCTGGCAAATTGTATCAGCTACAGTTGCAAGGACAACAATAAAGGCTTGCAGACTGAAGACTGGATGTGAATATCAGTTTAGAATTGCAGCTGAAAACAGATATGGGAAGAGTACCTACCTCAATTCAGAGCCTACTGTAGCCCAATATCCATTCAAAGTTCCTGGTCCTCCTGGCACTCCAGTTGTCACACTGTCCTCCAGGGACAGCATGGAAGTACAATGGAATGAGCCAATCAGTGATGGAGGAAGTAGAGTCATTGGCTATCATCTAGAACGCAAGGAAAGAAATAGCATCCTCTGGGTTAAGTTGAATAAAACACCTATTCCTCAAACCAAGTTTAAGACAACTGGCCTTGAAGAAGGTGTTGAATATGAATTTAGAGTCTCTGCAGAGAACATCGTGGGCATTGGCAAGCCGAGTAAAGTATCAGAATGTTATGTGGCTCGTGACCCATGTGATCCACCAGGACGGCCAGAGGCAATCATTGTCACAAGGAATTCTGTGACTCTTCAGTGGAAGAAACCCACCTATGACGGTGGAAGCAAGATCACTGGTTATATTGTTGAGAAGAAAGAATTACCTGAGGGCCGTTGGATGAAAGCCAGTTTTACAAATATTATTGACACTCATTTTGAAGTAACTGGCCTAGTTGAAGATCACAGATATGAGTTCCGGGTTATAGCCCGAAATGCCGCAGGAGTGTTTAGTGAGCCTTCAGAAAGCACAGGAGCAATAACAGCTAGAGATGAGGTAGATCCACCACGAATAAGTATGGATCCAAAATACAAAGACACAATCGTGGTTCATGCTGGTGAATCATTCAAGGTTGATGCAGATATTTATGGCAAACCAATACCAACCATTCAGTGGATAAAAGGTGATCAGGAGCTTTCAAACACAGCTCGATTAGAAATAAAGAGCACCGACTTTGCCACCAGTCTCAGTGTAAAAGATGCAGTACGTGTCGACAGTGGAAATTACATACTGAAGGCCAAAAATGTTGCAGGAGAAAGATCAGTTACTGTGAATGTCAAGGTTCTTGACAGACCAGGGCCACCTGAAGGACCTGTTGTTATCTCAGGAGTTACAGCAGAAAAATGCACACTAGCTTGGAAACCCCCACTTCAGGATGGTGGGAGTGACATCATAAATTATATTGTGGAAAGGAGAGAAACCAGCCGCTTAGTTTGGACTGTGGTTGATGCCAATGTGCAGACTCTCAGCTGCAAGGTTACTAAGCTTCTTGAAGGCAATGAATATACTTTCCGTATAATGGCAGTAAACAAATATGGTGTTGGTGAACCTCTTGAATCTGAGCCAGTAGTTGCCAAGAATCCATTTGTAGTACCAGATGCACCAAAAGCTCCAGAAGTCACAACAGTGACCAAGGACTCAATGATTGTTGTATGGGAAAGACCAGCATCTGATGGTGGTAGTGAAATTCTTGGATATGTTCTTGAGAAACGGGATAAAGAAGGCATTAGATGGACAAGATGCCATAAGCGTCTGATTGGAGAGTTGCGCCTGAGAGTAACTGGACTCATAGAAAATCACGATTATGAGTTCAGAGTTTCTGCTGAGAATGCTGCTGGACTTAGTGAACCAAGCCCTCCTTCTGCTTACCAAAAGGCTTGTGATCCTATTTATAAACCAGGACCCCCAAACAACCCCAAAGTCATAGACATAACCAGATCTTCAGTATTCCTTTCTTGGAGCAAACCAATATATGATGGTGGCTGTGAAATTCAAGGATACATTGTTGAAAAATGTGATGTGAGTGTTGGTGAATGGACAATGTGCACTCCACCAACAGGAATTAATAAAACAAACATAGAAGTAGAGAAGCTGTTGGAAAAGCATGAATACAACTTCCGTATCTGTGCTATTAATAAAGCTGGAGTTGGAGAACATGCTGACGTCCCTGGACCTATTATAGTTGAAGAAAAATTAGAAGCACCAGACATTGATCTTGACCTAGAACTAAGGAAAATCATAAATATAAGGGCAGGTGGCTCCTTAAGGTTATTTGTTCCTATAAAAGGTCGTCCTACACCAGAAGTTAAATGGGGAAAGGTGGATGGTGAAATCCGAGATGCAGCTATAATTGATGTCACTAGCAGTTTCACCTCTCTTGTTCTTGACAATGTCAACCGATATGATAGTGGAAAATATACGCTTACATTAGAAAACAGCAGTGGAACAAAGTCTGCCTTTGTTACTGTGAGAGTTCTGGACACGCCAAGTCCACCTGTTAACCTGAAAGTCACAGAAATCACCAAAGACTCAGTATCAATTACATGGGAACCTCCTTTGTTGGATGGGGGATCCAAAATAAAAAATTACATTGTTGAGAAACGTGAAGCCACAAGAAAATCATATGCTGCTGTTGTAACTAACTGCCATAAGAATTCTTGGAAAATCGATCAGCTCCAAGAAGGTTGCAGTTATTACTTTAGAGTCACAGCTGAGAATGAGTATGGTATTGGCCTTCCTGCCCAGACTGCTGATCCAATTAAGGTTGCAGAAGTGCCACAACCTCCTGGAAAAATAACTGTGGATGATGTCACCAGAAACAGTGTCTCTCTGAGTTGGACAAAACCTGAACATGATGGTGGCAGTAAAATCATTCAGTATATTGTGGAAATGCAAGCTAAACACAGTGAGAAATGGTCAGAGTGTGCTCGAGTAAAGTCTCTTCAGGCAGTAATTACCAACCTAACTCAAGGGGAAGAATATCTTTTTAGAGTTGTTGCTGTAAATGAAAAGGGGAGAAGTGATCCTCGGTCCCTTGCAGTTCCAATAGTTGCCAAAGATCTGGTAATTGAGCCAGATGTAAAACCTGCATTCAGTAGTTACAGTGTACAGGTTGGCCAAGATTTGAAAATAGAAGTGCCAATTTCTGGACGTCCTAAGCCAACCATTACCTGGACTAAAGATGGTCTCCCACTGAAGCAGACCACAAGAATCAATGTTACCGATTCACTGGATCTCACCACACTCAGTATTAAAGAAACTCATAAGGATGATGGTGGACAATATGGAATCACAGTTGCCAATGTTGTTGGTCAGAAGACAGCATCCATCGAAATTGTAACTCTAGATAAACCTGATCCTCCAAAAGGACCTGTTAAATTTGATGACGTCAGTGCTGAAAGTATTACATTATCTTGGAACCCTCCATTATATACAGGGGGCTGCCAAATCACCAACTACATTGTTCAGAAAAGAGATACAACCACCACAGTATGGGATGTTGTTTCTGCTACTGTTGCTAGAACTACACTCAAAGTGACCAAACTGAAAACTGGTACAGAATACCAATTTAGAATATTTGCCGAAAACAGATATGGACAAAGCTTTGCCTTAGAGTCTGATCCAATTGTAGCTCAATATCCCTACAAAGAACCAGGCCCTCCAGGTACACCATTTGCCACAGCCATTTCCAAAGACTCCATGGTCATACAGTGGCATGAACCAGTCAACAATGGTGGAAGCCCCGTCATAGGTTACCACCTGGAGAGAAAAGAAAGAAACAGTATTTTGTGGACAAAGGTCAACAAAACTATTATTCATGACACCCAATTCAAAGCACAGAATCTTGAAGAAGGCATTGAATATGAATTCAGAGTGTATGCTGAAAATATTGTTGGTGTAGGCAAAGCAAGCAAGAATTCTGAATGCTATGTAGCCAGAGATCCCTGTGACCCACCAGGAACCCCAGAACCAATAATGGTTAAAAGAAATGAAATCACTTTACAGTGGACCAAACCTGTGTATGATGGTGGAAGTATGATTACAGGCTACATTGTAGAGAAACGTGATTTGCCTGATGGTCGTTGGATGAAAGCTAGCTTTACAAATGTCATTGAAACTCAATTTACTGTGTCAGGTCTTACTGAAGATCAAAGATATGAATTCAGAGTCATTGCAAAGAATGCAGCTGGTGCAATAAGTAAACCCTCTGACAGTACTGGACCAATAACTGCCAAGGATGAGGTTGAACTCCCAAGAATTTCAATGGATCCAAAATTCAGAGACACAATTGTGGTAAATGCTGGAGAAACATTCAGACTTGAGGCTGATGTCCATGGAAAGCCCCTACCTACCATTGAGTGGTTAAGAGGAGATAAGGAAATTGAAGAATCTGCTAGATGTGAAATAAAGAACACAGATTTCAAGGCTTTACTTATTGTAAAAGATGCAATTAGAATTGATGGTGGGCAGTATATTTTAAGAGCTTCCAATGTTGCAGGTTCTAAGTCATTCCCAGTAAATGTAAAAGTATTAGATAGACCAGGACCTCCAGAAGGGCCAGTCCAGGTTACTGGAGTCACTTCTGAAAAATGCTCTTTAACATGGTCTCCACCACTTCAAGATGGTGGCAGTGACATTTCTCACTATGTTGTTGAAAAGCGAGAAACCAGTCGACTTGCCTGGACTGTTGTTGCTTCAGAAGTTGTGACCAATTCTCTGAAAGTTACCAAACTCTTAGAAGGTAATGAATATGTTTTCCGTATAATGGCTGTCAACAAATATGGTGTTGGAGAGCCTTTGGAATCTGCACCAGTACTAATGAAAAATCCATTTGTGCTTCCTGGACCACCAAAAAGCTTGGAAGTCACAAATATTGCCAAAGACTCCATGACCGTCTGTTGGAACCGTCCAGATAGTGATGGTGGAAGTGAGATTATTGGTTACATTGTAGAGAAAAGAGACAGAAGTGGCATTCGATGGATAAAATGTAATAAACGCCGCATTACAGATTTGCGTCTAAGAGTGACAGGATTAACAGAAGATCATGAGTATGAATTCAGGGTCTCTGCAGAAAATGCTGCTGGAGTTGGGGAACCAAGTCCAGCTACAGTTTATTATAAAGCCTGTGATCCTGTGTTCAAACCTGGCCCACCTACCAATGCACACATTGTAGACACCACTAAAAATTCAATCACACTTGCCTGGGGTAAACCCATCTATGATGGCGGCAGTGAGATCTTGGGATATGTAGTAGAAATCTGTAAAGCAGATGAAGAAGAATGGCAAATAGTTACTCCACAGACTGGCCTGAGAGTCACTCGATTTGAAATTTCAAAACTCACTGAACACCAAGAGTATAAAATACGAGTCTGTGCCCTCAACAAAGTTGGTTTAGGTGAGGCTACATCAGTTCCTGGTACTGTGAAACCAGAAGATAAACTTGAAGCACCTGAACTTGACCTTGACTCCGAATTAAGAAAAGGAATTGTTGTAAGAGCTGGTGGATCTGCCAGAATTCACATTCCATTCAAAGGTCGTCCAACGCCTGAGATCACTTGGTCTCGAGAGGAAGGTGAATTCACAGATAAGGTCCAAATTGAAAAGGGAGTAAACTATACCCAACTATCAATAGATAACTGTGATAGAAATGATGCTGGAAAATACATTCTTAAGTTGGAAAACAGCAGTGGATCAAAGTCTGCTTTTGTAACTGTGAAAGTTCTTGACACTCCAGGACCACCACAGAATTTGGCAGTCAAAGAAGTGAGAAAAGATTCTGCCTTCCTGGTATGGGAGCCACCCATCATTGATGGAGGGGCAAAGGTCAAGAACTATGTGATTGACAAACGTGAGTCAACCAGAAAAGCGTATGCTAATGTGAGTAGTAAATGCAGCAAAACAAGTTTTAAAGTGGAAAACCTTACAGAAGGAGCCATTTATTACTTCAGAGTCATGGCTGAAAATGAATTTGGAGTTGGTGTTCCAGTGGAAACTGTTGATGCCGTGAAAGCTGCTGAACCTCCTTCCCCACCAGGAAAGGTTACACTCACTGATGTGTCCCAGACCAGTGCATCACTTATGTGGGAGAAACCTGAACATGATGGCGGTAGCAGAGTCCTGGGGTACGTTGTTGAAATGCAGCCCAAAGGAACTGAAAAATGGAGCATTGTGGCTGAATCCAAAGTCTGTAATGCAGTTGTTACTGGTTTGAGTTCTGGACAAGAATATCAGTTCCGTGTCAAGGCTTATAATGAGAAAGGAAAAAGCGATCCAAGAGTGTTGGGTGTTCCTGTCATAGCCAAGGACTTGACTATACAGCCTAGTTTAAAGTTACCATTTAACACATATAGTATCCAAGCTGGAGAAGATCTTAAAATAGAAATTCCAGTTATAGGCCGACCAAGACCTAACATTTCTTGGGTCAAAGATGGTGAGCCTCTTAAACAGACAACAAGAGTAAACGTTGAAGAAACAGCTACCTCAACTGTTTTGCACATTAAAGAAGGTAACAAAGATGACTTTGGAAAATACACCGTAACGGCAACAAATAGTGCAGGCACAGCAACAGAAAATCTCAGTGTTATCGTTTTAGAAAAGCCTGGACCTCCAGTTGGCCCAGTTCGGTTTGATGAAGTTAGTGCAGACTTTGTAGTCATATCTTGGGAACCTCCAGCCTATACTGGTGGCTGCCAAATAAGCAACTACATTGTAGAGAAGCGAGATACAACCACCACCACTTGGCACATGGTATCAGCAACAGTTGCAAGAACAACAATTAAAATAACCAAACTGAAAACAGGCACGGAGTACCAGTTTAGAATTTTTGCTGAAAACAGGTATGGAAAAAGTGCCCCACTGGATTCTAAGGCAGTTATTGTACAATATCCATTTAAAGAACCTGGACCACCTGGAACTCCTTTTGTGACATCAATCTCAAAAGATCAGATGCTTGTGCAATGGCATGAGCCAGTGAATGATGGAGGCACCAAAATTATTGGCTACCATCTTGAACAGAAAGAAAAGAACAGTATTTTATGGGTCAAGTTAAATAAGACCCCCATTCAGGACACCAAATTCAAAACAACTGGGCTTGATGAGGGCCTTGAGTATGAGTTCAAAGTTTCTGCTGAAAATATTGTTGGCATTGGCAAGCCTAGCAAAGTGTCAGAATGCTTTGTTGCTCGTGATCCATGTGACCCACCTGGTCGCCCTGAAGCCATTGTTATTACAAGAAACAATGTCACACTGAAATGGAAGAAACCTGCCTATGATGGTGGTAGCAAAATAACAGGTTATATTGTAGAAAAGAAAGATCTACCTGATGGCCGCTGGATGAAAGCCAGCTTTACCAACGTATTAGAAACTGAATTTACAGTGAGTGGACTTGTAGAAGACCAAAGATATGAATTTAGAGTAATTGCAAGAAATGCAGCTGGAAACTTTAGTGAACCATCTGATAGTAGTGGTGCCATTACTGCAAGAGATGAAATTGATGCACCAAATGCCTCTCTGGATCCAAAATATAAAGATGTCATCGTTGTTCATGCAGGAGAGACTTTTGTTCTTGAAGCCGACATCCGTGGCAAACCTATACCTGATGTTGTTTGGTCAAAAGATGGAAAAGAACTTGAAGAAACAGCTGCTAGAATGGAAATTAAATCTACTATTCAGAAAACAACTCTTGTTGTCAAAGACTGTATACGGACTGATGGAGGACAATATATTCTGAAACTCAGCAATGTTGGTGGTACAAAGTCTATACCCATCACTGTAAAGGTACTTGACAGGCCAGGGCCTCCTGAAGGGCCTCTGAAAGTTACTGGAGTTACTGCGGAAAAATGTTACCTGGCATGGAACCCACCTTTGCAAGATGGTGGTGCTAATATTTCACATTACATCATTGAAAAGAGGGAGACAAGCCGACTCTCTTGGACCCAGGTTTCAACTGAGGTACAGGCCCTTAACTACAAAGTTACTAAACTTCTTCCTGGTAATGAGTACATTTTCCGTGTCATGGCTGTGAATAAATATGGAATTGGAGAGCCCTTGGAATCTGGGCCTGTTACGGCCTGTAATCCTTATAAGCCACCAGGTCCTCCCTCAACACCTGAAGTCTCAGCAATCACCAAAGATTCTATGGTAGTAACATGGGCACGCCCAGTAGACGACGGAGGTACCGAAATTGAGGGCTACATTCTTGAAAAACGAGATAAGGAAGGCGTTAGATGGACCAAGTGCAACAAGAAAACATTAACGGATCTGCGGCTCAGGGTAACTGGTCTTACCGAAGGCCATTCCTATGAATTCAGAGTTGCTGCTGAAAATGCAGCTGGTGTGGGAGAACCTAGTGAGCCATCTGTTTTCTACCGTGCGTGTGATGCCTTGTATCCACCAGGTCCCCCAAGCAATCCAAAAGTGACGGACACTTCCAGATCTTCTGTCTCCCTGGCATGGAGTAAGCCAATTTATGATGGTGGCGCACCTGTTAAAGGCTATGTTGTAGAGGTCAAAGAAGCTGCTGCGGATGAATGGACAACCTGCACTCCACCAACAGGATTACAAGGAAAGCAGTTCACAGTGACCAAGCTTAAAGAAAACACTGAATATAACTTCCGTATTTGTGCCATCAATTCTGAAGGTGTAGGTGAACCTGCAACTCTACCTGGCTCAGTGGTTGCTCAGGAGAGGATAGAGCCACCAGAAATAGAACTCGATGCTGATCTCAGAAAGGTGGTCGTTCTGCGTGCAAGTGCTACTTTACGCTTATTTGTCACTATCAAAGGTCGACCAGAACCCGAAGTTAAATGGGAAAAGGCAGAAGGCATTCTCACTGACAGGGCTCAGATAGAGGTGACCAGCTCATTTACAATGTTGGTGATTGATAATGTTACCAGATTTGACAGTGGTCGGTATAATCTGACATTAGAAAATAATAGTGGCTCCAAAACAGCTTTTGTTAACGTCAGAGTTCTTGACTCACCAAGTGCCCCTGTGAATTTGACCATAAGAGAAGTGAAGAAAGACTCAGTGACGTTGTCCTGGGAACCACCACTTATTGATGGTGGAGCTAAGATTACAAACTACATTGTCGAAAAACGAGAAACTACAAGAAAAGCCTATGCTACCATTACAAATAATTGCACTAAAACTACTTTCAGAATTGAAAATCTACAAGAAGGATGTTCTTACTACTTCCGAGTCTTGGCTTCCAATGAATATGGGATTGGTTTGCCAGCTGAAACAACAGAACCCGTTAAAGTGTCTGAACCACCCCTCCCACCTGGAAGAGTAACTCTTGTTGATGTGACCCGTAATACAGCTACAATTAAGTGGGAGAAACCAGAAAGTGATGGTGGCAGCAAAATTACTGGTTATGTGGTTGAAATGCAGACTAAAGGGAGTGAAAAGTGGAGCACCTGCACACAAGTTAAGACTCTAGAAGCAACTATATCTGGCTTAACTGCAGGAGAAGAGTATGTCTTCAGGGTAGCTGCAGTTAACGAAAAGGGAAGAAGTGATCCAAGACAACTTGGAGTGCCAGTAATTGCAAGGGATATTGAAATAAAGCCTTCAGTTGAGCTTCCTTTCCATACTTTCAATGTAAAGGCTAGAGAACAACTTAAGATTGATGTGCCATTCAAAGGAAGACCTCAAGCTACTGTGAACTGGAGAAAAGATGGTCAGACTCTTAAAGAGACAACTAGAGTCAATGTTTCTTCTTCAAAGACTGTAACATCACTATCTATTAAGGAAGCTTCAAAGGAAGATGTTGGAACTTATGAATTATGTGTTTCAAACAGTGCTGGATCCATAACAGTTCCTATTACTATAATTGTCCTTGACAGACCAGGACCTCCAGGTCCTATACGTATTGATGAGGTTAGTTGTGACAGCATAACCATTTCTTGGAATCCTCCAGAATATGATGGTGGCTGCCAAATTAGCAATTACATTGTTGAAAAGAAAGAAACCACCTCTACAACATGGCACATAGTTTCACAAGCAGTTGCAAGAACATCCATTAAAATAGTTCGCCTGACAACAGGAAGTGAGTATCAGTTCCGTGTTTGTGCAGAAAACCGCTATGGAAAGAGCTCCTACAGTGAATCTTCAGCTGTTGTTGCAGAGTATCCATTCAGTCCCCCAGGTCCTCCTGGTACTCCTAAAGTTGTGCATGCCACAAAATCTACCATGCTTGTAACCTGGCAAGTGCCAGTTAATGATGGAGGAAGTCGAGTAATTGGCTATCATCTTGAGTATAAAGAAAGAAGCAGCATTCTTTGGTCAAAAGCAAATAAAATCCTCATTGCTGATACTCAAATGAAAGTCTCCGGCCTTGATGAAGGACTGATGTATGAGTATCGTGTATATGCTGAAAATATTGCTGGAATTGGTAAATGCAGTAAATCTTGTGAACCAGTCCCTGCAAGAGATCCTTGTGACCCTCCTGGACAACCTGAAGTCACAAATATCACAAGAAAATCAGTGTCACTTAAATGGTCTAAACCACATTATGATGGTGGAGCTAAGATCACAGGATACATTGTTGAACGCAGAGAACTACCAGATGGCCGGTGGCTGAAGTGCAATTATACTAATATACAAGAAACATACTTTGAAGTAACTGAACTTACTGAAGATCAGCGTTATGAATTCCGGGTTTTTGCAAGGAATGCTGCTGACTCAGTTAGTGAGCCATCTGAATCCACTGGGCCTATTATAGTTAAAGATGATGTTGAGCCTCCAAGAGTTATGATGGATGTCAAGTTCCGAGACGTTATTGTTGTCAAAGCTGGAGAGGTCCTTAAGATAAATGCAGACATTGCAGGGCGACCTCTGCCAGTAATTTCCTGGGCCAAGGATGGTATAGAAATTGAAGAAAGAGCAAGAACAGAAATCATCTCAACAGACAATCATACTTTGTTAACAGTTAAAGACTGTATAAGACGAGACACTGGGCAATATGTACTAACACTGAAGAATGTTGCCGGCACTCGGTCTGTGGCCGTTAATTGCAAAGTACTTGATAAGCCTGGTCCACCAGCAGGACCACTTGAAATAAATGGCCTCACTGCTGAGAAATGCTCTCTTTCCTGGGGACGTCCCCAAGAAGATGGTGGTGCAGATATCGACTATTACATCGTAGAAAAACGTGAAACAAGCCACCTTGCATGGACAATATGTGAAGGAGAGTTACAGATGACATCCTGTAAAGTAACCAAGTTACTCAAAGGCAATGAATATATATTTAGAGTAACTGGTGTTAATAAATATGGTGTTGGTGAGCCCCTAGAGAGTGTAGCTATAAAGGCACTAGATCCATTTACAGTTCCAAGTCCACCCACGTCTTTGGAAATTACTTCTGTGACCAAAGAATCTATGACACTTTGCTGGTCAAGACCCGAGAGTGATGGAGGTAGTGAAATATCTGGATATATAATTGAAAGGCGAGAGAAAAATAGCCTAAGATGGGTGCGTGTAAACAAAAAACCAGTTTATGATCTAAGAGTGAAATCAACAGGACTTCGGGAAGGATGTGAATATGAATATCGTGTTTATGCAGAAAATGCTGCTGGCCTAAGTCTTCCAAGTGAAACCTCTCCCTTAATTAGGGCAGAAGATCCAGTGTTCCTACCATCTCCTCCATCCAAACCCAAAATTGTGGACTCAGGCAAGACAACTATAACTATTGCCTGGGTTAAGCCGCTGTTTGATGGTGGGGCCCCGATAACTGGATATACTGTAGAATACAAAAAATCTGATGACACTGACTGGAAAACTTCCATTCAGAGCTTACGAGGGACAGAATATACAATAAGCGGACTAACAACAGGAGCTGAATATGTTTTCAGAGTAAAATCTGTCAATAAGGTTGGTGCTAGTGACCCCAGTGATAGCTCTGACCCTCAGATAGCAAAGGAAAGAGAAGAAGAACCTTTATTTGATATTGACAGTGAAATGAGGAAGACCTTGATTGTCAAGGCTGGTGCCTCATTTACCATGACTGTGCCTTTCCGAGGAAGACCAGTACCCAATGTCTTGTGGAGTAAGCCAGACACTGACCTCCGTACTAGAGCTTATGTTGATACCACAGACTCTCGTACATCACTGACCATTGAAAATGCCAACAGAAATGACTCTGGAAAGTACACATTAACAATTCAGAATGTTTTGAGTGCTGCTTCACTGACCTTAGTTGTCAAAGTTTTAGATACCCCAGGTCCTCCAACCAACATTACTGTGCAAGATGTAACCAAAGAGTCTGCAGTGTTATCCTGGGATGTTCCTGAAAACGATGGTGGAGCACCAGTGAAGAATTACCACATAGAAAAACGTGAGGCCAGCAAGAAAGCATGGGTCTCTGTGACCAACAACTGTAACCGCCTCTCCTACAAAGTTACCAATTTACAAGAAGGAGCTATCTATTACTTCAGAGTCTCTGGAGAAAATGAGTTTGGTGTTGGTATACCAGCTGAAACAAAGGAAGGAGTAAAAATAACAG
>TTN-202,ENSE00003802597,1,297,918085,918381,AAAAACCAAGCCCACCTGAAAAACTTGGAGTAACAAGTATATCCAAAGACAGTGTTTCCCTGACCTGGCTGAAGCCTGAACATGATGGCGGAAGCAGAATTGTACACTATGTCGTTGAAGCACTAGAAAAAGGACAGAAAAACTGGGTTAAATGTGCAGTGGCAAAGTCAACCCATCACGTTGTTTCCGGTCTGAGAGAGAATTCTGAATACTTTTTCCGAGTGTTTGCTGAAAATCAAGCTGGCCTGAGTGACCCGAGAGAGCTTCTGCTTCCTGTTCTTATTAAGGAGCAACTAG
>TTN-202,ENSE00003802941,1,588,918382,918969,AACCACCTGAAATTGATATGAAGAATTTCCCAAGTCACACTGTATATGTTAGAGCTGGTTCAAACCTTAAAGTTGACATTCCAATCTCTGGAAAACCACTTCCCAAAGTGACCTTATCAAGAGATGGTGTCCCCCTTAAGGCAACCATGAGATTTAATACCGAAATTACTGCTGAGAACCTGACCATCAATCTCAAAGAAAGTGTTACAGCTGACGCTGGGAGATATGAAATCACTGCTGCCAACTCCAGTGGTACAACCAAAGCTTTCATTAACATTGTTGTGCTAGACAGGCCTGGTCCTCCAACTGGCCCTGTTGTTATTAGTGATATAACTGAAGAAAGTGTGACTCTCAAATGGGAGCCACCTAAGTATGACGGTGGAAGTCAAGTTACCAACTACATTCTACTCAAAAGAGAAACAAGTACTGCAGTGTGGACTGAAGTGTCTGCAACAGTTGCAAGAACCATGATGAAAGTCATGAAACTGACCACAGGAGAAGAATACCAATTCCGCATCAAGGCAGAAAACCGCTTTGGCATCAGTGATCATATAGATTCAGCTTGTGTGACTGTCAAACTACCATACA
>TTN-202,ENSE00003808789,1,303,918970,919272,CAACACCTGGACCACCATCTACACCATGGGTCACTAATGTTACTCGAGAAAGCATCACTGTGGGCTGGCATGAACCAGTGTCAAATGGAGGCAGTGCAGTCGTAGGCTATCACCTGGAAATGAAAGACAGAAACAGTATTTTATGGCAAAAAGCCAACAAACTGGTCATCCGCACAACTCACTTCAAAGTCACAACAATCAGTGCTGGACTTATTTATGAATTCAGGGTGTATGCAGAAAATGCTGCTGGAGTTGGAAAACCTAGCCATCCTTCTGAACCAGTCTTGGCAATTGATGCTTGTG
>TTN-202,ENSE00003806587,1,297,919273,919569,AACCCCCAAGAAATGTTCGTATCACTGATATTTCAAAGAACTCTGTCAGCCTTTCATGGCAACAACCAGCTTTCGATGGAGGTAGCAAGATTACAGGCTACATTGTTGAGAGACGTGACCTTCCAGATGGCAGATGGACCAAGGCCAGCTTCACCAATGTTACTGAAACTCAATTCATCATCTCTGGCTTGACTCAGAATTCCCAGTATGAATTCCGTGTCTTTGCTAGGAATGCTGTTGGTTCCATTAGCAATCCATCTGAGGTTGTAGGGCCCATTACTTGCATCGATTCTTATG
>TTN-202,ENSE00003807681,1,288,919570,919857,GTGGTCCTGTAATTGATTTGCCTCTAGAATATACAGAAGTTGTCAAATACAGAGCAGGTACATCTGTGAAGCTCAGAGCTGGCATTTCTGGCAAACCTGCGCCTACTATTGAGTGGTATAAAGATGATAAAGAATTACAAACCAATGCACTGGTGTGTGTTGAAAATACCACGGACCTCGCATCTATACTCATCAAAGATGCCGATCGCCTTAATAGTGGATGCTATGAATTAAAACTAAGGAATGCCATGGGCTCAGCCTCAGCCACCATCAGAGTACAGATCCTTG
>TTN-202,ENSE00003811102,1,300,919858,920157,ACAAACCAGGCCCACCTGGTGGACCAATTGAATTTAAGACTGTAACTGCTGAGAAGATCACCCTTCTCTGGCGGCCTCCAGCTGATGATGGTGGTGCAAAAATCACTCACTACATTGTGGAAAAGCGTGAGACAAGCCGCGTTGTGTGGTCTATGGTGTCTGAACATTTGGAAGAGTGCATCATTACAACCACCAAAATTATCAAAGGAAATGAATACATCTTCCGGGTCCGAGCCGTGAACAAATATGGAATTGGCGAGCCACTGGAATCTGATTCCGTTGTAGCCAAGAACGCATTTG
>TTN-202,ENSE00003802386,1,303,920158,920460,TTACACCTGGGCCACCAGGCATACCAGAAGTGACAAAGATTACCAAGAATTCGATGACTGTTGTATGGAGCAGGCCAATTGCAGATGGCGGTAGTGATATAAGTGGCTATTTCCTTGAAAAACGAGACAAGAAGAGCCTAGGATGGTTTAAAGTACTAAAAGAGACTATCCGTGACACCAGACAAAAAGTAACAGGACTCACAGAAAACAGTGACTATCAATACAGAGTTTGTGCTGTAAACGCTGCTGGACAGGGTCCATTTTCTGAACCATCTGAATTCTACAAAGCTGCTGATCCTATTG
>TTN-202,ENSE00003809908,1,306,920461,920766,ATCCTCCAGGTCCACCTGCTAAGATAAGAATCGCAGATTCAACCAAGTCATCCATCACCCTTGGCTGGAGTAAGCCTGTCTATGATGGGGGCAGTGCTGTTACTGGGTATGTTGTCGAGATAAGACAAGGAGAGGAAGAGGAATGGACTACTGTCTCTACCAAAGGAGAGGTCAGAACTACAGAATATGTGGTATCCAACCTGAAACCTGGAGTCAATTACTACTTCCGGGTATCTGCTGTAAACTGTGCTGGACAAGGAGAACCTATAGAAATGAATGAACCTGTACAAGCTAAAGATATACTTG
>TTN-202,ENSE00003808993,1,1767,920767,922533,AGGCACCAGAGATTGACCTGGATGTGGCTCTCAGAACTTCTGTTATTGCCAAAGCTGGTGAAGATGTACAAGTGTTGATTCCCTTTAAAGGCAGACCTCCACCTACTGTCACATGGAGAAAAGATGAGAAGAATCTTGGCAGTGATGCCAGATACAGCATTGAAAACACTGATTCATCCTCATTACTCACCATTCCTCAAGTTACTCGCAATGATACAGGAAAATATATTCTCACAATAGAAAATGGAGTTGGTGAACCTAAGTCTTCAACTGTGAGTGTTAAAGTGCTTGACACACCAGCTGCCTGCCAGAAACTACAGGTTAAACATGTTTCTCGAGGCACAGTCACTTTGCTCTGGGATCCTCCTCTCATTGATGGAGGATCTCCAATAATTAATTATGTCATTGAAAAGAGAGATGCCACCAAGAGAACATGGTCTGTCGTGTCACACAAATGTTCTAGCACATCCTTCAAGCTAATAGATTTGTCGGAGAAGACTCCATTCTTCTTCAGAGTTCTTGCAGAAAATGAAATTGGAATTGGGGAACCCTGTGAAACTACAGAGCCAGTGAAGGCTGCTGAAGTACCAGCTCCTATACGTGATCTCTCAATGAAAGACTCAACAAAGACATCTGTCATCCTCAGCTGGACCAAACCTGACTTTGATGGTGGTAGCGTCATCACAGAATATGTTGTAGAAAGGAAAGGTAAAGGTGAACAGACGTGGTCCCACGCTGGCATAAGTAAGACATGTGAAATTGAGGTTAGCCAACTTAAGGAGCAGTCAGTCCTGGAGTTCAGAGTGTTTGCCAAAAATGAGAAAGGACTGAGTGATCCTGTCACTATTGGGCCAATTACAGTGAAAGAACTTATTATTACACCTGAAGTTGACCTGTCAGATATCCCTGGGGCACAAGTCACTGTGAGAATTGGGCACAATGTGCACCTTGAATTACCTTATAAGGGAAAACCCAAACCATCCATCAGTTGGCTGAAAGATGGCTTGCCACTGAAAGAAAGTGAATTTGTTCGCTTCAGTAAAACTGAAAACAAAATTACTTTGAGTATTAAGAATGCCAAGAAGGAGCATGGAGGAAAATACACTGTTATTCTTGATAATGCAGTGTGTAGAATTGCAGTCCCCATTACAGTCATCACCCTTGGCCCACCATCAAAGCCCAAAGGACCCATTCGATTTGATGAAATCAAGGCTGATAGTGTCATCCTGTCATGGGATGTACCTGAAGATAATGGAGGAGGAGAAATTACTTGTTACAGCATCGAGAAGCGGGAAACTTCACAAACTAACTGGAAGATGGTGTGTTCAAGTGTTGCCAGAACGACTTTCAAAGTTCCTAATCTAGTCAAAGATGCTGAGTACCAGTTTAGAGTGAGAGCAGAAAACAGATACGGAGTCAGCCAACCACTTGTCTCAAGCATTATTGTGGCAAAACACCAGTTCAGGATTCCTGGTCCCCCAGGAAAGCCAGTTATATACAATGTGACTTCTGATGGCATGTCACTAACTTGGGATGCTCCAGTTTATGATGGTGGTTCAGAAGTTACTGGATTCCATGTTGAAAAGAAAGAAAGAAATAGCATCCTCTGGCAAAAAGTTAATACATCACCAATCTCTGGAAGAGAATATAGAGCCACTGGACTGGTAGAAGGTCTGGATTACCAATTCCGTGTATATGCTGAAAATTCTGCTGGCCTAAGCTCACCTAGTGACCCAAGCAAATTTACCTTAGCTGTTTCTCCAGTAG
>TTN-202,ENSE00003811205,1,294,922534,922827,ACCCACCTGGCACTCCTGACTACATTGATGTCACCCGGGAAACCATCACACTTAAATGGAACCCACCATTGCGTGATGGAGGCAGTAAGATTGTGGGCTATAGCATTGAGAAACGGCAAGGAAATGAACGCTGGGTGAGATGCAACTTTACTGACGTCAGTGAATGTCAGTACACAGTTACAGGACTCAGTCCTGGGGATCGCTATGAGTTCAGAATAATTGCAAGAAATGCTGTTGGAACTATAAGCCCGCCCTCACAGTCTTCTGGCATTATTATGACAAGAGATGAAAATG
>TTN-202,ENSE00003808021,1,288,922828,923115,TTCCACCAATAGTAGAGTTTGGCCCTGAATACTTTGATGGTCTCATTATTAAGTCCGGAGAGAGCCTTAGAATTAAAGCTTTGGTACAAGGAAGACCAGTGCCTCGAGTAACTTGGTTCAAAGATGGAGTGGAAATCGAAAAGAGGATGAATATGGAAATAACCGACGTACTTGGATCCACCAGCCTATTTGTTAGAGATGCTACTCGGGACCATCGTGGTGTATACACAGTGGAAGCCAAAAATGCATCTGGTTCTGCAAAAGCAGAAATTAAAGTGAAAGTACAAG
>TTN-202,ENSE00003804355,1,300,923116,923415,ATACACCAGGAAAAGTAGTTGGGCCAATAAGATTCACCAATATTACTGGGGAGAAGATGACTCTGTGGTGGGATGCCCCACTCAATGACGGTTGTGCTCCCATAACCCACTACATCATTGAAAAACGGGAAACCAGCAGACTTGCCTGGGCACTAATTGAGGATAAATGTGAAGCCCAAAGTTACACTGCCATTAAACTAATAAACGGCAATGAATACCAATTCCGTGTTTCTGCAGTTAACAAGTTTGGTGTTGGCAGGCCACTTGATTCTGATCCAGTGGTTGCTCAAATACAATATA
>TTN-202,ENSE00003807046,1,2067,923416,925482,CTGTTCCTGATGCCCCTGGCATTCCAGAACCTAGCAACATAACAGGCAACAGCATTACCCTGACATGGGCAAGGCCAGAATCAGATGGTGGCAGTGAAATTCAACAGTATATCCTTGAAAGAAGAGAAAAGAAAAGCACAAGATGGGTAAAAGTGATCAGCAAACGACCAATCTCTGAAACAAGATTCAAAGTCACTGGTCTGACAGAAGGCAATGAGTATGAATTCCATGTCATGGCTGAAAATGCTGCAGGAGTTGGACCTGCAAGTGGCATCTCAAGACTCATTAAATGTAGAGAGCCCGTCAACCCACCAGGTCCTCCCACAGTGGTCAAAGTAACAGACACATCAAAGACAACTGTGAGCTTAGAATGGTCCAAACCAGTGTTTGATGGTGGCATGGAAATAATTGGGTATATTATTGAAATGTGTAAGGCCGACTTAGGAGACTGGCACAAGGTGAATGCAGAGGCATGTGTGAAAACAAGATATACAGTCACTGATCTACAAGCAGGTGAAGAATACAAATTCCGAGTTAGTGCTATCAATGGTGCTGGAAAAGGCGACAGCTGTGAAGTGACTGGCACAATTAAAGCAGTTGACCGGTTAACAGCTCCTGAGTTAGACATAGATGCAAACTTCAAACAGACTCATGTTGTTAGAGCTGGGGCCAGTATTCGCCTCTTCATTGCCTACCAAGGTAGACCTACTCCTACAGCTGTGTGGAGCAAACCAGACTCTAACCTTAGCCTTCGGGCTGATATCCATACAACAGATTCCTTCAGCACCCTCACTGTGGAAAACTGCAACAGAAATGATGCAGGGAAATATACCCTTACTGTGGAAAACAACAGTGGTAGTAAGTCAATCACATTCACCGTGAAAGTGCTAGACACTCCAGGCCCACCTGGCCCAATTACCTTCAAAGATGTGACCCGGGGATCTGCTACATTGATGTGGGATGCCCCTCTTCTTGACGGTGGTGCCCGAATCCATCATTATGTGGTAGAGAAACGAGAGGCAAGTCGCCGTAGTTGGCAGGTTATCAGTGAAAAATGCACTCGTCAGATCTTCAAGGTCAATGACCTGGCCGAAGGTGTTCCGTACTATTTCCGTGTTTCTGCAGTAAATGAGTATGGTGTTGGTGAGCCCTATGAAATGCCAGAACCAATTGTAGCCACAGAACAGCCTGCTCCACCTAGGAGACTTGATGTTGTTGATACTAGCAAATCCTCCGCAGTCTTAGCTTGGCTTAAACCTGACCACGATGGAGGCAGCCGGATCACTGGCTACCTGCTTGAAATGAGACAAAAGGGATCTGACTTCTGGGTTGAAGCTGGTCACACCAAACAGCTAACTTTCACAGTAGAGCGTCTTGTTGAGAAAACTGAATATGAATTCCGTGTGAAGGCCAAGAATGATGCTGGCTATAGTGAACCCAGAGAAGCCTTCTCTTCTGTCATCATTAAGGAGCCTCAAATCGAGCCCACTGCTGACCTCACTGGAATTACCAATCAGCTTATAACTTGCAAAGCAGGAAGCCCATTTACCATTGACGTACCAATCAGTGGTCGTCCTGCCCCCAAAGTAACATGGAAACTGGAAGAAATGAGACTTAAAGAGACAGATCGAGTGAGCATTACAACAACAAAAGACAGAACCACACTGACTGTAAAGGACAGCATGAGAGGTGACTCTGGAAGATACTTCTTGACCCTGGAAAATACAGCTGGTGTTAAAACATTTAGCGTCACAGTTGTGGTCATTGGAAGGCCAGGTCCAGTAACCGGCCCCATTGAGGTCTCATCTGTCTCAGCTGAATCGTGTGTCCTGTCATGGGGAGAACCTAAAGATGGAGGAGGCACTGAAATTACTAATTACATAGTTGAAAAGCGTGAATCGGGTACAACAGCTTGGCAGCTTGTCAATTCCAGTGTCAAGCGCACTCAAATTAAAGTCACTCATCTCACAAAATACATGGAATATTCTTTCCGTGTCAGTTCAGAGAACAGATTTGGTGTCAGCAAACCTCTAGAATCAGCACCAATAATTGCTGAACATCCATTTG
>TTN-202,ENSE00003810611,1,303,925483,925785,TCCCACCAAGCGCTCCTACCAGACCTGAGGTCTACCATGTGTCTGCCAATGCCATGTCTATTCGTTGGGAAGAACCCTACCACGATGGTGGCAGTAAAATCATTGGCTACTGGGTTGAGAAGAAAGAACGTAATACAATTCTTTGGGTGAAAGAAAACAAAGTGCCATGCTTAGAGTGCAACTACAAAGTAACTGGTTTAGTAGAAGGACTGGAATATCAGTTCAGAACTTATGCACTCAATGCTGCAGGTGTTAGCAAGGCCAGCGAAGCTTCAAGACCTATAATGGCTCAAAATCCAGTTG
>TTN-202,ENSE00003803222,1,306,925786,926091,ATGCACCAGGCAGACCAGAGGTGACAGATGTCACAAGATCAACAGTATCACTGATTTGGTCTGCCCCAGCGTATGATGGAGGCAGCAAGGTTGTGGGCTACATCATAGAGCGTAAGCCAGTCAGTGAGGTAGGAGATGGTCGCTGGCTGAAGTGCAACTACACCATTGTATCTGACAATTTCTTCACCGTGACTGCTCTCAGTGAAGGAGACACTTATGAGTTCCGTGTGTTAGCCAAGAATGCAGCAGGCGTAATTAGCAAAGGGTCTGAATCTACAGGCCCTGTCACTTGCCGAGATGAATACG
>TTN-202,ENSE00003801213,1,291,926092,926382,CTCCACCCAAAGCCGAACTGGATGCCCGATTACACGGTGATCTGGTTACCATCAGAGCAGGTTCTGATCTTGTTCTGGATGCTGCAGTTGGTGGCAAACCTGAACCCAAAATTATCTGGACCAAAGGAGACAAGGAGCTAGATCTCTGTGAAAAAGTCTCTTTGCAGTATACTGGCAAACGAGCAACTGCTGTGATCAAGTTCTGTGACAGAAGTGACAGTGGAAAATACACTTTAACAGTGAAAAATGCCAGCGGGACCAAGGCCGTGTCTGTCATGGTCAAAGTGCTTG
>TTN-202,ENSE00003809128,1,297,926383,926679,ATTCCCCTGGCCCATGTGGAAAGCTCACCGTCAGCAGAGTAACACAGGAGAAGTGCACTTTAGCCTGGAGCCTTCCGCAGGAAGACGGAGGAGCAGAAATCACTCACTACATCGTGGAAAGACGCGAGACTAGCAGGCTCAACTGGGTGATTGTTGAAGGCGAATGCCCAACCCTATCCTATGTCGTTACCAGGCTCATCAAGAACAATGAGTACATATTCCGAGTGAGGGCAGTAAACAAATATGGCCCTGGTGTGCCTGTTGAATCAGAGCCAATTGTAGCCAGAAACTCATTCA
>TTN-202,ENSE00003803385,1,306,926680,926985,CTATTCCATCACCACCCGGCATACCTGAAGAAGTTGGGACTGGCAAAGAGCATATCATCATTCAGTGGACAAAACCTGAATCTGATGGTGGCAATGAAATCAGCAACTACCTAGTAGACAAACGTGAGAAGAAGAGCCTGCGCTGGACACGTGTCAACAAAGACTATGTGGTGTATGATACCAGGCTGAAGGTGACCAGCCTGATGGAGGGTTGTGATTACCAGTTCCGGGTGACCGCAGTGAATGCAGCTGGTAACAGTGAGCCCAGCGAAGCTTCCAACTTCATCTCATGCAGAGAACCATCAT
>TTN-202,ENSE00003807140,1,306,926986,927291,ATACCCCTGGACCACCTTCTGCTCCAAGAGTTGTGGATACCACCAAACACAGCATTAGTTTGGCATGGACCAAACCCATGTACGATGGTGGTACTGACATTGTAGGATATGTTCTGGAAATGCAAGAGAAGGACACTGATCAGTGGTACCGAGTGCATACCAATGCCACAATAAGAAATACTGAATTCACTGTGCCAGACCTTAAAATGGGCCAGAAATATTCCTTCAGAGTTGCTGCCGTGAACGTGAAGGGTATGAGCGAATACAGCGAATCAATTGCTGAAATTGAGCCCGTGGAAAGAATAG
>TTN-202,ENSE00003809946,1,282,927292,927573,AAATACCAGATCTTGAGCTTGCAGATGATCTAAAGAAGACTGTGACCATCAGGGCTGGGGCCTCCTTGCGCTTGATGGTGTCTGTATCTGGAAGACCACCTCCTGTCATAACGTGGAGCAAGCAGGGCATTGACCTTGCAAGCCGGGCAATTATTGACACCACTGAGAGCTACTCATTGCTAATAGTGGACAAAGTTAATCGGTACGATGCTGGAAAATACACAATTGAAGCTGAAAACCAATCTGGCAAGAAATCAGCAACAGTCCTTGTTAAAGTCTATG
>TTN-202,ENSE00003810384,1,594,927574,928167,ATACTCCTGGTCCCTGTCCTTCAGTGAAAGTTAAGGAAGTATCAAGAGATTCTGTGACTATAACTTGGGAAATTCCCACGATTGATGGTGGAGCTCCAGTCAACAATTACATCGTTGAGAAGCGTGAAGCTGCTATGAGAGCATTCAAAACAGTAACTACCAAATGCAGCAAGACACTTTACAGAATTTCTGGACTTGTAGAAGGAACCATGTACTATTTCAGAGTGCTGCCAGAAAATATTTATGGCATTGGAGAACCTTGTGAAACATCTGATGCAGTACTGGTCTCAGAAGTGCCTTTGGTGCCTGCAAAGCTAGAAGTGGTCGATGTCACCAAATCCACTGTTACCCTTGCCTGGGAAAAACCACTCTACGATGGTGGTAGCCGACTCACTGGATATGTTCTCGAGGCCTGCAAAGCTGGCACAGAGAGATGGATGAAGGTTGTCACCTTAAAACCCACAGTCCTAGAGCACACTGTTACTTCCTTAAATGAAGGTGAACAATACTTATTTAGAATAAGGGCACAAAATGAGAAAGGTGTGTCAGAACCAAGAGAGACTGTCACAGCCGTGACTGTACAAGACCTCAGAG
>TTN-202,ENSE00003802641,1,288,928168,928455,TGTTGCCAACAATCGATCTTTCTACAATGCCTCAGAAGACCATCCATGTCCCAGCTGGCAGACCAGTAGAGCTGGTGATACCTATTGCTGGCCGTCCACCTCCTGCTGCTTCCTGGTTCTTTGCTGGTTCTAAACTGAGAGAATCAGAGCGTGTCACAGTTGAAACTCACACTAAAGTAGCTAAATTAACCATCCGTGAAACCACTATCAGAGATACTGGAGAATACACACTTGAATTGAAGAATGTTACCGGAACTACTTCAGAAACCATTAAAGTTATCATTCTTG
>TTN-202,ENSE00003806194,1,300,928456,928755,ACAAGCCTGGTCCACCAACAGGACCTATTAAGATTGATGAAATTGATGCTACATCAATTACCATTTCCTGGGAACCACCTGAATTGGACGGTGGTGCTCCACTGAGTGGTTATGTGGTAGAACAACGTGACGCTCATCGTCCAGGATGGCTGCCCGTTTCTGAATCAGTGACTAGGTCCACGTTTAAGTTTACCAGACTCACCGAAGGAAATGAGTATGTGTTCCGTGTGGCTGCAACAAACCGCTTCGGGATTGGCTCTTACTTGCAGTCTGAGGTCATAGAGTGTCGCAGCAGCATCC
>TTN-202,ENSE00003805894,1,303,928756,929058,GTATTCCTGGACCCCCAGAAACATTACAGATATTTGATGTTTCCCGTGATGGCATGACACTTACTTGGTACCCACCAGAGGATGACGGTGGCTCCCAAGTGACTGGATATATTGTGGAGCGCAAAGAAGTGAGAGCAGATCGATGGGTCCGTGTAAATAAAGTACCTGTGACAATGACACGGTACCGCTCCACTGGCCTTACTGAAGGCTTAGAATATGAACACCGTGTCACAGCCATTAATGCAAGAGGGTCTGGGAAACCAAGTCGTCCTTCCAAACCCATCGTTGCCATGGATCCAATTG
>TTN-202,ENSE00003808643,1,303,929059,929361,CTCCTCCAGGAAAGCCACAAAACCCAAGAGTTACTGATACAACAAGGACATCAGTCTCCCTGGCCTGGAGTGTTCCAGAAGATGAAGGAGGATCTAAAGTCACAGGCTACTTGATTGAAATGCAAAAAGTAGATCAACATGAATGGACCAAGTGTAACACCACTCCAACCAAGATTCGAGAGTATACTCTAACACACCTACCTCAGGGTGCAGAATACAGGTTCCGCGTCCTAGCTTGTAATGCTGGTGGACCTGGTGAGCCTGCTGAGGTACCAGGAACAGTCAAAGTCACTGAAATGCTTG
>TTN-202,ENSE00003805779,1,585,929362,929946,AATATCCTGATTATGAACTTGATGAAAGATACCAAGAAGGTATCTTTGTAAGGCAAGGTGGCGTCATCAGACTTACCATACCAATCAAAGGAAAACCATTCCCAATATGTAAATGGACCAAGGAAGGCCAGGATATTAGTAAGCGTGCCATGATTGCAACATCTGAAACACACACTGAGCTTGTGATCAAAGAAGCAGACAGGGGTGATTCTGGCACTTATGACCTGGTTCTGGAAAATAAATGTGGCAAGAAGGCTGTCTACATCAAGGTCAGGGTGATAGGAAGTCCCAACAGTCCAGAAGGGCCACTGGAATATGATGACATCCAAGTCCGCTCTGTGAGGGTCAGCTGGAGACCTCCTGCTGATGATGGTGGTGCTGACATCTTAGGCTACATCCTCGAGAGACGAGAAGTGCCTAAAGCCGCCTGGTATACCATTGATTCCAGAGTCCGAGGTACATCTCTGGTGGTAAAAGGCCTCAAAGAGAATGTAGAATACCATTTCCGTGTTTCAGCAGAAAACCAGTTTGGCATAAGCAAACCCTTGAAATCTGAGGAACCAGTCACACCAAAAACACCATTGA
>TTN-202,ENSE00003806836,1,306,929947,930252,ATCCTCCAGAACCTCCAAGCAATCCTCCAGAAGTACTCGATGTAACCAAGAGTTCTGTTAGCTTGTCCTGGTCCCGGCCCAAAGATGATGGTGGTTCTAGAGTCACAGGCTACTACATCGAACGCAAAGAGACATCCACTGACAAGTGGGTCAGACACAACAAGACTCAGATCACCACCACAATGTACACTGTCACAGGGCTTGTTCCCGATGCTGAGTATCAGTTCCGCATCATCGCACAGAATGATGTTGGCCTGAGTGAGACCAGCCCTGCTTCTGAACCAGTTGTTTGCAAAGATCCATTTG
>TTN-202,ENSE00003810204,1,300,930253,930552,ATAAACCAAGCCAACCAGGAGAACTTGAGATTCTTTCAATATCCAAAGATAGTGTCACTCTACAGTGGGAGAAACCTGAATGTGATGGTGGTAAAGAAATTCTTGGATACTGGGTTGAATATAGACAGTCTGGAGACAGTGCCTGGAAGAAGAGCAATAAGGAACGTATTAAGGACAAGCAATTCACAATAGGAGGTTTGCTGGAAGCTACTGAGTATGAATTCAGGGTTTTTGCTGAGAATGAGACTGGGCTGAGCAGACCTCGCAGAACTGCTATGTCTATAAAGACTAAACTCACAT
>TTN-202,ENSE00003805486,1,576,930553,931128,CTGGAGAGGCCCCAGGAATACGCAAAGAAATGAAGGATGTTACCACAAAATTGGGTGAAGCTGCTCAACTCTCATGCCAGATTGTTGGAAGGCCTCTTCCTGACATTAAATGGTACAGATTTGGTAAAGAGCTCATACAAAGCCGGAAATACAAAATGTCTTCAGATGGACGCACACACACTCTTACAGTAATGACAGAGGAACAGGAAGATGAAGGTGTTTATACCTGCATAGCCACCAATGAGGTTGGAGAAGTAGAAACCAGTAGTAAGCTTCTCCTGCAAGCAACACCGCAGTTCCATCCTGGTTACCCACTGAAAGAGAAATATTATGGAGCTGTGGGTTCCACACTTCGGCTTCATGTTATGTACATTGGTCGTCCAGTACCTGCCATGACTTGGTTCCATGGTCAGAAACTTTTGCAAAACTCAGAAAACATTACTATTGAAAACACTGAGCACTATACTCATCTTGTCATGAAGAATGTCCAACGTAAGACTCATGCTGGGAAATACAAAGTCCAGCTCAGCAATGTTTTTGGAACAGTTGATGCCATCCTTGATGTGGAAATACAAG
>TTN-202,ENSE00003801306,1,306,931129,931434,ATAAACCAGACAAACCTACAGGACCAATTGTGATCGAAGCTCTATTGAAGAACTCCGCAGTGATCAGCTGGAAACCACCCGCAGATGACGGAGGCTCCTGGATCACCAACTATGTGGTGGAAAAATGTGAGGCCAAGGAGGGGGCTGAATGGCAATTGGTGTCTTCAGCCATCTCAGTGACAACCTGTAGAATTGTGAACCTCACAGAAAATGCTGGCTATTACTTCCGGGTTTCAGCTCAGAACACTTTCGGCATCAGTGACCCTCTAGAAGTGTCCTCAGTTGTGATCATTAAGAGTCCATTTG
>TTN-202,ENSE00003808123,1,594,931435,932028,AAAAGCCAGGTGCTCCTGGCAAACCAACTATTACTGCTGTCACAAAAGATTCTTGTGTTGTGGCCTGGAAGCCACCTGCCAGTGATGGAGGTGCAAAGATTAGAAATTACTACCTTGAGAAGCGTGAGAAGAAGCAGAATAAATGGATTTCTGTGACAACAGAAGAAATTCGAGAAACTGTCTTTTCAGTGAAAAACCTTATTGAAGGTCTTGAATACGAGTTTCGTGTGAAATGTGAAAATCTAGGTGGGGAAAGTGAATGGAGTGAAATATCAGAACCCATCACTCCCAAATCTGATGTCCCAATTCAGGCACCACACTTTAAAGAGGAACTGAGAAATCTAAATGTCAGATATCAGAGCAATGCTACCTTGGTCTGCAAAGTGACTGGTCATCCAAAACCTATCGTCAAATGGTACAGACAAGGCAAAGAAATCATTGCAGATGGATTAAAATATAGGATTCAAGAATTTAAGGGTGGCTACCACCAGCTCATCATTGCAAGTGTCACAGATGATGATGCCACAGTTTACCAAGTCAGAGCTACCAACCAAGGGGGATCTGTGTCTGGCACTGCCTCCTTGGAAGTGGAAG
>TTN-202,ENSE00003808212,1,5609,932029,937637,TTCCAGCTAAGATACACTTACCTAAAACTCTTGAAGGCATGGGAGCAGTTCATGCTCTCCGAGGTGAAGTGGTCAGCATCAAGATTCCTTTCAGTGGCAAACCAGATCCTGTGATCACCTGGCAGAAAGGACAAGATCTCATTGACAATAATGGCCACTACCAAGTTATTGTCACAAGATCCTTCACATCACTTGTTTTCCCCAATGGGGTAGAGAGAAAAGATGCTGGTTTCTATGTGGTCTGTGCTAAAAACAGATTTGGAATTGATCAGAAGACAGTTGAACTGGATGTGGCTGATGTTCCTGACCCACCCAGAGGAGTCAAAGTTAGTGATGTCTCACGAGATTCTGTCAACTTAACATGGACTGAGCCAGCCTCTGATGGTGGCAGCAAAATCACCAACTACATTGTTGAAAAATGTGCAACTACTGCAGAAAGATGGCTCCGTGTAGGACAGGCCCGAGAAACACGTTATACCGTGATCAACTTATTTGGAAAAACAAGTTACCAGTTCCGGGTAATAGCTGAAAATAAATTTGGTCTGAGCAAGCCTTCAGAGCCTTCAGAACCAACCATAACCAAAGAAGATAAGACCAGAGCTATGAACTATGATGAAGAGGTAGATGAAACCAGGGAAGTCTCCATGACTAAAGCATCTCACTCTTCAACCAAGGAACTCTATGAGAAATATATGATTGCTGAAGATCTTGGGCGTGGTGAGTTTGGAATTGTCCATCGTTGTGTTGAAACATCCTCAAAGAAGACATACATGGCCAAATTTGTTAAAGTCAAAGGGACTGATCAGGTTTTGGTAAAGAAGGAAATTTCCATTCTGAATATTGCTAGGCATAGAAACATCTTACACCTCCATGAATCATTTGAAAGCATGGAAGAATTAGTTATGATCTTTGAGTTTATATCAGGACTTGACATATTTGAGCGCATTAACACAAGTGCTTTTGAACTTAATGAAAGAGAAATTGTAAGTTATGTTCACCAGGTCTGTGAAGCACTTCAGTTTTTACACAGTCATAATATTGGACACTTTGACATTAGACCAGAAAATATCATTTACCAAACCAGAAGAAGCTCTACCATTAAAATCATAGAATTTGGTCAAGCCCGTCAGCTGAAACCAGGGGACAACTTCAGGCTTCTATTCACTGCCCCAGAATACTATGCACCTGAAGTCCACCAGCATGATGTTGTCAGCACAGCCACAGACATGTGGTCACTTGGAACACTGGTATATGTGCTATTGAGTGGTATCAACCCATTCCTGGCTGAAACTAACCAACAGATCATTGAGAATATCATGAATGCTGAATATACTTTCGATGAGGAAGCATTCAAAGAGATTAGCATTGAAGCCATGGATTTTGTTGACCGGTTGTTAGTGAAAGAGAGGAAATCTCGCATGACAGCATCGGAGGCTCTCCAGCACCCATGGTTGAAGCAGAAGATAGAAAGAGTCAGTACTAAAGTTATCAGAACATTAAAACACCGGCGTTATTACCACACCCTGATCAAGAAAGACCTCAACATGGTTGTGTCAGCAGCCCGGATCTCCTGTGGTGGTGCAATTCGATCTCAGAAGGGAGTGAGTGTTGCTAAAGTTAAAGTGGCATCCATTGAAATTGGCCCAGTTTCTGGGCAGATAATGCATGCAGTTGGTGAAGAAGGAGGACATGTCAAATATGTATGCAAAATTGAAAATTATGATCAGTCTACCCAAGTGACTTGGTACTTTGGCGTCCGACAGCTGGAGAACAGTGAGAAATACGAAATCACCTACGAAGATGGAGTGGCCATCCTCTATGTCAAAGACATTACCAAATTAGATGATGGTACCTACAGATGCAAAGTAGTCAATGACTATGGTGAAGACAGTTCTTATGCAGAGCTATTTGTTAAAGGTGTGAGAGAAGTCTATGACTATTACTGCCGTAGAACCATGAAGAAAATTAAGCGCAGAACAGACACAATGAGACTCCTGGAAAGGCCACCAGAATTTACCCTGCCTCTCTATAATAAGACAGCTTATGTAGGTGAAAATGTCCGGTTTGGAGTAACTATAACTGTCCACCCAGAGCCTCATGTAACATGGTATAAATCAGGTCAGAAAATCAAACCAGGTGACAATGACAAGAAGTACACATTTGAGTCAGACAAGGGTCTTTACCAATTAACAATCAACAGTGTCACTACAGATGATGACGCTGAATATACTGTTGTGGCAAGGAACAAATATGGTGAAGACAGCTGTAAAGCAAAGCTGACAGTAACCCTACACCCACCTCCAACAGATAGTACCTTAAGACCCATGTTCAAAAGGTTACTGGCAAATGCAGAATGCCAAGAAGGCCAAAGTGTCTGCTTTGAGATCAGAGTGTCTGGCATCCCCCCACCAACATTAAAATGGGAGAAAGATGGTCAGCCACTGTCCCTCGGGCCTAACATTGAAATTATCCATGAAGGCTTGGATTATTATGCTCTGCACATCAGGGACACTTTGCCTGAAGACACGGGTTATTATAGAGTCACAGCCACTAACACAGCTGGGTCCACCAGCTGCCAGGCTCACCTACAAGTGGAACGCCTGAGGTACAAGAAACAGGAATTCAAGAGTAAGGAGGAGCATGAGCGACACGTACAAAAACAAATTGACAAAACCCTCAGAATGGCTGAAATTCTTTCTGGAACTGAAAGTGTACCACTGACACAGGTAGCTAAAGAGGCTCTGAGAGAAGCTGCTGTCCTTTATAAACCGGCTGTAAGCACCAAGACTGTAAAAGGGGAATTCAGACTTGAGATAGAAGAAAAGAAGGAGGAGAGAAAACTCCGGATGCCTTATGATGTACCAGAGCCACGCAAGTATAAGCAGACTACCATAGAAGAAGACCAACGCATCAAGCAGTTCGTGCCCATGTCTGACATGAAGTGGTATAAAAAGATACGTGATCAGTATGAAATGCCTGGGAAACTTGACAGAGTTGTACAGAAACGACCCAAGCGCATCCGCCTTTCAAGATGGGAACAGTTCTATGTGATGCCTCTTCCACGCATTACAGATCAATACAGACCTAAATGGCGTATTCCTAAACTGTCCCAAGATGATCTTGAGATAGTGAGACCAGCCCGCCGGCGTACACCTTCTCCTGATTATGACTTTTACTACCGACCTAGAAGACGTTCTCTTGGGGACATCTCTGATGAAGAATTACTCCTCCCCATTGATGACTACTTAGCAATGAAAAGAACAGAGGAAGAGAGGCTGCGTCTTGAAGAAGAGCTTGAGTTAGGTTTTTCAGCTTCACCCCCAAGTCGAAGCCCTCCACACTTTGAGCTTTCTAGCCTACGTTACTCTTCACCACAAGCTCATGTCAAGGTGGAGGAAACAAGAAAAGACTTCAGGTATTCAACCTATCACATCCCAACGAAGGCTGAAGCTAGTACAAGTTATGCAGAACTGAGGGAACGGCATGCCCAGGCTGCGTACAGACAGCCAAAGCAACGGCAAAGAATCATGGCTGAGAGGGAGGATGAAGAGTTGCTTCGCCCAGTTACGACCACCCAGCATCTCTCAGAATACAAAAGCGAACTTGACTTCATGTCAAAGGAGGAAAAGTCTAGAAAGAAATCAAGGCGACAAAGAGAAGTGACAGAAATAACAGAAATTGAGGAAGAATACGAAATCTCAAAACATGCTCAAAGAGAATCATCCTCATCTGCGTCTAGACTACTGAGACGACGGCGCTCCCTGTCTCCAACTTATATTGAGTTAATGAGGCCAGTGTCTGAGCTGATCCGGTCACGTCCACAACCGGCTGAGGAATACGAAGATGACACAGAAAGAAGGTCACCTACTCCAGAGAGAACTCGCCCACGATCCCCCAGCCCTGTGTCTAGTGAGAGATCACTCTCGAGATTTGAGAGGTCTGCAAGATTTGATATCTTTTCCAGGTATGAGTCCATGAAAGCTGCTTTAAAAACTCAGAAGACATCAGAAAGGAAGTATGAAGTTTTGAGTCAGCAGCCTTTCACACTGGACCATGCCCCTCGAATCACACTGAGAATGCGCTCGCACAGGGTACCATGTGGCCAAAATACACGTTTTATTTTAAATGTTCAGTCTAAGCCAACTGCCGAGGTTAAATGGTACCACAATGGTGTGGAACTCCAAGAAAGCAGTAAGATTCATTACACCAACACGAGTGGAGTCCTCACCCTGGAAATTCTGGACTGTCATACTGATGACAGTGGAACCTACCGTGCTGTGTGCACCAACTACAAGGGCGAAGCTTCTGACTATGCAACGTTGGACGTGACAGGAGGGGATTATACCACCTATGCTTCCCAACGCAGAGATGAAGAGGTCCCCAGATCTGTTTTCCCTGAGCTGACAAGAACAGAGGCGTATGCTGTTTCATCATTTAAGAAAACATCTGAGATGGAAGCTTCGTCTTCTGTCAGGGAAGTGAAATCACAGATGACGGAGACAAGGGAAAGTCTCTCCTCATATGAACACTCTGCATCTGCAGAAATGAAAAGTGCTGCATTAGAAGAAAAGTCACTGGAAGAAAAATCCACAACCAGAAAGATCAAGACGACTTTGGCAGCAAGAATTCTAACAAAGCCACGGTCCATGACCGTCTACGAGGGCGAGTCTGCAAGGTTTTCTTGTGACACCGATGGTGAGCCGGTACCAACTGTGACCTGGCTGCGTAAAGGACAAGTGCTAAGTACTTCTGCCCGCCACCAAGTGACCACCACAAAGTACAAATCAACCTTTGAGATCTCTTCAGTCCAGGCTTCCGATGAGGGCAATTACAGCGTGGTGGTAGAAAACAGTGAAGGGAAACAAGAAGCAGAGTTCACTCTGACTATTCAAAAGGCCAGGGTAACTGAAAAGGCTGTGACATCACCACCAAGAGTCAAATCCCCAGAGCCTCGGGTGAAATCCCCAGAAGCAGTTAAGTCTCCAAAACGAGTGAAATCTCCAGAACCTTCTCACCCGAAAGCCGTATCACCCACAGAGACAAAACCAACACCAACAGAGAAAGTTCAGCACCTCCCAGTCTCTGCCCCACCAAAGATTACTCAGTTCCTGAAAGCAGAAGCTTCTAAAGAGATTGCAAAACTGACCTGTGTGGTTGAAAGCAGTGTATTAAGGGCAAAAGAGGTCACCTGGTATAAAGATGGCAAGAAACTGAAGGAAAATGGGCATTTCCAGTTTCATTATTCAGCAGATGGTACCTATGAGCTCAAAATCAATAACCTCACTGAATCTGATCAAGGAGAATATGTTTGTGAGATTTCTGGTGAAGGTGGAACGTCTAAAACCAACTTACAATTTATGGGGCAAGCCTTTAAGAGTATCCATGAGAAGGTATCAAAAATATCAGAAACTAAGAAATCAGATCAGAAAACCACTGAGTCAACAGTAACCAGAAAAACTGAACCAAAAGCTCCTGAACCAATTTCCTCAAAACCAGTAATTGTTACTGGGTTGCAGGATACAACTGTTTCTTCAGACAGTGTTGCTAAATTTGCAGTTAAGGCTACTGGAGAACCCCGGCCAACTGCCATCTGGACAAAAGATGGAAAG
>TTN-202,ENSE00003811220,1,157,937638,937794,GCCATTACACAAGGAGGTAAATATAAACTCTCTGAAGACAAGGGAGGGTTCTTCTTAGAAATTCATAAGACTGATACTTCTGACAGTGGACTTTATACTTGTACAGTAAAAAATTCAGCTGGATCTGTGTCCTCTAGCTGCAAATTAACAATAAAAG
>TTN-202,ENSE00003801641,1,692,937795,938486,CTATAAAAGATACTGAGGCACAGAAAGTCTCTACACAAAAGACTTCTGAAATTACACCTCAGAAGAAAGCTGTTGTCCAAGAGGAAATTTCCCAAAAAGCCCTAAGGTCTGAAGAAATTAAGATGTCAGAGGCAAAATCTCAAGAAAAGTTAGCCCTCAAAGAGGAAGCTTCAAAGGTTCTGATTTCTGAAGAAGTCAAGAAATCAGCAGCAACCTCCCTGGAAAAATCCATTGTCCATGAGGAAATCACTAAAACATCACAGGCATCAGAAGAAGTCAGAACTCATGCTGAGATTAAAGCATTTTCTACTCAGATGAGCATAAACGAAGGTCAAAGACTGGTTTTAAAAGCCAACATTGCTGGTGCCACTGATGTGAAATGGGTACTGAATGGCGTAGAGCTTACCAACTCTGAGGAGTACCGATATGGTGTCTCAGGCAGCGATCAGACCCTAACCATCAAGCAAGCCAGTCACAGAGATGAAGGAATCCTCACCTGCATAAGCAAAACCAAGGAAGGAATCGTCAAGTGTCAGTATGATTTGACACTGAGCAAAGAACTCTCAGATGCTCCAGCCTTCATCTCACAGCCTAGATCTCAAAATATTAATGAAGGACAAAATGTTCTCTTTACTTGTGAAATCAGTGGCGAGCCATCCCCTGAAATCGAATGGTTTAAAAACAACCTGCCA
>TTN-202,ENSE00003801638,1,154,938487,938640,ATTTCTATTTCTTCAAATGTCAGCATAAGCCGCTCCAGAAATGTATACTCCCTTGAAATCCGAAATGCATCAGTCAGCGACAGTGGAAAGTACACAATTAAGGCCAAAAATTTCCGTGGCCAGTGTTCAGCTACAGCTTCCTTAATGGTCCTTC
>TTN-202,ENSE00003805382,1,303,938641,938943,CTCTAGTTGAAGAACCTTCCAGAGAGGTAGTATTGAGAACAAGTGGTGACACAAGCTTGCAAGGAAGCTTCTCGTCTCAGTCAGTCCAAATGTCTGCCTCCAAGCAGGAGGCCTCCTTCAGCAGTTTCAGCAGCAGCAGTGCTAGCAGCATGACTGAGATGAAATTTGCAAGCATGTCTGCCCAAAGCATGTCCTCCATGCAAGAGTCCTTTGTAGAAATGAGTTCCAGCAGCTTTATGGGAATATCTAATATGACACAACTGGAAAGCTCAACTAGTAAAATGCTTAAAGCAGGCATAAGAG
>TTN-202,ENSE00003809884,1,1319,938944,940262,GAATTCCGCCTAAAATTGAAGCTCTTCCATCTGATATCAGCATTGATGAAGGCAAAGTTCTAACAGTAGCCTGTGCTTTCACGGGTGAGCCTACCCCAGAAGTAACATGGTCCTGTGGTGGAAGAAAAATCCACAGTCAAGAACAGGGGAGGTTCCACATTGAAAACACAGATGACCTGACAACCCTGATCATCATGGACGTACAGAAACAAGATGGTGGACTTTATACCCTGAGTTTAGGGAATGAATTTGGATCTGACTCTGCCACTGTGAATATACATATTCGATCCATTTAAGAGGGCCTGTGCCCTTATACTCTACACTCATTCTTAACTTTTCGCAAACGTTTCACACGGACTAATCTTTCTGAACTGTAAATATTTAAAGAAAAAAAAGTAGTTTTGTATCAACCTAAATGAGTCAAAGTTCAAAAATATTCATTTCAATCTTTTCATAATTGTTGACCTAAGAATATAATACATTTGCTAGTGACATGTACATACTGTATATAGCCGGATTAACGGTTATAAAGTTTTGTACCATTTATTTTATGACATTTTACAATGTAAGTTTTGAAACTAACTGTTGGTAGGAGAAAGTTTCTTATGGAACGAATACCCTGCTCAACATTTAATCAATCTTTGTGCCTCAACATACTGTTGATGTCTAAGTATGCCTCAGTGGGTTGAGAAAATCCCCATTGAAGATGTCCTGTCCACCTAAAAGAGAATGATGCTGTGCATATCACTTGATATGTGCACCAATACCTACTGAATCAGAAATGTAAGGCATTGGTGATGTTTGCATTTACCCTCCTGTAAGCAACACTTTAACGTCTTACATTTTCTCTGATGATGTCACACAAAATTATCATGACAAATATTACCAGAGCAAAGTGTAACGGCCAACACTTTGTTCGCTCATTTTACGCTGTCTCTGACATAAGGAGTGCCTGAATAGCTTGGAAAAGTAACATCTCCTGGCCATCCCTTCATTTAACCAAGCTATTCAAGTATTCCTATGCCAGAGCAGTGCCAACTCTTGGAGGTCCCAGAGTGCAGCCAATGCCTTTGTGTGGTAGTTCTAAATTTTAATTGCACCTGAAAAACCTGGGCACCTAAGCAATGAGCCACAGCAAAAAGTAAAGAACAACAACAAAATAAAGCTGTTGTTAAATTTTAAACAATATTACTAATTGCCCAAAATGTCAATTTGATGTAGTTCTTTTCATGCAAGTATAAATTCAATTGTTAGTTATAATTGTTGGACCTCCTTGAGATAGTAACAACAAAATAAAGCAAGCTATCTGCACCTCAAAA
>TTN-202,,0,2556,940263,942818,GTGAGCAGCAACTTTTCTTATTTTAATAGTAGAGTCACTTTCTTATTGATCTCTGGCTCTGGATTATTTGTGTGTGCTAAATGCCTATGTACAAGTGTTTGTATGACTATTTCTTGCCAGTGCTGACCCATTATTTAAATCTGCTTGTTAAATTCTATTTTAAAATGTCTGAACATTTTTCCTTAAAAAGTTGAAAGCTTTATTATATCAGCTAAATGATTCCATGATTCAAATTGTTTAAGTTCACTTAATATTCTAAAAGTTGAGGTCTGAAATGTTGAGAGAAATGTTTACTTCTTTTCTAGACTCTCTTTGCCTGTTGAGAATGTTCAAGGTTATATTACTCAATGATAAAGTTAAGCACACCAAGAATAGCTCTGATAAAATGCATGTGGTATCAGCTACACCCTGATGACTTTTTAAGGGAATCAACTGCTGAGGTATCAGTTGCAGGACAGTGACAGAACACTTGCCTGCTGTCAGTCAACCTTGGAGAGTTTAGGAGAGTTTATTTTAAGAGCATGACATTTTAGACGCATACCTTCAGCCCCAGTTAGACAAAGGCCTGTGAAGAGCAAGTGCTAAGGCAATAAAATTTACCTAGACAATAGGAATGTAAGATCAATTTAAGCTGGTTAATTGCAACATAGTTGGAGATTTGGAATAAAATGATATAATTGTTTTCTAAAATATTCAGAATCTCTTCATGCATTTTAACTCAGCACACAGTCCAATTATATATTTTGAGATAAATGTTGACACTAAGAAGGGTAAGAAATAATGTTTAAAGGAAAGGTTTCTTACTTCTAAATACACTTTGATTTCTCATCTTCCTAGAATTTGATTACTAATTGTCAATGCCTGTAAATACATAGATATATAATTAGGTATTCTATGTCTAAGAGGACAGCTATTTTTAGATATACTAACTTATAAACAGACAAAGTTAGACACAGAAAGTTGTTCATCCCAAAGATAATATGCTACAAAAAGGAGTTTCTGACAAAAAAAATTTATGAAAGCTTTTGGATATTATCTGATTTTTCCAAATATAAATTTTATTGTCTCAGAGAATGCTGGTTTCATTTTTTTAACTAAGTAGAAGGTTACAGTAAGGAACAGAATTATCACTAAGAAGATTATTGCTCCATGAAGTTTTAGTAAACAAAGAATTTAATGAAAAATAGTAATGAAGTGATTGACAATTCAGAAATGTTCTATTTCAGAACAGAATAGTCATGTTGAATAATTAGGTATTTATGCATCAGAAAATTCTTCACATAATGTCTCTGAAACTGATAGGCAAAGTACTTTCTTGCACTTAACAAAATGACTTAACTGCAAATTTTATATTCGTTTCTTTGATGTTGAATATTTTACTTTATGAAAGCATAGGCCTTTTCACTTCATCTACATTTTACACCAGCCTTCCATTATTCAAAGTTTGCAAATTGTTCCATATTAAGAACTCAAGCCAGCATTTTTCTTTCAGAACTATAATAAACTTTGGCCTGTTCACTAAAATTTAAATTTTTCTGAATATTTACTTCAGCAGTAACAACATTTACTGCACAGTTACAGTATGAAGAAATGTTAAGAAATAGAAAGCACCGTATGCCGTCTACAAAAAGCTTGCATATTTGATAAGGCTTGCCAAAGCTTCTCCAGTCAGGAAAGAGATTACAAAGTTCAGATTTTTACTTCTGGCAACTATTTTAAGTAATCAGATAATGTCTGAATCAATGTCAACTTTATAAATATAGAGTGAACGAAAAATATTGGGGAGAAGGAAAATTTTTAAAATAATTTTCACTTACTAAGCTGATGCAGAGGTTTATTTATTTTAATTTTTTTTTTTTTTTTTTTTTGAGACAGAGTCTCATTCTGTCACCCAGGCTGGAGTGTGGTGGCACCATCTTTGCTCACTGCAACCTCCACCTCCTGGGTTTAAGCAATTCTCATGCCTCAGCCTCCCAAGTAGCTGGGACTACAGACATGGGCCACCACGCCTGGCTAATTTTTGTATTTGTAGTAGAGACAGGGGTTTCACCATGTTAGCCAAACTGGTCTCAAACTCCTGACCTCAAGTAATCCTCCCGCCTCGGCCTCCTAAAGTGCTGGGATTACCAGCATGAGCCACCACGCCAGGCCCAGAGGTTTATTTTACATTTATCACATGTCTTGTCTCTCTAATTACACTTCACTAACCCTGCATTGCTGTGGTTTTCTTCTTCAACTCTGAACCTGGTTTTCCACCATTGGTAAGACTGTATATTCCCTCTTTGACCACTAGGGTTCATTCCTTGTTCTGTTTGGCTAATACTTTTTTCCATTTCCCCTTACACTTGCTACTTTGGGTTAGGCTTTAAGTCAACTCAATGATGAACTATGCAAAACTGTTCAAGCCACAAAAGAGAAGACCTGCCCATCACTCTAGGCCCACAGATGACCTATGGAGCAATCCATTTGGAGAAACGTGTGTCTCTGCTATCTGCAAAGCAGCTCCAGAGTGACCCTTAGCTGGGACACCCTAATTTATTTTCTCTTCTTTTTCAG
>TTN-202,,0,2210,942819,945028,GTAAGCTCACACATTCACACTTTTGTTTTTTTTTCCTTTGCCTCCTCTCCAGTAAGTTAACGTTGCTGCAGGACTTGACGCCAAGTTTAAGCCCTGCTTTCACTTCGGAAAATTAGTCCAACACTATGGAAAGGTCATTTTAAGGGTATACCATTCACAGAGTACTGACAAAATCTGACAATATAATGGCTTGAAATGTTTTATTCATATTTATTATTCCACAAAGCAAAAATAATTAGTGTTGGATTAAAATTGCCGTTAGAATCCAGCAACTAAATAGGACCAAATTTAGTCATTCTATATTTGGGCTCAGCTGCAGAGCCAGACTGGAAGCCAAGAACTCAAGCCCAATAGAAGCCAGCCACAGAGCCATGGGGTAGGCAGTCTGGGCTGCCTGCTCTGGACACCTGAACTTCAGTTGGTTCACACGCAAAATAACAGTGCATCTAATTTTCCTCAGAGGCAGAGCTGTTCAGTAATTAACCAACTCCTCATTATTTTATTATTTTATTTTCAATCTTTATTGAGTGATTCTAATGAATTAAAAGACTTTCCAATCGTTTTGAAATGACAGAAAATAATATGCTTCTCGGGTGTCTCTATTTAAAAGGAAGCAAACACTAACCCTAGAATTTTATCTGAAAGGAAGTTCATCTCTTTTTTGCCTTCTTTTTCTTCCTCATAACTCAGTTTATGGATGGTTCAAAAAAATGCATGGTATCATCTTATGAAAAAATGGAGAGTAGTGTATGAACTATATTGTAAATAATTTTAAAATTAATCAATATTTTCTCTTTCTGTAGTATTGTAACGAGCCATGTAAGATGGATACGGATTAAAAAAAATCATGCTTAATTCTTAATTTAGTGCACTTCCATGGTTCATTGCCCACTTCTTTTTTAAAATTTTATGGCTTATAATAAAGATATAAAATAAAATTTCTTTTTTTCTCTTTTTTTCTATTATATGCACCAATCTTATTCATAACTGGATAATACTTTCTTTTACATTGTACAAATATCATATAATCATTGCTTATTTTCTATTGTACATATATAGACCAATGAAATTCCCTTTTCATTGGTCTATATATGTACAATAGAAAATAAGTCTTACCGACTTCCAAATAATTTACCTATTTATCTGGTAACACTCAGTAACTTCTGAACTGAGCAGAACACATATGACTTCAGTGGGAATTTGCCTCCTTGAGAAGTAGTGGAATCTGGCTACTTCATATCTTCTTGTTCCTTCAAACTATATGCAAATAAATTATTACAAAGACACTACTGAAAATATCCAATACCCATAAATCAGTCCAATAAACTATTTAATTGGCCATAGTGGGAGATGGGCTAATGTATAAACAACAAAATAGACTTTCTCTAGATTATCTTTACCTACCAGCGTAAGTAGATAGAGCATCAACCTTTATGCCAAGTGTGAAATAAATCATGCCCTGAATGTGCCTCGTACATTCTCAATGTACAGAGTTTTAATATATTTAAAACATCAAACCATGGACATGTAGTTCTTGGCTCTACAATTTATGGCAGATAAAGAGAATTTGGCTTTCTACCTGCAATTCCAATGATCCATGTTGTTCTGGAAGACTAGGTTTGGATTAGTCTCTTATGAGAAATTGCTTGTCCATGTTACAATGTTTTTACTGATTGCACTTGTGAAAGCAGAAGAGTCCAAGAAGACAGTGTCCCTGTAACCACAGAGGAGGGAGGAGGGCATGCCTCCTGGGCTTGTCAGGCAGAAACTGGAGATCAGTTTGCTGCTTTTGTTCTTCACTTGCTCTCAAAGAGGACAACAATCACTCTTTATTTCAAATTTTCCTTGGTTCTTCATTTTTATAAGTCCCTTTCATGATTTTAATGTTGTCTATTAAATTGCATCAGATAGAGCCCTAGGCAGGCAGGCAGGAGATGGAAATTCTAGTCCCCTCTGTGTCACTGCTAGCTGAAGGACCTTGGAAAAATCATTAGGCCTCTTTTGGTCTCAGTTTCCTCCCTTCCTGCCTTCCTAATGGTCTGCAGGTTTACACACTGATCATGCAACTGTAGGGTTTTCCCTATCATTAAGTGGCATTCCATGCTGGAAAGCTTTTACAGATTCGGACAAGGCAGTGAACATGATGGGACAGAGCAGAGGACTTTGTGGTGCCCATTCAAACATAAAGGTGAATTGTTCTTGCTCTTCAG
>TTN-202,,0,1455,945029,946483,GTAGGCTGCTGGGGACCTGCCAATCCTCTGCTCCCCCAGAGGACATCTCCAGCAAATTGGGAAAGGAGTCCAGAAAAAGCTATGGGCAGAGGTAGATGCAGCTCTTAAACTACAGAAGGGTCTACTGGAGGCTGAATTATTTATAACCAAGTTGTTTGCCTTTTGGAATTTAATTTTCCTCTAGAGTACATCGTAAAAGTGACTGAGAATCAGTTTCTCAATACACATATTAAACACTCAAAAGTATGTTAAGGAAATATTAAAAATCATGTTTCTCAGCAAGTAGAAAAGCTTGGAGCCTTGTTTATAAGTCCTTTAAGGAATAAGACATATTCTCCAGGGAAGTGTGAATCTCCAGGAATTCACACTTTAACAAGCATCCAGATAATTCTGATGCCGGTAGTCTACAGACCACCCATTTAAGAGGCATGTAAACATACCCAGAAGAAAATAAATGCTTGTTTATTATTCAAATGCATGACACTGTTTCCCCAGAAAACTTATCACCAATCTTAGTGGCCTCTGTTGTTTTTCTCTATCCTTTACTACCTAGTGAGACATTAGTATACAGAATATTGCATGCCTTTACATGTTTTATAACAATATCTTACATGAGCTACGTAAAGTTACATATGCTTATCCAATAAACTTTACCTTCAATGATGTTCAATTATAGGGCTATAATTGACCTAAGCAGAAACCACATCAAGTAACATCAGGTAGAACTTTAGCATGCACCCAGAAAATTCACAAATGGAAAATGCACAGGGTTGGCAGCACCTGCTGTTGTTTATTACTCAAAATCATGTCAAAGTTAATTCCACTCACTCCTCACACTTATAAAAAATTTCCTTCAACATAACCAAAAAAATCCCCTTTCTGTAACACAATTAAAATGAAGTAATGTTATTATTGGGATTAACGTTTTAAATGCAAGTAAATATTTGGGTTATTTGAATACCTATCAAGTTGGAGAAGGTTTAGAATTTTAAAAATTAAATTAAAAATGTAATGATTCTTTAAGTAACAGGTACACCCATCGTAGCAACCACTGGAATTCATTTTAATGCAACTTACTGGAATATGCAACATGGCTTTCACATATTAATAGAGCGCTAGATGTGAGGTAGAGGGGGAAGTACCAGAAAGATTCTCAAGAAATGTTATAACAAAATCTAGAGCTTTTATTTAAAACAAAGAAACAAAAGGTGGTGGCCTAAACTGCTCAGCAAAACAAAGCAAATAAAATAAAATATGGTGGTGAGAAAGCCTTCTGTAATCTCCTGGCTCCCATTCTTGCTGTCATTGCTGGGTGAGCTGGGTTCAAGGACATTCAAGGATGTTTAGATTGGCGAGTCATCACCTGGTTTTGGAATTGGAGCTGTGATTATTTAAAAATACCTTGTAGGGAGCACCCTGGCTCTCACTCTTGACTTTGTTCTCTTGTCCCCGCAG
>TTN-202,,0,484,946484,946967,GTACGTGCTGGAGGTTGAGGAACAGAGAGAAGGGGAGAGAGCTGGTTTGTGTCTAAATGGGGCCAAGCGTCCACTTGCCACCTCTCACAGCCCTGGGAAGAATGCTGTGAGCTGATATAAAAGCTGGCTTTTCGACACCCATGAAAAGTCCCTGAGATTCTAGTCAGGAGCGCAGAATAGAAGCAATCTGTGCTTATGAATCTCATTATAAACTGGAAAGGGTTTCAATTAAGTGATCTACATTTCCAAATTATTGGCAAATAATGAAATTTTAAAAAATCATTCTAAGTAAATTTTTATCTTGTAATGAACATTTTCTATTTTTAAACCTAATTTATATTCATGCAAAATCCAAAACTTTCTGCAATTTTCTCCATTGGGATATCCAGAAAATCTTTTTGACTTTGTAGTCAGAATTAACAGAATCTCTTTTAAAATGGGTCATTGTGCCCCCTCCCAAACATTCATCTTTCCCTTCCCACAG
>TTN-202,,0,93,946968,947060,GTATTTTTCTATACTGTTGGTTTTCAAGCCTTTCAGGCTGTTGCGTCCCCAGCTATTCCTCCTCAACGTGGGCTTTGTTTTAATCTTTTACAG
>TTN-202,,0,4234,947061,951294,GTAAAGCTGCCATAGAGAGAGCAGATTATTGCACATTTTGGAACTAGGTTTTGAAACGAGAAAGATTCCCTTGTCCCCCTCGCAGGGCATGCGACGCGGAGAGTGGTTCGCTTCTTCAGTGTCCCGCTGCTCAAACCTCTAGGGGAGCATACAAACGGGCAGGTTGTGGGGCTCCGTGTTCCTCTGGACATCCAGCCGCTTGTGTGTCTGCCTACTAGGGTCTCAGGGGTTTTTATAGGCATAGGGTGTGGGCGTGGCAGGTCAGGGTGATCTTGGGAAATGCAACATTTGGGCGGGAAGGCAGGAGTGTTTGTCCTCACCTAGGTCCATGGGCACAGGCCTCGCTAGGGACCACGCACTTCTCTTCCCAGCACTTCCCTGCCCTCCTCCCGTGTAAGTTTCATGCACTCAAAAATGTAGCAGGTGACAAAGGAGGTAAACCAAGAAGTTACTGAATATGATTTTCACAAATCCTCACTGTCCACAGGTAAATTGAAGACCCTTATAAACTTCTGAATTCTTATTTATATTTCATGTAATAAATATCTACTTTAGGGGCCAAAATATGGCACAGTGAAAGGAGAAGAGCACAGAAGTTAGAGTTCAAAGCCCTAAGGACAAATCAGCCTGATCACTTAACAGTTTGATTTAGGGCAATAAGTATAAATAATAAAATAATTGTTATTATATATGGATCACTTCCTCTATCAGATTGGAACTATACATACATTATCTCATTAAATGTTCACAACCTGTAAGAATTATTATCCTCAATGTTATTGATAGGTAACTGGAATTAAAGAAGTTAAGCAGTTTATTTAAGGTTTCAGTTGTGTCATCTGTAAATTAAAGAGAGTCACAATAAGAATGATCTCAAGCTGCATTTTGGGGCTTCAATGAGATAATTAGTTGAAAGTGCCTTGTAAATAGAAAATAATTATGCCAATATTCTTATATTCAGATGGTAAGTAAAACCTTTTAAATATTTTGCATATGCTTGTGTTATTTTATCTAGAAAATAAAATGGACTTCTATGCTTACTTAATATGGAAGTATTTTAGAAGGTGATCATGTATCATGATCAGGGCTCAGAAATTATATAATCAAGTGTAAATTGTCCACAACAGTTTTGAAAGTTTGGGATTTAGTTTATCATGATGAAACTTTTAATATGATGAAATGAAAAATGTACAAAATTTGAGCAAAGAAGTGTTTATTGATCAATTTAAATGAAATAAAAAACACATGGATGTTCCCTGCCAAGAAAATTTTTTATAAAAGAATAATAAGGAGATAGTTGACCTAAATAATATTCAAACATACTGTAAAGTTACTATAATCAGAACAGTATGGTATTGGTAAATGAATAGAAAAATACACCAGGGGAACAAAACAGAGAGTCCAGAAAGAGATCCAAGTATAATAGATCCAAGTATATAGGGAATTCAAAAAGCAAAGTGGCCTTTCAATTCAGGGGAGGGAGAGGTATTTTAATAAAGAATGCTGGTCCAATTAGCTATCCATCTGGAAGCAAACAAACATAAACCTCTGCCTCTCACTATTTACAGAATAAATTTCAGCTTGATTAAATAGTTAAAAAATGAAAAAAAAAGAGAAGACAATCTGCAAAAGCATTTATGGGTGAAAGCTTTTAAAAAGACAGTTACAGATTCAACTACATAAAAATCAACATGTATGTATGGCAAAAGCAAAAAGTCATTTCTAAACCAAACAGCACTTGTGAAAAAATTTTAAGACCTTTCTCCTCCTCAAGGTACTTCATTGCCTCTGCCATAAAAGTATCACAATAAACATAAAATGGCTACAAGGTAGACAACACCAGCCTAGAAACAGTATATAACATACAAAATTACGTAAGCTTATGCTGGATAAGACCCATAAACAAGCAAAATATTGAAATGGATTAAAAGAAATGGATCTGGGGGAATGTTTGCAACACTTACGACAAATAACCAATAAATGCACTAAATGCATTAAAAATCATCCACAAATTAATTTTTAAAGGAAAAAAATGCAACACAAAAAAAGACAAAAGATACAAAAAAGTATTTAACATAAGAGGCAATGTAAAAGTCCAATAAACATGTGAAAAAAAATGCTAGATGTTTTCCAATTTTTATTGTTTTAGCCACAAAAATGTAAAGATATTGGCAAACACTAACATGAAACCTTGAACAAAAAGCTTACTTTAAAAAACATGTCTAGCAGTCGAATAAAAAAAAATGTTCAGTCTCAGGCTAAATCCAAGTTTGCACACCATGAAATCACAACACAAGCCAAATGCAATTTCTTGAGGAGATAACAACCTAACTATATTTTAAAACCCAAGCCTAAGGGTCATTTAGAATCATGGAGTGTCCCTGATCCCATGGAGCATTTTGACCATCTTAGCAGTTTTGAAAGTTCATTAATAACCATCCAAATTGCCCCAAAATTTTGCTTTCCAATAATTAAGAAATAAAATGCCAATTTGCAGAGAAAATAATGGTTATCAAAGATAGACTGCTTCCTAAATATCTCATAGTTTAATCTTGATTTTTGTTGTAGAGTAAGGCAAACATATTTCATTGAATAAGGTGCATTGTATCTCGCTGTGACCAGGTGATTATTTTTTGTTGTAAGTACAGAAATAAGCACTCTCCTATAATGACCAAAATTACAATGATTTTCACAGTTATGGGCTTACCTGTGTCCTGCTGTTAATCAGTCATGTCATGCTAATCATGTCTTTAACTCTTTTTGAATTAAACCCATTTACTAAGTACAGCAAGAACAAGGCACAGGGTGAAACTTAAAAGCACATGTCTCTTTGCTTTTCTTCAGTTAGTGGAAACCACACATTATTCTAACTTGGTTTTTGTTATATTTCAAAGGCAGTCATGTTCAGAAAAGAGGCTTATTCCCTAGATTTCCCTTTAGTTTGATTACAACTTCATTTACAAAATGTAAATGGATTTTCACACAAAAAAAGCCATTCTTCGAGAAAATAAACATTTCTTCGTGAAACTGGTTAATGTTGTAATGTACTGTTAGGGTACTCTGTAAGTTAGAGAAAATATCAACTGTACCTTGAGCTTAATTAGAATAATCATTTCATGTATGATCAGTGTAAGCTAAATATCCTAGATAGTGACAAGATGCATTTATAAACATTTTCTTATATGCAGAATTAATAAAATGCAATGATAGGGCAATACTGCCACCTAGAGAGGAAAATGTAATAAGCCTTATTAAGAATTAAATCAGTTCTGAAAAAAATTTTACCTTACAATAGTTGGCCAATCCCCAGAATTATTGCTATAGATCAGAAATAGTCTTTTTTGGCCATCAGTGCTGGGATTTAGCACCCAAATTCTTCAACTGATGCTACTTGCACTTTGGATACACCTAAAAAGCAAACAATGAAAACTATTCTGGAAGAAGCAACTTTATCAATTTACCCAAAAATCACAGAATCATTAGTTTTTAAGTTAGTCAATTCCCACAATAACTCTAAAGATATTTAAAATAAGTCCAGAGTGCAATACAAGGGGGGCGAGTGTAAACAAATATGGAGGAAATTAAAAGTAGCTGTCCACAAACACTTCGGCTAAAGCAGCAATTTGCAAAGTGCACTGCACAACCTGTACCCAGCAACATGCTGCAGAAAGCTTCCTGAGGATGTGTCCCCCTGTCCTGGAAATTCACAAGGCATACTGACATAGTAAAGGCTGTGGGAAGTCCTGCAGGGGAAAAAAAAAAATGGCTTAAGCTGCTTAGTCAAGAGTGGCACAAGCATTTTGATTACAGAAACCTTTCTTCTTATAACACCTATTTGACATCCTCTAACCCCCCCAGAATTGGAATACAGAGATGAATTTGGAATACAGAGGTTGCTGGATTTGACATGTCTTTCCTTTGGCTGCATATTAAAGAAGTAGCTTTTTCTGTTGTGATTTTTTTTTTTTTTTAATGTGAGAAGGTGCAAGGCACAAAATCTCCAGCTTATTTGGAATTAAAGCTGATTCTCTTACAGGGTTACAGCAGATAAGAATAGGTTTATTGAGATTTAAAACAAATTACTTCCAAGTACATTATTTACCCTCTGAATGGGTTATGGAGGCACACATTTTAAAACTCTGCCTTAAAGCACTTCCAGCTTTTCATCTCATGATTCACATCCAGTTACCCCTCCTTGCTTTGACATTCTTGACCTCTGCCTTTTGGTTTTCAG
>TTN-202,,0,370,951295,951664,GTACTGTCAGAATGGTTTTGTTTTTCCTTATTTCACATTCTAGTTTCTCCAACTGGATTTCTGCCATGAAACTCAGTCTGTATAAATTGGAGGAAAAATGCATATGAACATAAAAATATAGCAGCAACTGAAGACCAAATTCAGTAGTCATGCTTTGTAAAACCATTTTTAATTAGGACAAAAGCTCCAATCTGTGAAGTTTCCATAATATACAGGTTTTAATGATACAGTCTCTGTATTTCTTGGCAATAATAAATGCTTATGTATGAGTGTATTTTGCTCTAGGTGGCTCAGTTTTCCAGTATGCTTTTTTATTTTCTACTGGGCATGTCATTTAAAAAAGTAATCTACTTGGTCATTTCTAATCTAG
>TTN-202,,0,857,951665,952521,GTACGTGCGAGGCTGCCATGGGGCACCCGCAGAGCCACGTCCTTCAGTGCACATTAACTCAACCACCATCCACTGAGCTTGGCATGCAGCTGTGCTCAATTCATTCTGAAGACAGCCTTGAGCCCAGCAGGGCCCAGACTTTTAGAACTTTCTGAGCAAAAGGTGGTCGGAGATGTCAAAGGTGTTGACAATGTGAGTATCACAAGAGCAGAGTAGGCCAGAAATACCTGGGCTATATGAGCAGGCAAAAGTCAACTATGGTATTCAAGGTAGGAAGGCAAAGAGTGGCCAGAGAAACAGAGACCAGTCAATTCCAGAGCTCAGTCACTGCACACACTGGATGTGGAAACTACTATTTCAGGGAAGGCATTACATTTCTCTAAGTTTCCCCAAAGGACTTTTGTTTTTACTTTTCTCAAAACAAACATGACACTTGATTCATAGCTGGAACAGTGTCATAAATCCAGGATAATGTCCCACCTCGCATTTGAATAGATTTTCTGTTACAGTTTAAAATCATTCCAGCTTTCCTCCTTATCCTCTTGTGTGACATTTATGTCTAAATCCTGACAGATTATTGTAACTTTTTTTTCTTTTCTGAGACAGAGTCTCGCTCTGTCACCCAGGCTAGAGTGCAGTGGCATGACCTCCGCTCACTGCAGCCTCCGCCTCCTGGGTTTAAGTGATTCTTGTGCCTCAGTCTCGTGAGTAGCTGGGATTACAGGTGTGCGCCACCACACCCAGCTAATTTTTGTATTTTTTAGTAGAGGATTTCACCATGTTGGCGAGGCTGGTCTTGAACTAATTTTTATGTAAGATGCATTAAGGTGTTTTCTTCCTTTCTCTATGAAAAGCAG
>TTN-202,,0,1206,952522,953727,GTGAAAATGGGTTTGTATTTTAAATTCACTGAGGTTCTTACAGGGGTCAACACAGATAATCACCTTTACCATGAAGAGTGTTGTTCCTTGGGCCACATGGTTGTTAGCATACTAATAAGATCCCCTTGTTGTATGTGTAAATTTCTGGGTACTGGATACCAAAGTTTGGTAGTGTCCCTGAATGCTCCCCTTGTGAGTATGAAAAAGAACTCTGTGAACATACACCAGGAGTAGAAACAGGGGTCTCATCACATTGATCTGGGGATGCACTAAGTATAAGACTATAGGGAGAGGACAGATGGCTAAAACCAGGAGGAAGAAATAGATGCTGAGGCAGGAATGGGGAAAAGTGGAGGAGACACTGAACTCACTTTGCTTTAGAAATCTTAGCAACTGCTTCCTGGCTCCTTCGGAAGACATTTGCACATGAGTTTGAAGTGGAATGGACAGCATGGCTTTAACAAGCCAAATGACCAGAAAAGGTGAAAAGGACAGCCCCATGGTTGGCGGCATTTGGGGACAGATTGGAAAATGCCAGTTAGTAGAGCTCTTGGCCAGTGGAACCAGTTGGCAGTTGGGTGGTTTGAGAAGATGAATTTCAAGTCCCTTTCAGCCTTGAGATCCTGTGTTTCAGTGATGAGATATTTGAGAATGGCAAAGAGGCAAATAGAGAAAACTGTCCCCCTACATACGCATATACCTTAGGTGCCCAGATGGAAACAGCATTCTTCACAGTATTTAGGAAAACTGACAAAACAAAAATATTGTATAAATGCAGATTATAAATTATCCATGCTTGATTTCTCACATGTAAAATAAAAAGATCAGACAAAATTACTTCTAAAGTCTTCCATTCTGATATATATTCTAAGATTACCTTTAGATGACAGAATTAGTACAGAATAATATTGCCATAGATCTATTTGTAAACATTGGAAGTCATTTTAAAGAAGACTACAATTCTGCTGTTCAAAACAAAGTGTTGAATTCAACTTTGTTTTCTCTAAGCAGCCTACATAATTTACAGTTTAAGGAGAGAAAGAGCATGATCTTATTTATGAACATGGGATTATTTATTTTATTTAGTGACATCTGCAGAAAAGGGATTTTACATCTTCAAATTCCTATGTTGTTATATTTAATAAACACCATATTATTTCATTGGGCATCAGGAAATAAAGTTTTTTCTTAAATCATTCTTTGCAG
>TTN-202,,0,1226,953728,954953,GTAAGTCTGATTTTCTAAATATTTTGTAGTTTGTTGACAATATCACATTACAGCCAGCTGCAGGTAGCTTATAGTCAAAACCCTTAAATGGAGAAGTCTTTGGTTGTATATTTTTTGTTATTGTTCCTCTATGTCTAGTATTGAAACTCAGGATGGAAATTATGTTCACATTGCACTATTTTCCACTCACTTGATCAGTTTTCAGGAGATTGTCTACAGAACAGTTTAGGGCACATCTATGAACTTTCTAGAACATACATAAATGGATGATAGATATCATGCCAGTCCAGTTACCCACCGGGACAGTTGGTTTCTTCGTGCATAGCCTAAGCCCTCAGTCACTTAGATTGTAATGCACAAACTTTACATGCACACACACATGCACACACACACACACACACACACACATATACACATACATCAGCCATAAACACCCCGAATAAATAGCAAGGGAAAGTGAGGATATGCCAGACATCGGAGAAAGCAAATACTTCCTCAAAAAAAAAAATTCCTTCAATTCACGGTTGATAAACAGTGACCTAGAAGCATTTGCTGCTGTTGTGCCGTAGAGCTGTGTGAGGACAATCTCAGTGTCACTAAAATCCACATCTCTCCCGTATGTGAAATCAAACCTTTAAGTGTCAGGAGAGAGGCATTTATCTTGAATTCTTCCATGTCAAAGAGGGCGCCTGTGCTCATCCTCCTTGAACTCAAGCTCTTTGCTGATCTTAGAGCTACTTTCTTTAAAGGTCCAGTTGAGAACCTTGTACACTTAAAAGGCTGACCAGAGGCTGCTGACTGAATTTCCCTCTCCTTACTGTGAGTGAGACATTTTGAAAGCAGCAAGAACCCTACTTAGGATAATCAAAGGCATAGAAATCCCCATTGCCATTGCAATGCTGGTGACTGGCAAGTTCAGCTGGCCTATGGTTTTCCAGCCACTTGTCAGCAGCCACCCACCGGGTTCCCTAACACGTTGACATGTCTCAAGATGAGATATGTTCAGTTCTAGGACAATTTGCTAAGGCGCATGTGGGCAGAAAAGAAGCCCATTCCTCAGGAAAGCAGTCTATGTATTAAGCACAAGTGTAGGCCCCTGAAATGGAAATCTGACATTTTATCGTTCACCACTAAGCATCCTGTATTTTCCTGAGTGTTTCAAGGATGTCTTCCCATTGCTTTTGTATCTTTTGAAACTCAAATCTTTATTTTACTCTAAACATCAG
>TTN-202,,0,592,954954,955545,GTGATGACTTCCTGCCAATGTGAAAGTCACTCTTGCACCATTTCATTTGCAAATCACCTACATTTTCATCATGGATCTTAATCATCACTTCTTCACTTCCACCTCTTCTTATAATGCAAATAGAAAATTTCTTTTCCCACACAGCTACCTTTCACTGTCAATTCATTCCTAACTTTCAGACTTTCTTTGGCTTGTTACTAATATAATATAATAATTCACTTTAATATCTTCCTATTGAAGCAGATGTCCGTAAACAAGTCAATTCATAATACAAAAAATTATGTGCTATTTACAGTGCTACTGAAATGTCTCAGAGATTGCAGTTTTAAAAAATGTGAAAAGTACAAAATAGCACTCATTAGTCTTTTATTGCTAATCACATTTTTTTCTTTTAAACTGGACTTATTGTTTTGATATTTTTGCCAGTGAAACAGTATGGATGATCAAAGTAACTCAAATGATATATTTTAGTGCAATTAAAATTTCCTTGAATAGGAAGAAATTTTGCCTCCTTTCTTTTTGACTTACGTTTCTTTTATTAAAGATTTATGGAATTTAATGACTATTTTCTTACTTTCTTTTGTATGATCAG
>TTN-202,,0,480,955546,956025,GTGAATACAGATATTTGAGCTGTGAAAAGTTCATCTTTAAACTAATTTCTAGTAAACTATTAACTACAATATGGTATGAATTATTAATCTGTATTTGCCTTTTAAAATCCCTAACTAAAAACAAAATGGTAAATATGAGACTGATTATCATTAATTTTATCTGCACATTTGATTTTCATCCATCTGTAACATTTATAATTCATTTTATTCACCATTATTCTTTGCATGAAGATTAGCATTTTTTAGCTTAATTTTTAAAAAGTGACACAGGGACTCATCTAGAGGTTTTTTAATAGCTAACATTTCTAAGTTTTGTGATTCTCAGTCAGTATATGTAGACATTGCCGGTGAAAGTTTATTTCTCTTGTGTATTTAACCCTGAATAACCATCTTGCATCCCCATGAGGAAGGGGGAAGGGTCATACTATGTGTGTTTGAAGCCCTGTTCAACTTAAATCTTGATTTTACTGTAATAATCAG
>TTN-202,,0,3218,956026,959243,GTGACTATTGTTGTTCCAAGTGTGAAATCCCCTATTATAATACATTAATACCACATATCATGTGAAATTCCTTATTGTAATACATTAATATCAAGTCTCTGAATTTCTTATGTATGAGTCACTATTAACCAAATTTATTTTTTAGACAATTAAATAATTGGAAACTAAAAAAATTTATTATTGTTAATATTACTACATATCCCTTTCTCCACTTATCTCTTCACCATTATTGTCAACATTTTATTAACATCTGGGAATCTTCCAGAAGTTGATTAAAATTGCATGCAGGCTAATTTTAAGAGGCCCATGAACATTTTTTAAAAACACGGAAGATGTATAAGTAAATGATGACTCTTACTCACTGTCAAGAAGATGTGTGTTTTGAAGGGTCATAAATTCAGTATATTATGTTATGGAGTATGACTTATTTCAGTAAATTACCCATAATTTTCTTTGTATGAAACTTTATCTTTTTTCCCTCCTGTAAATATCAGAGGAGAAGATAAGCTGAAAAAATTATAATGCATGCTGTAGCAGCTCCCACTAAAGCTAAACAAGATGCATATTAAAATCTAGAGAAGGAAGTATCCAAACAGAACAATTACACATAAGCCATGAAAAGATTACCGTATCTATTTGTAGCTATGAAATATCCATGAATTAAACTGTTTCCCATGACTCTGTCATTTACTCCAAATGAGCCATTTACCTAATTGTATTCTTTATTGCTAATATACCACTTGAAAATTAGCAACTAAAGTTTTTCCATTTCATTAGCAGGATGGCCTGAATCCTATTTGTATTTCCCTCAGTGTCATTTTCTGACTCTACATCTTTTTTTTCTAAGATATGATTTAAGATAAACTTTTTAAACCTTTACTCAAATCTAACATTTAATGGCATATCAGCCTTTCAGAAGTCTCATAAATGACAGAAATTCCACTATGCAACATACTTCATGAGTGATTAACTTTTTACTTTTGTTTCCATTCAAATTTTGTCATGAATTGACTATCTTGTTTTTGTTAAAAATTAGCTAAGGATGGAAGCTGAGAAAATGTTTATACCTGAAGTAGTAGTTACCACTGCAAAATCTGCTGAACCAGCCACACCGCCAATGACTAGAGAAGGATTCACTATTAAACAAAAACAAATACATCTTTTTCGAGAAGAGATGAAAACTGATGCTATGGAGGTGAAAAGTATTGTTTCATCCCATTTCATCATCAACTCTCATAACTTTTCATCCGTCGTGAATTGTGCTTCTAGTGTTCCATCTAATTGTTTAACTGATCAATAAAACAATAGAGATGGTTAGATTCAGTCCATCCTCCAGTTGAACAGTGAGCATTTCTAGTAGTGAAAAGTCAGACCAAATAATACTCTTCTTTATGTCTCCTAAATTTATTCTCAGCATTTAACTCGTATGAATTGGAGTATTCTAGTCCAATTTGTCTTCCTGCTTCTCTAGGTTACAAACATGTGAGAGATATCAAAGTCCACTAAGAAATAAAAGCGGTTACCAGCATACTCATTTGTAGTCCACCAATAAGTGTGTGTATATAAATCTGATATACAATAATTCAAGGAAAAAACAGACAGATGCTTCCTCAATTTAAAATATTTTACCATGATTAAGATTTTTCCATATGTTTAAAATCAAGAACAAAATTTAAATATTTCAGTTGTGTGATATTTAGTCATATGACAGTTTCTTTGACAGTTTCTTTTATCATTGTTAAAATAAAATTAAGACTTAAGCTGACTACTTCATAGCAGACTGGCTAAAAGGTTCAAATGAGATATAGTGGAAATGTGATCACACTACAATCAAAATAATATTTATTTATTTAGTGTTATCTGTCGAAGATGTTAACATTTTAAAATGTCTATACAATTAAAGTCAGCTCATTGCCAATATAGTTTTTAAAAAAGAAAAAAATAAATGGACAAACTTAACTCACCTAAGCCTCATGTGTATTTTATGTTTTTTTCTGAGATGATGCAATCTAAAGTGAAGATGGTATTTGCAGTCCTTCGAGGCAGATGAAATTGTTTGTGTCTTCCTAAAAGGAAGCCCTGGATAAAGCCCATGATCACTAAAGACCCAATTCCATCTCAGAAAAATCTCATTTATATCTTGAATGGTTCAGAGAATAATTTTTAAAGATATGCAGGTAGCATAGTTGAAGAATGTTTCTGATGCATTCTAGATTCTATTCACAGGTATAGAAAACTGAATATTAATAAAATTTTCCAATCTTACTTTTAAAATGCACTTTTAAAATGTACTTTTAAAATGAACATGGCTATGTGATTTTTGAGGTATGCTGTTTCCAAGTATCACATAGAATCATAATATCTAAGCCACATCAGCTAGTTTGCCTTCTTTAAAAGAGAACCTCCTCTGCAAATTGTATTTCCATTAATGTTCATCAGACTCAGAAACGAGAAAATAATATTTGTTTCATTCTTTGCTTTAACTCTCCATAATAATGAAAGTAAATTAAACTTCAATGTGAAAGGTTGTTCTCTTGAATCCAAACATGATAACACTTTCATTTTAATCACAATATTTTTATTTGCACGGGGTTCTCTTTGTCATCTGTGTGTTTTAAGAAAGGTATTTTCTGATAGATTAAACAATCTTACCCTTAGGGAATCATAAGTAAATTCATATGCTCACTCTGTGTTTGTGAGCTTTCATGTTATGTCCGATTTGCATGCAACCATATAACTCTGTAGTCACTGATTTTTCTGGACAGGATGATGACGGTATTTGAGTGCACTTATATCATCACTGTCACTGCATTAATACCAGACTAAATGGTCAACAAGATAATAAAAATAATCAGTGAAAAGAACCAGCTCCAAAATTCTGATTTTCCAATTGCTGATTGATTGTCTGCCTGGAAAAATTCTAGAAAATTTCAAAATCTTCTTGTGATTTTATGTTCATATTGTGATTGTCCTATGTTGTGTATATGTGATTTAATGTCTAGTATAATTAAGTAGGTGTACAGAGAGTATATCTAAATAGATGTCTGTACAATATAATAATCAATGAAATAGTCCCTAAAAGTGTTTCTGAGATACATTTCTAGACACGTTAACACTGCTGTATAATGTGGACGCCATCTGCCTGTCCTGATGCCCAGGAGATATTCCAGCCTGATCTCGATATTCCTATGTATTAATTCTGGAAACCTTGTCTCCAG
>TTN-202,,0,105,959244,959348,GTGAGTCTATACCTGCTGATTTTTCACCTTGTTCATGGTAAAGCAAGCCTCACTGCTGTGGTCATCTGGTGATCAATGGTATCACTGAGTTTCATTTCAATGCAG
>TTN-202,,0,1268,959349,960616,GTAAGAAGTTACAGAGCATGATACAGAAATGTTTAAAGGAAATAAGTATCTAACCTGTGAAACAGAGCATCTCTGGGGTAGGCCAATGGAGGATTCTTTTTTGGTGATGTGTGTGTGCGTGTGTTTGCATTCACAGTGGGCCCAGACACCCTAAAGATTTGGTTTCTGAAACTCGCCCAGGGGAGTGAGCCTAGAGTCACAAGTGGTTATCTTATACCTCTGAGGAGAGACAAATCCACACAGGCTTCTCTCTAGTTCACATTTCAGGGACAGCTCAAACTCAATTGTTTTGATTACTATTGTTCTAATGATTTTGTGAAAGGTAGTGTGTTACACAGCATAGTTTTACTTATGCTGTGAGACATTTCAGAGTAACTTAACTGTGAATGTGTTTCAATAATAAAGACAGACATTGAGAAATCATATATTTATATACTCAATATAGCAAGATGGAGAGGTGGTACTGTATGGTGGTCGGGTTGGATTGTGGAATCAAATAGCTCTGGATTAGTGCCCTATCTTCTCCCTTATAATCTCTGTCATCAGGAGAAAGTAAGCATACATGTAAAATGCAAGTAAAAAGGACATAAAAACCTGCAGTTGTCAGCATGTAATAAATCCTTGATATTAGTCACTATTGTTATTATACACATCCAAGAAATAGAACCCAAACCTTCTATGCCTTCAAAGAACTGTAAGTTACATATAATGCCTATATTTGATTTAGTCCCAAATTACAAAACAAATAACCATAGACCACAACAGAATAAAAGCAGTAAGGAAACCTTTAAAATATTTTTTCTGAATGTCTTCATGTTTACCTTTCACATAGATTTGTGGCTAAAACCCAAATGTACTATTGCAAAGTAGTTCTTAGGCATTTACCAACAATTTCAATAATTTCTTAATTTTGAATCTCCCACTGTGGTATTTTCAAAAGTGGCATTCATCGGAATGGTTAAGTGAAAATTCGTGACTAAGCTTTAGAAGATCCTGTCCTTTTATGATAAAAGCTGTAAAATAAGGAGTTCTGAATACAACTCTTTAAAAAAGATATTTTAAAATTTGTTTTACAAACTAACAGGCATGACAAGGAGCTTTATAATTGGCTTATCTCTAAATGACTTTTCATTAACTGTGTGATAATGAGTGCTAATGAGAACATTAAAGAACAGACCTTATAGAAAATAGGCTCAGACTCAGTCCAAGAGGGCTAGCCATCGGAGGATGGTTAAATGACTTTATTTTCTGACTCTGTTTCCATGTAG
>TTN-202,,0,284,960617,960900,GTTGGTCACTGGTTACCCGCTGTTACATGGTCCACTCCCATTGAGCAGGGCCAGGTGGTTGGCTAGTTTGTACTGAAAAGTAGCCAGTGGAGTCTTGCCTTTCTCCTTTGCCATACTAAGACTTGATTTTTATGGAGCATAGTATGGGTCAGAGATCATTTTCTCAAATTATTTTTATAATTATTTTTATATTTTTATAATTATATAATGTTGCATGAGCTAAGAGTTTATGAGATTTCCCTTAATTTCATGAGCATTTTGTAATATAATTTGTAAAAATCTAG
>TTN-202,,0,655,960901,961555,GTGAGTAAAGAAGTTGATAATGCTGGACCCTATTCATATCTCCTCAAATCATTTTAATACACGTTTGCAAAGATCAGTTTCTCAAATTAATACAAAAATGACATTAGTGAGCTTACAGATGCTCATTTTAAGACCGTATTTGGTCTGGAAGACCATATTTGACCATATTTGGCAAGGAAGAAGGGAATTCTATGTGGTACATCATTCATGGATTCAAAAGATTTAATGAGCTTCTAATATGCAGAAGGCATTATTGCAGGAGCTGTGCAGACATAAAGACCAATCCATCCCTCTTTGAAATATTTTCTTTGCCATCAGAGAAAATGTACACAAACAAGCATAATAAAATATATAAGGTGATAAACATCACAACAGAAGGAGAATCCATGGGAGGCATAGATTCATTCCAGTTGGTGATACCATGGCAAAGCTTTGTTGAATAGGTAGCATTTGCTATTGAGCCTTACAGCTCTTTACTAATATATTAGTATATTATATAAATATTAGTTTCTCTACTACTATTTCTGGAGTCCTGATTAAAAGGCCATTTTGTGGCAGTTGAAATGCATAAGTTCAAACTCTACATTTGTTACAAAACAGAAGTGATTAATGAATATGCACACGTATCATTATTTATTTTTTCTCCTCTCTTCAG
>TTN-202,,0,203,961556,961758,GTTAGTGGCCACCCTCCCACAGTCCTAATGCACATGCCATCACTTTCATCTGACACTCTTTTCCACAATATGGTTTCTGTGCACCTTGAAATGATGTCCCTTTTTGGAACTTGGGGGGAGATTATATGGTCAATTTAACTGTCAGTGCTAAGCAGGGGTCACTAAACATCTCATCTCAATGAGAAACTTTTGTCTTCTTTTAG
>TTN-202,,0,111,961759,961869,GTAAAATATTTTGCTAATTAGTAGCTGTTCTAGTACCATTTTGACTTTCAGCCCCACCAGTATTGGCAAATTGCAACCCGGAAGCTAATATGAGGGGAATTCTCTTTCCAG
>TTN-202,,0,948,961870,962817,GTATTTTGATGGCTGAATATAGAGTTCTCTGTGACTTGTATAATACGTGCATGAAGCCTAGAGTAGAATTTACTCACCCCACCGACCCTGAGCATAGGCTCTTTCATTGTGGAGCCTTCTTAGTTTGTTTTGAGGTATTTTTACATTTTTTTTGTGCAAAGTCTTCCTAAGAAATAAAGCTATGTGACAAAAGTGGATGGAAGATATATTTCTTTACATTATAGTTTAATTCATTGAGTTTGTGAAAGTAGAGAAAATATGGATTTTCACACAAACACACCCACACACACACACACACACACACACTTCCAGAAAAGATTTGAGACAATTTTCAATAAAAACATGTAATAACTAAGTGACTAAAAGATAGAAGAATAGCCATGTAATGAAGAAGAAAGCTAGTTATGCACAAAAATCTATGCTAGTAATTTTTCTTCAATTCAATATAAAATTTAGCTCTGAATATTTTGCAATTTAAGATAAAAAGAGCAACCTGGTAATCTAAAAATGTAGGTGCCGTACCTTCATAATAATAAATATAATGTACCAGAGAGTTAATACTGAAATATTTGAAGGAATTTATTGTTTTAATTATTCATTTGATCTCTGAATGAAATAATGAGAAAAATAACGAACAAAGAGAAAATACCTGTTGTTTAAGTGACCTGATCATTTGCTAACATAAACACTGAAAACCACTTAATTTCATGACTGATTCTAGCAATAAATATTCTTTAAAATGAATATTTTAACTTATTTGGCCCTAATTACTCATGTTCTTGCATTTTTCTCAATTTTCAGCAATCTTATAATCTATTGTGGAGCTTAGTCATATGTTTAGGGTCATTGAATTTTATACCACAGATCCACTCACAGATAAGTCCAATTATTTTACCCACAGAAGAGTTGTTGATAACTGATTTTTAAATTTTGTACATTTACATAAAG
>TTN-202,,0,915,962818,963732,GTAAGTGCAACTCCAGTTTCTATGTGCATGATAAGAACTGAAATACAAGGAGATAGCAGTGCTGTCCGTTTGCTGAAAAACCTGTTGCCACTTACTGGTTCTGATACTTTGCCCCAGTGTCTTTGCCTCAGTTGTATGGAAAATGTTTTAGACCACATGGCCTCAAAAACTATACTGTCATTAAACTTCTGAGGTTCTAGCAATAGTTTCTTTTTGTTGTATTTGTTTCTAGGCATATCATGCCTCTGAAAATGCAGAGATTCTAAATCCGGTTGCCTTCCAGGCCCAGGCAGGTAACAGTGAGCTCAATGAAAACAGTAGCAAACTGGAGAGTAGGTGCCCTGCCTCAAAGAGACAGTAGCTGTGTTGTTGCCAGGCATGCACCAGGCTGTTACCAGGCTCAGTGTTGCTAGAGCTCCTGATATCTTAAAGAAAACCTGGAAGTCAGGATTTTCAATGTTTATAACTTGAAAACAAATGTAACAGCTTTCATGCTAGACTGTTCACATTTACAGTGAACTGGCTCACACTCTGTTTCACTTGACCTACACAGTATCCCTTAGAGGAAATTACAATATTATCTTCATTTAGCAGATAAAGCACTCAATATTCAGGAAGGTAAATGAATTGTTAAAAGACACACAGCAAATTAGGAAGTCCTCCGTGGTAGATCCCCCCAAAACTGACTGCTAATATAAAATTCTTTCTACAATTGTAATGGCTGGTTGGATTTGTTAGTGTTAGTTTGGTTTCCAAATTCCATCTAGAAAATATTGAGCACTTCAATAGTAGATATTTGGAAAATTTGGTTTTTGGTTATCAACTTTCCCCAGTGTAGAGTTTACCTGAATGCATAGTGGTATGACTGTTTTCTAATAAGAGCATTAAAAATTAACTGATGTTCTTAACTCTTAG
>TTN-202,,0,537,963733,964269,GTGAGTATAAAAGTAATGACCAACCAAACAATTTCATAAATTATACTTTCCTTTTTTTATTTGATATTTTCATTTTCAAGTGATGAGCTCGGGGTTAGACAGCTATTAGAAGGTCCAAGTTCACTGTTGCTAAGTTTCCTTAATCTTCATGGTATGTTGCACCTGTGAGTTTAGAAATAGAGATTACATATAGGCCATAAATGTGACTTTAAAAATAGGGCTTATAATATATTAAGGAAAACACCAATATTAGCACAGCTGAGTTCATTCATGCCAAGATCTCTTCATCTGTGTGATAAGCTAATGTAACCTCTAACCCAAATCTAACTCCTGCTTTTGGAATACCTTTCTACCCAAGATGCCACAACATTCACTGGGAAAGATGACCATAATGCAGATTAAAACAAACAAACCAAAAAGTCCTCTAGATTCTTCTCCCAGCTAAAAACTTCAACAGTCTAGCTCAGATACATCTCCTTAAATAATTTATATCAGTAAGGATATGTATTTTTAACAGACCATAATCTTTTTGCATAG
>TTN-202,,0,110,964270,964379,GTAAAATATAAACATTTATCATAGCTCCTTGCCACAGTAAAGATACAAATTGGTTAAAATATAACTATTTGATGTAAATTTTATTCATACATGCATGGTATTCTTTGCAG
>TTN-202,,0,898,964380,965277,GTAAGACTTGTAATAATTTGGGTTATTTAGTATGTAAATTGTTTTCAAAACATCAAATAGTAGCAAATTGCTATTGTGTAAGAAGAAAATCGAGGGCTAAAATGGCACAGAAACTTACCATTGGCAACACCAACAATTGCCAGAAGTTTTTATTTCTTGCCCCTGTGTAAGATGAGCAAAGAATTTTCATCAGTGTAACATACTGTTTATTTTCCTAGTGCTATAGCTAATATCACAATAGCTCTTATTTGACACCTGATTTTTACATATGTAAATTTATACAACAGCCCTGCAATAAAAAGATGACTATTATTGGTTTGGAAATAGGAACACTGAGGCCCTGGGAATCTATGAAAATTGTCTTAATTCATCCAGCCTGTAAGCGGTGGTGCCAGCATTCAAACTCCAAGTCAGTCTGGCTGCAATGTGTAGATGGAGTCTTGTTTTGCTTTGTTTTGTTTCCAAATTCATTTCTATGTTTTCCTCCTCTGAGATAAAGAATGTGTATTTTTTATTTTTCCATAAATGTATTCATTGGTTTACTTATCCAACCAACATTTATTAGGATGTTTTAGTAGTTAAATCAAAAAAGTCTAGTGACTGATTAAATCCAAGTGGTAAGGAAAAGAGAGTATTGAGGATTATTCCAAGATTTTTGAGCCTGGGTACCTGGATATACTGAATGACTACCAGCTAAAATTGAGAATATAGGAAAAACATAGTTGTGGGGGCAACAATAATATATTCTATTTTAGATCTGAATGAGTTTGAGGTGCCTTCTAATACGTGCAAGAAGTAAATTCTAAAATAACATGAATAATGAATAAGACAAAATGAAGTTTGTTTTGCTGAGTTTTCTTTATGCCTCACGAAAGTATTGTGTGTCTTTGTTTTGCAG
>TTN-202,,0,119,965278,965396,GTAAGCGTGATAAGTTTTTGCTCATGAATCATAAAAACACAAAAACAAGCTTATGTATGCATCTAACAATTTTTAAAAACTATTTTAAAATCTACTTTCTTTTAAACATATTTTCACAG
>TTN-202,,0,102,965397,965498,GTAAAATGAGATAAAATAAAAATAAATGAATTTTCTTATCACTTGGGTTATAAACAGGTATTTCAGCCTTACTCCCTCTAAATCATGACCTTTCTCTTTCAG
>TTN-202,,0,99,965499,965597,GTAAGTATGGAAATAATAAAGCTAAGCTCATTATACAAATCCAATAACCAGGGAAGCTATACCACTATATTGATTATTCCCTCCCCCAACTTTTTATAG
>TTN-202,,0,153,965598,965750,GTAATTTGCATGTCTTTCCTTTGATGGACCTGTCTTTGTATTCAAGAATATCCATGAGTGTGTTTACTTTTATTTTCTTTCCCCATTCCTCAGGTTGAGAATTTAATTTAATATAATGTGCTCTCCCCTTTTTCCCCCACCTTTTTCTTGTAG
>TTN-202,,0,447,965751,966197,GTATTCAACAACGAAGGATTTCATTGTTTACCTAAGCTCTAAAGTCACCCTTAGCATGTGGTAAAATTAGCTATGCAATTTTTCTTTCATGAAACAATTATTTGGAAATTGACTATAAGTTTCATAGCCAGAATCATAAATTTATGTTCGTAATTAAGAATGTTAACAATTTGACCATTTGGATTTTTTAAAGTAGTATTATCTTGATTTTTAGCTTTTAAGTTTTTTATTGAAGCATAATTCTTTACTTTCAAAAATATTTAAAAATTAAAATAAAATAACTGCTTCTTATTGAAAATTTATCTCTCAGCCCATCAGCGGGTAGATATTAAGAATACACCTGATAGTATGGGGGAGATAAAAGACATACAAGACATCATCTCTATCCTAAGTCTAGATGCATACCTCTCCAAAAAAATTGATTTATCTTTCTGTTATACACTTCAG
>TTN-202,,0,96,966198,966293,GTAAGTCCTCCCATTCCTGTCAGCCTGCAGTGAGCATCATTATGGTTTATTGATAAAAAATGATCATAACATTCTTTTTCTCCCCATATTTCACAG
>TTN-202,,0,112,966294,966405,GTGAGTCCTAATTATAAAATTTTATGTTTACACTATTAAGCAACATAAAGAACTTCAAGGAGCAGACAATTTCAACAAAATTCATTCATCTTGTGTGTGTATGATTTTGCAG
>TTN-202,,0,92,966406,966497,GTAAGGATTATTCTACCTATCTAATAATTACTTTAAGCATTCTACTTTCCCAGTGTAACAATAACCAAGAGATTATTTTATTTTTTCCCCAG
>TTN-202,,0,1637,966498,968134,GTTGGTATATTTATTAACCTAAATTCTTACGAGGAGTGATTGTTATTTTAAGAAATTATTATTCATTTCCCCCAAAATTCCTTTCAGTTTCCCACTTCCATGCCTCTGCTTATGCTGTTCCCAAAGCCAATAGTACTTGCAACACCATTCCCACCAGCCTAAATTACAAATGTTCTTCTAGGCCTACCTCAAACGTCACCTTCTCCATTAAACCTTCCTTAATCTCTCCATTTGTATATGATCTCTTCCTCATCCAACCCCAGGATCACTTTATATGTGCCTCTTTCCTAGTGTTTATTATGCACTTGTCTTATTCCCCATTTCCTCTTTCAATATCAGTGTATAAACTCCTGAAATCTGGAATTCTATTTGTATATTCCAATATATTGCAAATGACAGATAATCAATTGGTGTTTGCTGTATTGAGCTTTATTTAAACTTCCTTACTCTAAAGAATTATTTCCTTTTTTAGCCATTCTTGCTTCTTTAGCCTTTGTGCCTTTTATTTTCTTCCTACTTTTTAATGAAATCAATAAATATTTTCAAAATACAGCTTAATGTAACTGTATTTCTTATGATATCATGTAGAAATAAGACCATCATTCAGTAGAATTTCTTAGCTTTACAATGAAGAATAAAAAATGTAAATCAATTGCCAGAAAAAACTAGAAGTCATCATTAATTTGTTTGGTTCATTACAGTTTAAATTTTGAGGAGTTGAGATGTTACATTCAGATCGTGTTGTCCATTACATCTAGTATTGAAGCAAGTCATATGGTAATGATTTGTCTTATTTGGTATGAAAGTTTCATGGTTTATACTTACTTACGTTATAAGATTTCTTCAGAGATCGGACCATGAAAAGACTTGTAAAACAAAATTTCAGATTCAGCATTTTTATACATTTAATATAAATTACATGTTTTAAATGTGTGGAAACAGGAATAAACTATGAACTCCTCTGTGATTTCACCCAGTGTTTTTAAAGTACCTACCATTGGTCAGACACTTGTAGAAACTCAGGACACAAAACTAAATAAGAAATGATTTTTTTCTTGAGAAATTCATAATTTAGAGAGGACAGATACATAAGCAACTAGCTTGTTAAAGCAGTAATTATTTCTGCTAATGGATGATAAGAGTGGAGGCAATGGGGTGAAACTTCATAGAATGGGCGACATTTGCCAACACAGTGATTTTTAATATATAGAAATCCTCAATGTAGTAGAAACATTGATGACTCGTACATTTTGTTTAGCAAATTTTTATGTAGTCAAAATATCAGATTCCCAGGAAATAATCATTAAAAGACCAAGTAAAATGCTTTTGAAGAAGAAGGAATTGGGTTAGAGACTATCCTGGTGGTATACTGTTCTAAGAATTTCCTATTAATTCAACAGTTATTTTTTCTTCACAAAACTTTTCTGATTCCAGTATTTCTCCTAATTATCAGTTATGCATACTTAGAATAAGGGATTTCTTTGGTACCTTCTCAATATGGGTAAAAACAATCATAGACATTTCATGATTTCAAAATCATGTTCTTAAATTTGATATTTTATATTTACTTCTGCAAAGATTTTCCCATTGTGTGAATATGTTTAAAGGACTCATACTGTACATCTCTTGTTCCAAAG
>TTN-202,,0,535,968135,968669,GCAAGTAACATAGGATTTGTCCTTTTCAAATCATATTACAATCTTGATCGTTATCGTTTTAAAAGACAAACGATATGGCCATTTTGGATACCATAAATTTTCATTTCATAAAGTCATTCTAGATCCTCTAAACCTTCCTGAGACACATTCCACAAGGTACAAAATTGCTTATCAAATGCGTTTATGCAAAAAAGCCATTTCTTAGGTTAAAGCTCTGTGAAACAGCTAAATCAGACACTGATTCTCCATTCGTCTTTCACCCTTCTCCAATCAGTCTATTATGCTGCTAATACATAGCTATGCAAACTTCATACTACTAAAGCATAGAAAAATCATTTCACGATGTACATGTCCAGTTGGATCCCAGGTTCCCCTAAATAATCTCAGGTGTTTTTTAAAACAGAGGTGCTGCATAACTGTAAAATGTTTGGTAGCCATTCTTTTGCAGGGTGAGTAAGCAATGATCTTGTTCAGGACTTCTTTTCCTTGATGATGTCATCTATATTTTCTAACCCAATCATAAATTTGTCTTTAG
>TTN-202,,0,91,968670,968760,GTAAGTTGATTTAGAAACACTTTTCAAGCAGTCAGCCCATGGTTACCATTAAGTTAACCCTATCACTGAATTGCTCCAATTTTCCTCTTAG
>TTN-202,,0,120,968761,968880,GTAAGTATCAGGCAGCCCCCTACAGCCCTTTCCTTAATGAACCCCATGTATCTATTTGTTTGGTTTCATCTACTTTTTAAACAAATTGTATTAACTGAAGTGCTCTTTGATTTTACCAAG
>TTN-202,,0,745,968881,969625,GTAAGTTAAAAAATATATATATATATATACACATATATATAAAATATCAAATATTCAGTAGATTCATTGATATTCTATATCCTACACTTTGCTGACCACTCAAAAATCCTTGATTGGGTGGGCAGGGTGGCTCAAGCCTGTAATCCCAGCACTTTGGGAGGCCAAGGCAGGAGAATCACTTGAGATCAAGATTTTGAGACCAGGCTGGGAAATACAATGAGATCCTGCCTCTAGCAAAGACAAAAGGAAAAAAAAAAATTAGCTGGGCATGGTGGCACACACTTGTAGTCCCAGCTACTCAGGAGGCTGAGGTGGGAAGATCGCTTGGGCCCAGAAGGCCAAGGCTGCAGTGAGCCACAATCACGGCACTGCACTGCAGCCTGGGCGACAAAGTGAGAACCTGCCTCAAAAAATAAAGAAAAAAAATTGTTAATTGAAACATCTAGTATGTGGTTACACTGAGTAAAGCACTAGTATCTCCACCTGGATAAAATGTTCCAGTTAGAGTAGCATTGAAAGGCTACCTGGAAAGATGCCTCAGTGTCTATCACTTGATCTTTCTGTTCCTCTGTGAGTTGGCACTGTCCTGTATAGTACATGGAAGGTATCAAAGCTTATATCTCTAAACTGTAATCTCCTCAACAGACGCACTAAAAACATTCCAAATTTTTATTCTGCACCTGTTATAACCCACATCATATTTACGTAAAGTCTCCTTGGGTGTTTTTTCTTTTCTCCTTTGCAG
>TTN-202,,0,517,969626,970142,GTATGGTTTCATACATATTAGATCCATAGAAAAAATGTCATACATGCTTTATAAAATTTAGTGTATCAATTAATGAATGGATAAATAAAATGTGGGATAGCCATACGATGGGATATCATTCAGCAATAAAAAGGAAGCACTACGATATGCTACAACATGGATGAACCTTTAAAACTTTATGCTAAGTGAAAGAAGCCAGAGACCATACAAAGACCACATATTGTATGATTCCATTTATATGAAATGTCCAAGATACACAAATCTATAGAGATGTAGATTGGTGGTTGCTTAGGTCTACAGGGGAGACAATAGAAAAGTCCTTGGGGTGATGGCTAAGGGTTACATGATTTCTTCTTGGGGAATGAGAATGTTCTAAAATTATGGTGATGGCTACACAATGATGAATACATGGAAATTCATTGAATTGTATACTTTAAATTGGTGGATTGTACAGTATGTGAATTATATCTCAATAAAGCTGTTAAAAATGTTAATTTTTCTACATGCTATTTTCCAG
>TTN-202,,0,89,970143,970231,GTCAGTTGTTTTGTCTTGCTACATTCCAGTAATTCCCAGTTTCCTCTGAATCACCATACGGTAAACTCGAATTTCCATTTCATCCATAG
>TTN-202,,0,1146,970232,971377,GTATTGTCTACATACTAAATGTTTTGAAAAATCATCAGTAGTCCATAATCTATCATTTTATATTTTAATGTTTCCCTTTTACATTTTCTAACCACCATCCTTTAAAGAATTAAATCAGCTCATTCTTACTTGGCTTAGACTCTCTTATGCTGACCTCAATTTAGTCACAGTTTCCACTCAGGGAATAAGGGTGTCCCTAGCAGCTGTCTAAATACGTTAATTAAAGCAGCTGTAGAAATTTCACTGTCTAATAAATGGCTGCTTGCCAAGCAGCACCAACCAGAAAAGAATTAAAATGTAAATCGTGAGGTTCACACATCAATTAGAATTAAGGAAATTTAGAACAAGGTGATATTTTCTCAGAAGGTTTCTATCTGTGGAGAGGCAAGTGTCAAGGAACTTAGTGGCTAGAAATACTTTCTGTGAAGTCTAAGAGAAAGCCCTGTCCAAGCCGTGCTGGGTTCCTGGCAAGGATGCTGGGCACTCTTGCTGTCGGCTGCATTTACAGAGCTTGTCCTCATAAGTGTCCACCATCCCAAATGATATAATGGAGGAAACATGTCTAGAGAAATACCAGTTGAGTTCAGCTTTATCATATTGCTCATCCAAAGAAAACCAGGCTTTACAGACTGTGGACTATAATGAAAAAGGCTTCAATGAGGACTCAGATAACCTGGAGATGTCTTCCATCATTTATTTGCCAATTCTGAACCTCAGTGTTCTCACTCTTAAAATGAGGATAATAATTCCTACCTAGCCCACAAAGTTATTATTCATATAAAATGAAATCAAATTAAGTAATAACTTTTTAGACAATAAAAAGCCCCCAAAGGTAAAGCATCATTATATCCCTTATTAGTAAATAAGAAGCAAACATTTAAGGATGAAATAATTGTCTCTTTGGGGCAGCTCCTTTCCTCCATGCAGCTGTAAACACAATTCTCTACAAGAGAAGTTTATGTACCATTTGTCCAATACTAGGCAGGAAAAATTAGAGAGTGCTATAATCAGCCAACTTATTACATTATAATATATTGGTTTCACATGCCATTCATTGACCAGTTTTAGAAATTGATTAACTGGGAGGAAACCAGAGCTTCAAGTTTTTGTTGTTGTTGTTGTTTTTTTATGTTGTTCCATCAACAG
>TTN-202,,0,1569,971378,972946,GTATGTAGGGACAGATTTCAGCATATTTTGTGGATCCATCAGAAATAATCCTCCTGTTTAAGTCACTAAATTCTTGTAACTTGAAGGAAATTTCTAAAGAACCTATGGTATTCATGTGGTTCCAGCTACATTTTTTTTCACATTATATCTATGGAAAAGGGAGGGCAGCTGTTAAAAGACCTATTGAGAAGTTATTTTCAGAAAGCACCTGATGGCCAGATCCTCATCTGGTTGCTCAAAACTATTGAACACCCATTGGGTGTCCATTTTCATATACCCCAGATGAGCTTCTAGATTCGCTGTTAAACTATTTTAGTTCTCTGCCCTCTGCCTGAACTGCTCAAGTCCTAGCAGCACTACCAAGTGAAAGGGGTGTTTCCAGCCTCTGATATGGAGTGCCTGGGAGAACTCAAAAGTCCTCTTTGAGACCCTGGAAGGCCTAGAGAGCCTCAGGCAATGTGGAACTCGATCCTCTCTACCCCAAGCTCTAAGAACAGGGGCTCTTACTTTGGACAGGGAATTCCACATGCTACCAAGCACTCCTGAGGAGCCTCTGAGCAGTCCCCAGGGAAGTGCTGTTAAACCTCTGCTCTCCTCATTAGAAATCTTAAGGCTGAATCTCAAGCTGACCTTGTTTTGAGTCTAACCTAGATGCAAGAGAAAAATGGAACCTCCCTTCCTATTCTCATCCTAGGCCATATCTCTTTGAATAAAATACCCCTGAGGCAGATGCAGGAACTCCAGGGGTAATCTCAAGATTCACAAAGATGAACCATATCGCCAGCATTCCCTAGGTTCCTAGAAGACCAAATGGTCATGGCATCCAGTTCTTATTATCTCTGTATTAGTAGTGGAGAAACTGAGGCACAGAAAAGTAAAGATCTTTTCTATGATAGTGTCAGAAACCAGCCTCACAGAAGTCATTTCTTCTAATTTCTGGGTTCCATGAACTAACCAGGTCCCCTCACTCATCACAGCACTGAGAATATGCTTTAGTTAGCAAAACAGGAAAGCTGAATTTGTTAAGTCTACCTAATGGCATTTAACTAGATCTGAAATAGTGTTAATTCAGTCATTCATTCAATACTTACTGATTGCATTTTACTGGCACTGGTACATAACAAAATGACTATGACATAAACACAAATACTTGCAAAACAAACAAACTGGAATGATATGAGCCTCTTCACCACATGATTTGTCCAAATGAATTTTAAAAATAGGTAGCACACGGAAGTTATTGTATAATTCATTCAGGTGTCCATCGCTAAGCCCCCACCACAAACAGAAACTGGGATAATCAGGTTAACTCGGCACTCTCAGCATGCCCCCCAAATATCAAAAATATCTTTCTGAAGCTATTCCCTCTGCATGTGGACAAATTCCAAGTGCTTTCTTCATTCTTAGCACAAAGAATGTTCTAATATTCTGAGGCAAGTAAAAATACCACAATTCCAAAATTTTGTCTCTGGATGTATAACTAGCCAGCAACAAATTAATGTAGAGTTTTGCATGCTCTCTTGTGTTTTTACACTTTTTCATGGGCTATTTGTCAACATTTACTCCTAG
>TTN-202,,0,224,972947,973170,GTAGGAATGCCTCGCTACTTCCAGCTGAAAATAAAACCTAAGAAGCAGGCTTTTGTCCTTTCCCAGTGCATTTAAAAATACAATTTGGAGCTCATAAAAGTAGATTGCTACCCAACTTTGAAAGCACTCTGCAGTGAAATAAATTAAGATAAACCTACATGCTCCCTTCTGTGAGGTCTCTATGGTGACTTAATCATGACAAATCTTGTGGTTTCTTTCTTTAG
>TTN-202,,0,5004,973171,978174,GTAGGTTTAAGAACAAAAGGTGTCATTGCCAATACTTACAAATAATTACATGGGAAAAACATTCTGTCAGCTTCTCCTCCATCACAAACATCTCTCATGCATAATTTGAAGCTTAATGGAAATCTAACAGAAAACTTATTTCAATTATTAAATTAAGAATTAGATAAGTGTTTTTCACTATTTTGTGCCCTTAATAATGGTTGTTTATGTTATGTTATGTGTTCTTTATCACAATAAAAAAATTAGTGTTTTTCACTAATATTAAAAAAGGTCATGTTCCCTTTATGATTGTAGCTGCACTTTAATTTCTTCATTGATAAAATACAATGACAAAACTAAAATTATTAGATTATAATAGCATCTACATATAATTCAAAAGAATAATACATTTATATAAGACATTATTCAGTCTATGGACAATGCTTGTGTGAAAGGTATCCTTTGGAAGACAATATCCTATAGTGGTCAAAAGTCGGGGCTTCATTGTCAAAGATGCTGAATTTGAATCTTGCCTTCAATATATATCATGTCTCTCGTTCTCCTTCTGTCATGAATACATTGAGTATATGATTGCATTCAATCCTAGAAAATATATTTTATGAGGCTAGGAATTCCGTTTTAGTGCCTAGAATTTGGCATCTGAAAAATAGTACCTGCTAGAAGGTAAGCTCTATGAAAACAAGAGTGGATGGTTGCCCCAGAATATCACCTGATACATAGTAGATACTCCATAAGTAATTGTTGACTGGACTAATTAATGATGGTTAAATGACTGTTACCAAACACTTAAGATTATTATCAAGATTAAGTTAGGTAACTCAAGTCAGCACATAGCACAGTGCTCATCATACAGTAATCAATCAGAGTTAGCTGCTACCATTTTTAATTGGGGCATGCTTCTCAAGTACCACCAGCCAATTTCCTCATCCCAGGAATCTGATCTTGGTAGAATGAGACAATATATGTGGAACCACTTCAAGTCATAACTGATTGTCTATAATCACAATTATTTGAGAGTTTCCCAGCCAAAGGGAAACTCTCAAAGCTTGGGCATCTCCCAGCCCTCTTATTAGGCTGATGCAAAAGTAATTGCAAAGTTGTATTGTTTTGTTTATTATGCTTCTCCCATTAGTTTATAATCCAATCTCTACCTTGTCAAGATTTATTTTTCTCAACAGGTTAGTACTTCAGTTGGTCTTCTGACCCAATTATTTCCTCCTCAGGAATGGAGATGGTGATCTAGAAATCTAATAGACCTATTTGATTTTATGAGCATAATTAAAAGATATAATGTATGTAAAGCACCTATAGGCATGGCTGCCAGGTAACTGGGGCTCAATACATTCATTTTATTATAGCCATAGAGAGGAATTATATAAACATCAATGTTTAGTATTGTATGGCCAGTATGGACAAATACCATAGACTGTATATTTGAGGGATAGTGTTCAAGAAATGCTAAATATTAATAAATGAGGACTGATTTGATAATATCCTACTAACACAATAATACAAAATATATTTTAAAAGCAAGTTCATTAAAGCTACACTAAATAATTTATCCATTTATTTAATTTTTAGAGGAATTTTTTAATATAAACATATATGTACATCATTCAAAGTAGTAATATTTGTCTTAACTATATTGGTATAGTGCTTTTAAGTCTATAACATATTAACATATGGTAGTATTGCCTTTAAAGTGTTGTAGAAATACACCTGAAGCACTCTACAAGACACCAATTGGGGTAGAAAGAGAAAAATTTCACTATCTTTTCTGCATAACCAATGTCTTTAAAAAGGTTTGAATAGGCTTTGTAAACTGAGAAGATCATTAACTTCCTATGTGTGGTAATATCTGTACACATATAGTGGTTTTAGCATCCTCTTATAAATTTGTTTTCTATATGAAAGAAATTAAATTCATTAAATAGAATGACCCTTCAAAAACTTGCCAACTCACATAGTTTCATACCACTGGGACTAAAAATATTTACAGAACTTCCTCTGGCCAGGTATTGCCTTAAGTAAGTGTAGCCCTGCTTTCCACAAATTGGAAAGAAATTGGGAGTCTTCAGAAGCTCCCATGTTCTTGGGGGTTGTAATACTTTCTGAAGCATGAAACGTGGCCCTGAGCAACCAGGTGCTGTTTCTAACAGCGAAAATGTTACCTATTGAAGGTCTCCAGTGCCACCTACTGGTAGAGGAGTAATTTGGAAAAGCAGAATCTTAAAATGTAAAAAAGCTATTTTTTTGCTGTTTATTCTACAGATGATGAGTCAGTGTCATTTGGAGGCTTACAGAGTGACAGCTAGCTAAACAGAAATGATGAATAATTAGTTTAACAATGATATTGTCTGTTATTCATTTAAGCATCTGTGCAATTTTAATTCTACCATTTATTGTTTCCCTGCTATTGAGATATTACCCTAGGTGCTGGGGTGCAGATCTTGCTCTTGCCTTTAAGGAGCTTGACATGTAGGTGAGGAGATGCATGCACACAACTATATCCCAAGGTTGTAAGTGCTATTAACAGGCCCACGTACTCATCATTCTCTGTCTGGGAGAGAGCCAGAGAAAGATGTGTGAACTGAGCATTGAAAAATATGTAGGATCATTGAACACAGTGGCATCCTATGATGAGAAAACAACATCTCCAAGTCATCAAAACTTGCAATAATGCTTCATGTGCTAGAAGCAAGTGGTTTAAGTACAGTTGGAAAGTGATATCATGAGTGGGTAAGAAGGCTGGATAATACAGCAAAGGCCGTGCTAAAGTTTTTGGTATTCTATGCTGAAGATTTTGGAATTGATCTTGTTTACATTTAGGAGACACTGCAGGATTTTTAAGCCCCTGGGTACCATGATCAGGTTTACTTTTTAGAAGTGATACTGTGATAGGGAAAGAAGGGATGGACAGATGTGGGAGGCAAGACTGGCAGTCAGGAACTGGAGAGAGATTATTACAATAGGCCTGGAGAGCGTGGATGAGGCCCTCAGCCAGGGCAGTCAGGAGAGACAAGTGGGGTATTGCAGAAGTAGTAATATGGGAGAAGAATGGCCTCAAAGAAGACACGAGAGGCTAATGAGTAACGCAGATCATGGCATCACAGCCACAAGCACCAAGTCCACTACCAAGAAAAGTTTTACCTGTTAACTCACTTATTGTGTGCAGTTCATGTCCAGTGGCAGTTCATGTGTATCCTGGTGCCTCATTCAGTTCACCAAAGGAAGAAGCTGTCAGTAGAAATAAGCAGAGAACCTTGTAAGAGGATGTACCATTGATGATCTCACACACACACACACACACACACACACACACACACACCCCTTCACACAAACTAAATAGGGGTGGTGTTTCATGTTATATCACATGGCACTGTCTTTTGGCGTGTTATTGAAGACAACGTTGCTTCCATCTGTGATGTTAGATATTCTTGCTATAATGACTGACTTGTGCCAGTGGCTTATAAAGCCCTTCCATGTGTGTTATATCATTTAATTCTCACAGCAATTATATGCAACGAATAGCCCATAAATTATTACGCATGCCATTTTACAAATGAAAAGACTAATCCAGAAAGCTTAAATGACATTTCCAAGGCCACACAGCTGACAAGTTGTAGTGTCAAGATTTCATTTTCTTTATATGTATATATTTTGATGGAGTCTTGCTCTGTCACCAGGCTGGAGATCTCGGCTCACTGCAACCTCCCCCTCCCGGGTTCAAGCTATTCTCCTGCCTGAGCCTCCTGAATAGCTGGGATTATAGGTGTGTGCCACCACACCTGGCTAATTTTTGTATTTTCAGGAGAGACTAGGTTTCACCACGTTCGTCAGGCTGTTCTCGAACTCCTGACCTCGTGATCTGCCCGCCTCAGCCTCCCAAAGTGCTGGGATTACAGGTGTGAAGCACCGCGCCTGGCCAGGATTTCATCTTCTACTTTACCTTACTATCTAAGGAACTGAACAGATTTGTTACTCTAAGAGGAGAACCTGCCATTTATACACATCTACCATCATGGGCAGGAGAGTAACTTTTATAGACAAGTATTGGCATTAAAATGCAGACAAATGCTAGATGATTGGACTATTAGAAGATCATCTTGGATGGTTTTGAGACCAAGAAGTGGTATAGTGACTGTGCTCCAAAAACAAGATGGCTTTGATTTTGGCTATTCAAACAGTTAACTAAAATTAAAGTGCATATCACCTACAATTATTACAACACAATAACCTGCTACTTTACTGTAATTTGGGTTTTTACTTTCTATTATTTTAAGATGGTTCAAATCCTTATATAGAAATAGCTAGCTTTATTATAATGTCTTATAACTGCCACTCTGAAAAGAGTCAAATGTATCTAAGATGCTCAAATACCATAATAAATCACCCTCTTTATTTAAAAAATTATTTTCTCTACAATTATTTGTGCCATATATACTGCGTACTGAAACCTTTTGCTCATTAGTAACAAAGATAGAGATTTTTTTTCTACAGCCTTCAAAGGTATCTATTTTAGACTTTTCATATCTTGATCTTCTCAGCTCTCTTTTTGATTGATTTTTCTGCAAACCAAAAGTGGAGATTTTTCTCATTTCCTGTCCCAGAAGGCAACTACAAGCCCAGATCAAACCTTTCCTGATGACTCTTCTTAGGACTGTCTTTTTCTCAAAGTCACTGAATATGTCAAAATCTTGTCTCTGCTTCCACTGCATGACATGCAAATGTCTAAAGAGAATGTAACTGAAGTTCTATCATTTTAAACATTACAACCAGTTCAACCTTAGGACAAGCTATATTTTTCTATCATTACATTTCCTTCTTGAAGATGAAAGGAAATCATTTAACAATAGTAGATATGGCATGCCCAGAGAAAAGTATCATGTTATTAAGTCAAATATGAAATGTAGGCACTAGTATTATTAACATTGTGTTTGCAGGTAAATTGTAAAAATCCACTCATTTTTGTGGTTGAAGTATCTCTTTTCTTTTGTGTCGCAG
>TTN-202,,0,5803,978175,983977,GTAAAGTAAAACAACTTTCAGAACCCCATTTAAATATAGATCGAATCTTAACAATGTCTGTAACAATTACTCAAGAGTTCATGTAAATCATTGTTGTTCCTACCATTCTCTTCTAATTCAACTAATTATTTCCCTGTTATATGCCATGGTCTCGCCTCTCCTTTACCACTTTTCATTGTGAATCATAGACCATCACGTTTCATTTGGCCCCGCTTTTTCTCTGTAACAATTTGTAATGTATTGCTGCTGTCACCAGCTGTCATGCTTCCTAATCAGCATGAATCAGAAGGGGGCGAAATATGCTGCATAAATAGGTAGATTTGTTTTCTCAATTGGCTAAGATAAAAATTAAATTTTAAAAACATCTAAGAGTGTTATCATCCTCCTATCATGCTGACACAATTTTGATTTCACAAAAGCTAGACCGTTTCAGGTCTGTACACCAGCGAGCTATATTCATCCTCCTCTCAAGAATGTCTTAGTGTTAAGAAGTCCAGTCCTAAAGTGGTTTAACATTTCTGTTAGTTGGGGCTCTTAAATTGTAATCAGAAACACTTCCTCAGTAACATGGGGAATTTGATTCAAACAAGGATAGCATTTTTATATAGTGGTACTATTTTTCCTGAGCAAATATAGTCTATGTAGTATTAAGTACATACAAATACATAAGGATTTAGAGAAACTATTTTTTTCTTAACCTTATGCATTAACTGTAACTAGATGTTTTTTTAAATAATGAATTTAAAGTGGTTTAAAATTAAAAAGTTGACTTTACAACAAGAGGAAGAAAGAAAAGAATATCCAAAACCCTGTTGGGTACTCCACTATTGCCTTCATGAACAATGTAGTGAAGTTCCTTAGCCCATTCATGTCTCAGCTTGCTTCTCTGGGAAATGGAAGTGAACTTGTGTGACTTCGAGTCAATAGTGACATACAAGGACAAGGCAGTAGGAGTGGACTGAATTCTAGTCCATTATTGAAATTTGTGACAAATCTGTAGACAACTCCAAATGAGTTCTGGTTTCAGTGCAAGGTAAGACATTAAAAATTGGTATGCTTCTTTTCAGGATTTAGCAAATTTGAAGAAAATACATCAAACTCCCAATGGCATGTCTCTTTATCAGTTTCATTTAAGAAGGAGCCCCTTGGCCAAAAGCCCAGCTTCATCCAGCCTCTGTCAAGCCTCAGGGTGCACAACGGGGAGACAGTCAGATTTCATGCGAGGGTTTCTGGCATTCCCAAGCCAGAAATCCAATGGTTTCATAACCAGCAGCTAATTCTACCAACAAAAGATGTAGTTTTCCATTTTGAGGAGTCCACAGGCATGGCTTTAATGCTTATAGTTGATGCTTACTCAGAGCATGCTGGGCAGTACTCTTGCAAAGCAGCCAATAGTGCTGGGGAAGCCACTTGTGCAGCTACACTCACAGTGACTCCAAAAGGTAAAGCCCATCTTGCTTCAAGGACTTTGATTTGCTGTATACCTCTCAGTCCCACTGTTACTAATGAGAGTCTCTGCTGTTTGTTTTATTGCATACTGTGGTCAGTCCATAACTTACTAATAAAATAACATGCAATAACTCCCGCTAGGTCCTCAATTATGGGTTAACCTACATACTTTAAATTTCACTGAAGTATGTGTTCTATGCACTAGAGAACCAATAATTATTTTATTAGGCACCACCTTTGCTTGGCTTCTTTACTCTTCTAAGCAATATTGTATCATTGCATCATTAAATGATCTATTTGCTGATTATTACTTACTGTACTTAAAGTAAGTACAGTATTACTTACTGTACTTAAAGTAAGTACAGTATTACTTACTGTACTTAAAGCATACAGTGGACGGAGAGCAAATGCTAACCCAAATACAGTCAGCTAGAGGGAGAGAGAGAAAGACAGACTGGGTCACTTTGGATAGCTGAAATGACAACAGAAAGAAGGAACCAGATACTGCATGGCATCTGCATGAGTCTTCATCAACCACTCAGCACTGAATCACCAGGAATGAATTTTCTTTTGTGTGATCCTGACATCTAGATCATATTGCATCTGGCATGCTGCTTTCAAGTGACAACTACGTCTTTCATCTTCATCTTCCATGCCATTTTGTGTTACTAACATGGGCAAGTGACAAAGCTTAGATCTTAATATTCTTTTCTTTTTCTTGTCACTTGATTATACAGTGCAAGCCCTAGATAGGCAAAGTTCTGGGAAAGATGTAAGAGAGTCCACCAAGTCCCAGGCAGTGGCAGATTCCTCTTTCACAAAGGAGGAGAGCAAAATATCTCAAAAGGAAATTAAGTCATTTCAAGGATCATCATATGAATATGAAGTGCAGGTTTTTGAAAGTGTATCTCAAAGTTCCATCCACACAGCTGCATCTGTTCAAGATACACAGTTGTGCCATACTGCATCCCTTTCACAAATTGCAGAAAGCACTGAGCTATCTAAGGAATGTGCTAAAGAGTCCACGGGTGAGGCGCCCAAGATTTTCCTGCATCTTCAGGACGTCACTGTAAAGTGCGGTGACACGGCTCAATTCCTCTGTGTTTTAAAAGATGATTCTTTCATTGATGTAACCTGGACTCACGAAGGTGCAAAGATAGAGGAATCCGAGAGACTGAAACAATCACAAAATGGAAATATTCAGTTTCTTACCATATGTAATGTTCAGCTGGTAGACCAAGGACTATACAGCTGCATTGTACACAATGACTGTGGAGAGAGGACAACGTCAGCAGTACTAAGTGTAGAAGGTGGTTAATTGATTTTTAGCTATGACTTGCTTCATTTCATCCTCATCGCTTTATGCAGCTTTTCTGCCATGCAAATTCAATCGACGAATATATTAATTAGAATATCTCTAAATTAGCACCCTATTCATAAGTGACTTCTGAAAGTCAGCCAAGTCATTGGCCATGATTATCCTGAAAATTTAACTTACCAGTCTAGATTCAGAAAGTTTAATTTTTAAACGTAGGTTCGGGAAGCAAAGGTTTATTTCCTATGTGCTGCATTTTCTAATATTTACCAACGCACTACCAAGAAAGTGTAGCAAAGTTAAAATGTTGTATTCTGAGAAGTACTTATTGGGTATTTATTATTGTGCCAGATACTGTGGTAAATTTCAGTTTAATTGTTTTAATAGCAAGAGGTTCAACAATTCTTATCTCCTCTTTATTTTCACATCTGGAGGTTCTAGTTGTTTACAAAGGGGCCATGAAAATAGAAAATTGGGACCAAGTACAGTGACTCATGCCTGTAATCCCAGCACTTTGGGAGGCCGAGGCAGCCAGATCACTTGAGGTCAGGAGTTTGAGACCAGCCTGGCTAATATGGTGAAACCCCATCTCTACTAAAAATACAAAAATTAGCCAGGCATGTTGGATGTTGGTGCATGCCTGTAATCCCAACTACTCAGGAGGCTGAGGCCAGGAGAATCGCTTGAACCCAGGAGGCAGAGGTTGCAGTGAGCCGAAATAGGGTCACTGTACTCCAGCCTGGGCAACAGAACTAGACTCCATCTCCAAAAAAGAAAAATAGAAAATTGAAAATTGGGCACTGAAAATAACAAAGCTCTCTCTGGACCAAAATTAGAAGTCTCTAGATATTTCTCCATAAATGATGCTGCTTTTACAGGCTTAAAATCCTCCTGGAATTGTATAATTTTCTCATGGCAAGATCACAATTTTTGTCGTTATTGGGCTTGATTCTCCATTATGTCTGGAAGAGCAGGAATAAACTTGTCTGGGCAAGTAATAACTTCTTCCTCTTATCCATGGACTTTCCTTTTGGATATTAATGAAATGAGAAAAATATTTTTCAGGTGCCATAAGCCTGTGTTGTGTGCCCGTAGTCAAAACAGCTTCACTGAGTCTCATGGAAGGAAGCTGGTGGAATAAATTCAGGCATCTCCAGGGGTCTGTGGAAAGCTCTGGCCTCAAGTTCCTCCCTGATCCTGGCCATAGTGGTGTTAGGGATGAAAAGGGGGCAATGCAGTGCTATGTAGGTGCACAGCCATCTCTGCACAGAATTTTGAAACAGTGGCCTTTCTTCCTACCCAGTACAGAGAATACAGTTTATTGATTCATATAATGTATCCGCAACACCTACTCACCAAAAAGAGGTCTTATTCTTTCTTAATGAGATTTTGTTCTATAGCTATCTCTCATTCTGTCACCGTAGCCTACAAAGGCAATATCTCAAGAACTGAGGTCTAGTTATGTAAATTAGATAGAAAATTCCACCAGCCAGAGAGTTGACCCTCAATTTCACTACAGCTGCTGGCTAGCACAGTAATCACACAGAGTCACTATTTATTTGGAGGTGTTGTCTACAAGTCCTGTAGGTGACAGTGTGACAATTTTTTCAGTAATGTAATTGGGAGTTGGCTGTGTTGTGAAGGTGGGAGAAATGTAGATCTCTTAACTCACTTCCTAAAGAATCTAGTGCTATAGTGCGGTGTTTGACTGTCATATTCCCAGAATTGATTTGAACTCGGCTCTTTTGCCCTAGGATCTCCAGTTCATTCAGTTCCAATTGATAATATTATTAAAGTGTTCTTGAAGCAAAAGAATTTTTTTGAACATCCAACTGCCTTACTTGTACCTAAGAAAGTTGAAAGATAAGACATTTTTAGATGTTTGAAGAGTGAAAGATCAGGCACAGTTGTCTAATTATTTGACATAGGCCAGTCTTTATATGTTCCTTTTTTATTTTGGCTTAATAAGTTCATATAGGCTACAGAGTTATCCACCAAGATCAAGTAGGAATGTCAAACCCCTGGAAGTCTTTTTGAATACAGTTATTATGTGCATAATAAACATAAACATATCATATATAAGTTTCATGACTAACATGCTGCCTTTCCTTCTCATCCTAATGACATTCCATCTTCTCCACATTCAGCATGTTTTTCATTCTTACAAACACAGCTAATTTATGCCTTTCCCTAACTTTATTCTTACCTAGCAAAAGAATCGCAAGCCAGAGCACTTACAAAAATTACTCTGGGTTCTGACACTAAAAGTATTAAAACACTCAGAGAGTCACAAATTAAAACAACCCGTGAAGTAAAAAGAGAATCGTCAAAGAAAACATCAAGTTTGTCATTAACTTCATGCCAAAAACCGTAAGAAACTGAGAACAAGGGAATAAAGTCTACTGACAGGATACCACGTGGACTGAAGACTGAGAGTGATACGAGAGCCCCAGCCTTTCCCAAGGAGCTGCCCTAGATATGACTGTGTCTAAAAGCTGTGCATATTCCTTGTGGAATAAAAACAGTTTTGATAAGTCTTTGTTTTGTTTCTTAATATGTAATTTGGACTTCATGTAGTTCAAAGTTTGAAAGGTGATTCAAATCAAAGGAGTGTTTACTAGCAGGAAAAACTGAGAATAGCCCTCTGCTAAAGTAGCAATTTAGAAAATGCATGTTCTTTCTAAATGTGATTTCATCTCTTAGCAAGTGTTTAGTCAATAGGACATTTTTTAGAAAATAATATTCCTTCGGTTTGTAGATTGCTTTCTGCATGCATGTAAAGGCATGGGGAATTATAGAACTAAAAGTGGAAATTTCATGAAGAACCTAAAATAAAAATGTTTTAAATCTTTCTGTCAACATTGTCATGTGTTTTATCAGCTCAATAGTTTGTTTGGCATGGACTTTTTGGTAAATTTGGGGAATGTAGTTTTCTGTTGTTATAATAAAAAGAAAACTTTAATCATACAAGTCATGAATTGATGCAGAAAATATATGCAATTAATCACTAAAATCTCTTTATATGTTTTTCTATTTTAG
>TTN-202,,0,14763,983978,998740,GTATTGTTATAATGGATGTGAGATTTAAGTAGAAATTCTAAAGGATTAATAGGATCCTTGAGTTGCCTTCTTTCTCTTAGTATTATTGAGAAAAAAATGACATAGATATACAAATATATCTCTTAGAGTATATATTACTATGTCGCATGCTTGGTTTAGAATTTTGATGGTTACATGCATTTCACAGTAATTTATTGTAAGTTAATTTAAAATTTTGTATTTAAAATTTATCAGCCAAATTCAACTTTATGTTTGCAGTCATTTCCAAAAGTGTATATTAGGAGAAGTTGTCATCTTAATGCATGAAATCATGAAGTAGAAGTTTGTTTTCAAAATCACGGTGAATTACATTGAAAATAGACAATAACCTAGCTGTCATTCTCAGAATGCAATGTCATGAATGAATTATGATTGAAATGCTACTTTACTGAGGTTGTGTGAAAACATTACATTCCCATCTGGTTTACACTTCATTCACATATATCATTTTAACATTGATATGTCTCTTACACTGGCTTGCAGATAGCTGCCTTATGTGATCCTTATTGCCTGCTTTTCTTTGCATAACATTGTGACTTTATGGCTGTATTAGTTCGAATAAACGCCTTCTCATTTTATTTTAGCTAATTATTTATGGTTATAGTTCTTGTATATACTCTTTAAATAGTTGATTCTCAAAAATATAATAATTTAATCTACAATCAAAAGAATCAGAAAGGGCGTTTATTCCACTCTCTGCAAGTCAGGTAAGATTTTCCACTTAGCCATCAAAAGAACAAAGTTTTCCTGCTCTCAAAACAAATATGCACAGGAACATGTTATTTTGAAATGCATTTTTGCTTGTTCAAGAAGAAATTTCAACAGTTTGAAGAAAAGACCAGACAACGAACGATTTTCGTGTCAGAATCTTTTAAACAGAGCATGGTGTTGCGTTTATTCGAACAAATATGGTGAGTGAATTTTTCTATGGATTTGTGAGATCTGTAGCATGCAATTTATTTCATTTCCTATTTTGCAATTTTATTTACTTTCAACTTTTTCAAGTTCTATGGAAAATAGTAAAGGTTTTTTTTTTTTTTTCCAGAATTATTCTCTGAGGGGGAATCTGAACATTCAGAAAGGGATACACGTGACGCCTTTTCAGATTCTGAAGACATAGACCACAAATCCATGGCTGCTAAAAGATATGCAAGTAGAATATCATCTACAAGCTCCTGGCCTGAATATTTTAAGCCTTCTTTTACCCAGAAACTTACATTTAAATATGTTTTAGAGGGTGAACCGGTTGTTTTTACATGTAGATTAATTGCCTGTCCAACTCCAGAAATGACTTGGTTTCATAACAATCGGCCCATCCCAACAGGTCTTCGTCGGATTATAAAAGCTGAGAGTGATTTACACCATCACTCTTCCAGCTTAGAGATTAAAAGGGTCCAAGACAGAGATTCTGGAAGTTATAGGTTACTAGCAATTAATAGTGAAGGGTCTGCAGAATCAACTGCATCATTGCTTGTTATCCAAAAAGGGCAAGATGAGAAATATTTAGAATTTCTGAAAAGAGCAGAACGGACACATGAAAATGTGGAGGCTTTAGTTGAAAGGGGAGAAGATAGGATAAAGGTTGACCTGAGGTTTACTGGCTCTCCCTTTAACAAAAAACAAGATGTGGAACAAAAGGGAATGATGAGAACTATACATTTTAAGACAATGAGTTCTGCCAAGAAAACAGATTACATGTATGATGAAGAATATTTAGAAAGTAAATCTGACATAAGAGGTTGGCTTAATGTAGGTGAAAGTTTCCTGGACAAGGAGACCAAAGTGAAGTTGCAACGTTTAAGGGAGGCTAGAAAAACATTAATGGAGAAAAAGAAATTATCTCTTTTAGATACGTCTTCTGAAATAAGCTCAAGAACTTTGAGAAGTGAAGCTAGTGATAAAGATATTCTGTTCTCTAGAGAGGACATGAAAATCAGATCTATGTCTGATCTAGCTGAAAGTTATAAGGTAGATCATTCAGCTGAGAGTATTGTGCAAAATCCACATGCCCTTTCTAATCAAATGGATCAAAATATAGAATCTGAGGAACTTCCCACAAGCTTTCAAACTATTGTTGATGAAGAAATTTTCCAGACTGAAATAAGAATGAGCCAAGAAGCACTGGTAAAGGAAAGTCTACCAAAAGACCATTTATATGGTGAAATTCTAGTAAATGAAAATACCCAAGCAAGAGGACAGCTGGAAGAAATTATGGCCAATACTACAATTGGAGAGTCATCCACATATATCACTAATGTATGTGAGAAGGAGGAAGTATATGAGACTCCTGAAAATGTGTCTCAAGCTATTACACCACATGCCAGCGAATCTTTTGGTACACTTGTAAATGTTGAAGAAAGTGAAGAAATAGCTAGTGAAAGAATAAAAAAGGATGATTTGAGAGAATTACAACTCTCTGCTTCTACACGAATTGATGAATTCAAAACCGAACAGAAGGAAGAAAACATGAGATTTTTTGAAAATTCTTTTCGAAAACGCCCACAACGTTGCCCACCTTCATTTCTTCAAGAAATTGAATCTCAAGAAGTTTATGAAGGTGACAGTTGTAATTTTGTGTGTCATTTTCAAGGATATCCTCAACCTATAGTGACGTGGTATAACAATGACATGCCAATCCCACGTAATCAAAACTTTATCATTCATTCGTTGGAAAACTATTCAATATTAACTCTTTCATCTGTTCATCATCAGAATGAAGGTTCTATTACTTGTGTGCTATTTAACCAATATGGAACAGTAAAAACAACCAGTATGCTTAAAGTGAAAGCAAAACAAAAACATGATGTCAAAGCACATAAAGTCCCAGTGTTCCATGACTACTTGGATGAGGAAGAAGAGTTAGCATTGGTGTTTGACCAAGCAAAAGGCGCCCATCCATCTATGAGTCAAGAGGGCCAAACAAATCTTCATTTGTTAAAAACTAACCCACCAGTTCCTCCCTCTGGAGACACAGAATTGCTTTCCTTTCCTGTAGAAATTCAGGTAACAGCAGCTACTCCTATCCCAGAACAGGATAAAGAGTCTAAAGAAGTGTTTCAAACTGAGGAGCTGGAACCTAAAGCAATGCCTCAAGATCAAGTTACTCAATCACCAAAACACAGATTTGTATTTTTGTCTGATATTACTAATGAACCACCAAAAATGTTACAAGAAATGCCAAAGCATGCCAGGTGTAGAGAAGGGGATTCCATCATTCTTGAATGTTTAATATCTGGTGAGCCCCAGCCAGTTGTAACATGGTTTCAAAATGGAGTCCTTTTAAAGCAGAACCAGAAGTTTCAGTTTGAAGAAGTTAATTGTAGCCACCAATTATATATTAAGGATGTTAATTCTCAAGATTCTGGAAAATATAAATGTGTTGCTGAAAACAATTCAGGGGCAGTTGAAAGTGTTTCAGATCTAACAGTGGAGCCTGTCACTTATAGAGAAAATAGTCAATTCGAAAATATTGGTGAAATTTATGGAAAATATTCCAGAGATCAGCAACTGCAAGACCAGGGAGAATCTGTAAGGGCACATTTTTATGATTATCCAGCTGGTCCCTTTACTCCCTGGACAAATGTAAAAGAATATTCAGTAAGGGACTATTTTCAAAGCCTTGAGACTATTGAGCAAATAGACCAGAAAGAGCAGGTGCGTTGCATACCTTCTAGAGAAAAAATTCCCAGATTTGTGCATGGTGCTTCAAGAACCATAAAAATCAGCAAGCCCATCAGGGCTGAATTCATACAATGTCAGGCTGAAGGGAAAGAGAGACATGTAAGTGAAAAATCAAAGCTGCACCAAGCAGAGGGTACTGTTTATCCATTTGTTGATGATTTCAGTGATGTCACTATTAAGAAAGAAATAAGAAATAATTTTGGAAAACTTGGTAGATCAGAAAAGGAAAATGTACAAGAATGTGCCCAAAGTGACTATTTACCAAATATTCACTCTGAGAGAATTTCTGACAGTTACAATACAAAAGATTCATCTGCCATTGTATATGAAGAATCCCTTGGTGAAGAGATACACTACCCGGGGAAAAAGGTGAAGCATAGAATTATCGAATTTGAAAAATTACATGTAGAAAAAGGAGTTCTAGAAAAAAGACCTACCAGAACATCAATTGTTAATCCTCCTCAAAAGAAGATTGATGACAAAGCCTTTTCATTAAAGCAAAGAGAATCAAGATCAAGCAATCTAAATGCAAATATGTATCAGGCAGAGAAAATGTCTCCAAATACTGAATCAGATTCATCTAACATTGCAATAAATTTAAAGCTGCTTTCCTCTCAAACTCATAAAGAATTTGACGCACAAGAAAGGGAACAACAGGAAAAAATAAGTCTTATAGATAAACCTGCAATTTCTAAAAGAGCTGAACATGAATCACCTATTACATTTGACTTAAAGCAGTTTCACACTCAAATAAAACACACAGATGTGAAATTCCAAGAATTAGATAGTGGTCAACCAGAAGAAGCTTATTTTAAAATCCAACATCCTGCTGACACTGAGAACATTGTATTTGATCTAAAACAAATGTATTCTCATATAGGAGATCCAGCTCTGGAGTTCCAAGGGCAAGAAACTAGGGAACAGCAGGAAATACATTATAAAGAAAAAATTCCTAGCCCTGAAACGTTACAACCTGACACACACAATATCTCTAAAAGTGTGCAAAATAATGTATTTGCCAGTCAAGAAATTTCTTCCAGTCAAGAGCTTTCAAATAGAACTATGGTGGAGAAAAGTAGTATTGATGAAAATTCCATTTCTTTAGAAAAAGAAGTCCGACATGTACAGGAACAAAACTTAGACATTTTAAAAACTGATCTTTCTCTTAAATCCTTTTCTGAAGAAATCTATAGTGAATCATGTGCCCTACTTCCAACCTCATCTGCAGATATAGAAGAAACTGATCTTTCTGAGAAAAGTTGTCCTCTAGAAAATGGAGGCAGAAGTTCCATCTCACATTTGAAAAAAGCAGCAAGTGAGGAAAAGCCTTTAGGGGTTGGTGAAATGGAAGAAGAATGCACTCTAGAACCAGAGTTGGCAGCATTTCCAAAGCAGGATGGTGGGACACAGGAATATACAGATGCCACTTTGGAAGACCACAGAGGTGATGTTCAGGAAGCTGACACACTCCATAGACAGCTCTCCCTGAGTCAGTGCTTCCCACTCTTGATGACTGAAGAACAACAGAATCCAGGTGAACAAATAAGTACAAACATTCATGCCTCTGGAGAAGAAAAATGTTATGAAGAAGTTCAAGTTCAGAATGAAGCTTCTTTCTCCACTTTAGAAGGAGAAATGATAGAAACTAGTTTTTCTCAAAATATTCCTAAATTAGATGAGGCACATACCACTGAGGCAGCAGAATCTGAGACCTCCCTAACACAATATTTACTTGCTGCTGGAAAGCGTGAGGTTCCTGAAACTAAAGACACCAGAGACCAGGCAAAGCTTGTCCAGAGTGAATCAATCACTTCAATGGAGGTGGAAGAAGTAACTTTCAACACTGTGTATGAATACTACAACCAGAAACAGGAATCACTAGGTCGTCCACTTTCTCCTGAGTCTGACATTTCCATTGGTGTGGGAAGTACAACCAGTGAAGAAATATCTGAGTTAGATCAGTTTTATACCCCACCATCATCTGTTGAATATTTTGAATCTCCAAAGTCCCCTGACTTATATTTTAATCCTTCAGATATAACTAAACAATCCTCAATACATTCAGGAGGTGAGACAGTTGAAAGATATTCCACACCTTTAGGGGAAGTTGCTGAAAGATATTCAACACCTTCCGAAGGTGAGGTAGGAGAAAGATACTCCACACCCCCAGGGGAGACACTAGAGAGATACTCCACACCTCCAGGAGAGACTCTAGAGAGATACTCCACACCCCCAGGAGAGACTCTAGAGAGATATTCCACACCCCCAGGAGAGACTCTGGAGAGATACTCCACACCCCCAGGAGAGACTCTAGAGCGATATTCCACACCCCCAGGGGAGGCACTAGAGAGATATTCTATTCCTACTGGAGGACCAAACCCCACTGGTACTTTTAAAACATATCCATCAAAAATAGAAAGGGAAGACGGTACACCAAATGAGCATTTCTACACACCTACAGAAGAGAGGGGTTCAGCTTATGAAATATGGCGTTCCGATTCATTTGGTACACCCAATGAAGCCATTGAGCCAAAAGACAATGAAATGCCTCCATCTTTTATTGAACCTCTGACCAAAAGGAAGGTATATGAAAACACAACACTAGGCTTCATTGTTGAAGTTGAAGGTCTTCCAGTTCCTGGTGTGAAATGGTATCGAAATAAATCTTTACTAGAGCCAGATGAAAGAATCAAAATGGAAAGAGTGGGTAATGTGTGTTCACTGGAAATTTCTAACATTCAAAAAGGAGAAGGGGGAGAGTACATGTGTCATGCTGTAAACATCATAGGGGAAGCAAAGAGCTTTGCAAATGTAGACATAATGCCCCAGGAAGAAAGAGTGGTGGCACTACCACCTCCAGTAACACATCAGCATGTCATGGAGTTTGATTTGGAACACACCACATCATCAAGAACACCTTCTCCTCAAGAAATTGTCCTGGAAGTTGAATTAAGTGAAAAAGACGTTAAAGAATTTGAGAAGCAGGTGAAAATAGTGACAGTTCCCGAATTTACTCCTGACCATAAAAGTATGATTGTGAGTCTAGATGTTCTTCCATTTAATTTTGTAGATCCAAATATGGATTCAAGGGAGGGAGAAGACAAAGAACTAAAAATTGATTTAGAAGTATTTGAAATGCCTCCTCGCTTTATAATGCCTATTTGTGATTTTAAAATTCCAGAAAATTCAGATGCTGTATTCAAATGTTCAGTCATAGGGATCCCGACTCCCGAAGTTAAGTGGTATAAAGAATATATGTGTATTGAGCCAGATAATATTAAATACGTGATTAGCGAGGAGAAGGGAAGTCACACTCTTAAAATTCGAAATGTCTGTCTTTCTGATAGTGCAACATACAGGTGCAGAGCTGTGAATTGTGTAGGAGAGGCTATCTGTCGGGGATTCCTCACCATGGGAGATTCTGAAATATTTGCTGTGATAGCAAAGAAAAGCAAAGTGACTTTAAGCAGTTTAATGGAAGAATTGGTCTTAAAGAGCAACTACACAGACAGTTTTTTTGAATTTCAGGTGGTGGAAGGGCCTCCCAGGTTTATCAAAGGTATTTCTGACTGTTATGCACCAATAGGTACAGCAGCATATTTTCAGTGCTTAGTTCGTGGCTCTCCAAGACCCACGGTTTACTGGTACAAAGATGGAAAATTAGTCCAAGGAAGAAGGTTCACTGTTGAGGAAAGTGGCACAGGGTTCCATAACCTGTTTATAACAAGCTTAGTAAAGAGTGATGAAGGAGAGTATAGGTGTGTAGCTACAAACAAATCAGGAATGGCTGAGAGCTTTGCAGCACTCACCTTAACTTAAAATGTAATGTTTTAGTGCCTCAGTAATTATTAGCATTGATCTGAGTGCTTTCATATTTTCCAAATTATGTGGATCTAATAAACTTCCAAACAGGTCCACCATATTTGAATTCATTACCTTGGAGACCCCTAAAGAAATAATCTCTATGTAGAAATCTCATCTTTGTAATACATGTAAATATTTTGTTATCTGAACTGTGGAATCATCACTTGTGTCAATCATGCTGTGTAATATCAAACACAATTAAATCTCTCCTTGGCTACCTAATTGTTTGTACTTCTATTTACCCTCATGCCTCCTCCACAAAGTGTTTCAGTGGAATGGACTCTCTTTTAGCAGATAAACCATATATGCAAAAGTACAATGTAAAAGTGGAGACCATATCAGATGACCACGCAGACAAATTGGTAAGGGCAAATCTCTCTGCTCCCATTCTAAGTTATTTTTGGAATTTTAACCCCTTTGCATCCAAACTCATGTTTATTTACTTTGACTTAGAATAGGCAAAACAAACAACAAAAACCAGCTTCTCCCAATTGGCAACTAACTCTATAATCTGTTTGACATTTCAATCTTAATATATTAACTTCATCTCTTTTAAAAATGTTTTCGTTATTAATATTCCTCTTCATAAGTGCTTTAATTCTCACTGGCTTCAAGGGACCAATTGTGCTCTTTGTGGGCAGGGTTCACCTAGACATTTGCAAAATAAGCAAATAGATCTTTCCACTTTTGGAGATACCTTATTTTTCTCCATTTTTGAGATGACATCAAGTGTAAAATGCAGCAATAATTTAGTATTGGCCTGGGGAAAAAAGGGAAACTATCATATTGTGTTTACATATAGATTTTAAAACTGTATTCTGATTTCAGAATCTTTAAAATTTAAAAAAAGGTGGGATATTTTTAGAATTGAGACAATATGGTAATTTGTATTTCAGATTATATATAAATAACAAGATAACAAGCTTTCCTATCAGTTTCACTGAATTTCATCTTTAAAACGAATATAGCTTAATAAGCATTCAATTTTTATTGTGATGTTTATGTTTCTAAAGTAACTCTTTAATTTTGTCTTTTAAAATTAAAATAACAGTAAATTAACATACTCCTTAATATCTTACCTATATACTAATGTGGACCCAAGTCTTCTCATATAAGACTCGACAAATATAAAAAATTCTGAAAATGAAGGGTAGGACCAAAAGACCTTAGAGGTGATCATTCAACAATACAATTCTGTGTTAAGCTAATAGTAATTATTCTTAATACAATTTAGAATAAACTTTAATTTTGTAACAAAGGACGAGAGAAATAATATTACAATGAAAGATAAATTTTATCTCCCTCCACCTCTTAAATTACTTATTGTTACTTAATGGCTACATTTGTCACCTGCATTTAGCAATATTTAAGTACCATTATCATATTTAAAATGCTAATTTTAATTAGAAATGTAAACAATTTAAATTTAATTTTCAAAAGAATTCATATCCAATTATGTTTATTATGTTTCTTTCATCTATCAGTCTTTATTCTCAACATGGGAATTCTCTAACAGCTATCCAAATTAAAGAAGCAATAGAGACAATGTACAGAAAATAGGCAGAGCAGCCAGGCCTCCCCTGCCTCCCTCACAAAAAAAATTTTGAATTATCTGTTTGAGCCACCATAACTCATCAGCATAGATACACTATTGTAGAACAATCATTCCTGTTCCAACCAGTGAGCACACAATATCTGTGATAATAATTATAGACATAATGTAATATATCACATCACAAATTCCTGAAATAAAACTAATTCTATAGATTAGGAACTTAGAGATTTATTCTGCACTTAGTCACATAATGGATGTTAAAATTAACGAGAAACTCAGATTGAGGCAAACATGACAAGCATGCTTTACTCAAACATCATACAGCACAGCAACAGTTCAAACCTTGTTTCTTAAAAAAAGAGAAAGAGAGAAATAGAAAAATGTTTTTATGTCCTACTGGATTTCAGGAAGAGCTGAAAAACACTCTTATTCATATAGTAAAGAGGGCTTTGTTTGGTTTTGCTCATTAGAATTCTGTAATTCTGTTAGTTTCAAGTATGGTGAGCTTGAGTATACGCAGAATAACAGTGACTGAATAAAGAAAAGTAAGCCTTGGCTTACTTTAATTGTCATAGATAATGAAATGGAATTTTTTATTTTCTGACTCAATGGCACGTAACATAAAACCCCAAAATATTAATTTCTCTGATTCTGGATAAAGAATTTATTGTATTGCACATAGTTGAGTTTAGACAATTAATAGCTGCTACCACAACATGTAATTTTTTAAACTATGCCTTTCAAGTTTCAGCACATTTGAATTTCATTTACTATCCTTTTTATGGCTAATAATACCATGGCTTGAAGTAAAATATTTGCAAATAGTTCAACATAGTAGTGAGTAAGGGTATTTTAACTGTATTCACATTCACTCCCTTTACAGATATTTTGTGAGTTCAAGTGAAGGGAAAGGTAACGCGAATTATGTATTGTAGATTAAATGCGAAGTTAAGTGATCACCATTAATATGTAAAATTATCAATGGTTTTATGGTTTACTTAAAATAATAAATACCTGAATATGTATTCTGCATGCTATAGATGAGTTTCTCCAGTATTTTTACAGCCAGCAGACACTTGAGTCCTGTCTTCTAATGCTTATATGCTAGAACAGAAAGGAATTAAGGTGTAAGTCTATTTCATGTGATGCAAGTGAAGTCACCAAATAAAATCATAAAACTGCCTTTTGCTAAGGCAATAAAACTACTAATAACAGGCCTGTTCTACATAGCTAAGAGGTTTAATAAAAAATCGAATTCCTTGTTTAAAATTACATGTCTTTCATCCTGTCATCCAGGATACTGTTTAAAGAGTCTCTGTTATGCACTGCTTTGTTTCTTGCTCAGTGGTTCTGTATAGGTTTTCTTATACAATAAAATACAATGAACTTTTAATATTGGAGTTGTTTTCTCTTATTTTTGATTATCTTATTTTCTTGGCTAATGCCTTATTACAAAGGCTTTGTTCAAGTAATATGGTGATTTACATAGATGAAAGAAGGCCTGCATTTCTAGAAACTGAAAACAGTGGTTCTCTTACAAATCCAAATTAAACATTTCCTGTAGCCTCTTATTTTTAATAATGACTTTAGAGGCAGTAATTAGAACATCAATGGTTTATTTTGGAAATAATCAGTCTTTAACAAAGAAGATTATTCTTAACCTCAAGAAAACTCTAAATATAAATAACAATTCTGGATCTTTTTAGAAGTTGATTTAAATAATGCTGGATTATTATAACTATTTAATTAGCAGTTTTTCAAACTTTAAAATTGGAATTATATCTCAAGAAAAACTCATGAGAGCATTTTTAAAACATGAACTCTATCACAGATGAAGTGGATCAAAAATTGCTTTTGTACAGTATCTATAATTTTGCATAATTTTATATGTTAAGCTAAGAAAAATTTAGAAATGTGCTTTTTGATACATTAATCTTGGAATAATCTAATCATTCCAGGAATAAAGCAGAAGAAGGCCATCAACTGGTGTCTAATTCTTTGATTTCTATTTTTATATTAAATAAAATTTTATAGTAAAATAATAATCATTTTTCCCCATACAGAGTTTTCTAGTTCTTTTCTGTCTGCCGAGGAAGAAGGACTTCATAGCGCCGAACTTCAATTATCTAAAATAAATGAAACACTTGAACTTTTGTCTGAATCTCCAGTTTACCCAACTAAATTTGATTCCGAAAAGGAAGGCACTGGCCCAATTTTCATCAAAGAAGTGTCAAATGCTGATATAAGCATGGGGGATGTGGCTACACTGTCTGTAACTGTCATTGGCATCCCCAAACCTAAAATTCAGTGGTTCTTTAATGGAGTGCTATTAACCCCTTCTGCTGACTACAAATTTGTTTTTGACGGTGATGATCATAGCCTGATCATTCTGTTCACCAAATTGGAGGATGAGGGAGAGTATACATGTATGGCCAGTAATGACTATGGAAAGACAATATGTAGTGCCTATCTAAAAATTAATTCCAAAGGAGAGGGTCACAAAGACACTGAAACAGAATCAGCAGTGGCAAAATCTCTGGAAAAGCTGGGAGGTCCTTGTCCTCCTCACTTCCTTAAGGAGTTAAAACCAATTCGCTGTGCTCAAGGGCTTCCTGCCATCTTTGAGTACACAGTGGTTGGAGAGCCTGCCCCTACTGTTACATGGTTCAAAGAAAACAAGCAGCTTTGCACCAGTGTTTATTACACTATCATTCATAACCCTAATGGCTCTGGAACTTTCATTGTCAATGACCCTCAGAGGGAAGACAGTGGCCTCTATATCTGTAAAGCAGAGAATATGTTGGGTGAGTCCACCTGTGCAGCAGAGCTGCTTGTGCTTCTGGAAGACACAGACATGACTGATACCCCCTGCAAAGCAAAGTCCACACCAGAGGCTCCTGAGGATTTTCCACAGACACCCTTAAAGGGTCCCGCAGTTGAAGCACTTGACTCAGAGCAGGAAATTGCAACGTTTGTAAAAGACACCATTTTGAAAGCTGCTTTAATTACAGAAGAAAACCAGCAACTATCTTATGAGCATATTGCTAAAGCCAATGAATTGAGCAGTCAGCTTCCTTTGGGAGCTCAGGAATTGCAATCCATTTTGGAGCAAGACAAGCTCACTCCTGAAAGCACCAGGGAATTTCTTTGCATCAATGGCAGTATTCACTTTCAGCCTCTCAAGGAACCATCTCCCAACCTACAGCTGCAGATTGTACAGTCCCAGAAAACCTTCTCCAAAGAAGGTATTCTAATGCCTGAAGAGCCTGAGACACAGGCAGTTCTATCAGATACCGAGAAAATCTTCCCAAGTGCCATGTCCATAGAACAAATTAATTCATTAACAGTTGAGCCTCTGAAAACTTTATTAGCTGAACCTGAAGGGAATTATCCACAGTCTTCAATAGAACCTCCAATGCATTCTTATCTAACCTCTGTGGCTGAGGAAGTACTTTCACCAAAAGAAAAGACAGTATCTGACACCAACAGAGAGCAAAGAGTGACTCTTCAAAAGCAAGAGGCACAAAGTGCGCTCATCTTGAGTCAGAGCTTAGCTGAGGGACACGTGGAGAGTCTCCAGAGTCCTGATGTCATGATCTCTCAGGTAAACTATGAGCCCCTAGTCCCTTCAGAACACTCATGCACAGAAGGAGGTAAAATTTTGATAGAAAGTGCAAATCCACTGGAAAATGCAGGGCAAGATTCTGCGGTCAGAATTGAGGAAGGCAAGTCCTTAAGATTTCCACTAGCACTTGAAGAAAAGCAGGTACTGCTCAAAGAAGAGCATTCTGACAACGTGGTGATGCCCCCAGACCAAATCATTGAGTCTAAAAGAGAGCCCGTGGCAATAAAGAAAGTGCAGGAGGTACAGGGAAGGGACCTTCTTTCTAAGGAAAGCTTGCTTTCTGGTATTCCAGAAGAGCAGAGATTAAACCTGAAAATTCAAATCTGCCGGGCTTTGCAAGCAGCCGTGGCCAGCGAGCAGCCAGGTCTTTTCTCTGAGTGGCTAAGAAATATTGAAAAGGTGGAGGTCGAGGCTGTAAACATCACCCAAGAGCCCAGACACATCATGTGCATGTACCTTGTTACTTCGGCAAAGTCTGTAACAGAAGAAGTAACCATCATTATTGAAGATGTTGATCCTCAAATGGCTAACCTGAAAATGGAACTTAGGGATGCTTTGTGTGCTATTATATATGAGGAAATAGACATCCTAACAGCTGAGGGTCCTAGAATTCAGCAAGGAGCCAAAACAAGTTTGCAAGAAGAAATGGATTCTTTTTCAGGTTCACAGAAGGTTGAACCCATTACTGAACCAGAAGTTGAATCTAAATATCTGATCTCAACTGAAGAGGTCAGTTATTTTAACGTGCAAAGTAGGGTTAAATATTTGGATGCCACACCTGTCACTAAAGGGGTTGCTTCAGCTGTTGTCTCTGACGAAAAACAAGATGAGAGTCTGAAACCATCAGAGGAAAAAGAGGAGTCTTCCTCTGAAAGTGGTACTGAGGAGGTTGCTACAGTAAAGATACAGGAAGCTGAGGGTGGCTTAATCAAAGAGGATGGCCCCATGATACATACACCTTTAGTGGACACTGTTTCTGAGGAAGGTGATATTGTACACCTCACAACATCCATAACAAATGCTAAAGAGGTGAATTGGTATTTTGAGAATAAACTGGTGCCTTCAGATGAAAAGTTCAAGTGTTTACAAGATCAAAATACATATACGCTAGTCATCGACAAAGTAAATACCGAAGACCATCAAGGAGAGTATGTCTGTGAGGCCTTGAATGACAGCGGAAAAACAGCAACTTCAGCCAAACTCACTGTAGTAAAAAGAGGTTGGATTTTAAGGATAAAATAGATCAAATGCTAACATTCACTGGATTGTAATGATTTAGCTTGCATCACTTAAATTTTCACTTATCTGCCACTTCCAGAATGTAATTTATTTAGAGTAAGAATGAAATCACAGACATAATCATGGTTATGAACTCACCTTTTCCCTTACTGCCCTGTTGGGTGCTATGCTATCATATCCATGGTACTATTTATTTTAAAAATAAAACATATTTTCATATGTTTCATAATACCAATAGATAAGCTTTTAGTTAATTTTCATATGAAGATAACTTTCATAATATGTAATAAAAAGTATCAGTGAACACCTAGCCACTCTGAAATCACTGGTCTCACCCTTAGATTTAAAATAACCATGATTAGTTGTCTGTTTCTTTTTTCTGTTTATTTTTTGTTGTTGTTTCACTTCATCACTTTATTTAGTATATCATGTTTCTTCACATTATTTTCAGTGTTCCCATTCAGCATGGTATATTTAAAGAATATATCATGTTGTTATGCATATAATCCAATAGCATCACATTTTTTCACAATTCACTGCAAAGCAATGATTGAATAGGTTTTTTTTAAAAAAAGCTTATTGTCTTCTTTTGCCTTCAATGATCTTTCTCATTTTCCAGTCACTTGCCTTAAACTGCTGTAATCCATCTCACCAATTTCAACTGTTTTACTCCATTAACAGCAACAAAAGTTAGAAGAAAAACAAAAATGTCATATGCCTGATAAGGAGGCATGTTAATGGACTCTACTTCCCTTTGCAG
>TTN-202,,0,2007,998741,1000747,GTAAATGCCATACATTGGCACAGATGTTGTCACTTCATTTCATATTGTTGTCCTTTTTGCTTTCTGTACATGTGTGGGAAATGCTTGTATTACCAACTGGAGAGACCAACAACCAAGACAGTAACATGGTAGGTAGGTACTGCAGAGCCTATATGGGATAAGAAATCATTATTTACAGTCACATTTCTACTACTGACCAAAGAAAAAATAATTTATTATTTGAGAACAAAGTTAAGTAATCAAATGAGCTCAGCTTGGCCCTTCATATAAAACATATCAGGACAGTTTGGTGCCACTAAAAAAAAATAATGTCTCAATGTATTTAAAAATTTTAAATCAAATAACCAATTAAGAACAGAATTACAAACTTAAAAAAGTCAGTGTCTAAGTCTAAAATTAAATCCTAATGTAAGACAGGGAGCTAGTATAGGACTGAAAACTAGGATTCTCTCTAGGCATTTTTACTAATTTAAAAATAAGACGGCTGGGCACGGTGGCTCACGCTTGTAATCCCAGCACTTTGGGAGGCCAAGGCAGGCGGATCACAAGGTCAGGAGATCGAGACCATCCTGGCTAACACAGTGAAACCCGATCTCTACTAAAAATATAAAAAATTAGCCAGGCGTGGTGTCACGCACCTGTAGTCCCAGCTACTTGGGAGGCTGAGGCAGGAGAATTGCTTGAAGCCAGGAGGCAGAGGTTGCAGTAAGCCAGGATTGCACCACTGCTCTCCAGCCTGGGCAACATAGCGAGACTCCACCTAAAAAAAAAAAAAGAAAGAAAGAAAATAAGACAACTACACAAATATCCTATTCCCAATTTTCTAATTGATATGTAGGGTGACTTTCAAATAGTTAACACTCATCAAATACTTGAATGCCTTCATTAACCAAAATATTAGTAGCAAGCTTTTCTTCCTTTCTTCCTACCTTCTTTCCTTCCTTCCTTCCTTCCCTCCTTCCCTCCCTCCTCTCTATCTTTCTTTCTTTCTTTTCTTTCTTTCCCTCTTCCCAAGAGAAAGTGTGAGTATGAACTGTGGTTTGAGGACAGGGGTAGAGGTACAGTCAAGCCATACTTGGACTGTTGGGGAAGGCTGTCCCTTGGTCTTCTTTGTCAATGAGAATATCAAGGGGAAGGGCAAATGCAGCACATCTCTTGAATGTGAAAACGATGAGGTTCCCTATAGCTTCCTCTTCTCTACAATCCTTTTACGTGATCCTAAGAAAAACCCAGGCCCATGATGACCCAACCAGTGCTTTTCACTCTGGTCAAAATGTCTCCATAAAACCAAGTACATGATATTATTCATACTGACGCGTTTGGAAGTTTCTTTACTCAAATTAGGTCAATTTAGGAATGCGACTAATATTGAAGCTTCAGATAATAAGAGGAAAGGATAAGGAGGATGACTTAAAAAAATTAAAAAGAGAGGTTCTGAAAGTCTGGCTTCAAGATGCAGAATGGAAAGGGGAAGTTGCTGCTATTAAATATTTTTACAAGTTTGAGTTGGCCTAGAGGATGCATTCATAGTTAAGCCATATAAGAATTTCCAGGCAGTTGACATGAGGGTTAGAAAGACATTACAAAACTACTTCAATCTTCTTATCACTTAATATCCCTACTCTTCAGAAGAGTCAAATACATTTTCTTTATCTTCCTTACATAATCTTCTAATTTGCAGAATTAAAGTATCAGCTCAATAGCTTATCAAATAATTAAACAAGCAGCCACTAAAATGGACAAATCTTTAGTAATGTTACTTAATAAAGGAACGCTTGTCTTTTCTTTGATAGAGACAAGTAAAGTGATGTCTTGCTCCCTTATAAAGAACACTCTCATCCCTTTCCTTTGACAATCTTTTGTTCTTATTAACACATTACTCCATTTTAAATTATGGCTCATGTCTATCTAAAGACTTAACTCATCTTTTCTCTGTCTTGGAATATATAATTACAGCAAGTGCTTTGGTGGGGACTAAATGTAATGCTGGAAAAATTTCTTTTGCAG
>TTN-202,,0,522,1000748,1001269,GTAAGAAACGTGTGAATGTATTTTCTAGTCCCTTCTCTGCAAGGAATCCTCAGTAGAAAAACTGTTGGCAAACAATTCAGTCAGTACACTTTGTTATTAAAATAATGTCATTCAGCAAACATTATGGTTTGGGAAAGTCCTGGCATTGTTTGATTTTATTTTTTTAATCCTCTTCAAAGTTCACTTAACTTTTGTTCTTTTAAATTGTCTGCTATTAACAAAGCTTGCTTAAAATTTCTTCTAAGAAAAAACTCCAAGTGTCTGAGCAATTCTTAACTATCTTCTTTTATAAAATTCTTCTTTGTGTAGGTAGTCTGTTTATTGTTGTTTTATTTTAAATCAAGAGACTGGGAAAGTGTCTTAGAATGATAGGAACCTATTAAATGCACCACAGCTTTTACAGAAATTTTGTGGAGATATTTTATGTGTGTTGGGTCTCTTTGTTGTATATGTCTACTTTTCTTTTGCGGAGTTTATGTTTCAGATATCTTCTCCTTTTTCTTTTTTGTAAACTTCATGTAG
>TTN-202,,0,100,1001270,1001369,GTTTGTTTACTGAGTTTCCATCCAGTATTTTTCTGAGAAAAGATTTCCCTTTTAATTACTTATTACCCATTACTTACACAATGCTTTCATGCTTTTGTAG
>TTN-202,,0,435,1001370,1001804,GTTAGTGCTTGAAAAACTAATGTCTCTTTAATAAATTGTCAAACTAGCTTTCTTACCCCATGGAAGAAAAACTGGTACTTTCTTCTCTTGTCCTATCCTTTAAATTTGTTTTGTCTTGGTTTGACCTGGGACCTTGGGAACAAAGTCAGTAACTTTCACCTGGTCTTTTTCCCGAGACTAGTGTAAATATCTATTATCTGATAACAAAAGGGAATAATAAGCCATTTTGTCAGCTGACAAACATGTATCATCTATGCCTCTGTCTCTTGGATGGAATTATAATTATTCTTAACTTTTATTTCTTCTTCTAATTAACACTATGAAATAGTAGTATTGGGACAAGATAAATATAATCTTGAAAAAACTCTTAAATATAGATGGTGTTGAAAGTGTTTGGGAATTGATATGTTTTATATGCTCTCTTTCCTTAACTAG
>TTN-202,,0,96,1001805,1001900,GTTTGTGTAGGAACATTTAAACCTCAAATTGCTATTTAGAATTAAAGTGAAACCCTAACAAGCATTTAGGGTGCTAACTATTTCATACCATTGTAG
>TTN-202,,0,117,1001901,1002017,GTTAGTATTTTTAGAAAATGATGCTACATATGCATTTGAAACCCAACAAATGGCCTAAAGTCAATCACTGAGCACTCTTCTATATTGACCTTTTCTCCCTTCTTGTGCAACACACAG
>TTN-202,,0,115,1002018,1002132,GTTGGCTGGAGACTTTGCATTTTATCCTTATTAAAGATTATGTTCAAATTAAGTCATCTTCCCTTAGATCAACCCTCTTAACTCTTTGAAATTCTTTCTTATACCCCTTCTTCAG
>TTN-202,,0,92,1002133,1002224,GTTTGCATTGTTTTCTTGACATCTTTGTGCTAACCTTGTTATAAATTCTTTCCTCTTTCTCACATTTCTTAATAACTTCCTTCCTTCCACAG
>TTN-202,,0,94,1002225,1002318,GTTTGTGTTCACTTTGCCTCTTGTGTTGCCAAAGTTATGGCCCATGGCACAGACCCCTCCTCCCTTAATGCAAATCATTCCTTTTTTACTGTAG
>TTN-202,,0,109,1002319,1002427,GTTAGTGTTGGTTCCAGTGAGGGACTGGCTTTTCTGAAGAGTCAATTCTTTTTTTTAAGCCACTTTTGCTATAGGGATAATATTGATTGAGAATTCATTCTTCTGTTAG
>TTN-202,,0,101,1002428,1002528,GTTGGTTCAGAACGTTTGCCTTGGGTTTGAGGAAGAAATGCAGATGTAAGCCTTTCAGCAGGGTAATGCACAACCCACATCTATCCCTTTGTTTTCTACAG
>TTN-202,,0,132,1002529,1002660,GTTGGTATTGTTCTTCTACAGAGAGGATTGGGCATTTCCATGCTCCTTCTTCCCTTAAAATTTAAAAAAAAAAACAAAAACAAATTAGTAGATTGACCTTTTTTTGTTGTTGTTTGCTTTTTCATTGAATAG
>TTN-202,,0,133,1002661,1002793,GTTGGCAAATTTTATTTCCACTTATCAAGAACTTACAAAATATTTTTGTTTCATTTCTAAATTTTCACCTTTATTGCTAAGTTATAAAATAAAACTTCCTATTTTCTTTTGCTTGTTTTTTCTTTCACCTCAG
>TTN-202,,0,147,1002794,1002940,GTCTGGTCTCTACATCTCCTCACTTTCTTGCTTGTCTAGATTTTCTTGCCTGGGGTGGGCCGGGGCGGGGGACGCTTAAGACAGCAGTTTTGCCCAGTGACCTGTTTTTAAAAATATTCAACATCACAATTCTTTTTCCATCTTTAG
>TTN-202,,0,97,1002941,1003037,GTTCGTGAATGGAATCTATTCTCCATTTTGGCTGTGCTGCCTGATAAGTTTGGGGTCTTCCCTTGAGTAAGCTACTGTCTTCCTTTTGAATCTTTAG
>TTN-202,,0,118,1003038,1003155,GTCAGTTATACAAGAAGCAGCCTATCAAATAAAAATTCTGTAACGCTTTTAAATCTTATCATTATGGGTAGGAGTTACAATATGTTTCTTCTTTTCACACTCTCTTATTTAATCACAG
>TTN-202,,0,112,1003156,1003267,GTTTGTAAGCTATTCTCTTTCAAAGATAGTCTATAGCGACAGTTTCATTAGCAGACATTATTTCTAGTGGAGTTACCAATGTAACTCATCCACATTTTCATTTTTACTACAG
>TTN-202,,0,102,1003268,1003369,GTTTGTATCTTCACCCCAGTCAGCTTCCCTTATTTATAGTATGTCCTTTGTAAACAAATAGCAAGAGATTAATGGATGTGTTTTGCTGTTTGCATTGGACAG
>TTN-202,,0,246,1003370,1003615,GTTAGAATTTCTTTACCTCTTCTTGATTCTTCCTTGCGAATGCTTCTTAAATGTATCACTCTTGCCTTTGTATCCTTTAGAGCTAAAATCTCTATGATTCTGGTTCTTTAGATACATATTCATTGTGTTCAAGAAATATTCAGCCATTGCCTCTTTCCAAGAGTGTTTTCTTAAATGTCCATAAAACTGTCACAATAATTCAACTGCAAGCAATTTAATTAAATATATCTCTCTTAAAATCTATAG
>TTN-202,,0,213,1003616,1003828,GTGTGCAAATTTGATTCCTTTATGTTTCTGTCTGACTGTGTCTTTGGTTCTCTGTATTCAGTTACAATGTCTCTAAACAATCAAGAAAGTAGTATTCTTTCTAACATAGTAAACAGTATTTGCTCATGTTTTTCTCTTGCCTGTATACTATCTAATTTAACTATTGTTATTTATTTCTGTTCCCTGATACTCTCCTCTTTCCTGACTCTTTAG
>TTN-202,,0,1043,1003829,1004871,GTAGACATCTTGTTCTTGTGTTTCTCATTAAATGAAAACCACCTTCTCCCCTGGGTATTATAGCTCTTTATTCATTTACTATCATTTTAGTTTCCATTTGAGATCATAGAATATTTTTCTGAGCTAGTATTATTTCCCTTTTTAGATGGTTTCCTTCTTGAATTTTGCTTACATGTAACTAGTCATTATGAAATATTTTTGTTATTCCAGTGTCATAATTCTGATTACCTCAACACATTTGCCAAACATCAAACGTGATGTTTCAAAACTGCACAAAAAAATGAAGTAGGCATTTTAAAATTAGTCTTTTGCTTTCAATCAACTTACAGATATATCATTCTCACTATAATCTATATCATTAATAACAAGCACTTTTACTATATCTATGCAAAGTGAAAGCAATACAGGTTTTAAACTTATGTTTAAAACAGGACAATAATATTTTTTCCTTCTCTCTCAAGGATCACTTCCTATCCTTTAAAAATTATATGACTATACCTTGGTACAAATAGTATCTGTGTTTTTTTGCTGCAATTTTCCAGTGCTTTTTTTTTTTGTCACAAAGGCCAAGTTTGTCTTGTTTTAAGACAATTATTGCAGTAATCATTTGCTGAAATGGAAGACTTAGATCACGGATGTTGTGATGACTTCCAAGTGTCTGTTATAGAACATATACAAAAAAAATCATCCTTGAAATTAGAATTCCATACTTCATGCAAATCATTATTTATTGCTATACTTGCTTGTTTGCAATTTTTGTATCAATCTTTGTAGCCTAAGATACATCAGTAAGGTGTAGTAGATAGAATGTTGAACTGTTCAGTAACGACATCTAGGATCTATCTGGGTTCTCTGCCCATCTAGCTGGTTATCTTGTGAAGGCAAATGGCTTCTGAGGCTGTTATCCCATGAGAGTGTTAGTGCTGGACTCTACTTACCCATTAGAATATCTTAAACCTTTCTTCCAATTTAAAGACAAATAAAAAATTTTCATTTTGTGAAATTCAGTAGCCCAATTCATGAGAAATTCTTGTTTTTTGCAG
>TTN-202,,0,118,1004872,1004989,GTAAATATAGTTCATCCACATGGCAGAAATGTCATAAATGTGCAAAATCCTACTTTTTTCACTCTCGCATGATCTGGACAATCTTTTCAACAATTTCCATCCATCTTTTCCTGTTCAG
>TTN-202,,0,829,1004990,1005818,GTTGGTACAATAGCCCACGATAGAAACTGGTGCCAAATGCTGGAATGAATTACTAAGAGTTACTGGCAGATTCTTTTTCTGAGTTTCTTCTAGAACTATATTTATCCTCATCTATTTGAAAGGTCTAGAGGAAAGACATAGTTGATCTTTCAAACACTCTTTTCTGTTTCTGTGATTCTAACAAAAATTAGACATCTGTTTTATTGTTTAATAACTACCTGTCTATATCAATTAGCAGATACAATCATGACTCTCTTTGATTAAGCATGAAAGAATACAGAGCCCAGCATGTGCTACAAGAGTAATTGTTAAAACTAACAAGAACTCCAAAGGTTGGCATTTGATAGCAAAGCTTCCACATAAAATTAATGACAATTAAACAATTGTTTGAATAACAACTTTCAAAGAATTGTCTTTAGCACCTTAAGGTAGAGCAAAAATACCAAGTAATTCACAATAACCTGTAGACTTTGATCTACAGAGGGTCAAGTGGAAATCAATATATACTATCTAATGCACATTGTTTAAATTGTTTTGAAGTTGAGTCATGCACGAACATATATTTCTTAAGAATAATTGCTACATAAGACGACAGCAAGAGTGGTGGGAAAAACAAAAAATAAAGAAAAAACTGAAAAGAAAAAATATTAAAATAAAAAATAGCTATAATTCTATGACTGCATGTAATTATGGAATCACACTTTAAAGTCGAGAGAGAGAGCACCCTAACATAACCATCTCACTGGGAGAAACAATCTTAGTGAATGTGATAGTAGAGACAGAGTAAAGATCCCAGACTTTGACAGATGGATATCACGTTTTATTTCAG
>TTN-202,,0,116,1005819,1005934,GTTAGTTCTGCTGTTTTCTTCTGGTTGCTTATGCAAATTCCTTTTACAAGTTTCCTTCTTTCAAGTCTCTTCTATTCTTTCAAATCATGATGAGTCTCTTACCTTTCCTCACACAG
>TTN-202,,0,159,1005935,1006093,GTCAGTAGACAGTCAAACTTGTAAGGAATTTCTTACAAATTCCTCTTCAGGTGCACATCTATGTTGACAAACATTTGAAAGTGCTCTAATGTTTTATTCAAAATTGCAACTCCATCTGAAGCTTACAGGATCTTTTAATTGTTCTCCATGTCTATATAG
>TTN-202,,0,93,1006094,1006186,GTTTGCTCAAGTGGATTCACTTTTTCTGTTTTCTGTATACCGACATCCTTGTGTTTTTCTTGTGTTTAACTGCTGTGCTTTGTCACTTACTAG
>TTN-202,,0,108,1006187,1006294,GTGTGTTGTCTTATTGTCTCTTAAATCATTTGCATTCTTCTAACATGTAGCATAGTTTCTTTGATATTCATTAATTCCAGTTGCTAACTGTGAGCCTTTCTTCCTTAG
>TTN-202,,0,112,1006295,1006406,GTGATGATATTTTACAAATTAAAAAAATTCTTTTTTCCTTAACTCTTGTATCTTTATGGTGAACTTCTCATTTCATCTCCTAACACCTTAAGTATTACATGTCTCCCTACAG
>TTN-202,,0,124,1006407,1006530,GTTTGTTCACACGTCACTCTTTTTCTTTGCAAACTGTGGCTTCATATTTCATTGTCAAAGTAGAAACGACCAATGGCAAAAAAACAAACAAAAAATACACATTGCCTTTCTTCTCATCCTCCAG
>TTN-202,,0,644,1006531,1007174,GTATCATTCCATGACTTTTGACAATATTTGTTCCTTACCATATTTGCATAATTGTCTTATAAAAGTTTCTTTGGTTTTTAAATGTTTGAGAGAAACTAACTGGACATGTTAGAATTTGTGTATTAGTGTTGGAGGCAACATTAATCAAAGTTGTGTTTTCTCTTTATATTGTTCTTTACATTAGTGTAACTCTAAGTGTAATCTTATCAAAAAGTATTGTTTAATTGAAATTTGTTAAATGTTGTTTTAACTATCTAGTCCATTTTTTAATGCTTTCTTGTTATATGGCATTCTGATTTATCATTACTAAATGTTGATCAAATACATCTATAATACATTAACTTTTATGTTTTAACTTACATAGTCAAACTAAAAAAAAGAATCAACTAAATTCTCTATTAAAAATGCACATGTACCCTAAAACTTAAAGTATAATAATAATAAATTTTAAAAAACTAAAAAAAAAATGTTATGAGATTATTTAACTTAAAAGATAACTTATTTTACTGTAAAATCCTCAGAAAGTATATTCTTAATAACAAACCAGTTTAAATATAAATTTATGGGATCTTCAGCTACAAAAACAAGCTCTTTTAACATGTATAATAAATATCCCTTACTGACTGTTTTGTTTGGTTTACTAG
>TTN-202,,0,257,1007175,1007431,GTTAGACACACTAAGCTTCTTTGTTTCTTTATTCTCCTCTGATTTGGGCTCTTAGCAAAGTTATGAGTTCCAAAATAAAAGGATAATTAAGGTTATTTGGTTGCAATTCTTCAACAAGTTTTAATGAATTGTCATTTCTTGTGTCAGCATGTATTGTCATATGATCACACCAGTCACTCTTCAAGGTTCTAGATTTAATTTTTTTTTCCTTTATAGTAAGCAAGTGTTCTCATTGTTTATCTCCTTTTTTCTGGTAG
>TTN-202,,0,120,1007432,1007551,GTTTGTATACATGGACACAAAAATATATGCCCCTTCCTCCTATCTGTTCTTGCCTAACTAATAACTTGTGTGGCCATGATTCTCACATTTTTTCCTCTAACCACAAATTTCTTTCATCAG
>TTN-202,,0,150,1007552,1007701,GTTAGTAGCAAAGCACAGCCAGAGAAAAAATCAATTTACTTGATCCATGATCATTTTCCTCAAATATTCCTCTTATCCAGTAATTCAGTGATTGCACTCTTGAGTTTGAAAGGTTACTTTGTTTTCAATGCAAAATACTTCTTCTTTTAG
>TTN-202,,0,102,1007702,1007803,GTGAGTAGAATGAGATTTTTATGAATATACAATATTTCCAGGGGGTGGAGGGGCACAGAATAAAACTTCTCTTTAAACGCAAAACTACCCTTCCCCACATAG
>TTN-202,,0,190,1007804,1007993,GTCAGTGTGCAAGGATAAAGCTGCTGCTTCTCTAACACCTCTTTCATGTGGACGTGGTGCCTGCCTTCCCTGGAGTTTCTTTATTTTGTCTTCATGTTTAGTCTTAGCTCCCTTTTTTTAAGGAGCAAAAGCACTTCTCACTTGGATTTCTTTCTTCTCTTTATCTCCCCTTCCGCCTTGCAATATCTAG
>TTN-202,,0,94,1007994,1008087,GTTTGCTCTTTCCCCCAATATATACATCTTTTAAAATTTCTCTTAAGTCTTCATTAGAAGGCAAGAATTTTACCCACATGTTTTCTCCTTATAG
>TTN-202,,0,100,1008088,1008187,GTGTGTTGACAGCTACCTCTTTTTATTGCTCTCTTTCTTTTCAAACATCCTCTTTTACATGGCATGACTGACTTGCTGACTACCATCCTTTGTACCATAG
>TTN-202,,0,132,1008188,1008319,GTGATGGTGTTGTTTAACCTAGTGTGTGTGAACAGATTCATTTTCTTAAAAACGTTAAAACTTTTATGAATTGAAATATGTTGTGGATGCCTTCTCACCTGTAAATAAGGATTATCTGTAACTTCTTTACAG
>TTN-202,,0,140,1008320,1008459,GTGAGTAACTCACAGTACCCTCTTCATTGTAAAGCAGCTTCACTGCTCCAGGCCACCAAAAGGCTGGTGCCATTTAGTTTCTGCTCTGTATGTGAGAGCATGGAAATAAAAATCACCATGTTGGTCTTCATTCTTTTCAG
>TTN-202,,0,1320,1008460,1009779,GTACTTGTTAGAGTGAAGGAGCAAGATCTCTTTTACATTTTCAGTATCTTAAAATATAGGAGGGTGGGTGTGCTTGAGAGAGAGCTATGTTTAGGACCAGGGTCTAGTGATGAAAATGGATCAAGTGGATCAAGGACCTTCCAAATGGAGACAAGTATTTTTTAATTACTTTAAAAAAAAAATTTAAAACTAGGAAAACATGGACCAAAAGTCCATTTTAAGAGACTAAAAATAGAGACTAGAGAGAGATAACCGAAACTCTACAAAATTGCAAGAAAATCCTAGTTTGAAAGACGGTATCATAGGACAAAAGCGAAGTTATTGCAAATGACTTTTTTCCCACAGTACTTAGTAAATGAATGGATTTTGTCCCTCTAAGGCATAGCAAAGAGCCAAACTATCAAGCCCTTCAAGGAGAATTCAGATGAGAATGATAAGTTCAACTTACTTTCCTCCACTAGCCCCACTTAAATAATAGTGGAGGTCAGGGGCTGGGGAGTAAGTAGATCAGTATCTGCTATTATGGAAGGCAGTCATGTGTTTCTGCCACATGTTTATCGCTGCTACTGTCAGAAATTAAATAGTTCACTCAATGGACTGCTAGTCTAGTCCATTAGAGTATTTTTAAGGGTTTTTGTAGTGGTGGTTTATAAATATCTTGAAATTAAAATATAATTAGATTTAGCAGCCCATTTGCTCTATGACATATAGCTAATCACTTTTACTTCCCTATGCCTGAATTTTTTGCTTCAGTTAATGAGGAAATCATTACTCTCACACACTTCAAAGGAAAATTATGAAGGTTGAGGAAATACCCATTTAACACCTAAAAGAGGAAAATGGCATTTTAAAAATATTAAGATATCTGACCCACTTTGCCATTCCGGCTCTTCATGCTATGTAACTGATAGCATTGCAGCCTTAGGAAATAGTTCTCCACTGGTTCATATACAAGACAGTAATCAAATTCTCATTCCCCGTGGACCTCAGAGGGCTTCCACTGACAGATACATGCTATTATCTCTGATCTTGGCACTAGAGAAGGGACTCTTTTGCTGGGGAGAGGATGGCACAATAAAGAGTAATGTCTTTTTCTCCTTCTTTTAGTAATAATACTTGATGTGGATGCTTACAAAAACAAGCATATTTTATTTTAGAAATTTTCTATTTAGGTTTCATTTAACTCTTCTTCCTTGAACTGCATAAATTTGTTTTCCAGAGCTAAAGACCTCTCTAGCAAAGATTATTTTTTCCACCTCATCTTGAATTATATGCATCTGTTCCATCCCTTACCCTGTGTTTTTCCTCTTGGTTCCATAG
>TTN-202,,0,228,1009780,1010007,GTCAGCGCTCTCCCCACCTGTGTGTTTTTCACATTAGCCTCCTCTTTAATTGTCCTCTTAACTTCCTGTTTGACTCTTCAACGATGTTTTAAAATAGGGAAAGGACACAACAAAGAATTGAAAGTGTTTTTTTCACTCTCTATCTCTCTGATGGAGTGGAAGATTGATTCTTACTTTTAACTATATACTTACAGAATACATCCGTATTTTCCTTTTTTCCAATTTTAG
>TTN-202,,0,412,1010008,1010419,GTTAGATGGACTGCATTCACTTCTGCTCACTACTTCCCTTCTAATTGTAATACTCTGTTGCCCCCTCCACCCCAGCCCAGTCTTATCACTAGCAGCCTATTCCACTTTCCCTTTGTTTCCTCTCCAAGTCCTTTTCTGTTTAGTCTGCTTCCCTTTTCCAAATCCTACTGAATATCCTTTTAGATAATGTTGTAATTAGGTTTTGATTGGATTAAGAAAGCTGGAGTAGATGAGATATTCAACTTTCCTACTGAATACAAACTTTAATGTGTCCCTGCTCGCATCCACCAAAAATGCCTCTTAAATGGAAATAACACATTATCACTAGTTTGATTCCCGGCATTCACGATTTGAGCAAAATGCTGTCAGTCTCACAAATTTTAAAACCCAGGCTTTCCTCCTTTTTCATCAG
>TTN-202,,0,116,1010420,1010535,GTTAGTAAAAAGATGATGTTATCACAGATACAAGGCACACACTCACCAGGATCTGTATTTTCTTTAGTTTTTCAATTTGAGTTTAAAATATGGATATCTTTTACATTTCATTCCAG
>TTN-202,,0,524,1010536,1011059,GTTGGTTGATTTCTTGGGCTTTTCCTTCATCATTATAATAATGTAGTTCCTGATTTTCATAAATGTATATGGGTTGTTACATCTTCTATAGGATAACATGAGTCCGACATCTTCTGAATCAGCAAATTCAGAGGCAATACCATCTGTAGAATTAGAAGAAAACCATGTTCAAAAGTTATATCCCTTTCTTTTTGAGGAATTTCCAAAATGATGATAGGAATGAAAAATAGTCCCTGGATAAGGTTAAAGCAGTCTTCATTTATGCTGAAATAATTCACCACATAATTCTTCACGGCAAAGAGAGAACAAAATCCCTAGCAAGTCAACCATCACATTCTGCCCACTGATTCTCCAAGCTTTTGATAGTGTGAACCCATAGAGGAGTTTTTAATACCGTCACAAAAGAGCCAAATGGATCTAGGGATAGTCCATCAAAAAGACAGTTCTCTCTTCAAGTCATTTTATAATTGTTGTCCTTTGTTTTTTTTGTTTTGTTTTGTTTTGTTTTGTTTTGTATCATTCAG
>TTN-202,,0,109,1011060,1011168,GTCAGTTTACAAAACAGTAAAATGAATTGCATTTCATAGTTTATTAAGCATGTTTGTCATAACAATTCACAAATACTAAACCTTTTCTGATATGTGCTTTTGTGTTTAG
>TTN-202,,0,103,1011169,1011271,GTTTGTCAGACTGCTCTTCTAGATTTATACGATTAGTAATTAGATGTGTCTTTGTCTGTATGTATATGTGTTTGATTTTATATTTTCAATTTGGTCACTTTAG
>TTN-202,,0,92,1011272,1011363,GTTTGTCATGATTGCACATTTTTATCTTTGTATACAATCGATGATCTGGCATGTCTCCTTCATGACTGATTGATTATCTCTCTTGGCTGCAG
>TTN-202,,0,594,1011364,1011957,GTGATTGCAATATTTTTAAAGTGAACGAATTTGTGTTTCTTTTGAACAAGATTTAAAATGTCTGGGGAGGCCTATTTTTTAGGAAAATCTTTCCAAAGGCTTAAAATTCTGCTTAAGTAATCCTATTTACAGTTAGTGGCTTATCTTTTTCTATGGATTCTACAGAGAGATAATATGACTAAATCTTTAATTGGAAGGATTATGCAATCATTTGCTTCTATAATTAAATCTTTTTTAAAAAGTGACCATATATTTTTAAATTCCACCCCGTAAGTATCTCATGCAAATTGCTAGAAGGCAGTCTTTAAAATTACAGGAATCTGCTGCTTGCCCAGAGACATGCCTTCAGCCAACCAATTGCTTTATTGGTTTTCATACTGTTTTGCACCTACTGTGCATTAGGGTTGGTCTCAGAGTGATACTTTTGCTCCAGAAATCTATATGCTTTTCTTTATCTCCAAGTTAATTCAAGAGACATTAATAATTCCTGATTTTTAATAGAAATTGCATATATACGTGCGTTTGTATATATATAATTGTGAGAAGAGCATTTAGTAAATTAAAGTATTTGTTACTTTTATTCTGTTCCTACAG
>TTN-202,,0,139,1011958,1012096,GTTTGTGGATTCTTAAACTTTCATTTCTAGAATTAAAGTATTATAATCAAATATGAACTTAGGGAGAAATTTCTATTTCAGTAAACTGACATGGTCCAGATATTGAGCCTGAAACCTTGTCTTTCTGCTCTACTATTAG
>TTN-202,,0,778,1012097,1012874,GTATCGTTTATTTTGCAAGTGGTCCAACAAAAGTGTAATCATTTTGTAGTATAGCCTGAAGGTGTCGTTTTTATGATGATGAATGCAATTTAGGACATTTTTAAACAAATGAAAAGAAAATGTTTAAGAGGAAATAAGTTTATCTAGAGAAGAAGTCATTTTTTAAATCTGTATTTCTTTCTTTCCTCGAGACAGGATCTCATTCTGTCGCACAGGCTGGAGTACAGTGGCGTGATCTCAGTTCACTGCAACCTCTGCCTCCTGGGTTCAAGTGATTCTTGTGCCTCAGCCTCCTGAGTAGCTGGGATTACAGGCGCCTGCCACCATGACCAACTAATTTTTGTATTTTTTGGTAGAAACGGGGTTTCACCATGTTGGCCAGGTTGGTCTGGAGCTCCTGACCTCAAGTGATCCACCCGCCTTGGCCTCCCAAAGTGCTGGGATTACAGGCATGAGCCACCACACCCAGCTTATAATCTATATTTCTAAAACTTTATATATTCCCTATGATACTGAGACTACCCCTTCTTTTTACAAATTTGTGATTCTCTAAATGGCCATGAGTTACTTCTTATCATCCACCTTGTAAGTCAAAGAACAGTTTAGAATAAGCTCGTAGAAGGAGGCTGAAATGTTTAGGAACATATTCTGATATAGTGTATTTAGTTGGTTAGCCTTGATTTTTAACTAAAAATATGAGGGTTTTTTTTCTTGAAAAGCTTCATATTAGTAATCTGCTTCTAGCTTCTACTTCATATATCCTTGCAATTTCTTATAG
>TTN-202,,0,1752,1012875,1014626,GTGAGTTATCCTCACAGCCCCAACCTGTTGTGTTTTTCTTCACTGCCTGTTATATATCCATGAGCATTTCTTATGATATCTTGACCAAGTAAGTTATAACAAATATAAATACACATTATTTAACTGTGTATTTATCACTCCATATGTTTACTAAAAATATAAATTATTGTAATTTAATTATGTGGCTTCCCGAAGGAGGTGTCATTTAACGGACTAATATCTTAGGTTTCTAAATCATATCCTAAAATTCCTTTAGGTAGTTAGAAGTTTCAGCGTACTCTGAAATGTGTGCATATGTGACATATATTTTTATGAAGCACATTTGTTTTGAAATTTTTTTAATGTTCATCACCAAATATCACATTAACTTGACTATTATTGAGTTATATATTATATCACAGTCTGAAACTTTCTCCTTTCCAAGTGTATTTCTAAAGGATTATTGTTTAATGTATATTGCCCAAAGCGTTTGACCTGCAAACAAATATTAATCCCAGACAAAAGGGTAACATTTGCCCAAAAAGAAAAATAATGGGTAGAAAACATTGCATATCATTATGGAAGACATATTTAAATACACAATCATCGCTTGAGAAAATGAAATAGACCATGTTGTTTAAGGATATCTTTATCTGTTTCTCTTCACTGTAATGGCTTCCAGTAATTACAACATAGCTTCATCAAAATCACATTAAAAACTAACCTCCTAGAGCAGCCTGGAATTAATTACCAACTCTTATGATCTGGTTAGTTATCTCACAGTGCACAGGTAGTAAGTTATTATTAATAGGCTGATATCACTAATAAGTAAATATCACTGAGTTGTCTTAAAATTCCAGTTTCACCACTCATTTTGTGGAATTTAGATGCATTTAGTTTTAAAACACATTTTATAAAATGAAAAATATATACTTAGCAGTGGCTTATCTTCATGATTTACACTCATGATGGTTTTACCATGGGCAGATAAATGCTTTCTATAGAATTCTGAAGCTATTTATAAAATGTTTTTAAAGGATAGACATCAGAAGTTTTAATCTTTGCAATAACAAAAAAAATGGCCTTATTCTTTCTAGGTACAGGTCTCAGAACCATTGAACAAAATCATTACATAATACTGAGTTGTACATTGCCTTCCTATCATGTTACTCATCAATGTCTTCATCATTGGTCTTCAGTTAAACACTGAGCCTCAACTCCTAATTCCCTTGGGCTAAGATTGGATTTTAAATGCTACTGTGGCTGCATTTAATAGCTAAAGATGAACATCAGAGAAAATCACATATAAATATGTGGGCTCATGTATTACTCAAATGCTAGCTTTCTTTCCTAGAGGGTAGCAATCATTGCCGCTGGAGATAAGCAGAATTCCCAAATAAGCCCTTCATTTTCAGGGTTCAGCAAAAACACCGCTGTACACAGGTTTGAGAGAATTAATAGTGTGCTATATGGCAAAGAAGTTCATAGTAACTGCCAATGTCTGCAGTGCTTAGTAAGGACACAGAGGCTGGGGCAATTTGTGGGCAGCATGTGATGTGTTCTTTGCTTGTTTTTAAACCTTTATCTTTTTAAAAAATCCAACAAATTTAAACTATTGTCTTTAGAGAGGAATAAACCAGGCACATAATTCTGTCCTACTACAGCAACAGTGTTACCTGTTAGAGGCCAGTTTTTCTCTTTATTTGTTTCTCTTGTGGAATTTAATACTTTTTTGCCTTTATGTTCCTCATGAAAATACCTTTTCAATTCCAG
>TTN-202,,0,571,1014627,1015197,GTACAGACACCTCAAAAGTATTATGCAGCTCAAGCCAGCAACCACTCATGTTTATTTGCTTATTATGATTTCCCTAGAAATGGAATTAGATTTTTAGAAATATCAGTTGTTGCTCATCTGCAATTTGTAGGCTCCTTATTATAATTGAAATATTAGGTAATTTAACAGAAATAATGTCAATACAAAGTATCTGAAATTACTACAAGTTTACCACCCTATTTCTTGAACTTCTTTTCACCATATCCATTAAGATGTAATTAACGCAGTTCCAAAAATGATGCTATAATAATGCGATAGAAAGTAGGCTGTTGTGATACACCTGGAAAAAATAAAACCAAGTCTAAAAATATTGACACTACTAATATGATTATAGTTCAACCTTTGATAGCTATCATTAGCATAAATGTCTGAGAAGCTGCTTTATCTTCTGTAACCCACCCTTACATAGAAAGAGAATTCTGCAGTACTTACTTATCAAACTGCCAACCTCCTAAGGCTTATTTTACAAAGGGGGATATGTATTGTAATTCTGAGGTGATTGTAGTAACAAAACATGTAAATGTTTTTTCAG
>TTN-202,,0,122,1015198,1015319,GTAAGTGCACTTCATGAGAAGTACATCTTCATCTATCTTATACCTTTTACTTATGATTTAATTTTGGAAGAACTGATTTTAGAAAATTAAATTTTTATTCACTTGTTTTCATTATTCCTTAG
>TTN-202,,0,1096,1015320,1016415,GTGAGTTCAATAAAAACCACAAATCGTACAATCAGCCCTCCATATAAGTGGGTTCCGCATCCACAGTCAACCAGCCCCAGTGGAAAGTATTAAAGAACAAAAAATTTAAAAATACAAATAAACAATACAGCATAACAACCATTTACACAGCACTTACATTGTATTAGATATTATAAGTAATCTAGAGATGAAGCATATGGGAGGATGTGCATAGGTTACATGCAAATACTATGCCATTTTGCATCAGGGACTTGAGCATCTGGCCACAGGCCTCCTGAAGCCAATCTCCCAGGCATAGAGAGGGATGACTGTAATGTCCCATTCACAAAAAGAATCTCTCAAGAGTCATGGGCCATCCATCTCAAGATTCAGATTGTTAAAGAACATAGGCATATAGACATTTTCACAGAAGCAGATAAGCAAATACACAACATCTGGGTGTTCTTGTTTCATTAGAATCAATTTCCGAATTTAAGAGAAAGTTTTAAGAATGAGGTGAATGTCTATTAAGATTTTTAAACAAAAAGAAATGGCCTATAAAGAAACCCCAGTATTGTCTGTGCCTAGGTATGAAACTTTTTTTCTATATATGATTTCTTATGTTATGAATGGTTCTCTAAAACAACTGTTTTAAACATTTTCCATAATTATCATTCATTTCAATATGGTTCATTTTTCAACATAATTATTAAATTAAATCCACACTCAATTTCCACACATCGTTTCCGTGATATGTATACTATTCTATTATTAAAGTTTTCCATTGCTATTATTATTTTTTCTGATATTATAATTCATTAGCTAGGCTCTTTGGTTATAAAGTTTACAGAAATACTTCTATTATCCTTTCCCTTCTTAAAATTTTCATTCCTACATCTATATTTTATTACAATGGTCCTAATCCATCTGATCTTAATCGACTCCATCTCCAAACCCACATTTTTAAATTGTTTCACAGCTAACATGGTAAAATTAATATTTATTGAATAAAGAACATAGAAAACCTTAATGAAGTATATAATCTTTGAATGATGATAGACAATTAAAAATAAGTAGAAGACAGGTGTTTTATCCTTACTTTTTAAATTTTATTTAG
>TTN-202,,0,207,1016416,1016622,GTATGCTCCTTCATATATAGCATCATGCTAAAAAAGTCACATTTAAAACATCTCACATATTCCCTTTGAATTACCAGAATCCTATAGTTATATGACGTCATTTAATATGACCTAACCAGCATCCAGAATGGAAGCTGAATATAGTCATGCGTCCTCTAAATCAAATTTTGTTTCATCTGTAATGCCTATCATTTTTGTTCTTCTCAG
>TTN-202,,0,99,1016623,1016721,GTAAAAAGAATTATGTTGATAATAAAATGAACAAGTTATTATTGAGTATTATTATAAGGGAAGGAGTAACAAATGTGTTTTAATTCTTTATTCTCCTAG
>TTN-202,,0,102,1016722,1016823,GTAAGTTAGAAAAGGCTTATGAAATACTTGTGAGATTTAAATTACTGTTGAGCACATCTGCGTGTGATATTGAACAAAATGCGTGTTGTATCACATGAACAG
>TTN-202,,0,1483,1016824,1018306,GTGCGTGAAACACTATGGAGTCCTTGTGGGTACAGCATAGGTCAATGGCAAATGTTGTGCAGGACCCCTGCAACCCTACCTGTAGACACACACCAAAGTGGTCATGTGTTCTTATTTCCCAACACACGTTCTCATAGTATTCATCTCAAAGTTCATACAAAAGCACAAGGGAAATATTCAAATGAGTGTCAGTTCTTTTGCATCGTTCTTTTAGATTTTAATCTAGTCTAAGACATAATCTTTAACAGTTATTTCTGTCTAAAGTCTAAATTTCATGATTCTCATATCTAGGATTGTAGAAAGAAAGCTAGGAAAGGACAAGATCTCATAGATGTAAATCTGGAGGATCTTGGCTAGGAATTGATATTTTGTTTATAGGACTTAGTCTGACTTTCTCTGTACAAAATTATATAGATAACATAAACATGTCATGTGCAATTAGCAACTATTTTTCAAAAATATTTATTTCATTTTCAGATCATGTTTCAACCTTCTGAATCTCTGAAATTAAGTGAAATCTCAGAATTTAGGAGTAACAACATTCATTTCCTAATTGATTATACACATTTTCCAAAGACACCCTCAAACTGTATTGAGAAAAATTTTGGCTATGATAATAGCATCTGCTTTCAGCTATTGGTGCCCATTCGTAGTTGCTGAAACACAAATATATGACATTGGATTTACATAAGCATGTCAACTTTTCTGACTTACCTTACAATGAATATCAGTGACTGGTTGTATTTTAAATGGTTTTCAAATTAAAGGGCCAGCTGCAAGTACTAATTATTTTTTAAATAATTGATATTTTTAATATAATTCTTTAGTAAATAGAGCTCACCAGAGTACTGTGATTTCTAAGACTTTATGGTACTGTTATACATATAAGACCCTCCCCTCCAGCCTCTTCTAGAAAGCACTCCTGCCATCCACACACATACTTTGTTTGTGCCCATATGTACTTAGCAGATTTCTGAACTCTAAAATTTTTCTTTTTGAAATTTAGAAGTGCAGATTTCCGATTGCGTTTGAAATTATTTTACAGGAAAAGTTATACATATTAGATAAACAATTATAGATCCTGAATAGCAAAAATTATTTTACTGAGGCAAGAAAGAATTTCACAGAGGAATAAGTTGTAGAGTACAATCAAGTTTGTGTTCCCTAACACTTTTAAAATTTAATTTGACTTTGGGTCATTAGCTCTCTTTAGTATGTTCTTTATATAAATATTTTAAGAACTCACAATAATTTCTTTACACTTTGCTACATTCGACCAGCATGAATACACTTAAGAATTGGGATACTTTTTTGTTAGTGATGCAAAGAAGAGTGCATTTCTTCTCATTTTGGATTTTTGAACTTTTCTTGCTATTTTATAACTGGGTACAAAGATGGAGATTTTAAGTATCTGAGGTAAAAGCAAGTAAAAGAAATTCCTCTCTATATAATCTAACTTTGAACCCTCTTTGTACTTAAACAG
>TTN-202,,0,208,1018307,1018514,GTGATTTCATTGACAGTTTTCCAGTGAATGTATAATTTAAGCCTCGTCTGTTTTCTGTATTTCTACCCTGTATGCGCTCATGCTCTCATTCTATCTAGAATGCTTTTTTAGAAAAGACAAGTGTAAATAAACACATACGTATATTGAAGTAAAGAAGTGTTATTTGCAACATATCAGAAAACAAAAGTTGGATGATTTTTCACCCTAG
>TTN-202,,0,101,1018515,1018615,GTGAGGTAGCGCCATCAGAAAGCCACCCTGCCATCTTCGAAACACGTAGCCTACCTATACCATTCTGAACACAAAAATATCATTTTTTTTTTATTTTGCAG
>TTN-202,,0,452,1018616,1019067,GTAAGTTGTTTTGTAAAAATCAATCCTTGCTTACAATAAATTTGGCATAATTTTGTAAATCACAGAAGCCAAACTAAAATGTATAAGATATCTTTCTCTTTTGGGTAAAATATTTTTCAATAAAACTGTTATGCAGTAGAATTACTTTCAGTCAAATAATAAAATGTTAAACCTTGTGAGTCTGGCAAATTAGAGATAATAAGGTCTCACTCAGCTGATGCTAGAATCATGTTAAATAGAATAGCCACAGAATGAAACAAATTTTGACAGTGAACAAAACTTACCTGCGTGGTTGCATACAAAAGAATACTAATATTATTTTGTCTGTATATTAGATTCTGCCATTAGATATGCCTGACATATCTCAGGATCTAATAAATCAAACACACCTTAGTTTTCTAATAAATAGCTTGTTCTCAGTCTCTCTATGCTTATTACATGTCCCTTTCCAG
>TTN-202,,0,324,1019068,1019391,GTAAGACCCAGAACCTCAACATCTGAGCTTGGAGCAGCAATATTCTAGCACTAGGAATCTGTACGAAATTTTATACCAGCGACCAAACTGCAGCAGAGTCAGAACAAAACCTTCCATGTCATATTCTTCAGTGAGCAATTAGAAATTAAAGTAAAAAAAAAAAGTAGTTCCAGTTATAAATAAATGCTACTTTTATTTGTTCCGACTGATGAATTCGTACTATAATACCTATGAAGTACTGAAAGAAATGCATGAGACTTTTCATTATATTTTACGCAAAATAAGAAACTAAAACATGTTACTAACGGCATTTATTTTCTTCAG
>TTN-202,,0,2205,1019392,1021596,GTATTATACCTCATCTACCTAGATGTCGAAATAAGAATTTCACTCTGCTGACCCGAAAAATGTTGCTTAATACAACGCATTGGCCCTCTAGTGGTCAAGAGGTGGAATTGCCTTTCAAAATGTAAATTACTTTCTCAAAGTATTAGCTAACTAAATGTGTAAGTTATGTGCTTAAAACTCTGAAAATCATCAAACAAAATACTATTTTGGTATTAAAATATTTTATTTTAATGAAATTACTGAAACATTAATAGAGAACTAATTTAATGTTTCATATTTTCCTAACTACTATGTATAACAAAAAGAATAATGGAACCAATTTCTAGTGCAGCTTATAGAAATAAACCATAGTAGTTTACAGCCAAATTGCAAATTATAGCTTGTGGCTTTTCTCAATTTATAGTATTAACTACTCTTAAAAATTTACTATTTTGTCACATAAAATATGATTTAGAATACTTATGAAATATTTGACTTCTTTTGTACCTAAGGCATGATCTCACCAATAAAGAGATCTTAAGTGTTCCAAGGAATTGCTCCTCTCAAATACTCAGTAGAGAAGTTGTAGTATTTGTGTCCCAAAGCTTCTCAACTAAATTAGACAACAGATTTCCTGGGACTTTCTGGAGTTATAGGGAGTTCAGAAATGCTGTCAGAATTCTCCCAGCATGGTCAGAAAAAATTCTGTATGTCAAAATCACATTTTTCTATAGCTAAGTCACTACTACTGTATTAGATTCAAGGGGTGGAAATGGTAGGCCCTTAACACCCGCTATAATTGGCATTAAACGCTTGACCTATTTTTCAGCCAGCCTTAGAGGAAATTCAATTAGAAACTTCCAATTTTGTGACTAATGCAACCTCATTAACAAAGAGAAGCATTTTTATGATTCATACGAACATAAGCATTTTATCTAGCTGTGAGAACAGAGAGGAACAAGAATCAACAATCATAAATTGGATTTCCATTTCTATTTCTGTTGTCAAAAATAATAACTTATGTTAATGAATGATTTGTTCTTTGACTGGTAGTATCAACATGGCTAAGTTTGGTACTCACTGTGAAACTTGAGAAGTTAAATAATGTTTTAAAAATTAAAAAAGAGGCCTGGCGCGGTGGCTCACGCTTGTAATCCCAGCACTTTGGGAGGCCGAGGTGGGCGGATCACGAGGTCAGGAGATCGAGACCACGATGAAACCGCGTCTCTACTAAAAATACAAAAAATTAGCCGGGCGTGGTGGTGGGCACCTGTAGTCCCAGCTACTCAGAGAGGCTGAGGCAGGAGAATGGCGTGAACCCGGGAGGCGGAGCTTGCAATGAGCCGAGATCGAGCCACTGCACTCCAGCCTGGGTGACAGAGTGAGACTCCGTCTCAAAAAAAAAAAAAAAAAAAAATTAAAAAAGAGTGGGCTGGGCGCGGTGGCTCACGCCTGTAATCCCAGCACTTTGGGAGGCCGAGGCGGGCGGATCACAAGGTCAGGAGATCGAGACCATCTTGGCTAACACGGTGAAACCCCGTCTCTACTAAAAATACAAAAAATTAGCCGGGCGCGGTGGCGGGCGCCTGTAGTCCCAGCTACTCGGGAGGCTGAGGCAGGAGAATGGTGTGGACCTGGGAGGCGGAGCTTGCAGTGAGCCGAGATTGCGCCACTGCAATCCGGCCTGGGCTAAACAGCGGGACTCCGTCTCAAAAAAAAAAAAAAAAAAAAAAAAAAAAAAAAAAAAAAAAAAAAAAGAGTGTTATTTATTCATGAATACAAAAGGCCATAATCAAGTATGATTAGGAACCGTGGTTAAGGTATAACAGCTGCACAACAAAGGACTTTAAACCCACTTGTTACTCTTCCTCCTAACATATTTGTGTTCGTCCCTAAGGATGAAGCAAAGATGAAAATGTGTACTTTACTATTTATGATATCACTTAGATTCACACTCCATGTTCTGAAAACTTTAACTCTCAGCAGACATAAAATCAGTGAAGATGTAAGATCACAGTACATTTTCTATATCCCTCCAAAACAATTTTTTTGCATCTAGTCCTAGATCTTTCCAAAACAAATATCTTGTAGTAATATGCAGAATCTCGCTACTATCAACATATGGAAAAATAAAATATTTCAATAAAATTCCTAGTTTCCTGAAAGCATTTTAGTTACTTACACCAGAAATATTTTTTCTTTTTTTTTCTTTTTTTTTTTTTTTAG
>TTN-202,,0,1674,1021597,1023270,GTATTATAATTAATCAAAAAGCAGTCTTAACACTTTTTTCTTGGCCAAAACTTTTAAATTCTAAACAGTGGAGGGTGAAGGAAGGGTAAGAGTTTGCAATCACAAAATGGTACCTCTCCCTTCACTCACTTTCGCCCTCGTCTTTGACTCAGTCCTCACTCTCTCAACTCCTTTTTTCCCCCTTTTCTCTTTCCTGTCCTCCTGAGCCCCTGGGAACCAATGACAACACCAGTGTATTCTGGTTATTTCTGGATGAAAATTTAAAGAAGGTCTTGCCCAGAAATCCAACAGCTATTCTTTTTTTTTCTTTTTTATTTTATTGTAAATTGACTATTTACTATTGTGTATATATTTATGGGGTACAAAGTGATGTTATGATCTGTGAATACAATATGGAATAATTAAATCAAGCCAATTAACATATCCATCACCTCAAATACTTAACATTTTTGTGGTGAGAATATTTGAAATTTACTCTTAGCGATTTTGAAATGTACAGTACACTATTATTAACTATATTCACCACTCTGTGCAACAGATCTCAAGAAAAGCCATGTTTCTTCTGTCTAAGATTTTGTACCCTTTGACCAACATTTCCCCATTCCCTCAAATCCCCAGCCTCTGTAACCATCATTCTACTCTTTATGAATTCAACTTTTTTAGTTCCACATCTAAGTGAGAACTTACAGTCTTTGTCTTTCTGTGCCTGGCTTATTTCACTTAGCATAATCTCCAGTTCTATCCATGTTGTCACAAATGACAAAATTCCCTTTTTTTATAAGGCTGAATAGTATTCCATTGTGTATTTATATACCACCTTTTCCTTATGTATTCATCCATTGATGGACACTTAGGGTGTTTCCATAACTTGGTCTTTGTGAATAATGCTGCAATGAACATGGAAGTACCCAACAGCTGGTCTTGATAAAGTCACATCAATGTAAGATCAAGGGTTGCTGCTAATTTTAAGAGGTTGCTGCAACCCACCTCAGTATCTTTCCTGATTTAGGTGATCTAAATATCAATATTTGAAGAAAAAATACTTTATGAAGGAGGATCAATTCAAATCACTTTAACTTTCAATATATCCTCGAAGATTTTTAGGAAAACAGTTGGATAACTAAATTTAAACAAATAGTTTTAACTCATTTGACTAAGATTAGAGTACAGCAACCTCCATAAAGAAGGAAAATATGGAAACACAAGGCATCATTCATCATTCAGACTTTTCTGAGTGGTCATTTGTGAAACATCATGGAATAAGAGGACACTCAAAAAGCATGGATATTTCATGAACTTCATAGTTAATAATTGAAAAAGTCTAATGTGTTATTTTTAGCATTGGACATATTAAACATTCTCTTCATGCTTAATGTTAACTTATTAGAAATCAATCTAAACTAGAACCAATTTAAATGATCTTAAATCAATCTAAACTAGAATCAAACTTTGGCCTTTTGCATGTTTGATTTTTGTTAATATGGCCTTGCATAGCATTTCTAATGAGCTAGATTTGGAAATTATAGAAGCATTATTATGATTCCTGGAAGGGCTGGTGTATGAGTAGTAGTCATAGCTCCTACAAACAACTAACAATGATGTGGAGGATTAGTAAACATTAATAATAATGTAATCTAAAAATAAACACACATTTTTATGTTTTTAAACTCCCAG
>TTN-202,,0,851,1023271,1024121,GTAAATAAAGATAAATTATTTTTATTCTGTTTATTCCTGAGATTTGCACTTCTGCTAACTATTCTTATTTTAAATATTAGGCTTCCAACTTATTGAAAGTTGTGGAGTCTCCTCTGCTGTGTTAAATTTAGCATTAGAAATGATGGCTATTTCATATTGCCCCTTTCCCAGGAAAACAAACCCAGGCAGATGTTTATGCTGCCTCTGTGCAATGGTCTCAGAGAAAGAAGAAGTGAGGGCTAGAAAGGAAGGGCCATTCCTTATTTTTTTATTGTAGTTAACACAAATGTTAAGAGTCATATAAATAATGAGAGCCCTTAAGAACTTTAAAAATCTGTTATCTAAAAGTACCTAATTAACTTGGTTACATAATTTTAAATGTTGTTTTTATGAAACTGACTAAGGGATCATATGCAATAGTCAAAAACCTAGGTTTAAAATTAGAAATGTTTTTGAAATAATAATCAGAACTTTTTAAAAAGGTTAACTGTATAAATATGAAATATAAATTCCATGAACTTATCGAATATTAAAACTATTCCACTGGAAGAAACTAGGGGTTCTGCAAACTGGAGCTCTCATGGAATAATAGAAGGTGTGTCCATTTGATAATATTTATTGAATCCATTTTTTCATACTGGAAAAATCCTCAAATCAAGAGTAGAATGCATCTTGATACTCTACTATGTTCCATAGTCAAAAATTTAAATGGAACCAATACAAAAAAAAAAAACAAATTATCAATAAAATAGATCTGAAATACTGATGTTGTTTAACTAGGTAGATTTTTGTTTAGTGAAGCAGTTGGATGGATAGAATTAATATGCTAATAGTATCTTTATCTATTTTAG
>TTN-202,,0,454,1024122,1024575,GTATGTATAAACTGAATGACTTGTTTCCCTCTTTTCTTCATTTTTGCTCAGTTCATTAAATTTTCAATGCTATGAACCTGATTTGCAGTTTATGTGAAATAGTTAAAATGATCTTAGATTTTTTTAAGGTTAGAAATCTTTTAAAAGTTATTTTCCTCAGAGTTACTTTCATGCTTTGACATTACAAGCTAAATCATTTAGTCTTATTACTAACACTAAATTCCAAGTGCTAATTTCTAATGCAGAAGTTCAAGTTTTACTTTTACTGCCTTGTTGCATCTCTGCTTGATCCTGCTTCAAATCCTAGCACTAAGAATTGTGTTGGTAATAACGATCCCAAATATAATACTTCACACGATTATATATTATCCTTACCTTATCTCATTTGCAATTAACAACCTAAGAGAACTTACCTATTTAAGCATCCCTTCTTATTCCTGTGTTTTTATTTCAG
>TTN-202,,0,441,1024576,1025016,GTAAGTAATTAGAAATATTTAAATAGACTAGAGCATCAACATCATTATCATGGCTTGTTTGGCAGCAATGTATAAATCAGCAGTTCAATCCAATAGGCACAACTTCTTCTCTAAGCTTTATTGTGAATGATTTTTTTTTCTTAAAATTTCTATCTAATTGATTTCATTAAAAAATCAAAAGATGATAAAAATTGTAATGGTAAACTTAAATATAACCAAAATATGTTAAGTACAGAAACTTGTACCCAGAGTTCAAAGTTGTGCGTAAAGGTCAAAGAAAAAAAAACCGAACTCATCTCTCTCTTTAAAAAATGATACATGTATCTGCATATACACTTATAGGTGTGTATAAACACATATACACAGAGAGAGAGAGATAGAGAGAGAGAGAATTTTAATAGGAATTCTAAAAGTACTGCAATTTCTCTAAAATGCTTGCAG
>TTN-202,,0,152,1025017,1025168,GTATTATTTAAAACATTCCTAGCACCCATGTACACAAGTAATATGTTTACTGATCTATACTCACATTAGTTATTTATATAATCAAATACTTTTAAATTTTGTGCAAAGCAATATTCTTCAAAATACAAATATATTTGTACATATTTTTAAAG
>TTN-202,,0,590,1025169,1025758,GTATACATCTTTGTGTTTCAGCTACAAGTTCAAAATTTTTTTATTTATGTGTATGGACATGTGTACATATATTGCTAAGTAACTCACAAATCTGAAACGACCAAAAACAGCACATTTTTACATAATACAAATTTTATGTTGAGTTGCACATATGTTTAATTTAAATAGTAACATTATCTACTTTGTTTCTAGTTCTGCTTAAAAATTACATTTTTTTATTATAAAGAAGGTTTGTGTTTAATTAGTAGTTTGCTAACTTCACTATGCAATGCATTCCATTGCATATAATATTCCCTGTCCTCTTATTTATAGAAATAGACCCTAACAGATTTGGAAAAGCACAACATTGTGTGTGAAGAAGTTGTGTCTATTTGATTCTCATTTAAGAATGTTTGATGAAGGCTGCATGCATTGTTTGTCCCTATAGATCAAAACATGATTTGTTTTCTTGTCAATACTGAATTTGTTCTCAAGCTACCATATTAACCCACTCATTCTGTGTCTAAATACTTGAGTATAAAATCCATGTGTTTGATCTGATGTCTTGTACTAAAAAAAAGGAATACTAATGTGAAATACTCTCTTTAAAG
>TTN-202,,0,232,1025759,1025990,GTATAAGGCAAACTGGAATGTGGGGGCTCAAATGGAAGGGTTTTAGGCAGATTTTTATCCCTCTTGTTGTCTAATTTGTGATCGTGTAGACATTTCTGTCTCCTTGTAAATTCTGTCATCTTTTTCATTTCATGTTTGTCTCTGTTTTCATTTTTATTTTAATGTTCTTTGTAAATTACAATTACCACCCACAACATGGCATATCAGTAATTAAAATGTACATTTTTTTAAG
>TTN-202,,0,1028,1025991,1027018,GTATTAGTAATTCATTCTAAGTTTAAACTCTTTTAATAAAAATTAGTACAAATACCATAGTAAAACATTTATGTTAGTATTAAATAATAGATTTAGTCACAGTGTGCATACCTATAGCCACTATGTACAAAGGATGTGATGGGGGACGGGAAGAACCATGAGGAAGGCACAGGGGGAAAAAAGTGAAAATTATGGGAGGCTCCATTCCCTGCTTCAGAGAGTTTGCAATCTCGTAACCTGTTACTTGGAAATACAGTGTCCTGGAGCCAGTTCATGCTAGCTCACCAGAGCCTATGGTTACATTTTCAGGAATTTTGCCAGTCAGTAGTTTAACACCACCATTATTAAAAATTAGATTATGTAAATTTACAGTCCAATAAAGTATATTTTTAAATATTAATAAATACTCAAAACTCCTATTTTACTGCATTTTGTTCTTATCTGTGTTTCTGAGATTGTTTCCATCTTTGTGTCTGTGTGGTGGAAATGCCATATAATGTACTACTGCACATCTCTTTCCAACTCCAGGACAATGACATCACCTTGACAGCCAGGGTGGGAGGGAGTGTTTATACCACCTTGGAAATCGGAAATCTGCAAGCACTATAGATCAAGGCTCCACCCCCTCCATCCCACCCAAATTGTTAAACATTTAAGACACAAAAAAATCTAATGCAATTGTATTTATGAAACTGCTTTATAAAAGTAAAGGTTACAAAAAAAAAAACTAACTTCATAGTTATCGATGTTCATAAAAAGCTGGTTTCTGAGGAACTGACACAGGCACCTCCGAGGGAGGATTGCTCCTACCTGTTCCTGACAAAGTAGAGGCTTCTGCAGTTAAAGGTGACAGCAGTCACATTTTCTAATTAGCCATTCAGCCATCTTCATTTACTCTCATTTCTAAAGCATAATTTTCTTGCATTCAGTTGGTATAAAAAGGGAATCTCTATTTAATTCTAAGTCTTACAACAACATATGCCTTGTCAAATGCACACTTTCTCAAAAATGGCACTTTTCTTTTAAAG
>TTN-202,,0,397,1027019,1027415,GTAGAATAATATTTGTGAAAAAAATAATTCTTAGCATCCATCTTGTATCTTTTTCTATAAGATCTGTGTATTAACAAAATAGCATCTGTAAACCATCTATAATATATTTAATTCTGTGTATATTGATTTCATTTATTTGTGGTGATGTGTTATACAAGTATTGGTAACATTTCTAAACTCCAGATCACGCTAACTGGGTCTTTGTCTGCTTGTGTAATGTATGTAATGTCTATATGGTGTTGAGGTATTTAGCTTTCATTTCTACCACAAGTAGGCATATTTAAATTACTTCCTAATTCTCACACTGTTAGTGAAGATTTATGCTTTAATGTAATCTTAGATGTCTCAGAAGGTGACTAGAATATTCCACATTATTTCAACAATTGTATCTTTAAAG
>TTN-202,,0,2119,1027416,1029534,GTACGCCAGAGCCAATGATGGGGAGACTCTTTGCTCCAAGTGCCAGCCTTTTGCTTTCTACGATCTTCATATGTACTATGCTGCCTTTGTCTTTTGTCTCTTTTACATTCTTCTTGTGTTTTTACTGTTTGTCAGCTTCCGTGCCATGCTCTTGACATACTTTATTTATTATACTGAATATTCCTAAGACATCACCAAAAAGTATTGTTAAAGGAAGTAACTATGTCAAACTGCTATCTTACATTTTTAATATCTTCCCTCTTTTAGAGAAAGAGGAAATGTTTGTGAAACTTGTTTTCTACTGACATGTTTCTAGGAAAAAACCTTTCATCCTTCATAAATGTAACTTTTTCTTAATAAAAGCAGTTTCATGCATTATGAAGAGGTGGAGACAGGCAATGACAACTGGAGAGTGTCTGGCAGAACTGAATGTTAATTACATAAAGACGTACATAGTACCACGCTTCTTAAAAGTCAATAGTGGCGAGTCTTCAATAGTGGGGAACATACAGATTTTTTGAAGTTTACTTTCACCATTTTCTTGAGACCTTAACTGAGCTTCAGTATTTGCCATAAATGTTTCCGTTATCTAATTAGCTAGTCAAAGTACCTTTCACAGAGGTATGTTTGAATGAAAATGTGCTGCTGTGGTATATCACAAATCCCTTGCTTTGGTTTGTTTGGGATTTTTTTGGCGATAAAAGGCACTATCTTATTGAAGCACTGAAGCTACAATTGCACGCATCCATTCAGTTATAGAGAGACTCAGCAAGAATTCAACATTATCCAATTTAGGAGAAACCAGACCTAACTAAAATAGTACATTTTGAATAGTGTTCCCTTGGCCTGACTTTGCAATGTTTCTATTTTCTTCCTGAATCAAATATGCTTCTCTCTTTCTCAAACTCTTGGCTCTTTCAAAATTCTTTTGATTATCTAACCATTAAATACAAAGGTCATGTTAGTAAAACCAATACTAATACTAAAGCTACTTGAGACAGATCGTCTTAGATAAATTAAATCCATTGTTATTATGTACTACATTTCCCCATACAAAGCATAAAGAACCTTTTCTATATACTATCTGAACATTCTTGACTGTTTGTGTAATCACTAATTCGTTTTCAGCAAAGTCATATATGTCTTCTAAAGGAGACACAGAGGCATCTCTCATTTACTCATAAAAACAAATACACATAGTATAATAGCACGTATATATATATAAATACTGCATGTATATATAGCATAACATATACATATATAAATTAACAGCTATATAATTGCACCAAAATATTACAAATGCACGTGCAGAGGTGCAGGGATTCACAAAAGCTGCCAATATTGTATTTAAAATGAGAACAATTATTGCCAATAATGCATGCTGTTAAAATTCATCTTCCAATTAAAAAGTCAACATTATCCATTCTTAGAATAGATAAATCAAATACACTGTAAACATTTTTTAGGTTGAAAACCCTGTTCAAAACTCTAGAGCCCCTTAGAAAAAAAAAGCACAAATACACATACCCACAAAATTCTGCACACAAAGCTCTGTAAAGTCATTAACACATGGGTATCAGATTGAGAGACCTACTCTAGAGTGTTTCCTGAGTTTTGAATTCACTACAGGCACACCCCCCAAAAATGAGAGGAGAAATGTGGGGAAGAGAAGTAAGTTACACATATTCAACTATTCTAAGACTTCTTAGTCTTAGTCTAAAATAGTCTTAGATAAACTAAAGCCATTGTTATTAAGTACTCCATTTCTCAATACAAAGCGTAAAGAAGTTTTCTATATACCATATCCACATTCTTGATTGTTTGTGTCATCACTAATTTGTTTTTAGCAAGGTCATACAATATATAAAGGATGAATTCTGTGCACAACTTTGTTACATAACTCATTTTTGCCTAAATGCCTCTAAAACATTATTTGTGATATTTATCACATTGTGATCCTTGGAATAGTATAGTTAGTTTAATTTTCTGGATAATTTTGCTGATGCATAGATAATCCATAACAACATTAATGTACTACATAAAGATTTGTGCATGTGCCTATGTTCTTTCATAAAAGTGATATATGTCTGAACTAACATTGTGTTTCAAAAACTTTAAG
>TTN-202,,0,217,1029535,1029751,GTACAGTGGCTTTCGACGTAAAGCCCTATCTTTTATCTTTGATACAAAATATGTTGTGTTTAATTATCTGTTCATTGAGTTAGTTTAATTCTAAATGAATGTTTTGTGGTGAGAACTGAACAAAAGTGTCTGTCCACCCGTCTGCTTTCTTAAAAAAAATAACTGTGCATAGCTACTTTAGAAAATATAAAGTCAATTCTAAAAATGTCTCTTCAAG
>TTN-202,,0,141,1029752,1029892,GTACTTAATCCCATCTCCATGAAATAACCTTGTCTTTCCTTCAAGCCTCTTTAATTGCATGTCTTCTTTAATTGCCACTTCTATGTTGCTCATTTATTTGGCCTTTTTGACAAATTTTAAAATTCAATACTATCCTTTAAG
>TTN-202,,0,153,1029893,1030045,GTATTGTTTCTCCATCTTCCCAAGAACTGTCTTTATGTTCCAGTGATTTTGTTAGTTTTGTGATATGAGTGCACTGTGGGTGTATTTCTTTGTTTTGCACTGGGCTTCAATGAGATCACATTAAATTTCTAAAAGTGCATAATGTCTCTAAAG
>TTN-202,,0,274,1030046,1030319,GTAGGATTTGCCTCAATCCTCTGACAAAAAAAAAAAAAAAAAAAAAAAATCTTCGAGTGTGTTAAATTCTTGCTTTTTCCATCTGGTCTGTGCTTATACTGATCCATTGTCTCACTTGCAGTGAAACTTTTGTGTTTATGTCCTTGTGATATGTAACTTGTTTTCCCATTTTGCTAGTCAAAGTGGTGTACTGTGCAACTCTTCCCCAAATTCTAGAAAGTGAGAATTGTTAAAATTCTTGATTTTAAACTTCAACTTTAACACTTTCTTAAAG
>TTN-202,,0,452,1030320,1030771,GTATATAATCGGAAGTCAGGGGATAAATGAGTTTGTGTGTGTTTCCTCAAAGTCTCTTCTTCTTCCACATGTGATTGTTTACTTTAGAACATGTCCTCATCAGTTATTTCTCCTTATGTTGGTATTAGAATGTGTCTACCTTTTGTAGCCTTCTGGGACTGAGTCTTTTGTGTCTATGTTGGCCTTGAATCATTCGAAGGAAGTGGATGAGTCCCGAAAATGTTATAATTTTGAAAGTGGCCACACTTGGACATAACTCAAGTATCATTCTCAGTCTTGGGCTGTACTTGCCCTCATCTTAAATTAGCTTCCTCCTTCTTATAGTGAGGAAGTACCATGAAGCTATGTCCTAAGCAGATAGAAGAACAGTTATCCATCTGTAGTGACCACATGGCTGTATATACATCTGTATCTCAGCAGGCTGAATTTAAATGAAACCTTATCTTTTAAAG
>TTN-202,,0,2512,1030772,1033283,GTAAACAATGCAAATAAGCTAGAGATGATCTGGGGTTTTGATGAGGTGTTTTCTTTCACAAATTGTCTACAGACCAATGAAAAGAGACAGAAAAAAGTGACACAAATTCAGTGAACATCTACCAGTCTCATTAAATGAATATTTTGATCAAAACACAAGATTCAGGAGGATTATACTAGATTAGAGAAATCCAGTGTATTTCTTCTGCATCCCTTCTTACTTGCCTACATAGAATAAAAGAGGCTTCATATTTATATATAATTAATCAGGGCAGGTATCTCCATATACATATATCCTTTCATTAAACAGGACTTGGCTTCAGCATGGTGGGCTGGCATAAGCTTTACCTTAGTAGCCTAATGCCTAATTGGTGTTTCTCAAACATTGCTTGTACCACAATCCACAGACAGAAATATATTTTATATTATAATCCTTTAATTTTTTTATTCTAGGCATTTAAAAAATACAAGTTATAATCCATTAAGTCAATTGCAGAAGTCACTATAATGTCTTAAAATGTTTTAAAATGAGCAAGAAAATATATTACCTCATTACATTCCAGGAGTCAATGCCATATTTGTGAGTCTGAAGCCCTGAACACATAAGGCTTTCCTGTATTTTACATATGGAGAAAACCATTGTGTTATATATGGGATCAGACTGACTTGTTACTCAGATCTTTTCATACCTATAATGCTAATTATCTATAGTTTCTTAAGGACAGAACCAACAAACTATTCCATTGGGATATTTTTTCAATGAATTAAGGCAGCACCAGGTTTCCAACTAAAATCCAGCATTCTGGCTAGAGCCATGTGGCCAAAAGAACTTTCCTAAGAAAGTTCCTAAGGTCTGCTTTTAAAGAGAAATCAATAAGCTCCTTAACCAAACTAACTCTCTCCCCAGTGAGAAGATGAGTAGAATTGAAGTACATTTAGATGTCCCAAGTATCTGTTTTTATCTGTCTAATAAAAGATGGCACACCATGCCCCTTTTTTCACTTGGAACAAAAGCCCATGTAAAAATCCAAGGTGCCATAGTCTTAGTGGAATGCCTTGGAATAGGCCAAGATGGGACATGACTCCCAGGAGGAAATCCATTAACTCTGTTGTGCTTCCTGGAAGAGGCCATGATGGTGGACATAAGTCAGGAAGCTGGTAGATTTGAAGACGACTCCATCTTTTCTAAAAGTGTTTGTAAAACCAAACATAGTCTGATTTCAACTTTTGACACTATAAACTTCCTGTAGTACTCCAGACTCTAGTTAAAAGGAGAAACACTGTGATTATTTTTATGTTCTCATTATGCCCCAAAGATGGGTGGCTTGTTAGGTTTACTTTCAGCGTAAGGAGCAGATATGTTTTTAACCAGACACTTCTATTCCTTATTTAACTTTGACCAGGCATGGTGGCTCATGCCTATAATCCCAGTGCTTTGGGAGGCTGAGAAGGGAGGATTGCTTGAGCACAGGAGTTCAAGACCAGCCTATGCAACATAGCAAGCCCCATTCTACAAAAATTAAAAAAACAGCTAGGCATGGTGGCATGCACCTCTAGTCCCAGCTACTCAGGAGGCTGATGCAGGAGGATCATTTGAACCCAGGAGTTCGAGGTTACAGTGAGCTGTGATTACACCACTGCATTTTAGCCTGGGCAACAAAGCAAGACATTGTCTTAAAAAAAATTAAAACTGGCCGGGCGCGGTGGCTCACGCCTGTAATCCCAGCACTTTGGGAGGCCGAGGCGGGTGGATCACGAGGTCAGGAGATCGAGACCATCCCGGCTAAAACGGTGAAACCCCGTCTCTACTAAAAATACAAAAAATTAGCCGGGCGTAGTGGCGGGCGCCTGTAGTCCCAGCTACTTGGGAGGCTGAGGCAGGAGAATGGCGTGAACCCGGGAGGCGGAGCTTGCAGTGAGCCGAGATCCCGCCACTGCACTCCAGCCTGGGCGACAGAGCGAGACTCCGTCTCAAAAAAAAAAAAAAAAAAAAAAAAATTAAAACTGTATACACTTAGGCTCAAAAATCATGTGAAGCCTCCTGCCTCTTCTACCATACCTGCCCCACAAAACTGGCGGGGAAAACAATATGGAATATTATCTTACAATTCACTTAAATCCTCAAGTATGTTTCTGCCCTGTGGCCTTCAAATCTACAGTGCTCTGCTATTTGTGAAACTCATCTTCAAATTCTTCTGTTCTTATTAACTCAGCTATTATAATCGTTTCTTGTCCCGTACTTGTCCTGTCGTTGCTGTGGATATAAGCATTATTATCTGTATGACACATTTGAAAATTAAGTTAATGAAACCTATTTCCCATTTCCCATACTCTTCATTAACGCATGTGCTTTGATTAAAATGCTCTTTGAGTATTTTAAATAGGAACAAGCAGGGGTTTGGCAAGGGTTAAACTTTTGCTATTTTGATTACTCTTTGAAGTGATAAATTAAAGCTAAAAATAAACATGAAAAACACTGTAATTTATCTTCTTTAAAACTGCTGTCTTTAAAG
>TTN-202,,0,187,1033284,1033470,GTATGCTGACTCTTTAATTAGTTTTATCCCTATGTTAGCTTGTCTCCTTCTTTATGTTTCCTTATAGCTAATTTGTCATCCATATTGCAAATATTGATAAATATCATGTCTAATAAAAAGATCCCTTACACTTTTATCGAAAAGAAATCTAGACATTTCTACAAACATATTTTATAATCTTTTCAAG
>TTN-202,,0,263,1033471,1033733,GTATGATTTCTTTCAAAGAAATGCAACACTATTTATTTTAATGTATATAATAATACCTTCACATTTGCATAACTGTCTTATGCATAACAATTTGCATAACTGTCTACGTTTTGTCAGAACACATGTATGAACGTATTTACTGAGTATAGTCATTAACGTTTGTATATATGTGCAATCTTTTCAAAAAGTGAATGCTAAGCCCCACAACTGTGTCACTTCATATGTAAGGCAAACTCATATTCTTAAACCTAATCTTTCTAAAG
>TTN-202,,0,156,1033734,1033889,GTATATTGGATTTTATTTTATTCTCAAGACTGTCTTTTTTTAATCTTAAATTGATACATTCTTCAGATTTTTTAAACATTAACCAGAAAATAAGTGTGCCTGTGTTTAGTGTTTTCCATATCGTATGTTTGATGGTATTGCCTGGTATCTTTTAAG
>TTN-202,,0,252,1033890,1034141,GTAAACAAACCTCCCCAGCAGAAAAACTAGGAACATATGGCTTGTCTTTCTTTCTCTCTGCTGCTGTTCTTTGGGTCATACTGTTTATATGTTGGTGGGTGACAATGGTGTCTTTGGGTAGAGTATTACTTGTGATGTTTTTGTGTGTGTGCCTTGTAAATTCTTCTATTCTAAAATCACAGTACTTTCTGGCTAGTATATTTTTTACGTCCACTTTGATATAACTCCCTAATCCTAAAATTATCTTTTAAG
>TTN-202,,0,247,1034142,1034388,GTACATCCGCCCTTCCATTATGCACAATATTGTACTTGCCCTACTCTCTTTACCAAATACACTGGTTATGGGGGCTGGTTTTTGTTGTTGTTGTTGTTGTTGATGTTGTTGTTGTTGTTACAGTTGTTGTTTTATGTTTGAAATAATGAAAATGTCAAGTGTTTATGTTTGGGCTACTACTTTATGGCTGCCTTTTTGTGGTTTGAAAGAGGGAAACAATACTTTAAAGTGAAATCTCTCTTTAAAG
>TTN-202,,0,707,1034389,1035095,GTATACTGACTCTTAAAAAAAAAAAAAAAATCAAAATAAGCATCCAGACACTAAAACTAATCTAGTGGAATAGGTTCCATTAGAAAAAAAAAGACATAGTATAAAGTAAGCAATATAAGTTTGTTAATGCATATCACTTCAAAACTAAACATTTTTGATAACAGAAAGTACTTTTTTCTTAAAAAAAAGTGAGGCTTCTTCTAAACGTATGTGAATAATTTTCCTTAATCTGTATTTGTCTTCTAATGTCTTTTCCATATACTAAACTCATCTGCCTAGATGCTTGCTTTATGTGGCAATCTCTGATGAAATTTTTAATTTTTTCAATTCTGAATTTTCTACATTGTACCAATAGAGCTAAGGAAAATGTCTTAGAAGTGAGGTGAAGAAACTATTCATGTAACATAGGTTTCTGTCTAATGCTTCTACTTAGTTTGATAGTCATTATTTATGCTGTTTAGTTGTCTTTTTAAACTTTTATAAATACTACTTGATTTTCCTAAAATTATTCAATGTCTTTGACGTACTTCATATGTATATTAGAGTAAGTTTATTTCCAAGTCTATTGATTTTCTTGCTTTTTAAATGAAAGTTTAATCAGGCACTGTTATGGTTGTCTTTGTCCTTGAATTGTTTGAACAAAATTTCTCTTCACACACACATTTTCAGAATCTTGCAATTCACTTTTAATAATTACTCCTTTAAAG
>TTN-202,,0,307,1035096,1035402,GTATATTGAACTTTGATTAAGTAATGTGAGGCATGAAACTATCTGGCTCTTTGCCTTCTAGTTCCCAATCTGACTCCTATACTTTATTAGCTTATTGTTGATTAAGGGCAGGGTATATAACATTTGAAATCACAATTGCTAAATATACTCTATGATACCTTGACTGGCCAAAAAAGAACAGTCAGGGTCTCCCATAATCAGTGCATGAAACAAACGCAAAAGAATAAAATCAAAGCACATTGTTACTATCAGTCATCCTTAAAAGTGCTTTAAAGTAAAGTGCTGCCTGTTGTTAATATTGTTTCAG
>TTN-202,,0,958,1035403,1036360,GTATGAGCAAAACTGCAAACTCAAAACCACACTAAATATGTGCACACTCAAACAAGATAAAACAAGATAAATCATAACAAGATAAAAATTTGGATACCCAAAGAAATTTGGAAAGAACTTTGTTTCATTTCGCAAATGCGGAATTTTCTTCTTTGATAACTTCTAGAAAAAATTTTAAAAACCCTCTATAAATCTTAAGGTTATTGTTAGACTTTTGTTCCGGGAATAATCTAATACCCCCCTCATTTTTGCTCGTATGCAAAATAGCAAATGTCCCTAAGTTTCTTTTTCAAAAAGGTTACAAGTTTATCTTCAAGTGCCCGTGATCATTCTAGTACATGGTTAAAAATTTCTGAACATCCTTTATTCTAAAACTTGCTATTACGGAGTATGATAGGCTATTGAGAAAATGTATTTACCCACAGGGTTCCCATTATCAAAACTTGACAATGACTGCTTCAAAAGTTAAGATAGAGATGTAAGCTAACACAAGCTGTTGTGTTTTACCTAATGAAGGTCAAATTTGTTGGCATATAGTTTGGGCTTCAAATTGTTTATTTTACTCAAAGAATAAATCTCTATTGAAATTTTGAAATGAATCAATCTTATTTCACTTATTCAGTCTCTGATGTTTCATAGCCCAACTTTGAGAACATTCTACATAGTCTTACTGATAGCTTTAAAAAAACCATATTATAGGGGAGTTTCAGCCAGGAATTTATCTACCTGAAATGAAATGAGAATTTTAATATGTAAGAATTACCTAATTAAAGAAAATAGCAAGAAGGAAAGGGCAATATGAGCTTGTTCTGCTTGGATCTCTGATTCTTGCCTACTTCAATAGGCTATGGCTATACTGTAGATAAAAGATATTATTTCAATTATTTGATTCCTTTTAAGAAATGTTTAAACTTATATTCTAAGTCTAACATGAAATACCTTGTATGTACTTTTAAAG
>TTN-202,,0,210,1036361,1036570,GTAGAGTGAAAAAAACATTATTACCTGTAAGAGATCTTTGTTTCCTCCATGTCTGTCCTACTATAAAAATATATGTAAAAGTGGCAGTGTACAAATTATGTGTGTGTTTGGGAATATTATGTTGTATTTGTCTTTCTTAACTTTTTGTTCTTGCTAGCCTTGAGAAACCTGTTTCAATTTTTAAAATCTCTTAATATTGATATTTTGAAG
>TTN-202,,0,204,1036571,1036774,GTACATTACTGAGTAATAATCACCAAAAACAACTTTGTTATGTATGTTCTAAAATCATGTCTTCCTAGCCCGTCTGATGGTCTGTGTTTTTGCTGAGTAGGATGTTCTTGTCCTGATTCTTACATTTCAGTTTTTTATGTGTATTTATTACATAGTATTCAAGGAGTTGGTTTTAATGCTCTTTAATAATTAATATCTTTAAAG
>TTN-202,,0,747,1036775,1037521,GTATAATGATTTCCTTCCTCGATTGTGATCTTTTCTGATGCCTCTTTTGAAATTAATGTAACTATGATTCATTTCATTTTGTTGTTTCATGTCTTTTAAATTAGTTGTCAGCAGAATGTTGGATGTAAAAATGTGTAAATACAGGATAAGAAGATAATGCCTTTAAAAGGAAAAATTATTTCTAAATACATCCATAGCCTGTTAGCCAGTGGCTGTGTCCTGCCACATGGCTACAATACATATAAAATAGAATGTTTGGGTTTAAAATCAGTGACCGTTTGGCATATTCCTGATTTACCTAAATGATGTAATGATACCATAATATTCACCAAGCTTTGGTAACTGTTTATTCATTCTAAATTCATTTTGAAGATTTTTTTTAAAGCTAACCAGTTTCCAGTCATTTTCCCCCTGATTCATACTAAGTATGAAGTATACTAATTGAGAAGTAAATTTCACTTTTCAGGAAGGATATTTCTTTCAAGCAGAGATATTTGAACACTAAACCTCATTTCACATTTGGGCTCTGCTACTTCATGTTTACTTGGGTACTTCTGTGTACTTGTATTTATATGAAGCTCAGAATCCTTTCCACAGAGAGTATATAGTTTCTTAAAGATGAACAATCGCATATGTATCTCATTAAAGGAAGATACATTATTCTATCTGCTTAAAGTACAGCAAAACAAGCATTGGCTGGGTGGCCTTTTACTGACAATAAAATTTCCTTATACTTCATATTTCAAG
>TTN-202,,0,198,1037522,1037719,GTACCTAATGGCACTCATTTTAATGTTTTGTTCGTCTTTTGCTGTTGAATTCCTCTTCAGTTCTGTGTGTGAAAACTTCTTTTGTGGGAAAAGTAAATCTTGTCCTTTCTTCTGTTATAAATGGGCCTGTGTTTCTAAGGTGTCTTAATTTTGTTGAGTCATTGGCAAATGTCCAACTTAAAGATAATATCTTTAAAG
>TTN-202,,0,211,1037720,1037930,GTAGATGATGCCTCCTGCAAAGGGCTGTGCAACAGCATCTTTGGAGTTTGGGGGTCTGATTTGGTCAGATTCTGGGGGTTATTGGCAGCACCAATGATTGCTTACTTTAAAGCAGATATTTTTAGATGCTGAAATATGATTTCTACAGGTGCTTTTCACATTTTATTTCTTTCCTGCAAAATTTCCAACATTCTTAATAATATCTTTAAAG
>TTN-202,,0,182,1037931,1038112,GTACACCACCATTCATTGACGGGTATCTAAGAGACTTCATCTGCCTAGAAATAGTTAACTTTCTTCTGAGTTCAAAACCTTGTGTGTGTGTCACTGTCCGTTGTTAAAAAACATTAGCTGTGTTTTATATGGATGTGTTGTTACTAGTAGTTAGAACTTAACAATAAACAATATCTTTAAAG
>TTN-202,,0,508,1038113,1038620,GTACATCCTTATAATCCATCAGTGGAATAGCATGATAATTCACCCATGCAGCATAACTTGGTGAGCCATAGCAGATCTTTCCCCATGACAATATTAACAACATTAATGCCATGACAAGCGCCTCTCAACTGGCCACAGGAGCAGTTTACCCGGTATTCATCTCTGAATTTTACCATCAAATTATGCTTATGCTCAATGGTTGGCTCCTCCTCTTTAGTGGAAAGTTCTTCAAGTAAAATACATTCCTTTTGCATATCAAAATGGACAAAACCATCATTTACCAGGCATTGTGTCTTGTCTTTATCACCAGTCCACGTTTTTTTCGGTGTTTTTTATTTTAATTTTTGTGTATTTTCTGGCCTTTGTTTTGTGGCTATTATAATTTTCAGTCTTAAAGTGAAATTGATAGAATATCTATGCTGCTTCAGTTAAGGCCTTACATTGCCAGCCTTAAAATCTTAGCTATGGGTAAAAAATGTGACACTAACTCTATTTGATATCTTTGAAG
>TTN-202,,0,249,1038621,1038869,GTACATGAACTTGCAATGTTGCAATATTTTTATTTCACATTTGCATATGGGTAAAAATTAATTGGTTTAATTCTGTACTCTTTGGGATGCAACTCTTTAGAGAAAATTAAATATTTTATTTTAAAAATAAAATGCTTCTTGGAATACCTTTGTCATACTTTTATTACCTTATCTTAATCTTTTGAAACTATGCTTGGAATCAGTATTTTTATGTCGTATAAAATTTTTCTCTAAATCATTTCGTTAAAG
>TTN-202,,0,205,1038870,1039074,GTACATAATTTCATCACTTAGAGTACTTGGGGGAAAAAACTCACATCTATGTATACTCACATACAAATTTCCCCATTACATTGTACATTTTTAAAGTGTCTATCTGGTTAGAAATATGTCAGATATTTTGTGATTCTTTTTCATATCTATTGCTCTAAGACATTTTAAAAGAACATATTCCTAAATATAAATAATATCTTTAAAG
>TTN-202,,0,207,1039075,1039281,GTACATTAATCTGTAACAGAGCCATGGTAAAAGACAAAACTAACTGGTGTTATACAGCCTTACTAATTATAATTAATGCTTAGTATTTATGTTGATAATAATTGATGCTTTGTGATCACAGAATATTTGCCTTTCATAAGCTTCTTCATTGTTGTGAATATTTTACATAAAAGTGATGTTTGTACCCTTGAATAAATATCTTTAAAG
>TTN-202,,0,1625,1039282,1040906,GTATAGCAGCTCTTCTTGGAATCATCAAGGCCTCTTTTGTGTTGAATTCTGCTTTCCCATCCTTTTGTTCATCTCCAGTTTTATCTATAATCCTTTACCCTCTGTGATTGACCACCTAAATCTTAGAAAACATTCCAGACATGTGTGTTCTTATTGTGTATCTGCCTTGTGTATCTGTCTATTGTAAATTATCTAAATGTCTTTTCAAATCACATATTATGTTTACATGTTTGTGGTCTTATCCTCACGTGTCTCTTTCATATATATATATATATATATATATATGACCATGTATATGTGGTTTTTAATGCCTTCAAATGAAATGTTTTTAAGTGCCTGAAGTGCCAAAGAAACCTGTACCAGAGAAGAAAGTCCCTGTTCCCGCCCCTAAAAAAGTGGAACCTCCACCACCACCCAAAGGTACACCTCCCCAAAGTGAATACACATTGTTCACCCATAGCTTGGTCACATAAATTATGATGAAACTGGGTTTTAGGAAAATTATATTTACAAAATGGATAATCACACAGTTACATATTTACTTCTAACGATGTTCAGGAACACTGATATCTACTTTTTTCACTGATACAAAGCAGTATTCAAGAACAAAGATGAAAGGAAGCATTGTCCCAGAACTGATACAAAAGTTCTGATTTCATATCATTTGATTAAACATCATAGTTTTCATGGAGATATATTTAAATATATATGAATAAGTATACTATATATTTAAATGTATTGAAAACTATTATGAATAAATATTCTTAAATTTCTTCCTTCAACCATTTATATTAAATGCCTTTTTAACACCAGGCTAAAAAGAAAAAAAGATGAATGTATTTATCAAAACACAGAATAATAGTTATGTCTTCTAATACATATATATAAAGGGCAGCCCAACAGGTTTTGATTTTAGCGTTGACTTTACACCTTGTTGTATTACTCTCAGCGAGTCCTTTAACCAACCTGAGCCTGAAGTTATTTTCCTGTAAATTGGGGATGCTAATATCAGTCTTAATGGGCTCAGCTATTATGGTGAGAATTAAATAAAGTAAGGTATTAAAGTAGTCTATCATTGAATGAATAGTATCCAGATTTAACATATTCAATCAGCTCATAGTACAGGACAGAATTAATATATTTGTGCTTTAAAGCTCAATAATATTTTCTACAAAAGATGCTGGCATGGCTGCTTAAAATCAGCATAACCCTCGCATCAGGCCATATAGTTATATAATCAAATGAAATAGTAAAGCTGATCTTTTATTGGATATCAACGATTCAGAAATACTTTCTAGACAATAAATTACTAGTGAAATTTAAATGTATGAAATGATATTAGGTTGGTGCAAAAGTAATTGCGGTTTTTAGCATTAAAAGTAATGTCAAAACCGCAATTATTTTTGCACCACCCTAATAGCATCTGTCCTCTGATAATGACATATGCTGCTGGTCCCTTGCTTTACAAATCCCAATTACATTATAATATCTGGGCTCCCAACTAACATGACAGACCTGTCTTGAGCGACTGTTAACACATTGGTCTTTCTGGGTGTGGGGTCTTCTTGGTTTCTCTTTTTTTGTCCTTCAAAATAAATCCTTATCATGAAATGATGTCTTTAAAG
>TTN-202,,0,807,1040907,1041713,GTATTGCTATTCCGAAGTAAATTAGACTATGCCATTTCCTTCCTTCTCCTATAAAAGTCAAAATGTCCTGTTTCCGTATTTGTTAATACAACTTATATTACTGCTGTGTCTACTTGTCTTTGTGTGTGTGAAACTGAACTTATAAAATAAAATAATATTTTTAAAGTGTCTGTGGTACCTAAGAAACCTGAGCCAGAAAAGAAGGTCCCTCCTCCTGGTCTTAAGAAAGCAGTGGCCCCTCCTGCCAAAGGTACATCATCCCATAACAGGGATATGTTTGCTGCACCGATGTTGAACTGTGGTTCTATCCACACAGGACACTCAACATAAATGTGTGCATTGTATGGTCTGTCATTCACATTCGTCATTTCTGACTCTTTTGCACCCAAGTTTGTGTTGTGTCCATTTTTTCACTTGGTGTTGGTGTGCTTTACATCGTTTCTCTATGTATGTTGTTTCTAAAAAATAAAAATATATCTTTAAAGAGCCAAAAATAACTAAGGAACTAGTCCCTGAAATACCCATTTCTTCATACCCATTTCTTCCTACAAAAAAAAAAAAGACAAAAGAAAAAAGAAATAGAGGCTCCAGCAGTAAAAAGTAGAATTTCTCTTTAATAAACCCTAAATCTTAAACCACAAACCTTTTTATTCTTTTCTCATTAACCGATTCTGTGAAATGTCAATGTTTCATCTTGTGTATGTGCCTTGTGATATTTACTCTCTTATGTTGGAAACTGGAAACGTGGTCTTTATTCTTCTTTGGTTCTTGCATTTTAAGTGTCTAAAATAATCAATGTCTCTCAAG
>TTN-202,,0,629,1041714,1042342,GTAGATAACTTTCTAAGAAAATAACATTTCAAAGTCATCCTTGTCTTATTATTGTCTAATATTTGAAGTAGGTAAATGTAAAATTTACCCCAGGAAATCAACATATTCAGATTCTAAAATAAATTATTATTAACCTAATAGAAATTGGGCAGGCAAATTAATATTATTTGAATCTCTTTGCATGTTCAGCCTGTTTGTCTGTTTGCTATTTGTTTTATTTTAATTAGAATTCATGAAGGGAAACTGTATTTGCTGTGGGAAATTTTTCATCAAATGACTTAGTAGGCAACTGTAAAATAAGCTTATCCAAGAGAAATTCCAGTTAAGCCTGAGTAACTGGTGCAGAAAATCTGATTTCTACCCCAAGTGGCTGTTTGACTTCAAACAAGTCTTTCATTAAAAAAAAAACAATAATAATTTTTTTATTATTATAAATTATCTGAAGTCCTTTCCAGTTCACAAATGCTGGGATATGCCTAACATATTTTGAAGACCCAGTAGAGATTTTTTAAGGACTAGTGAGTTTACACAAGCGTTTCGAAGGCTGAGCAGTTTTCAGATATTATCACTGTAGTCTAATATTCAAAATAATTATAAAAATAATTTACAAAATAATAATCTTTTTAAAG
>TTN-202,,0,603,1042343,1042945,GTATAACCGCTTTTAAGGATTGAACATTTAAAATTCCTGGTGTTCCAAATCTTTCTCAGTAGCTAAATCTAAGATTCACCAGTATGCTTTTCTTATATCGTATCCATGATAAAGTGAAGATTAATTATTCCTGGCACCTGAATCTATGTGTCCTTTTTTTACCCTAAATTTTTCTACAACATCTGCAATACAACTAAGAATGAGAGATTACTATTTTGTTATTGGCGATTGAATTTTTTTCTGACCAGGCCCTACTATAATAGTTTCTCCTAGATTTCAATCCTTAATTTTGTTTTTAATATTAATATGGGGGGAATCTATTTCTCTGGTGAAAGTGTTCATTTTTTAAGAAAAATCTTTAATTTACTATTCCTGAAGAGTGTGATAATATTTTGCATAATTGGTATTACATTTGCTTATAGGATTTCTAAGTAATATCCTTTACACCTCTAGGGTTCCTACTCCACATTTATTATTACCATTTAGGTTGCTAATATCTTTTAAAAATAAGTCAATGTTTTGTGATATTTATTTATTGGTATATGGGTGGTGTTCTGCTCATCACATGCCACTTTTCAAAATGTTCATAAAATTTCTTTTAAG
>TTN-202,,0,929,1042946,1043874,GTATATCAAATCCTCATTATTAATATCTTTAACTTCCCATTAATTTTCTTTCTTAAAAGCAACATTTTCTTTTTTGACTGCCTTCTTATAATCATTTAGATAGTGAACTGATTAAGGACCAGTAAAAATATAACTCATTCCATTTCTTTAATCTTTTCTAGGATGTTAACGAATAATTGTGTGCATGTGTTTACGTATGAATTATTCTAGAAGCTTCTTAACTGAGAATTTTAATATATTAGTATGTCTCTATATACTTATACACATAGCAATGGATCCCTCTTCCCCACATTTTAGATTTTATTCCATAAGTGGAACGGAGTTTTCTTCTGTGTTATAATAATTATTTTACTATATTTATTATTTTATGGAACAAACCTAATGCTTGGATAATAACTATTTTAAAGAGCCTCACGTCCCTTTTGTAATGTTTAGCCCAAGCATTCAAGGTTATTACAAAATGTCTACTTTTCCCTGCTTCCTAATTCACTTAATGCTTCAGACAGTGCTCTTAAGCAGTTAGATTATGCTGTCCCTGTCATAGTAGACTCCTCAGCTAATAGAAGAGTGCACAGCAGAAAGTGAGGCCAGTGTCAGGGCTTAAATACTCTACAATGGTAATCACTTCAAAAAAGTCTTCATCAAGTTAAAAATAGTAAAAGTGAGTCCATATTGGTAATCCCTGTTATTAAAAGAAAAAAAAAAGAATGGCACAGGTACTTTGTGGACATTTCTTCTTCTATAGGAATGTTAGAACAAATGAGTGATTTGAGAAAGTATCTTTATTGCCTCTAAAATGGATGTCCCACAGTACAGAGTGACTTCTGAAAAACTTTAATTATTGTAATGTTGGCGTTGTCTCTGGTGTTTTTATTTCATGTGTGTTATTGAACATTCTCAGCTAACTAAAACACCTAATATCTTTAAAG
>TTN-202,,0,153,1043875,1044027,GTACATCTTCTCTTTTAAACCTGACTTCCTCTTCTGTCTTTTTTCGTTAAGACTTTTATGTTTCATGTCTCTGTGTCTTGATTGTTTTTGATGATTTTTGTCTATGAAAGCTTGCTCTCGACAGTCCTAAATATTAAAACTGTATCTTTAAAG
>TTN-202,,0,139,1044028,1044166,GTATTTTTGGAAAGATCCTGGATTTTCGTGTATTGTTGCATGCAATCCTTTATTCAGTTTTAAAAATATATATTTTGAATGTACATCTTTATTTCTTCAGTGTTTAAAAAAATAAGTCTTAAAATAGATGCTCTTTCAG
>TTN-202,,0,800,1044167,1044966,GTATAGGGAATTCTTCAAATACTACAAATTCTTATATCTTGCTCTAACTTTCCTTTGAAAGTAAATTTTGTGTTCAGTTTGGAAGATTAGAAACCCCATGAAATACTTTAAACATGAGTTTAAACTAGTTGACACAAAGATTAATATCTCTTAACCACACGGAGTATAATTTTAGTAGATGATAGTAATATTTGATATCTACTTATCTAAGGAGGTCACTGTATGAATTTGGGGATTATTTTTTAAATCTGACTAAGAATGTTACACAATTGTTACAGGTACCAAAATAACTGACCAGTGTCATTGGTTAAGTGAAAAAGAAACTCCTCAGTTCACTGAGGAATTTACATGTTCAGGCAAAATAATCACTGCTTTAACATTTTAGTCAACTGTTCACAAACTGAGAAATACTTACCAAAAGCTTTTGCCAGTTTATGATACTTTCATTAGAGAAACAACATTAAGGAAGTGAAGTATTGTTAATGGCACCTGTATTCTAGCATACTGTGAAGACAAGCCATAGCACAAATAAGTTATCTGCAATACCACTCTAGATCTTGCACAAATTAACAATATATGTGTAATATGAAGGAATGTGTGTGTGTGTGTGTTTAGCATATATAGCAAATTACAATATACATGATATTTAGCAAATCAAATCTCTTTTGGAAATAAGTGTGTTATAAATTAAAAAAATATAGATAAAGAATTTTGTGACCCCTCATTGTACTAACGTTAGTAGTAGTGCTCCAAAATACTTCAAGAGTTCATTCTAAACCAAAATACTAATATCTTTGAAG
>TTN-202,,0,794,1044967,1045760,GTATCTTCTTTGTGAAAAATTACTACTTAACTTTACATACAATAGCACCTTGGTTGCTTTATAAGCACAAGTTTGCATTCCACTTGATGTCTTTCTTCTGTATTTCTTGTTTCTGACATGTCTAAAACAAACTAATATCTTTAAAGCAGCTGAGGGTCCAAGGGAAGTTCTACCAAAAAAAGACAGTCACTGTTGTTATACCTAAAACAACCAAAGCAAATATCTCTAGTAACCAAATAGTGAGCCCAAATTTCCTCCTTTGGTGCTATTTGGTTATATATTCACTAACATGCTTACTGATAAACACATGTTTTTCTATTTATTATTAATTATATTAACCTGGCAAATATAAATACATAGTGAATATGTGTTTAATGTTCTTGCTTTGTTCATTTTTGCAAATCTCTTAAATTTCACAATAGAAATAAAAACAGTATCTAATAAATAATATAAACTTATTTCTTTAAAGTCTCTGAAGCATGTGCGTAAGTTATCACTGAAGAGAAGGTAGCAACTCTTCCACAAAAACAAACAGTAATAGCACCAGCTGAAGGTGTACTGTTAATTTTTCTTCTCAAGTTCTTACCATTCTAACATGGGAAATTTCCCTGGATTTTTGTTATTATATATTTTTTAAATTCAATGCATTTGAAATACTGTAATGTATTTGATAAAGTGTTGTCTGCATTTTATATTGTTGCTGTGTTCTGTTCTGTGTTTATATCTCTCATGCTCTGCTTGTTAAAAAATTGTATATTTAAAAATAAAAGAAATTATTACTATTATCTTTAAAG
>TTN-202,,0,7162,1045761,1052922,GTAACTGGCTTTTCTCATTCATCATTAATATAAAATCCTTTTTTATTCACTTACTATGTAAGAGAGACCTTTCTCTTCTCAATGCCACAAGATGGCTATGAATGACATAAACTTCAATTTATGTTCTATAACATAATCCTGCCTTTTGAGGCAATGTTTTAGGCGTAAAGACATAAGCCCAAAGTTATCATTTGTATTGATCCTCTTATTTAATAACTAAATAATATTGATCCCTCAACTTCTCTTTCAAAAATAATTCATTTTGGAAGCTCTTCTGAAGTAGCTCTGGAAAAAAAAAAGTGTGCTCTAAATGGCAATAGAAAATGATACTATCTCCAAAGAGCAAAGTGTTTCTGATATAATGAATCAAGAACTCATCGACAAAGCAATTCAGAGAAATGCAATGACTACATTTGACTTATAGTTGACTTATAATTGAGGGGTTTTTGGCGTTCATCTTGTTAGATGCCCCTTCTAGGCTTGCTATGTTTACACCCAACTATAATGTTCTGAAAAAATAAGATAAATAAATATCTTTAAAGCACCCGAAGTACCCAAGAAAATTGTCCCAGAAGAAAAAGTTCGTGAAGCTGTTCTGAAAAAGCCTGAAGTTCCACCAGCTAAAGGTATACAGTGATGCTAATCAGAACATGAAATAATTCTTGGTTTAGTTTTTCATGGTTTAAAGTGAATGTGTGTGACATTAAATCCTTGTATTTCGTATCTTATATTTGTTATCTGTAACAATTAATATACTAATATCTTTAAAGTTCCTGGGATGCCTAAGAAAAGTGTTCAAGAAGAAAAATCACCTATTGTTATTTCTGAAGACACAGAGATGTACAGTGAGTGTAGAAAAATTAGTGGTTCTTTTTCGTTTCATTTATGTCCTTAAATTCACTATGTTTGTCTTTTTAGCTTTGAAAAGTAAATATACTAAACTCTTATAAAAGCCTAACATGCCACAAATATATGACTCAAATAATCTTAGTGTCTATTATCCTCAGACAAGTTATATTTCCTCACCAATTTAAAAAAGAAATACTCTACTTATCAGAGTGTATGATTTCAGAAAAGTCAGTTGTCTTGTTAAATTTTCCTAACCTATTCTGTATACAAGTGTCTTTTGCTTTGAAGCAATTTATTTTCTCAGATCATGAAGTAACTTAACTCCATAATATTTTAATTGGATTTTATAAAATCAAAATGTTTCACCATTATTTTTTTTTTTACTCTTGATAACCATAATTGGAAACATTTTGGCAAAACTGCTCAAAGGACCCTAGGTTTACAAGGCCACTCAAACCTCAAAAGAATTCTCACGACCTTTTTTTTTGGGGGGGGGTTTCATACAAAATTAGGTTTAAATAATTTGAATTATGAAATAATCCAAATAGTAAAATATTGTGAATAGAATACTGTTCAACAACCTGAATAGTAAAAGTGACAGTAGTCAAAATATTCTTCCTTTTTTTTTTTTTTTTGAGATGGAATCTCACTCTGCTGCACCCAGGCTGCAGTGCAGTGGCACGATCTTGGCTCACTGCAACCTCCGTCTCCTGGGTTCAAGCTATTCTCCTGCCCCAGCCTCCCGAGTGGCTGGGATTACAGGTGCCTACCACCAGGCCCGGCTAATTTTGTGTATTTTTAGTAGAGACAGGGTTTTACCATGTTGGTCAGGCTGGTCTCAAACTCCTGACCTCAGGTGACCCGCCCACCTCAGCCTCCCAAAGTGCTGGGATTACAGGCATGAGCCACTACACCAGACCCGCTTCCATTTTTTTTAATCTAAAAAATTTCCTGTTGAAACTCAACTTTCTTGTTGTTCATCCTGTTATACTAAGTTGGGATAAAATAATATAATCACTTCCTCCTTTGAATATCCTTTCTATTCTTGACTTTAGTTATTGTTTTCAGACAGTTTTTCTTTCTAAAGGCTGGAGAAATTTTTGTTGTCTTTATTTGCCTTATTTTCTAAGTATTTAATTTTTTTAATTTTCTGCCTCCAAACCCTAAATGGCTTTTACATTCATATTAAACTGTGAAACCATATATTAGATGTGATTTGAAAATATAGATAATGAGGCTTCTAGAAAGGGAAAAGACTTACATGAATTTCTAGTAGGTCAAATATCGGAGAATTCTCAATGTGCAATTCAGCATCTTCCCTGTTCTTTATAGACAAATCCATTAAAAATAAGACCAATAGGACAATTTTACCAATAACTTTCTTAAGGCAAAATGAAGAATTATATAGTCCTTGCCTGAACAATTCCTCCATTTTATTATCATCATCATAGAGAAATGCTTAGAGTCTTACATCATGAAACTGGGAGTGAGGCTATCCCCAGCCAATGCATTCTAGCCACTAATTTGCCTCTATGTGCTACTATTAATTTTGGTGATGAATGTGGTATTATATATTATATTTTTCTTAATACACTTCTTTATCCACCTTGAAACATCCTAATTATTTAAATACTAATATCTTTAAAGTTTATGAAGCATCTGAAGAAGCAGTCCTAGAAGAAAAAGTACTTGTGACTCAACCTCAAAAGACAAAACCCAAACTAGCAAAAGGTATATAACACCAATGATCCACTCTGAAGAAAAATTATTTTTTGGCCCCTTTTAAAAAGCTCAATATTTTTCTTCACCATTTATAAATATAACTATACTCATATCTTTTAAGTGCCTGAGCCACCCAAGAAAGTTGTTCCAGAAGACAAAATATATGTGACTATTCCTAAAAAGAGAGAAACACCAGCAACTAAAGGTATATTTCAAATACATCAAACCCAGATGAGTATCTTTAGCTTTATGACTCAAACATTGCATGCTTTTTATAATTTACTGTTTTTACAACTTTTAAATGTAAACCTACTAATATCTTTAAAGAACCTGATACAACCAGAGGCATTTTTCCAGAGGTGGAGCCACCTGAGGCTATTCCTGAAATTCCAGAACATCCTCCAACTGAAGGTATAATTCTCTAGTTAGGAAAATCTAAAGAAGAAAATATACTGTCTTCAGTCTGCAAAATATTTAATGTTTAATATACATTCTCACAACCTCTAATGTTAAAATACTGTGTTTAAAGGATCTGATATACCCACAACAAAGAATGACCTATGACTTGCCCCCAAGAAAGTCAAGTCCCACACATATAATATACAAAGATAAAATATTAGAACAAAAATAACATTTCTAACATAAAGATATCTGAAATGATATTAACATATCTAACTTTCTTAGTATGTCATGTCTTTATGCCTTTGCCTTTTCTCAATTAAAAAAAATACTAATATCTTTAAAGAGTTTGAAGTCTTCAAGGAAGTCATTCCAGAGGGAGAAACTCCTATTGTTAAAAGAAGAAAAACACCATCACCAACAGGTACAAGTTGGAAGAAAGTCACCTTTTTAATCTCATGTTTGCAGTTGTACTTAACACATGTAAAAATACTAATATCTTTTAAGCCAAAGTGGCTACAGTGGAAATCATTTCAGAGATGGATCCCCCAAGTAGAAGCTCAACCAAATGTATTCATGTCCCAGTGAGTCACTCAAGAGACAACAGAGGGAAAAAATACCTTTAGCTTATACACATGAAAGATAGTTGAGTCAGTGTATTTTTATGAGGACTCCAAAGAAAATATATATACACATATTATGATCAAAACATGTCTTAAAGAAAATATTAATTCAGTGTGAAGCTGATCTGTAATATCTCTACAAGATTAGAGCACCTGAGACCCTCCCAGAATATCCTCCAACCTAGGGAAAAATAATTCCAGTTAAAGCTGGAAATCTCCCCTCCATGTTCATTTGCTCCTCTCATAGCCTATCTTTTATTTTTCAAGCATCATTTTTTTTCATTTTGAATATCTTTAGATAAGTCAAAACATGAAAAAGCTTTAAAACCTCCAGAACAATAATTTCATCATAACACCCATGGTATTCTGTAATTTGAAGAATATCTGAATATTTTGATATTTTTTCTCAGTCTGGAATCTTTTGGTTGTTCTCCTCTCTCCTAAACTTGAAAAACACTCACCTTTTTAAGGTGCCTGAGGTGTGAATACAAAAAAATGCCGACCTAGATTTTTCGAAGTGGCTGTAATTTGTTTTTCTCAACATAATAGCTAGAGGTATAGCATTAATTATAATCAATGTTTCCACTTTCCATGATCTAGTTTTCTATGCATCTACCATTCCAAGAAATAAAATTACTAATACTGATAGTGCCTGAGGTGACCAAGAAAACAGCCGCTTATAACCAAATACTCACACTGCTACAAAAGATCCGATTCTGGGGGCGGGGAGTGGGAGAAGGTTCCCATCTGGAATGTTCTGTATGTGCAGTTAAGATGGGAACTCTTTACTCCTCTTCATAACTCCAAAGTACAATGCATTCATATCTTTAAAGTGCCTGAATCACCTCGAGAAATTGTCCCTGTAAAGGAAACACCCATGGCTGCTCCCCTTGAAATTGAAATACCTCCCACTAAAGGTATCGTTCATCCTGCCATTCCTTCCTTCATTTATTAGAGTGCTTAGCATGTACAGGGTGCTAGGGAACTGGAGAATAATAAACAAAGACAATTAATATGTGGTTCCTCTCCTCAAGATTGTATACCTCCTCAGATTCTTTAAAGGAATCATCTTTTTAGCCATAAATATCACTTTGGTTCAGCTCATTTAATTAATGTCTCCACTGATCCTTTTAACCTCTAACCATAATACTAATATCTTCAAAGCACCAGAAGCTATGAAAGAAGTTGTCCCTGAAATGAAAATATTTGAGGATGTACCTGAAGAGCCAGAAACTCCACGTATGAAAAGTACGTTACCTCTGAACAAATGTGGAAGAAGAAATTATCTGTCCTCTGCTCTTAAAACTATGGTTTCTTCCTAATACTCTTCATAAATTCTAAATATAAACATACTAATATCTTTTAAGTGTCTGAGGTTCCACAGGAAGTTTCCTCTAAAAAGAAATTATTTATGGCTGTTTCTGCCAAAACAGAAAACACTCCTGCTGGAAGTATTCATTCAACAAATCCTTTATAATGAGAGTGTAGAGTGTCGCGAGAGCTCTGTGAGGTTCTGGAGGAGGGGGAGCACCTCCTCTCAAGGATCCACTAACCCCTTAAAAGACTTAGCCTATTGGTGGAACAAAGGGAGGATGGAGGAAAGAGAAGAAAATGTGGTTATATTTCCTAACTTATTGTGGTTACTGTTTTCCATTAATCATTTTAACTCTTAAATGTGAATTGCTAATATCTTTCAAGCGCCCGAAGCTCCTCAAGAAATTATTCCTGCCAAGACAGTTCCTTCCAAAAAAAGAGAACCCCCATCAGTTAAAGGTACAAGTCACCATGCTCTCAGGGTCAAGAACTAGCTCTTGTAGTTTTGAGAATATTTTTGCTATTCCTAGTTATCTGCATAACACTAAACATAAAACTACTAATTTCTTAAAGTGCCTGAAGCTCTCCAAGAAATTGTCCCTGAAAAGAAAACGCTTGTGGTTCCTCTCAGAAAGCCTGAAGTCCTTCCTGATGAAGGTATATCTTGCTGGAAGCTTAGAGGGGTGGGAACATGTCTTTTCTTGTATAAATGTTTTTCCTGATTGTGTTGATTCTTGTAACTTCTAAATGTAAAATTATTAATATCTTCAAAGTGCCGGAGGCTCTCAGAGAAGTTGTCCCGGAAAAGAAAGTGCATCCTCCCCAAAGGGCTGAAGTTGTACCTGTCAAAGGTACATTCTTAACTGTCTTTTTATGGTGGGATAGTGGGTGGGGCGATAGAAAGGACCACCTTTCTAGTTTTGAAAATTATTTTGATGTGTACATGTGAATCATGTCTGTGTTGACTCTTGCAACTCAAGTGTAAATGTATTAATATCTTCAAACTGCCTGAAGCTCCCAAAGAAATGGCTACCAAAAAGAAAATACCGGAAGTTCCTCCTCTAAAACCTGAAACACCACCTATTATGGGAACTTGTTACCACTGATCTCAGCTCAGGAGAAAAAAATAGCTCTTTTGTTCTTGAAAATGTCTTTGTATCTATCTAGTAATCTCTGTATTTTCTGAGTGTAAAAATACTAATATCTTTCAAGTGCACGAAGCTCCCAAAGAGATTATCCCTGAAAAGAAAGTGTCGGTGGTGCCTCCTAAAAAGCCTGAAGTCCCACCTGTTAAAGGTATTTGTCACTGACTTTAGGCTTCAGAAGACCTAATTCTTCTGCTCTTGACAATATTTTTTTCTAGCGGTCTTCATAACACCTAAATGTAATTTCACTAATATCTTTCAAGTGCCAGAAGCTTCCAAAGAGGTTATCCGCGAAGAGAAAGTGCCCTTGGCTCCTCCTAAAGAGCCTGAAGTCCCACCTGTTAAAGGTAGTTGCCACTGACCTTAGGCTTCAGATCTCATTCTTTTGCTCTTGAAGATATTTTTTCCAGTGGTCTTCATAACTTCTGAATGTAATTTTGCTAATATCTTTTAAGTACCAGAGCCTCCCAAAGAAGTAGTTCCTGAAAAGAAAGCGCCAGTGGCTCCTCCTAAAGAGCCTGAAGTCCCACCTGTTAAAGGTATTTGTCACTGATTTTAGGCTTCAGATGATGTATCTCTTCTGCTCTGGAAAATATTTTTCTAGTGGTCTTCATAATGCCTAAATGTAATTTCACTAATATCTTTCAAGTGCCTGAGGCTCCCAAAGAAGTTGTTCCTGAAAAGAAAGTGCCAGTGCCTCCTCCTAAAAAGCCTGAAGTGCCACCCACAAAAGGTAGACACCCTCTTGTTGCTGTGTTTGATATTGTTTGTTTGTCTTTACTTTGTCTAATAATGAAAATACTAATATCTTTAAAGTCCCAGAGGTGCCAAAGGCAGCTGTCCCAGAAAAGAAGTTGCCTGAAGCTATTCCTCCCAAACCGGAAAGTCCTCCCCCTGAAGGTAATGCCAAAGCTATACAAACTATAGGAGAAAAATAACTGTTATTTTAACTAGGAAATTACATGTTAAAAATCCTACTACATAAAGATGATATAATTCTAAAGAAAACAAATGTCAATCGCTATCCAAAATATCTTGGTGGGTGTTTATATGCAAAAGGCATCCATCATTTTCACCTTTTCTAAACACAAATTACAAATATCTTTGAAG
>TTN-202,,0,3710,1052923,1056632,GTAGGTATCATTACACATTGTCAGTCGGGGGGCCCTGGGGAAAGACTGCATAGAAGTGTCCGCCGATCTCACAAGTTGTATTTGCTTGGGTAAATGTGGAGTCGATATTCCCCCTTTATAGCTTCTAACTAAAAGATACTAATATCTTCAAAGTTCCTGAAGCTCCTAAAGAAGTTGTACTTGAAAAGAAAGCATCTGTGGCTGTGCCCAAAAAACCGGAAGCCCCACGTGCAAAAGGTATTTATTCCCTCTCCTCTGCTAAGAAAAACTTATCGTCTGTACCCCTCACAATCACTGTAATATATACCTTCACCATTCATAAATTATAAAAATACTAATATCTTTCAAGTGCCTGAAGCTGCTCAAGAAGTTGTCCCAGAAAAGAAAATTCCCAAGGCACCAATCAAAAAACCAGAAGCCCCCGCAGTTACAGGTACATGTCAGCTCAACCTTATCCTGCAGAAGAAATCTCTCTTCCATTCCTGAAAACAATTTTAGTCCATTCCTCTTCATTAACCTAAGTATAAAACTACTAATATCTTTCAAGTGCCAGAAGTTCCTCAAGAAGCCACAGAAAAAGAAATTCCCGTGGCTCCACCCAAAAAACCAGAAGCTCCAATTGTCCCAGGTACACTTTAGCCCTGACTTCATTCTGCAGAAGAGATATCTCCTCTCCTACTGTAAACAATTTTAGCCCATTTCTCTTCATTAACTTAAGTCTAAAACTACTAATATCTTTCAAGTGCCTGAAGCTCAAGAAGTTGTCCCAGAAAAGAAAGTTCCTAAGGCTCCTCCCACAAAACCAGAAGCCCCACCTGCCACAGGTATTTTTTACCCCTGTCCTTTTTCTGCAGAAGAAATATCTCTTCTGATCTTAGAAATATTTTACTCCATTTGTCTCATTAACCTAAGTGAAAAACTACTAATATCTTTCAAGTGCCTGAAGTCCCACAAGAAATTGTGCCAGAAAAGAAAACACTGGTGCTTCCTAAAAAGCCAGAAGTTCCACCTGTTACAGGTACTTGTCATTTGACCTTAAGCTTCAGAAGATCCAATTCCTCTGCTGTATATTTTGCTAGTAGTCTCCATAGCTCCACATGTAACTTTACTAATATCTTTTAAGTGCCAGAGGCTCCCAAAGAAGTTGTCCTTGAAAAGAAAGTGCCCTCGGCTCCTCCTAAAAAGCCTGAAGTCCCACCTGTTAAAGGTATTTGTCACTGATTTTAGGCTTCAGATGATCTATCTCTTGTGCTCTGGAAAATATTTTTCTTTTTATATATATATATATTTTTATTATACTTTAAGTTCTAGGGTACATGTGCACAACGTGCAGGTTGTTACGTATGTATACATGTGCCATGTTGGTGTGCTGCACCCACTAACTCGTCATTTACATTAGGTATGTCTCCTAATGCTATCCCTCCCCCATCCCCCCACCTCACAACACACTCCGGTGTGTGGTGTCCCCCTTCCTGTATCCATGTGTTCTCATTGTTCAATTCCCACCTATGAATGAGAACATGCAATGTTTGGTTTTTTATCCTTGTGATAGTTTGCCAAGAATGATGGTTTCCAGTTTCATCCATGTCCCTACAAAGGACATGAACTCATCATTTTTTATGGCTGCATAGTATTCCATGGAGTATATGTGGAACATTTTCTTAATCCAGTCTATCATTGATGGACATTTGGGTTGGTTCCAAGTCTTTGCTAATATGAATAGTGCCGCAATAAACATACGTGTGCACGTGTCTTTATAGCAGCATGATTTATAATCCTTTGGGTATATACCCAGTAATGGGATGGCTGGGTCAAATGGTATTTCTAGTTCTAGATCCCTGAGGAATCGCCACACTGACTTCCACAATGGTTGAACTAGTTTACAGTCCCAGCAACATTGTAAAAGTGTTCCTATTGCTCCACATCCTCTCCAGCGCCTGTCGTTTCCTGACTTTTTAATGATCACCATTCTAACTGGTGTGAGATGGTATCTCATTGTGGTTTTGATTTGCATTTCTCTGATGGCCAGTGATGATGAGCATTTTTTCTTGTGTATTTTGGCTGCATAAATGTCTTTTTTTGAGAAGTGTCTGTTTGTATCCTTCGCCCACTTGTTGATGGGGTTGTTTTTTTCTTACACGTTTGTTTGAGTTCATTGTAGATTCTGGATATTAGCCCTTCGTCAGATGAGTAGATTGCAAAAATTTTCTCCCATTCTGTGGGTTGCCTGTTCATTCTGATGGTAGTTTCCTTTGCTGTGCAGAAGCTCTTTAGTTTAATTCGATCCTATCTGTCAATTTTGGCTTTTGTTACCATTGCTTTTGGTATTTTAGACATGAAGTCCTTGCCCATGCCTATGTCCTGAATGGTATTGCCTAGGTTTTCTTCTAGGGTTTTTATGGTTTTAGGTCTAACATTTAAGTCTTTACTCCATCTTGAATTAATTTTTGTGTAAGGTGTAAGGAAGGGATCCAATTTCAGCTTTCTACATATGGCTAGCCAGTTTTCCCAGCACCATTTGCTAAATAGGGAACCCTTTCCCCATTTCTTGTTTTTGTCAGGTTTGTCAAAGATCAGATGGTTGCAGATGTGTGGTATTATTCTGAGGGCTCTGTTCTGTTCCATTGGTCTATATCTCTGTTTTGGTACCAGTACCATGCTGTTTTGGTTACTGTAGCCTTGTAATACAGTAGCGTGACGCCTCCAGCTTTGTTCTTTTGGCTTAGGATTGACTTGGCAATGTGGGCTCTTTTTTGGTTCCATATGAACTTTAAAGTAGTTTTTTCCAATTCTGTGAAGAGAGTCATTGATAGCTTGACGGAGATGGCATTGAATCTATAAATTACCTTGGGCAGTATGGCCATTTTCACGGTATTAGTTCTTCCTATCCATGAGCATGGAATGTTCTTCCATTTGTGTCCTCTTTTATTTCGTTGAGCAGTGGTTTGTAGTTCTCCTTGAAGAGGTCCTTCACATCCCTTGTAAGTTGGATTCCTAGGTATTTTATTCTCTTTGAAGCAACTGTGAATGGGAGGTCACTCACGATTTGGCTCTCTGTTTGTCTGTTATTGGTGCATAAGAATGCTTGTGATCTTTGCACATTGATTTTGTATCCTGAGACTTTGCTGAAGTTGCTTATCAGCTTAAGGAGATTTTGGGCTGAGACGATGGGGTTTTCTAGATATACAATCATGCCATCTGCAAACAGGGACAATTTGACTTCCTCTTTTCCTTATTGAATACCCTTTATTTCTTTCTCCTGCCTGATTGCCCTGGCCAGAACTTCCAACACTATGTTGAATAGGAGTGGTGAGAGAGGGCATCCCTGTCTTGTGCCAGTTTTCAAAGGGAATGCTTCCAGTTTTTGCCCATTCAGTATGATACTGGCTGTGGGTTTGTCATAAATAGCTCTTATTATTTTGAGATACGTCCCATCAATACCTAATTTATTGAGAGTCTTTAGCATGAAGGGCTGTTGAATTTTGTCAAAGGCCCTTTCTGCATCTATTGAGATAATCATGTGGTTTTTGTCGTTGGTTCTGTTTATATGATGGATTACGTTTATTGATTTTTGTATGTTGAATCAGCCTTCCATCCCAGGGATGAAGCCCACTTGATCATGGTGGATAAGCTTTTTGATGTGCTGCTGGAAAATATTTTTCTAGTGGTCTTCATAATGCCTAAATGTAATTTCACTAATATCTTTCAAG
>TTN-202,,0,83,1056633,1056715,GTAGACACCCTCTTGTTGCTGTGTTTGATATTGTTTGTTTGTCTTTACTTTGTCTAATAATGAAAATACTAATATCTTTAAAG
>TTN-202,,0,6463,1056716,1063178,GTAATGCCAAAGCTATACAAACTATAGGAGAAAAATAACTGTTATTTTAACTAGGAAATTACATGTTAAAAATCCTACTACATAAAGATGATATAATTCTAAAGAAAACAAATGTCAATCACTATCCAAAATATCTTGGTGGGTGTTTATATGCAAAAGGCATCCATCGTTTTCACCTTTTCTAAACACAAATTACAAATATCTTTGAAGTGCCTGAAGTGCTGCCACCGAAGGAAGTGGTCCCAGAAAAGAAAGTACCGGTGCCTCCTGCCAAAAAGCCAGAAGCTCCACCTCCTAAAGGTAGGTATCATTACACATTGTCAGTCGGGGGGCCCTGGGGAAAGACTGTATAGAAGTGTCCGCCGATCTCACAAGTTGTATTTGCTTGGGTAAATGTGGAGTCGATATTCCCCCTTTATAGCTTCTAACTAAAAGATACTAATATCTTCAAAGTTCCTGAAGCTCCTAAAGAAGTTGTACTTGAAAAGAAAGCATCTGTGGCTGTGCCCAAAAAACCGGAAGCCCCACGTGCAAAAGGTATTTATTCCCTCTCCTCTGCTAAGAAAAACTTATCGTCTGTACCCCTCACAATCACTGTAATATATACCTTCACCATTCATAAATTATAAAAATACTAATATCTTTCAAGTGCCTGAAGCTGCTCAAGAAGTTGTCCCAGAAAAGAAAATTCCCAAGGCACCAATCAAAAAACCAGAAGCCCCCGCAGTTACAGGTACATGTCAGCTCAACCTTATCCTGCAGAAGAAATCTCTCTTCCATTCCTGAAAACAATTTTAGTCCATTCCTCTTCATTAACCTAAGTATAAAACTACTAATATCTTTCAAGTGCCAGAAGTTCCTCAAGAAGCCGCAGAAAAAGAAATTCCCGTGGCTCCACCCAAAAAACCAGAAGCTCCGATTGTCCCAGGTACACTTTAGCCCTGACTTCATTCTGCAGAAGAGATATCTCCTCTCCTACTGTAAACAATTTTAGCCCATTTCTCTTCATTAACTTAAGTCTAAAACTACTAATATCTTTCAAGTGCCTGAAGCTCAAGAAGTTGTCCCAGAAAAGAAAGTTCCTAAGGCTCCTCCCACAAAACCAGAAGCCCCACCTGCCACAGGTATTTTTTACCCCTGTCCTTTTTCTGCAGAAGAAATATCTCTTCTGATCTTAGAAATATTTTACTCCATTTGTCTCATTAACCTAAGTGAAAAACTACTAATATCTTTCAAGTGCCTGAAGTCCCACAAGAAATTGTGCCAGAAAAGAAAACACTGGTGCTTCCTAAAAAGCCAGAAGTTCCACCTGTTACAGGTACTTGTCATTTGACCTTAAGCTTCAGAAGATCCAATTCCTCTGCTGTATATTTTGCTAGTAGTCTCCATAGCTCCACATGTAACTTTACTAATATCTTTTAAGTGCCAGAGGCTCCCAAAGAAGTTGTCCTTGAAAAGAAAGTGCCCTCGACTCCTCCTAAAAAGCCTGAAGTCCCACCTGTTAAAGGTATTTGTCACTGATTTTAGGCTTCAGATGATCTATCTCTTGTGCTCTGGAAAATATTTTTCTTTTTATATATATATATATTTTTATTATACTTTAAGTTCTAGGGTACATGTGCACAACGTGCAGGTTGTTACGTATGTATACATGTGCCATGTTGGTGTGCTGCACCCACTAACTCGTCATTTACATTAGGTATGTCTCCTAATGCTATCCCTCCCCCATCCCCCCACCTCACAACACACTCCGGTGTGTGGTGTCCCCCTTCCTGTATCCATGTGTTCTCATTGTTCAATTCCCACCTATGAATGAGAACATGCAATGTTTGGTTTTTTATCCTTGTGATAGTTTGCCAAGAATGATGGTTTCCAGTTTCATCCATGTCCCTACAAAGGACATGAACTCATCATTTTTTATGGCTGCATAGTATTCCATGGAGTATATGTGGAACATTTTCTTAATCCAGTCTATCATTGATGGACATTTGGGTTGGTTCCAAGTCTTTGCTAATATGAATAGTGCCGCAATAAACATACGTGTGCACGTGTCTTTATAGCAGCATGATTTATAATCCTTTGGGTATATACCCAGTAATGGGATGGCTGGGTCAAATGGTATTTCTAGTTCTAGATCCCTGAGGAATCGCCACACTGACTTCCACAATGGTTGAACTAGTTTACAGTCCCAGCAACATTGTAAAAGTGTTCCTATTGCTCCACATCCTCTCCAGCGCCTGTCGTTTCCTGACTTTTTAATGATCACCATTCTAACTGGTGTGAGATGGTATCTCATTGTGGTTTTGATTTGCATTTCTCTGATGGCCAGTGATGATGAGCATTTTTTCTTGTGTATTTTGGCTGCATAAATGTCTTTTTTTGAGAAGTGTCTGTTTGTATCCTTCGCCCACTTGTTGATGGGGTTGTTTTTTTCTTACACGTTTGTTTGAGTTCATTGTAGATTCTGGATATTAGCCCTTCGTCAGATGAGTAGATTGCAAAAATTTTCTCCCATTCTGTGGGTTGCCTGTTCATTCTGATGGTAGTACCTTTGCTGTGCAGAAGCTCTTTAGTTTAATTCGATCCTATCTGTCAATTTTGGCTTTTGTTACCATTGCTTTTGGTATTTTAGACATGAAGTCCTTGCCCATGCCTATGTCCTGAATGGTATTGCCTAGGTTTTCTTCTAGGGTTTTTATGGTTTTAGGTCTAACATTTAAGTCTTTACTCCATCTTGAATTAATTTTTGTGTAAGGTGTAAGGAAGGGATCCAATTTCAGCTTTCTACATATGGCTAGCCAGTTTTCCCAGCACCATTTGCTAAATAGGGAACCCTTTCCCCATTTCTTGTTTTTGTCAGGTTTGTCAAAGATCAGATGGTTGCAGATGTGTGGTATTATTCTGAGGGCTCTGTTCTGTTCCATTGGTCTATATCTCTGTTTTGGTACCAGTACCATGCTGTTTTGGTTACTGTAGCCTTGTAATACAGTAGCGTGACGCCTCCAGCTTTGTTCTTTTGGCTTAGGATTGACTTGGCAATGTGGGCTCTTTTTTGGTTCCATATGAACTTTAAAGTAGTTTTTTCCAATTCTGTGAAGAGAGTCATTGATAGCTTGACGGAGATGGCATTGAATCTATAAATTACCTTGGGCAGTATGGCCATTTTCACGGTATTAGTTCTTCCTATCCATGAGCATGGAATGTTCTTCCATTTGTGTCCTCTTTTATTTCGTTGAGCAGTGGTTTGTAGTTCTCCTTGAAGAGGTCCTTCACATCCCTTGTAAGTTGGATTCCTAGGTATTTTATTCTCTTTGAAGCAACTGTGAATGGGAGGTCACTCACGATTTGGCTCTCTGTTTGTCTGTTATTGGTGCATAAGAATGCTTGTGATCTTTGCACATTGATTTTGTATCCTGAGACTTTGCTGAAGTTGCTTATCAGCTTAAGGAGATTTTGGGCTGAGACGATGGGGTTTTCTAGATATACAATCATGCCATCTGCAAACAGGGACAATTTGACTTCCTCTTTTCCTTATTGAATACCCTTTATTTCTTTCTCCTGCCTGATTGCCCTGGCCAGAACTTCCAACACTATGTTGAATAGGAGTGGTGAGAGAGGGCATCCCTGTCTTGTGCCAGTTTTCAAAGGGAATGCTTCCAGTTTTTGCCCATTCAGTATGATACTGGCTGTGGGTTTGTCATAAATAGCTCTTATTATTTTGAGATATGTCCCATCAATACCTAATTTATTGAGAGTCTTTAGCATGAAGGGCTGTTGAATTTTGTCAAAGGCCCTTTCTGCATCTATTGAGATAATCACGTGGTTTTTGTCGTTGGTTCTGTTTATATGATGGATTACGTTTATTGATTTTTGTATGTTGAATCAGCCTTCCATCCCAGGGATGAAGCCCACTTGATCATGGTGGATAAGCTTTTTGATGTGCTGCTGGAAAATATTTTTCTAGTGGTCTTCATAATGCCTAAATGTAATTTCACTAATATCTTTCAAGTGCCTGAGGCTCCCAAAGAAGTTGTTCCTGAAAAGAAAGTGCCAGTGCCTCCTCCTAAAAAGCCTGAAGTGCCACCCACAAAAGGTAGACACCCTCTTGTTGCTGTGTTTGATATTGTTTGTTTGTCTTTACTTTGTCTAATAATGAAAATACTAATATCTTTAAAGTCCCAGAGGTGCCAAAGGCAGCTGTCCCAGAAAAGAAGGTGCCTGAAGCTATTCCTCCCAAACCGGAAAGTCCTCCCCCTGAAGGTAATGCCAAAGCTATACAAACTATAGGAGAAAAATAACTGTTATTTTAACTAGGAAATTACATGTTAAAAATCCTACTACATAAAGATGATATAATTCTAAAGAAAACAAATGTCAATCACTATCCAAAATATCTTGGTGGGTGTTTATATGCAAAAGGCATCCATCATTTTCACCTTTTCTAAACACAAATTACAAATATCTTTGAAGTGCCTGAAGTGCTGCCACCGAAGGAAGTGGTCCCAGAAAAGAAAGTACCGGTGCCTCCTGCCAAAAAGCCAGAAGCTCCACCTCCTAAAGGTAGGTATCATTACACATTGTCAGTCGGGGGGCCCTGGGGAAAGACTGTATAGAAGTGTCCGCCGATCTCACAAGTTGTATTTGCTTGGGTAAATGTGGAGTCGATATTCCCCCTTTATAGCTTCTAACTAAAAGATACTAATATCTTCAAAGTTCCTGAAGCTCCTAAAGAAGTTGTACTTGAAAAGAAAGTATCTGTGGCTGTGCCCAAAAAACCGGAAGCCCCACGTGCAAAAGGTATTTATTCCCTCTCCTCTGCTAAGAATAACTTACTGTCTGTACCCCTCACAATCACTGTAATATATACCTTCGCCATTCATAAATTATAAAAATACTAATATCTTTCAAGTGCCTGAAGCTGCTCAAGAAGTTGTCCCAGAAAAGAAAATTCCCAAGGCACCAATCAAAAAACCAGAAGCCCCCGCAGTTACAGGTACATGTCAGCTCAACCTTATCCTGCAGAAGAAATCTCTCTTCCATTCCTGAAAACAATTTTAGTCCATTCCTCTTCATTAACCTAAGTATAAAACTACTAATATCTTTCAAGTGCCAGAAGTTCCTCAAGAAGCCGCAGAAAAAGAAATTCCCGTGGCTCCACCCAAAAAACCAGAAGCTCCAATTGTCCCAGGTACACTTTAGCCCTGACTTCATTCTGCAGAAGAGATATCTCCTCTCCTACTGTAAACAATTTTAGCCCATTTCTCTTCATTAACTTAAGTCTAAAACTACTAATATCTTTCAAGTGCCTGAAGCTCAAGAAGTTGTCCCAGAAAAGAAAGTTCCTAAGGCTCCTCCCACAAAACCAGAAGCCCCACCTGCCACAGGTATTTTTTACCCCTGTCCTTTTTCTGCAGAAGAAATATCTCTTCTGATCTTAGAAATATTTTACTCCATTTGTCTCATTAACCTAAGTGAAAAACTACTAATATCTTTCAAGTGCCTGAAGTCCCACAAGAAATTGTGCCAGAAAAGAAAACACTGGTGCTTCCTAAAAAGCCAGAAGTTCCACCTGTTACAGGTACTTGTCATTTGACCTTAAGCTTCAGAAGATCCAATTCCTCTGCTGTATATTTTGCTAGTAGTCTCCATAGCTCTACATGTAACTTTACTAATATCTTTTAAGTGCCAGAGGCTCCCAAAGAAGTTGTCCTTGAAAAGAAAGTGCCCTTGGCTCCTCCTAAAAAGCCTGAAGTCCCACCTGTTAAAGGTATTTGTCACTGACCTTAGGCTTCAGATGATCTAATTCTTTTGCAGTTGAAGACATTTTGTTCCAGTGGTCTTCATAACCCCTAAATGTAATTTTACCTAATATCTTTTAAGTGCCAGAGGCTCCCAAAGAAGTTGTTCCTGAAAAGAAAGTGCCAGTGACTCCTCCTAAAAAACCTGAAGTCCCACCTGTTAAAGGTATTTGTCACTGGCTTTAGGCTTCAGAAGACTGAACTCTTCATTTCTTGAAAATACTTTTCTAGTGGTCTTCAAACTTCTAAATGTAATTTCACTAATATCTTTTAAGTGCCAGAGGCTCCCATAGAGGTTGTTCCTGAAAAGAAAATGCCCTTGGCTCCTCCTAAAAAGCCTGAAGTCCCTCCTGTTAAAGGTATTTGTCACTGGCTTTAGGCTTCAGAAGATCAAACTCCTCTATTCTTGAAAATATTTTTTCTAGTGGTCTTCATAACCCCTAAATGTAATTTCACTAATATCTTTTAAGTACCAGAGGCTCCCAAAGAGGTTGTTCCTGAAAAGAAAGTGCCCTCGGCTCCTCCTAAAAAGCCTGAAGTCCCACCTGTTAAAGGTATTTGTCATTGAGTTTAAGCGTCAGAAGATCTATCTCTTCTACTCTTGAAAATATTTTTCCTAATGGTCTTCATAACTTCTAAATGTAATTTCACTAATATCTTTTAAG
>TTN-202,,0,110,1063179,1063288,GTATTTGTCACTGATTTTAGGCTTCAGATGATCAAACTCTTCTGCTCTGGAAAGTATTTTTCTAGTGGTCTTCATAATGCCTAAATGTAATTTCACTATTATCTTTCAAG
>TTN-202,,0,84,1063289,1063372,GTAGACACCCTCATGGTGCTGTGTTTGATATTGTTTGTTTGTCTTTACTTTGTCTAACAATGAAAATAATAATATCTTTTAAAG
>TTN-202,,0,128,1063373,1063500,GTAATAATGAAACTATTCAAATTAGTGTTTTTTAAAAAAATCTTTCCTTAGTGTTGTAAAAACATTTTTTTGCAAACTATCTCAGTTTTAGTCAATTCTGGCATTAAAATGAGCTCATGTCTTTAAAG
>TTN-202,,0,134,1063501,1063634,GTACATGGCAAGAAAGCTGCTAGGACACCTCGGCCACTCTTTCCCCTTCCTGCCCTGATAATTCTGGGTGCTCTGAGCTTTTGTCTTGTTTCTCAATCTTCGTTCTTTCTAAAACATACCTTCTAATTCTTTAG
>TTN-202,,0,129,1063635,1063763,GTATTCCTCACTGCCACTAACTCCCTAACAAAAAACTTTCTTTGAAGTGTCATATTCTACTGTTCTGCTTCATGATTTTCACATTTCATTGAAACCATGAGCTTAAACAACTACTAATATCTTTTATAG
>TTN-202,,0,132,1063764,1063895,GTATATGTGGCTGTCCACTGTTTGATGGGGGCGGATGGAGCCCCCAGCTTCTAAAAGGGTTTTGTTCTGTGTAAATGTGATGAATGTTTACTGGTGATTGTTTCTAATGTTAAAATACTAATATATTTGAAG
>TTN-202,,0,408,1063896,1064303,GTACATGTCACTAATGAGATTCTGCAGAAAAGCACTCACCCTTGTCTAATAAGTCACCTATTATCAAACCTTTTGTTTGCGAGTCCTCTTAAATTTGCAACTACAAAACTGTCATTCTGGATTTTTAGGGTCTGAATACTTTTTAATAATTTTTTCATTGACTTTAAAAAGTGATATATTTACTTATTACAAGCATTGGAAAAGTTTACTAACTTGGTTCTTTTATTCTTAATAGGCCATATTTTCCTCCCCACTATATGAGGGTCCAAAGACAGATCACTGACCTTATTGTGAAATTTGTTCTTGGATCTGTCCCTGGGTTATTTGAGCAAAATGTGAAGTCGATGTGGTATAAATTTAATATACTTCTCAACTACTCATAAGAAAAATGAATTAATATCTTTAAAG
>TTN-202,,0,479,1064304,1064782,GTACACGTGAGACCGGTGATTAATGACCTTGCCACTTGCGACTATTTCTAATTTAAGCTTTGTTCTTCTTCCTTCCTAACTCATTATTTCTTGGTCATTTTCTAACCTTTAATTATTTGTCTTAATTCATCATTCTAAATTAGCTCCAATCTCAAATCTATTTTGGGTTATTGGTCCACAGTATCTACATAAGTCATAGTAAGCTATATTAAACAAAGCTTCTCCAATGTACATAGAAAGTAAGGCAGGAGAACTAATGATTATAAATGACATTAAACACTAAAAGGGCTTTGCAAGCATTTGAATCAATAGACAAAGAAGTCAGTGCAAATGAGATAGATTTTATCTAAACAAAAATAAGAGAAGGTATCAATTGAAACAAAGGAAGAAATCAAGATTACTATTTATCGTGTTTAGTGTTTGTCCATCTTAGAATATTGTTCCATACATTGAAATAAAATTAACTAATATCTTTAAAG
>TTN-202,,0,269,1064783,1065051,GTACAAAGCAGAATCCACTGTATGGGAAAATACAGTCATTTCATTTTTCATGTCTATATATCTTCCTTAAGGCAAAATATCAGTCTTGTATCTTGTTGCCTGAAATCTGACTACATTAAGAACAAAAGTTATTTCTACACATAAAACTTTGGACCCACAGAATTTGGTCCCACATATACCAAGAAATATGTGTGGTTTTTAATTCATTCATTAGCATTAAATTTTTCATTGTAATCACCTAATTCTAAAAGAAATTCCTATTATTCAAG
>TTN-202,,0,3786,1065052,1068837,GTACTCATGTTAAAATGAATACTTCATTTTTGTGGTGTCTACAATTTTACACTCTTCTTATTGTGTGTTGTGTTGTATTATATGTTTGTTAACTCTTACCTATATGTTACAGTGTTGAATAAACTTGTATGTATATCTTACATCTCACAACTTTGTATTATTAAATGCTACTGATATCTTTAAAGAACCTGAGATGCCAAAGAAAGTTGTTCCAGTGAAGAAGGTCCCAACTGTTAAGAAGCCAGAAACACCAGCAGCTAAAGGTATTCACTTCATCGTTGGCATCATAAAAAAGAAAGTATTCTGATATCTTAAAGTGGAATCCAATAAGTTGTCCTCATTGTTGTTGCATAACTAAGGACAAAAATTTCCTTATTTTGCTTTCATTAATTTTAATGCTGCTCCAATAAATACAGGTTTTTTATTCTTAATATTTTAAAATGTTTTTAAATACTATTTTTAAAACAAAACTAATATCTTCAAAGTGCCTGAGGTGCCCAAGAAACTTGTTCCAGTAAAGAAAGAACCTGTGCCTGTTACCAAAAAACCAGAAGTTCTTCCAGAAAAAGGTACCTACCATGAAGAAAAAATAGATTTCTCTAACTGCTATTTAAGCATGTTAATAATAGGTCTTAGAGAAAAACATACTGAATGTGAATTTATGTTAAAACCATATTGCACAGAAAAAAGGGAAATAATGAAGGGAAAAAAATGAAACAGACAAGCAGGAGTGAAAAAATGAGTGGGATTCAGTTGTGCTGTGATATATCACATGGCTACAACTAGTAGAAAAGAACCTTCTCTCATTCAATGTGTAAAACAGCTCAATTCAACATATTTTGTTGAATGTTGACCATTAACAAGACATCATATTAGAAAAATTAAGGCCTGATTCTGTCTTCAAATAAGTTAAATCTGGTGAGAGGATAGAAAGATAACAGGACTCTAATACAGACAGGAAGTGATTACACATAGCAAGTGAATACAAAAGGGCTGCAGAAACACACGGCAAGAAAAGATTAAGTTCAGGCAGAGGCATCATGGGAAGCTGTGTTAAACTGAATTTAAATTTTGATGGACTTTTACATGTAGAAATTGAGGAAATAAGGCCGGATGTGGTGGCTCACGCCTGTCATCCCAACACTTGGGGAGGCCAAGGTGGGTGGATCACTTGAGGTCAGGAGTTCAAGACCAGCCTGGCCAACATGGTGAAACCCCGTCTCTACTAAAAATACAAAAATTAGCTGGGGGTGGTGATATGTGCCTGTAATCCCAGCTACTTGGGAGGCTGAGGCAGGAGAATTGCTTGAACCCAGGAGGCAGAGGTTGCAGTGAGCTGAGATAATGCCACTGCACTCCAGCTTGGGTGACAGAGTGAGCCTCTGTCTCAAAAAAATTAAAAAAAAGAAATTGAGGACATGATATCCCATGGAAAGGGAAGAGCATATTGAAAGGCACAGAGATAGAAGGGTCTAGAATGTTCAAGGATTGTCAAGTAAACTTATGTCAAGTAAACTCAATTTGAGTATGGATTGGCTGTGGAATGTCTTGAAAGATAATACCAGATATAAAGATGGGGTCATATTTTGGAGTACTTCAAATGCCAGTAAAAGGCTTGTACTTTTTTCTGTAGGCAATAGGAAGCTTCAAAGATTTTGAAGCAGGCTTACATATTAATAGGATTTGGGCTTTAGAAAGATAACTGGCAGCAATTTCAGCTACTAAATAGTAAAGACCCATTGCAATTATTTAAGGTCTTTAAGAGTTGGACAAGATCCGTGGCGGCAGAAATGGAAAGGGGGACTGGGTTTGAAAGAGATGGAGACTTAGTGGCCTCTGACCATTATCAAAACCATTAGGGAAATTGAGGAGCCCAAGATCATTGTAAGGTTTAAAGCTAGATGGCCAAAAGAATGGTTCATTGGGTCTCTGAACTAACGTTAGAGGAAAATGGTAGATGTGCTTTTCACCTTTAAAGCATAAAAGTTGGGAGTGTGTATCAGGAGCTTAAGAAAGAGATCAGGCCTAGAGATGTAGATCTTAAAGTCATTCACATGTAAATAAGAATTGAGTGTGCAGGAACAATTACTCAGAAAATGTAGAGCAAATTTTTTTAAGTGTCAAAGTTAGACCACCTTCATTTAAGTGTACACAGAGGACTAGAAGCAAATGAAGAAAGCTGAGAAGATTCATATATAAAATTAGGATGTCCAAAATGGTGCCATGTCTCAGAAGCCATTTTCCCCATGAAATCTAAGATGAAGCTCTTGCCCCTGCATTCTTTGCCTGCTCTTTAGACAATCTTGCATGTCTTCTAAATTCTTAATAGTAAACAAAATCATATCTTTAAAGTGCCCAAAGTGCCTGAGAAAATCATCCCAGAAAAGGAAGTGTCTGTGCCTATCCCTGCAGAGCCAGAAGTTCCACCTGCTGAAGGTACACGGCTTCTCCATAAATCTTGGAAAGATGACAATTGTCTTCATCCTCTTGCTTTGATTGTAGATGAATCTTACGTATTTGTCTGTCTGTATTGAAGTTATTGATATTTGGGGGGTCATCTGAATAATCTGTTATAGAGTGTTACTTAATGTAACTAGGTTGATATGTTAGAATAGTAGTTGCAGTATTCTGTTCTAAATATAGTCTAAAATAAAATACTATGTTTTTTAAAGTTGAAGAGACTCCTGAGGAAATAATATATGAAGAAAAAGCATCTATAACCATTGGTAGAAAAGAGACTCCCCCTGTTGAAGGTATATATATATATATATATATACATTTTTTTAATCTCCTGAAGATTCCTGTTAGAATTACAAAAGCATTTACAGGACAATATTCCTTCTTGAAATTATATACAAGAGCAGTCTAGCATGTTTGACTGCTTTATTTTTGAAATAGTTACACTTCTTTTAAGTTAGAATCTTTAATTTAGTTACTGTTGTTGGTAATTACAATTTCCAAAAGGTACAGTTTACTGAAGCAAAATGGAATAATTGCCTTGGATCCTCAAATGATAACACGGTATCAAATTTTAAAAGTCATCTCATTTGCCATCAATATACATTGAATAATCTAATTAATAGGCAGTTCAAGTAAAAGAACTTTTTCTTATACGTGAATTTTTCTATACATGAATTTGTATGAATTGTATATTTTTATTTTGTGACTGTAATCTTTGCATCAATGTGAAATTTGTATGAGTCTTTTTGAAGAACTTTACATTGCAACCTCATCTCCTTTGTCAACATTCTTTAAAGAACGTGAAATTGAAAAGTATATTAAACCTGAAGAGCCCGAACCTGAACCACAGCCTGAAGAAATACCAGTAAAAGGTATTCAATCCAGTGGACTTAAATCTTCTTTATCATATTCTTTCTCTTGAAATGTATATGGTTTATGTTGTTGTACATATGTAGTATGTCTGTTCCCATTTGTATGTAAAGTATTCTTTGTTGTAAATGTGAGCCTCATTCTTAGGTTTCCATGTAACTTGTACTGTTTCTCTCATGTCAACTGTGGCTTGTCTGGATGCTTTGTTTGTTGTTGTTATTGGTGCCTTTGCTGTATTTCTCATCATCTTTGTAAAGGGTTGATATTTTTATGTTTTATGTTCTGTGTTTTATGTTGGATACTGGTATTACGTACCTTAAAAAGTAAACTTTGTACTTCATATATATATATATATATATATATATATATATATATATATATAATTTCTATTAAATATACTACATATCCACATGCTAACATATACATATACTAACACCTCTGAAATACTCTTTCAAG
>TTN-202,,0,1303,1068838,1070140,GTAAAAAATGCCACTTCCAAAGTTTTATTAGCCTGCTTCAAACTTCTATCCAGCCATCTGAAATGATGCTTGCAAGAAATGTATGACTTTTAGAAGTGTGTACTTTCAGACATGATTGTACTGTGAGATTGCATAGAGCTGTCTCTTCTGCTGCCCCATGGTTCCTGGGTTGCTTGTCATGCCATGCCTGCTGCTGCAAAAGTCAGAAAGTACATTGATAGCGTCATCCGGGATATCTGAATGCAGGCACTGTCCAATTAACTTTCTTTTGTGGAGTGGGGAGAAAGAGTTTTCTGATTTCAAAGCCTGATTGCTATACATATCATTGCGATCTTATGCTTAAGGAATGTATAAGAAATCCTTGCAAGATATTTTTAATATTGCAGTAACACATTTACATAAAAGCCAAAACTTTGTTCTTAAAGAATTGCATGTGCTTTTAAATATATTACAAGTAATATAGTTATGATTTCCAGTAGCTGATATGTGCCTATATATCATGAAAGGAAAGCATATGAATGACTTGTTACAGTTCCCCCATCTCTTTTTTTTTCTTGCAACTTAAAGAAGTGTTCTGTGTGGTTCTCAGGGGAGCTGGAAAGAGTGGTTATGAAGACATTTGGTATCCAGCATTTATTATTAAACTTCCCTTCCCCCTTCTTATATTTTGATTTTTCTATGAATTGACACAATGTTACTTAATTTTAAAAATATCAGTTTCTTTAAAAGCTGAAATAAACTGGCAGAAACATATTATTCTTATTTTAATAAAAAGTTGTCTTGTGACGTCATATGATTCCCCAATCTAAAATTATCTAGATATAATCTTAGATATGCACTTTCCCTATACAGACCTATGTATCTTCAAACCACAGTCTTCCAGCATAAGACATTGCTGCTGGTGATTCTTGCCCTCTACAACCCTCATAGCCATTAGGGGGACCTTCTGGCACCTCTTGAAAGGCCACCCATCTGTTAATTGACACTCCATGAAGACACACACATAAATACATTTCCCTTAATGTAAAATATATGCTTAAAGGAAAATTTCTTCCTCCTGCCAATAACAAAAATTGTCTTCTTTTTCTGCTGGTCTTTAATTAACTACTGAACTTTGGAGTAAAACTGCAGTCTGTTTTCATGGTTCGAATGCTGCTTGTATGTTCTTTGAAGGCTGTTCTTGGCTGTTATTAATGCTTTCTGGTTATAAGCAAAGCTTGGTTTTGATTCTTGGAGTAGAAAGTTAATCACTTGCTTCAGATTAAATATACAAATAACAAAAGTAAAATCATATTCTTTAAAG
>TTN-202,,0,2230,1070141,1072370,GTATTTCACAGGCTGAAAAATACATACTTATGTAGTACCCCTTTACCTGACTCCTTGCTCTTTCTGCCTCCATCGAATGTTCTGTCTCTCTTTTTCAATGATCAGAGAGTAGTCCCATTCATTTCTTATATTTCTGTGGCTTTTATGGTCCTGGCTCATGAGTGTTGCTTCCTTTGTCTCCCATCCATTTCATACATGTATAGACATGGTCTATCTTTGTCTCATCTACATATGTCTTCTTGCATTTTCCTAAACTTAAAAATAACAAATTTTACTGGTTAGCCAAAATTGATATCAAGAGACATATGAGATTAAAATGCTGAGAGCTAGTAGTAAACTGTTTTGACATTTCACCTGACATAAAAATTTTAGCCAATGTAATAAGCACTAAAAATAAGTCCTATCTTCCTTTTATATTATTAAGGTTATTTGTAGGGATTTCCTTAGGACTTTCATGTCACTCTCTTCTCACTGGCTCTAAGTCATTCTCTGAGGGGTACGGAACTCACATTTCAGAAAAATTTCCTTATTACTGTAGGTAATTTTTCAAAATGTATTTTTCTGTAAACAATATTTTCCCTAATAAGGTCTCATCTAAAATTAGACCCTAAAGAAAACTAAATGAATTATAAGAGTCTAGAAAACATCTATCAAAAATAAACATAATTTTTCTAATGGGTAGTAGTGTTCTGTTCAAGTAATCAACACATTCAGACCTAGAAATTAAGACTGTTTCTGGTCACTCTGAAATTTTGGGGAAAAAAGTCACCCATATAAATATACATTTCCTGATTTCATAAAGAGGCAATTACAAAATAATGTTATCATGGATATTGATCATAAACATTAAAATAGCATATAATCACATATAATGACTTTAAAAATAATAGCTACAATGTTGGGTTCTCAAACATCAATAAGATTTTTAAAATCAAATAATAATATAAAAAATGCACAGATATATTTTCACTATGTTCATTATATCAGTAAAGAAAATCTATATTATGCCTCCTCACTTTACATTAATTAGATGCATGTGCTTCCTTCTGGGTTTGAGCAATAAAAATAGTTATTAAGAAGATTGGTACCTCTAAAATAGTATTGAAGGCCAACACAATTTATCCTGGATAAAATACGTAATGTTTAACTTTAAAATTTTTACTTAAAATATTTGACATTAAAAAAATGATTATTCAAAACGAAATACATATTTGCCTATTGTAGGTTTAAATTTTTGAAATAAGAGTTAAGCAGTTATCTTTATCACATAAAAAACCATTTAATGAATTGCAAATATCTTGTTTAAAGCCCTAAATAGGAAGTTTTATAGAAATATCTAAAAATTCAGATTCCTAATAGCAAATAGTTACACAATACAAATAAATACTGTTTTAAATTAGATTTTAATTGACATTAGTAGAGAGGAAAATGGTTTAATAATCACCACGTGTTCCTTTCTTTCACCATTCAAATCTATGAGGGCCATAATAGCAAAAGAGGCTGCTCTATAAAATAGCATCATCCACCATGCTCAGTATTCACTGTAGACGCAACAGGAAATTTTGAATTCCTTGCGTTCCTTAATTTGAATGAATTTAAGAACATTTTCTTATTCATGAAAAACGAGCTTCCAACACCAGCTTTGAAATTTTATAATTCTATAATTTTAAATATTTTATCCAGCATTATTTCAAAAAGGAAATCTTAAGAAAGGCTACTCTTCTTCTGTTCAGAAAGTGAGATATGGCCCTTCCCCAGCATCAAAGTCACAAACCGGAACTCTTGGCCACCTTCTTCCCTCAGTGGAGAAGACTGAATGATGGCACTAACACTTGCCAGTATCATTTTCATACATTTAGTGGTTGGGTAGATAACATCGTAGATTTGGACAATCTACAATTGCAGTTTGGGACAAAGATGCTGTCAAGAACCCTGTAATTTGATGAAAGATTCATAAAGTCAGTATGGAGCAACATCCTCTACATGCATTTAAAATGAATACATTTGCCTGCAGTTAATGGAGTTGAATTTCATCACAAGGCTGTATAGATATTTGCAGAGGAGATAACTTGAAATGTATCATTTAAACTTAAATTCTGTGGTATTTATATGCAGCGAAAATTGTTACTTAATGCACTACAGTTAACTAGTTTTAGGAGAGACATTTTTCTTGTTGAAATTCCGTTTTTATATAAATTCACTTCAAAATTTGAAATCATATTCTTTTAAG
>TTN-202,,0,921,1072371,1073291,GTATAGTATTTTTCAACCATTCTGTCAGCGTTAAGTATATTTTAAAAATGAACTTGAAAGCTTACAAAATGTTTCTGTCCTTTGGTTTTCTTTGAATTGGTTCGCTATTTATCAAAATTTGTTTGTAGTTTCATTGAAAATTAAGAAAAATGTCATTTCCAGATCTTTTTTTTTAAAAAAAAAAGACAGAAATTTTGTGAGCATTCACAGTATTTTGAAATTTAAAATGTTAATAGACATAACTAAGTTGATAATATTCTAAACTAACAACAACTATGACTGCCATTTTCATAACCAAATTATGTAGTAAAGTACACTAAACCTATTAAATACCTTACATGAAACTACTTTAGCTTAAATTCAATATTCAGTTTTAAAGTGTGACACAGGATCACCACAACTAATAAATAACATTTTTAAAAAACTGAACATTTCTTTCTGACTAATAAAATATTAAAGAATGAGAAACAAGATAGTCAAATGAAGAATTAAGTTCTAACATTGTCTTCACATAGAATTACTGATTTTTAGGCTACATTTCTTCAGATATCTCTGCTTAAGTAAACTTTCTACTTATTTACATACTCATTAAATCATTAACATTTAATTATTATTATAATTCGTTGCTATTCAAATTATTCATTTTGTGTTGGAGCTGTTTCTCCCACAGACTTGTCTCAGAATAGACCCTCTATCTAGATAGAAACAAAGTAACTTTGAGTGCTATTATAATTGACAACCTTTGATTTTAAAAAAAACAAAACAAAAAACACTTTCGGTGTAAATGCTTACTTTCCAGAGTGCTAGGTAGCATGCTTTTTTTCATTTTCCTTGCTTTGTACATTATTTGCATTTGTCAAGCTTATTCAACATCTTCATTAGTTTGTCTTGGTTTACATATAAACCTTTTTGTCTTTAAAG
>TTN-202,,0,610,1073292,1073901,GTAGGAATCTCAGTGACAATTTGTAAGATTATCTTTTAACAAAATGGACATTTAACAAAAGGTTTATCTTGTAAACATAAATGAAGTTAGATGTAAACATGGCTTCATATTTCATCTGTGATGTAGTCTCTGTTTTCCATTGTCTGCTTTCTGTTTAAATATTTTTATAGTAATTCCCAAATCCATTCATGTATTTCCCTGCACTTCATTCTTATCATTACTTTGCAACTTAAGTTCTTCCAGTAGAAATGACTGAAATAATCAAGTGGCTATTCATGGGAGGGTGTCAGCAAAGGTTTCATAATCTGGGGGCTTTTAAATGGGTTGGTTTTTATCATTAGCCTATTCTCAAAGGGCAAAATTATTGGGAACTATTATAGAAGTGATTTAGAAGGAGAGAGCTAAGGGGAGTGGAAGATAAGTGGATGGAATAAAAGGAAGAAAAATAAATGGAAGCAGAGTCAAGAAAATAAAATAGAAATTACTTGATAAACTATAAGGTTTTTTAAAAAACCATCCATAGAGTTTTTGAAAAATAAATTGATATTTCAGATGAGGTGCTTCCTAAATATTCAAATATTAACACTGAAAAAATAATCTTATCTTAAAG
>TTN-202,,0,430,1073902,1074331,GTACAAATCTACTGTCATTCTTAGTTGTCTCTAAAAATGCAAATATGTATCATTTAAAATATCATTACACTGACATCAAGATTTGAACACATGACCTTAATCTGTTAATCACATATGGCTTAATTTTCTTTACCATCTCACTCTCCTATGCAATTGGCTAATGATTACTCAGTTGCTAAATAAGTTACCTGAAAAAAAATTGTATTTATGGGCAATGAGATAAATAACAACATTAAAACCAAGAACATTGCCTTACTATATTTTCCAAATATTTTGTTTAAAATGAAAACTAATCAAATACTTGATTTGATAATTATATGTATATAAATTCTAATATCTTCCAAGATACGTGGGCTTAATTTTAGTTTTGACTTTGTGAAAAACTTCAAAAATCCTGTAATAATCTGCCCTCTACTCTAAATTATTTCAG
>TTN-202,,0,259,1074332,1074590,GTGAGCAAGCTTATCCTCAATGTCAACAGCATATTCTTTCTGTATTCACACACATAACATGTACTTAATAAAAGATAGTAGGTGAAAGTCAGTATGTATCAAATGATTTCTAACGTCTCAAAATGCTTAATATACTATTCTCTTAAAAACTAGTTATTTGAAGATTTCAAAATTATATCAGAAGAGGCAAATAAGCTACCAAATAAGTTTTTAGGAAGTGACAAATTGATACACTAATGCAATGGACTTCTCTCTACAG
>TTN-202,,0,2279,1074591,1076869,GTATTTATCCTGTAGCTTTCTTTTTGCTAGTTTGTTTTGGTGACTTAATAAAAGTATTCACACTTGATTAAAATTCAAGCCCTGTTTATGCTGCAACATAGGTATCATTTCAACTTCGGAGGTTTATGGTAAGTTTCTACCTTTTCTTCATGTGATATCCTTTATCCACCTTGTCTCTTGCCCAGTGGGTGAATATTGTGCCTTAACTGGAATGTACGTTCCTGGGTTGCACCATTTCTTTCATATGCTTTGGAGATTAAGTAATGAATATGTTTGGGGCTGATAAAAACTAAGGAGACAGGCAGAGACCCTGTAAGGGTATACATATAAGAATCCCATGAAGCTTCAAATTTCCCTTATACCCTATTGGAACAATTTCTCTTTTTTAAAAAAGTGTGTATATTGGGATAATGTAAAAGTTCTGGAAATGGATAGTGTTGATGGTTGTACAATATTGTGAATGTATTTCATGCAACTGAATTGAATACTTAAAAATGGCTAAAATGGTAAATTTTATGTTAGGTATATTTTACCACAATAAGAAAGAAAAAGAAAAAAGAGACTCCATATTTCAGTCTTTTAATCTGTATAAGGAATTAGATCAATAATAATTTTCTTAAATGTTCTAACTTAATGATATAGGTATCTCAAGTCCAAACTTAAAGCACCTATTAATTGTATATGAACTATTTAGTATAGTTCATCATTTAAGTGATAATTTGAGATATAATTGATCAAAACTGATTTGATGTGTAATTGATAGTCATTGATAAACATACACATCCTGACTATTTGCCCTTTGGCTCACTATCTGGGTGATGAGATCACTCATATCCCAGACCTCAGCATCATGAAATATATCCACATAACAAAACTGCACATGCATCCCATGAGTTTAAAATAAAAGTTGAAATTATTTTTTTAAAAAAGAAACAACAAAACCAAAAATAAAACAAAGTAAATTTAAAGCGGGGGCGGTGGTGGTGGGGTGGGGAGAAGGCATGTATTGATAATTTTCTAAGATGTGAAGAATCTAAGATATTCAATATAATGCCTTGACAATTTGTTCCTATGGAAAAATGATCATCTCCACTGATAAAGCACAAAATAAAAAATTCAGGGTGAATTTAAAAAAAAAAAAAGAGAACTATTTGTTACATTCCACAGTGAGATGTGCATAGGCCCCGGGAATAACATTTAGAAATGTCCATAATAGTTTGACAGAGAAATTTTTTAATTTAATTTTCTGAACCTAATAATAAAAATTGGCTTATATCTTTAATAAATCAATAAATAAAACTATTTGGAAAAATTATATTATTTTAGATTATTAATTCAATAATTAGTCATTTTATATTTGTTTATATATTTTTATATAAATTATTTAGAAATTTTTTTATTTAAAATTATCTCAAAATATTTGGACATTACCATGTTTAATGACATAAAAAAATACACTATATTCTTTTGACTGTAGTTTAATTTTTAATATTTGTGTTATATTTTGTTGCTGATGTTTATGATTTGGGCATATTCTTTTAAACTTTTATAATGTCAACGTAGTACTTTTATTATTCAGAAAAAGGTGATGAACTGCTCTTGTCTAATTAAGTATGTATAAAAATAAAGCTATTCTCAGTTATCCTGGGGGCTGAAGCTAGAGAACTCATTCCACAGTTTATACTGTCCCTGTATTAATAATGGAATCAAACTCTAAATGTCAGAACTCTCTTGCTTCTGCCTTACTTCATTGTCTAAAGGAAATCTTCAAAGAAACTCATGCATGTGTGGTACATGGACTCTTTTTCCTTAGTCTTCCCTGGATTTGTTTGTCTGCCCAATTTAGACATAAAAAGAAAGGCTTTTGGTAACCTCTCAGCCATTTCCCTTTTCCCTACACTGATTTATTGACAAAACCTTATTTCCTTGGTTCACATAATCAGGACTTACATAAACATATAAAATATTTTGCACAGCTAGGCAGGAGCAAAACTTTTCCTCACAAGGCAACAGTAAGCCTTCCAAAAATGGGAAGATAATAAGGCACTTGCTGAAAGAAGTTGTTAATCCTAAATATGTTGGCAGTTTAGCTTGAGCTCTTCAGTCTCAGAATATGCCTTCCTGGAAATGTGATTATCCATAGAAGTCATATAAATGAAACCAATTTCTCTTTATGCGTTAATATTTATAATGGAGCATGACTCACCCTCCATGGTTTACTATTAAACATGAAATAAGTCCGAAAAGTGTTTAAATGCTGAGTTTTATTTTTATTTCAG
>TTN-202,,0,569,1076870,1077438,GTGAAATTCATTTTTCTAGTACTTGCATTGTAACCTTCCACTCTGAATTTCCAAAGTTCATATTCAAGGGGAAAAAAATTTCAAAATTCATAACAATTTTTATTTTTTCTAATTGATTCTACTAAAACTAGCATGTTTTCTGATATTTCAAATAATACTTTTAGTATTATGCAAGGAGATATATATATATATATATATATATATATATATATATATATATATCCAACTATATTTTAGCATAGTGAATCCCATAAGTTCTTAGCTTCATTTTTCATATGCATGGTATTTATACATGGCAGATAAAATAATTAGACATTAATCTGGCTATTTTATACTTCAGATTAAAACTTGAGAAAAGGGACATTTATTATTCATGGATTCCTTATACCATCTCATTTTCCTGCCTGAAACAAGGCAGTATAAACTCAATTGGCCTTTCAATTGCCTGGTCTTTAGTTTTCTCGTCTTCTAATTGCTTTACGGCTGGTTTTATCCAGCAGGCAGCCAAGTATGAACTTTCTGACTCCTAAGGAGATGCCAAATCAACTTTTTATTTTACTTTGAATTAG
>TTN-202,,0,156,1077439,1077594,GTAATTTCTAGTCTTCTGAACATAATCTATATTAAACTTTAATGTAACAAACCTTAGTAGCAACTTGCATTGTAGTTTTACAAAACCTCTTATTTCCAAGTTTTATTTCATTGAAAATATTGTATTTATTGAAATATATACTGAAATTCTCCATAG
>TTN-202,,0,247,1077595,1077841,GTTAGTACTTTCCTGGGAGATTTCGTTCTGCTTATTGTTACACTAAGAAAATGGAAGAAAGGACCTCGTTTCCCAGTATTACAATATCAGAAATCTTGTACCTAAGAGGGGAATAACAATATATCCTACAGTGGATTAATTATGCCCAGTATTGTGAAATTTTTCCTATTCCTGAAATTTACTAAGGAAGCTATGTATATTACTTGTTCAGACCTTAATCATTTTTTCTGATCTTATTTTCATATAG
>TTN-202,,0,135,1077842,1077976,GTATAAAATCTTACCTTTTATTCAAATTATAAGTTTTGCGTATGTGTAAAGCCAAATAACACACCAAAACACATAAAAGCAAAGCATCGTTGGGTTGTCTAAAGCATTATGTTACTTCATCCCTGACCAATACAG
>TTN-202,,0,315,1077977,1078291,GTGAGTAATTTCACATTTTAAATTGTTAGTCATATAAAATAACCACATCCAATATTCAGGATCTATATCCTAGATTCGGGTTGCTTTAATAATAATGGAGTTAATGGAGTCTTCTAAAGTCTCCAAGAAGGAAAGAAATTTTACGTATCATTTGGGGACAACTTGAACAATTTGTGTAAAATGTTATGACAGGGAATTCTCTGCTTACTTTTATTAGTAGTAATTTTTAAAACTCTATAGAAATTTGTATCTGAAACACTTCTCCTATAGGGAATTTATCTCTTTCAAATGGTTACTAAAACTATTGTTTTTCAG
>TTN-202,,0,93,1078292,1078384,GTATGGGGCTTTTAGAATTTGGGGAGGGGTCTCAACTTTATTTCACTTCCCTGTGCATTCTGAAAAGCCTCATTCTTAATGTCTGATTTTCAG
>TTN-202,,0,282,1078385,1078666,GTAAGCGAGCTAATGAGATCTGTGACATCCCATAAAGGCATGCAAATATATGACTTTAAAGATAGGACGCCAAGTTCTAAAAGCTGTGATAATGCATCACTAATTAACTTTCACAGTGTTACCAAAACAACCCCCCTTAATTTGTTTTTAGTGGAGCTCTATTTGGAAAGATGAATAAATAAGTGCCATGTGAAATGGGTCCCTTTTACTCAGGCAGATTAGAATGGAATCTTTCTGAAGGTGAATTGTGTTTCTGAGGCATTATCTATGCTTGCATTTCAG
>TTN-202,,0,140,1078667,1078806,GTAAATGTAACCAAGTATAACCAGATAGCCAGTTTCTGAATCATGGGAGTGGGGAGTAATAAAATATTTTGCAACCTTTTACTCTTTAATAAACTTTAATTTTCACATTCTTCTAATTTTATGCTAAATGTCTTTTACAG
>TTN-202,,0,86,1078807,1078892,GTGAGTTGCTCAACAATGTAAAATTTACCCTATCTGAATCTGCAGTTTATTAGTTCAGTCATGCTAACAAAACTGTATCATTTCAG
>TTN-202,,0,142,1078893,1079034,GTAAGTCAAGATTAGCTAATTATATAGGAGAGGGGTTGCTTGGTTGTGTAGGGTGAAAAAAGGCATAAAATATCTTGATGATTTGTAGGAATAACTATATAAATGATGTTCTTTCTTTCCTTCTAACCCTCACTCCAAACAG
>TTN-202,,0,125,1079035,1079159,GTATGCTCTACTTGTCAGCCACGTTTTTGTATTTTCTCTGCAAGACTTCCTGATACACCCCTGCATTGATCAAGGGTCATCAATGGAAACGTATTCTGACTTCATCCACTGTCCACTTCTTTCAG
>TTN-202,,0,112,1079160,1079271,GTAAATAGTTTTATCAAATAGTCCACCCCAAAATCATTTTTTTTGCCTTTAGTTTTATATTTCTTCTTTAAAGTGCTTCAATTAATAAGTTCTTTCTTTTTTTTCTTGATAG
>TTN-202,,0,846,1079272,1080117,GTAAGTGCTTTTTAAATTTTAATTTTACTGCATTAAATTCAACAGAAATTTGTGGAGTATCTATTCTATAAAATAGTCTTCTAAGTGTTATATTGCATGAAAGCAGCCCAACTCCTTAAGAAGCTATCACATATGTAATCAGGCTTATTTCTAAAACACTTTACCTTCATTACTATAAGTTAATGAAGATTCTAGCTTACACCCACAAAATAGCCAATTAAAAGCCAACTTAAAATTCTTCATTAATTATTGAGCCCTGTCATGTTTAAAATAGGAGTATATAAATACTTTCTATCTCTTCATTTTATCAAAATTATTTCAGAGGAATGTTTTTCAAGTTTCCCATAAGAGAAGATATTACATAATTTACATTAATAAGCCTCATTGTTTTTCTTGGCCACCTAATATCAACAAGATTAAACATGAAGGCTAACATATATAGACATGATTAAAGGCAAACTATTAATTGATTAAGAAAAACTAACAATGTGAACCTGAAAGCTTAAAAGTAAACTAGACATAATAGAGTTGCTAAGAATTAGAAATTTACCCAAATAATGGAGGAACACAAAATTGTATTTGAAGCTAAATTTCAGTCTTTTTAGCTACTGTTAATAAAATGTTTCAAAATTCAATATGAATGGATTAGATCTTGATAAATCCCACACACTGATTCCCTTCCTAATATTTAGAGAACTTTTGAACATAAACAGGTTAAATGATTGAACACTTGACACAATTTTAAAAGATACTCAGAACTCTGTGAGTTGTGTCTTAAACTTTCCAAGAGATTGTCATTTCCCTAAGGTGATTAATAAAAGCTTTTCACTTATACTTTACTTGCAG
>TTN-202,,0,90,1080118,1080207,GTAAGGAAATTTCCATGAGTTTCACTCTTGAAGCATTGGGGTTATTTGTGCCAGAGGCTAATGACCCATGCTGGCCCTTCACTTTTCTAG
>TTN-202,,0,436,1080208,1080643,GTAAGGCTATTTCTGAACTTGTCAACACCTAAAGGAGCTGTGTGAATTAGAAAAGAACAGGTGAAAGTCAGAGTGGATGCAGGACATTTAAAACATGATAGCAGTTTCTCTATCAGACCCTAAGCCAAAGAGAGATGTCAGGGTCTATGAATGGGCTCAGACTGGCACACTTGCATTACTTTTGATCCAGCAGAGTGAGTATAAGGTTGTAGATACTCTGTGATGCTGCTAGTTGGCTCAGAATTATACAGCTAAAATAAATGTGGCTTTCCTCTTAGTACTTGTAAGCTTTACTTCCTAAAAAAAGAGCTCAAAGTTATATAAAGTTTCATCACCATTTATTTGTTGCATTCCTTTAATTAAGATAATCTATCCTTAGAACAAAATTTCAAAGAAAATTATTTTCTATGAAAGTTTTTCTGTTTTGTTGGTACAG
>TTN-202,,0,797,1080644,1081440,GTAAGTATTGTATATTTTTCAGGGAAATTAAATAAACACTTTTTCAGAAAATGAATGTGAGTGAAATTAATTGGACCTATTTTATTAGTTAGAAAATATTATTAAAACACAAAAACTGGCTCTCTTGTATTTGCCACTTTGACATTCCAATACAGAAGTGGTTCAAATCGTAAAGTTTTGGAAATTTTGTTGACCTTGCCATTTGAACAAAAGAAAATTTAGCAAATCAGATTTTCCTGCTCTGTAGTCCTCTCATTGAAAGTAGATACACATACAATGAGAATCTAACTCAGAACCCTTAAAGACCACTTCCCTCAAGTGGCTGTGCAACTAGAGCACCAGAAAGACAAGCTTTGCTGTGTGGGCATTTTAGATTCAAGAAAGAAGGTGGGAAGCATTAGGCTAACGTTTCTGGAAGGTGCAAAGTGTTTGATGGATAGGGACAGCCTCTGATTGAGGGCCCCTTGTCCTCTCCCAATCAGAGTCTTAGTTATTTTGGAAGTCACATACCTTATGTAGCAAGAAGAACTTGACGCCTGGCAGAGAGACAGATGCAGCACAGATTTCTCGCTGACCTTGTACGTCAGAACGAAAGGGCCCCTACATATACTCGCTCTCTGGCTACCAGCTCTCCCCTTCTCAGCGCCGTGGGGCCACGTTCACGTGGGAGTTAAAATAGTGGCCAGTCCTGTGGCTTCTTGAAGAAAGCAACCATGAAGATTCATATCTAAGTCTCTATTTATTCTTTTGGGATTACAAAATGAGTAACGCAAAGCTGTTTCTTCCCTCTCGAAAAG
>TTN-202,,0,3904,1081441,1085344,GTAAAAAGCAGGCATGCCTTGTCTTTCCCGTTCTTTTTCTGGAGTTCTTCCACCTTCACTTGTATGTTCCTTATTCTTTGCTCTTTCTAATGTCTCTTCCTCTGTCTTTGCCTTTCTCTTTCCGCCTTTAGCCTGATTTCTGCTGAAACTGTAAAGCCAATTTTTTGCATTTTTTCTTAGGTTTAACCTGATGATTTTTTTATTGAAATTGAAATAAATTTAAAGTATGATCATGTTTTAGTTTTTTGAAGAAAAGACAAGACTCATTGACTATGAATGATAGTTTGATTAACCAGAAGGCAGGAAGGATCAAAAAGGCTTTCTGATTGCACGCTCTGCAGCCATGGTGCACATTAAGTTTTAAGACTAACGCTCTCCATCCTATTTAGTGTTCTGCATATAAGGGGATTAAGAGGAGAAGACTGAAATTCCATTTCGGGCAGTTGATCAAGTAGTTGAGATAACTTCTGGGCAGATTTGCTCTTCAAGCATTTCTCCAAAGCTATTTTTAACCTTCAAGTGCTCTGGGCTGTGCGATATCTGGAATGCAAGTGGACTATTTAAAGTGCAACTGATGGTACTGACAAGAAAGAAGGGCTCTGTGGTTATCCACATATGTGGATGAAATATTTTTTTTAAGCTTTGGTAAATAACTAGCTCCTGCTTTTAGCTTTTACTAACATTCTTTATGCCCAAGATTTTACCCATAAGTAAAAACTAAGGGATTATTCAGATAGGCCCACAATACAATTTGCCTAAATTGATCTATATGTTTTGTCCCCAGAAACAACATATGTCTTTAAATTATCTTGACAATCCATCATTAATTTTGAATTCTTAAAATAAAATATATGGAATATGTCCAGCCTGGGTTGGAAATAAAGCACAGGACAGTACATTGTTCTGTGACATATTCCCCCAATATTTCAGAAATACTATTAAATGTGCTATAAAGATCTCAACAAAAATCAAACTTTGAAGACTTAAAGGAATATAATTAAAAAGTGATTCAGTTTAACAAAAAGCCACAGCATTGACTGAAGTATTTGAAAGCAATGCCTTCAAGTAACTGCTTTGAAACAAACAAACAAACAACAACAACAACAACAAAACTAGTATTCCACTAAAGTGATTACAGGGTAATTCACCAGCAGTCATCTGATAGGTAACGCCTGCCTGTTATACAGATAATAAGATCTTCTTGGTCTCCTTTTCCAGTGACCAGAAAAAGCAGCAGTACATTCCATTTGTAGCATGGGAATTAAGTTACATATCACAAAACCTTCCTTACAATGAGGTCTTCTAAATATTGAACTGAGGGAGGCACCTCTACCTTCAAGCTTATTGTTTGAAAAAATATATTTTGCCTATCATGCATGATTTAATTAACTTCATGTCTAAAGGCAGAGAATTGGTTGCTTTTTCAAGATTCTTTCTAGATCTGCAAATTCATGATTTATATATAGGAACACTGCTTAAAGACAAATGATATTATTTTTTCATTACCAAATATCTTTTTGTCATAGTAAGAGCTTCTTATTAAAAGATCAGTCTCAGTTCTAATACAAAAACTGCACTATTTTAATTCAAATGTAGACTCCTAAAAATCTTATTCACATTTTATTTTTAAAAAATTCTCATTGTAACTAAAATTTTTTCTAGGGTTAGAAAGGATCAGTTTACTATAATTCTATAGGGCCCCTTTACATCTCTTTTGGCATAGGAATTTTAATCCTTTACTCTAGGCACCCGAAATACCTTAGCCTTTTGTGAACTTGCTCTTGCATTACTTAAATGTCTCTTTTCAAAAAGAACTTAAATATAAACTTTGAAGTAATAAAATCATTTTGTTACATGTGGCAGATTTTGTTTAAATTAAGTCTGTCAGAACAAACTTGCTCTTGTCAATGTAATTCCGAACTTTAATACTCATTTTATGTAAAAATTTTCGCCTTCAAAACTACAATAACCAAACAAGCAAAAACAAGCTGTAGGAATAGGAAATATGAAGAGAAACTTGTAGACATGAGTTGTTTGCATTTTTTCTTTGTTGTTGTAGTTGTTTTTGGCTGTCAGTTTAAGAAAGGACTGCCAAGTTCCAAATGGCATTTGATAATTTTAAAGTTAAATTTTAAATTTGATAAAATTAAAGTTTAAATACAAAACTTTAATAGTTTTGTCATGGTCATAAGCCTACCGTATTATATTAATATGCTTCCACTATAAATAAATATTTTTAAAATCTCTAACATTATTCTTACAATCTACTGCAAAATCTTCAACATTCATTTCATTGGTTTATTTTTATAAGGCACCTACCAGTTTTCCTTTTTTTTCTTTTAACATAGTGGAGGTAGATTGTATACAAGCTGTTTATTGAGACATACTGCATTCTGAGCAGTGTCCTAGAGTAGCTACAGAGGAACTCAGATGATAAAGCAACATAATATTAATAGATAAAATATATCTGTGGGTGGGTTAGAAACTGAGACACCTTTTCAAATAGCCAAAAGTTGCATGCCAAAATTTATACTGAAATGTTATTAAAAAAACAAATTTTTCCCATTTCAGCACCATGCCCTCGGATAAGTAGCTCTGTTCCAAGGGCATATTTAACTACCCCCTCCTAGCTGTTATTTTTCCTTATTATGTTTTTTGGCCACTCTCAATTATTAAGATAATTATGTGACTAACCATGCCCAGTTCTTAATTAAAGAAAACACTTTTAGATGAAACCTTATTTCTGATTCTTTTCTTTACACTAGCATAACAAATAGTTCCACTGGTGAAAAACTTTACATTATTTTTAACGCTAAGTAAACTCTTAAGCAGTGCAAAATCAGTCTGGATGACAGGGCACAGCTTCTTAGGAATTTTATATCATAGAACTGGAAGAACCCCCAAGTCTCTTATCTTTGCTGTCAGAATGACCCCTATCTGTCGCACCATTGACATCTGATTTTCCCATTCCTGATGCTTAGACACATGAAAAAGGAAGAAGAGTCCAACTTTCATTTGCAGTTTTGAACAAAATTAATAGGTTGTACAAATTATTTAATCACAGGTTTAATTGGTTTGCAAAATAAGTTTAATTGCTAAAATAAATGGGAAGAAGAGTTATAGCTTGTTGTTGCATGGCAAACACCTTACATACAGAACATAAGGTTTACTTTTAGCTTGCCATAGCTGATATTTTCTTTCATCCTTTCATGAATTCGCTTTTCTAAGTTCTTCCTTTATATGTATATAAGCCCAGGGGCAGAATGGGGGCACACATATATATACACATATACGTATATACTATATGTGCTGTATATCTACGCATATGCAAAAAAGACCACAAATGTAAACAGAAACTGGCCTGGGCAATTTCAATGTGAAAGGCCACCTAGTAATTATATAAAGGTAACTATGAAACCCTAAAATTTTCTTGAAAGATCCCAAACTGCATAGTATTCCATGGTGTATATGTGCCACATTTTCTTAATCCGGTCTATCATTGTTGGACATTTGGGTTGGTTCCAAGTCTTTGCTATTGTGAATAATGCCACAATAAACATACGTGTGCATGTGTCTTTACAGCAGCATGATTTATAGTCCTTATACCCAATGCTAGATGATGAGTTAGTGGGTGCAGGGCACCAGCATGGCACATGTATACATATGTAACTAACCTGCACATTGTGCACATGTACCCTAAAACTTAAAGTATAATAATAATAAATAAATTTAAAAAAAAGATCCCAAACTATTGGTTGAAATGATTTTTGAATGCATACGTGCTAAATAGATGATTATAAAACAACTTGGAAAGCTCTATTTCCATTTATTTTTATCTAAATGAATTAAATGCACCCATATACTAGATTGCTGTTTCATGTATTCTTTTTTTAAAAACAACTAG
>TTN-202,,0,541,1085345,1085885,GTAATTACAAGGCTTATTTTAAAAACATGTATAAGGCAGAGGCTCATGAACAATGCCAACTCTCAATTATCTTTATATGATGAGTACTATAGATGTTTAAAATCAACCAAATAATCAAAAGTCTGATTTTACTTTTTAGCATAACAAAATAATTCACAGACTATCTTTTTAAAGAGCCAAAATTGACTAGCATAGGTTTTACTTCCTCCTTCCATCTCTATTGTTTTTATTGCACATCCTAGATTTTCAAAAGCCAGCTGGAGGAAGAATTATTATCAAGCTAGGTATCCATCACTTTATTAACCAAGAGTTGGCTGTTATTTCCTTAATGTTTCCTAGTTTTTAAAAATGATTTTCCTCTTGTCTGTACAAATAATGATAAAATATCATTTTTAGAGGAAAATGTCTGAGTGTAATCAAAACTTGAAAATAAAACTTAGGACAGAACAAAGCCCTGGAGATGGCAGGGGAAAGTTGAGAAGGTACCAAAACTCTTGGAGAAGGAAAGGAGTACCTTGGCTAATGAGTATGATTCTTTCAG
>TTN-202,,0,1697,1085886,1087582,GTAAGTATTCTTCTTACAAAGGACTTTTCATTTGCAATTCTTTAATAACTACAACAACAAAACAACACAACACTTTTTGCATGCCCTTCTTGGCCTAACTGCATTTCTTGGCAACTTCTAGTATTGACACTGACCTAACCTGATCCTTTATGTGTTTAAAGAAAAAAAGAAAAGAAAAGTCTTATTCTATGTCTGGTCTGATTAATGATGGAGCAATCACTTTTCCCTATGCTTCTTTTCTCTCACTGAGTAGTGAGTAGATGTGCTCTTTGTCTACATGGGGTCAGCCTACTGTATGGATATCCTGATATGGATGAGGAGAAACTGAATTTTAAAGATAAGTAGGGAGTCCTAATTTTAAAAACAAAGTAAAAGTGATTTCCATGTGGAAGGAAAATGAATTTTCAGGTGTGGGGAACAACTAGAAAATGAGCATGAAATTTCAGTCTGAATAGGAGCATACTAGAGATCTGCTGTAATATGACAAAGCACATTCACATGATTCAATCTCTGAGAATAAGAATGGATAAGAAGATGGAGTGAGGCCCTGGATCTTTTGAGTCCTGGACTCTTTGAATGAAGAGAACTCTAATGGTTTTTAACATTACTTCTTCCTCTGGTGAAAAATGTAATGTCTTTTTTCAAAATGCCACATACTAGCTTATTTGTTTCATTCATTCCTTTGTCCAGTGATGACATTTTTCTGCAAATTTTTTGTGCAATATTTGTTTGTTTGGTTTGGTTGCTTCCCATCTGTCAACAGCTACAACCTAGTGACTCTGTGCTTCATGCATCTTGTACCATGTTTTTCTTACCACTTTGTGGTTGCTCTGCTCAAGCTTATGTCAAAGTAGCTTCTTGGGTCTCCTTCTTCACCTTGACATCTACCTTCACTCCAAGAAGGCTCAGCTGCAAGGAGCATATTTTCAAACCTATTAGACAGCATTTGTCTCAGAATCTTATTGCTCAAGAATGGTCATCTTGGGAAGGACTCACAGGGAGCTCTGAAAGAAGGAAGGGCAAGGGGGCAGCTCCCTAATCCTATACACCAGCTGAATTAATTCTACAGATGAATGAAATAACAGATGTAAAATCCTAATCACCCTCCCATACAAAACACATTGCTTTATTGCACTAATAGATGTTATGCCTGACTTATATGTGACGTCTTCAAAGCTGATTTTTTTAAAAAGCTAAATGTATGTTTCAATTACAGCCTCATGCCTCTTAGCCATACACAAGGCTGGCCATAGTGCTTCACGTGTTCTATCTTTGAATTCTGCTAATTTCTCAAAGATTGTGCTAAGTGCCTTAAATAAGACAATGTTTCTTTGCCACTGGTGTCTGAAGTTTCCTTTGACATTATCTTTCAAGTCTGGTGCAGTGCAAATGAAGATTTTTCCTCCAGCTATTATTCAAAAGAACTGAGATGGCTCCCTAGTATATATACTGTACACACACACATGCACACTAGTTGAACATATAGAATGCCACATAATTTTATGTAAACTAAAGAGATATCTAAAAAGCAAAGCATCATACCTGATGGGCAGCTTCAAGTGATTTCAAAGTCAGTTGTAGTCTATTAAGATGGAAAATCCCTAAAAAAGAGTCACTTTTTCTTAATGTATACTATGGTAATGTCAGAGTAAATTTCCAGAAACCTCATTTTGAATTCTGATGACATTCTCTTACAG
>TTN-202,,0,661,1087583,1088243,GTCTGTGACTGTATACCTGTCATCTTGTACTGTCAAATAACTTTATATTTACTTTTGGTCTAGCCAAAATGGAAAAAAAAAAGTTAGTCACAACTTCTCTGGTCACCACTTTACTTTTAAAGATAATTGTAGTATAAAATGTATTCTTGACTTTAATTGCTCTCTTTTTAGTATTATTAATTTACTATTACTTGAAAAACACTGGACTCACAATCAGGAGATTTAGATATTAGTTTGAACCATATGAAAGTGCTGTTTTCTTAGATCAGAAAGTCAAATATCAGCAATTATATTTCTTTCAACTAAGTACCTCCTGTTGCTATTAACTACCATTGGCAAGTTTCTTCAAGTCTGAGCCTTAGTTTACACATCCAAGAAGTTAGTCTGCATAATGTCTAAGGCTCACTATAGCTCTAAACTTATATGATCCCATTGTTTTTAATAACTGATAATAGTATCACAGCAGCTAACTTAACAGTAATTGGTAAGATTGTTCTTGCTTTTGGGGTTTGTTTATATTTGTGTCTGCCACCTTGGTTCTTCTTCACACTATGAAGTCTTGTTGGTTGCTTTCAGAAAAACTCAGGATCATAGTTTTTCTTAAGGACACCTGTGTGAAGGAACAACAAGAAAACTGATAATCTATTTATCTTAAATATAG
>TTN-202,,0,98,1088244,1088341,GTAAGAGTAAAGTCATTCTTTGTGAAGTATATGTGTTGGGAAAAAATAATAATTTCCAGCTTAACTCAATGTGGTTTTTGTTTTTTCAATGCTTGCAG
>TTN-202,,0,106,1088342,1088447,GTATGAAAACTACAGTGAATAATCTTTTATTTCTAACAATTCACACTTGCTAGATTTAAAGTACAAAGACATATGTTTCTAATATCTTGTAACTTTTTCTTCCCAG
>TTN-202,,0,108,1088448,1088555,GTAAGTTTGTTCTTGCTTTTAGGGTTTTTTGTTTGTTTGTTTGTTTTGTATTTGTATTTACCACTTTGATCATTATTCATACTATAAAGTCTTGTCGGTTGCTTTCAG
>TTN-202,,0,89,1088556,1088644,GTAAGTAATTTATATACCACTAGAGATTTTTTCATCAGTTTCTGTTATAAAAATAATTAAAATCAACATATTTTTCTCCTTTACAACAG
>TTN-202,,0,104,1088645,1088748,GTAAGCAAGATCTTTTTATTCTCTATTTCTGTAGCTATATATACACTTTTGACAATTTAGTGGCCATCATTGCAAGCTAACTGATAATCCAATGTCTCCTTTAG
>TTN-202,,0,100,1088749,1088848,GTACATATTAAGTGAAAAAACAATTCTAATGTTACCAATTTTTTAAAATTGTTAATCAAAATGTAAACATATTTGTATTTATTTCACATTTTCTTTCCAG
>TTN-202,,0,767,1088849,1089615,GTCAGTCCCTTTATTTTAAAATATCCTTCCAATATCACAGAGTTTAGATTTCAGATTTCACAGTTATTTAATGAGGTAATCCTTGTGAGGGTCTTTCATTTCTAGCAAGCCCTACCCACATGTTAACAACTCTAATTTTGCTCACTACAAAGTAAGTGTCTTGAGTAAGAGGAAATTAATAGCAATAATCTTTACATGCCAGAGCCTTGGACAGTTGCTAGTACATGATGACTATTTATGAACTTAGGCTACAACTAAGCTATCACCCTGAGAGTCTTGGCAAATCTAAAGACGGTCTTATACTCTCCTACTTTACAAACCCCTGTGTGCCTTTTAGGTATGTTCTCATCCTGACCCAGGACATCCTTATACACTGTCCTTATGAAAAAGCCATTAGTGTACCTCTCATTCATAAGAAAAAAGTTTCTCTGATTTATTGAACTAAGTATGCAGTGCCTACTCTATCAAAAAACAAAACAAAACATGTTTTGCACTACACTGAGTCCTATGTTACTATTTTTGGCAAGGAATGCATGTCTTATGATTTTATGCCATTCTCAATCCTCTACTCTCCAATCTAATTTGCACGCACAACAACAACAAAAAGCTATGAGAACTCTAAGCCACTTAGTTTTCTCTGCTATAAAGTTACTGTAGCTTACTTCCAAGGTTATGTAACCAATATTTTCTAATAAATGCATAATAACATGATGTAGCTTGGCTACGTTTAATAGTCGAAAGCGTTCACATGTTATCTTTCTCACTAG
>TTN-202,,0,92,1089616,1089707,GTAAGCCCTTGGGTCTCTCAGACTTAATTGGCAAAGCACAATTTAAAAGCAAGACAGCACACTAAAAAAATTCCTCTATATGTGAATTTCAG
>TTN-202,,0,107,1089708,1089814,GTAAGAAGTTTTAAGTAAATTCAAGTTAGCTTTTAAGTAAATTGCAGTCTTTGCCTTCATCATCGTTACCCCAAACTCATATTTTCTTCTTCTGTGGTGAAATCCAG
>TTN-202,,0,266,1089815,1090080,GTAAGCCCATCAAAAAAGGGAAATAATTACTGCATGAAATCCAGATATTAGGCCTATCAATTAAAATAAATCAAGTTAAATGAAAGTTAATAAAAAGGTAGAATATCATAAAAATTTGGATAAAGTTTTAGAAACCCAGACTGTGCCTACTTTACTTAGTGAATTTGATAAACCTGTTAATGAGGATGATATAATTGATTACAACACTGTTTTCATAAATTGTCACTAACGTAAATGGTATGCTCCAACTCCTTCTTTTATTCCAG
>TTN-202,,0,90,1090081,1090170,GTAGGTCATTTGCATATAAAAAAGAATATTCAATGTGGATCATGGACATAACTGTATGTGTTTTTTACAAATATTAATTCATAATCGTAG
>TTN-202,,0,106,1090171,1090276,GTAAATAGATATTTTATTTTTAGATCGGGGAATAGCACATAGCTACTTTGGGGCAACAGGGACTTAAATATGGCACTGCAAACTCATTAACTTTTCTTCTTTGTAG
>TTN-202,,0,98,1090277,1090374,GTAAGGAACAAAACATTTATCATCTAAGGTGATTTGGCAGTATTAACAAATATTAGTTCAGACTATTAACAGTGACTCGTGAGTGCATTTTTTTTCAG
>TTN-202,,0,690,1090375,1091064,GTGAGTTTTGAGCAGCACTGCATCAATGCCAAAAATGAGAGTAGGGGAAATCCCAGAAGGTTGGGATGCCATACAAAAGTCTTATGTGCTACAACTTCTTACCTTTACCTCACTGAAAATGTACAAAAACTTTTTAAGAATGCATCGGTGCTAATGCTTCCTGAGGTAGCTCAACCAAGGATTGTATAATTGTAATTGTCTTGTCTTGTGAGCCTTACCAAATTTGTAATAAAAAAAAAAATTCCCTACTGACTTGGTACCTGCTAAGTACCCAATATGTACCCATTAAGCTAGAAGTGGAAAGTAAATATTTATTTCCCTGGTGGTCACACTTCTTATTCCACTAGAATACCTTAGTTGACCTAATCAGCCATTATTTCCTTGTGTTTATATTAGTTACTATTCTTTACCCTGAATTAAAATCATATTTCTGATAAGCAAACTGGTAGAATCAACACCTCATTTGCCATCTTTTTTCATGTGTACAAACTATGAAGCAGTTTTTCTTATATTGAGTCAAATATTATCATGTATCCTACTTTGCAATTTTCCCTAATATGAAATTAATGTAAGAATAATCCCTAGCATTCAAAACAACTGCAGTTTGTATCCCTGGTCATGGTAAAAATCTTTTGGGTTGGCGAAAGGGTTTTTTGGAAATAACTGATTAACTGTATTTCTTTGTCCCAG
>TTN-202,,0,156,1091065,1091220,GTGAGTACATTCTTGATGATTTCTTACCTAATCTTGTTGCCTGTTTTTGCTTTTAGACCTAGAGTTGAAGTTATGGGGCAAGGCAGGGGTTGGCAATGTGAAGAGAACTGCATAGGTGGCCTGTGTAAGACTGACTCTCTCTTCCAAATGTTGTAG
>TTN-202,,0,338,1091221,1091558,GTAGGTTTTTAATTTGGCATGAGAGTAAATGTGTACTCCTAGTCACTAAAATGGGCTTTGTTGGGGAAAATTTAAATGTTTGTCTTTTTTCATTGAGAATCCTATGCTGCCGGTGTATCTGTCTGATTTTTAAAGGTGCTGCTGAATGTACTGCCTGCTCAGGGTTTTCATGACAGTATTGAAATGAAAATGTATTCAGTTATAGTGTTGAAGTAATCCAGGTTTAATTTAAAGACTAGTATTATACCAGGGGTTTGAATTTTTGAAAGATTATGAGTACTACACAATGAAACGATTATCGACATCACAGTAAAACATCCTATTCTGTTTTCTGACAG
>TTN-202,,0,93,1091559,1091651,GTATCTATTTTTGATTTTTGTCTTATCAAATAGGCCTCTGACCTTAAATCTGCTTGAACTTGATAACATCATAAATAATCTTTTCCAATTCAG
>TTN-202,,0,117,1091652,1091768,GTAAGGAAGGTTCTCATTTTAAAAGGGGATAAACTCTTTGCAGTTACTTTCTTGAAAGAAAAAAATAAAAAAAATGGTGAACAATTTTTTTTTCTGCATCTGTAATGCCATACACAG
>TTN-202,,0,114,1091769,1091882,GTAAGTTTCTCAATCAGCTGATAAAAAAAAAAGGATGCTTATGTCAAACTTGCATTTTGGTGTCATATTTATATACAGGACATATAACATTTTACACCATTATCCTGTCTATAG
>TTN-202,,0,474,1091883,1092356,GTATGCTCAGAATCCCCATCAAGATGTTAAGACAGCAGTATATTCAAATGTTTACTCTTTAGTATTCCTTGGGATTACAGATGATTATATATTACTAAAAAAATTTTAAACTACTTTTACTCATATTTTCTATTACCTCATAATTTGAAAAATTATATAAATTCCATTCAAGGGCACATTTCTTAGTTTACTCTAAAATATTAACCTTCAGGAAGTTTCAAAGTGTTTGATCCCCCAGTATATTATGATAATGACCACTGTCATAGATATTATAATTAGATTGGTATGTTTGGCCCAGTCTAAAGTGTGTGGCAGTTAAAAAGCAATTTTTAATTTATATTGAAGTGCTTTTCAGTTAAATTTCCAAATCACCTTTTCACAATTTAAATAAATTAGTCTCTTCTGTGTAAAATAAACATAGGCTTCTTCTGCTTCTTACCATGATGATACACATGCACTTTGTTCCTAATTCAG
>TTN-202,,0,88,1092357,1092444,GTATTATTTATATAATTTTTGTGGTTATTTCGAAGTTCATATGAACTCCTTTTTGACAAACCTAAACAATGATTTCATTGGCTTGCAG
>TTN-202,,0,196,1092445,1092640,GTAAGTCACTCTTGATGTCTGGGATATATAAATTCTTCTAATATCTGCCTGTGAGCTACGATATGAGAAAATATGAAAAATTCATTACTATTATTTCCTCCTGGCTACATTACTTCTTAATGACTGCCTGCACTTTCAGACTGACTATTGGGTAATAAAAAAAAAAATGAATTTGTTTTCCTTCCTTCTTTTTCAG
>TTN-202,,0,114,1092641,1092754,GTATGCTCTTGCACTTAATCTTTGTGACAATAAGTGCTCTCGCACTTAATTTTTGTGACAGGAGATTATCACCTTTCCTCTGGTTTTCCTAATCATTGTTTATTTTATTTTCAG
>TTN-202,,0,102,1092755,1092856,GTAGAATTTGAATTAATTCATAAAGAATAACTTACACTTGGCTGCAAATTCTTAACTGTGTTTTTTCATTAATGCTAATGAAATGCTTTGTTGTTTCAATAG
>TTN-202,,0,80,1092857,1092936,GTAAGTAGTGCTGATTATACACAAGATATTGTCTAGAACTTGATGAGACTGTGGATATGAATATTTCACTCTTTTCTCAG
>TTN-202,,0,100,1092937,1093036,GTAAGAGCACAAGGTCTTTTATAGTTAATAAAATACCCTTTATTCATGCATTGCATTTTGACATACTCTGTTTTTTGCTCTTTTGAATGATATCTTACAG
>TTN-202,,0,603,1093037,1093639,GTAATCATTCTTTGAAGAAAAACCAGACATTCTTCACATGTAGAGGAAATTAGTTAACTTTGCAGTGCTATTAATAATATAATTGGCTTCATGAACTGGCCACTTGTAAACTAAATGTCACTTCTGATTATGTCTTTCCATAGGAGAAGTAAAACAATTCTAAAGAGATGAAATCGCTAAACGCTTATTAGACTAATTTATACTAGTTTTAGTTAATTGCATGTGAAATACTAATTTAAATAACAGATATTAGCATACCCAAAGAGCATTGAAATGACCACAATTTTTTAATTGCACAGCTTCACATTTTCCCATAGTGTTCTTAACCAGGGATAGTAACATTTTCTGCATTCCCCCCAGCCCTGCAAATAATGTCTGGAAATTTGTGGGGCCATTTTTGCTTGGCACACAGACTTGAGGTAGATACCACTGACATTTAGTAGTTGGGAGCCAAGGATGCTAAATGCTCTGCAGTGTGAATGACACTCCAGCACATCAAAGATTATCCTACCCAAAATACAGATAGCCCCACTTAGAGACAAGTGCATTATTAAAATGCTGATTTTTCAGGATTACTAGAATAATTATCCATTTTTGTAATAG
>TTN-202,,0,103,1093640,1093742,GTAAGTTTGGACATGGATGCACTATGGCTAAGAACTAATAAACCATAGTTTTGTTTTAAGAAGGTGGTTTTCCTGATACTAACATTTTTTTCTTGTTCTTCAG
>TTN-202,,0,113,1093743,1093855,GTAAGTTTTGTTTCATGGAGTTGCCACTTTCCCATTTTGAAATAAATGAAAATAATGTTTTGTCAGTTATTTTCATCAGAATTGAAAACATTTATTGGTTATGATCACTATAG
>TTN-202,,0,299,1093856,1094154,GTGAGTCATTAAAACTACACTTTCCAATGGAAAAAGGTTTTAGTAAAACATAAAAATAAAAAGTTTGGGAGAGAGTTAAAAGAAATGGGACATAGCTTCAGCAAGTTATCCTCAATCATATTTTATCTGCTGGCCATGTAAAAGAAATCACCTGATCTTGTTATTTATTAGCTAATGGAATACAAAGATAGATGTGGGAAAACCACAAATCATGTCAGAGGAGCATGCTCACATTTATATTTTCCATAGCAACCCTTCCCACACAAATTTTTGATTACTGTTCTCTTCTGAAATATTAG
>TTN-202,,0,128,1094155,1094282,GTAAGTTTCCTTTGGCATCTAAAGTTTGCCTTTTTACCATGTACTTTGGTATATAATTACTACAGCTTTTAAAATTGCATTTTTATGTCATACTGGGAAATTTACTTCAAATGTTATTTTTTTATCAG
>TTN-202,,0,96,1094283,1094378,GTAAGTAGTTCCTTAAGAAGAAGGTGGAGTAGAACAAGCTATTGTACATTTTAAAACCATCAGGGAGTTTGATTTGTCTATCTTCATTCATTCTAG
>TTN-202,,0,99,1094379,1094477,GTACTTAACGTTATTGGAATAAAATTATGGATATTTTCTCTATATGGGACTATTTTTTAATCTTTCATGGGCTAATGCATGACTGTTCTCTTTCAACAG
>TTN-202,,0,86,1094478,1094563,GTAAGGAATGTTGCACTGATTTTCACAGGATTTTCCCAAGTGATACTATCTTATTACATTGATTTTTGGCTTTGTTTTGTTTTCAG
>TTN-202,,0,1307,1094564,1095870,GTAAAAGAGAAGGTTTCATTGTGTTTATAGAGTAATGTTTTGCTTCTAGTTATATTATTTACTGAGCTTTATGGCTTCAAACTCCCAACAGTCTCAAAATCTATAGCTAAAGAGTAATAAGAAAAGTAAATCAAAAAACTATTAGCAACATTAAAGATATCATATTTCCTATAATTTCAATGTAATTTGTGGCTGTAAGTATATTAATCATGCATGGTTTCTTGTACTGAAAAACTTGGATCTACAGGGGCTTAATAATAACCTAGAAGTAGTTTAGACATATTATATCTCTCCAGTAGAACACATTGGAAGTCGGGTTTTTAAAACTTACTAGCGTAGTAGTTAAAGAGAATTCAATGTTCTTCTAAAAGATTAGACAATTCCTGAGAATAAATGCCTTAGTCTTCCTCTATATTCAAAAAGTCCCCATACTGGAAGGATAGAGAGGCCCAAAACCAGAAACAGCCTCCAAAGAATAGAAAACCAACCAGAGGGAATCTCCCAGAAATCAATACGAAACACTAAAATTGCACACACAGTAATGCACACTGACATCCCATCTAAGAAAGCAAAGGCTTTGAGGAAGACCCATTCCTCAAGAGACAGAAGAACTTATTCCTTCACCATCACCCCCTGAAAAAAAAAAATACATCCTATATCACTGCTGCAGCTCATCTATGAACGTCCAATATACCACAGGCTGTGCCAGAGGCACCAGAACAGAGCTGAGCTTCCACTCCTTCTGGTTGCAATAACAGTCAACAAGTATGGATTGGGTCTAGTTTTACCACTGAAAGCTTAACTCTTAGTTTGGTCCTTCAGGAAAGAAAACTTCAGCAGCATTACATACATCCTCTTTCCACCATATTTTGAACCCACATGTGAGGCAACATGACTCAAAGTATGTTCATAGACATATCCACTATCTGTTAATAAAAGAAAAAACACTTTGCTCTCAGCTGGTCATTCAAAGCAAAGCTTCACAGACTTACTTTCCTAGTTCAGTAGAATTAGAAGCATCCCCAGTTACAAAGGTAAACAATCTAAAATGTTAAATTAAAAAAGCATACGTGCCCTTGATTTATTTTTCACTGATAATCTTGATGAAAAGTTTGCTAAGAAAAATTCTGTCTACATGAATGTCTATAATTTTGGCAACTGACAAGTTTTAGGAATGATTTTAAATAAGGATGTAAGGTTATGCCAAACAGAAGGCTATTTTTTACATAATTAAGTTGAAGTGAAATATTATTTCTTACATGAATATTTATCTCATGCTAATCATTTTCACTTGCCTCTGGCTAAAG
>TTN-202,,0,118,1095871,1095988,GTGCGGAATCTGAATATAATAATAATTTTAATGCATTTTACAGTGTGCCTTTATCCCATAAGTTGAAAAAAACATCCTTATGACTTTGTTACTGTTTTTCTTTCTCTTCTCTTTGCAG
>TTN-202,,0,88,1095989,1096076,GTAAGTGACTTGCTTTCTTACATCAAAAAGGCATCCAGTGTCTGTTTAAGAATTGCCTTCTCAATATTCTCTGTTGATTCCTTTCCAG
>TTN-202,,0,402,1096077,1096478,GTAAACTCTTCTGAATATTTTCTTATACACATTAAAAGTACATGACTCTGGTTTGATGCCATTTTAATATAACCTTGGAATTTGATAATTAAACTCAAAACCACACACGATAAGCTGTTATTTTGTTATTGTAGTGTTTAGCCCCACACACATAAGGCTCCTTAGTACATAGCGTTTGATACACAGATACTCTTTTAATTGAGATCCACTATCAGGTACAATACATCTACATATTTTTATTTTAAAAAAAGCTTTCTCCTTTTCTCTGTCTTCCCATGTTTTGAGTCTATATATTTATTTCTTCTTACAGTCATCCCTCCCAAAATAAGTTGAATTTTTAAATGAGTGAAAACCAACATAAGTATATTCTCTTCAATAAATTTCTGTTTTTCTAATTTCTAG
>TTN-202,,0,1285,1096479,1097763,GTAAGTATGCTTCCGTTTCTGGGGACTAATTTCTAAAGCACAAAGTCACTAAATGGATAATTCTGCCTTAAATTTCTTATATTTTTCTATGCCAAATTATTTTATTTATTAAAATAAAAAAGGTTCATGTTCACATAGACTATCGGAAGTATATATTTATGTGTGTATACATACATGCACAGATATATACATACACACATACATAAAATCATACAGTTTGTAAACTCTTGGATTAAACCAAATATTTTATGAGGAATCACAATAATAAAGACCTGGACTATAAACTCCTATGTCTTCTGATACTTTAAATAAATTTCTATCTCATTAGATACTGGGGAAATCATCTCTCCCACTAAACAGTCAGACCTTCCAGTAGGAATTCAACAAAAAACAGAATGTTGTTAGCTTTTCTATAATATTATTGAACAAAGATTTAGGATTCTCAGGCATAGTCTGTGAGGTCAAATAAGAGAGAAAAATTCTTCTAAAAGATCTGTGAGCAGATTCGTTCAAAAATTAAAAAATACTGTGGCCATAATAATTCATCCTATTTGCTACATATCTGATTAGATTCTCTATAGAAGAAAAATTCAATTATTTGTTAAAAAGAAAATTTTAAATACTCAAGTGCTATGTGGAGCATATATACCTATATAATGAGGTAGTTATTCATTCATTTGCAAACTAGTATTGAACATGTGCTTTGTGCAAGGATCTATATTAACCACTGGAGGGGGAAAAGTTAAGATTAAAAAGACAAGTACAGTAAAAGAATTTCTGTAATTGTAAAGCACTTTCAGAAAGGTAAAGGATTGTTATGGGATTATTGTAGACACTGATCCTGTCCCTAAAGGGCATTAAGATTAGTTTGTGTTCAAAGGTTTACTAGCTATTGATGGAATCCTTTTTAAATTTTCATATTGTGGCAAATTAAATTTAAATCATGTTTTCAGTAAAGGCTATTGTAGAATTTCTTCAAAGGGATCTCAAAAGTAAAGTAGTTTTTTACCAATCATGTATAAATAGAATGTAAATCTAACAAGATAGGAAGTAGTCTTTCTATTCCCAGTTAGTTGTTTGCTTTCTCTGTTTTTGCATTAATGCTAAAGGAAAATAGACCATTTCCTTTATTTCTCTTCTCTAGAAGGCAACTGTATTTCCTTTTAGCATTTCTATTTTAATATTTTAATAGATTAAAATAATATATGATCATGTGTAGTAAAAGACTCCAGCACTTCATCAGCTTCAAAATCTGATGAAGCTTTTTTTTTTCTTTTGTTATTAG
>TTN-202,,0,131,1097764,1097894,GTACTAGTACTTACTCAGTTTATGTATTCCTCTTTTGATCTTATTATGAAATTGATTAATTTACTGAAGATATTTCAATTACTTTTGACAAATATGAGCTAAATCCTGTTAAATTGTATGTGGTATTACAG
>TTN-202,,0,87,1097895,1097981,GTAGGAAAATAACCATTCTCCTCTTTTTTCCACTGAATCACTATAAGGAGTATTTATACTACAACTGACTGTCTCCTTTTCTAATAG
>TTN-202,,0,94,1097982,1098075,GTAAAAAAATAATAATTAAAATAATTCAGAATATGGTTGACTTCAATATTGCTATGATTTCATTCAATGTATGACTACTATTTTCTTTGTACAG
>TTN-202,,0,93,1098076,1098168,GTAAGAAAGACTTTGAAAGTTGCTACAGAATAAAAACAAATTATTTTTAAGCATTTAAGGAACGTTGCTTATATTGTGATTTACATCCAACAG
>TTN-202,,0,93,1098169,1098261,GTAAGCTTTAAAATCTAAATTTAAAATATCTTCTCAAAATTGAAGTATATTATTATAAACAACGCTTAATACTTCCTTTAATTATTTTTACAG
>TTN-202,,0,1003,1098262,1099264,GTAAGTACCAATGTACTGACAAAGAATGTCCTCCTTACAGCTGCCTTCCTAGGTGTTCAATAATAGTTCACAATTAAAAGAGCTATATCTGTACCTTAGGAAGCTACTATGGCTTGAATGTAGACATGGGCACATTACTTAATTACTCATTCCTTCAATTTCCACAGAATTTTCACATTCCCTTACCTGTTACCTTTTCCCTGTTCAAAGGAGATGATGTCTGTAATTTCCTCGCTGTAATTTTCCTCGCAGTCTGTTTTATTTATCAGAGGCTAAAGCAATTTCTCTGCATGCTCCTCAAAAGGGACAGAAAGTAACCAGTCATTTTCTTAGCAACTGCTGAGACCCATTTATCTTCACAATCAAGTTTTTATTTCTCTATATGAGAAAAGATATATCCATTTTAATGAAGTATATATATATATATATATATATATATATATGGTAATAATTCTTCCTCTGATAATTACCATCACTACTGTTGTGTATTTGTTTATTCTCTCATCTAAGTGTGAAGAAACTGTAGTCACTACCCTCTTTGAATATTTCTGTCCTAAATTTGTGCAAAATGGAAAATTGCTTTCCTTTTATTAACAGTTATATTTCTTAAAAGGGGAATTCACCTTCTTGTGTATCCCTTCATAATTCTGTGTAAATATTAAAGAGAGTATCCCATGATACTCTCCTACTACAATCTCCTCTCTTCCCTTTTGTCAGGATATGAGAATATAATAATACACATCATTACATGCATAATGATGCCAAATAAAGTGAGGCAAGCACAGATACATAGCCACATGTAGATCCAATAAAAGATGCTGACCCCGTGTACCTGCTCCCCAAACTAGCGTAATAGTGTTAAAGACAGAACCATTCTTTATATTGGGCTGAGCTACAAAGTCTGCCTACAGTGGATCCAAACAACTTTATAGTAACTGTGAATTCTACTTTCTATCCCTCAATGCTTTTTGCTCCTAATGACAACTTTTTTTAAATAATCTAG
>TTN-202,,0,108,1099265,1099372,GTAAAGACTGCATGGTTTGGTTAAAATTACTTGTTTTTCTGTTCATAAATAACATTTGGCTTTAAAATCATCTGAGTGATAAAGGGTTCCTTCTTTAAACCATTTTAG
>TTN-202,,0,83,1099373,1099455,GTAAGTAGGAGAACATTTTCACATACAAAGCCATTTTTACTTTTTTTTTAAATTTCTTATAATCAATATGATCTTTTTCACAG
>TTN-202,,0,93,1099456,1099548,GTAAGCCTGGAAACCATTCCTTTTTTTTAAATCTTATTTTCCAAAAGTGCCTTGGAAAAGTCAAGAATACTAACGTATACTGGCTCTTTGCAG
>TTN-202,,0,447,1099549,1099995,GTAGGAAAACTTGGCACTAAGGAAATGCACTATGAATAAACTAAAAAATGTCATAGTTATTCTCAATCCCATTAACTTCTGTCTATACTTTTTGGATTAAGAAATCAGGAAAATAGCATAATTTTAACTCACATTCCAAACATCTGTTAATGTCAGAAATCGAATCAAAAGTTAAGTCATGTTATTACTAATCTTTTGGTTATAAACCCTGGAATGTGGAATAAATAAATCAAGGTTTAATCATTTGACAATAATTTTAAAGCATAACTCCTGCCAAGTTATTCCATTCAGTGTTGCCTGTAATATCTGATCCCTAAAACCTAAACCAGCAACAATTTTCCCAGAGTAAACAGTTAAATAGGCTGCTGGTGATGCTTTAGGAAGCCATTAAAGCAAGAAGCTACAAAGAACTATTCTAATTATAAAATGTCTATGATTTCTCCCCAG
>TTN-202,,0,88,1099996,1100083,GTAATTATCAATCCTTCCTTATGCCATCAGTATTTATGTTTCAGATTGAAGGGGAAAAATCACATTTGTAATTTTCAATTGCTTCCAG
>TTN-202,,0,1728,1100084,1101811,GTAAATACTTTCAATTTGTCTGTGCAACTTTTTAAACCAACATTCTTATTATATTTACACAAAGCTATGCTGTATGCTGTGTAACAAACATTTTGGAAAATAAGAAAAATCACCCATAATCATGTTGAACATTATTAGAATTTTTAAAAATTTCCTCCTTACTTTTTTATTCTATGTGTATTCTGTATGGTGGGTGTAAGTTTACAAATTATATAATTGAGAAAACAGATGCTAACAAGAAGACATGCATCCATGTTTCCAGTGAACCTAAAGAGTGCATGTACACAATTCTCAAATTGCTAGAAGGCCATGAATATGTATTCTGAATCATGGCCCAGAATAAATATGGCTTTTTTATAGAACTTGCCCCCATAGTGTCTATTATGTTGTTATATAGTTTTCATAGAAGCAACTTTCCTTAAACTGTACATGAATGTTTAACAATCTGCAACTTTCCTTAAACTGTACATGAATGTTTAACAATTTGCCAGTGCTGACCATTTCACATCATGAGACTCTACCCCTATCGCTAAATTATCATAATAATGCAAAAACCTGTTTGAAGGGTTTCAGTATTCTAATTGAAGAGAAGCATCATAGTTGGTTATCAATATTGCATTTCTAGTCACTGAATATAGAGTTGAACTCTATGAGGCTTTTTCATGGCTCTCACTGGAGGCTTTAGTCCAGTGATTTGCTCAGAACACGAAGCCTTTCCACTCAGGGCTCTTTCTAAGCATGTCTCTAGGCACAACAATACTCCAGCCACAGTTTTTATGTGAAAATTGCCAGTTCTATGTTGAATATAATTAATATAAGAATGGCATAAGGAAAAATATTTCATTAAGCAGTAGCCCCACAAACTTTCAGGTTAGTTTCAAGCACCTAAAGCTCTTTTGCCTAATGGTTATTACTTTAATTTGAGAACTGGTACATTTCCACGTTAATTATTTGCAACCTCCTCAAAGTCATTCTGAAATTTGGGGCCTCCTATGCTGCTTGTTGATCCACTGGTCATCCAGAAATAAACCATCTCTCTCTCCGTTTCCCCTGCAGAGGAAACTGGACATAGAAACTGACTATGCCACTCTTACCCATCTCTTGTATCCCTCTGCATGCTTGCCTCCCAGCTCCCTCCTGTCCAACTCACAAATTGCTTTTAAAAAGCATTTTTATTTTCCCTTCAGCCTCTACTAAAACCATGGTAACCAATAACTGTTGCAAACCTACTTCATTAACAAATATGGGGCTTGATGCTATGGCTCACACCTGTAATCCCCTGACTTTGGGAGGCCAAGGCAGGTGGATCACTTGAGGTCAGGAGTTCGAGACCAGCCTGACCAACATGGTGAAACCCTGTCTCTACTAAAAATGCAAAAATTAGCCTGGTATGGTGGCACATGCCTGTAGTCCCAGCTACTTGGGAGGCTGAGGCAGGAGAATTGCTTGAACCTGGGAAGCGGAGGTTGCAGTGAGCTGAGATTGTGCCACTGAACTCCAGCCTGGGTGACAGAGCGAGACTCCCATCTCAAAAAAAAAAAAAAAAAAAAAAAGTGGTTGACTGTTTTTGTATTGACTAGATAGCAGAAGGAAAAACTAACTCAATTAGTAGACACAAAACCTTACTTTCTTCAAAACAACATTTTTGTCTCCTTTTAAAAAAACAAGTGTTGAGCATTATCTTTCATTGAAGGCAAACAGCTTGAATTATTTTCTTCTTATTTCCAG
>TTN-202,,0,860,1101812,1102671,GTAAGTAAAAAAAAAAAAATGTATACTTAATCACTTCTTTACTCATTTAGTACAAGACTATGGTGAAAAAATATGTGTATAAATGCCGTACATTTCATTCACTTGACAAGCAGTTATCACACAACTACTCAGTATCTGATTTGGTAGTATTTGGACAGTGATTGTGAAAGAGATTTTACAAATATGTATAATTCATTGAATTTCTTTTTGTTTTTTTTTTTCTTTTTGGTTTTGTTTTGACACATAGTCTTACTGTTACCGAGGCTGGAGTATAGTGTCATGATCTTGGCTCACTGCAACCTCCACCTCTGAGGTTCAAGTGATTCTTGTGTCTCAGTCTCCCGAGTAGCTGGGATTACAGACATGCACCACCATGCCCAGCTAATTTTTCTATTTCTAGTAGAGGCAGGGTTTTGCCATGTTGGCCAGGCTGGTCTCAAACTCCTGGCCTCAAGTGATCCACCTGCCTCGGCCTCCGAAAGTGCTGGCATTACCACTCCTAGTTCATTTATCAAATTTCTTCCATCTATACCTCACAGATTTTTTTTTAATTTCCCACTTAATGGCATTAATAGAAACTGAATTATTTTCCTACTTCTAAAACTACCAATTCTGAAGACCTTTCCTAAATTATTTTGCCTCAACAAACCTCTATTTCCTCATCTGTCAAGTGAAGAAATTCAATTGTATTGGGTCCTTTTTAACTCTAATAGTTTTATGATGAGATCTCTTTTGCTATTTATGGGAGCAGAGAGTTTAATGTTTAAATGCAATCTTCAGAAAAGGAATATTCACTACATCCTACTACATTCTTAATGTGACATTTTTTTCTACCACAATTCCTATACTTATATTCGCAG
>TTN-202,,0,101,1102672,1102772,GTATGTGTCTACTACAATTTATACTTCTGAAACTTGCACATTTGTAGATTTGTAATAAGACATCAATAAAAATGACTTGCCTTTATAATTACAAATTTTAG
>TTN-202,,0,93,1102773,1102865,GTAAGTCTTATTTAGTGGAAAGAATAGATCTTCTGTTCTTTCAAAAGCAGAAATGGCAATAACATTTTGTGCCATGATTTTTTTTTTCTGCAG
>TTN-202,,0,92,1102866,1102957,GTATGCATTATGTTTCTTTTTAGTGATTCAATGCTTGATAAAACTAATATAAAGAAATAAATTTCTAACGCATTTTCCAACATTTGTTACAG
>TTN-202,,0,89,1102958,1103046,GTATAGTATTAATGGATTTATTCAGTTTTCATGTTATCTAACTTTGTTTTCAGCTATATGCTAATTCGTTTTTTACTTTTATTTTTTAG
>TTN-202,,0,114,1103047,1103160,GTGAGTAAAATGCTCTCACTTGTGTTTGCAAGGAAAATAGATGTCTGATTGTATGTGTTTAATTGTAATCTGCATTATGGATCAAATCTGAGTGTTCTGTTCTCTTTATTCTAG
>TTN-202,,0,101,1103161,1103261,GTAAGAATTTTACTACTTAGGCCATTAAAAATAAATTTTGATAATTTTGAGCTCTTATATGGATAAAATTACTTATCAAACTGTTATTTAACACTTTTTAG
>TTN-202,,0,85,1103262,1103346,GTAAGTTGCTTTCTCTGAATACAAAACTATTGTTTGACTGTCTTTAAGAATATTACTTTTTCATCATAACTTCTTCTTTGAAAAG
>TTN-202,,0,94,1103347,1103440,GTAATTTTTGGACTAGCAGTATTACCTTATTTCTTTTTAAAATTATTCATATAGGTGAAAATCAAAATCTAATTTTTTCATGTTTACTTTTCAG
>TTN-202,,0,318,1103441,1103758,GTAGGATGTCCTTGTTTTTTCTGATATTACAGCAACTCTTAATCTCAAGCACAGAAGTATTCGATAAATAAGTTAATGTAACATCTAAATCTGTAACATCCAAACTGTATTTAGCAAATATTTTTCCAAATAGACCTTTTACCAAAATACCTAAAAGGTACAAACAATAGTAGATTCTCATTTTTATGAAGGAAAATAAAGAGGACACTAATTGAAAAATTGGATGACCTATATTTGATTAACTGAGAATAGGCTATATAAAATTACACATTGAAGTATCACTAGTAGTAGTTAACTATATGTATATTTTACTTTCAG
>TTN-202,,0,98,1103759,1103856,GTAAGTCCTTCCCTTAGCATGTGATTCATTCACACTTAATTTCTTATGATTTCCCCACATTCTGAAAAATCAATTAATGACCTTAATGTCATTTGCAG
>TTN-202,,0,98,1103857,1103954,GTGGGTTACTAAAATGCTTCTCCCTCCCACTTCAAAAATGAATTTGTTAATAGGGATGCTGAGGAGACATGTATATCTGATTTTATGATTCTTTACAG
>TTN-202,,0,310,1103955,1104264,GTAAGTATTATGCTTTCTTCCTCCTTTTAACCCCAGTCTCCTATTTTAGCAAGGTCAAGATACTAATACCATTTTAATCCACTTCTGAAAGAGATTTCATTTGTAGAGACCGAAATAGTGTAATAAATATCTATCTCACTCATGAAACACTTTTTTGATCTGTCTCATCTTATATGTTTTGCTTTTAATGTACTGAACTACAGGTTCTATGTACATTGGAGCAAATCCATACTAAAACTCTTATGTACATTAACAAAGGGGATTTGATTAGGTTACCTAGGTAATCTTCTAAATTATGTTTTTCTTCTAG
>TTN-202,,0,1157,1104265,1105421,GTAAGTAGTCTTTGCTTCATTTATGTCATGTGGTAAGTTTATTAGAATTTCTTCTTTTATATGTAGACATTTCTCCCTGAGGAATCTAGCTCTAGAAATTCTTGAAAAACAGTAGAGAACAGTGGCTTTCAAACACATGAGTGGGCCAAAAACACACAGTAAATAAACTTATACAAACACATATATAACTAAAAAACATTTCCTGAAACAATACCCATTTATTATCATGTGCATTCTTATGTTTTCTACCCTATTCTGTGTTTTTAAAAATATTGGCTGTACAACAAACATATGAAGAAAAGCTCATCACCACTGGTCACTAGAGAAATGCAAATCAAAACCACAATGAGATACCATCTCACACCAGTTAGAATGGTGATCACTAAAAAGTCAGGAAACAACAGGTGCTAGAGAGGATGTGGAGAAATAGGAAAGCTTTTACACTGTTGGTGGGAGTGTAAATTAGTTCAACCATTATGGAAGACAGTGTGGCGATTCCTCAAGGATCTAGAACCAGAAATACCATTTGACCCAGCAATCTCATTACTGGGTATATACCCAAAGGATTATAAATCATTCTACTATAAAGACACATGCACATGTATGTTTATTGTGGCACTGTTCACAATAGCAAAGACTTGGAACCAACCCAAATGCCCATCAATGACAGACTGGATAAAGAAAATGTGGCACCACATTTACACCACAGGATACTACGCAGCCATAAAAAAGGATGAGTTCATGTCCTTTGCAGGGACATGGATGAAGCTGGAAACCATCATTCTCAGCAAACACAAGAACAGAAAACCAAACACCACATGTTCTCACTCATAAGTGGGAGCTGAACAATGAAAACACATGGACACAGGGAGGGGAGCATCACACACTGGGGCCTGTCAGGGGTTGGGAGGCTAGGGGAAGGATAGCATTAGGAGAATACCTAATGTAGACGATGTGTTGATGGGTGCAGCAAATCACCATGGCACATGTATACCTATGTAACAAGCCTGCACATTCTGCATATGTATCCCAGAACTTAAAGTATATATTAAAAAAAATTGGTGGTAATACAAGCATTAATTTGCACCAGTATAGCTCTCCACCAGAAGAAACTTATCCACCTTCCCAAAATTAATATCTTTTCATTTTACTTTCAG
>TTN-202,,0,103,1105422,1105524,GTAAGTTAAGTATTAGACAAATGGCCATCTAAATATGAAGCTCAGAAATATTTTTACGTATCAAATCCTTGTTCTTACATTTCTTTCCTCTTGGTTCATGTAG
>TTN-202,,0,90,1105525,1105614,GTATGTTTTTGTGAAGGAGAAAAAAAGTTGTTTTCTTTCTAGTTTGTTACTTAATGTAGAAACTGACATCTTCCTTGTCTTCATCTCCAG
>TTN-202,,0,369,1105615,1105983,GTAAGTTTTGGGGTTTTTTTATTGTTGTTGTTGTTTTAGTATTATGGAGGCACATTTAAATCTCGGAGTCTAAGATTTGGACTCCAAGACACAGAGAGTAGTAGAGATCTGAAGATTACAACTCCCATTTAAGAATATGTTCTATCTCTTACAATGAAGATGACATATTAAAAAAAGAAAAGGACATATAATTTCCTTTAAAGCATACAGCAAGGACTCAAAAGTGCATACTAGTTGGACGGTTATTAAAATGGGATAATTGTCTTCCTGTTGAGCTTGTTACTTAGCAGCAGGGATGATAATGTGAAATATGGAAGTTTAAACTTCTGCTGGTAAGATAAATGGTGAGTGTACCTCTTTTTGTTTTAG
>TTN-202,,0,379,1105984,1106362,GTAAGATTCTGCTGAGTATTATAGGCAAAGATGTAACAGCATTCATGATGGTCATTTTTCCTAATAAAAAACTAAATATACACCTAAGGAAAAAAGGAAAATTAAAATGATGTTTTGTATATAGACACAAACATTATGATTATGGAGAATCATAATAACATGCTAAATTAAAAAGCAAGATACACAACTGTGGCAACTATATAATTTCAATAGTTATTCAATAGTGCAGTTATTATTTGTCTATTAAAAATAAACAAAATGAAATAACACTAAAATTCCATTCTTGAAAGAAGCAGCATATGAATTTCCCACTATTATTAATAAGGATTACATAATATAGCTTTGCATACATTAAGTCCTTTATCTTATTTCTTTCCAG
>TTN-202,,0,347,1106363,1106709,GTAACTAATAAACTTCATTGGAATCCCATATTTTACTTTGGATAATGGGATGTAAATAGGATTTACAGAATAATGTGGGAGAAGACATTCATATTCTAATGTGTATTTCCTATGCACAGAATTATTCTTATGACAGAACCACGTTTTAGAGTTAAAAAGAGCTTTAGAAATCACATATTTCAATTACCTAATTTTACAAGTGAAGAAACTAAGATTCTAAAAAATTAACTAACCTCCTAGGTCATATAGGAAATTGACAATAGAAAGACTGCAGCCCAGGTCTCCAGACCTCTACTCTATACTCATTCCCCATTCCACATATTCACTCTTCTTCCTTATTCCTTCAG
>TTN-202,,0,87,1106710,1106796,GTAGGAACATTTCCCGGTGGTTTTTCATTTTATTTTTTAAAATTATCTTTTAGCCTGGGAAATTAACTTTTCAATCAATTTCTGCAG
>TTN-202,,0,101,1106797,1106897,GTAAGTGTTCATGAACGAGTTCCATATCCTGTGTTAAAAGCAGCATTAAACACCCAGGAAGGAAGTTTTCATGAAAATTTCCTATCATTATTTATTCTCAG
>TTN-202,,0,889,1106898,1107786,GTAAGTATTACCAGGGGGAGTACATAAGGCTTTTCCTATTAATCATATTCTAAGAGGGAGACTAGAACTCCCTTAGGTAGATTAATTTATTAACAAGGTGTAGAGCTGGTAACTCCAAGAGTACTTTTTAGGAGAGCTGGGTGGGTACTTTACGGTATTGTGGAACAGGCAAATCAAATGCACATGATTTGTGGTTTTGAAAAGCTTTTCATATATATAAGAATTTCCTGTCTTCAAAAGACATGAAATGAGAGAATTTTATTGGAATGTAAGAATTTTATTTTAGGAATAAAGAGGCCTTTTAACTAAGTAGTGAGCTATTTACTATTCTTAGGGTTTCTGTTTTCCAATCCACCATCTCCCTAAGTATGTGACTGGTGGGCTCTCCATCTTAATTTCCCTTCTTCTTATTTCTTCTATTTGCTTATCCTCCATGATAATTTCCCCTTTATTTGAATTACTTGATATTATATGTCACCCTCCAGGTACTTTTCTTCCTACTATGAAATAATAAAGAGAGCTAGAATATGTGGCAGAATACCTTCATGGAATATAGAAAGGAAAAAACAAGAATGAAAGGGAGCCAAAAATCAATCGTCTACTTTCCTTTTAATATATGTAGCATTTCAGAGTACATAAGGCTCATGAAAGAGGAGGTACAGATCCTCCGGGGGGAAAACCTGGTTAAGCCTAAAGCATAGTGGAAAATGGAAAGATCAACAATTAGTACAGAACAGAAAAATGATTTTGAGGATTGTATTAAGGAAGTTTTAAAGAACAAGAAATCAGCTCTAGAAAATAAATGTATTTTAGGAGTGACAAGGCCAGTCCCTGGAAATACATTTGACTATTAAATTTTTATTTAACTTCTTCACCCAAAATTAAACAG
>TTN-202,,0,92,1107787,1107878,GTAAGTCTATTTCAAAAAAGAATCATATATATTTTAAAATAGCTTATGTATTTTTTACACATTCATTTCTTATTTACCTACTATTTATCCAG
>TTN-202,,0,90,1107879,1107968,GTAAGCAAATGAACCATCATCCCATCATTTTGAGTTATATCCTTCCTTTGTTATATGGGGCTTACACTTATCATTTCTCCTTTGCTTTAG
>TTN-202,,0,167,1107969,1108135,GTAAGGCTCTATGCACACATCTTCATTTTTCCTTTATTGTCATCGAAAGTGCACTCTTGTGTCCCACTCACTAGCTTATCTAAAAATCCGTTAAAAGCTAGAACTATTTGAAAAAGTTAATCGCCTGGCCTTAAAAATAACAGTAATTTATCTCTGCTATTTTACAG
>TTN-202,,0,90,1108136,1108225,GTAAGTGTCTTAAATTCAGAAGACGTAAAGCAAAACACGGTTTTGAGGAGGCTTCTTATTATAAATCTTGCATTATCTACTTTTTTCTAG
>TTN-202,,0,425,1108226,1108650,GTATTTTGTTTGTTCTTATCCTACAGCTTTTACATCAAGATTCCTCACAAATATTTCCCTGAGAACAGTTGAACATGTGCTTATCGATAACATTATCTGCTTATACAGAAATGTGTTTTTATTTCAGTACATATGGTTAATGTTTAATTTTATTGAAAATATCCTAATGTAATAGTTAATAAAGTATTTCTTAATTATAATATCTATTTTTGTAAGTTAAAATTGTTCACCAAAAAAGACAACAACTATGCATATTCCAAGAGGAAAAAAAAAATGGCACTATGCTTGGGTAATAAAAGTATAGATACTAGCAAGAATGACTACTTGTTCAATATATATGGATATGTATAAATAATTTGGGCAACACATATATATTGTAAAATCAAGCTGCATTTATACTTGATACATCCCTGGGTCTTTTGTAG
>TTN-202,,0,89,1108651,1108739,GTAAGTCATTATATGAAGAAAAACCCAGGTGCATGTTTTACATGAAGAAAACTGGTATTTGTTTGACTGGTTTTGCTTTTATGTTTTAG
>TTN-202,,0,91,1108740,1108830,GTAGGTCCATTTTACTTTTTATGTACTTTTTTTTTTAAAGCAAATTAAGCCTCCTTCCTTTTCTGATTAAAATGTATTTTTTTCTTTGCAG
>TTN-202,,0,91,1108831,1108921,GTATGTAGAGCATGTGAGGGAATTGACATGGAAACATTTATAGCAGAGTTTAGGAAATCATGGATTTCTAATAAATTTGCTTCCTTTTCAG
>TTN-202,,0,112,1108922,1109033,GTTAGTATTTGTCTTTTTCAACACCGTTCATTCCAGAGTGCCAATATTTTATCTAAATTACCCAAAAGCCAAACTCTGAATATATACTTTTGTGTCTTTGTTTCTTTCTCAG
>TTN-202,,0,673,1109034,1109706,GTATGTTTTAAGAATAAGGAAATTCTACATATCCACGTTAATTTTGCTAGAATAGTGTGAGTCATTCTAATTAGTCGTTATTTCATCTTAAATGCTTTTGGGTTCACACCCTTCACACCCCAAACTATTCATACTATGGCACAAAATGGAATCTCTAGTGAAGAGTCTTTCATTGATTAAAAAAACAGAAATTTACGTAGCTAAAATTGGATAATATATGTTGAATTTAAGTATTATTGAATCTAACTGTATATATATGTAGGTATACATGTTTATATATATATATACACAGATTATATATATATAGTATGTGTGTATGACATATATCATATGTGTGTATGTGCGTGTGTACAGAAATTGTATATAAAGTTTTTTAAAAGATTGTTCATCTTGTTCCTCTTTTTTATCCCCATGGTGAATTTGGAGTAAATTTTATCATTTAATCTGGTCATTTTACCCTTAATTTGGATTTGAATGCTATAGCATGTAATGACATAGCTTGTGGGAGCCTTGGTTGGTTCAGAAGCAAAATGGGTTATGTAAAAAGGAAGACTAAAATCAACATAAAAATATGGCCTTCATTTAAAAGTTTTCTTTTGACAATACATGAAGAGTGCACATTTAAAAGTGCTGTAATAATTATTCACTTTCTTTTGATGCTTTGTTTTCTTAG
>TTN-202,,0,105,1109707,1109811,GTATGTCTAATTTTGTGTAGAAGCAAAATTTGAAATTATTTGCATTGATTTATGTTAATTTTCAGAAACACTTTTTCACTTTCACTTTCTATACTCATTTTTCAG
>TTN-202,,0,92,1109812,1109903,GTAAGTTGTCCAACTTTTCAAAGATCCAGGTTTTCTTTTACCATAAATGTGTTATTGTCTGTACTAATCTATAGGATTTCTCTCTTTTGTAG
>TTN-202,,0,108,1109904,1110011,GTACGTATTTGTCATGGGAAGGGCAGTTCTGATAACAAAAATGCAAATCTTACTTCTGCGAAGCAAAATATTATAAGTGCCGCTAATCTGCTTCTCTTATTACCACAG
>TTN-202,,0,1695,1110012,1111706,GTAAGCATGCTTAGCACTTTGAATCAAAATTGCTATTTAACTCAGTATTTCCGCATACCTTTTCCTGGTTCTAATCCTATAGAATAACTTTTACTCTGTGCCTTAATGGGGTTTTTGGAAGAAATTATGGACTAGCTGGGAGTCTGAGGAAAATTCCTTAAATACCTTTCCAGCCCTCTTGACTTGACTGTAAAGTGAGAGATTTAGACCTCAGGATATCTATGGGCCTTTCCAACTTCAACCTTTTATGATTGATTGTATGAGTTGGTGCTTTCATTCTGTTTTAAATTATCAGAGTCAATAATTAAACCATGGTTGAGTTCCTAGAGAATATTGCTCTTAAATAAGCCACAGACTAAACAGAGACTTCATTTTTTGGTTTTTTTTTTTTTGTTTGTTTGTTTGTTTGTTTGTTTTGAGACAGAGTCTCACTCTGTCGCCCAGGCTGTAGTGCAGTGGCACGGTCTTGGTTCACTGCAACTTCCGCCTCCTGGGCTCAAACGATTCTCGTGCCTCAGTCACCTGAGTAGCTGGGATTACAGGCATGCCCCACCACACCCAGCTAATTTTTTGTATTTTTAGTAGGGACGGAGTTTCACCATGTTGGCCAGGCAGGTCTCAACCTCCTGACCTCAGGTGATCCACCCACCTCGGCCTCCCAAAGTGTTGGGATTACAGGTGTGAGCCACCATGCCTGGTCTAAACACAGACTTTGATGATGATAGTATTAGCAGCAGCTAACATTTATTGAGGAATTTTCATGAATTCTTTCCCTTAGTTCTCACAGCCCTCATATTAGCCATCTTATAGAAGGGAAACTGAGGCTGAGAGTGCTTTTGTAACTTCCCCGTTAGGGATGGAGTGGGAATTCAGACAGACAGACTTCAGAGCCCTCTCTATCATGGTTAGTCCAAAATGCGTATTCTTCACCATTCTGGAAAATAAGTGGCACATTCAACTCAACAATGTTTTGAAAATTAAAACGTCATGAGAGTCAGGTATCCTGTGACACTTTACCTAAAAGATCTCCATTTGCTAAGAGAAAATTGAGCCACTGTAGTGTCTGGGCAAAAGTATCCACTTCCATCTTCATGCTGAGAATCTCAGGGCTGTTCATTATTTATGAATCAGGCTTTGTGGATACTGAATCAGTGTTTATGAGAGTATAAAGCAAGTCGAATTTAGTTATCTTTCTTGATAATTCCAAACAGCATGGCAGAAAATCTGTCCAGTAATTATGTAGCTCTGTGGGTAGAGAATTCAGACTTTAAGTGTCTGACATGAACCATCCACACTTGGATATCAGTGAACTGGGATGGGAAAAGAAAAAGAATAGGAGGTGCGTAGAAGAAAAGGAAAGAAAAGCTAAAGTGAAAGGAAATGTTTTAACAGCTTCTTCCATGATGTTCTCACTACCATATCCCATTTCTTCACTGGAATAAAGCAACTAATGGACTTTAAAACACATGTAAAAGGTGCTTAAGTCCCTGCACAACTCACAGTCTTTCTACCCCATCTGAGATAGAAGAGTGGCCTATAAATTTTTAATTTTTAAATAATAATTGCATAGAATTATAATGATGGTGTGTGTGTATAATTTAATAATGGCCAATGACCTTACTTTAAGGTTGGTGCAACTATTTTTTTTTCCATCCTTATAATATTTTAAATATTTCTCATCTGTTTTTCTTGCAG
>TTN-202,,0,112,1111707,1111818,GTAGGTGCTGAATACAGACCACTGTCATATTACATTTGCCTAAAGCTTAGTAATTTTGAACAAGTAGGCTTTAAAGAAGTACTAACATCGTGTTTTGTCCTTTCACTGATAG
>TTN-202,,0,236,1111819,1112054,GTGAGACATGATTTCATTAGAAAACTGAAACGTGAAAAATTTAAAAATAAACTACGCTAACCTGTGCATATGCTTTAATTTTCTTTTATATAACACCTGTCTCATTACCATCCTTTTCACAAGGTGAAAAATATAAAAAATAAAACCAATGTTCTTGGAAAGAATGCGAACATCAAAGGTATAATTTATCAGTAATGTGGATTCTTGTACCTTGTTTTCCCTTCCTTTCTAAATAG
>TTN-202,,0,106,1112055,1112160,GTAAGTGCTCATACCTGCAGCATCTTCACCTGTGTCTTCTATATTCACCTGTGTGACTAAATTGTACATGATTGTGTAATTATTTTATTGTGAATGGCCATTCCAG
>TTN-202,,0,105,1112161,1112265,GTATGTACCTACTGGTTTGATTATGTTTTTTAATAAGCATACTTCCAGGAAATCACTCTTTTTTGCTTTTAAAATTCACTGTATGTATCCATTTTATGTCTACAG
>TTN-202,,0,369,1112266,1112634,GTAAGTGATTATTATTCAAATACATTTAGTTTAGCAATTGAACATATTAGAAACAAATATATCAAGGAATGCTTTTCTTCTCTGCATCACCTTCTTACATATCTTCTTGTCACTAGAGAACTGGTCATGTAAAGCAAGAGGAATTATTTTAAGTCAGTCTAATAAACTAATTTGAAGTTCATTTTAAAGACTATGAAATGGAAAGTTGAAATTAATGACCAATATGAGTTTGGGAGATTGAATAAATTACTTATTATAAAAATTTTACTTATTTATTAAAATTATAGAATAATTGTATTGTTCTTCCATGGATGATTAAGACCTGGTTACAAATGTAATGATGCATTTACCTTCCTTATAATTTTTTAG
>TTN-202,,0,693,1112635,1113327,GTAAGCATTTACAACTTATTTCCAATGAGACTAAGAGCATTCACATTTTTAAAAAACACATTTGGCCCCTGGCCTGTAAAATGGTAACAGAAACAAATTACCCAAGGTTGCTAAGTGGATGAATTATGTCTTTCTACCTTTCAGATGAAAAGAAGAAAAAAATAATTGGCATCAATTATTTTTTCTATTATTTCACTCCATTCCCATATAAAGAGCATGCAGCAAGTGGGAATGAGTTTTTAGCTTTGTAATTTTCGCCACTTAACAGTACATAAAGAAAAGGTTCTCGAGAATAAGTGTCCATCTTTACTGAAGTTATTAAAATACAACATACATCCAACAACACAATCATCCCCTTGCTTGAATGCAGCTGATGGCCTCTTAAAAGAACTTGTGTGACTGTGCAGCAGTATTAGGAAGTACATGATCTGTAAATGTTTCACTTTCCTTTTTACAAAGAGCAATGCAAAATTAAAAACATGACAGGCATTACAAAGGGAATAATAATAGGCAAATATTTAACCCCATAGTCCAAATTCTCAATTATCAATCCTACTTTCAAAATAGGCTTTGGTAGCACAGTAGAAGTCACTACTCTTCCTGGCCTTGTGATATGGCACTACTGAAAAATATATATTTATGTATGTCTTTATTAAGCCAAACTAATACATAGTATTTCTCTTTCTTTTATAG
>TTN-202,,0,116,1113328,1113443,GTACTTTTAAAATAGCTTCTTAATGCTACAATTTATGAACTTGGATTAGAGACATGCCTAGTTGTATTTTAATGGACAAGGAAAAAGAAACTAACTCTAGAAACTTTTTCTTATAG
>TTN-202,,0,96,1113444,1113539,GTAAGTTTGCGTTTTTACTAAGCGGTACTATGTCAAAAGTTTAACCTTCCAAGCAAATGCATCTAATTGATTTGGGGTTTTGTTTTTGTTTTACAG
>TTN-202,,0,101,1113540,1113640,GTAAGAAAAATAAAAATCCTATTTCAAAGTCTCTATTATTAAATGTTTCCCCTGAATTTTATAAAATTGTATTCATACTTAATACCTTTGTTTATATTTAG
>TTN-202,,0,97,1113641,1113737,GTATGTATCACAATTTAAGGGCATATTTGTTTATTATTACTGATTCTAGTAGAACTCAGAGTGGTATATTTTAACCTTATTTTTGCATCCCTTCCAG
>TTN-202,,0,97,1113738,1113834,GTAGGAAATAGTCAACATTCTCCTTTTTAAAATTATCTCAATTTATGTGAAAATAAACTCTCAGATATTCATTCATATCTGTTTTGCCTACTGACAG
>TTN-202,,0,95,1113835,1113929,GTAAGCATGTCAAATGTTCTCACATTTATATAGCATTTTCCAGTGTGGGCAGAAAGAATGATCTTCATCATGGCTTGTCATTACACCTGTTTCAG
>TTN-202,,0,126,1113930,1114055,GTAAGTATTAACACTTTTAAATAATTTGACAGTTGAAATGTAATAGAATCAGGGGGAGAAGGGAGAAGGGCAGTCTTATCAATAGTAATTTTGTGCAATTCTCATCATCCTTATTTTCATAAACAG
>TTN-202,,0,881,1114056,1114936,GTGAGCTCCAAGAATCATACATAAATACAATGCTCCTCAAAACTATATGACAGATAATTTTCCAACACACAATCTCTAAGAATTTTTAGAATTTATGAATGGTCTAGAAAAGCACATGCTTATTTGCATGATCATAAATATAGCTTAAGTCAGAGAACATTTTAACTATTACATCTGTTAAGTTAGCAATTAGAATTGCTAAAAGTTGTACAGCATTTTCCAATTAATGAAAAAATATTCTATCAATATGAAAAGAATCTATTTTATAAATTTTCCTTAGAGAAAAATGCATTGTACTGTAATAACTGAAAAGAAAAATGGCAAAACTCCTTTTAAGAAGAGGTTTAGCAGGAACATACAGTTTCTAGTGGTTTCATAAGTTACTGACAAAGTAATTGTGACAAGAGCTTCAAAAATAAGTGGCAAATCCTTTTACAGAGTCTGAGCCCAAGAACTATAAAGGAATAGTCACTGGGACTGAATTGGGGAAGCTAAGGAAACCAATTCTTGTATTCATTAGAAATGTATTGGTGGCAAGTGATACTAACCCAGTGAAAGATAAGCAACTAAAGAAAAGTCCCTAAGAATGGGTACTTTAAGTAATGAGCTTAGCTAATAGAGAACACACAGTAAAGCTGGCCAAAGAAGTAGGGAAGAAATATCTACTTTCCTAAAGCAATTTAATTCTTAAGATAATAATATTAAATTATAATGTGGCACTCTGTGCTGTCCTATAATATCAGGAGCCCAGTTAATAAAGATTATCTTGGTGAGTGTGGACAAGAGCAATAATGCCTTTGTGAGTCTTGAAAACAAAAAATACAAATCTCAACATTTCCTTATTTGCCTAATATCTGCATCTCACTTTTTAAATTCCACAG
>TTN-202,,0,85,1114937,1115021,GTATTTATCACAGAAGCTTTTAGGTGAATTATTTTCTTCTCACACCTGTCCATGAATTAATTAAATTTTGTCATTAACTTTCCAG
>TTN-202,,0,171,1115022,1115192,GTAAGCATTTTACTTAAAATTGGCTATACAATGAGTAGATCCTCTAAAACAATATAGCTTGACCTATGATTGATCACCTCTCTAGAAAGGAACTATGTTGATTATATTTCCCCAAGAAAAAAAAAGCTATCAGGCAAATAGGAAATATGAATCTTTCATTCTGTTTTTCAG
>TTN-202,,0,119,1115193,1115311,GTATGTACCAAATAGCCAAAAAAAAAAAAAAAGTAAAGTAAAATGAAAACATTCAGAATTCGTAACAATTTACCATAAAAATAATGCTTAAGAATAAATGCCTGATTTCTTTCCCATAG
>TTN-202,,0,98,1115312,1115409,GTAAGGATGTGTGACAAAGATACAAGCAAGTTGATGTTCAGTCACCCAATTTTGATTTGAAGTAAAAATTAATTTCCTGTATTTCTTCTCTTTCATAG
>TTN-202,,0,679,1115410,1116088,GTAAGTCCACAGGCCCTTCCACCACTCTCCCCACCTCTGATTCTGAATGTTAACAAAAAAGAATTTGTTTTTAATATGCCCTAATGTAAATAAAAATAGGTCACAAAATTAACCCTGTGGTCTTTCTAAGGTTTCTAAACCTCCTTTTCTCAGGTTTCTAAACCTCCTTTTCTCAGAGGTTTTCAACACACTTAGGCTTGATTTTTTTTTTAATATCTTCACTCTTATGAAAGAGAAGAGGAGGGAGTTAGGAAGAAAGGAATGGAAGGAAGAAAAGAGAGAAGGGAAGGAGGAAGAGAGGAAAGGAAGGAGGACTGGCAATGTTATAGTGAGAAAAAAATACAGAGTGCATGCTTAATAAATGTAGAATTGAAGAAAATGAGGAACAGCAAGGAAAGTACAAAATTAAACCTCAGCATCATGCAATATACCCATGTAACAAACTGCACATGTACCCCTGAAGCTAAAAGTCAAAAATTTTTAATAAAAATAATTAAATAATTAAATGATTTAAATTAAAATTTACAAATAGTACAAAAGTGAAACTATTGGAAAAATAGTCATGTGCCTTATGTACCTTTTAAAATACCAACCAAAACCTAAGGAAAACACAAATATATGAGTCATTGTTTTAACGTATTCATATTGCCATATCGTGTTAACCTCTGTCTTGCTGCAG
>TTN-202,,0,911,1116089,1116999,GTAAGGACATTTTGTATCAGTCAAATTGATTGAGTTACAATTTATATGTGGGAAAATTCACCTTTTTGAAATATATAGTTCTATGACTTTTGAAAAATGTACTGTTTTGTAATCACCACCACAATCAAAATGTGGAATATTTTTATTACCCCGTAAAGTTCCCTTGTGTCCGTTTGTAATCAGTCCCTTCCCCACCCCAGCTGCTAGCGATTTCTGGCAAATAATTTTTAATATTCTTCTCTGGAGTCAATTTCCACTTCTTTAAGATGAGATTCATAATATATGCTTTCTATCACACTTAAAATTTTAAAACAAGTTAATATTTCTGGAAGCACTTTAAAAACTGCTGATAAATGTAAGATAATAATAGTGATTACAAATGAAGCACATTTAAGAGAAAGGAAAGTGAAAAAATGTTAAGTATTTTTAGCTGATAAAATGAATAAAATTTTCTTTTTTCTTTCTTTTGTTTTTTTGTGTTTTTTTGAGACAGAGTCTCACTCTGTCACCCAGGCTGGAGTGCAGTGGCATGATCTTGGCTCACTGCAACCTCTGTCTCCCAGGTTCAAGCAATTCTTCTGCCTCAGCCTCCTGAGTAGCTGGGATTACAGGTGCCTGCCACCACGCATGGCTAATTTTTATGTTTTTAGTAGAGACGCGGTTTCACCATGTTGGCCAGGCTGGTCTTGAACTAACTCCTGACCTCAAGTATCTGCCCACCTTGGCCTCCCAACTTGCTGTGATTACAGGCATGAGCCACCACACCCAGCCATGAATAAAATTTTCACAAGACAAAAAAACAGGCTAATGTTAACAGTCCGTTTCAACAACTCATTGAATTTGTTAGGTGGCACAGCTAATTTTCAACTTTGCAGCAACTTTAACCAGTATATTCTTATTCTTATTCTCAG
>TTN-202,,0,101,1117000,1117100,GTGAGACATATGATCATTTGCTTTCTGCAATAATTGCCATAGACTTATTTCTTAGTCCCCCTACCCCAAATGCTAAATTGAAACCCTACCTTTTTTTCCAG
>TTN-202,,0,130,1117101,1117230,GTAAGTGCCCTTTCAACCACAAAATTATAAACATTATTTCAGCACTTTTCTGTTTTTAAATGAAAGTCATTGGCTTATAATACTTGGGACTGTATTCTAATACATGTGTGCTTTCCACTTATATTTACAG
>TTN-202,,0,106,1117231,1117336,GTAAGGAATTCAGAAGAAGGGGTTAAATTAAAGAAGCAAGCCATGTTTGGTCCTTTTATTTCACCAGTAAAGCTGACTCCCTTTTCATTATTTTAAAATATTTCAG
>TTN-202,,0,622,1117337,1117958,GTAAGTAGCCTTTGGTTCTCTACTTATGATTTACAAACTAAACAAGTTAAGGCTAATTCCCCCTCTATACTAAGTAGAACCCTGGAAAGCTTTATTGGAGAGCAAGTGTTAAGAAAGAAAAGCAAGTACACACACAGGAAATATGACAAGTTCTACAGGAAACCATTCCAAGCACACAACCTCAGCAGATGTTAGATGGAGTGAACTGAGCACTTTCCTTGAGTAATTCCCTCTAATGCAATGGTTTCTTTTTAAAAATATTTCCCAACAAGATTTGAAAGGTCAACAATTGTATGCCACTTCAATGAACCTAAGTAAGGGCAAGAATACTACAGAATTATAGAGAGAATTTACAGTCCCTTAAAAGCCTATACATTATTAATCCCCTTCCAATCATAAAGAGAAAAAAACACTCTACATAAAATGTGACGATGTGCTCATTGAATCCCTATTTACCATATGATCCTAGGAAAATCACTTCAAAGAGTTTTTAAGAATTAGGCTAATATGTAAATCATGGTATGTGTCAGTAAATAAGGTAAATTCATTCCTGATATACAAGGACAAAGGATTACAGATTGAGTATTAACAGTCACTTAATATTATCTTTCATATTGTTCAG
>TTN-202,,0,98,1117959,1118056,GTATTTTATTTTTATTTTCAGTGCTTTTTATTTTTAAAGAAAAAAAAATCTCAAAAACACACTATGAAAACCACCACAATTGTATTTTCCCCCAACAG
>TTN-202,,0,362,1118057,1118418,GTGAGTACAACTTGATTTCTGTATCTTCCTATGGTAAAGTTCCATCTTTGCATAAAATTCTTTTAAACAGAAAGAAATTTTGAAAGGAAATAGCAAAGATTCAGATAAAGTACAAGTGCCTTTTCTTTCACTTTAATTGAATGTTTGCATATCTAAAAGGAGAAATATATATCCTAACCCCATTGTAAAAATAGAACTTTGGTTTTTGATATGTCTTAGTATAAAGTAACCAATTTCATCTTTCTGGAATAGCTATTTTTTAACAAAATTTTGGACTCATATAACATTCTTTTTTAAAAAAATAAGCTTTAATAAAGCTGCCTGTTTCATCTCATGACTCAAATCTTTTTTTTGTTTAATAG
>TTN-202,,0,132,1118419,1118550,GTAAAAATAAATAAATTATCATCAAGTTGAGGCTAAATGAGTTATTAACTTGGGGGTGGAGGCTATTGCACTTAAACACATACTGTTAGATGTTGCTAAATTATATTCTTTTTTTTTTTTTTTCTGATACAG
>TTN-202,,0,124,1118551,1118674,GTAACCAGTTCTTAAATGTCTCTTTCTTTTATCTTCTAAAATATTTTATCTTCTAAATTCAGCTTCCCAAAAAAAGCTTAAAATGAAATCACTTTTTAAAACACAAATCATTTGCATTCTACAG
>TTN-202,,0,740,1118675,1119414,GTAGGTTGGCTTTTGTTTTTACCCACATTTCTTCAGAAGATAATATTAGGGAAATATTTTCAAACATCCCCCCTTATATACACATACAAGAAAGTATTAAAATAAAATTATTTTCCTAATTCCAGAATACAATTTGTACACCAAAGCAGAAACACACATTTGAAGTTAGCATATGCTTTTCTATGAGCATAAAAAGCAGTTATTAAGTACCTAGTTATATGTGGTATTATATAAGATTCCATAGTGTCAGCCCCTGCTCCCAGGAATATTTAAGAATAAAGTCAGTGAATATACAAAATGGCACTACTTGCCTAAACCTTCACAGTTGCTAATTTTCCAAAGCAGTGCAAAGTTAATTAAAGAACTATTTCTATTTTACCAATTAAAATTAGTTTGCTTTCATTTCAATCTTCTGAAAGATAATTTAATGTTTTGGTTACTCAAAATCTCCCAAATCCACTTATCTCCTAAATCCGTTGACTATTCTTTTCAAGACTTTTTTCCTTAAGTCATATGAATCATCTTTGGCTCAGTTTAGTTTAAGGAATCATTACAGTGATCTCAAAAGTCACACATGATAATTTTCCAAAAGTGGAACTGAGAAAGTATTAGGTATTACCTACATTGCATGAAGAAGTTGACTTTTTTTCTTTTTATGTTTTTCACACGCAGAATCTAGAAGAGTAAAAGGTGGGGGTCTCTTTCTAATTAAGTTTGCCTTACAGAGGTTTCTTTTTTAG
>TTN-202,,0,100,1119415,1119514,GTAAGTTTAATTATGAATATATTATTGAAGAAAAACTAAAATACCATGTCTTCCACATCTGAAGAACTTCAACATTTCTTTTCTTTTTCCTTTGTCTTAG
>TTN-202,,0,525,1119515,1120039,GTAAGTATCTCCTCACCCTTCTTCCTTACATGTTTAAGGCCTTTAGATCGTTTTTTTGCCTCTCTTTCAAGCACAGAAAACTCTAAGAAGCCTTATTAAATTCCATGTGAAAGAGGGACAGCCAACTGATGTGAATTCATTCTTGTAGTCAAACTTTCTTTATAGCTACACAGAAACTTGGATAGATTACATTTCAAAGTAAAGCTACCAACTGCCGTGTAACATTTATTTGCAGGATGCACAATATGTCAATTACTTTCTATATGACTAATCATTTTTCTCCTAGTGATTCCTAGCACCTGCATGTAATGTAATGATAGAAATATAAGGATTCATGTTTTGGAGACATTGAGCTAGCTCTTGACAAATGTATGTATATATGTATTTGCTTATGCTTCAACAGCAAATTGTTTGGGTTATGCTGCTGTGTGTGTGTTGAAGTTTCCATTTCTGTAAGTCAGCGTCATATGTCATCAATTAACCAGATGTCATTGATGTTCACTGTGTATCTGCTATGCTCCACAG
>TTN-202,,0,138,1120040,1120177,GTGAGCAATAAAATTACTGGTAGAGGTAGACAAGCCAAGTAACATGGTGTAGTCTTTAGTACACACAATTCAGTAGAAAGCAAATCTTTATTTTTTTCAGTGATTCTAAGACCTTTTTTTTGTCATTGTTCCATAAAG
>TTN-206,ENSE00001465556,1,212,1120178,1120389,GAGCAGTCGTGCATTCCCAGCCTCGCCTCGGGTGTAGGGATTGCATAGAAAAGCAAAACTACACAGTCTTGACTGTGTAGTTTTGTTTTTAGGATTAGAGGCTCACCGATTCATGTCGGAGATGGTCAGAAAAACCAACTCTCCATAGGACGTCGTTTCAGAAGCAACCTTGGGCTTAGTCCCACCCTTTTTAGGCACTCTTGAGAAATCAG
>TTN-206,ENSE00003502146,1,104,1120390,1120493,AGTGCCTAGAAAGATGACAACTCAAGCACCGACGTTTACGCAGCCGTTACAAAGCGTTGTGGTACTGGAGGGTAGTACCGCAACCTTTGAGGCTCACATTAGTG
>TTN-206,ENSE00003807606,1,204,1120494,1120697,GTTTTCCAGTTCCTGAGGTGAGCTGGTTTAGGGATGGCCAGGTGATTTCCACTTCCACTCTGCCCGGCGTGCAGATCTCCTTTAGCGATGGCCGCGCTAAACTGACGATCCCCGCCGTGACTAAAGCCAACAGTGGACGATATTCCCTGAAAGCCACCAATGGATCTGGACAAGCGACTAGTACTGCTGAGCTTCTCGTGAAAG
>TTN-206,ENSE00003810976,1,288,1120698,1120985,CTGAGACAGCACCACCCAACTTCGTTCAACGACTGCAGAGCATGACCGTGAGACAAGGAAGCCAAGTGAGACTCCAAGTGAGAGTGACTGGAATCCCTACACCTGTGGTGAAGTTCTACCGGGATGGAGCCGAAATCCAGAGCTCCCTTGATTTCCAAATTTCACAAGAAGGCGACCTCTACAGCTTACTGATTGCAGAAGCATACCCTGAGGACTCAGGGACCTATTCAGTAAATGCCACCAATAGCGTTGGAAGAGCTACTTCGACTGCTGAATTACTGGTTCAAG
>TTN-206,ENSE00003809662,1,86,1120986,1121071,GTGAAGAAGAAGTACCTGCTAAAAAGACAAAGACAATTGTTTCGACTGCTCAGATCTCAGAATCAAGACAAACCCGAATTGAAAAG
>TTN-206,ENSE00003809782,1,245,1121072,1121316,AAGATTGAAGCCCACTTTGATGCCAGATCAATTGCAACAGTTGAGATGGTCATAGATGGTGCCGCTGGGCAACAGCTGCCACATAAAACACCTCCCAGGATTCCTCCGAAGCCAAAGTCAAGATCCCCAACACCACCGTCTATTGCTGCCAAAGCACAGCTGGCTCGGCAGCAGTCCCCATCGCCCATAAGACACTCCCCTTCCCCGGTCAGACACGTGCGGGCACCGACCCCATCTCCGGTCAG
>TTN-206,ENSE00003805863,1,331,1121317,1121647,GTCCGTGTCTCCAGCAGCAAGAATCTCCACATCCCCCATCAGGTCTGTTAGGTCTCCATTGCTCATGCGTAAGACTCAGGCATCCACCGTGGCCACAGGTCCTGAAGTGCCTCCCCCTTGGAAGCAAGAGGGCTACGTGGCCTCCTCATCTGAGGCTGAGATGAGAGAGACAACGCTGACAACCTCTACTCAGATCAGGACAGAAGAGAGATGGGAAGGGAGATACGGTGTCCAGGAGCAAGTGACCATCAGTGGTGCTGCGGGTGCTGCCGCCAGTGTGTCGGCCAGTGCTAGCTACGCAGCAGAGGCTGTTGCCACTGGTGCTAAAGAG
>TTN-206,ENSE00003803639,1,153,1121648,1121800,GTGAAACAAGATGCTGACAAAAGTGCAGCTGTTGCGACTGTTGTTGCTGCCGTTGATATGGCCAGAGTGAGAGAACCAGTGATCAGCGCTGTAGAGCAGACTGCTCAGAGGACAACCACGACTGCTGTGCACATCCAACCTGCTCAAGAACAG
>TTN-206,ENSE00003810843,1,138,1121801,1121938,GTAAGAAAGGAAGCGGAGAAGACTGCTGTAACTAAGGTAGTAGTGGCCGCCGATAAAGCCAAGGAACAAGAATTAAAATCAAGAACCAAAGAAGTAATTACCACAAAGCAAGAGCAGATGCACGTAACTCATGAGCAG
>TTN-206,ENSE00003803899,1,126,1121939,1122064,ATAAGAAAAGAAACTGAAAAAACATTTGTACCAAAGGTAGTAATTTCCGCAGCTAAAGCCAAAGAACAAGAAACTAGAATTTCTGAAGAAATTACTAAGAAACAGAAACAAGTAACTCAAGAAGCA
>TTN-206,ENSE00003808716,1,138,1122065,1122202,ATAAGACAGGAAACTGAGATAACTGCTGCATCCATGGTGGTAGTTGCCACTGCAAAGTCCACAAAACTAGAAACAGTCCCGGGAGCTCAAGAAGAAACTACCACACAACAAGATCAAATGCACCTAAGTTATGAAAAG
>TTN-206,ENSE00003809802,1,138,1122203,1122340,ATAATGAAGGAAACTAGGAAAACAGTTGTACCTAAAGTCATAGTTGCCACACCCAAAGTCAAAGAACAAGATTTAGTATCAAGAGGTAGAGAAGGCATTACTACCAAAAGAGAACAAGTGCAAATAACTCAGGAGAAG
>TTN-206,ENSE00003805623,1,138,1122341,1122478,ATGAGAAAGGAAGCCGAGAAAACTGCCTTGTCTACAATAGCAGTTGCTACTGCTAAAGCCAAAGAACAAGAAACAATACTGAGAACTAGAGAAACTATGGCTACTAGACAAGAACAAATCCAAGTTACCCATGGAAAG
>TTN-206,ENSE00003801659,1,294,1122479,1122772,GTGGACGTTGGAAAAAAGGCTGAAGCTGTAGCAACAGTTGTTGCTGCAGTAGACCAGGCCCGAGTCAGAGAGCCCAGAGAGCCTGGGCATCTTGAAGAATCCTATGCTCAGCAGACCACTTTGGAGTACGGATATAAGGAACGCATTTCCGCCGCAAAGGTAGCTGAGCCTCCCCAACGTCCAGCCTCAGAACCCCACGTTGTCCCTAAAGCAGTCAAGCCTAGAGTAATCCAGGCTCCTTCTGAGACTCATATCAAAACTACTGATCAAAAGGGAATGCACATATCATCACAG
>TTN-206,ENSE00003804455,1,123,1122773,1122895,ATCAAGAAAACTACAGATCTAACAACGGAAAGATTAGTCCATGTGGATAAACGCCCCCGCACAGCTAGCCCTCACTTTACTGTTTCAAAAATTTCTGTTCCTAAGACAGAACATGGATATGAG
>TTN-206,ENSE00003810306,1,282,1122896,1123177,GCATCAATAGCCGGTAGTGCTATTGCCACATTACAAAAAGAGTTGTCAGCCACATCTTCTGCTCAGAAGATCACCAAATCGGTGAAGGCTCCTACTGTGAAGCCCAGTGAGACTAGAGTAAGGGCAGAGCCCACACCCTTGCCACAGTTCCCCTTCGCTGACACACCAGATACTTACAAGAGTGAAGCTGGCGTTGAGGTGAAAAAGGAAGTAGGGGTGAGCATCACTGGCACCACCGTCCGTGAAGAGCGCTTTGAAGTACTGCACGGACGCGAAGCCAAG
>TTN-206,ENSE00003805296,1,66,1123178,1123243,GTAACAGAAACAGCAAGAGTACCAGCACCTGTTGAAATTCCTGTTACTCCACCAACTTTGGTCTCG
>TTN-206,ENSE00003806123,1,259,1123244,1123502,GGCTTAAAAAATGTGACTGTCATAGAAGGTGAATCTGTCACCTTGGAGTGCCACATCTCTGGATACCCATCCCCGACAGTGACATGGTACAGGGAAGACTACCAAATCGAAAGTTCCATTGACTTCCAGATAACCTTCCAGAGTGGAATTGCTCGTCTTATGATTCGCGAAGCATTTGCGGAAGACAGCGGGCGATTTACTTGCAGTGCTGTAAATGAGGCTGGAACCGTCAGCACATCCTGCTATCTGGCTGTGCAGG
>TTN-206,ENSE00003808554,1,64,1123503,1123566,TGTCAGAAGAATTTGAAAAGGAAACCACAGCCGTGACTGAGAAATTTACTACAGAAGAGAAACG
>TTN-206,ENSE00003804962,1,216,1123567,1123782,CTTTGTTGAGTCAAGAGATGTGGTTATGACTGATACTAGCCTCACAGAGGAACAAGCAGGGCCTGGAGAACCTGCCGCGCCTTACTTTATTACAAAACCAGTGGTCCAGAAACTGGTGGAAGGTGGGAGCGTGGTGTTTGGATGCCAAGTTGGCGGCAACCCAAAGCCCCATGTATACTGGAAAAAATCTGGTGTTCCTCTAACCACTGGATACAG
>TTN-206,ENSE00003804165,1,143,1123783,1123925,ATACAAAGTGAGTTACAACAAACAAACCGGTGAATGCAAGCTGGTGATTTCTATGACTTTTGCTGATGATGCTGGAGAATACACTATTGTTGTTCGCAATAAGCATGGAGAAACTTCTGCATCTGCTTCCTTGCTTGAAGAAG
>TTN-206,ENSE00003802603,1,206,1123926,1124131,CTGATTATGAGTTACTGATGAAGTCCCAGCAAGAAATGCTTTATCAGACACAAGTGACTGCATTTGTTCAAGAACCTAAAGTTGGAGAAACAGCACCTGGATTTGTATACTCTGAGTATGAAAAAGAGTATGAAAAAGAACAAGCCTTAATTAGGAAGAAAATGGCCAAAGATACTGTAGTGGTCAGAACTTATGTAGAAGATCAG
>TTN-206,ENSE00003807963,1,234,1124132,1124365,GAATTCCATATTTCTTCCTTTGAAGAGAGACTTATTAAAGAAATTGAATATAGAATAATAAAGACTACATTAGAAGAACTTCTTGAAGAAGATGGAGAAGAAAAGATGGCAGTTGACATTTCTGAATCTGAAGCTGTTGAATCAGGATTTGATTCAAGAATCAAGAATTATAGAATTCTTGAGGGGATGGGTGTCACTTTTCATTGCAAGATGTCTGGATATCCATTACCAAAG
>TTN-206,ENSE00003808968,1,245,1124366,1124610,ATTGCTTGGTACAAAGATGGCAAGCGCATCAAACATGGAGAAAGATACCAAATGGACTTTCTACAAGATGGCAGAGCTAGTCTGCGTATACCTGTTGTTCTTCCAGAAGATGAAGGAATCTACACTGCATTTGCCAGCAATATTAAAGGAAATGCAATTTGCTCAGGGAAATTGTATGTGGAGCCTGCTGCACCACTTGGAGCTCCGACTTACATTCCCACACTAGAGCCAGTGAGCAGAATCAG
>TTN-206,ENSE00003802614,1,272,1124611,1124882,ATCTCTCTCTCCACGTTCAGTGAGCAGGTCTCCTATACGCATGTCTCCTGCACGGATGTCACCTGCAAGGATGTCTCCTGCACGGATGTCCCCTGCAAGAATGTCCCCTGGACGTAGGCTGGAGGAGACAGATGAGTCACAACTTGAGAGACTATATAAACCAGTCTTTGTGTTAAAACCTGTTTCTTTCAAATGTTTAGAAGGGCAAACTGCCAGATTTGACTTAAAGGTTGTTGGTAGACCTATGCCAGAGACGTTCTGGTTTCATGATG
>TTN-206,ENSE00003811446,1,165,1124883,1125047,GCCAGCAAATTGTCAATGACTATACCCATAAAGTAGTCATTAAAGAAGATGGTACTCAATCACTAATTATTGTCCCTGCCACACCCAGTGATTCTGGGGAATGGACTGTGGTTGCCCAAAACAGGGCAGGCAGATCTTCAATTTCAGTGATTTTAACTGTGGAAG
>TTN-206,ENSE00003805710,1,169,1125048,1125216,CTGTGGAACATCAGGTAAAACCGATGTTTGTAGAAAAACTGAAAAATGTCAATATAAAGGAAGGTTCCCGACTTGAAATGAAAGTCAGAGCTACGGGTAACCCCAACCCTGACATTGTATGGTTGAAAAACAGTGACATCATTGTGCCTCATAAATATCCCAAAATCAG
>TTN-206,ENSE00003809358,1,1694,1125217,1126910,AATTGAAGGAACCAAGGGAGAAGCTGCCCTTAAAATCGATTCCACTGTCAGCCAAGATTCTGCCTGGTATACTGCGACTGCTATTAATAAAGCTGGCAGAGACACTACAAGATGCAAAGTAAATGTTGAAGTTGAGTTTGCAGAGCCTGAGCCAGAGAGAAAGTTAATCATCCCACGGGGGACATATAGAGCAAAGGAGATTGCAGCCCCAGAACTGGAGCCCCTCCATTTGCGATATGGCCAAGAGCAATGGGAAGAAGGTGATCTCTATGACAAAGAGAAACAACAGAAACCATTTTTCAAGAAAAAACTCACTTCCTTAAGACTTAAGCGCTTTGGGCCTGCCCACTTTGAATGCAGGCTAACACCCATTGGTGACCCAACGATGGTGGTGGAGTGGCTCCATGATGGAAAGCCACTTGAAGCAGCCAACAGGCTCCGTATGATCAATGAATTTGGGTACTGCAGCCTTGATTATGGCGTTGCATATTCTAGAGACAGTGGTATCATTACTTGCAGAGCCACTAACAAATATGGAACAGATCACACATCTGCTACCCTTATTGTTAAAGATGAGAAAAGTCTTGTGGAAGAATCCCAATTGCCTGAGGGGAGGAAAGGCTTACAGAGAATTGAAGAATTAGAGAGAATGGCTCATGAAGGTGCACTTACAGGTGTAACAACAGATCAGAAAGAAAAGCAAAAGCCAGACATTGTCTTGTACCCAGAGCCAGTTAGAGTACTTGAAGGGGAGACTGCAAGGTTCCGCTGCAGGGTAACAGGCTACCCTCAGCCCAAAGTCAACTGGTACCTCAATGGACAGCTCATCCGCAAAAGCAAAAGGTTCAGAGTTCGCTATGATGGTATCCATTACCTGGACATCGTGGACTGCAAATCATATGACACAGGTGAAGTGAAGGTCACCGCGGAAAATCCTGAAGGTGTGATAGAGCATAAAGTGAAGCTTGAGATTCAACAGAGGGAAGATTTTAGGTCTGTCCTTAGGAGAGCTCCTGAACCAAGGCCTGAGTTTCACGTACATGAACCAGGAAAGCTTCAGTTTGAAGTACAAAAAGTGGATAGACCTGTTGACACCACTGAAACCAAAGAAGTTGTGAAGTTGAAAAGGGCTGAAAGAATTACCCATGAAAAAGTGCCTGAAGAGTCGGAAGAGCTGCGCAGTAAATTCAAGCGCAGAACAGAAGAGGGCTATTATGAAGCCATTACCGCTGTGGAGCTCAAGTCTCGAAAGAAGGATGAATCCTATGAGGAACTCCTCAGGAAGACAAAAGATGAACTTCTCCACTGGACCAAAGAGTTAACTGAAGAGGAAAAGAAAGCTCTTGCCGAAGAAGGCAAAATCACGATTCCAACTTTTAAACCTGACAAGATTGAACTAAGTCCTAGTATGGAGGCTCCAAAAATCTTCGAAAGAATCCAGAGCCAAACAGTGGGCCAAGGATCTGATGCACACTTCCGGGTCAGAGTCGTGGGGAAACCAGACCCCGAATGTGAATGGTACAAAAATGGTGTCAAAATTGAACGGTCTGACCGGATCTACTGGTACTGGCCCGAAGACAATGTTTGTGAATTGGTCATAAGAGATGTGACTGCTGAGGACTCTGCCAGCATCATGGTAAAAGCCATCAACATAGCTGGAGAAACCTCCAGTCACGCATTCTTACTTGTCCAAG
>TTN-206,ENSE00003809440,1,282,1126911,1127192,CCAAGCAATTGATCACTTTCACACAGGAATTACAAGATGTTGTTGCTAAGGAAAAAGACACTATGGCAACCTTTGAATGTGAAACTTCAGAACCATTTGTCAAAGTGAAATGGTATAAAGATGGTATGGAGGTTCATGAGGGAGATAAATACAGGATGCACTCTGACAGAAAGGTTCACTTCCTCTCCATACTGACCATTGATACGTCTGATGCTGAAGATTACAGCTGTGTACTTGTGGAAGATGAAAATGTCAAAACGACTGCTAAACTTATTGTTGAAG
>TTN-206,ENSE00003802960,1,267,1127193,1127459,GTGCAGTTGTTGAGTTTGTGAAAGAACTTCAGGACATAGAAGTTCCAGAATCATATTCAGGAGAATTAGAGTGCATTGTATCCCCAGAAAATATAGAAGGAAAATGGTATCATAATGATGTGGAGCTTAAATCCAATGGCAAATATACAATTACATCTCGTCGTGGACGTCAGAACCTCACGGTCAAGGATGTAACCAAGGAGGACCAGGGAGAATACAGCTTTGTCATCGACGGGAAAAAGACAACCTGTAAATTAAAGATGAAAC
>TTN-206,ENSE00003804241,1,273,1127460,1127732,CCCGCCCCATTGCTATCCTACAAGGACTTAGTGACCAAAAAGTCTGTGAGGGTGACATTGTTCAGCTTGAAGTTAAAGTCTCCTTGGAAAGTGTGGAAGGCGTCTGGATGAAAGACGGCCAAGAAGTGCAGCCCAGTGACAGGGTTCACATTGTGATAGACAAACAATCTCATATGCTGCTCATTGAAGACATGACTAAGGAAGATGCTGGAAATTACTCTTTCACCATTCCAGCCCTTGGCCTCTCCACCAGTGGGCGTGTCTCTGTCTATA
>TTN-206,ENSE00003806988,1,264,1127733,1127996,GTGTGGACGTGATAACACCTCTAAAAGATGTTAATGTGATTGAAGGCACCAAGGCTGTGCTTGAATGTAAGGTGTCAGTCCCTGATGTGACTTCTGTTAAGTGGTACTTAAATGATGAACAAATCAAGCCTGATGACCGTGTACAGGCCATTGTGAAAGGTACTAAACAGCGACTAGTCATTAACCGAACTCATGCTTCAGACGAAGGACCTTACAAGCTGATAGTTGGCAGAGTTGAAACCAACTGTAATCTCTCTGTAGAAA
>TTN-206,ENSE00003804968,1,261,1127997,1128257,AAATTAAAATTATCAGAGGTCTTCGTGACCTTACCTGTACAGAAACTCAAAATGTGGTGTTTGAGGTTGAGCTGTCCCACTCTGGAATTGATGTCCTGTGGAATTTTAAGGACAAGGAAATCAAGCCCAGTTCTAAATATAAAATTGAAGCACATGGAAAAATATATAAATTGACAGTTCTAAATATGATGAAAGATGATGAAGGAAAATACACATTTTACGCGGGAGAAAATATGACATCTGGAAAACTTACTGTGGCAG
>TTN-206,ENSE00003809850,1,261,1128258,1128518,GTGGGGCCATCTCCAAGCCACTCACAGATCAGACCGTAGCTGAATCCCAGGAAGCTGTGTTTGAATGTGAAGTTGCCAACCCAGATTCCAAAGGCGAATGGTTGAGGGATGGCAAACACCTACCACTGACTAACAACATCAGAAGTGAGTCTGATGGCCACAAAAGGAGACTTATCATTGCTGCCACCAAATTAGATGACATTGGAGAATATACCTACAAGGTGGCCACCTCCAAAACATCTGCCAAACTCAAAGTTGAAG
>TTN-206,ENSE00003806479,1,264,1128519,1128782,CTGTCAAAATTAAGAAGACTCTGAAGAACCTCACAGTGACAGAAACACAGGATGCTGTTTTCACTGTCGAGCTTACACACCCTAATGTCAAAGGTGTCCAGTGGATCAAAAATGGAGTTGTGCTGGAATCCAATGAAAAGTATGCTATCTCTGTCAAAGGAACAATTTACTCTCTGAGGATTAAAAACTGTGCCATCGTGGATGAGTCTGTTTATGGCTTCAGGCTTGGAAGGCTTGGAGCCAGTGCCAGACTGCACGTGGAGA
>TTN-206,ENSE00003804523,1,261,1128783,1129043,CTGTCAAGATCATTAAAAAGCCAAAGGATGTGACAGCCTTGGAAAATGCCACTGTTGCCTTTGAAGTTAGTGTTTCCCATGACACTGTTCCAGTAAAATGGTTCCATAAGAGTGTGGAAATTAAGCCAAGTGACAAACACAGACTGGTCTCAGAAAGGAAAGTCCACAAGCTGATGCTGCAGAACATCTCCCCCTCAGATGCTGGGGAATACACAGCTGTGGTCGGGCAATTGGAATGCAAAGCAAAACTGTTTGTGGAGA
>TTN-206,ENSE00003807378,1,261,1129044,1129304,CATTACATATTACAAAAACCATGAAAAATATCGAGGTGCCTGAGACCAAAACTGCCTCTTTTGAGTGTGAGGTGTCCCACTTCAATGTCCCTTCCATGTGGCTGAAGAATGGTGTGGAAATTGAGATGAGTGAAAAGTTCAAGATAGTTGTGCAGGGAAAACTCCATCAGCTGATCATCATGAACACCAGCACAGAGGACTCGGCAGAATACACATTTGTCTGTGGCAATGACCAAGTCAGTGCCACCCTGACAGTCACCC
>TTN-206,ENSE00003807271,1,261,1129305,1129565,CAATCATGATTACTTCCATGCTGAAAGACATCAACGCTGAAGAAAAAGACACTATTACTTTTGAGGTGACAGTGAACTATGAAGGCATCTCTTACAAATGGTTAAAGAATGGTGTGGAAATCAAATCAACTGACAAGTGCCAGATGAGAACCAAAAAGCTCACACACTCACTGAACATCAGGAATGTTCACTTTGGGGATGCTGCTGACTACACCTTTGTGGCTGGAAAAGCAACATCAACAGCCACACTTTATGTGGAAG
>TTN-206,ENSE00003808172,1,142,1129566,1129707,CTCGTCATATAGAATTTAGGAAACACATTAAGGACATTAAGGTACTGGAGAAGAAGCGAGCCATGTTTGAATGTGAAGTTTCTGAACCTGACATCACTGTACAGTGGATGAAAGATGACCAGGAACTGCAGATCACAGACAG
>TTN-206,ENSE00003808223,1,166,1129708,1129873,AATAAAGATTCAGAAGGAGAAATATGTCCACCGCCTTCTGATCCCATCCACCCGGATGTCTGATGCTGGGAAGTACACAGTGGTGGCAGGAGGCAACGTGTCAACTGCAAAACTCTTTGTAGAAGGCAGAGATGTTCGCATCCGAAGTATTAAAAAGGAGGTTCAG
>TTN-206,ENSE00003810851,1,232,1129874,1130105,GTCATTGAGAAACAGCGTGCTGTTGTTGAATTTGAGGTCAATGAAGACGATGTTGATGCCCACTGGTATAAAGATGGCATTGAAATCAATTTCCAAGTTCAAGAACGACACAAATATGTAGTGGAAAGAAGAATCCACCGAATGTTTATCTCTGAGACCAGACAGAGCGATGCAGGAGAATACACCTTTGTGGCAGGAAGGAACAGGAGTTCTGTCACTCTCTATGTCAATG
>TTN-206,ENSE00003802092,1,285,1130106,1130390,CTCCTGAACCGCCCCAAGTTCTGCAGGAGCTCCAGCCTGTCACTGTGCAGTCTGGCAAGCCTGCCCGCTTCTGTGCCGTGATATCCGGAAGACCACAGCCCAAAATTTCCTGGTACAAGGAAGAGCAGCTGCTTTCCACTGGCTTCAAGTGCAAATTTCTTCATGATGGGCAAGAATACACGCTTTTGCTAATTGAAGCCTTCCCAGAGGATGCGGCAGTCTATACCTGTGAAGCCAAGAATGACTATGGTGTTGCCACAACATCAGCTTCACTCTCAGTGGAAG
>TTN-206,ENSE00003807103,1,126,1130391,1130516,TTCCAGAAGTTGTGTCTCCTGATCAGGAAATGCCTGTTTATCCACCTGCCATCATCACCCCGCTTCAGGACACTGTCACTTCTGAAGGGCAGCCAGCCCGTTTTCAATGCCGGGTTTCTGGAACAG
>TTN-206,ENSE00003801355,1,189,1130517,1130705,ATCTAAAAGTGTCGTGGTACAGCAAAGACAAGAAAATCAAGCCATCTCGGTTCTTTAGAATGACTCAATTTGAAGACACTTATCAACTGGAAATTGCCGAAGCTTATCCAGAAGATGAAGGAACTTACACGTTTGTTGCTAGTAATGCTGTAGGCCAAGTATCAAGCACAGCCAACCTGAGTCTGGAAG
>TTN-206,ENSE00004024281,1,375,1130706,1131080,GATTTAGCAAATTTGAAGAAAATACATCAAACTCCCAATGGCATGTCTCTTTATCAGTTTCATTTAAGAAGGAGCCCCTTGGCCAAAAGCCCAGCTTCATCCAGCCTCTGTCAAGCCTCAGGGTGCACAACGGGGAGACAGTCAGATTTCATGCGAGGGTTTCTGGCATTCCCAAGCCAGAAATCCAATGGTTTCATAACCAGCAGCTAATTCTACCAACAAAAGATGTAGTTTTCCATTTTGAGGAGTCCACAGGCATGGCTTTAATGCTTATAGTTGATGCTTACTCAGAGCATGCTGGGCAGTACTCTTGCAAAGCAGCCAATAGTGCTGGGGAAGCCACTTGTGCAGCTACACTCACAGTGACTCCAAAAG
>TTN-206,ENSE00004024285,1,576,1131081,1131656,TGCAAGCCCTAGATAGGCAAAGTTCTGGGAAAGATGTAAGAGAGTCCACCAAGTCCCAGGCAGTGGCAGATTCCTCTTTCACAAAGGAGGAGAGCAAAATATCTCAAAAGGAAATTAAGTCATTTCAAGGATCATCATATGAATATGAAGTGCAGGTTTTTGAAAGTGTATCTCAAAGTTCCATCCACACAGCTGCATCTGTTCAAGATACACAGTTGTGCCATACTGCATCCCTTTCACAAATTGCAGAAAGCACTGAGCTATCTAAGGAATGTGCTAAAGAGTCCACGGGTGAGGCGCCCAAGATTTTCCTGCATCTTCAGGACGTCACTGTAAAGTGCGGTGACACGGCTCAATTCCTCTGTGTTTTAAAAGATGATTCTTTCATTGATGTAACCTGGACTCACGAAGGTGCAAAGATAGAGGAATCCGAGAGACTGAAACAATCACAAAATGGAAATATTCAGTTTCTTACCATATGTAATGTTCAGCTGGTAGACCAAGGACTATACAGCTGCATTGTACACAATGACTGTGGAGAGAGGACAACGTCAGCAGTACTAAGTGTAGAAGGTG
>TTN-206,ENSE00003810791,1,57,1131657,1131713,CTCCTGAATCAATTTTGCATGAGAGGATTGAACAAGAGATTGAGATGGAAATGAAAG
>TTN-206,ENSE00004024265,1,2781,1131714,1134494,AGTTTTCTAGTTCTTTTCTGTCTGCCGAGGAAGAAGGACTTCATAGCGCCGAACTTCAATTATCTAAAATAAATGAAACACTTGAACTTTTGTCTGAATCTCCAGTTTACCCAACTAAATTTGATTCCGAAAAGGAAGGCACTGGCCCAATTTTCATCAAAGAAGTGTCAAATGCTGATATAAGCATGGGGGATGTGGCTACACTGTCTGTAACTGTCATTGGCATCCCCAAACCTAAAATTCAGTGGTTCTTTAATGGAGTGCTATTAACCCCTTCTGCTGACTACAAATTTGTTTTTGACGGTGATGATCATAGCCTGATCATTCTGTTCACCAAATTGGAGGATGAGGGAGAGTATACATGTATGGCCAGTAATGACTATGGAAAGACAATATGTAGTGCCTATCTAAAAATTAATTCCAAAGGAGAGGGTCACAAAGACACTGAAACAGAATCAGCAGTGGCAAAATCTCTGGAAAAGCTGGGAGGTCCTTGTCCTCCTCACTTCCTTAAGGAGTTAAAACCAATTCGCTGTGCTCAAGGGCTTCCTGCCATCTTTGAGTACACAGTGGTTGGAGAGCCTGCCCCTACTGTTACATGGTTCAAAGAAAACAAGCAGCTTTGCACCAGTGTTTATTACACTATCATTCATAACCCTAATGGCTCTGGAACTTTCATTGTCAATGACCCTCAGAGGGAAGACAGTGGCCTCTATATCTGTAAAGCAGAGAATATGTTGGGTGAGTCCACCTGTGCAGCAGAGCTGCTTGTGCTTCTGGAAGACACAGACATGACTGATACCCCCTGCAAAGCAAAGTCCACACCAGAGGCTCCTGAGGATTTTCCACAGACACCCTTAAAGGGTCCCGCAGTTGAAGCACTTGACTCAGAGCAGGAAATTGCAACGTTTGTAAAAGACACCATTTTGAAAGCTGCTTTAATTACAGAAGAAAACCAGCAACTATCTTATGAGCATATTGCTAAAGCCAATGAATTGAGCAGTCAGCTTCCTTTGGGAGCTCAGGAATTGCAATCCATTTTGGAGCAAGACAAGCTCACTCCTGAAAGCACCAGGGAATTTCTTTGCATCAATGGCAGTATTCACTTTCAGCCTCTCAAGGAACCATCTCCCAACCTACAGCTGCAGATTGTACAGTCCCAGAAAACCTTCTCCAAAGAAGGTATTCTAATGCCTGAAGAGCCTGAGACACAGGCAGTTCTATCAGATACCGAGAAAATCTTCCCAAGTGCCATGTCCATAGAACAAATTAATTCATTAACAGTTGAGCCTCTGAAAACTTTATTAGCTGAACCTGAAGGGAATTATCCACAGTCTTCAATAGAACCTCCAATGCATTCTTATCTAACCTCTGTGGCTGAGGAAGTACTTTCACCAAAAGAAAAGACAGTATCTGACACCAACAGAGAGCAAAGAGTGACTCTTCAAAAGCAAGAGGCACAAAGTGCGCTCATCTTGAGTCAGAGCTTAGCTGAGGGACACGTGGAGAGTCTCCAGAGTCCTGATGTCATGATCTCTCAGGTAAACTATGAGCCCCTAGTCCCTTCAGAACACTCATGCACAGAAGGAGGTAAAATTTTGATAGAAAGTGCAAATCCACTGGAAAATGCAGGGCAAGATTCTGCGGTCAGAATTGAGGAAGGCAAGTCCTTAAGATTTCCACTAGCACTTGAAGAAAAGCAGGTACTGCTCAAAGAAGAGCATTCTGACAACGTGGTGATGCCCCCAGACCAAATCATTGAGTCTAAAAGAGAGCCCGTGGCAATAAAGAAAGTGCAGGAGGTACAGGGAAGGGACCTTCTTTCTAAGGAAAGCTTGCTTTCTGGTATTCCAGAAGAGCAGAGATTAAACCTGAAAATTCAAATCTGCCGGGCTTTGCAAGCAGCCGTGGCCAGCGAGCAGCCAGGTCTTTTCTCTGAGTGGCTAAGAAATATTGAAAAGGTGGAGGTCGAGGCTGTAAACATCACCCAAGAGCCCAGACACATCATGTGCATGTACCTTGTTACTTCGGCAAAGTCTGTAACAGAAGAAGTAACCATCATTATTGAAGATGTTGATCCTCAAATGGCTAACCTGAAAATGGAACTTAGGGATGCTTTGTGTGCTATTATATATGAGGAAATAGACATCCTAACAGCTGAGGGTCCTAGAATTCAGCAAGGAGCCAAAACAAGTTTGCAAGAAGAAATGGATTCTTTTTCAGGTTCACAGAAGGTTGAACCCATTACTGAACCAGAAGTTGAATCTAAATATCTGATCTCAACTGAAGAGGTCAGTTATTTTAACGTGCAAAGTAGGGTTAAATATTTGGATGCCACACCTGTCACTAAAGGGGTTGCTTCAGCTGTTGTCTCTGACGAAAAACAAGATGAGAGTCTGAAACCATCAGAGGAAAAAGAGGAGTCTTCCTCTGAAAGTGGTACTGAGGAGGTTGCTACAGTAAAGATACAGGAAGCTGAGGGTGGCTTAATCAAAGAGGATGGCCCCATGATACATACACCTTTAGTGGACACTGTTTCTGAGGAAGGTGATATTGTACACCTCACAACATCCATAACAAATGCTAAAGAGGTGAATTGGTATTTTGAGAATAAACTGGTGCCTTCAGATGAAAAGTTCAAGTGTTTACAAGATCAAAATACATATACGCTAGTCATCGACAAAGTAAATACCGAAGACCATCAAGGAGAGTATGTCTGTGAGGCCTTGAATGACAGCGGAAAAACAGCAACTTCAGCCAAACTCACTGTAGTAAAAAGAG
>TTN-206,ENSE00003805227,1,279,1134495,1134773,CTGCCCCAGTGATCAAGAGGAAAATCGAACCCCTGGAAGTAGCACTGGGCCACCTAGCCAAATTCACCTGTGAGATCCAAAGTGCTCCCAATGTCCGGTTCCAGTGGTTTAAAGCTGGCCGAGAAATTTATGAGAGTGACAAGTGTTCTATTCGATCTTCAAAGTATATCTCCAGCCTTGAAATCCTGAGAACCCAGGTGGTTGACTGCGGCGAGTATACATGCAAAGCTTCCAATGAGTATGGCAGTGTCAGCTGTACAGCCACACTAACTGTGACAG
>TTN-206,ENSE00003808619,1,564,1134774,1135337,AGGCATATCCACCAACCTTTCTCTCCAGACCTAAGTCCCTTACAACTTTTGTGGGTAAGGCAGCCAAGTTCATCTGCACAGTGACAGGGACTCCTGTGATAGAAACCATTTGGCAGAAAGATGGTGCTGCACTCTCACCTTCACCTAACTGGAGGATTTCCGACGCAGAAAACAAACACATTTTAGAACTCTCAAACCTTACCATTCAAGATAGAGGAGTTTATTCTTGTAAGGCTTCCAACAAGTTTGGAGCAGACATCTGCCAAGCAGAGTTGATCATCATTGATAAGCCACATTTCATTAAAGAATTAGAGCCTGTGCAGTCCGCTATCAATAAGAAGGTCCACCTTGAGTGCCAAGTAGATGAAGACAGAAAAGTCACAGTTACGTGGAGCAAAGATGGGCAAAAACTCCCCCCAGGGAAAGATTATAAGATCTGTTTTGAAGATAAAATAGCAACACTTGAGATTCCTTTGGCCAAACTGAAAGATTCAGGAACCTATGTCTGTACAGCTTCAAATGAGGCTGGAAGCAGCTCCTGCTCAGCCACAGTCACTGTCAGAG
>TTN-206,ENSE00003811334,1,282,1135338,1135619,AGCCACCATCCTTCGTGAAGAAGGTGGATCCCTCTTATTTAATGCTCCCAGGTGAATCAGCACGCCTCCATTGCAAGCTGAAAGGCTCACCTGTGATCCAGGTTACTTGGTTTAAAAATAACAAAGAACTCAGTGAAAGTAACACAGTCCGAATGTATTTTGTCAATTCTGAGGCTATACTTGATATTACGGATGTAAAAGTTGAAGACAGTGGGAGTTACTCATGTGAAGCAGTGAATGACGTCGGCAGTGATAGCTGCAGTACTGAAATAGTTATCAAAG
>TTN-206,ENSE00003807496,1,279,1135620,1135898,AACCTCCTTCTTTCATCAAAACTCTTGAGCCTGCAGACATAGTGAGAGGAACAAATGCTCTACTTCAGTGTGAAGTCTCAGGCACTGGACCATTTGAAATTAGCTGGTTCAAAGACAAGAAACAAATTCGAAGTAGTAAAAAATACAGATTGTTTTCTCAGAAGTCTCTTGTGTGTCTGGAGATCTTTTCGTTTAATAGTGCAGATGTTGGTGAATATGAATGTGTTGTTGCTAATGAAGTCGGCAAGTGTGGCTGCATGGCAACCCACTTACTCAAAG
>TTN-206,ENSE00003806831,1,279,1135899,1136177,AACCTCCAACCTTTGTAAAGAAAGTAGATGATTTGATTGCACTAGGAGGACAAACCGTTACCCTGCAAGCTGCTGTGAGAGGGTCAGAGCCCATTTCTGTCACATGGATGAAAGGTCAAGAGGTCATCAGAGAAGACGGAAAAATCAAAATGAGCTTTTCCAATGGTGTTGCAGTCTTGATAATCCCTGATGTTCAGATTAGTTTTGGAGGCAAATACACGTGCCTGGCTGAAAATGAAGCTGGAAGCCAAACATCTGTTGGGGAATTAATAGTTAAAG
>TTN-206,ENSE00003801788,1,279,1136178,1136456,AACCTGCCAAAATCATTGAGCGAGCAGAACTGATCCAGGTGACAGCAGGAGATCCCGCCACACTGGAGTACACAGTGGCAGGCACGCCAGAACTGAAGCCCAAATGGTACAAAGATGGGAGACCCTTGGTCGCCAGTAAAAAATACCGAATAAGTTTTAAAAACAATGTTGCCCAGCTCAAATTTTATTCAGCTGAGCTGCACGACAGTGGCCAATACACATTTGAGATTTCCAATGAAGTGGGCAGCAGCTCCTGTGAGACTACATTCACTGTATTAG
>TTN-206,ENSE00003804186,1,288,1136457,1136744,ATCGAGACATTGCTCCATTTTTTACCAAACCCTTGCGCAACGTGGATAGTGTTGTTAATGGTACCTGCAGACTGGACTGCAAAATTGCAGGCTCCCTCCCCATGAGGGTGTCCTGGTTTAAGGATGGCAAAGAAATAGCTGCTTCTGACAGATACAGGATAGCATTTGTGGAAGGCACAGCCTCTTTGGAGATCATCAGAGTAGACATGAATGATGCAGGGAATTTCACTTGTCGAGCCACAAATTCCGTGGGAAGCAAAGACAGCAGTGGAGCCCTGATTGTGCAAG
>TTN-206,ENSE00003805178,1,279,1136745,1137023,AACCACCCAGTTTTGTAACTAAACCCGGCTCAAAGGATGTTCTGCCTGGCTCAGCAGTCTGCCTGAAGAGCACTTTCCAAGGATCTACTCCTCTCACAATCAGATGGTTTAAGGGCAACAAAGAGCTGGTTTCTGGTGGAAGCTGCTATATTACCAAAGAAGCTTTAGAGAGTTCCCTGGAACTCTATTTAGTAAAAACCTCTGATTCGGGCACGTACACATGTAAAGTCAGCAATGTCGCTGGAGGGGTGGAATGCAGTGCAAACTTGTTTGTAAAAG
>TTN-206,ENSE00003806856,1,282,1137024,1137305,AACCTGCCACATTTGTTGAAAAGTTAGAGCCATCACAGCTGTTAAAGAAGGGAGATGCCACCCAGCTAGCCTGCAAAGTAACTGGTACCCCTCCAATTAAAATAACATGGTTTGCAAATGATAGAGAAATTAAGGAGAGCAGCAAACACAGAATGTCTTTTGTGGAGTCTACTGCAGTTCTAAGACTGACAGATGTTGGCATCGAAGACAGTGGTGAATATATGTGTGAGGCCCAAAATGAGGCTGGCAGTGACCACTGCAGTAGCATTGTAATAGTCAAAG
>TTN-206,ENSE00003804074,1,279,1137306,1137584,AGTCACCTTATTTTACCAAGGAATTTAAGCCAATTGAAGTCTTAAAGGAGTACGATGTCATGTTGCTGGCTGAGGTGGCAGGCACTCCTCCCTTTGAGATCACTTGGTTCAAAGATAACACAATCCTGCGAAGTGGTAGAAAGTATAAGACTTTCATTCAGGATCATCTGGTTAGCCTGCAGATCCTCAAGTTTGTAGCTGCAGATGCTGGCGAATACCAGTGTCGGGTGACCAATGAGGTGGGCAGCAGCATCTGCAGTGCCAGGGTGACTTTAAGAG
>TTN-206,ENSE00003807057,1,279,1137585,1137863,AACCCCCATCCTTCATAAAGAAGATCGAGAGTACCAGCTCCCTCCGGGGAGGCACAGCTGCCTTCCAGGCCACTCTGAAGGGCTCCTTGCCAATTACGGTGACTTGGCTAAAAGACAGCGATGAAATCACTGAAGACGATAATATAAGAATGACCTTTGAGAACAATGTGGCCAGTTTGTACCTCAGTGGCATTGAAGTCAAGCATGATGGGAAATATGTCTGTCAGGCCAAAAATGATGCAGGAATACAAAGATGTTCTGCATTACTCTCAGTAAAAG
>TTN-206,ENSE00003807032,1,279,1137864,1138142,AACCTGCAACAATCACCGAGGAAGCTGTGTCTATAGATGTCACCCAAGGAGACCCAGCCACTTTGCAGGTTAAATTTTCAGGGACTAAGGAGATTACAGCCAAATGGTTTAAAGATGGCCAAGAACTGACCCTGGGCTCAAAATATAAAATCAGTGTCACTGATACAGTCTCAATACTGAAGATTATTTCTACAGAAAAGAAAGATAGTGGAGAATATACTTTCGAGGTCCAAAATGATGTTGGGAGGAGCAGCTGCAAGGCTAGAATTAATGTATTAG
>TTN-206,ENSE00003810010,1,288,1138143,1138430,ATCTTATCATACCTCCTTCATTCACCAAAAAGCTGAAGAAAATGGACAGCATTAAAGGTTCTTTCATTGATTTAGAATGTATAGTGGCTGGGTCACATCCCATAAGCATCCAGTGGTTCAAAGATGACCAAGAAATATCAGCTAGTGAAAAGTACAAATTCTCTTTTCATGACAATACTGCCTTCTTGGAAATCAGCCAGCTGGAAGGTACAGACAGTGGGACATACACTTGTTCTGCCACAAATAAGGCAGGGCACAACCAATGCAGTGGGCATCTGACAGTCAAAG
>TTN-206,ENSE00003805733,1,279,1138431,1138709,AACCCCCTTACTTTGTGGAAAAGCCACAGTCACAAGATGTCAATCCCAACACAAGGGTACAGTTAAAGGCTCTTGTGGGTGGCACTGCACCCATGACAATAAAGTGGTTTAAAGATAACAAAGAGTTACACTCAGGAGCAGCCCGCTCAGTTTGGAAGGATGACACCTCTACCAGTCTAGAGCTCTTTGCAGCCAAAGCTACCGATTCTGGAACCTACATTTGCCAACTAAGCAATGATGTTGGCACAGCAACCAGCAAAGCCACTCTCTTTGTAAAAG
>TTN-206,ENSE00003805836,1,282,1138710,1138991,AACCTCCTCAATTCATTAAGAAGCCCAGTCCAGTCTTAGTGCTGAGGAATGGACAGTCAACAACATTTGAATGCCAAATAACAGGCACTCCTAAAATCCGAGTGTCTTGGTATCTAGACGGGAATGAAATAACAGCCATTCAGAAACATGGCATTTCCTTCATTGATGGTTTAGCCACTTTCCAGATTTCTGGTGCCAGGGTAGAAAATAGTGGGACTTATGTGTGTGAAGCTCGAAATGACGCAGGCACGGCGAGCTGCAGCATTGAACTCAAAGTGAAAG
>TTN-206,ENSE00003802637,1,279,1138992,1139270,AACCCCCCACCTTTATCAGAGAGCTGAAGCCTGTGGAGGTAGTAAAATATAGTGACGTGGAGCTGGAGTGTGAAGTTACGGGAACACCTCCGTTTGAAGTCACTTGGCTGAAGAATAACAGGGAAATTCGAAGCAGCAAAAAATACACATTGACCGACAGAGTGTCTGTGTTTAACCTCCATATAACCAAGTGTGACCCTTCAGACACTGGGGAATACCAGTGCATTGTATCCAATGAAGGCGGCAGCTGCTCATGCAGTACTAGAGTTGCCCTGAAAG
>TTN-206,ENSE00003809504,1,279,1139271,1139549,AACCACCATCATTCATTAAGAAGATAGAAAATACCACTACTGTTTTGAAAAGTTCTGCCACCTTTCAGAGTACCGTGGCAGGTTCTCCTCCTATTTCTATAACCTGGCTAAAGGATGATCAGATTCTTGATGAAGATGATAATGTCTATATTTCATTTGTGGACAGTGTGGCCACACTTCAAATCAGAAGTGTGGATAATGGACACAGTGGGAGATATACCTGTCAAGCCAAGAATGAGTCAGGAGTTGAGAGGTGTTATGCTTTCCTTTTAGTACAAG
>TTN-206,ENSE00003802968,1,279,1139550,1139828,AACCAGCTCAAATCGTAGAGAAAGCTAAATCAGTTGATGTTACGGAGAAAGATCCCATGACCTTGGAATGTGTTGTGGCTGGAACACCAGAACTCAAAGTGAAATGGCTTAAAGACGGGAAACAAATAGTTCCCAGTAGATACTTTTCAATGAGTTTTGAAAATAACGTGGCCAGTTTTAGAATTCAGTCAGTAATGAAGCAGGACAGCGGTCAGTACACTTTCAAGGTGGAAAATGACTTCGGAAGCAGTAGCTGTGATGCCTACTTAAGAGTGCTAG
>TTN-206,ENSE00003810612,1,288,1139829,1140116,ATCAAAATATTCCTCCATCATTCACCAAAAAATTAACCAAAATGGATAAAGTTCTGGGCTCTTCTATTCATATGGAGTGCAAGGTGTCTGGTTCACTTCCCATTAGTGCTCAGTGGTTTAAGGATGGAAAAGAAATATCTACAAGTGCAAAATACAGACTTGTGTGCCATGAGAGATCTGTGTCTCTGGAAGTTAATAATCTGGAATTAGAAGATACTGCAAATTACACATGCAAAGTGTCAAATGTAGCAGGAGATGATGCATGCAGTGGCATCTTAACTGTGAAAG
>TTN-206,ENSE00003806423,1,279,1140117,1140395,AACCACCAAGCTTCCTAGTGAAACCTGGGCGACAGCAAGCCATACCTGATTCTACAGTGGAATTTAAGGCAATACTAAAAGGAACACCACCATTTAAAATAAAATGGTTTAAGGATGATGTGGAACTTGTCTCAGGTCCTAAATGTTTCATTGGCTTGGAAGGGTCGACTAGCTTCTTAAATCTCTACTCAGTGGATGCTTCTAAGACTGGACAGTATACTTGCCATGTTACCAATGATGTTGGTAGCGACTCTTGTACTACGATGTTGCTTGTGACAG
>TTN-206,ENSE00003805536,1,282,1140396,1140677,AACCACCAAAGTTTGTAAAGAAATTAGAAGCCTCCAAAATTGTGAAAGCAGGTGACTCTTCACGACTTGAATGCAAGATAGCTGGATCCCCAGAAATCAGAGTTGTGTGGTTCCGAAATGAACATGAACTTCCAGCCAGTGATAAGTACAGAATGACTTTCATTGACTCAGTGGCCGTCATACAGATGAACAATCTCAGTACTGAGGACAGTGGAGATTTCATTTGTGAGGCTCAGAATCCCGCTGGCAGCACAAGCTGCAGTACCAAGGTTATAGTAAAAG
>TTN-206,ENSE00003807762,1,279,1140678,1140956,AGCCACCTGTTTTTAGCAGCTTCCCTCCTATAGTAGAAACCCTTAAAAATGCTGAAGTCAGTCTTGAATGTGAACTTTCGGGAACACCACCGTTTGAGGTGGTATGGTACAAAGACAAGCGGCAACTCAGAAGCAGCAAGAAATACAAGATTGCATCCAAAAACTTCCACACAAGTATTCACATTCTCAATGTGGACACTTCAGACATCGGTGAATACCACTGCAAAGCACAGAATGAAGTGGGAAGTGATACTTGTGTTTGTACTGTAAAATTGAAAG
>TTN-206,ENSE00003809887,1,282,1140957,1141238,AACCACCAAGATTTGTCTCCAAACTGAACAGCCTCACTGTTGTAGCCGGAGAGCCTGCTGAATTACAAGCATCCATAGAAGGCGCCCAGCCTATTTTTGTCCAGTGGCTTAAAGAGAAGGAAGAAGTGATTAGAGAAAGTGAAAACATCAGGATTACATTTGTGGAAAATGTTGCAACTCTACAGTTTGCAAAAGCAGAGCCAGCTAATGCTGGAAAGTATATCTGCCAAATCAAGAATGATGGTGGAATGAGGGAGAACATGGCCACACTGATGGTCTTAG
>TTN-206,ENSE00003811356,1,279,1141239,1141517,AGCCCGCAGTCATTGTTGAGAAGGCAGGACCGATGACGGTGACTGTAGGAGAAACGTGCACTCTGGAGTGTAAGGTGGCTGGCACTCCGGAACTCTCTGTTGAATGGTACAAGGATGGAAAGCTGTTGACCAGCAGCCAAAAACACAAATTTAGCTTCTACAACAAAATCTCTTCCTTAAGGATTCTCTCAGTTGAAAGGCAAGATGCAGGCACATACACTTTCCAGGTTCAAAATAATGTTGGGAAAAGCAGCTGCACAGCTGTGGTTGATGTTTCAG
>TTN-206,ENSE00003804298,1,288,1141518,1141805,ACCGAGCAGTTCCTCCCTCTTTCACACGAAGACTGAAAAATACTGGTGGGGTGTTAGGTGCTTCTTGCATCTTGGAATGCAAAGTAGCTGGATCATCACCTATTTCAGTTGCCTGGTTTCATGAGAAAACCAAGATTGTCAGTGGAGCAAAGTACCAAACCACATTTTCAGATAATGTCTGCACATTGCAGTTGAATTCTCTGGATTCCTCAGATATGGGCAATTACACATGCGTGGCTGCTAATGTCGCTGGGTCTGATGAATGTCGTGCAGTGCTAACTGTACAAG
>TTN-206,ENSE00003807700,1,279,1141806,1142084,AACCACCCTCTTTTGTGAAAGAACCTGAACCTTTGGAAGTACTACCAGGCAAAAATGTAACCTTCACAAGCGTTATTAGAGGAACCCCTCCATTCAAAGTCAACTGGTTCAGAGGTGCCAGAGAACTAGTGAAAGGAGACCGGTGCAACATCTATTTTGAAGACACTGTGGCAGAACTGGAATTATTTAATATTGACATATCTCAGAGTGGGGAATACACCTGTGTGGTTTCTAACAACGCTGGCCAAGCATCTTGCACTACCCGTCTCTTTGTGAAAG
>TTN-206,ENSE00003803086,1,279,1142085,1142363,AACCAGCTGCATTTTTGAAGAGATTAAGTGATCATTCTGTAGAACCAGGGAAGTCCATAATTCTGGAGAGCACCTACACTGGAACACTTCCAATTTCTGTCACTTGGAAAAAGGATGGTTTTAACATAACTACCTCTGAAAAATGTAACATAGTCACAACAGAGAAAACTTGTATCCTGGAAATTCTGAATAGCACAAAAAGAGATGCAGGGCAGTATTCCTGCGAGATTGAAAATGAGGCAGGAAGGGATGTTTGTGGAGCTCTGGTATCTACATTAG
>TTN-206,ENSE00003806655,1,279,1142364,1142642,AACCGCCTTATTTTGTTACGGAACTGGAACCTCTGGAGGCAGCAGTTGGAGATTCGGTTTCTTTACAATGCCAAGTTGCTGGGACACCAGAAATTACAGTGTCTTGGTACAAAGGAGATACCAAATTACGGCCAACTCCTGAATACAGGACCTACTTTACAAACAATGTGGCCACACTTGTTTTTAATAAAGTGAACATCAATGACAGTGGAGAGTACACATGCAAAGCAGAAAATAGTATAGGAACTGCTTCTTCTAAGACTGTGTTCAGAATTCAAG
>TTN-206,ENSE00003805355,1,288,1142643,1142930,AGCGCCAACTCCCACCTTCTTTTGCAAGACAATTAAAGGACATTGAACAAACTGTGGGGTTACCTGTTACACTCACTTGTCGATTAAATGGCTCTGCACCCATCCAAGTGTGCTGGTATAGAGATGGAGTACTTTTAAGAGACGATGAAAATCTACAGACTTCATTTGTAGATAATGTGGCAACTTTAAAAATTTTGCAAACTGACTTGAGTCACTCTGGCCAGTACTCTTGCTCAGCTTCCAACCCACTTGGAACAGCATCTTCTAGTGCTAGACTCACAGCAAGAG
>TTN-206,ENSE00003804884,1,288,1142931,1143218,AACCCAAGAAATCTCCCTTCTTTGACATCAAGCCTGTATCTATAGATGTTATTGCTGGAGAAAGTGCTGATTTTGAGTGTCATGTTACTGGTGCTCAACCGATGCGAATCACTTGGTCAAAAGATAACAAGGAGATCCGTCCTGGAGGAAACTATACAATCACATGTGTGGGAAACACTCCTCATTTGAGAATTCTTAAAGTAGGCAAAGGAGACTCTGGTCAATATACTTGCCAAGCAACCAATGATGTTGGCAAAGACATGTGCTCAGCTCAGCTCAGTGTAAAAG
>TTN-206,ENSE00003805805,1,282,1143219,1143500,AACCTCCAAAGTTTGTTAAGAAATTAGAAGCTTCAAAAGTTGCAAAGCAGGGAGAATCCATTCAACTGGAATGTAAAATAAGTGGCTCCCCAGAAATCAAAGTTTCATGGTTCCGAAATGACAGCGAACTTCATGAAAGTTGGAAATACAACATGTCATTCATTAATTCTGTGGCATTGCTTACGATCAATGAAGCTAGTGCTGAAGACAGCGGGGACTACATTTGTGAGGCTCATAATGGTGTTGGTGACGCCAGCTGCAGCACAGCGTTGACAGTGAAAG
>TTN-206,ENSE00003803146,1,279,1143501,1143779,CACCTCCTGTTTTCACCCAGAAGCCTTCTCCAGTAGGAGCTCTTAAAGGTTCTGATGTGATTCTCCAATGTGAAATTTCGGGAACTCCCCCATTTGAAGTAGTATGGGTTAAAGATCGAAAGCAGGTTAGAAACAGCAAGAAATTTAAAATCACTTCAAAACATTTTGATACAAGTCTTCATATCCTTAATCTTGAAGCCTCCGATGTCGGGGAATATCACTGCAAAGCTACTAATGAGGTGGGAAGTGACACGTGTTCTTGCTCTGTCAAGTTCAAAG
>TTN-206,ENSE00003806016,1,282,1143780,1144061,AACCTCCACGATTCGTGAAAAAGCTAAGTGACACCTCAACCCTTATTGGGGATGCTGTTGAGTTACGGGCCATAGTGGAGGGCTTCCAGCCAATTTCTGTTGTCTGGCTGAAAGATAGAGGTGAAGTCATCAGAGAGAGTGAAAATACCAGGATTTCATTCATTGATAACATTGCAACCCTCCAGCTGGGGAGTCCAGAAGCATCTAATTCTGGAAAATATATATGCCAAATCAAAAACGATGCTGGAATGAGAGAATGCTCTGCAGTCTTGACTGTACTAG
>TTN-206,ENSE00003808302,1,279,1144062,1144340,AACCAGCAAGAATCATAGAGAAGCCCGAACCCATGACTGTCACTACTGGAAATCCTTTTGCATTAGAGTGTGTAGTGACTGGAACACCAGAACTCTCAGCCAAGTGGTTCAAAGATGGAAGAGAATTGTCTGCAGACAGCAAACATCACATTACATTCATCAATAAAGTGGCTTCCCTTAAAATCCCCTGTGCCGAAATGAGTGACAAAGGATTATATAGCTTTGAAGTGAAAAACAGTGTTGGCAAAAGTAACTGCACTGTATCCGTCCATGTTTCTG
>TTN-206,ENSE00003802442,1,288,1144341,1144628,ATCGGATTGTGCCTCCTTCCTTCATCCGCAAGCTGAAAGACGTGAATGCCATCCTGGGGGCCTCAGTTGTTTTGGAGTGCCGAGTCTCTGGCTCAGCCCCGATTTCAGTTGGCTGGTTTCAGGATGGAAATGAGATTGTTAGTGGGCCCAAATGTCAGTCCAGCTTTTCGGAAAACGTCTGTACTTTGAATCTGAGCTTGTTGGAGCCCTCCGACACAGGCATATACACGTGTGTGGCTGCCAATGTAGCTGGTTCCGATGAGTGCTCAGCAGTCCTGACTGTGCAAG
>TTN-206,ENSE00003809965,1,279,1144629,1144907,AACCACCATCTTTTGAACAAACCCCTGATTCTGTGGAAGTTTTGCCTGGAATGAGCCTCACATTCACCAGTGTCATCAGAGGCACCCCTCCTTTCAAGGTCAAGTGGTTTAAAGGCAGCAGGGAACTGGTGCCTGGGGAGTCATGCAACATCTCTCTGGAAGATTTTGTCACAGAACTGGAGTTGTTTGAGGTGCAGCCATTAGAAAGTGGAGACTATTCTTGCCTCGTTACAAATGATGCTGGCAGTGCTTCCTGTACCACACATCTTTTTGTGAAAG
>TTN-206,ENSE00003809650,1,279,1144908,1145186,AACCAGCCACCTTTGTGAAAAGATTGGCTGATTTCAGTGTTGAGACAGGAAGCCCCATAGTTCTCGAGGCCACATACACTGGCACACCTCCAATCTCAGTGAGCTGGATAAAGGACGAGTATCTTATTTCACAATCTGAGAGATGCAGTATTACTATGACAGAAAAATCTACCATACTGGAAATTCTTGAGAGCACAATAGAGGATTATGCACAGTACAGCTGCCTGATAGAAAATGAGGCTGGTCAAGATATCTGTGAAGCTCTGGTGTCTGTCTTAG
>TTN-206,ENSE00003810498,1,279,1145187,1145465,AACCACCGTACTTTATTGAACCTCTGGAACATGTGGAAGCAGTCATTGGAGAACCTGCAACTTTACAGTGTAAAGTGGATGGAACTCCAGAAATTAGAATTTCTTGGTATAAAGAACACACAAAGCTACGATCAGCTCCTGCATATAAAATGCAATTCAAAAATAACGTTGCTTCCTTAGTAATCAACAAAGTGGATCACAGTGATGTGGGAGAGTATTCATGCAAGGCAGACAACAGTGTGGGGGCAGTCGCTTCTTCAGCTGTGCTTGTTATCAAAG
>TTN-206,ENSE00003807178,1,288,1145466,1145753,CGCGCAAACTTCCACCTTTCTTTGCAAGAAAACTGAAAGACGTTCATGAGACTCTAGGCTTCCCAGTTGCATTTGAATGCCGCATCAATGGCTCAGAACCTCTTCAAGTGTCTTGGTACAAGGATGGGGTTCTTTTGAAAGATGATGCTAATTTGCAGACATCTTTTGTTCATAATGTAGCAACTCTTCAGATTTTACAAACTGACCAGAGCCACATAGGGCAGTATAATTGCTCTGCTTCTAATCCTCTTGGGACTGCTTCATCCAGTGCCAAGCTCATTCTCTCAG
>TTN-206,ENSE00003808579,1,288,1145754,1146041,AGCATGAAGTGCCTCCTTTCTTTGATCTAAAGCCTGTATCAGTAGATCTTGCTCTTGGAGAAAGTGGTACTTTTAAATGTCATGTAACTGGGACTGCACCAATCAAAATCACTTGGGCCAAAGATAACCGAGAGATTCGCCCTGGAGGCAACTACAAGATGACTTTGGTAGAAAATACTGCCACTCTGACAGTTCTCAAAGTAGGCAAAGGCGATGCCGGGCAGTACACCTGCTATGCAAGCAACATCGCTGGAAAAGACTCTTGTTCTGCTCAGCTGGGTGTACAAG
>TTN-206,ENSE00003801249,1,282,1146042,1146323,AACCACCCAGGTTCATTAAGAAGCTAGAACCTTCAAGAATTGTGAAACAGGATGAATTCACAAGGTATGAATGCAAAATCGGTGGGTCTCCAGAAATCAAAGTTTTATGGTATAAGGACGAGACTGAAATTCAAGAGAGCAGTAAATTCAGAATGTCATTCGTTGACTCGGTGGCTGTGCTGGAAATGCACAATCTCAGTGTTGAAGACAGTGGAGACTACACCTGTGAGGCCCACAATGCAGCAGGCAGTGCCAGCAGCAGCACATCCTTAAAAGTTAAAG
>TTN-206,ENSE00003810208,1,279,1146324,1146602,AACCACCCATTTTCCGCAAAAAGCCTCATCCTATAGAGACACTGAAAGGAGCTGATGTTCACCTTGAATGTGAGCTTCAGGGCACTCCCCCATTTCACGTTTCTTGGTATAAAGACAAGAGAGAACTTAGGAGCGGCAAGAAGTACAAGATAATGTCTGAGAACTTCCTAACCAGTATCCACATCCTGAATGTCGATGCTGCAGACATTGGGGAATATCAGTGTAAAGCCACAAATGATGTGGGAAGCGACACTTGCGTTGGTTCCATCGCTCTCAAAG
>TTN-206,ENSE00003802440,1,282,1146603,1146884,CACCACCAAGATTTGTGAAGAAGCTCAGTGACATATCTACTGTCGTTGGTAAAGAAGTTCAGCTGCAGACTACCATTGAAGGCGCTGAACCCATTTCAGTGGTGTGGTTCAAAGATAAGGGAGAAATCGTTAGAGAAAGTGACAACATATGGATTTCTTATTCAGAAAACATTGCAACCTTACAGTTTTCAAGAGTGGAACCAGCCAATGCTGGAAAATACACTTGTCAGATCAAAAACGATGCTGGGATGCAAGAGTGCTTCGCCACGCTATCCGTTCTCG
>TTN-206,ENSE00003802351,1,279,1146885,1147163,AGCCTGCAACAATTGTAGAAAAGCCAGAATCCATAAAAGTTACCACGGGAGACACCTGTACCTTGGAGTGTACAGTAGCTGGCACCCCTGAACTCAGTACTAAGTGGTTTAAGGATGGAAAAGAGCTAACAAGTGACAACAAATACAAAATAAGCTTCTTCAACAAAGTATCCGGCCTTAAGATCATCAATGTAGCACCGAGTGACAGTGGGGTATACAGTTTTGAGGTGCAGAACCCTGTTGGCAAAGACAGCTGCACAGCTTCATTGCAGGTTTCAG
>TTN-206,ENSE00003807933,1,288,1147164,1147451,ACCGAACCGTTCCTCCTTCATTCACAAGAAAATTGAAAGAGACAAATGGTCTATCCGGCTCCTCAGTTGTAATGGAGTGTAAAGTCTATGGGTCACCTCCAATCTCTGTCTCCTGGTTCCATGAAGGAAATGAGATCAGTAGTGGAAGGAAATACCAGACCACCCTGACAGATAATACTTGTGCTTTAACTGTGAACATGCTGGAAGAATCAGACAGTGGTGACTACACATGTATAGCTACTAATATGGCTGGTTCTGATGAATGTAGTGCTCCTTTGACTGTGAGAG
>TTN-206,ENSE00003804939,1,279,1147452,1147730,AACCACCATCTTTTGTTCAGAAACCTGATCCCATGGATGTTTTAACTGGGACCAATGTAACTTTCACAAGTATCGTAAAAGGAACACCTCCTTTCAGTGTTAGCTGGTTCAAAGGTAGCAGTGAACTAGTACCAGGTGACAGATGCAACGTGTCTTTGGAGGATTCAGTTGCTGAACTGGAGTTGTTCGATGTAGATACATCACAAAGTGGAGAATATACTTGCATAGTTAGCAATGAAGCTGGCAAGGCTTCTTGTACAACACATCTCTACATAAAAG
>TTN-206,ENSE00003810094,1,279,1147731,1148009,CCCCAGCCAAATTTGTGAAGAGGCTGAATGATTACAGCATAGAGAAAGGAAAACCCCTGATCCTAGAGGGTACATTCACTGGAACTCCTCCCATTTCGGTTACCTGGAAGAAAAATGGCATAAATGTAACTCCTTCTCAGAGGTGTAATATAACTACGACTGAAAAATCGGCAATCCTGGAAATTCCAAGTAGCACAGTAGAGGATGCAGGACAATACAACTGCTACATTGAAAATGCCTCTGGAAAAGATTCCTGTTCAGCACAAATACTCATACTAG
>TTN-206,ENSE00003811103,1,279,1148010,1148288,AACCACCGTATTTTGTCAAGCAGTTGGAGCCGGTTAAGGTGTCTGTTGGAGATTCTGCCTCTCTACAATGCCAGCTTGCTGGAACCCCTGAAATTGGGGTATCCTGGTATAAAGGAGATACAAAATTGAGACCCACTACGACTTACAAAATGCATTTTAGGAATAATGTTGCTACACTGGTTTTCAACCAGGTTGATATTAATGATAGTGGAGAATATATCTGCAAAGCTGAAAACAGCGTGGGAGAAGTTTCTGCATCAACTTTCCTTACCGTTCAAG
>TTN-206,ENSE00003801476,1,288,1148289,1148576,AGCAAAAACTTCCACCATCATTTTCTCGACAATTGAGAGATGTTCAAGAAACAGTTGGACTGCCAGTTGTTTTTGATTGTGCCATAAGTGGATCAGAACCTATCTCCGTGTCTTGGTATAAAGACGGCAAGCCATTGAAAGACAGCCCAAATGTACAAACATCATTTTTAGACAATACAGCCACACTCAATATTTTTAAAACTGACCGGAGCCTTGCAGGCCAGTATTCCTGCACAGCTACAAACCCTATAGGCTCTGCTTCTTCCAGTGCCAGGCTCATTCTCACAG
>TTN-206,ENSE00003808430,1,288,1148577,1148864,AGGGGAAGAACCCACCCTTCTTTGACATCCGTCTTGCCCCTGTGGATGCTGTGGTGGGAGAAAGTGCTGACTTTGAGTGCCACGTCACGGGCACACAACCGATAAAGGTCAGCTGGGCCAAAGACAGCAGAGAAATACGAAGTGGCGGAAAGTACCAGATTAGTTATCTGGAAAACAGCGCCCACCTGACAGTCCTCAAAGTAGACAAAGGAGATTCTGGACAATATACCTGCTATGCTGTGAATGAAGTGGGAAAAGACTCTTGCACAGCTCAGCTGAATATAAAAG
>TTN-206,ENSE00003809007,1,291,1148865,1149155,AGCGGCTCATCCCACCAAGTTTCACTAAAAGACTCTCAGAGACAGTAGAAGAAACAGAAGGGAATTCTTTCAAACTTGAGGGACGTGTGGCTGGTTCCCAACCTATAACTGTTGCCTGGTACAAAAATAATATAGAGATACAACCAACTTCTAACTGTGAAATAACATTCAAGAACAACACGTTAGTGCTGCAAGTCAGGAAAGCAGGCATGAACGACGCTGGTTTGTACACATGCAAAGTGTCCAATGATGCAGGCTCTGCTCTGTGCACGTCTTCAATCGTCATCAAAG
>TTN-206,ENSE00003803910,1,288,1149156,1149443,AACCTAAGAAGCCACCTGTATTTGATCAGCACCTTACTCCAGTAACAGTGAGTGAAGGAGAATACGTGCAGCTCAGCTGCCATGTCCAGGGATCTGAGCCAATTAGGATCCAGTGGTTGAAGGCTGGCAGGGAAATAAAGCCTTCAGACAGATGCAGCTTCAGCTTTGCTAGTGGGACAGCTGTACTGGAACTCAGAGATGTGGCTAAAGCAGATTCGGGAGATTATGTGTGTAAAGCTTCAAATGTGGCTGGAAGTGACACTACCAAATCAAAAGTGACCATTAAAG
>TTN-206,ENSE00003804245,1,93,1149444,1149536,ACAAACCAGCTGTGGCCCCAGCAACCAAGAAAGCTGCGGTAGATGGAAGACTCTTTTTTGTGTCAGAACCTCAGAGTATCAGAGTCGTAGAAA
>TTN-206,ENSE00003801649,1,286,1149537,1149822,AAACCACTGCGACCTTCATTGCAAAAGTTGGAGGTGACCCAATCCCAAATGTTAAATGGACAAAAGGGAAGTGGAGACAGCTGAACCAAGGAGGTCGTGTTTTCATCCACCAAAAAGGCGATGAAGCAAAACTGGAGATTAGGGACACCACAAAAACTGATTCTGGGTTATACCGATGCGTGGCATTTAACGAACATGGTGAAATTGAAAGTAATGTTAACTTACAGGTGGATGAAAGGAAGAAACAAGAGAAAATTGAAGGCGATCTTAGAGCAATGCTGAAAAA
>TTN-206,ENSE00003805371,1,184,1149823,1150006,GACTCCAATCTTAAAGAAAGGAGCTGGAGAAGAAGAGGAAATTGATATCATGGAACTTCTCAAAAATGTTGATCCTAAAGAATATGAAAAATATGCCCGCATGTATGGAATCACTGACTTCCGAGGTCTTCTTCAAGCATTTGAACTGCTCAAGCAAAGCCAAGAAGAAGAGACACATAGACTG
>TTN-206,ENSE00003802112,1,90,1150007,1150096,GAAATTGAGGAAATAGAGAGGTCAGAGAGGGACGAAAAGGAATTTGAGGAACTTGTATCATTTATTCAGCAAAGACTGTCACAGACAGAG
>TTN-206,ENSE00003810323,1,268,1150097,1150364,CCTGTCACTCTGATCAAGGACATTGAAAATCAGACAGTTTTGAAAGATAATGATGCTGTCTTTGAAATTGACATTAAAATTAATTATCCAGAAATCAAGCTTTCGTGGTACAAAGGAACTGAAAAACTGGAACCCAGTGATAAATTTGAAATAAGCATTGATGGTGACCGACATACACTCAGAGTCAAAAACTGTCAACTTAAAGACCAGGGCAATTATCGATTGGTTTGTGGTCCACACATCGCTAGCGCTAAACTAACTGTAATTG
>TTN-206,ENSE00003810781,1,261,1150365,1150625,AGCCTGCATGGGAACGGCATCTTCAGGATGTGACTCTGAAAGAAGGCCAGACTTGCACCATGACATGCCAATTTTCTGTACCAAATGTAAAATCTGAATGGTTCAGAAATGGCAGAATCCTTAAACCCCAAGGTAGACATAAAACAGAAGTGGAACACAAAGTCCATAAATTGACCATTGCAGATGTTCGAGCAGAAGACCAGGGTCAGTACACCTGCAAATATGAAGACCTTGAAACTTCAGCAGAACTCAGAATCGAAG
>TTN-206,ENSE00003805599,1,210,1150626,1150835,CTGAACCAATTCAGTTTACAAAGCGCATACAGAACATCGTGGTGAGTGAGCATCAGTCTGCCACCTTTGAGTGTGAAGTGTCCTTTGATGATGCCATTGTAACATGGTACAAAGGACCAACAGAACTGACAGAGAGCCAGAAATACAACTTCAGGAATGATGGCCGCTGCCATTATATGACCATCCACAATGTGACCCCAGACGATGAAG
>TTN-206,ENSE00003809461,1,78,1150836,1150913,GTGTCTACTCGGTCATCGCTCGGCTGGAGCCAAGAGGTGAAGCAAGAAGCACGGCAGAGCTGTACCTAACGACGAAAG
>TTN-206,ENSE00003805821,1,27,1150914,1150940,AAATCAAACTTGAGCTGAAGCCTCCTG
>TTN-206,ENSE00003803485,1,60,1150941,1151000,ATATTCCTGACTCCAGAGTTCCAATCCCAACCATGCCTATCAGAGCAGTGCCACCAGAAG
>TTN-206,ENSE00003803812,1,84,1151001,1151084,AAATCCCTCCTGTGGTTGCTCCTCCTATCCCCCTTTTGCTACCAACACCCGAAGAAAAGAAACCACCACCAAAACGTATTGAAG
>TTN-206,ENSE00003804844,1,72,1151085,1151156,TTACCAAAAAGGCTGTGAAGAAAGATGCCAAAAAAGTTGTTGCAAAGCCCAAAGAGATGACACCACGTGAAG
>TTN-206,ENSE00003810688,1,48,1151157,1151204,AGATTGTCAAGAAGCCTCCACCTCCTACTACCTTAATTCCAGCAAAAG
>TTN-206,ENSE00003806388,1,405,1151205,1151609,CTCCTGAAATCATTGATGTATCCTCTAAAGCTGAAGAAGTAAAAATAATGACTATAACCAGAAAGAAAGAGGTTCAGAAAGAAAAAGAAGCTGTGTATGAGAAAAAGCAAGCAGTCCACAAGGAGAAGAGAGTCTTCATTGAATCTTTCGAAGAACCTTATGACGAACTGGAGGTAGAACCATACACAGAGCCATTTGAACAACCTTATTATGAAGAACCAGATGAAGACTATGAAGAGATTAAGGTAGAAGCTAAAAAAGAAGTTCACGAGGAATGGGAAGAAGATTTTGAAGAAGGGCAAGAATACTATGAAAGGGAAGAAGGCTATGACGAAGGGGAGGAAGAGTGGGAAGAGGCTTACCAAGAAAGGGAAGTAATTCAAGTTCAAAAGGAGGTCTATGAAG
>TTN-206,ENSE00003803093,1,63,1151610,1151672,AATCACATGAGAGAAAAGTTCCAGCCAAAGTACCTGAAAAGAAAGCACCACCACCTCCTAAAG
>TTN-206,ENSE00003802009,1,78,1151673,1151750,TTATAAAGAAGCCAGTAATTGAAAAAATTGAAAAGACTTCTCGAAGAATGGAGGAAGAAAAAGTTCAAGTCACCAAAG
>TTN-206,ENSE00003806356,1,78,1151751,1151828,TACCTGAAGTTTCAAAGAAGATTGTTCCACAAAAACCTTCCCGGACTCCAGTACAGGAAGAAGTTATTGAAGTGAAAG
>TTN-206,ENSE00003803112,1,87,1151829,1151915,TACCAGCTGTGCATACAAAGAAGATGGTTATTTCAGAAGAAAAGATGTTCTTTGCTTCTCACACAGAGGAGGAGGTGTCAGTCACAG
>TTN-206,ENSE00003811115,1,81,1151916,1151996,TCCCCGAGGTACAAAAGGAAATTGTTACTGAAGAGAAAATTCACGTTGCCATTTCCAAAAGGGTTGAACCACCACCTAAAG
>TTN-206,ENSE00003810048,1,84,1151997,1152080,TCCCTGAGCTACCTGAGAAACCAGCTCCAGAAGAAGTGGCCCCTGTTCCTATCCCTAAAAAAGTGGAGCCCCCAGCACCAAAAG
>TTN-206,ENSE00003809302,1,84,1152081,1152164,TTCCTGAGGTTCCCAAGAAACCCGTGCCAGAGGAGAAAAAGCCAGTTCCTGTGCCTAAGAAGGAACCTGCTGCTCCCCCAAAAG
>TTN-206,ENSE00003811271,1,84,1152165,1152248,TCCCAGAGGTGCCAAAGAAACCTGTCCCTGAAGAAAAGATTCCCGTTCCTGTTGCAAAGAAAAAGGAAGCTCCCCCAGCTAAAG
>TTN-206,ENSE00003811169,1,81,1152249,1152329,TTCCTGAAGTACAGAAGGGAGTTGTGACAGAAGAAAAAATAACCATTGTAACTCAAAGAGAGGAATCTCCACCACCAGCAG
>TTN-206,ENSE00003802187,1,84,1152330,1152413,TGCCAGAAATACCAAAGAAGAAAGTTCCTGAAGAAAGGAAACCTGTTCCTCGGAAGGAGGAAGAAGTTCCACCACCACCAAAAG
>TTN-206,ENSE00003810484,1,84,1152414,1152497,TGCCAGCTCTGCCTAAGAAACCCGTCCCAGAGGAGAAAGTTGCAGTGCCAGTTCCTGTCGCTAAGAAAGCTCCTCCTCCCCGAG
>TTN-206,ENSE00003810121,1,102,1152498,1152599,CTGAAGTCTCTAAGAAAACTGTTGTAGAAGAAAAGAGATTTGTTGCTGAAGAAAAACTATCCTTCGCAGTTCCTCAAAGAGTGGAAGTCACGCGGCACGAAG
>TTN-206,ENSE00003805410,1,114,1152600,1152713,TATCTGCAGAGGAGGAATGGAGTTACTCAGAAGAGGAGGAAGGTGTGTCCATTTCAGTTTATAGAGAAGAAGAAAGAGAGGAGGAGGAAGAAGCAGAGGTTACAGAATATGAAG
>TTN-206,ENSE00003801264,1,81,1152714,1152794,TGATGGAAGAGCCTGAGGAATATGTTGTGGAAGAAAAGCTGCACATTATTTCTAAGAGAGTGGAAGCTGAGCCAGCTGAAG
>TTN-206,ENSE00003805756,1,78,1152795,1152872,TGACAGAGAGGCAGGAGAAGAAAATTGTACTGAAACCAAAAATTCCTGCTAAAATAGAGGAGCCTCCACCGGCTAAAG
>TTN-206,ENSE00003808334,1,84,1152873,1152956,TTCCTGAAGCACCTAAGAAAATTGTGCCAGAAAAGAAAGTTCCTGCTCCAGTTCCTAAAAAGGAAAAGGTGCCCCCACCTAAAG
>TTN-206,ENSE00003808052,1,84,1152957,1153040,TGCCAGAAGAGCCAAAGAAACCAGTTCCAGAAAAAAAGGTTCCTCCAAAAGTCATTAAGATGGAAGAACCTCTCCCAGCCAAAG
>TTN-206,ENSE00003803067,1,84,1153041,1153124,TGACTGAGAGGCACATGCAAATTACCCAGGAAGAAAAAGTTCTTGTTGCTGTAACTAAAAAAGAGGCGCCTCCAAAAGCAAGAG
>TTN-206,ENSE00003808806,1,84,1153125,1153208,TGCCAGAGGAACCGAAGAGAGCTGTCCCAGAAGAAAAAGTTCTGAAACTCAAACCTAAAAGAGAGGAGGAACCACCAGCTAAAG
>TTN-206,ENSE00003805330,1,81,1153209,1153289,TGACTGAATTCAGAAAAAGAGTGGTTAAAGAAGAAAAAGTATCAATTGAAGCTCCAAAAAGAGAACCTCAACCCATCAAAG
>TTN-206,ENSE00003807878,1,207,1153290,1153496,AAGTAACTATAATGGAAGAGAAAGAAAGGGCTTATACCCTAGAAGAAGAAGCTGTTTCAGTACAACGGGAAGAAGAATATGAGGAATATGAAGAATATGATTATAAAGAATTTGAGGAGTATGAACCAACAGAAGAATATGACCAATATGAAGAATACGAGGAGCGGGAGTATGAACGATATGAAGAGCATGAAGAATACATCACAG
>TTN-206,ENSE00003806244,1,78,1153497,1153574,AACCAGAGAAGCCTATCCCTGTAAAGCCTGTCCCAGAAGAACCAGTTCCCACAAAACCAAAGGCCCCACCGGCTAAAG
>TTN-206,ENSE00003810594,1,75,1153575,1153649,TGCTGAAGAAAGCTGTCCCTGAAGAAAAAGTACCAGTGCCCATTCCTAAGAAACTCAAACCTCCACCACCCAAAG
>TTN-206,ENSE00003809388,1,93,1153650,1153742,TGCCTGAAGAACCAAAGAAAGTTTTTGAGGAAAAAATACGTATTTCAATTACCAAACGTGAAAAAGAGCAGGTGACTGAACCCGCTGCTAAAG
>TTN-206,ENSE00003807405,1,78,1153743,1153820,TGCCCATGAAGCCCAAGAGGGTTGTCGCAGAAGAAAAAGTACCTGTCCCTAGAAAAGAAGTAGCACCACCTGTTAGAG
>TTN-206,ENSE00003810081,1,162,1153821,1153982,TGCCAGAAGTGCCTAAAGAACTTGAACCAGAAGAGGTTGCCTTTGAAGAGGAAGTTGTAACCCATGTAGAAGAATATCTTGTAGAAGAAGAAGAAGAGTACATTCATGAAGAAGAGGAGTTCATAACTGAGGAAGAAGTGGTGCCAGTGATACCAGTCAAAG
>TTN-206,ENSE00003806496,1,84,1153983,1154066,TGCCTGAGGTACCCAGGAAACCTGTTCCAGAAGAGAAGAAACCTGTTCCTGTTCCCAAGAAGAAGGAAGCTCCACCGGCAAAAG
>TTN-206,ENSE00003802498,1,78,1154067,1154144,TGCCTGAGGTTCCTAAGAAGCCAGAGGAGAAAGTTCCTGTGCTTATTCCTAAAAAGGAGAAGCCTCCGCCAGCAAAAG
>TTN-206,ENSE00003809653,1,84,1154145,1154228,TTCCTGAAGTGCCCAAGAAACCTGTGCCAGAGGAGAAAGTACCAGTACCAGTTCCTAAAAAGGTGGAAGCTCCACCTGCCAAAG
>TTN-206,ENSE00003810862,1,84,1154229,1154312,TGCCAGAGGTACCCAAGAAGCCTGTGCCTGAGAAGAAGGTGCCAGTTCCTGCTCCTAAGAAAGTGGAGGCTCCACCTGCAAAAG
>TTN-206,ENSE00003805059,1,84,1154313,1154396,TGCCAGAGGTGCCCAAGAAGCTCATCCCAGAAGAAAAGAAACCAACACCTGTTCCGAAAAAAGTGGAAGCACCACCACCCAAAG
>TTN-206,ENSE00003801382,1,297,1154397,1154693,TGCCAAAGAAACGTGAACCAGTTCCAGTTCCTGTAGCTCTACCTCAGGAAGAGGAAGTTCTATTTGAAGAAGAAATTGTTCCTGAAGAGGAAGTTCTACCTGAGGAAGAGGAAGTTCTACCTGAGGAAGAGGAAGTTCTACCTGAAGAAGAGGAAGTTCTACCTGAAGAAGAGGAAATTCCACCTGAGGAAGAGGAAGTTCCTCCCGAAGAAGAATATGTACCTGAGGAAGAAGAATTTGTACCTGAAGAAGAAGTCCTTCCAGAAGTTAAACCTAAGGTGCCAGTACCTGCACCAG
>TTN-206,ENSE00004025982,1,87,1154694,1154780,TGCCTGAAGTGCCAAAGAAACCTGTACCAGAGAAGAAAGTCCCTGTTCCCGCCCCTAAAAAAGTGGAACCTCCACCACCACCCAAAG
>TTN-206,ENSE00003805240,1,75,1154781,1154855,TGCCTGAAATTAAGAAGAAAGTGACAGAGAAGAAAGTGGTCATTCCCAAGAAAGAGGAGGCTCCCCCTGCCAAAG
>TTN-206,ENSE00004025997,1,84,1154856,1154939,TGTCTGTGGTACCTAAGAAACCTGAGCCAGAAAAGAAGGTCCCTCCTCCTGGTCTTAAGAAAGCAGTGGCCCCTCCTGCCAAAG
>TTN-206,ENSE00003804875,1,75,1154940,1155014,TTCCTGAGGTGCCTAAGAAGGTGGAAGAAAAACGAATCATTCTCCCTAAAGAAGAGGAAGTTCTACCAGTTGAAG
>TTN-206,ENSE00003801552,1,96,1155015,1155110,TGACTGAGGAGCCTGAAGAAGAGCCTATTTCAGAAGAAGAAATCCCAGAAGAACCACCTAGCATAGAGGAAGTTGAAGAGGTGGCACCACCTAGAG
>TTN-206,ENSE00003804385,1,78,1155111,1155188,TGCCTGAAGTGATTAAGAAAGCAGTACCTGAAGCACCTACTCCTGTTCCTAAAAAAGTGGAGGCACCACCAGCTAAAG
>TTN-206,ENSE00003805135,1,69,1155189,1155257,TGTCAAAGAAAATTCCTGAGGAAAAAGTACCTGTTCCTGTTCAGAAAAAAGAGGCACCCCCAGCCAAAG
>TTN-206,ENSE00003808243,1,75,1155258,1155332,TGCCTGAAGTACCAAAGAAAGTCCCAGAAAAGAAAGTCCTTGTGCCTAAAAAGGAAGCTGTTCCCCCAGCTAAAG
>TTN-206,ENSE00003808353,1,297,1155333,1155629,GGAGAACTGTCCTTGAAGAAAAAGTATCAGTTGCCTTCCGCCAAGAAGTAGTAGTAAAAGAAAGACTAGAATTAGAAGTAGTAGAAGCAGAAGTGGAAGAAATTCCGGAAGAAGAAGAGTTCCATGAAGTTGAAGAATATTTTGAAGAAGGCGAGTTTCATGAAGTAGAAGAATTCATCAAATTAGAACAACATAGAGTTGAAGAAGAACACAGAGTTGAAAAAGTTCATAGGGTAATAGAAGTTTTTGAGGCTGAAGAAGTGGAAGTATTTGAAAAACCAAAAGCTCCACCTAAAG
>TTN-206,ENSE00003807571,1,81,1155630,1155710,GGCCTGAGATATCTGAGAAAATCATCCCTCCAAAAAAACCGCCCACTAAAGTTGTTCCTCGAAAAGAGCCACCAGCTAAAG
>TTN-206,ENSE00003808118,1,78,1155711,1155788,TACCGGAGGTGCCTAAGAAAATTGTGGTAGAAGAAAAAGTACGTGTTCCTGAAGAGCCCAGAGTTCCACCAACTAAAG
>TTN-206,ENSE00004025978,1,84,1155789,1155872,CACCCGAAGTACCCAAGAAAATTGTCCCAGAAGAAAAAGTTCGTGAAGCTGTTCTGAAAAAGCCTGAAGTTCCACCAGCTAAAG
>TTN-206,ENSE00004026002,1,75,1155873,1155947,TTCCTGGGATGCCTAAGAAAAGTGTTCAAGAAGAAAAATCACCTATTGTTATTTCTGAAGACACAGAGATGTACA
>TTN-206,ENSE00004025998,1,84,1155948,1156031,TTTATGAAGCATCTGAAGAAGCAGTCCTAGAAGAAAAAGTACTTGTGACTCAACCTCAAAAGACAAAACCCAAACTAGCAAAAG
>TTN-206,ENSE00004025971,1,84,1156032,1156115,TGCCTGAGCCACCCAAGAAAGTTGTTCCAGAAGACAAAATATATGTGACTATTCCTAAAAAGAGAGAAACACCAGCAACTAAAG
>TTN-206,ENSE00001725280,1,84,1156116,1156199,AACCTGATACAACCAGAGGCATTTTTCCAGAGGTGGAGCCACCTGAGGCTATTCCTGAAATTCCAGAACATCCTCCAACTGAAG
>TTN-206,ENSE00004024308,1,78,1156200,1156277,AGTTTGAAGTCTTCAAGGAAGTCATTCCAGAGGGAGAAACTCCTATTGTTAAAAGAAGAAAAACACCATCACCAACAG
>TTN-206,ENSE00004024272,1,84,1156278,1156361,CACCAGAAGCTATGAAAGAAGTTGTCCCTGAAATGAAAATATTTGAGGATGTACCTGAAGAGCCAGAAACTCCACGTATGAAAA
>TTN-206,ENSE00004024280,1,75,1156362,1156436,CGCCCGAAGCTCCTCAAGAAATTATTCCTGCCAAGACAGTTCCTTCCAAAAAAAGAGAACCCCCATCAGTTAAAG
>TTN-206,ENSE00004024279,1,84,1156437,1156520,TGCCTGAAGCTCTCCAAGAAATTGTCCCTGAAAAGAAAACGCTTGTGGTTCCTCTCAGAAAGCCTGAAGTCCTTCCTGATGAAG
>TTN-206,ENSE00004024286,1,78,1156521,1156598,TGCCGGAGGCTCTCAGAGAAGTTGTCCCGGAAAAGAAAGTGCATCCTCCCCAAAGGGCTGAAGTTGTACCTGTCAAAG
>TTN-206,ENSE00004024310,1,84,1156599,1156682,TGCACGAAGCTCCCAAAGAGATTATCCCTGAAAAGAAAGTGTCGGTGGTGCCTCCTAAAAAGCCTGAAGTCCCACCTGTTAAAG
>TTN-206,ENSE00004024305,1,84,1156683,1156766,TGCCAGAAGCTTCCAAAGAGGTTATCCGCGAAGAGAAAGTGCCCTTGGCTCCTCCTAAAGAGCCTGAAGTCCCACCTGTTAAAG
>TTN-206,ENSE00004024294,1,84,1156767,1156850,TACCAGAGCCTCCCAAAGAAGTAGTTCCTGAAAAGAAAGCGCCAGTGGCTCCTCCTAAAGAGCCTGAAGTCCCACCTGTTAAAG
>TTN-206,ENSE00004025974,1,84,1156851,1156934,TGCCTGAGGCTCCCAAAGAAGTTGTTCCTGAAAAGAAAGTGCCAGTGCCTCCTCCTAAAAAGCCTGAAGTGCCACCCACAAAAG
>TTN-206,ENSE00004025967,1,84,1156935,1157018,TCCCAGAGGTGCCAAAGGCAGCTGTCCCAGAAAAGAAGTTGCCTGAAGCTATTCCTCCCAAACCGGAAAGTCCTCCCCCTGAAG
>TTN-206,ENSE00003807304,1,90,1157019,1157108,TGCCTGAAGTGCTGCCACCGAAGGAAGTGGTCCCAGAAAAGAAAGTACCGGTGCCTCCTGCCAAAAAGCCAGAAGCTCCACCTCCTAAAG
>TTN-206,ENSE00004026001,1,84,1157109,1157192,TTCCTGAAGCTCCTAAAGAAGTTGTACTTGAAAAGAAAGCATCTGTGGCTGTGCCCAAAAAACCGGAAGCCCCACGTGCAAAAG
>TTN-206,ENSE00004025988,1,84,1157193,1157276,TGCCTGAAGCTGCTCAAGAAGTTGTCCCAGAAAAGAAAATTCCCAAGGCACCAATCAAAAAACCAGAAGCCCCCGCAGTTACAG
>TTN-206,ENSE00004025983,1,81,1157277,1157357,TGCCAGAAGTTCCTCAAGAAGCCACAGAAAAAGAAATTCCCGTGGCTCCACCCAAAAAACCAGAAGCTCCAATTGTCCCAG
>TTN-206,ENSE00004025976,1,81,1157358,1157438,TGCCTGAAGCTCAAGAAGTTGTCCCAGAAAAGAAAGTTCCTAAGGCTCCTCCCACAAAACCAGAAGCCCCACCTGCCACAG
>TTN-206,ENSE00004025986,1,81,1157439,1157519,TGCCTGAAGTCCCACAAGAAATTGTGCCAGAAAAGAAAACACTGGTGCTTCCTAAAAAGCCAGAAGTTCCACCTGTTACAG
>TTN-206,ENSE00004025969,1,84,1157520,1157603,TGCCAGAGGCTCCCAAAGAAGTTGTCCTTGAAAAGAAAGTGCCCTCGGCTCCTCCTAAAAAGCCTGAAGTCCCACCTGTTAAAG
>TTN-206,ENSE00003802745,1,84,1157604,1157687,TGCCTGAGGCTCCCAAAGAAGTTGTTCCTGAAAAGAAAGTGCCAGTGCCTCCTCCTAAAAAGCCTGAAGTGCCACCCACAAAAG
>TTN-206,ENSE00003809569,1,84,1157688,1157771,TCCCAGAGGTGCCAAAGGCAGCTGTCCCAGAAAAGAAGGTGCCTGAAGCTATTCCTCCCAAACCGGAAAGTCCTCCCCCTGAAG
>TTN-206,ENSE00004025984,1,90,1157772,1157861,TGCCTGAAGTGCTGCCACCGAAGGAAGTGGTCCCAGAAAAGAAAGTACCGGTGCCTCCTGCCAAAAAGCCAGAAGCTCCACCTCCTAAAG
>TTN-206,ENSE00004026000,1,84,1157862,1157945,TTCCTGAAGCTCCTAAAGAAGTTGTACTTGAAAAGAAAGCATCTGTGGCTGTGCCCAAAAAACCGGAAGCCCCACGTGCAAAAG
>TTN-206,ENSE00004025966,1,84,1157946,1158029,TGCCTGAAGCTGCTCAAGAAGTTGTCCCAGAAAAGAAAATTCCCAAGGCACCAATCAAAAAACCAGAAGCCCCCGCAGTTACAG
>TTN-206,ENSE00004025973,1,81,1158030,1158110,TGCCAGAAGTTCCTCAAGAAGCCGCAGAAAAAGAAATTCCCGTGGCTCCACCCAAAAAACCAGAAGCTCCGATTGTCCCAG
>TTN-206,ENSE00004025979,1,81,1158111,1158191,TGCCTGAAGCTCAAGAAGTTGTCCCAGAAAAGAAAGTTCCTAAGGCTCCTCCCACAAAACCAGAAGCCCCACCTGCCACAG
>TTN-206,ENSE00004025981,1,81,1158192,1158272,TGCCTGAAGTCCCACAAGAAATTGTGCCAGAAAAGAAAACACTGGTGCTTCCTAAAAAGCCAGAAGTTCCACCTGTTACAG
>TTN-206,ENSE00004025970,1,84,1158273,1158356,TGCCAGAGGCTCCCAAAGAAGTTGTCCTTGAAAAGAAAGTGCCCTCGACTCCTCCTAAAAAGCCTGAAGTCCCACCTGTTAAAG
>TTN-206,ENSE00004025993,1,84,1158357,1158440,TGCCTGAGGCTCCCAAAGAAGTTGTTCCTGAAAAGAAAGTGCCAGTGCCTCCTCCTAAAAAGCCTGAAGTGCCACCCACAAAAG
>TTN-206,ENSE00004025989,1,84,1158441,1158524,TCCCAGAGGTGCCAAAGGCAGCTGTCCCAGAAAAGAAGGTGCCTGAAGCTATTCCTCCCAAACCGGAAAGTCCTCCCCCTGAAG
>TTN-206,ENSE00004025987,1,90,1158525,1158614,TGCCTGAAGTGCTGCCACCGAAGGAAGTGGTCCCAGAAAAGAAAGTACCGGTGCCTCCTGCCAAAAAGCCAGAAGCTCCACCTCCTAAAG
>TTN-206,ENSE00004025975,1,84,1158615,1158698,TTCCTGAAGCTCCTAAAGAAGTTGTACTTGAAAAGAAAGTATCTGTGGCTGTGCCCAAAAAACCGGAAGCCCCACGTGCAAAAG
>TTN-206,ENSE00004026003,1,84,1158699,1158782,TGCCTGAAGCTGCTCAAGAAGTTGTCCCAGAAAAGAAAATTCCCAAGGCACCAATCAAAAAACCAGAAGCCCCCGCAGTTACAG
>TTN-206,ENSE00004025980,1,81,1158783,1158863,TGCCAGAAGTTCCTCAAGAAGCCGCAGAAAAAGAAATTCCCGTGGCTCCACCCAAAAAACCAGAAGCTCCAATTGTCCCAG
>TTN-206,ENSE00004025994,1,81,1158864,1158944,TGCCTGAAGCTCAAGAAGTTGTCCCAGAAAAGAAAGTTCCTAAGGCTCCTCCCACAAAACCAGAAGCCCCACCTGCCACAG
>TTN-206,ENSE00004025996,1,81,1158945,1159025,TGCCTGAAGTCCCACAAGAAATTGTGCCAGAAAAGAAAACACTGGTGCTTCCTAAAAAGCCAGAAGTTCCACCTGTTACAG
>TTN-206,ENSE00004025990,1,84,1159026,1159109,TGCCAGAGGCTCCCAAAGAAGTTGTCCTTGAAAAGAAAGTGCCCTTGGCTCCTCCTAAAAAGCCTGAAGTCCCACCTGTTAAAG
>TTN-206,ENSE00004026004,1,84,1159110,1159193,TGCCAGAGGCTCCCAAAGAAGTTGTTCCTGAAAAGAAAGTGCCAGTGACTCCTCCTAAAAAACCTGAAGTCCCACCTGTTAAAG
>TTN-206,ENSE00004025977,1,84,1159194,1159277,TGCCAGAGGCTCCCATAGAGGTTGTTCCTGAAAAGAAAATGCCCTTGGCTCCTCCTAAAAAGCCTGAAGTCCCTCCTGTTAAAG
>TTN-206,ENSE00004025991,1,84,1159278,1159361,TACCAGAGGCTCCCAAAGAGGTTGTTCCTGAAAAGAAAGTGCCCTCGGCTCCTCCTAAAAAGCCTGAAGTCCCACCTGTTAAAG
>TTN-206,ENSE00003806373,1,84,1159362,1159445,TGCCAGAGGCTCCGAAAGAAGTTGTTCCTGAAAAGAAAGTGCCAGCGGCTCCTCCTAAAAAGCCTGAAGTCACACCTGTTAAAG
>TTN-206,ENSE00003807489,1,84,1159446,1159529,TGCCTGAGGCTCCCAAAGAAGTTGTTCCTGAAAAGAAAGTGCCAGTGCCTCCTCCTAAAAAGCCTGAAGTGCCACCCACAAAAG
>TTN-206,ENSE00003805050,1,84,1159530,1159613,TCCCAGAGGTGCCAAAGGTAGCTGTCCCAGAAAAGAAGGTGCCTGAAGCTATTCCTCCCAAACCGGAAAGTCCTCCCCCTGAAG
>TTN-206,ENSE00003808824,1,84,1159614,1159697,TGTTCGAGGAGCCTGAGGAAGTTGCCCTAGAAGAGCCTCCTGCTGAAGTTGTGGAAGAGCCAGAGCCAGCGGCGCCTCCACAAG
>TTN-206,ENSE00003807203,1,84,1159698,1159781,TGACCGTACCACCTAAGAAACCTGTCCCAGAAAAGAAAGCACCTGCTGTCGTTGCCAAAAAACCTGAACTACCACCAGTGAAAG
>TTN-206,ENSE00003811260,1,84,1159782,1159865,TGCCCGAGGTGCCCAAGGAGGTTGTTCCTGAAAAGAAGGTGCCTCTGGTGGTTCCCAAAAAGCCAGAAGCCCCACCTGCTAAAG
>TTN-206,ENSE00003806229,1,78,1159866,1159943,TGCCTGAAGTTCCAAAAGAAGTTGTTCCAGAAAAGAAAGTAGCTGTTCCCAAAAAGCCAGAAGTCCCACCAGCAAAAG
>TTN-206,ENSE00003807893,1,84,1159944,1160027,TGCCAGAAGTGCCAAAGAAACCTGTCTTGGAAGAGAAACCAGCTGTTCCTGTTCCAGAAAGAGCGGAGTCTCCTCCCCCAGAAG
>TTN-206,ENSE00003809515,1,108,1160028,1160135,TATATGAAGAACCTGAGGAAATTGCTCCTGAAGAGGAAATTGCTCCTGAAGAGGAAAAGCCAGTTCCTGTTGCAGAAGAGGAGGAACCAGAGGTTCCACCTCCAGCAG
>TTN-206,ENSE00003804845,1,78,1160136,1160213,TGCCTGAAGAGCCCAAGAAGATCATCCCAGAGAAGAAAGTTCCTGTCATCAAAAAACCAGAAGCACCGCCTCCTAAAG
>TTN-206,ENSE00004025992,1,78,1160214,1160291,AACCTGAGATGCCAAAGAAAGTTGTTCCAGTGAAGAAGGTCCCAACTGTTAAGAAGCCAGAAACACCAGCAGCTAAAG
>TTN-206,ENSE00004025972,1,84,1160292,1160375,TGCCTGAGGTGCCCAAGAAACTTGTTCCAGTAAAGAAAGAACCTGTGCCTGTTACCAAAAAACCAGAAGTTCTTCCAGAAAAAG
>TTN-206,ENSE00004025968,1,84,1160376,1160459,TGCCCAAAGTGCCTGAGAAAATCATCCCAGAAAAGGAAGTGTCTGTGCCTATCCCTGCAGAGCCAGAAGTTCCACCTGCTGAAG
>TTN-206,ENSE00004025985,1,81,1160460,1160540,TTGAAGAGACTCCTGAGGAAATAATATATGAAGAAAAAGCATCTATAACCATTGGTAGAAAAGAGACTCCCCCTGTTGAAG
>TTN-206,ENSE00004025999,1,75,1160541,1160615,AACGTGAAATTGAAAAGTATATTAAACCTGAAGAGCCCGAACCTGAACCACAGCCTGAAGAAATACCAGTAAAAG
>TTN-206,ENSE00003806702,1,111,1160616,1160726,AACCTGAACCTGAAAAGGTTATTGAGAAGCCAAAACTCAAACCAAGACCCCCACCTCCTCCACCTGCTCCACCTAAGGAAGATGTGAAGGAGAAAATATTCCAACTTAAAG
>TTN-206,ENSE00003809179,1,69,1160727,1160795,CTATTCCAAAGAAGAAAGTTCCTGAAAAACCTCAGGTTCCAGAAAAAGTGGAGCTTACACCTCTGAAAG
>TTN-206,ENSE00003804802,1,81,1160796,1160876,TGCCTGGAGGTGAAAAGAAAGTTCGCAAATTACTTCCGGAACGTAAACCTGAACCAAAGGAAGAAGTTGTTCTGAAAAGCG
>TTN-206,ENSE00003811452,1,75,1160877,1160951,TTCTAAGAAAAAGACCTGAAGAAGAAGAACCTAAAGTAGAACCTAAAAAACTAGAAAAAGTTAAAAAACCTGCAG
>TTN-206,ENSE00003807205,1,90,1160952,1161041,TACCAGAACCACCACCTCCAAAACCTGTTGAAGAGGTTGAAGTACCTACTGTTACAAAAAGGGAAAGGAAGATTCCTGAACCAACAAAAG
>TTN-206,ENSE00003806747,1,63,1161042,1161104,TGCCTGAAATCAAGCCAGCAATACCTCTCCCTGCACCTGAACCGAAACCAAAGCCCGAAGCAG
>TTN-206,ENSE00003810755,1,90,1161105,1161194,AAGTGAAAACAATCAAACCACCTCCTGTGGAACCTGAACCAACCCCCATCGCTGCCCCAGTAACAGTGCCAGTGGTTGGAAAGAAAGCAG
>TTN-206,ENSE00003806122,1,51,1161195,1161245,AAGCCAAAGCACCTAAGGAAGAGGCTGCCAAGCCAAAAGGTCCTATCAAAG
>TTN-206,ENSE00003804858,1,402,1161246,1161647,GTGTACCCAAAAAGACTCCTTCACCAATAGAAGCCGAAAGGAGAAAGTTAAGGCCAGGAAGTGGTGGAGAGAAACCTCCTGATGAAGCCCCGTTCACCTACCAGCTAAAGGCTGTGCCACTGAAGTTTGTGAAAGAAATCAAAGACATCATCTTGACAGAATCAGAGTTCGTTGGCTCTTCAGCAATCTTTGAATGTTTGGTCTCCCCTTCCACTGCAATTACAACCTGGATGAAAGACGGTAGCAATATCCGTGAGAGTCCCAAGCACAGGTTTATTGCAGATGGTAAAGACAGAAAGCTGCACATCATTGATGTTCAACTTTCCGATGCTGGTGAATACACCTGTGTTTTACGTTTGGGAAACAAAGAAAAGACCTCCACGGCTAAACTTGTTGTAGAAG
>TTN-206,ENSE00003803996,1,279,1161648,1161926,AACTTCCTGTGCGTTTTGTAAAAACACTGGAAGAGGAAGTCACAGTGGTCAAAGGACAGCCATTGTACTTGAGCTGCGAGTTAAACAAAGAGCGTGACGTGGTCTGGAGGAAGGATGGCAAGATTGTGGTGGAGAAACCTGGCCGAATTGTGCCAGGCGTCATTGGCTTGATGCGGGCTCTGACCATCAACGATGCAGATGACACAGATGCTGGAACATACACAGTTACTGTGGAAAACGCCAACAACCTGGAGTGTTCATCTTGCGTAAAAGTAGTAG
>TTN-206,ENSE00003807976,1,276,1161927,1162202,AAGTCATTAGAGATTGGCTGGTGAAACCTATACGAGACCAGCATGTGAAACCCAAGGGGACAGCTATTTTTGCCTGTGATATAGCAAAAGATACTCCAAACATTAAGTGGTTCAAAGGATATGATGAAATCCCTGCGGAACCAAATGATAAGACTGAAATACTGAGAGATGGAAATCATCTGTACCTCAAAATTAAGAATGCTATGCCAGAAGATATTGCTGAGTATGCAGTGGAAATTGAAGGAAAAAGATACCCTGCAAAGCTGACACTTGGAG
>TTN-206,ENSE00003804328,1,140,1162203,1162342,AGCGTGAAGTTGAACTGCTTAAACCAATAGAGGACGTTACCATTTATGAGAAAGAAAGTGCAAGCTTTGATGCAGAAATCTCAGAGGCAGACATTCCTGGACAATGGAAACTGAAAGGAGAACTTCTAAGGCCCTCACCT
>TTN-206,ENSE00003802254,1,127,1162343,1162469,ACTTGTGAAATCAAAGCAGAAGGTGGAAAACGCTTCTTAACTTTGCACAAAGTCAAACTGGACCAAGCTGGTGAAGTCCTCTACCAGGCCCTTAATGCAATTACAACTGCCATTTTGACAGTAAAAG
>TTN-206,ENSE00003811410,1,264,1162470,1162733,AAATCGAACTTGACTTTGCTGTGCCCCTGAAGGATGTCACTGTTCCAGAAAGGCGACAGGCTCGATTCGAATGTGTCCTCACCCGAGAGGCAAATGTTATATGGTCCAAAGGACCTGATATAATTAAGTCATCTGACAAATTTGATATCATCGCTGATGGAAAGAAACATATTCTTGTTATTAATGATTCTCAATTTGATGATGAAGGGGTCTATACTGCTGAGGTGGAGGGCAAGAAGACCTCAGCTCGGTTGTTTGTCACAG
>TTN-206,ENSE00003805150,1,267,1162734,1163000,GTATAAGACTGAAATTCATGTCACCTCTTGAAGATCAAACAGTAAAAGAAGGTGAAACAGCAACTTTTGTTTGTGAACTTTCTCATGAAAAAATGCATGTAGTCTGGTTCAAAAATGATGCCAAACTCCATACAAGCAGAACAGTACTCATCTCTTCTGAGGGCAAGACTCACAAATTGGAAATGAAAGAAGTGACATTGGATGATATATCTCAGATAAAAGCTCAAGTCAAGGAGCTGAGCTCCACAGCACAGCTGAAGGTCTTAG
>TTN-206,ENSE00003801907,1,264,1163001,1163264,AGGCCGATCCCTACTTCACTGTGAAATTACATGACAAAACTGCAGTGGAGAAGGATGAGATTACTTTGAAGTGTGAAGTGAGCAAAGATGTACCAGTGAAATGGTTCAAAGATGGTGAAGAGATTGTCCCTTCACCCAAATATTCTATCAAGGCAGATGGCCTGCGCCGCATCTTAAAAATCAAAAAGGCGGACCTTAAAGATAAAGGCGAATATGTGTGTGACTGTGGCACAGACAAGACCAAGGCAAATGTTACTGTTGAGG
>TTN-206,ENSE00003802031,1,140,1163265,1163404,CTCGACTAATAAAAGTGGAAAAGCCTCTGTACGGAGTAGAGGTGTTTGTTGGTGAAACAGCCCACTTTGAAATTGAACTTTCTGAACCTGATGTTCACGGCCAGTGGAAGCTGAAAGGACAGCCTTTGACAGCTTCCCCT
>TTN-206,ENSE00003811443,1,127,1163405,1163531,GACTGTGAAATCATTGAGGATGGAAAGAAGCATATTCTGATCCTTCATAACTGTCAGCTGGGTATGACAGGAGAGGTTTCCTTCCAGGCTGCTAATGCCAAATCTGCAGCCAATCTGAAAGTGAAAG
>TTN-206,ENSE00003811384,1,267,1163532,1163798,AATTGCCTCTTATCTTCATCACACCTCTCAGTGATGTTAAAGTCTTCGAGAAAGATGAGGCTAAGTTTGAGTGTGAAGTATCCAGGGAGCCCAAAACATTCCGTTGGCTAAAAGGAACCCAGGAAATCACAGGTGATGACAGATTTGAGCTTATAAAGGATGGCACTAAGCATTCAATGGTGATCAAGTCAGCTGCTTTTGAAGATGAAGCAAAATACATGTTTGAAGCTGAAGATAAGCACACAAGTGGCAAACTGATCATTGAAG
>TTN-206,ENSE00003801954,1,267,1163799,1164065,GAATCCGGCTCAAATTCCTCACCCCTCTCAAAGATGTAACTGCCAAAGAGAAGGAAAGTGCTGTATTTACTGTGGAGTTATCTCATGATAACATCCGAGTTAAATGGTTCAAGAATGACCAGCGCCTACACACCACCAGGTCGGTCTCAATGCAAGACGAAGGGAAAACTCATTCGATCACATTCAAAGACCTGTCTATTGATGACACCTCCCAAATTAGAGTAGAAGCTATGGGGATGAGTTCAGAAGCTAAACTCACTGTGCTTG
>TTN-206,ENSE00003809996,1,267,1164066,1164332,AGGGAGACCCATATTTTACAGGAAAACTTCAAGATTATACTGGTGTAGAGAAAGATGAAGTTATTCTACAGTGTGAAATTAGCAAAGCAGATGCACCAGTGAAATGGTTTAAGGATGGGAAGGAAATAAAGCCATCCAAAAATGCTGTTATTAAGGCAGATGGCAAGAAACGCATGCTAATCCTAAAGAAAGCCTTGAAATCAGATATTGGACAGTACACCTGTGACTGTGGGACAGATAAGACCTCAGGAAAACTTGACATTGAGG
>TTN-206,ENSE00003804589,1,140,1164333,1164472,ATCGGGAAATTAAACTGGTGCGACCCCTGCACAGTGTGGAGGTGATGGAGACTGAGACAGCACGCTTTGAAACCGAAATCTCTGAAGATGATATCCACGCCAACTGGAAACTCAAGGGAGAGGCCCTACTCCAAACACCT
>TTN-206,ENSE00003805931,1,127,1164473,1164599,GATTGTGAAATTAAGGAAGAAGGCAAAATACACTCCCTTGTTTTGCACAACTGTCGCCTGGACCAGACGGGTGGGGTGGATTTCCAAGCTGCCAATGTTAAATCTAGTGCCCACCTCCGAGTTAAGC
>TTN-206,ENSE00003811344,1,143,1164600,1164742,CACGAGTAATTGGTCTTCTGAGGCCTTTAAAGGATGTCACCGTGACTGCAGGGGAAACAGCCACCTTCGACTGCGAGCTCTCCTACGAAGATATCCCAGTGGAATGGTATCTCAAAGGGAAGAAACTAGAGCCCAGCGATAAG
>TTN-206,ENSE00003802375,1,124,1164743,1164866,GTGGTCCCACGTTCAGAAGGAAAAGTTCATACACTTACTCTGAGGGATGTAAAGTTAGAAGATGCTGGGGAAGTCCAACTAACAGCAAAAGATTTCAAAACTCACGCCAACCTCTTTGTGAAAG
>TTN-206,ENSE00003806733,1,267,1164867,1165133,AACCCCCAGTTGAATTCACTAAGCCTCTTGAGGACCAGACGGTCGAAGAGGGAGCCACTGCAGTGCTGGAGTGTGAAGTCTCCAGAGAAAATGCTAAGGTGAAATGGTTCAAAAATGGGACAGAAATCCTCAAAAGCAAGAAGTATGAAATTGTTGCTGATGGCAGGGTCAGAAAACTTGTTATACATGACTGTACCCCAGAGGATATTAAAACATACACTTGTGATGCTAAGGATTTTAAGACTTCCTGTAACCTGAATGTCGTGC
>TTN-206,ENSE00003807497,1,98,1165134,1165231,CTCCTCATGTGGAATTCTTAAGACCACTCACCGACCTTCAAGTTAGAGAAAAAGAAATGGCTCGATTTGAGTGTGAACTTTCCCGAGAAAATGCTAAG
>TTN-206,ENSE00003802530,1,169,1165232,1165400,GTTAAGTGGTTTAAAGATGGTGCTGAAATTAAAAAGGGCAAAAAATATGACATCATATCCAAGGGAGCAGTGCGCATTCTTGTCATCAACAAATGTCTACTGGATGATGAAGCTGAATATTCCTGTGAAGTAAGGACAGCGAGAACTTCTGGCATGCTGACAGTTCTGG
>TTN-206,ENSE00003811387,1,267,1165401,1165667,AAGAAGAAGCTGTCTTTACCAAAAATCTTGCCAACATTGAAGTTAGTGAAACAGACACTATAAAACTGGTTTGTGAAGTCTCCAAACCTGGCGCAGAAGTGATTTGGTATAAAGGGGATGAGGAGATCATTGAAACAGGAAGATATGAAATACTGACTGAAGGACGGAAGAGAATCCTGGTCATTCAGAACGCTCACCTTGAGGATGCTGGCAACTACAACTGTCGACTCCCAAGCTCTCGAACCGATGGCAAAGTCAAAGTACATG
>TTN-206,ENSE00003802653,1,267,1165668,1165934,AACTGGCTGCTGAATTTATCTCAAAGCCTCAAAACCTTGAAATACTTGAAGGAGAAAAGGCTGAATTTGTCTGCTCTATATCAAAAGAAAGCTTTCCAGTCCAGTGGAAGAGGGATGATAAGACACTTGAATCTGGAGATAAATATGACGTTATTGCTGATGGTAAAAAGAGGGTCCTAGTTGTGAAAGATGCCACATTACAAGATATGGGCACTTACGTTGTCATGGTAGGGGCCGCCAGAGCAGCAGCTCACTTGACAGTCATTG
>TTN-206,ENSE00003802540,1,279,1165935,1166213,AAAAACTCAGGATCGTAGTTCCTCTTAAGGACACCCGGGTGAAGGAACAACAGGAAGTTGTCTTCAACTGTGAAGTCAATACTGAAGGTGCCAAAGCCAAATGGTTCAGAAATGAAGAAGCTATATTTGATAGTTCAAAATACATCATTCTCCAAAAAGACCTAGTCTACACCCTCAGAATTAGAGATGCACACTTAGATGACCAAGCCAACTATAATGTGTCTTTGACCAATCACAGAGGTGAAAATGTTAAAAGTGCAGCCAATCTAATAGTAGAAG
>TTN-206,ENSE00003802874,1,409,1166214,1166622,AGGAAGACCTTAGGATTGTTGAGCCTCTTAAAGATATTGAAACAATGGAGAAGAAATCTGTCACATTCTGGTGCAAGGTGAATCGTCTCAATGTAACACTGAAGTGGACCAAAAATGGTGAAGAAGTGCCTTTTGACAACCGTGTCTCATACAGAGTTGATAAGTACAAGCACATGTTAACCATTAAAGACTGTGGCTTCCCAGATGAAGGTGAATACATTGTCACTGCTGGACAAGATAAATCTGTTGCTGAGCTTCTCATCATAGAAGCCCCGACAGAATTTGTGGAACACTTGGAAGATCAGACAGTCACTGAGTTCGATGACGCTGTCTTCTCCTGCCAGCTCTCCAGAGAGAAAGCCAATGTAAAATGGTACAGAAATGGGAGAGAAATCAAAGAAGGCAAAAA
>TTN-206,ENSE00003804130,1,125,1166623,1166747,ATACAAATTTGAAAAAGATGGAAGTATACACAGACTCATTATAAAAGATTGCAGGCTGGATGATGAGTGTGAATATGCTTGCGGGGTAGAAGACAGGAAGTCTCGTGCTAGACTTTTTGTGGAAG
>TTN-206,ENSE00003807647,1,267,1166748,1167014,AAATTCCTGTTGAGATCATCAGGCCTCCACAAGATATTCTTGAAGCCCCTGGTGCTGATGTTGTCTTTTTAGCAGAACTCAATAAAGATAAGGTGGAAGTCCAATGGCTAAGAAATAACATGGTTGTTGTCCAGGGTGATAAACACCAGATGATGAGTGAAGGAAAGATACATCGACTACAGATTTGTGATATTAAGCCCCGTGACCAGGGTGAATACAGATTTATTGCCAAAGACAAAGAAGCCAGAGCTAAGCTTGAACTGGCAG
>TTN-206,ENSE00003802353,1,270,1167015,1167284,CTGCACCAAAAATCAAGACAGCTGACCAAGACCTTGTGGTTGATGTTGGCAAGCCTCTGACAATGGTGGTGCCATATGATGCCTACCCCAAAGCAGAAGCTGAATGGTTTAAAGAAAATGAACCTTTATCTACAAAAACCATTGATACTACGGCTGAACAAACTTCTTTCAGAATTTTAGAAGCCAAGAAAGGAGACAAAGGGAGGTATAAAATTGTGCTTCAGAACAAACATGGAAAAGCAGAAGGATTCATCAATTTAAAAGTTATTG
>TTN-206,ENSE00003809195,1,303,1167285,1167587,ATGTTCCTGGGCCAGTACGTAACTTAGAAGTGACAGAAACATTTGATGGTGAAGTGAGCCTTGCTTGGGAAGAACCTTTAACTGATGGTGGAAGCAAAATCATAGGTTACGTTGTTGAAAGACGTGACATTAAGAGAAAGACCTGGGTTCTGGCCACAGACCGTGCAGAGAGTTGTGAGTTTACTGTCACTGGTCTACAGAAAGGAGGAGTTGAGTACCTATTCCGTGTGAGTGCAAGAAACAGAGTTGGCACTGGTGAGCCAGTAGAAACTGACAATCCTGTAGAAGCAAGGAGTAAATATG
>TTN-206,ENSE00003803170,1,303,1167588,1167890,ATGTTCCAGGCCCTCCTTTGAATGTAACCATCACTGATGTGAATCGATTTGGTGTCTCACTGACATGGGAACCACCAGAGTATGATGGAGGTGCTGAGATCACAAACTACGTCATTGAATTAAGAGACAAGACTTCTATCAGGTGGGATACTGCCATGACTGTGAGAGCTGAAGACCTGTCTGCAACTGTTACTGATGTGGTAGAAGGACAGGAGTACAGTTTCCGAGTGAGAGCCCAAAATCGAATTGGAGTTGGAAAACCAAGTGCAGCCACACCCTTCGTCAAAGTTGCTGATCCAATTG
>TTN-206,ENSE00003806295,1,188,1167891,1168078,AGAGACCAAGTCCTCCTGTAAACCTAACTTCCTCAGATCAGACTCAGTCATCAGTTCAGCTCAAATGGGAACCTCCTCTGAAAGATGGAGGAAGCCCAATATTAGGCTATATAATTGAGCGATGCGAAGAAGGAAAAGATAATTGGATTCGTTGCAATATGAAACTTGTCCCTGAACTGACTTACAAG
>TTN-206,ENSE00003810732,1,115,1168079,1168193,GTTACCGGATTGGAAAAAGGAAATAAATATTTATATAGAGTATCTGCAGAAAATAAAGCTGGTGTTTCAGATCCATCTGAAATTCTTGGTCCTCTCACCGCTGACGATGCATTTG
>TTN-206,ENSE00003809985,1,285,1168194,1168478,TTGAACCAACAATGGATTTAAGTGCATTTAAAGATGGTCTGGAAGTTATTGTCCCAAATCCTATCACGATCCTGGTTCCAAGTACAGGCTATCCAAGGCCAACTGCAACCTGGTGTTTTGGAGATAAAGTACTAGAAACAGGGGACCGGGTGAAAATGAAGACCTTGTCTGCCTATGCCGAACTTGTCATTTCTCCAAGTGAACGTTCAGACAAGGGCATTTATACACTGAAATTAGAAAACCGTGTGAAAACAATTTCTGGGGAAATTGATGTCAATGTAATTG
>TTN-206,ENSE00003808828,1,152,1168479,1168630,CTCGCCCAAGTGCACCCAAAGAATTGAAATTTGGTGATATAACCAAGGACTCAGTACATTTGACTTGGGAACCACCTGATGATGATGGAGGAAGTCCGTTAACTGGATACGTTGTTGAAAAACGAGAAGTCAGCCGGAAAACATGGACTAAA
>TTN-206,ENSE00003803811,1,148,1168631,1168778,GTTATGGACTTTGTGACTGATCTAGAATTCACAGTTCCTGATCTTGTTCAAGGAAAAGAGTACTTATTTAAAGTTTGTGCTCGTAACAAATGTGGCCCTGGAGAACCTGCATATGTTGATGAACCTGTAAATATGTCAACTCCTGCAA
>TTN-206,ENSE00003803944,1,178,1168779,1168956,CGGTACCTGACCCACCAGAGAATGTTAAATGGAGAGATCGAACAGCCAATAGCATCTTCTTAACATGGGATCCACCTAAAAATGATGGTGGTTCACGCATCAAAGGATATATAGTTGAAAGATGTCCACGTGGTTCTGATAAATGGGTTGCCTGTGGAGAACCTGTTGCAGAAACAAA
>TTN-206,ENSE00003802090,1,122,1168957,1169078,AATGGAAGTGACAGGTCTTGAGGAAGGCAAATGGTATGCCTACCGCGTGAAGGCCTTAAACAGGCAGGGTGCTAGCAAACCAAGCAGACCCACAGAGGAAATCCAGGCTGTGGACACACAAG
>TTN-206,ENSE00003809522,1,288,1169079,1169366,AGGCCCCAGAAATCTTCCTCGATGTGAAGCTCCTTGCTGGTCTCACTGTAAAAGCTGGGACCAAGATTGAACTTCCTGCCACCGTAACCGGAAAACCTGAACCTAAAATAACTTGGACAAAGGCTGATATGATTCTGAAGCAGGACAAAAGAATTACCATTGAAAATGTCCCTAAGAAATCCACAGTGACTATTGTTGATAGTAAGAGAAGTGACACTGGCACATATATCATTGAGGCTGTGAATGTGTGTGGCCGGGCCACTGCTGTGGTGGAAGTGAACGTCTTAG
>TTN-206,ENSE00003804879,1,297,1169367,1169663,ATAAACCCGGACCACCAGCTGCCTTTGACATCACAGATGTAACCAATGAGTCATGTCTTCTAACATGGAACCCACCACGCGATGATGGTGGATCTAAGATCACAAACTATGTTGTGGAGAGACGAGCAACTGATAGTGAAGTGTGGCACAAGCTCTCATCCACCGTCAAGGATACAAACTTCAAGGCCACCAAATTAATCCCCAATAAAGAGTACATCTTCAGAGTTGCTGCAGAAAACATGTATGGTGTTGGTGAACCAGTTCAGGCCTCTCCAATAACAGCCAAATATCAGTTTG
>TTN-206,ENSE00003809410,1,187,1169664,1169850,ATCCACCTGGTCCTCCAACTCGCCTAGAACCTTCTGATATCACTAAAGACGCAGTGACTCTCACATGGTGTGAGCCAGATGATGATGGTGGCAGCCCAATCACAGGATACTGGGTTGAAAGACTGGATCCTGATACAGATAAATGGGTTAGATGCAATAAGATGCCAGTAAAGGACACAACATACAG
>TTN-206,ENSE00003808827,1,116,1169851,1169966,AGTGAAAGGTCTCACTAATAAGAAAAAATACAGATTCCGTGTGTTGGCTGAAAATCTTGCTGGACCTGGAAAACCAAGCAAATCAACTGAACCAATCTTAATAAAGGATCCCATAG
>TTN-206,ENSE00003806136,1,300,1169967,1170266,ATCCTCCATGGCCCCCTGGAAAACCAACTGTAAAAGATGTAGGCAAAACATCAGTAAGGTTGAATTGGACAAAACCAGAACATGATGGAGGTGCAAAGATTGAGTCTTATGTCATTGAAATGCTGAAGACTGGAACAGATGAGTGGGTCAGAGTGGCGGAAGGGGTTCCCACCACTCAGCACTTGCTCCCAGGGCTCATGGAAGGACAGGAATACTCATTCCGAGTTAGAGCTGTGAATAAGGCTGGGGAAAGTGAACCCAGTGAACCCAGTGACCCTGTGCTTTGCCGGGAGAAGCTAT
>TTN-206,ENSE00003804290,1,300,1170267,1170566,ATCCTCCATCACCACCACGCTGGCTTGAAGTTATTAATATCACAAAAAATACAGCAGACCTAAAATGGACAGTTCCTGAGAAAGATGGAGGGTCCCCCATCACCAACTACATTGTGGAAAAGAGAGACGTCAGGCGAAAAGGCTGGCAAACAGTGGATACCACTGTCAAGGACACCAAGTGCACAGTCACCCCACTGACTGAGGGCTCTTTATATGTGTTCCGAGTTGCTGCAGAAAATGCTATAGGACAAAGCGACTACACCGAAATTGAGGACTCTGTGCTGGCCAAAGACACCTTTA
>TTN-206,ENSE00003803723,1,106,1170567,1170672,CCACTCCTGGACCACCCTACGCCCTGGCAGTGGTTGATGTGACAAAACGACATGTTGACCTAAAGTGGGAGCCACCTAAAAATGATGGTGGAAGACCAATACAGAG
>TTN-206,ENSE00003805819,1,197,1170673,1170869,ATATGTCATTGAGAAGAAAGAAAGGTTAGGTACCCGTTGGGTGAAAGCTGGAAAGACTGCAGGACCTGACTGTAACTTCAGAGTAACTGATGTCATCGAAGGAACAGAGGTCCAGTTTCAGGTTCGGGCTGAAAATGAAGCTGGAGTTGGCCACCCAAGTGAACCCACAGAAATCCTATCCATTGAAGATCCAACAA
>TTN-206,ENSE00003806467,1,306,1170870,1171175,GTCCTCCCTCACCACCCCTTGACCTACATGTGACTGATGCTGGGAGAAAACACATTGCCATTGCTTGGAAGCCTCCAGAGAAAAATGGTGGAAGTCCTATCATAGGATACCATGTTGAAATGTGTCCAGTAGGCACTGAGAAATGGATGAGAGTTAATTCTCGCCCAATAAAGGACTTGAAATTCAAGGTTGAAGAAGGTGTTGTTCCTGACAAAGAATATGTCCTGAGAGTGAGAGCAGTCAATGCTATTGGTGTCAGCGAGCCATCTGAAATCTCTGAAAATGTGGTTGCCAAAGACCCAGACT
>TTN-206,ENSE00003808061,1,279,1171176,1171454,GCAAGCCAACAATTGACCTGGAGACTCATGACATTATTGTTATTGAAGGTGAAAAGTTAAGCATTCCTGTTCCCTTCAGAGCTGTCCCAGTTCCAACTGTTAGTTGGCATAAAGATGGCAAAGAAGTTAAAGCAAGTGATAGATTAACAATGAAGAATGATCACATCTCTGCACACCTTGAAGTTCCCAAGAGTGTCCGTGCAGATGCCGGAATTTATACCATTACACTGGAGAATAAGCTCGGCTCAGCAACAGCCTCAATCAATGTCAAAGTCATAG
>TTN-206,ENSE00003811164,1,300,1171455,1171754,GCCTACCTGGACCATGCAAAGATATTAAAGCAAGTGACATTACCAAGAGTTCTTGTAAGTTAACTTGGGAACCTCCAGAATTTGATGGTGGAACCCCAATTCTTCATTATGTCCTGGAGCGCAGAGAAGCTGGGAGGAGAACATATATACCAGTCATGTCTGGTGAGAACAAACTGTCATGGACTGTGAAGGATCTCATACCAAATGGTGAATACTTCTTCCGTGTTAAAGCAGTCAACAAGGTTGGTGGAGGAGAATATATTGAACTGAAAAATCCAGTCATTGCTCAAGATCCAAAGC
>TTN-206,ENSE00003805132,1,303,1171755,1172057,AACCCCCTGATCCACCTGTAGATGTAGAGGTTCATAATCCTACAGCGGAGGCAATGACTATTACATGGAAGCCACCTTTGTATGATGGAGGGAGCAAGATAATGGGCTACATCATAGAGAAGATTGCTAAGGGTGAAGAAAGGTGGAAGAGATGCAATGAACACCTGGTACCAATCCTGACCTATACAGCAAAAGGACTTGAAGAGGGGAAAGAGTACCAATTCCGTGTGCGAGCAGAGAACGCCGCGGGTATTAGTGAACCTTCTCGGGCTACTCCTCCAACCAAAGCTGTAGATCCCATTG
>TTN-206,ENSE00003805056,1,363,1172058,1172420,ATGCCCCCAAAGTCATTCTGAGAACAAGCCTAGAAGTGAAACGAGGTGATGAAATAGCACTTGATGCAAGTATTTCTGGATCACCTTACCCAACTATTACATGGATAAAGGATGAAAATGTTATTGTACCAGAGGAAATTAAGAAGCGTGCAGCACCCTTGGTTAGGAGAAGGAAGGGTGAAGTTCAAGAAGAAGAACCATTTGTCCTGCCTCTGACACAGCGTTTGAGTATTGACAACAGCAAAAAGGGAGAATCTCAGCTACGCGTCCGAGATTCTCTCCGACCTGACCATGGTCTGTATATGATCAAAGTTGAAAATGACCACGGTATTGCAAAAGCTCCTTGTACTGTCAGTGTGTTAG
>TTN-206,ENSE00003811138,1,303,1172421,1172723,ATACACCGGGACCACCAATCAACTTTGTATTTGAAGATATCAGAAAGACCTCAGTCCTTTGTAAATGGGAACCACCCCTTGATGATGGTGGCAGTGAAATCATAAACTACACTTTGGAAAAGAAAGACAAGACAAAACCCGACTCAGAATGGATTGTTGTCACTTCAACACTTAGACATTGCAAATATTCAGTAACAAAACTGATTGAAGGAAAAGAGTACCTCTTCCGTGTAAGAGCTGAAAACAGATTTGGGCCAGGTCCACCATGTGTTTCAAAGCCACTTGTGGCTAAAGATCCATTTG
>TTN-206,ENSE00003809346,1,300,1172724,1173023,GACCACCTGATGCACCAGATAAGCCCATTGTGGAAGATGTTACCAGCAACAGTATGCTAGTGAAATGGAATGAACCAAAAGATAATGGAAGCCCCATTTTGGGTTACTGGCTTGAAAAACGTGAAGTTAACAGTACACATTGGTCTCGTGTCAACAAAAGCCTTCTGAATGCCTTGAAAGCCAATGTAGATGGCTTATTAGAAGGACTCACCTATGTCTTCAGAGTATGTGCTGAAAATGCAGCTGGACCTGGAAAGTTCAGTCCACCTTCAGATCCCAAAACAGCACATGATCCAATCT
>TTN-206,ENSE00003806782,1,297,1173024,1173320,CTCCTCCTGGGCCACCTATCCCAAGAGTCACTGACACAAGCTCTACAACTATTGAACTAGAATGGGAACCCCCAGCTTTCAATGGTGGTGGGGAAATTGTTGGCTATTTTGTTGATAAGCAGTTGGTTGGCACAAATGAATGGTCACGCTGCACAGAGAAGATGATCAAGGTCCGTCAGTACACCGTCAAAGAAATCCGAGAGGGTGCTGATTACAAACTTCGGGTGAGTGCTGTCAATGCCGCAGGGGAAGGACCGCCTGGAGAAACACAACCTGTTACTGTGGCTGAACCACAAG
>TTN-206,ENSE00003804121,1,285,1173321,1173605,AGCCTCCAGCTGTGGAACTGGATGTTTCTGTCAAGGGTGGAATACAAATAATGGCTGGGAAGACTCTTAGAATTCCAGCTGTGGTGACTGGTCGCCCTGTACCTACAAAAGTATGGACCAAAGAAGAAGGGGAGCTGGATAAAGACCGTGTTGTAATAGACAACGTTGGAACCAAATCTGAACTAATTATCAAGGATGCACTGCGAAAAGACCATGGCAGATATGTGATTACAGCTACAAATAGCTGTGGTTCCAAATTTGCAGCAGCCAGGGTAGAAGTTTTTG
>TTN-206,ENSE00003804454,1,294,1173606,1173899,ATGTCCCTGGTCCAGTTCTTGACTTAAAACCTGTTGTAACAAACAGAAAAATGTGTCTACTTAACTGGTCTGATCCAGAAGATGATGGAGGAAGTGAAATAACAGGCTTTATCATTGAAAGAAAAGATGCCAAGATGCATACTTGGAGACAACCAATAGAGACTGAGAGATCTAAATGTGACATCACAGGTCTGCTTGAGGGACAAGAATATAAGTTCCGTGTTATTGCCAAGAACAAGTTTGGCTGTGGCCCTCCTGTTGAAATAGGACCAATTCTTGCAGTTGATCCACTAG
>TTN-206,ENSE00003803420,1,300,1173900,1174199,GTCCTCCAACATCTCCAGAGAGGCTCACATACACTGAAAGGACAAAGTCCACTATCACACTTGACTGGAAAGAGCCCCGCAGTAATGGTGGCAGTCCCATCCAAGGATATATCATTGAAAAACGGCGTCATGACAAACCTGACTTTGAAAGAGTTAACAAGCGACTCTGCCCAACCACATCTTTTCTGGTTGAAAATCTTGATGAACACCAAATGTATGAGTTCCGTGTCAAAGCTGTCAATGAAATTGGTGAAAGTGAACCATCCCTACCTCTTAATGTAGTCATACAAGATGATGAAG
>TTN-206,ENSE00003809028,1,309,1174200,1174508,TGCCTCCAACTATTAAGTTGCGTCTGAGTGTTCGAGGAGACACTATCAAAGTTAAGGCAGGAGAGCCTGTCCACATCCCTGCAGATGTGACAGGCCTTCCAATGCCTAAGATTGAATGGTCCAAAAATGAAACTGTAATTGAAAAACCCACTGATGCACTTCAGATAACCAAGGAAGAGGTATCCCGAAGTGAGGCAAAAACTGAGCTTAGCATTCCCAAAGCGGTCCGGGAGGACAAAGGCACTTACACAGTTACTGCTTCCAATCGCCTTGGCTCAGTGTTCCGAAATGTTCACGTTGAAGTATATG
>TTN-206,ENSE00003801894,1,191,1174509,1174699,ACCGCCCATCCCCACCAAGAAATCTTGCTGTTACTGACATTAAAGCTGAATCTTGCTACTTGACATGGGATGCCCCTCTTGATAATGGTGGCAGTGAAATCACCCATTATGTTATTGACAAACGTGATGCAAGTAGGAAGAAAGCAGAATGGGAGGAAGTCACCAACACTGCTGTAGAGAAAAGATATGGG
>TTN-206,ENSE00003809851,1,430,1174700,1175129,ATCTGGAAACTTATCCCCAATGGTCAGTATGAGTTCCGAGTCAGGGCAGTGAATAAATATGGAATCAGTGATGAGTGCAAATCAGATAAAGTAGTCATTCAAGATCCTTATCGCCTTCCTGGACCTCCAGGAAAACCAAAAGTTTTGGCACGCACCAAAGGATCAATGCTAGTGAGCTGGACTCCTCCTTTGGACAATGGTGGCTCTCCAATTACTGGCTACTGGCTGGAGAAAAGAGAAGAGGGAAGTCCTTATTGGTCACGTGTTAGCCGAGCACCAATAACCAAAGTGGGATTGAAAGGCGTGGAATTTAATGTTCCTCGTTTGCTTGAAGGCGTTAAATACCAGTTCAGAGCCATGGCAATAAATGCTGCAGGAATTGGTCCTCCCAGTGAACCATCAGATCCAGAGGTTGCAGGAGATCCCATAT
>TTN-206,ENSE00003808594,1,309,1175130,1175438,TTCCACCGGGGCCACCTTCTTGCCCAGAAGTTAAAGATAAAACGAAGTCAAGCATCTCACTAGGATGGAAACCTCCAGCCAAAGATGGTGGCAGCCCAATCAAAGGATACATTGTAGAAATGCAAGAAGAAGGTACTACTGACTGGAAAAGAGTAAATGAACCAGACAAACTTATAACTACCTGTGAATGTGTGGTGCCTAATCTGAAAGAGCTCAGGAAGTACAGATTCAGAGTGAAAGCTGTCAATGAAGCTGGTGAATCTGAACCAAGTGATACAACTGGGGAGATCCCTGCCACTGATATTCAAG
>TTN-206,ENSE00003810473,1,149,1175439,1175587,AGGAACCAGAAGTTTTCATTGACATTGGAGCACAGGACTGTCTGGTTTGTAAAGCTGGCTCACAGATTAGGATTCCTGCTGTCATCAAGGGACGCCCAACACCAAAATCATCTTGGGAATTTGATGGAAAGGCAAAGAAAGCAATGAAG
>TTN-206,ENSE00003801625,1,33,1175588,1175620,GATGGAGTTCATGACATACCCGAAGATGCACAG
>TTN-206,ENSE00003802643,1,130,1175621,1175750,CTGGAGACTGCTGAAAACTCCTCAGTAATTATTATTCCGGAGTGTAAACGATCTCATACAGGCAAATACAGCATCACAGCCAAGAATAAAGCAGGACAAAAGACTGCAAATTGCAGAGTTAAAGTCATGG
>TTN-206,ENSE00003804239,1,300,1175751,1176050,ATGTACCAGGCCCACCCAAAGATCTGAAAGTCAGTGATATCACAAGGGGTAGTTGCAGACTTTCATGGAAGATGCCAGACGACGATGGAGGAGACAGGATCAAAGGCTATGTTATTGAGAAGAGGACTATTGATGGAAAAGCCTGGACCAAAGTCAATCCAGACTGTGGAAGCACCACATTTGTAGTGCCTGATCTCCTCTCTGAACAGCAATATTTCTTCCGTGTGCGAGCAGAAAACCGTTTTGGTATTGGCCCACCTGTGGAAACCATTCAGAGGACCACTGCCAGAGATCCGATAT
>TTN-206,ENSE00003806278,1,318,1176051,1176368,ATCCTCCTGATCCTCCTATTAAACTCAAGATTGGCCTCATCACAAAGAACACAGTGCATCTGTCATGGAAACCCCCGAAGAATGATGGGGGCTCCCCTGTTACCCACTATATTGTTGAGTGCCTTGCATGGGACCCTACTGGGACAAAGAAAGAAGCCTGGAGGCAGTGCAATAAGCGTGATGTGGAAGAACTGCAATTTACTGTTGAAGACCTAGTAGAGGGTGGGGAATATGAATTCCGAGTCAAAGCTGTCAATGCTGCAGGAGTCAGCAAGCCTTCAGCCACTGTTGGCCCTGTGACTGTCAAAGACCAGACAT
>TTN-206,ENSE00003801391,1,297,1176369,1176665,GCCCACCATCAATTGATCTAAAAGAATTCATGGAGGTTGAAGAAGGAACCAATGTTAACATTGTGGCCAAAATTAAAGGTGTGCCATTCCCGACACTAACCTGGTTTAAAGCTCCTCCAAAGAAGCCTGATAACAAAGAACCTGTTCTCTATGACACCCATGTCAACAAACTGGTGGTAGATGATACTTGCACTTTAGTTATTCCGCAGTCTCGCAGGAGTGACACTGGCTTATATACCATCACAGCTGTAAATAATCTGGGAACAGCATCAAAGGAGATGAGACTGAATGTCCTGG
>TTN-206,ENSE00003806021,1,300,1176666,1176965,GTCGTCCTGGCCCTCCAGTGGGACCCATAAAATTTGAATCTGTTTCAGCAGATCAAATGACACTATCTTGGTTTCCACCTAAAGATGATGGTGGGTCTAAGATTACAAACTATGTAATTGAGAAAAGAGAAGCTAACAGGAAGACATGGGTCCATGTCTCCAGTGAACCTAAGGAGTGCACGTACACGATTCCCAAATTGCTAGAAGGCCATGAATATGTATTCCGAATCATGGCCCAGAATAAATATGGCATTGGAGAACCTCTTGACAGTGAACCTGAAACAGCAAGAAACCTCTTCT
>TTN-206,ENSE00003803442,1,315,1176966,1177280,CTGTCCCTGGAGCACCAGATAAACCAACAGTTAGCAGCGTGACTCGTAACTCCATGACTGTCAACTGGGAAGAGCCAGAATATGATGGAGGCTCTCCTGTGACAGGGTACTGGCTGGAAATGAAAGACACCACTTCAAAGAGATGGAAGAGAGTTAACCGAGATCCTATCAAAGCCATGACTTTGGGTGTTTCTTATAAAGTGACTGGTCTTATTGAAGGTTCCGACTATCAATTCCGGGTATATGCAATCAATGCTGCTGGCGTGGGTCCAGCAAGTCTGCCATCAGACCCAGCGACTGCTAGAGATCCAATTG
>TTN-206,ENSE00003801787,1,149,1177281,1177429,CCCCTCCTGGTCCTCCATTTCCCAAAGTGACAGATTGGACTAAATCATCTGCAGATCTGGAGTGGTCTCCCCCACTAAAAGATGGTGGATCCAAAGTAACTGGATACATCGTTGAATATAAAGAAGAAGGAAAAGAAGAATGGGAAAAG
>TTN-206,ENSE00003802004,1,151,1177430,1177580,GGTAAAGATAAAGAAGTGAGAGGAACAAAGCTTGTTGTGACAGGATTAAAGGAAGGAGCATTCTACAAATTTAGAGTTAGAGCAGTCAACATTGCTGGCATTGGAGAACCTGGAGAGGTCACAGATGTCATTGAAATGAAGGACAGACTTG
>TTN-206,ENSE00003808790,1,282,1177581,1177862,TTTCACCTGACCTTCAGCTAGATGCCAGTGTCAGAGATAGAATTGTTGTCCATGCTGGAGGGGTGATCCGAATCATTGCCTATGTGTCTGGAAAGCCTCCTCCAACCGTCACCTGGAACATGAATGAAAGAACCTTACCTCAAGAAGCCACCATTGAGACCACAGCCATTAGCTCATCCATGGTCATCAAGAACTGCCAGAGGAGCCATCAAGGCGTCTATTCTCTTCTTGCCAAAAATGAAGCCGGAGAAAGAAAGAAGACAATTATTGTTGATGTATTAG
>TTN-206,ENSE00003807896,1,303,1177863,1178165,ATGTTCCAGGTCCCGTTGGAACACCATTCCTAGCTCACAACCTAACCAATGAGTCCTGCAAACTGACATGGTTTTCTCCAGAAGATGATGGAGGCTCTCCAATCACCAATTATGTCATTGAAAAGCGTGAATCTGACCGCAGAGCATGGACCCCAGTGACATATACAGTTACCCGACAAAATGCTACTGTCCAGGGTCTCATTCAAGGAAAAGCCTACTTTTTCCGAATTGCGGCTGAAAATAGTATTGGCATGGGTCCATTTGTTGAGACATCAGAGGCACTTGTTATCAGAGAGCCAATAA
>TTN-206,ENSE00003801753,1,303,1178166,1178468,CTGTACCAGAGCGTCCTGAAGACCTGGAAGTCAAAGAAGTTACTAAAAATACTGTAACTTTGACTTGGAATCCTCCTAAGTATGATGGTGGGTCAGAAATTATTAACTATGTCCTAGAAAGTCGGCTCATTGGGACTGAGAAGTTCCACAAAGTTACAAATGACAACTTGCTTAGCAGAAAATACACTGTTAAAGGCTTAAAAGAAGGTGATACCTATGAGTACCGTGTCAGTGCTGTCAACATTGTTGGACAAGGCAAACCATCATTTTGCACCAAACCAATTACTTGCAAGGATGAGCTGG
>TTN-206,ENSE00003807039,1,282,1178469,1178750,CACCCCCAACGCTTCACCTCGACTTCAGAGATAAGCTCACGATTCGAGTTGGTGAAGCTTTTGCCCTCACTGGCCGTTACTCAGGCAAACCAAAGCCTAAGGTTTCCTGGTTCAAAGATGAAGCTGATGTGCTGGAAGATGATCGCACTCATATAAAGACTACACCAGCAACACTTGCTTTAGAGAAGATCAAGGCCAAACGTTCAGATTCCGGCAAATACTGTGTGGTTGTGGAGAACAGTACAGGCTCTAGGAAAGGTTTCTGTCAAGTTAATGTTGTTG
>TTN-206,ENSE00003804106,1,300,1178751,1179050,ACCGTCCTGGACCACCAGTAGGACCAGTTAGTTTTGATGAGGTGACCAAAGATTACATGGTTATCTCTTGGAAGCCTCCTTTAGATGATGGAGGCAGTAAAATCACCAATTATATTATTGAGAAGAAGGAAGTGGGTAAAGACGTCTGGATGCCAGTGACATCTGCAAGTGCTAAAACAACATGCAAAGTTTCTAAACTACTTGAAGGAAAAGATTATATTTTCCGGATACATGCTGAAAATCTGTATGGAATAAGTGATCCTCTGGTGTCTGATTCAATGAAAGCCAAAGATCGTTTCA
>TTN-206,ENSE00003801817,1,303,1179051,1179353,GGGTTCCTGATGCACCTGATCAGCCAATTGTTACAGAAGTTACCAAAGACTCTGCATTAGTAACCTGGAATAAGCCACATGATGGAGGAAAACCCATCACAAACTACATCCTGGAAAAGAGAGAAACTATGTCTAAACGATGGGCTAGAGTTACCAAAGATCCTATTCATCCATACACTAAATTTAGGGTTCCTGATCTTCTAGAAGGATGTCAGTATGAATTCCGGGTTTCTGCAGAAAATGAAATTGGTATTGGAGATCCAAGCCCACCATCCAAACCAGTCTTTGCTAAAGATCCAATTG
>TTN-206,ENSE00003810564,1,309,1179354,1179662,CTAAACCAAGTCCACCTGTTAATCCTGAAGCAATAGATACAACATGCAATTCAGTCGATCTAACTTGGCAGCCACCACGTCATGATGGTGGGAGCAAGATTCTGGGTTATATTGTTGAGTACCAGAAAGTTGGAGATGAAGAGTGGAGAAGAGCCAATCACACCCCTGAGTCATGTCCTGAAACTAAATATAAAGTCACCGGTCTTCGGGACGGTCAAACCTATAAGTTTAGAGTGTTAGCAGTCAATGCAGCTGGTGAATCAGATCCAGCTCATGTTCCGGAGCCAGTCCTAGTAAAAGACAGGCTTG
>TTN-206,ENSE00003807476,1,282,1179663,1179944,AACCCCCTGAGTTGATTCTTGATGCCAACATGGCAAGAGAACAACACATTAAAGTTGGTGATACTCTAAGACTTAGTGCCATCATCAAAGGAGTGCCATTCCCAAAAGTAACTTGGAAAAAAGAAGACAGAGATGCTCCAACTAAAGCAAGAATTGATGTGACTCCAGTTGGTAGCAAGCTTGAAATTCGTAATGCTGCCCATGAAGATGGTGGAATTTATTCTTTAACAGTGGAGAATCCAGCTGGTTCAAAAACTGTCTCAGTAAAAGTACTTGTATTAG
>TTN-206,ENSE00003807363,1,300,1179945,1180244,ATAAACCTGGGCCACCTAGAGATCTGGAAGTCAGTGAAATTAGGAAAGATTCATGTTACCTTACTTGGAAAGAACCACTGGATGATGGTGGTTCTGTTATTACCAATTATGTGGTTGAGAGGAGAGATGTTGCCAGCGCCCAGTGGTCACCTCTCTCAGCTACATCAAAGAAAAAGAGTCACTTCGCTAAGCATCTGAATGAAGGCAACCAGTACCTCTTCCGAGTAGCTGCGGAGAACCAGTATGGACGTGGTCCTTTTGTTGAAACACCAAAACCAATCAAGGCTTTGGATCCTCTCC
>TTN-206,ENSE00003808994,1,294,1180245,1180538,ATCCCCCAGGGCCACCCAAGGACCTGCACCATGTAGATGTTGACAAGACTGAAGTCTCCCTAGTCTGGAATAAGCCGGATCGTGATGGTGGTTCTCCAATCACTGGATATTTGGTAGAATATCAAGAAGAAGGCACCCAGGACTGGATTAAATTTAAGACTGTGACAAACTTAGAGTGTGTGGTTACTGGACTACAACAAGGAAAGACCTATAGATTCCGTGTAAAAGCTGAAAACATTGTGGGTCTTGGTCTCCCTGACACAACTATCCCGATAGAATGTCAAGAAAAACTAG
>TTN-206,ENSE00003810188,1,2967,1180539,1183505,TGCCTCCATCCGTGGAGCTAGATGTGAAATTAATTGAAGGTCTTGTGGTAAAGGCTGGAACCACAGTCAGATTCCCTGCTATTATAAGAGGTGTGCCTGTTCCTACTGCAAAGTGGACAACCGATGGGAGTGAGATTAAAACCGATGAGCACTACACAGTTGAAACAGACAACTTCTCATCAGTACTTACCATTAAGAACTGCTTAAGGAGAGACACTGGGGAATATCAAATCACAGTTTCCAATGCAGCCGGTAGCAAAACAGTAGCCGTACATCTTACTGTTCTTGATGTTCCTGGGCCACCAACAGGTCCTATTAATATTCTGGATGTTACTCCTGAACACATGACTATCTCATGGCAGCCACCTAAGGATGATGGAGGAAGCCCTGTGATAAATTATATTGTTGAGAAACAAGATACAAGGAAAGACACGTGGGGTGTTGTCTCTTCCGGAAGCAGTAAGACAAAGCTGAAAATCCCACATCTGCAGAAGGGCTGTGAATATGTTTTCCGAGTTAGAGCAGAGAATAAGATAGGTGTTGGTCCTCCCCTTGACTCCACACCTACTGTTGCTAAGCATAAATTTAGTCCTCCGTCTCCTCCTGGTAAACCAGTGGTTACTGACATTACTGAAAATGCAGCAACAGTGTCTTGGACCCTGCCAAAATCTGATGGTGGCAGTCCAATAACTGGCTACTATATGGAACGTCGAGAAGTAACTGGCAAATGGGTGAGGGTCAACAAAACACCTATCGCTGACCTGAAGTTCAGAGTGACTGGACTCTATGAAGGAAATACATATGAGTTTAGAGTTTTTGCTGAAAATCTTGCAGGACTAAGCAAACCATCCCCAAGTTCTGATCCAATAAAAGCTTGCCGGCCCATCAAACCACCTGGACCACCTATTAATCCTAAACTGAAAGACAAGAGCAGAGAAACAGCTGATTTGGTGTGGACAAAGCCTCTCAGTGATGGTGGTAGCCCCATTCTAGGATATGTAGTGGAATGTCAGAAACCTGGCACAGCACAATGGAACAGGATTAATAAAGATGAACTCATTAGGCAATGTGCCTTTAGGGTACCTGGACTAATTGAAGGAAATGAGTACAGATTCCGTATAAAGGCAGCTAATATTGTAGGAGAGGGTGAGCCAAGAGAACTAGCAGAATCTGTGATTGCAAAAGATATCCTTCATCCTCCAGAAGTAGAACTTGATGTTACTTGTCGTGATGTTATTACCGTGAGAGTAGGCCAAACTATCCGCATTCTAGCTCGAGTCAAAGGCAGACCTGAACCAGACATAACTTGGACTAAGGAAGGCAAAGTATTGGTCCGAGAAAAGAGGGTGGACCTTATTCAGGATCTACCTCGTGTTGAGTTACAAATTAAAGAAGCTGTTAGAGCTGATCATGGCAAGTATATCATCTCAGCTAAGAACAGCAGTGGACATGCCCAAGGTTCAGCCATCGTTAACGTCCTTGACAGACCTGGGCCTTGCCAGAATTTGAAGGTTACCAATGTAACCAAAGAGAACTGTACAATTTCTTGGGAAAACCCACTAGATAATGGTGGCTCAGAAATAACAAACTTCATAGTAGAATATCGCAAACCAAACCAGAAAGGCTGGTCAATTGTTGCATCAGATGTCACTAAACGATTAATCAAGGCCAACCTTTTAGCCAACAATGAATACTATTTCCGAGTTTGTGCAGAGAATAAAGTAGGTGTTGGGCCAACCATCGAAACAAAAACTCCCATTCTGGCTATTAACCCTATTGACAGACCAGGTGAGCCTGAAAACCTTCACATTGCAGATAAAGGAAAGACATTTGTCTATCTAAAGTGGCGGAGGCCTGACTATGATGGTGGCAGTCCAAATCTGTCATATCATGTTGAGAGAAGGCTTAAGGGCTCCGATGACTGGGAAAGAGTGCATAAAGGAAGCATTAAAGAAACTCACTACATGGTTGACAGATGTGTTGAAAACCAGATTTATGAGTTCAGAGTGCAAACAAAGAATGAAGGTGGGGAAAGTGACTGGGTGAAGACAGAGGAAGTTGTTGTGAAAGAAGACTTACAAAAACCAGTACTTGATCTGAAATTAAGTGGGGTCCTAACTGTCAAAGCAGGGGACACCATTAGGCTTGAGGCAGGGGTTAGAGGCAAACCATTCCCAGAAGTTGCATGGACCAAGGACAAAGACGCTACAGACTTAACAAGATCACCAAGGGTCAAGATTGATACCCGTGCTGATTCATCTAAATTTTCTCTTACTAAAGCAAAGCGAAGTGATGGGGGTAAATATGTAGTTACGGCAACTAACACGGCTGGCAGTTTTGTGGCCTATGCCACTGTCAATGTTTTAGATAAGCCTGGTCCTGTGAGAAATCTGAAAATTGTTGATGTGTCCAGTGATAGGTGTACTGTTTGCTGGGATCCACCAGAAGATGATGGTGGCTGTGAAATCCAAAATTATATTCTAGAAAAATGTGAGACAAAGCGAATGGTTTGGTCTACCTATTCTGCTACTGTCTTGACACCTGGTACTACAGTAACACGTCTCATAGAAGGAAATGAATATATTTTCAGAGTCCGTGCAGAAAATAAAATAGGCACAGGGCCTCCAACAGAAAGTAAACCAGTCATAGCCAAAACCAAGTATGATAAACCTGGTCGCCCTGATCCCCCAGAAGTCACTAAAGTAAGCAAAGAAGAGATGACTGTGGTTTGGAATCCACCTGAATATGATGGTGGAAAGTCTATAACTGGATACTTTTTGGAGAAAAAGGAAAAGCATTCAACACGATGGGTCCCTGTCAACAAGAGTGCAATCCCTGAGAGACGTATGAAAGTACAGAATCTCCTCCCAGACCATGAATATCAGTTCCGTGTCAAGGCAGAAAATGAAATTGGAATTGGAGAACCAAGCTTGCCTTCAAGACCGGTGGTGGCAAAAGACCCCATAG
>TTN-206,ENSE00003811401,1,321,1183506,1183826,AGCCACCTGGTCCACCAACCAATTTCAGAGTGGTTGATACAACCAAACATTCCATAACTCTTGGGTGGGGAAAACCAGTCTATGATGGTGGTGCACCGATCATTGGATATGTTGTGGAAATGAGACCAAAAATAGCAGATGCGTCTCCTGATGAAGGCTGGAAACGGTGTAATGCTGCAGCACAGCTTGTACGCAAGGAATTCACTGTTACCAGCTTGGATGAAAACCAGGAATATGAGTTCAGGGTGTGTGCCCAAAACCAAGTTGGTATTGGGCGCCCTGCAGAGCTAAAGGAAGCTATCAAACCTAAAGAAATACTAG
>TTN-206,ENSE00003805661,1,285,1183827,1184111,AACCTCCGGAGATTGATTTGGATGCCAGCATGAGGAAACTGGTCATAGTGAGAGCAGGATGCCCTATTCGTCTCTTTGCTATAGTGAGAGGACGACCAGCCCCTAAAGTCACTTGGCGAAAAGTTGGCATTGATAATGTGGTCAGAAAAGGACAAGTTGATCTGGTTGACACTATGGCCTTCCTTGTCATCCCCAATTCTACCCGTGATGACTCAGGAAAATATTCCTTAACACTTGTGAACCCAGCAGGAGAAAAGGCTGTATTCGTAAATGTCAGAGTATTAG
>TTN-206,ENSE00003804742,1,300,1184112,1184411,ACACTCCTGGGCCTGTGTCTGATTTAAAAGTTTCAGATGTCACTAAAACATCATGCCATGTGTCCTGGGCCCCTCCTGAAAACGACGGTGGGAGCCAAGTGACACATTATATCGTGGAGAAACGTGAGGCAGACAGAAAGACATGGTCGACCGTTACCCCAGAAGTTAAGAAAACAAGCTTCCATGTAACCAATCTTGTCCCTGGGAATGAGTATTACTTCAGAGTAACTGCTGTCAACGAATATGGCCCTGGCGTCCCAACAGATGTCCCAAAACCAGTGCTTGCATCAGATCCTCTAA
>TTN-206,ENSE00003810357,1,303,1184412,1184714,GTGAGCCGGATCCCCCAAGGAAATTAGAAGTGACTGAAATGACCAAGAACAGTGCCACCTTAGCCTGGTTACCTCCCCTACGTGATGGAGGTGCTAAAATCGATGGCTACATCACTAGTTACAGAGAAGAAGAGCAGCCTGCAGATCGCTGGACAGAGTACTCAGTGGTAAAAGATCTGAGCCTTGTTGTCACTGGCCTAAAGGAAGGAAAGAAATACAAATTTAGAGTAGCGGCCAGAAATGCTGTTGGAGTCAGTTTGCCAAGAGAAGCTGAAGGAGTGTATGAAGCCAAAGAACAACTGT
>TTN-206,ENSE00003801707,1,276,1184715,1184990,TGCCACCAAAGATCCTTATGCCAGAGCAAATAACTATCAAAGCTGGGAAAAAACTCCGAATTGAAGCCCATGTGTATGGAAAGCCTCATCCCACCTGTAAATGGAAAAAAGGAGAAGATGAAGTTGTCACATCCAGCCACCTGGCAGTGCATAAAGCAGACAGCTCTTCAATTCTGATCATAAAAGATGTGACTAGGAAAGACAGTGGTTACTACAGCCTCACAGCAGAGAACAGTTCTGGGACAGACACTCAGAAAATCAAAGTTGTAGTCATGG
>TTN-206,ENSE00003810399,1,300,1184991,1185290,ATGCCCCCGGCCCCCCTCAGCCTCCATTTGACATTTCTGATATAGACGCTGATGCTTGCTCCCTGTCATGGCACATCCCTCTGGAGGACGGAGGCAGTAACATCACCAATTATATAGTGGAGAAGTGTGATGTAAGCCGAGGTGACTGGGTCACGGCTCTAGCTTCAGTCACAAAAACTTCCTGCAGGGTTGGAAAGCTGATCCCAGGCCAGGAGTACATCTTCCGGGTCCGTGCTGAAAACCGATTTGGCATTTCAGAGCCTCTCACATCTCCAAAGATGGTTGCGCAGTTCCCATTTG
>TTN-206,ENSE00003810448,1,303,1185291,1185593,GTGTTCCTAGTGAACCAAAGAATGCACGAGTCACCAAAGTCAACAAGGACTGTATTTTTGTTGCTTGGGACAGACCAGATAGTGATGGAGGGAGCCCCATTATTGGTTATCTGATTGAACGCAAGGAAAGAAACAGTTTGCTGTGGGTGAAAGCCAATGATACTCTTGTCCGGTCAACTGAATATCCTTGTGCTGGCCTTGTAGAAGGTCTTGAGTATTCATTCAGAATCTATGCCCTAAACAAAGCTGGATCCAGCCCACCCAGCAAACCCACAGAATATGTAACTGCAAGAATGCCAGTTG
>TTN-206,ENSE00003802505,1,300,1185594,1185893,ATCCTCCTGGGAAACCTGAGGTTATTGATGTCACCAAGAGTACTGTATCTCTGATCTGGGCTCGTCCAAAGCATGATGGAGGCAGTAAAATTATTGGCTATTTCGTAGAAGCTTGCAAACTTCCTGGTGATAAATGGGTACGGTGCAATACTGCACCTCACCAGATTCCCCAGGAAGAGTACACAGCTACTGGCCTAGAAGAGAAAGCTCAGTATCAATTTAGAGCTATTGCCAGGACCGCGGTAAACATTAGCCCACCTTCTGAACCTTCTGATCCAGTGACTATCCTCGCAGAAAATG
>TTN-206,ENSE00003806397,1,288,1185894,1186181,TCCCTCCCAGGATAGACCTGAGTGTGGCTATGAAATCTTTGCTTACTGTGAAAGCTGGAACTAATGTCTGCTTGGATGCTACTGTTTTTGGTAAACCGATGCCAACAGTTTCTTGGAAAAAAGATGGCACACTGCTAAAACCAGCAGAAGGCATAAAGATGGCCATGCAGCGGAATCTGTGCACCTTGGAGCTATTCAGCGTGAACCGGAAGGACTCAGGAGACTATACCATTACTGCTGAAAATTCAAGTGGTTCTAAATCAGCCACCATTAAGCTTAAAGTGTTAG
>TTN-206,ENSE00003807889,1,297,1186182,1186478,ATAAACCGGGTCCTCCAGCATCTGTTAAAATCAACAAAATGTATTCAGATCGTGCTATGCTTTCTTGGGAACCGCCTCTTGAAGATGGAGGCTCAGAAATCACCAACTATATTGTTGACAAACGTGAAACAAGCAGGCCCAACTGGGCTCAAGTCTCTGCAACTGTGCCTATCACCAGCTGCAGCGTGGAGAAACTTATAGAGGGCCATGAGTATCAGTTCCGTATTTGTGCTGAAAATAAATATGGAGTAGGCGATCCAGTCTTCACTGAACCAGCAATTGCCAAAAACCCATATG
>TTN-206,ENSE00003811290,1,303,1186479,1186781,ACCCACCAGGACGCTGTGATCCTCCTGTTATTAGCAACATAACCAAAGATCACATGACAGTCAGCTGGAAGCCACCAGCAGATGATGGGGGCTCACCCATCACTGGCTATTTGCTTGAAAAGCGGGAAACCCAGGCTGTTAACTGGACTAAGGTCAACAGAAAACCTATTATAGAAAGAACATTAAAAGCAACAGGTCTTCAAGAAGGTACCGAATATGAGTTCCGTGTTACAGCTATAAATAAAGCTGGACCAGGCAAACCCAGTGACGCATCCAAGGCCGCTTATGCTCGGGACCCTCAGT
>TTN-206,ENSE00003808853,1,306,1186782,1187087,ATCCTCCTGGCCCACCGGCTTTCCCTAAAGTATATGATACAACTCGCAGCTCTGTGAGTCTATCTTGGGGCAAGCCAGCCTATGACGGCGGCAGCCCTATCATTGGTTATCTCGTTGAAGTAAAACGGGCTGACTCCGATAACTGGGTGAGGTGCAACTTACCACAGAATCTACAGAAAACCCGCTTTGAGGTTACTGGCCTGATGGAAGACACACAATATCAATTCCGTGTGTATGCCGTTAATAAGATTGGATACAGTGACCCCAGTGATGTGCCAGATAAACACTATCCCAAGGACATCTTAA
>TTN-206,ENSE00003807542,1,288,1187088,1187375,TTCCACCTGAGGGAGAACTTGATGCGGACTTAAGGAAGACACTCATATTACGTGCTGGAGTTACTATGAGACTATATGTACCAGTAAAAGGACGCCCACCTCCAAAGATTACTTGGTCTAAACCAAATGTCAATCTAAGAGACAGGATTGGACTGGACATAAAGTCAACTGACTTTGACACTTTCTTGCGCTGTGAAAATGTGAACAAATATGATGCAGGAAAATATATCTTAACCCTGGAGAACAGCTGTGGTAAAAAGGAATATACCATTGTTGTGAAAGTGCTTG
>TTN-206,ENSE00003810775,1,291,1187376,1187666,ATACTCCTGGGCCACCTGTCAATGTGACTGTTAAGGAAATATCCAAAGACTCTGCTTATGTTACCTGGGAGCCTCCCATTATTGATGGCGGAAGCCCCATCATAAACTATGTGGTACAAAAACGTGATGCAGAGAGGAAATCCTGGTCTACAGTGACAACTGAGTGCTCCAAAACAAGCTTCAGAGTAGCTAATTTGGAGGAGGGAAAATCCTACTTCTTCCGAGTGTTTGCTGAAAATGAGTATGGCATTGGTGATCCCGGTGAAACTCGTGATGCTGTCAAAGCTTCCC
>TTN-206,ENSE00003811210,1,288,1187667,1187954,AAACTCCTGGACCAGTTGTGGACCTGAAAGTGAGGTCTGTATCTAAGTCATCCTGTAGCATTGGCTGGAAAAAGCCTCACAGTGATGGTGGAAGTCGGATTATTGGATATGTAGTTGATTTCCTGACTGAAGAAAATAAGTGGCAACGAGTTATGAAATCCTTAAGCCTACAGTACTCTGCAAAAGATTTGACTGAAGGGAAGGAATATACCTTCAGAGTGAGTGCTGAGAATGAAAATGGAGAAGGAACCCCAAGCGAAATCACTGTTGTGGCAAGGGATGATGTTG
>TTN-206,ENSE00003805436,1,588,1187955,1188542,TGGCTCCTGATCTTGACTTAAAGGGTCTACCTGATTTGTGCTACTTGGCTAAAGAAAACAGCAACTTCCGGCTTAAGATCCCCATAAAAGGCAAGCCAGCTCCATCAGTCTCCTGGAAGAAAGGGGAAGATCCTCTAGCAACTGACACTAGAGTCAGTGTTGAGTCATCTGCGGTTAACACAACTCTTATAGTGTACGATTGCCAAAAATCTGATGCTGGAAAATACACAATCACACTTAAGAATGTTGCTGGCACCAAGGAAGGAACTATCTCCATAAAGGTTGTTGGCAAGCCTGGCATCCCCACTGGACCAATCAAATTTGATGAAGTCACAGCAGAAGCCATGACCTTAAAGTGGGCTCCTCCAAAGGATGATGGAGGTTCTGAAATCACCAACTATATCCTAGAGAAGAGGGATTCTGTGAACAACAAGTGGGTGACGTGCGCCTCAGCTGTCCAGAAAACCACCTTTAGAGTAACCAGACTTCATGAGGGCATGGAATATACCTTCAGGGTCAGTGCCGAAAATAAATATGGTGTAGGGGAAGGCCTGAAATCGGAGCCAATTGTTGCGAGACATCCATTTG
>TTN-206,ENSE00003808777,1,105,1188543,1188647,ATGTGCCTGATGCTCCCCCACCTCCCAATATTGTGGATGTCAGACACGATTCAGTATCTCTAACTTGGACTGACCCCAAGAAAACTGGTGGTTCTCCAATTACAG
>TTN-206,ENSE00003806939,1,198,1188648,1188845,GGTATCATCTCGAGTTCAAGGAAAGAAACAGCCTTTTGTGGAAGAGAGCTAACAAGACTCCGATAAGGATGAGAGACTTTAAAGTGACAGGATTAACTGAAGGTCTTGAATATGAATTCCGAGTTATGGCAATCAATTTAGCAGGTGTGGGCAAGCCAAGCCTACCATCAGAGCCTGTTGTGGCACTGGACCCAATTG
>TTN-206,ENSE00003811024,1,297,1188846,1189142,ATCCTCCTGGAAAACCTGAGGTTATTAACATAACAAGGAATTCAGTGACTCTCATTTGGACTGAACCTAAATATGACGGTGGTCATAAGTTAACTGGATATATAGTGGAGAAGCGAGATCTACCTTCGAAGTCTTGGATGAAAGCCAACCATGTTAATGTCCCAGAATGTGCCTTTACTGTAACTGACCTTGTTGAGGGTGGAAAATATGAATTCAGAATTAGAGCAAAGAATACAGCAGGTGCTATCAGTGCTCCATCAGAAAGTACAGAAACCATTATTTGCAAGGATGAATACG
>TTN-206,ENSE00003803896,1,588,1189143,1189730,AGGCACCAACAATTGTCCTTGATCCCACAATAAAAGATGGGCTAACAATTAAAGCAGGGGATACCATTGTTTTGAATGCCATTAGCATTCTTGGCAAACCCCTTCCAAAATCAAGTTGGTCCAAGGCAGGAAAAGACATTAGACCATCAGATATCACTCAGATAACTTCAACCCCAACATCTTCCATGCTTACTATCAAGTATGCCACTAGAAAAGATGCGGGTGAATATACCATCACTGCTACCAATCCTTTTGGCACGAAGGTGGAACATGTGAAGGTAACAGTCCTTGATGTACCTGGTCCCCCAGGTCCTGTTGAAATCAGTAATGTTTCTGCTGAAAAAGCAACACTTACATGGACACCTCCCTTGGAAGATGGCGGCTCACCAATTAAGTCCTATATACTTGAAAAGAGAGAAACCAGCCGACTTTTGTGGACAGTGGTTTCTGAAGATATTCAGTCTTGCAGGCATGTGGCAACCAAACTTATCCAAGGAAATGAGTACATCTTCCGGGTCTCAGCTGTAAACCACTATGGCAAAGGAGAACCTGTACAGTCTGAACCTGTCAAAATGGTAGACAGATTTG
>TTN-206,ENSE00003807419,1,303,1189731,1190033,GTCCCCCTGGCCCTCCTGAAAAACCAGAGGTATCAAATGTCACTAAGAACACTGCCACTGTCAGCTGGAAAAGGCCAGTGGATGATGGTGGCAGCGAAATTACAGGATATCATGTAGAAAGGAGAGAAAAGAAAAGCCTGCGATGGGTGAGAGCAATAAAAACACCAGTTTCCGATCTCAGGTGCAAAGTAACAGGACTGCAAGAAGGAAGCACCTACGAATTCCGTGTCAGTGCAGAAAACAGAGCAGGAATTGGTCCACCCAGTGAGGCTTCAGATTCTGTTCTGATGAAAGATGCAGCAT
>TTN-206,ENSE00003811193,1,17106,1190034,1207139,ATCCTCCAGGACCACCTTCAAATCCGCATGTCACTGATACTACCAAGAAATCTGCTTCTTTGGCATGGGGCAAGCCTCATTATGATGGTGGACTTGAAATCACTGGCTATGTCGTGGAGCATCAAAAAGTAGGAGACGAGGCCTGGATAAAAGATACCACAGGAACCGCCCTCAGAATCACTCAGTTCGTTGTTCCTGATCTTCAGACTAAAGAAAAATACAACTTCAGAATCAGTGCCATCAACGATGCAGGTGTTGGGGAGCCAGCGGTGATTCCAGATGTTGAAATCGTAGAACGGGAGATGGCTCCTGATTTTGAACTAGATGCCGAGCTTCGAAGAACACTTGTTGTTAGAGCAGGACTCAGTATTAGGATATTTGTGCCAATTAAAGGTCGTCCTGCTCCTGAAGTGACATGGACCAAAGATAACATCAACCTGAAAAACCGAGCCAACATTGAAAATACGGAATCATTTACTCTTCTGATTATCCCAGAATGTAACAGATATGATACCGGTAAATTTGTCATGACCATTGAAAACCCGGCTGGGAAGAAAAGTGGCTTTGTGAACGTCAGAGTCTTGGACACGCCAGGCCCAGTCCTCAACCTGCGGCCTACAGACATCACAAAGGACAGTGTCACCCTGCACTGGGACCTCCCTCTGATAGATGGAGGCTCACGTATAACAAACTACATTGTAGAGAAACGTGAAGCAACACGGAAATCTTATTCCACAGCCACCACTAAGTGCCATAAATGCACATATAAAGTTACCGGCTTGTCTGAAGGGTGTGAATATTTCTTCAGAGTGATGGCAGAGAATGAATATGGAATTGGTGAGCCAACAGAAACTACAGAGCCCGTAAAAGCCTCTGAAGCACCATCTCCACCAGACAGCCTTAACATCATGGACATAACTAAGAGCACCGTCAGCCTGGCATGGCCTAAGCCCAAACACGATGGTGGCAGCAAGATCACTGGCTATGTGATTGAAGCCCAAAGAAAAGGCTCTGACCAGTGGACCCACATCACAACCGTGAAAGGGTTAGAATGTGTTGTGAGGAATCTAACTGAAGGAGAGGAATATACCTTCCAAGTGATGGCAGTGAACAGCGCGGGGAGAAGTGCCCCTAGAGAAAGCAGACCCGTCATTGTCAAGGAGCAGACAATGCTTCCAGAGCTGGATCTCCGTGGCATCTATCAGAAACTGGTCATTGCCAAAGCTGGTGACAACATCAAAGTTGAAATTCCAGTGCTCGGTCGACCGAAGCCCACAGTGACATGGAAAAAAGGAGACCAAATTCTTAAACAGACACAGAGAGTTAATTTTGAAACCACAGCGACTTCAACCATTTTAAATATCAATGAGTGTGTCAGAAGTGATAGTGGGCCCTATCCATTAACAGCAAGGAACATTGTAGGAGAGGTTGGTGATGTCATCACCATTCAAGTCCATGATATCCCAGGGCCACCTACTGGACCAATCAAATTTGATGAAGTTTCATCTGATTTTGTAACCTTCTCTTGGGACCCACCTGAGAACGATGGTGGTGTACCAATAAGCAACTATGTAGTGGAAATGCGGCAGACTGACAGTACTACCTGGGTTGAGTTAGCAACCACCGTTATACGTACTACCTATAAAGCCACCCGCCTTACTACTGGATTAGAGTATCAGTTCCGTGTAAAAGCTCAGAATAGATATGGAGTTGGACCAGGCATCACATCAGCATGCATAGTTGCCAACTATCCATTTAAGGTTCCTGGACCTCCTGGTACCCCTCAGGTAACTGCAGTTACCAAGGATTCAATGACAATTAGCTGGCATGAGCCACTTTCTGATGGTGGAAGCCCCATTTTAGGATATCATGTTGAAAGAAAAGAACGAAATGGTATTCTCTGGCAGACTGTGAGCAAAGCTTTAGTACCAGGCAACATTTTCAAATCAAGTGGACTTACAGATGGTATTGCTTATGAGTTCCGGGTGATTGCAGAAAACATGGCAGGCAAAAGTAAGCCAAGCAAGCCATCAGAACCTATGTTGGCTCTGGATCCCATTGACCCACCTGGAAAACCAGTACCTCTAAATATTACAAGACACACAGTAACACTTAAATGGGCTAAGCCTGAATATACTGGGGGCTTTAAAATTACCAGTTATATCGTTGAAAAGAGAGACCTTCCTAATGGACGGTGGCTGAAGGCCAACTTCAGCAACATTTTGGAGAATGAATTTACAGTCAGTGGCCTAACAGAAGATGCTGCATATGAATTCCGTGTGATCGCCAAAAATGCTGCAGGTGCCATCAGTCCACCATCTGAGCCATCTGATGCTATCACTTGCAGGGATGATGTTGAGGCACCAAAGATAAAGGTGGATGTTAAATTTAAGGACACGGTTATATTAAAAGCAGGTGAAGCATTCAGACTGGAAGCTGATGTTTCAGGCCGCCCACCTCCAACAATGGAATGGAGCAAAGATGGAAAAGAGCTGGAAGGCACAGCAAAGTTAGAAATAAAAATTGCAGATTTCTCTACTAATCTGGTAAACAAAGATTCAACAAGAAGGGATAGTGGTGCCTATACCCTTACAGCGACTAATCCTGGTGGCTTTGCTAAACACATTTTCAATGTCAAAGTTCTTGACAGACCAGGCCCACCTGAAGGACCTTTGGCTGTAACTGAAGTGACATCAGAAAAGTGTGTACTATCATGGTTCCCTCCACTGGATGATGGAGGTGCCAAAATTGATCATTACATAGTACAGAAACGTGAAACCAGCAGATTGGCATGGACAAATGTAGCCTCAGAAGTCCAAGTAACAAAGCTAAAGGTCACTAAACTCTTGAAAGGCAATGAATACATATTCCGTGTCATGGCTGTAAATAAATATGGAGTGGGAGAGCCACTGGAATCAGAGCCTGTGCTTGCAGTGAATCCTTATGGACCCCCTGATCCGCCCAAAAACCCTGAAGTGACAACTATTACTAAAGATTCGATGGTTGTCTGCTGGGGACATCCTGATTCTGATGGTGGAAGTGAAATCATCAATTATATTGTGGAACGGCGTGATAAAGCTGGCCAACGCTGGATTAAATGCAACAAAAAAACTCTTACTGATTTAAGATATAAAGTGTCTGGACTGACAGAAGGACATGAATATGAGTTCAGGATTATGGCTGAAAATGCTGCTGGAATTAGTGCACCAAGTCCTACCAGTCCATTTTACAAGGCTTGTGACACTGTGTTTAAACCTGGACCACCAGGTAACCCACGTGTTCTGGATACAAGCAGATCATCCATTTCAATCGCTTGGAATAAACCTATCTATGATGGTGGTTCAGAAATCACTGGGTATATGGTTGAGATTGCCCTGCCAGAGGAAGATGAATGGCAGATTGTCACTCCACCAGCAGGACTCAAGGCAACTTCGTATACTATCACTGGCCTCACAGAGAATCAGGAATATAAGATCCGCATCTATGCCATGAATTCCGAAGGACTTGGGGAACCTGCCCTTGTTCCTGGAACTCCAAAGGCTGAAGACAGAATGCTGCCTCCAGAAATTGAACTGGATGCTGACCTGCGCAAAGTTGTTACTATAAGGGCCTGCTGCACCCTGAGACTTTTTGTTCCCATCAAAGGAAGGCCTGCACCTGAGGTGAAGTGGGCCCGGGACCATGGAGAATCTTTAGATAAAGCTAGCATCGAATCCACAAGCTCTTACACCCTGCTTATTGTTGGAAATGTAAACAGATTTGACAGTGGCAAATATATACTAACTGTAGAAAATAGTTCAGGCAGCAAGTCTGCATTTGTCAATGTTAGAGTTCTCGATACACCAGGCCCCCCACAGGATCTGAAGGTAAAAGAGGTCACTAAGACATCTGTCACACTCACATGGGACCCACCTCTCCTTGATGGAGGTTCAAAAATCAAGAACTATATTGTTGAAAAGCGGGAATCAACAAGAAAAGCATATTCAACTGTTGCAACAAACTGCCACAAGACTTCCTGGAAGGTAGACCAGCTTCAAGAAGGCTGTAGCTACTATTTCAGGGTTCTCGCAGAAAATGAATATGGCATTGGGCTGCCTGCTGAAACCGCAGAATCTGTGAAAGCATCAGAACGACCTCTTCCTCCAGGAAAAATAACTTTGATGGATGTCACAAGAAATAGTGTGTCACTCTCTTGGGAGAAACCAGAGCATGATGGAGGCAGCCGAATTCTAGGCTACATTGTGGAGATGCAGACCAAAGGCAGTGACAAATGGGCCACGTGTGCCACAGTCAAGGTCACTGAAGCCACTATCACTGGATTAATTCAGGGTGAAGAATACTCTTTCCGTGTTTCAGCTCAGAATGAAAAGGGCATCAGTGATCCTAGACAACTGAGTGTGCCAGTGATCGCCAAAGATCTTGTCATTCCACCAGCCTTCAAACTCCTGTTCAATACTTTCACTGTACTGGCAGGTGAAGACCTAAAAGTTGATGTTCCATTCATTGGCCGCCCTACCCCAGCTGTAACCTGGCATAAAGATAATGTACCACTGAAGCAGACAACTAGAGTAAATGCAGAGAGCACAGAAAATAATTCACTACTGACAATAAAGGACGCCTGCCGAGAAGATGTTGGCCATTATGTGGTTAAACTGACTAACTCAGCTGGTGAAGCTATTGAAACCCTTAATGTTATCGTTCTTGACAAACCAGGGCCTCCAACTGGACCAGTTAAAATGGATGAAGTGACAGCTGATAGTATTACTCTTTCCTGGGGCCCACCCAAGTATGATGGTGGAAGTTCTATCAATAATTACATTGTTGAGAAACGGGACACTTCCACAACCACCTGGCAAATTGTATCAGCTACAGTTGCAAGGACAACAATAAAGGCTTGCAGACTGAAGACTGGATGTGAATATCAGTTTAGAATTGCAGCTGAAAACAGATATGGGAAGAGTACCTACCTCAATTCAGAGCCTACTGTAGCCCAATATCCATTCAAAGTTCCTGGTCCTCCTGGCACTCCAGTTGTCACACTGTCCTCCAGGGACAGCATGGAAGTACAATGGAATGAGCCAATCAGTGATGGAGGAAGTAGAGTCATTGGCTATCATCTAGAACGCAAGGAAAGAAATAGCATCCTCTGGGTTAAGTTGAATAAAACACCTATTCCTCAAACCAAGTTTAAGACAACTGGCCTTGAAGAAGGTGTTGAATATGAATTTAGAGTCTCTGCAGAGAACATCGTGGGCATTGGCAAGCCGAGTAAAGTATCAGAATGTTATGTGGCTCGTGACCCATGTGATCCACCAGGACGGCCAGAGGCAATCATTGTCACAAGGAATTCTGTGACTCTTCAGTGGAAGAAACCCACCTATGACGGTGGAAGCAAGATCACTGGTTATATTGTTGAGAAGAAAGAATTACCTGAGGGCCGTTGGATGAAAGCCAGTTTTACAAATATTATTGACACTCATTTTGAAGTAACTGGCCTAGTTGAAGATCACAGATATGAGTTCCGGGTTATAGCCCGAAATGCCGCAGGAGTGTTTAGTGAGCCTTCAGAAAGCACAGGAGCAATAACAGCTAGAGATGAGGTAGATCCACCACGAATAAGTATGGATCCAAAATACAAAGACACAATCGTGGTTCATGCTGGTGAATCATTCAAGGTTGATGCAGATATTTATGGCAAACCAATACCAACCATTCAGTGGATAAAAGGTGATCAGGAGCTTTCAAACACAGCTCGATTAGAAATAAAGAGCACCGACTTTGCCACCAGTCTCAGTGTAAAAGATGCAGTACGTGTCGACAGTGGAAATTACATACTGAAGGCCAAAAATGTTGCAGGAGAAAGATCAGTTACTGTGAATGTCAAGGTTCTTGACAGACCAGGGCCACCTGAAGGACCTGTTGTTATCTCAGGAGTTACAGCAGAAAAATGCACACTAGCTTGGAAACCCCCACTTCAGGATGGTGGGAGTGACATCATAAATTATATTGTGGAAAGGAGAGAAACCAGCCGCTTAGTTTGGACTGTGGTTGATGCCAATGTGCAGACTCTCAGCTGCAAGGTTACTAAGCTTCTTGAAGGCAATGAATATACTTTCCGTATAATGGCAGTAAACAAATATGGTGTTGGTGAACCTCTTGAATCTGAGCCAGTAGTTGCCAAGAATCCATTTGTAGTACCAGATGCACCAAAAGCTCCAGAAGTCACAACAGTGACCAAGGACTCAATGATTGTTGTATGGGAAAGACCAGCATCTGATGGTGGTAGTGAAATTCTTGGATATGTTCTTGAGAAACGGGATAAAGAAGGCATTAGATGGACAAGATGCCATAAGCGTCTGATTGGAGAGTTGCGCCTGAGAGTAACTGGACTCATAGAAAATCACGATTATGAGTTCAGAGTTTCTGCTGAGAATGCTGCTGGACTTAGTGAACCAAGCCCTCCTTCTGCTTACCAAAAGGCTTGTGATCCTATTTATAAACCAGGACCCCCAAACAACCCCAAAGTCATAGACATAACCAGATCTTCAGTATTCCTTTCTTGGAGCAAACCAATATATGATGGTGGCTGTGAAATTCAAGGATACATTGTTGAAAAATGTGATGTGAGTGTTGGTGAATGGACAATGTGCACTCCACCAACAGGAATTAATAAAACAAACATAGAAGTAGAGAAGCTGTTGGAAAAGCATGAATACAACTTCCGTATCTGTGCTATTAATAAAGCTGGAGTTGGAGAACATGCTGACGTCCCTGGACCTATTATAGTTGAAGAAAAATTAGAAGCACCAGACATTGATCTTGACCTAGAACTAAGGAAAATCATAAATATAAGGGCAGGTGGCTCCTTAAGGTTATTTGTTCCTATAAAAGGTCGTCCTACACCAGAAGTTAAATGGGGAAAGGTGGATGGTGAAATCCGAGATGCAGCTATAATTGATGTCACTAGCAGTTTCACCTCTCTTGTTCTTGACAATGTCAACCGATATGATAGTGGAAAATATACGCTTACATTAGAAAACAGCAGTGGAACAAAGTCTGCCTTTGTTACTGTGAGAGTTCTGGACACGCCAAGTCCACCTGTTAACCTGAAAGTCACAGAAATCACCAAAGACTCAGTATCAATTACATGGGAACCTCCTTTGTTGGATGGGGGATCCAAAATAAAAAATTACATTGTTGAGAAACGTGAAGCCACAAGAAAATCATATGCTGCTGTTGTAACTAACTGCCATAAGAATTCTTGGAAAATCGATCAGCTCCAAGAAGGTTGCAGTTATTACTTTAGAGTCACAGCTGAGAATGAGTATGGTATTGGCCTTCCTGCCCAGACTGCTGATCCAATTAAGGTTGCAGAAGTGCCACAACCTCCTGGAAAAATAACTGTGGATGATGTCACCAGAAACAGTGTCTCTCTGAGTTGGACAAAACCTGAACATGATGGTGGCAGTAAAATCATTCAGTATATTGTGGAAATGCAAGCTAAACACAGTGAGAAATGGTCAGAGTGTGCTCGAGTAAAGTCTCTTCAGGCAGTAATTACCAACCTAACTCAAGGGGAAGAATATCTTTTTAGAGTTGTTGCTGTAAATGAAAAGGGGAGAAGTGATCCTCGGTCCCTTGCAGTTCCAATAGTTGCCAAAGATCTGGTAATTGAGCCAGATGTAAAACCTGCATTCAGTAGTTACAGTGTACAGGTTGGCCAAGATTTGAAAATAGAAGTGCCAATTTCTGGACGTCCTAAGCCAACCATTACCTGGACTAAAGATGGTCTCCCACTGAAGCAGACCACAAGAATCAATGTTACCGATTCACTGGATCTCACCACACTCAGTATTAAAGAAACTCATAAGGATGATGGTGGACAATATGGAATCACAGTTGCCAATGTTGTTGGTCAGAAGACAGCATCCATCGAAATTGTAACTCTAGATAAACCTGATCCTCCAAAAGGACCTGTTAAATTTGATGACGTCAGTGCTGAAAGTATTACATTATCTTGGAACCCTCCATTATATACAGGGGGCTGCCAAATCACCAACTACATTGTTCAGAAAAGAGATACAACCACCACAGTATGGGATGTTGTTTCTGCTACTGTTGCTAGAACTACACTCAAAGTGACCAAACTGAAAACTGGTACAGAATACCAATTTAGAATATTTGCCGAAAACAGATATGGACAAAGCTTTGCCTTAGAGTCTGATCCAATTGTAGCTCAATATCCCTACAAAGAACCAGGCCCTCCAGGTACACCATTTGCCACAGCCATTTCCAAAGACTCCATGGTCATACAGTGGCATGAACCAGTCAACAATGGTGGAAGCCCCGTCATAGGTTACCACCTGGAGAGAAAAGAAAGAAACAGTATTTTGTGGACAAAGGTCAACAAAACTATTATTCATGACACCCAATTCAAAGCACAGAATCTTGAAGAAGGCATTGAATATGAATTCAGAGTGTATGCTGAAAATATTGTTGGTGTAGGCAAAGCAAGCAAGAATTCTGAATGCTATGTAGCCAGAGATCCCTGTGACCCACCAGGAACCCCAGAACCAATAATGGTTAAAAGAAATGAAATCACTTTACAGTGGACCAAACCTGTGTATGATGGTGGAAGTATGATTACAGGCTACATTGTAGAGAAACGTGATTTGCCTGATGGTCGTTGGATGAAAGCTAGCTTTACAAATGTCATTGAAACTCAATTTACTGTGTCAGGTCTTACTGAAGATCAAAGATATGAATTCAGAGTCATTGCAAAGAATGCAGCTGGTGCAATAAGTAAACCCTCTGACAGTACTGGACCAATAACTGCCAAGGATGAGGTTGAACTCCCAAGAATTTCAATGGATCCAAAATTCAGAGACACAATTGTGGTAAATGCTGGAGAAACATTCAGACTTGAGGCTGATGTCCATGGAAAGCCCCTACCTACCATTGAGTGGTTAAGAGGAGATAAGGAAATTGAAGAATCTGCTAGATGTGAAATAAAGAACACAGATTTCAAGGCTTTACTTATTGTAAAAGATGCAATTAGAATTGATGGTGGGCAGTATATTTTAAGAGCTTCCAATGTTGCAGGTTCTAAGTCATTCCCAGTAAATGTAAAAGTATTAGATAGACCAGGACCTCCAGAAGGGCCAGTCCAGGTTACTGGAGTCACTTCTGAAAAATGCTCTTTAACATGGTCTCCACCACTTCAAGATGGTGGCAGTGACATTTCTCACTATGTTGTTGAAAAGCGAGAAACCAGTCGACTTGCCTGGACTGTTGTTGCTTCAGAAGTTGTGACCAATTCTCTGAAAGTTACCAAACTCTTAGAAGGTAATGAATATGTTTTCCGTATAATGGCTGTCAACAAATATGGTGTTGGAGAGCCTTTGGAATCTGCACCAGTACTAATGAAAAATCCATTTGTGCTTCCTGGACCACCAAAAAGCTTGGAAGTCACAAATATTGCCAAAGACTCCATGACCGTCTGTTGGAACCGTCCAGATAGTGATGGTGGAAGTGAGATTATTGGTTACATTGTAGAGAAAAGAGACAGAAGTGGCATTCGATGGATAAAATGTAATAAACGCCGCATTACAGATTTGCGTCTAAGAGTGACAGGATTAACAGAAGATCATGAGTATGAATTCAGGGTCTCTGCAGAAAATGCTGCTGGAGTTGGGGAACCAAGTCCAGCTACAGTTTATTATAAAGCCTGTGATCCTGTGTTCAAACCTGGCCCACCTACCAATGCACACATTGTAGACACCACTAAAAATTCAATCACACTTGCCTGGGGTAAACCCATCTATGATGGCGGCAGTGAGATCTTGGGATATGTAGTAGAAATCTGTAAAGCAGATGAAGAAGAATGGCAAATAGTTACTCCACAGACTGGCCTGAGAGTCACTCGATTTGAAATTTCAAAACTCACTGAACACCAAGAGTATAAAATACGAGTCTGTGCCCTCAACAAAGTTGGTTTAGGTGAGGCTACATCAGTTCCTGGTACTGTGAAACCAGAAGATAAACTTGAAGCACCTGAACTTGACCTTGACTCCGAATTAAGAAAAGGAATTGTTGTAAGAGCTGGTGGATCTGCCAGAATTCACATTCCATTCAAAGGTCGTCCAACGCCTGAGATCACTTGGTCTCGAGAGGAAGGTGAATTCACAGATAAGGTCCAAATTGAAAAGGGAGTAAACTATACCCAACTATCAATAGATAACTGTGATAGAAATGATGCTGGAAAATACATTCTTAAGTTGGAAAACAGCAGTGGATCAAAGTCTGCTTTTGTAACTGTGAAAGTTCTTGACACTCCAGGACCACCACAGAATTTGGCAGTCAAAGAAGTGAGAAAAGATTCTGCCTTCCTGGTATGGGAGCCACCCATCATTGATGGAGGGGCAAAGGTCAAGAACTATGTGATTGACAAACGTGAGTCAACCAGAAAAGCGTATGCTAATGTGAGTAGTAAATGCAGCAAAACAAGTTTTAAAGTGGAAAACCTTACAGAAGGAGCCATTTATTACTTCAGAGTCATGGCTGAAAATGAATTTGGAGTTGGTGTTCCAGTGGAAACTGTTGATGCCGTGAAAGCTGCTGAACCTCCTTCCCCACCAGGAAAGGTTACACTCACTGATGTGTCCCAGACCAGTGCATCACTTATGTGGGAGAAACCTGAACATGATGGCGGTAGCAGAGTCCTGGGGTACGTTGTTGAAATGCAGCCCAAAGGAACTGAAAAATGGAGCATTGTGGCTGAATCCAAAGTCTGTAATGCAGTTGTTACTGGTTTGAGTTCTGGACAAGAATATCAGTTCCGTGTCAAGGCTTATAATGAGAAAGGAAAAAGCGATCCAAGAGTGTTGGGTGTTCCTGTCATAGCCAAGGACTTGACTATACAGCCTAGTTTAAAGTTACCATTTAACACATATAGTATCCAAGCTGGAGAAGATCTTAAAATAGAAATTCCAGTTATAGGCCGACCAAGACCTAACATTTCTTGGGTCAAAGATGGTGAGCCTCTTAAACAGACAACAAGAGTAAACGTTGAAGAAACAGCTACCTCAACTGTTTTGCACATTAAAGAAGGTAACAAAGATGACTTTGGAAAATACACCGTAACGGCAACAAATAGTGCAGGCACAGCAACAGAAAATCTCAGTGTTATCGTTTTAGAAAAGCCTGGACCTCCAGTTGGCCCAGTTCGGTTTGATGAAGTTAGTGCAGACTTTGTAGTCATATCTTGGGAACCTCCAGCCTATACTGGTGGCTGCCAAATAAGCAACTACATTGTAGAGAAGCGAGATACAACCACCACCACTTGGCACATGGTATCAGCAACAGTTGCAAGAACAACAATTAAAATAACCAAACTGAAAACAGGCACGGAGTACCAGTTTAGAATTTTTGCTGAAAACAGGTATGGAAAAAGTGCCCCACTGGATTCTAAGGCAGTTATTGTACAATATCCATTTAAAGAACCTGGACCACCTGGAACTCCTTTTGTGACATCAATCTCAAAAGATCAGATGCTTGTGCAATGGCATGAGCCAGTGAATGATGGAGGCACCAAAATTATTGGCTACCATCTTGAACAGAAAGAAAAGAACAGTATTTTATGGGTCAAGTTAAATAAGACCCCCATTCAGGACACCAAATTCAAAACAACTGGGCTTGATGAGGGCCTTGAGTATGAGTTCAAAGTTTCTGCTGAAAATATTGTTGGCATTGGCAAGCCTAGCAAAGTGTCAGAATGCTTTGTTGCTCGTGATCCATGTGACCCACCTGGTCGCCCTGAAGCCATTGTTATTACAAGAAACAATGTCACACTGAAATGGAAGAAACCTGCCTATGATGGTGGTAGCAAAATAACAGGTTATATTGTAGAAAAGAAAGATCTACCTGATGGCCGCTGGATGAAAGCCAGCTTTACCAACGTATTAGAAACTGAATTTACAGTGAGTGGACTTGTAGAAGACCAAAGATATGAATTTAGAGTAATTGCAAGAAATGCAGCTGGAAACTTTAGTGAACCATCTGATAGTAGTGGTGCCATTACTGCAAGAGATGAAATTGATGCACCAAATGCCTCTCTGGATCCAAAATATAAAGATGTCATCGTTGTTCATGCAGGAGAGACTTTTGTTCTTGAAGCCGACATCCGTGGCAAACCTATACCTGATGTTGTTTGGTCAAAAGATGGAAAAGAACTTGAAGAAACAGCTGCTAGAATGGAAATTAAATCTACTATTCAGAAAACAACTCTTGTTGTCAAAGACTGTATACGGACTGATGGAGGACAATATATTCTGAAACTCAGCAATGTTGGTGGTACAAAGTCTATACCCATCACTGTAAAGGTACTTGACAGGCCAGGGCCTCCTGAAGGGCCTCTGAAAGTTACTGGAGTTACTGCGGAAAAATGTTACCTGGCATGGAACCCACCTTTGCAAGATGGTGGTGCTAATATTTCACATTACATCATTGAAAAGAGGGAGACAAGCCGACTCTCTTGGACCCAGGTTTCAACTGAGGTACAGGCCCTTAACTACAAAGTTACTAAACTTCTTCCTGGTAATGAGTACATTTTCCGTGTCATGGCTGTGAATAAATATGGAATTGGAGAGCCCTTGGAATCTGGGCCTGTTACGGCCTGTAATCCTTATAAGCCACCAGGTCCTCCCTCAACACCTGAAGTCTCAGCAATCACCAAAGATTCTATGGTAGTAACATGGGCACGCCCAGTAGACGACGGAGGTACCGAAATTGAGGGCTACATTCTTGAAAAACGAGATAAGGAAGGCGTTAGATGGACCAAGTGCAACAAGAAAACATTAACGGATCTGCGGCTCAGGGTAACTGGTCTTACCGAAGGCCATTCCTATGAATTCAGAGTTGCTGCTGAAAATGCAGCTGGTGTGGGAGAACCTAGTGAGCCATCTGTTTTCTACCGTGCGTGTGATGCCTTGTATCCACCAGGTCCCCCAAGCAATCCAAAAGTGACGGACACTTCCAGATCTTCTGTCTCCCTGGCATGGAGTAAGCCAATTTATGATGGTGGCGCACCTGTTAAAGGCTATGTTGTAGAGGTCAAAGAAGCTGCTGCGGATGAATGGACAACCTGCACTCCACCAACAGGATTACAAGGAAAGCAGTTCACAGTGACCAAGCTTAAAGAAAACACTGAATATAACTTCCGTATTTGTGCCATCAATTCTGAAGGTGTAGGTGAACCTGCAACTCTACCTGGCTCAGTGGTTGCTCAGGAGAGGATAGAGCCACCAGAAATAGAACTCGATGCTGATCTCAGAAAGGTGGTCGTTCTGCGTGCAAGTGCTACTTTACGCTTATTTGTCACTATCAAAGGTCGACCAGAACCCGAAGTTAAATGGGAAAAGGCAGAAGGCATTCTCACTGACAGGGCTCAGATAGAGGTGACCAGCTCATTTACAATGTTGGTGATTGATAATGTTACCAGATTTGACAGTGGTCGGTATAATCTGACATTAGAAAATAATAGTGGCTCCAAAACAGCTTTTGTTAACGTCAGAGTTCTTGACTCACCAAGTGCCCCTGTGAATTTGACCATAAGAGAAGTGAAGAAAGACTCAGTGACGTTGTCCTGGGAACCACCACTTATTGATGGTGGAGCTAAGATTACAAACTACATTGTCGAAAAACGAGAAACTACAAGAAAAGCCTATGCTACCATTACAAATAATTGCACTAAAACTACTTTCAGAATTGAAAATCTACAAGAAGGATGTTCTTACTACTTCCGAGTCTTGGCTTCCAATGAATATGGGATTGGTTTGCCAGCTGAAACAACAGAACCCGTTAAAGTGTCTGAACCACCCCTCCCACCTGGAAGAGTAACTCTTGTTGATGTGACCCGTAATACAGCTACAATTAAGTGGGAGAAACCAGAAAGTGATGGTGGCAGCAAAATTACTGGTTATGTGGTTGAAATGCAGACTAAAGGGAGTGAAAAGTGGAGCACCTGCACACAAGTTAAGACTCTAGAAGCAACTATATCTGGCTTAACTGCAGGAGAAGAGTATGTCTTCAGGGTAGCTGCAGTTAACGAAAAGGGAAGAAGTGATCCAAGACAACTTGGAGTGCCAGTAATTGCAAGGGATATTGAAATAAAGCCTTCAGTTGAGCTTCCTTTCCATACTTTCAATGTAAAGGCTAGAGAACAACTTAAGATTGATGTGCCATTCAAAGGAAGACCTCAAGCTACTGTGAACTGGAGAAAAGATGGTCAGACTCTTAAAGAGACAACTAGAGTCAATGTTTCTTCTTCAAAGACTGTAACATCACTATCTATTAAGGAAGCTTCAAAGGAAGATGTTGGAACTTATGAATTATGTGTTTCAAACAGTGCTGGATCCATAACAGTTCCTATTACTATAATTGTCCTTGACAGACCAGGACCTCCAGGTCCTATACGTATTGATGAGGTTAGTTGTGACAGCATAACCATTTCTTGGAATCCTCCAGAATATGATGGTGGCTGCCAAATTAGCAATTACATTGTTGAAAAGAAAGAAACCACCTCTACAACATGGCACATAGTTTCACAAGCAGTTGCAAGAACATCCATTAAAATAGTTCGCCTGACAACAGGAAGTGAGTATCAGTTCCGTGTTTGTGCAGAAAACCGCTATGGAAAGAGCTCCTACAGTGAATCTTCAGCTGTTGTTGCAGAGTATCCATTCAGTCCCCCAGGTCCTCCTGGTACTCCTAAAGTTGTGCATGCCACAAAATCTACCATGCTTGTAACCTGGCAAGTGCCAGTTAATGATGGAGGAAGTCGAGTAATTGGCTATCATCTTGAGTATAAAGAAAGAAGCAGCATTCTTTGGTCAAAAGCAAATAAAATCCTCATTGCTGATACTCAAATGAAAGTCTCCGGCCTTGATGAAGGACTGATGTATGAGTATCGTGTATATGCTGAAAATATTGCTGGAATTGGTAAATGCAGTAAATCTTGTGAACCAGTCCCTGCAAGAGATCCTTGTGACCCTCCTGGACAACCTGAAGTCACAAATATCACAAGAAAATCAGTGTCACTTAAATGGTCTAAACCACATTATGATGGTGGAGCTAAGATCACAGGATACATTGTTGAACGCAGAGAACTACCAGATGGCCGGTGGCTGAAGTGCAATTATACTAATATACAAGAAACATACTTTGAAGTAACTGAACTTACTGAAGATCAGCGTTATGAATTCCGGGTTTTTGCAAGGAATGCTGCTGACTCAGTTAGTGAGCCATCTGAATCCACTGGGCCTATTATAGTTAAAGATGATGTTGAGCCTCCAAGAGTTATGATGGATGTCAAGTTCCGAGACGTTATTGTTGTCAAAGCTGGAGAGGTCCTTAAGATAAATGCAGACATTGCAGGGCGACCTCTGCCAGTAATTTCCTGGGCCAAGGATGGTATAGAAATTGAAGAAAGAGCAAGAACAGAAATCATCTCAACAGACAATCATACTTTGTTAACAGTTAAAGACTGTATAAGACGAGACACTGGGCAATATGTACTAACACTGAAGAATGTTGCCGGCACTCGGTCTGTGGCCGTTAATTGCAAAGTACTTGATAAGCCTGGTCCACCAGCAGGACCACTTGAAATAAATGGCCTCACTGCTGAGAAATGCTCTCTTTCCTGGGGACGTCCCCAAGAAGATGGTGGTGCAGATATCGACTATTACATCGTAGAAAAACGTGAAACAAGCCACCTTGCATGGACAATATGTGAAGGAGAGTTACAGATGACATCCTGTAAAGTAACCAAGTTACTCAAAGGCAATGAATATATATTTAGAGTAACTGGTGTTAATAAATATGGTGTTGGTGAGCCCCTAGAGAGTGTAGCTATAAAGGCACTAGATCCATTTACAGTTCCAAGTCCACCCACGTCTTTGGAAATTACTTCTGTGACCAAAGAATCTATGACACTTTGCTGGTCAAGACCCGAGAGTGATGGAGGTAGTGAAATATCTGGATATATAATTGAAAGGCGAGAGAAAAATAGCCTAAGATGGGTGCGTGTAAACAAAAAACCAGTTTATGATCTAAGAGTGAAATCAACAGGACTTCGGGAAGGATGTGAATATGAATATCGTGTTTATGCAGAAAATGCTGCTGGCCTAAGTCTTCCAAGTGAAACCTCTCCCTTAATTAGGGCAGAAGATCCAGTGTTCCTACCATCTCCTCCATCCAAACCCAAAATTGTGGACTCAGGCAAGACAACTATAACTATTGCCTGGGTTAAGCCGCTGTTTGATGGTGGGGCCCCGATAACTGGATATACTGTAGAATACAAAAAATCTGATGACACTGACTGGAAAACTTCCATTCAGAGCTTACGAGGGACAGAATATACAATAAGCGGACTAACAACAGGAGCTGAATATGTTTTCAGAGTAAAATCTGTCAATAAGGTTGGTGCTAGTGACCCCAGTGATAGCTCTGACCCTCAGATAGCAAAGGAAAGAGAAGAAGAACCTTTATTTGATATTGACAGTGAAATGAGGAAGACCTTGATTGTCAAGGCTGGTGCCTCATTTACCATGACTGTGCCTTTCCGAGGAAGACCAGTACCCAATGTCTTGTGGAGTAAGCCAGACACTGACCTCCGTACTAGAGCTTATGTTGATACCACAGACTCTCGTACATCACTGACCATTGAAAATGCCAACAGAAATGACTCTGGAAAGTACACATTAACAATTCAGAATGTTTTGAGTGCTGCTTCACTGACCTTAGTTGTCAAAGTTTTAGATACCCCAGGTCCTCCAACCAACATTACTGTGCAAGATGTAACCAAAGAGTCTGCAGTGTTATCCTGGGATGTTCCTGAAAACGATGGTGGAGCACCAGTGAAGAATTACCACATAGAAAAACGTGAGGCCAGCAAGAAAGCATGGGTCTCTGTGACCAACAACTGTAACCGCCTCTCCTACAAAGTTACCAATTTACAAGAAGGAGCTATCTATTACTTCAGAGTCTCTGGAGAAAATGAGTTTGGTGTTGGTATACCAGCTGAAACAAAGGAAGGAGTAAAAATAACAG
>TTN-206,ENSE00003802597,1,297,1207140,1207436,AAAAACCAAGCCCACCTGAAAAACTTGGAGTAACAAGTATATCCAAAGACAGTGTTTCCCTGACCTGGCTGAAGCCTGAACATGATGGCGGAAGCAGAATTGTACACTATGTCGTTGAAGCACTAGAAAAAGGACAGAAAAACTGGGTTAAATGTGCAGTGGCAAAGTCAACCCATCACGTTGTTTCCGGTCTGAGAGAGAATTCTGAATACTTTTTCCGAGTGTTTGCTGAAAATCAAGCTGGCCTGAGTGACCCGAGAGAGCTTCTGCTTCCTGTTCTTATTAAGGAGCAACTAG
>TTN-206,ENSE00003802941,1,588,1207437,1208024,AACCACCTGAAATTGATATGAAGAATTTCCCAAGTCACACTGTATATGTTAGAGCTGGTTCAAACCTTAAAGTTGACATTCCAATCTCTGGAAAACCACTTCCCAAAGTGACCTTATCAAGAGATGGTGTCCCCCTTAAGGCAACCATGAGATTTAATACCGAAATTACTGCTGAGAACCTGACCATCAATCTCAAAGAAAGTGTTACAGCTGACGCTGGGAGATATGAAATCACTGCTGCCAACTCCAGTGGTACAACCAAAGCTTTCATTAACATTGTTGTGCTAGACAGGCCTGGTCCTCCAACTGGCCCTGTTGTTATTAGTGATATAACTGAAGAAAGTGTGACTCTCAAATGGGAGCCACCTAAGTATGACGGTGGAAGTCAAGTTACCAACTACATTCTACTCAAAAGAGAAACAAGTACTGCAGTGTGGACTGAAGTGTCTGCAACAGTTGCAAGAACCATGATGAAAGTCATGAAACTGACCACAGGAGAAGAATACCAATTCCGCATCAAGGCAGAAAACCGCTTTGGCATCAGTGATCATATAGATTCAGCTTGTGTGACTGTCAAACTACCATACA
>TTN-206,ENSE00003808789,1,303,1208025,1208327,CAACACCTGGACCACCATCTACACCATGGGTCACTAATGTTACTCGAGAAAGCATCACTGTGGGCTGGCATGAACCAGTGTCAAATGGAGGCAGTGCAGTCGTAGGCTATCACCTGGAAATGAAAGACAGAAACAGTATTTTATGGCAAAAAGCCAACAAACTGGTCATCCGCACAACTCACTTCAAAGTCACAACAATCAGTGCTGGACTTATTTATGAATTCAGGGTGTATGCAGAAAATGCTGCTGGAGTTGGAAAACCTAGCCATCCTTCTGAACCAGTCTTGGCAATTGATGCTTGTG
>TTN-206,ENSE00003806587,1,297,1208328,1208624,AACCCCCAAGAAATGTTCGTATCACTGATATTTCAAAGAACTCTGTCAGCCTTTCATGGCAACAACCAGCTTTCGATGGAGGTAGCAAGATTACAGGCTACATTGTTGAGAGACGTGACCTTCCAGATGGCAGATGGACCAAGGCCAGCTTCACCAATGTTACTGAAACTCAATTCATCATCTCTGGCTTGACTCAGAATTCCCAGTATGAATTCCGTGTCTTTGCTAGGAATGCTGTTGGTTCCATTAGCAATCCATCTGAGGTTGTAGGGCCCATTACTTGCATCGATTCTTATG
>TTN-206,ENSE00003807681,1,288,1208625,1208912,GTGGTCCTGTAATTGATTTGCCTCTAGAATATACAGAAGTTGTCAAATACAGAGCAGGTACATCTGTGAAGCTCAGAGCTGGCATTTCTGGCAAACCTGCGCCTACTATTGAGTGGTATAAAGATGATAAAGAATTACAAACCAATGCACTGGTGTGTGTTGAAAATACCACGGACCTCGCATCTATACTCATCAAAGATGCCGATCGCCTTAATAGTGGATGCTATGAATTAAAACTAAGGAATGCCATGGGCTCAGCCTCAGCCACCATCAGAGTACAGATCCTTG
>TTN-206,ENSE00003811102,1,300,1208913,1209212,ACAAACCAGGCCCACCTGGTGGACCAATTGAATTTAAGACTGTAACTGCTGAGAAGATCACCCTTCTCTGGCGGCCTCCAGCTGATGATGGTGGTGCAAAAATCACTCACTACATTGTGGAAAAGCGTGAGACAAGCCGCGTTGTGTGGTCTATGGTGTCTGAACATTTGGAAGAGTGCATCATTACAACCACCAAAATTATCAAAGGAAATGAATACATCTTCCGGGTCCGAGCCGTGAACAAATATGGAATTGGCGAGCCACTGGAATCTGATTCCGTTGTAGCCAAGAACGCATTTG
>TTN-206,ENSE00003802386,1,303,1209213,1209515,TTACACCTGGGCCACCAGGCATACCAGAAGTGACAAAGATTACCAAGAATTCGATGACTGTTGTATGGAGCAGGCCAATTGCAGATGGCGGTAGTGATATAAGTGGCTATTTCCTTGAAAAACGAGACAAGAAGAGCCTAGGATGGTTTAAAGTACTAAAAGAGACTATCCGTGACACCAGACAAAAAGTAACAGGACTCACAGAAAACAGTGACTATCAATACAGAGTTTGTGCTGTAAACGCTGCTGGACAGGGTCCATTTTCTGAACCATCTGAATTCTACAAAGCTGCTGATCCTATTG
>TTN-206,ENSE00003809908,1,306,1209516,1209821,ATCCTCCAGGTCCACCTGCTAAGATAAGAATCGCAGATTCAACCAAGTCATCCATCACCCTTGGCTGGAGTAAGCCTGTCTATGATGGGGGCAGTGCTGTTACTGGGTATGTTGTCGAGATAAGACAAGGAGAGGAAGAGGAATGGACTACTGTCTCTACCAAAGGAGAGGTCAGAACTACAGAATATGTGGTATCCAACCTGAAACCTGGAGTCAATTACTACTTCCGGGTATCTGCTGTAAACTGTGCTGGACAAGGAGAACCTATAGAAATGAATGAACCTGTACAAGCTAAAGATATACTTG
>TTN-206,ENSE00003808993,1,1767,1209822,1211588,AGGCACCAGAGATTGACCTGGATGTGGCTCTCAGAACTTCTGTTATTGCCAAAGCTGGTGAAGATGTACAAGTGTTGATTCCCTTTAAAGGCAGACCTCCACCTACTGTCACATGGAGAAAAGATGAGAAGAATCTTGGCAGTGATGCCAGATACAGCATTGAAAACACTGATTCATCCTCATTACTCACCATTCCTCAAGTTACTCGCAATGATACAGGAAAATATATTCTCACAATAGAAAATGGAGTTGGTGAACCTAAGTCTTCAACTGTGAGTGTTAAAGTGCTTGACACACCAGCTGCCTGCCAGAAACTACAGGTTAAACATGTTTCTCGAGGCACAGTCACTTTGCTCTGGGATCCTCCTCTCATTGATGGAGGATCTCCAATAATTAATTATGTCATTGAAAAGAGAGATGCCACCAAGAGAACATGGTCTGTCGTGTCACACAAATGTTCTAGCACATCCTTCAAGCTAATAGATTTGTCGGAGAAGACTCCATTCTTCTTCAGAGTTCTTGCAGAAAATGAAATTGGAATTGGGGAACCCTGTGAAACTACAGAGCCAGTGAAGGCTGCTGAAGTACCAGCTCCTATACGTGATCTCTCAATGAAAGACTCAACAAAGACATCTGTCATCCTCAGCTGGACCAAACCTGACTTTGATGGTGGTAGCGTCATCACAGAATATGTTGTAGAAAGGAAAGGTAAAGGTGAACAGACGTGGTCCCACGCTGGCATAAGTAAGACATGTGAAATTGAGGTTAGCCAACTTAAGGAGCAGTCAGTCCTGGAGTTCAGAGTGTTTGCCAAAAATGAGAAAGGACTGAGTGATCCTGTCACTATTGGGCCAATTACAGTGAAAGAACTTATTATTACACCTGAAGTTGACCTGTCAGATATCCCTGGGGCACAAGTCACTGTGAGAATTGGGCACAATGTGCACCTTGAATTACCTTATAAGGGAAAACCCAAACCATCCATCAGTTGGCTGAAAGATGGCTTGCCACTGAAAGAAAGTGAATTTGTTCGCTTCAGTAAAACTGAAAACAAAATTACTTTGAGTATTAAGAATGCCAAGAAGGAGCATGGAGGAAAATACACTGTTATTCTTGATAATGCAGTGTGTAGAATTGCAGTCCCCATTACAGTCATCACCCTTGGCCCACCATCAAAGCCCAAAGGACCCATTCGATTTGATGAAATCAAGGCTGATAGTGTCATCCTGTCATGGGATGTACCTGAAGATAATGGAGGAGGAGAAATTACTTGTTACAGCATCGAGAAGCGGGAAACTTCACAAACTAACTGGAAGATGGTGTGTTCAAGTGTTGCCAGAACGACTTTCAAAGTTCCTAATCTAGTCAAAGATGCTGAGTACCAGTTTAGAGTGAGAGCAGAAAACAGATACGGAGTCAGCCAACCACTTGTCTCAAGCATTATTGTGGCAAAACACCAGTTCAGGATTCCTGGTCCCCCAGGAAAGCCAGTTATATACAATGTGACTTCTGATGGCATGTCACTAACTTGGGATGCTCCAGTTTATGATGGTGGTTCAGAAGTTACTGGATTCCATGTTGAAAAGAAAGAAAGAAATAGCATCCTCTGGCAAAAAGTTAATACATCACCAATCTCTGGAAGAGAATATAGAGCCACTGGACTGGTAGAAGGTCTGGATTACCAATTCCGTGTATATGCTGAAAATTCTGCTGGCCTAAGCTCACCTAGTGACCCAAGCAAATTTACCTTAGCTGTTTCTCCAGTAG
>TTN-206,ENSE00003811205,1,294,1211589,1211882,ACCCACCTGGCACTCCTGACTACATTGATGTCACCCGGGAAACCATCACACTTAAATGGAACCCACCATTGCGTGATGGAGGCAGTAAGATTGTGGGCTATAGCATTGAGAAACGGCAAGGAAATGAACGCTGGGTGAGATGCAACTTTACTGACGTCAGTGAATGTCAGTACACAGTTACAGGACTCAGTCCTGGGGATCGCTATGAGTTCAGAATAATTGCAAGAAATGCTGTTGGAACTATAAGCCCGCCCTCACAGTCTTCTGGCATTATTATGACAAGAGATGAAAATG
>TTN-206,ENSE00003808021,1,288,1211883,1212170,TTCCACCAATAGTAGAGTTTGGCCCTGAATACTTTGATGGTCTCATTATTAAGTCCGGAGAGAGCCTTAGAATTAAAGCTTTGGTACAAGGAAGACCAGTGCCTCGAGTAACTTGGTTCAAAGATGGAGTGGAAATCGAAAAGAGGATGAATATGGAAATAACCGACGTACTTGGATCCACCAGCCTATTTGTTAGAGATGCTACTCGGGACCATCGTGGTGTATACACAGTGGAAGCCAAAAATGCATCTGGTTCTGCAAAAGCAGAAATTAAAGTGAAAGTACAAG
>TTN-206,ENSE00003804355,1,300,1212171,1212470,ATACACCAGGAAAAGTAGTTGGGCCAATAAGATTCACCAATATTACTGGGGAGAAGATGACTCTGTGGTGGGATGCCCCACTCAATGACGGTTGTGCTCCCATAACCCACTACATCATTGAAAAACGGGAAACCAGCAGACTTGCCTGGGCACTAATTGAGGATAAATGTGAAGCCCAAAGTTACACTGCCATTAAACTAATAAACGGCAATGAATACCAATTCCGTGTTTCTGCAGTTAACAAGTTTGGTGTTGGCAGGCCACTTGATTCTGATCCAGTGGTTGCTCAAATACAATATA
>TTN-206,ENSE00003807046,1,2067,1212471,1214537,CTGTTCCTGATGCCCCTGGCATTCCAGAACCTAGCAACATAACAGGCAACAGCATTACCCTGACATGGGCAAGGCCAGAATCAGATGGTGGCAGTGAAATTCAACAGTATATCCTTGAAAGAAGAGAAAAGAAAAGCACAAGATGGGTAAAAGTGATCAGCAAACGACCAATCTCTGAAACAAGATTCAAAGTCACTGGTCTGACAGAAGGCAATGAGTATGAATTCCATGTCATGGCTGAAAATGCTGCAGGAGTTGGACCTGCAAGTGGCATCTCAAGACTCATTAAATGTAGAGAGCCCGTCAACCCACCAGGTCCTCCCACAGTGGTCAAAGTAACAGACACATCAAAGACAACTGTGAGCTTAGAATGGTCCAAACCAGTGTTTGATGGTGGCATGGAAATAATTGGGTATATTATTGAAATGTGTAAGGCCGACTTAGGAGACTGGCACAAGGTGAATGCAGAGGCATGTGTGAAAACAAGATATACAGTCACTGATCTACAAGCAGGTGAAGAATACAAATTCCGAGTTAGTGCTATCAATGGTGCTGGAAAAGGCGACAGCTGTGAAGTGACTGGCACAATTAAAGCAGTTGACCGGTTAACAGCTCCTGAGTTAGACATAGATGCAAACTTCAAACAGACTCATGTTGTTAGAGCTGGGGCCAGTATTCGCCTCTTCATTGCCTACCAAGGTAGACCTACTCCTACAGCTGTGTGGAGCAAACCAGACTCTAACCTTAGCCTTCGGGCTGATATCCATACAACAGATTCCTTCAGCACCCTCACTGTGGAAAACTGCAACAGAAATGATGCAGGGAAATATACCCTTACTGTGGAAAACAACAGTGGTAGTAAGTCAATCACATTCACCGTGAAAGTGCTAGACACTCCAGGCCCACCTGGCCCAATTACCTTCAAAGATGTGACCCGGGGATCTGCTACATTGATGTGGGATGCCCCTCTTCTTGACGGTGGTGCCCGAATCCATCATTATGTGGTAGAGAAACGAGAGGCAAGTCGCCGTAGTTGGCAGGTTATCAGTGAAAAATGCACTCGTCAGATCTTCAAGGTCAATGACCTGGCCGAAGGTGTTCCGTACTATTTCCGTGTTTCTGCAGTAAATGAGTATGGTGTTGGTGAGCCCTATGAAATGCCAGAACCAATTGTAGCCACAGAACAGCCTGCTCCACCTAGGAGACTTGATGTTGTTGATACTAGCAAATCCTCCGCAGTCTTAGCTTGGCTTAAACCTGACCACGATGGAGGCAGCCGGATCACTGGCTACCTGCTTGAAATGAGACAAAAGGGATCTGACTTCTGGGTTGAAGCTGGTCACACCAAACAGCTAACTTTCACAGTAGAGCGTCTTGTTGAGAAAACTGAATATGAATTCCGTGTGAAGGCCAAGAATGATGCTGGCTATAGTGAACCCAGAGAAGCCTTCTCTTCTGTCATCATTAAGGAGCCTCAAATCGAGCCCACTGCTGACCTCACTGGAATTACCAATCAGCTTATAACTTGCAAAGCAGGAAGCCCATTTACCATTGACGTACCAATCAGTGGTCGTCCTGCCCCCAAAGTAACATGGAAACTGGAAGAAATGAGACTTAAAGAGACAGATCGAGTGAGCATTACAACAACAAAAGACAGAACCACACTGACTGTAAAGGACAGCATGAGAGGTGACTCTGGAAGATACTTCTTGACCCTGGAAAATACAGCTGGTGTTAAAACATTTAGCGTCACAGTTGTGGTCATTGGAAGGCCAGGTCCAGTAACCGGCCCCATTGAGGTCTCATCTGTCTCAGCTGAATCGTGTGTCCTGTCATGGGGAGAACCTAAAGATGGAGGAGGCACTGAAATTACTAATTACATAGTTGAAAAGCGTGAATCGGGTACAACAGCTTGGCAGCTTGTCAATTCCAGTGTCAAGCGCACTCAAATTAAAGTCACTCATCTCACAAAATACATGGAATATTCTTTCCGTGTCAGTTCAGAGAACAGATTTGGTGTCAGCAAACCTCTAGAATCAGCACCAATAATTGCTGAACATCCATTTG
>TTN-206,ENSE00003810611,1,303,1214538,1214840,TCCCACCAAGCGCTCCTACCAGACCTGAGGTCTACCATGTGTCTGCCAATGCCATGTCTATTCGTTGGGAAGAACCCTACCACGATGGTGGCAGTAAAATCATTGGCTACTGGGTTGAGAAGAAAGAACGTAATACAATTCTTTGGGTGAAAGAAAACAAAGTGCCATGCTTAGAGTGCAACTACAAAGTAACTGGTTTAGTAGAAGGACTGGAATATCAGTTCAGAACTTATGCACTCAATGCTGCAGGTGTTAGCAAGGCCAGCGAAGCTTCAAGACCTATAATGGCTCAAAATCCAGTTG
>TTN-206,ENSE00003803222,1,306,1214841,1215146,ATGCACCAGGCAGACCAGAGGTGACAGATGTCACAAGATCAACAGTATCACTGATTTGGTCTGCCCCAGCGTATGATGGAGGCAGCAAGGTTGTGGGCTACATCATAGAGCGTAAGCCAGTCAGTGAGGTAGGAGATGGTCGCTGGCTGAAGTGCAACTACACCATTGTATCTGACAATTTCTTCACCGTGACTGCTCTCAGTGAAGGAGACACTTATGAGTTCCGTGTGTTAGCCAAGAATGCAGCAGGCGTAATTAGCAAAGGGTCTGAATCTACAGGCCCTGTCACTTGCCGAGATGAATACG
>TTN-206,ENSE00003801213,1,291,1215147,1215437,CTCCACCCAAAGCCGAACTGGATGCCCGATTACACGGTGATCTGGTTACCATCAGAGCAGGTTCTGATCTTGTTCTGGATGCTGCAGTTGGTGGCAAACCTGAACCCAAAATTATCTGGACCAAAGGAGACAAGGAGCTAGATCTCTGTGAAAAAGTCTCTTTGCAGTATACTGGCAAACGAGCAACTGCTGTGATCAAGTTCTGTGACAGAAGTGACAGTGGAAAATACACTTTAACAGTGAAAAATGCCAGCGGGACCAAGGCCGTGTCTGTCATGGTCAAAGTGCTTG
>TTN-206,ENSE00003809128,1,297,1215438,1215734,ATTCCCCTGGCCCATGTGGAAAGCTCACCGTCAGCAGAGTAACACAGGAGAAGTGCACTTTAGCCTGGAGCCTTCCGCAGGAAGACGGAGGAGCAGAAATCACTCACTACATCGTGGAAAGACGCGAGACTAGCAGGCTCAACTGGGTGATTGTTGAAGGCGAATGCCCAACCCTATCCTATGTCGTTACCAGGCTCATCAAGAACAATGAGTACATATTCCGAGTGAGGGCAGTAAACAAATATGGCCCTGGTGTGCCTGTTGAATCAGAGCCAATTGTAGCCAGAAACTCATTCA
>TTN-206,ENSE00003803385,1,306,1215735,1216040,CTATTCCATCACCACCCGGCATACCTGAAGAAGTTGGGACTGGCAAAGAGCATATCATCATTCAGTGGACAAAACCTGAATCTGATGGTGGCAATGAAATCAGCAACTACCTAGTAGACAAACGTGAGAAGAAGAGCCTGCGCTGGACACGTGTCAACAAAGACTATGTGGTGTATGATACCAGGCTGAAGGTGACCAGCCTGATGGAGGGTTGTGATTACCAGTTCCGGGTGACCGCAGTGAATGCAGCTGGTAACAGTGAGCCCAGCGAAGCTTCCAACTTCATCTCATGCAGAGAACCATCAT
>TTN-206,ENSE00003807140,1,306,1216041,1216346,ATACCCCTGGACCACCTTCTGCTCCAAGAGTTGTGGATACCACCAAACACAGCATTAGTTTGGCATGGACCAAACCCATGTACGATGGTGGTACTGACATTGTAGGATATGTTCTGGAAATGCAAGAGAAGGACACTGATCAGTGGTACCGAGTGCATACCAATGCCACAATAAGAAATACTGAATTCACTGTGCCAGACCTTAAAATGGGCCAGAAATATTCCTTCAGAGTTGCTGCCGTGAACGTGAAGGGTATGAGCGAATACAGCGAATCAATTGCTGAAATTGAGCCCGTGGAAAGAATAG
>TTN-206,ENSE00003809946,1,282,1216347,1216628,AAATACCAGATCTTGAGCTTGCAGATGATCTAAAGAAGACTGTGACCATCAGGGCTGGGGCCTCCTTGCGCTTGATGGTGTCTGTATCTGGAAGACCACCTCCTGTCATAACGTGGAGCAAGCAGGGCATTGACCTTGCAAGCCGGGCAATTATTGACACCACTGAGAGCTACTCATTGCTAATAGTGGACAAAGTTAATCGGTACGATGCTGGAAAATACACAATTGAAGCTGAAAACCAATCTGGCAAGAAATCAGCAACAGTCCTTGTTAAAGTCTATG
>TTN-206,ENSE00003810384,1,594,1216629,1217222,ATACTCCTGGTCCCTGTCCTTCAGTGAAAGTTAAGGAAGTATCAAGAGATTCTGTGACTATAACTTGGGAAATTCCCACGATTGATGGTGGAGCTCCAGTCAACAATTACATCGTTGAGAAGCGTGAAGCTGCTATGAGAGCATTCAAAACAGTAACTACCAAATGCAGCAAGACACTTTACAGAATTTCTGGACTTGTAGAAGGAACCATGTACTATTTCAGAGTGCTGCCAGAAAATATTTATGGCATTGGAGAACCTTGTGAAACATCTGATGCAGTACTGGTCTCAGAAGTGCCTTTGGTGCCTGCAAAGCTAGAAGTGGTCGATGTCACCAAATCCACTGTTACCCTTGCCTGGGAAAAACCACTCTACGATGGTGGTAGCCGACTCACTGGATATGTTCTCGAGGCCTGCAAAGCTGGCACAGAGAGATGGATGAAGGTTGTCACCTTAAAACCCACAGTCCTAGAGCACACTGTTACTTCCTTAAATGAAGGTGAACAATACTTATTTAGAATAAGGGCACAAAATGAGAAAGGTGTGTCAGAACCAAGAGAGACTGTCACAGCCGTGACTGTACAAGACCTCAGAG
>TTN-206,ENSE00003802641,1,288,1217223,1217510,TGTTGCCAACAATCGATCTTTCTACAATGCCTCAGAAGACCATCCATGTCCCAGCTGGCAGACCAGTAGAGCTGGTGATACCTATTGCTGGCCGTCCACCTCCTGCTGCTTCCTGGTTCTTTGCTGGTTCTAAACTGAGAGAATCAGAGCGTGTCACAGTTGAAACTCACACTAAAGTAGCTAAATTAACCATCCGTGAAACCACTATCAGAGATACTGGAGAATACACACTTGAATTGAAGAATGTTACCGGAACTACTTCAGAAACCATTAAAGTTATCATTCTTG
>TTN-206,ENSE00003806194,1,300,1217511,1217810,ACAAGCCTGGTCCACCAACAGGACCTATTAAGATTGATGAAATTGATGCTACATCAATTACCATTTCCTGGGAACCACCTGAATTGGACGGTGGTGCTCCACTGAGTGGTTATGTGGTAGAACAACGTGACGCTCATCGTCCAGGATGGCTGCCCGTTTCTGAATCAGTGACTAGGTCCACGTTTAAGTTTACCAGACTCACCGAAGGAAATGAGTATGTGTTCCGTGTGGCTGCAACAAACCGCTTCGGGATTGGCTCTTACTTGCAGTCTGAGGTCATAGAGTGTCGCAGCAGCATCC
>TTN-206,ENSE00003805894,1,303,1217811,1218113,GTATTCCTGGACCCCCAGAAACATTACAGATATTTGATGTTTCCCGTGATGGCATGACACTTACTTGGTACCCACCAGAGGATGACGGTGGCTCCCAAGTGACTGGATATATTGTGGAGCGCAAAGAAGTGAGAGCAGATCGATGGGTCCGTGTAAATAAAGTACCTGTGACAATGACACGGTACCGCTCCACTGGCCTTACTGAAGGCTTAGAATATGAACACCGTGTCACAGCCATTAATGCAAGAGGGTCTGGGAAACCAAGTCGTCCTTCCAAACCCATCGTTGCCATGGATCCAATTG
>TTN-206,ENSE00003808643,1,303,1218114,1218416,CTCCTCCAGGAAAGCCACAAAACCCAAGAGTTACTGATACAACAAGGACATCAGTCTCCCTGGCCTGGAGTGTTCCAGAAGATGAAGGAGGATCTAAAGTCACAGGCTACTTGATTGAAATGCAAAAAGTAGATCAACATGAATGGACCAAGTGTAACACCACTCCAACCAAGATTCGAGAGTATACTCTAACACACCTACCTCAGGGTGCAGAATACAGGTTCCGCGTCCTAGCTTGTAATGCTGGTGGACCTGGTGAGCCTGCTGAGGTACCAGGAACAGTCAAAGTCACTGAAATGCTTG
>TTN-206,ENSE00003805779,1,585,1218417,1219001,AATATCCTGATTATGAACTTGATGAAAGATACCAAGAAGGTATCTTTGTAAGGCAAGGTGGCGTCATCAGACTTACCATACCAATCAAAGGAAAACCATTCCCAATATGTAAATGGACCAAGGAAGGCCAGGATATTAGTAAGCGTGCCATGATTGCAACATCTGAAACACACACTGAGCTTGTGATCAAAGAAGCAGACAGGGGTGATTCTGGCACTTATGACCTGGTTCTGGAAAATAAATGTGGCAAGAAGGCTGTCTACATCAAGGTCAGGGTGATAGGAAGTCCCAACAGTCCAGAAGGGCCACTGGAATATGATGACATCCAAGTCCGCTCTGTGAGGGTCAGCTGGAGACCTCCTGCTGATGATGGTGGTGCTGACATCTTAGGCTACATCCTCGAGAGACGAGAAGTGCCTAAAGCCGCCTGGTATACCATTGATTCCAGAGTCCGAGGTACATCTCTGGTGGTAAAAGGCCTCAAAGAGAATGTAGAATACCATTTCCGTGTTTCAGCAGAAAACCAGTTTGGCATAAGCAAACCCTTGAAATCTGAGGAACCAGTCACACCAAAAACACCATTGA
>TTN-206,ENSE00003806836,1,306,1219002,1219307,ATCCTCCAGAACCTCCAAGCAATCCTCCAGAAGTACTCGATGTAACCAAGAGTTCTGTTAGCTTGTCCTGGTCCCGGCCCAAAGATGATGGTGGTTCTAGAGTCACAGGCTACTACATCGAACGCAAAGAGACATCCACTGACAAGTGGGTCAGACACAACAAGACTCAGATCACCACCACAATGTACACTGTCACAGGGCTTGTTCCCGATGCTGAGTATCAGTTCCGCATCATCGCACAGAATGATGTTGGCCTGAGTGAGACCAGCCCTGCTTCTGAACCAGTTGTTTGCAAAGATCCATTTG
>TTN-206,ENSE00003810204,1,300,1219308,1219607,ATAAACCAAGCCAACCAGGAGAACTTGAGATTCTTTCAATATCCAAAGATAGTGTCACTCTACAGTGGGAGAAACCTGAATGTGATGGTGGTAAAGAAATTCTTGGATACTGGGTTGAATATAGACAGTCTGGAGACAGTGCCTGGAAGAAGAGCAATAAGGAACGTATTAAGGACAAGCAATTCACAATAGGAGGTTTGCTGGAAGCTACTGAGTATGAATTCAGGGTTTTTGCTGAGAATGAGACTGGGCTGAGCAGACCTCGCAGAACTGCTATGTCTATAAAGACTAAACTCACAT
>TTN-206,ENSE00003805486,1,576,1219608,1220183,CTGGAGAGGCCCCAGGAATACGCAAAGAAATGAAGGATGTTACCACAAAATTGGGTGAAGCTGCTCAACTCTCATGCCAGATTGTTGGAAGGCCTCTTCCTGACATTAAATGGTACAGATTTGGTAAAGAGCTCATACAAAGCCGGAAATACAAAATGTCTTCAGATGGACGCACACACACTCTTACAGTAATGACAGAGGAACAGGAAGATGAAGGTGTTTATACCTGCATAGCCACCAATGAGGTTGGAGAAGTAGAAACCAGTAGTAAGCTTCTCCTGCAAGCAACACCGCAGTTCCATCCTGGTTACCCACTGAAAGAGAAATATTATGGAGCTGTGGGTTCCACACTTCGGCTTCATGTTATGTACATTGGTCGTCCAGTACCTGCCATGACTTGGTTCCATGGTCAGAAACTTTTGCAAAACTCAGAAAACATTACTATTGAAAACACTGAGCACTATACTCATCTTGTCATGAAGAATGTCCAACGTAAGACTCATGCTGGGAAATACAAAGTCCAGCTCAGCAATGTTTTTGGAACAGTTGATGCCATCCTTGATGTGGAAATACAAG
>TTN-206,ENSE00003801306,1,306,1220184,1220489,ATAAACCAGACAAACCTACAGGACCAATTGTGATCGAAGCTCTATTGAAGAACTCCGCAGTGATCAGCTGGAAACCACCCGCAGATGACGGAGGCTCCTGGATCACCAACTATGTGGTGGAAAAATGTGAGGCCAAGGAGGGGGCTGAATGGCAATTGGTGTCTTCAGCCATCTCAGTGACAACCTGTAGAATTGTGAACCTCACAGAAAATGCTGGCTATTACTTCCGGGTTTCAGCTCAGAACACTTTCGGCATCAGTGACCCTCTAGAAGTGTCCTCAGTTGTGATCATTAAGAGTCCATTTG
>TTN-206,ENSE00003808123,1,594,1220490,1221083,AAAAGCCAGGTGCTCCTGGCAAACCAACTATTACTGCTGTCACAAAAGATTCTTGTGTTGTGGCCTGGAAGCCACCTGCCAGTGATGGAGGTGCAAAGATTAGAAATTACTACCTTGAGAAGCGTGAGAAGAAGCAGAATAAATGGATTTCTGTGACAACAGAAGAAATTCGAGAAACTGTCTTTTCAGTGAAAAACCTTATTGAAGGTCTTGAATACGAGTTTCGTGTGAAATGTGAAAATCTAGGTGGGGAAAGTGAATGGAGTGAAATATCAGAACCCATCACTCCCAAATCTGATGTCCCAATTCAGGCACCACACTTTAAAGAGGAACTGAGAAATCTAAATGTCAGATATCAGAGCAATGCTACCTTGGTCTGCAAAGTGACTGGTCATCCAAAACCTATCGTCAAATGGTACAGACAAGGCAAAGAAATCATTGCAGATGGATTAAAATATAGGATTCAAGAATTTAAGGGTGGCTACCACCAGCTCATCATTGCAAGTGTCACAGATGATGATGCCACAGTTTACCAAGTCAGAGCTACCAACCAAGGGGGATCTGTGTCTGGCACTGCCTCCTTGGAAGTGGAAG
>TTN-206,ENSE00003808212,1,5609,1221084,1226692,TTCCAGCTAAGATACACTTACCTAAAACTCTTGAAGGCATGGGAGCAGTTCATGCTCTCCGAGGTGAAGTGGTCAGCATCAAGATTCCTTTCAGTGGCAAACCAGATCCTGTGATCACCTGGCAGAAAGGACAAGATCTCATTGACAATAATGGCCACTACCAAGTTATTGTCACAAGATCCTTCACATCACTTGTTTTCCCCAATGGGGTAGAGAGAAAAGATGCTGGTTTCTATGTGGTCTGTGCTAAAAACAGATTTGGAATTGATCAGAAGACAGTTGAACTGGATGTGGCTGATGTTCCTGACCCACCCAGAGGAGTCAAAGTTAGTGATGTCTCACGAGATTCTGTCAACTTAACATGGACTGAGCCAGCCTCTGATGGTGGCAGCAAAATCACCAACTACATTGTTGAAAAATGTGCAACTACTGCAGAAAGATGGCTCCGTGTAGGACAGGCCCGAGAAACACGTTATACCGTGATCAACTTATTTGGAAAAACAAGTTACCAGTTCCGGGTAATAGCTGAAAATAAATTTGGTCTGAGCAAGCCTTCAGAGCCTTCAGAACCAACCATAACCAAAGAAGATAAGACCAGAGCTATGAACTATGATGAAGAGGTAGATGAAACCAGGGAAGTCTCCATGACTAAAGCATCTCACTCTTCAACCAAGGAACTCTATGAGAAATATATGATTGCTGAAGATCTTGGGCGTGGTGAGTTTGGAATTGTCCATCGTTGTGTTGAAACATCCTCAAAGAAGACATACATGGCCAAATTTGTTAAAGTCAAAGGGACTGATCAGGTTTTGGTAAAGAAGGAAATTTCCATTCTGAATATTGCTAGGCATAGAAACATCTTACACCTCCATGAATCATTTGAAAGCATGGAAGAATTAGTTATGATCTTTGAGTTTATATCAGGACTTGACATATTTGAGCGCATTAACACAAGTGCTTTTGAACTTAATGAAAGAGAAATTGTAAGTTATGTTCACCAGGTCTGTGAAGCACTTCAGTTTTTACACAGTCATAATATTGGACACTTTGACATTAGACCAGAAAATATCATTTACCAAACCAGAAGAAGCTCTACCATTAAAATCATAGAATTTGGTCAAGCCCGTCAGCTGAAACCAGGGGACAACTTCAGGCTTCTATTCACTGCCCCAGAATACTATGCACCTGAAGTCCACCAGCATGATGTTGTCAGCACAGCCACAGACATGTGGTCACTTGGAACACTGGTATATGTGCTATTGAGTGGTATCAACCCATTCCTGGCTGAAACTAACCAACAGATCATTGAGAATATCATGAATGCTGAATATACTTTCGATGAGGAAGCATTCAAAGAGATTAGCATTGAAGCCATGGATTTTGTTGACCGGTTGTTAGTGAAAGAGAGGAAATCTCGCATGACAGCATCGGAGGCTCTCCAGCACCCATGGTTGAAGCAGAAGATAGAAAGAGTCAGTACTAAAGTTATCAGAACATTAAAACACCGGCGTTATTACCACACCCTGATCAAGAAAGACCTCAACATGGTTGTGTCAGCAGCCCGGATCTCCTGTGGTGGTGCAATTCGATCTCAGAAGGGAGTGAGTGTTGCTAAAGTTAAAGTGGCATCCATTGAAATTGGCCCAGTTTCTGGGCAGATAATGCATGCAGTTGGTGAAGAAGGAGGACATGTCAAATATGTATGCAAAATTGAAAATTATGATCAGTCTACCCAAGTGACTTGGTACTTTGGCGTCCGACAGCTGGAGAACAGTGAGAAATACGAAATCACCTACGAAGATGGAGTGGCCATCCTCTATGTCAAAGACATTACCAAATTAGATGATGGTACCTACAGATGCAAAGTAGTCAATGACTATGGTGAAGACAGTTCTTATGCAGAGCTATTTGTTAAAGGTGTGAGAGAAGTCTATGACTATTACTGCCGTAGAACCATGAAGAAAATTAAGCGCAGAACAGACACAATGAGACTCCTGGAAAGGCCACCAGAATTTACCCTGCCTCTCTATAATAAGACAGCTTATGTAGGTGAAAATGTCCGGTTTGGAGTAACTATAACTGTCCACCCAGAGCCTCATGTAACATGGTATAAATCAGGTCAGAAAATCAAACCAGGTGACAATGACAAGAAGTACACATTTGAGTCAGACAAGGGTCTTTACCAATTAACAATCAACAGTGTCACTACAGATGATGACGCTGAATATACTGTTGTGGCAAGGAACAAATATGGTGAAGACAGCTGTAAAGCAAAGCTGACAGTAACCCTACACCCACCTCCAACAGATAGTACCTTAAGACCCATGTTCAAAAGGTTACTGGCAAATGCAGAATGCCAAGAAGGCCAAAGTGTCTGCTTTGAGATCAGAGTGTCTGGCATCCCCCCACCAACATTAAAATGGGAGAAAGATGGTCAGCCACTGTCCCTCGGGCCTAACATTGAAATTATCCATGAAGGCTTGGATTATTATGCTCTGCACATCAGGGACACTTTGCCTGAAGACACGGGTTATTATAGAGTCACAGCCACTAACACAGCTGGGTCCACCAGCTGCCAGGCTCACCTACAAGTGGAACGCCTGAGGTACAAGAAACAGGAATTCAAGAGTAAGGAGGAGCATGAGCGACACGTACAAAAACAAATTGACAAAACCCTCAGAATGGCTGAAATTCTTTCTGGAACTGAAAGTGTACCACTGACACAGGTAGCTAAAGAGGCTCTGAGAGAAGCTGCTGTCCTTTATAAACCGGCTGTAAGCACCAAGACTGTAAAAGGGGAATTCAGACTTGAGATAGAAGAAAAGAAGGAGGAGAGAAAACTCCGGATGCCTTATGATGTACCAGAGCCACGCAAGTATAAGCAGACTACCATAGAAGAAGACCAACGCATCAAGCAGTTCGTGCCCATGTCTGACATGAAGTGGTATAAAAAGATACGTGATCAGTATGAAATGCCTGGGAAACTTGACAGAGTTGTACAGAAACGACCCAAGCGCATCCGCCTTTCAAGATGGGAACAGTTCTATGTGATGCCTCTTCCACGCATTACAGATCAATACAGACCTAAATGGCGTATTCCTAAACTGTCCCAAGATGATCTTGAGATAGTGAGACCAGCCCGCCGGCGTACACCTTCTCCTGATTATGACTTTTACTACCGACCTAGAAGACGTTCTCTTGGGGACATCTCTGATGAAGAATTACTCCTCCCCATTGATGACTACTTAGCAATGAAAAGAACAGAGGAAGAGAGGCTGCGTCTTGAAGAAGAGCTTGAGTTAGGTTTTTCAGCTTCACCCCCAAGTCGAAGCCCTCCACACTTTGAGCTTTCTAGCCTACGTTACTCTTCACCACAAGCTCATGTCAAGGTGGAGGAAACAAGAAAAGACTTCAGGTATTCAACCTATCACATCCCAACGAAGGCTGAAGCTAGTACAAGTTATGCAGAACTGAGGGAACGGCATGCCCAGGCTGCGTACAGACAGCCAAAGCAACGGCAAAGAATCATGGCTGAGAGGGAGGATGAAGAGTTGCTTCGCCCAGTTACGACCACCCAGCATCTCTCAGAATACAAAAGCGAACTTGACTTCATGTCAAAGGAGGAAAAGTCTAGAAAGAAATCAAGGCGACAAAGAGAAGTGACAGAAATAACAGAAATTGAGGAAGAATACGAAATCTCAAAACATGCTCAAAGAGAATCATCCTCATCTGCGTCTAGACTACTGAGACGACGGCGCTCCCTGTCTCCAACTTATATTGAGTTAATGAGGCCAGTGTCTGAGCTGATCCGGTCACGTCCACAACCGGCTGAGGAATACGAAGATGACACAGAAAGAAGGTCACCTACTCCAGAGAGAACTCGCCCACGATCCCCCAGCCCTGTGTCTAGTGAGAGATCACTCTCGAGATTTGAGAGGTCTGCAAGATTTGATATCTTTTCCAGGTATGAGTCCATGAAAGCTGCTTTAAAAACTCAGAAGACATCAGAAAGGAAGTATGAAGTTTTGAGTCAGCAGCCTTTCACACTGGACCATGCCCCTCGAATCACACTGAGAATGCGCTCGCACAGGGTACCATGTGGCCAAAATACACGTTTTATTTTAAATGTTCAGTCTAAGCCAACTGCCGAGGTTAAATGGTACCACAATGGTGTGGAACTCCAAGAAAGCAGTAAGATTCATTACACCAACACGAGTGGAGTCCTCACCCTGGAAATTCTGGACTGTCATACTGATGACAGTGGAACCTACCGTGCTGTGTGCACCAACTACAAGGGCGAAGCTTCTGACTATGCAACGTTGGACGTGACAGGAGGGGATTATACCACCTATGCTTCCCAACGCAGAGATGAAGAGGTCCCCAGATCTGTTTTCCCTGAGCTGACAAGAACAGAGGCGTATGCTGTTTCATCATTTAAGAAAACATCTGAGATGGAAGCTTCGTCTTCTGTCAGGGAAGTGAAATCACAGATGACGGAGACAAGGGAAAGTCTCTCCTCATATGAACACTCTGCATCTGCAGAAATGAAAAGTGCTGCATTAGAAGAAAAGTCACTGGAAGAAAAATCCACAACCAGAAAGATCAAGACGACTTTGGCAGCAAGAATTCTAACAAAGCCACGGTCCATGACCGTCTACGAGGGCGAGTCTGCAAGGTTTTCTTGTGACACCGATGGTGAGCCGGTACCAACTGTGACCTGGCTGCGTAAAGGACAAGTGCTAAGTACTTCTGCCCGCCACCAAGTGACCACCACAAAGTACAAATCAACCTTTGAGATCTCTTCAGTCCAGGCTTCCGATGAGGGCAATTACAGCGTGGTGGTAGAAAACAGTGAAGGGAAACAAGAAGCAGAGTTCACTCTGACTATTCAAAAGGCCAGGGTAACTGAAAAGGCTGTGACATCACCACCAAGAGTCAAATCCCCAGAGCCTCGGGTGAAATCCCCAGAAGCAGTTAAGTCTCCAAAACGAGTGAAATCTCCAGAACCTTCTCACCCGAAAGCCGTATCACCCACAGAGACAAAACCAACACCAACAGAGAAAGTTCAGCACCTCCCAGTCTCTGCCCCACCAAAGATTACTCAGTTCCTGAAAGCAGAAGCTTCTAAAGAGATTGCAAAACTGACCTGTGTGGTTGAAAGCAGTGTATTAAGGGCAAAAGAGGTCACCTGGTATAAAGATGGCAAGAAACTGAAGGAAAATGGGCATTTCCAGTTTCATTATTCAGCAGATGGTACCTATGAGCTCAAAATCAATAACCTCACTGAATCTGATCAAGGAGAATATGTTTGTGAGATTTCTGGTGAAGGTGGAACGTCTAAAACCAACTTACAATTTATGGGGCAAGCCTTTAAGAGTATCCATGAGAAGGTATCAAAAATATCAGAAACTAAGAAATCAGATCAGAAAACCACTGAGTCAACAGTAACCAGAAAAACTGAACCAAAAGCTCCTGAACCAATTTCCTCAAAACCAGTAATTGTTACTGGGTTGCAGGATACAACTGTTTCTTCAGACAGTGTTGCTAAATTTGCAGTTAAGGCTACTGGAGAACCCCGGCCAACTGCCATCTGGACAAAAGATGGAAAG
>TTN-206,ENSE00003811220,1,157,1226693,1226849,GCCATTACACAAGGAGGTAAATATAAACTCTCTGAAGACAAGGGAGGGTTCTTCTTAGAAATTCATAAGACTGATACTTCTGACAGTGGACTTTATACTTGTACAGTAAAAAATTCAGCTGGATCTGTGTCCTCTAGCTGCAAATTAACAATAAAAG
>TTN-206,ENSE00003801641,1,692,1226850,1227541,CTATAAAAGATACTGAGGCACAGAAAGTCTCTACACAAAAGACTTCTGAAATTACACCTCAGAAGAAAGCTGTTGTCCAAGAGGAAATTTCCCAAAAAGCCCTAAGGTCTGAAGAAATTAAGATGTCAGAGGCAAAATCTCAAGAAAAGTTAGCCCTCAAAGAGGAAGCTTCAAAGGTTCTGATTTCTGAAGAAGTCAAGAAATCAGCAGCAACCTCCCTGGAAAAATCCATTGTCCATGAGGAAATCACTAAAACATCACAGGCATCAGAAGAAGTCAGAACTCATGCTGAGATTAAAGCATTTTCTACTCAGATGAGCATAAACGAAGGTCAAAGACTGGTTTTAAAAGCCAACATTGCTGGTGCCACTGATGTGAAATGGGTACTGAATGGCGTAGAGCTTACCAACTCTGAGGAGTACCGATATGGTGTCTCAGGCAGCGATCAGACCCTAACCATCAAGCAAGCCAGTCACAGAGATGAAGGAATCCTCACCTGCATAAGCAAAACCAAGGAAGGAATCGTCAAGTGTCAGTATGATTTGACACTGAGCAAAGAACTCTCAGATGCTCCAGCCTTCATCTCACAGCCTAGATCTCAAAATATTAATGAAGGACAAAATGTTCTCTTTACTTGTGAAATCAGTGGCGAGCCATCCCCTGAAATCGAATGGTTTAAAAACAACCTGCCA
>TTN-206,ENSE00003801638,1,154,1227542,1227695,ATTTCTATTTCTTCAAATGTCAGCATAAGCCGCTCCAGAAATGTATACTCCCTTGAAATCCGAAATGCATCAGTCAGCGACAGTGGAAAGTACACAATTAAGGCCAAAAATTTCCGTGGCCAGTGTTCAGCTACAGCTTCCTTAATGGTCCTTC
>TTN-206,ENSE00003805382,1,303,1227696,1227998,CTCTAGTTGAAGAACCTTCCAGAGAGGTAGTATTGAGAACAAGTGGTGACACAAGCTTGCAAGGAAGCTTCTCGTCTCAGTCAGTCCAAATGTCTGCCTCCAAGCAGGAGGCCTCCTTCAGCAGTTTCAGCAGCAGCAGTGCTAGCAGCATGACTGAGATGAAATTTGCAAGCATGTCTGCCCAAAGCATGTCCTCCATGCAAGAGTCCTTTGTAGAAATGAGTTCCAGCAGCTTTATGGGAATATCTAATATGACACAACTGGAAAGCTCAACTAGTAAAATGCTTAAAGCAGGCATAAGAG
>TTN-206,ENSE00003809884,1,1319,1227999,1229317,GAATTCCGCCTAAAATTGAAGCTCTTCCATCTGATATCAGCATTGATGAAGGCAAAGTTCTAACAGTAGCCTGTGCTTTCACGGGTGAGCCTACCCCAGAAGTAACATGGTCCTGTGGTGGAAGAAAAATCCACAGTCAAGAACAGGGGAGGTTCCACATTGAAAACACAGATGACCTGACAACCCTGATCATCATGGACGTACAGAAACAAGATGGTGGACTTTATACCCTGAGTTTAGGGAATGAATTTGGATCTGACTCTGCCACTGTGAATATACATATTCGATCCATTTAAGAGGGCCTGTGCCCTTATACTCTACACTCATTCTTAACTTTTCGCAAACGTTTCACACGGACTAATCTTTCTGAACTGTAAATATTTAAAGAAAAAAAAGTAGTTTTGTATCAACCTAAATGAGTCAAAGTTCAAAAATATTCATTTCAATCTTTTCATAATTGTTGACCTAAGAATATAATACATTTGCTAGTGACATGTACATACTGTATATAGCCGGATTAACGGTTATAAAGTTTTGTACCATTTATTTTATGACATTTTACAATGTAAGTTTTGAAACTAACTGTTGGTAGGAGAAAGTTTCTTATGGAACGAATACCCTGCTCAACATTTAATCAATCTTTGTGCCTCAACATACTGTTGATGTCTAAGTATGCCTCAGTGGGTTGAGAAAATCCCCATTGAAGATGTCCTGTCCACCTAAAAGAGAATGATGCTGTGCATATCACTTGATATGTGCACCAATACCTACTGAATCAGAAATGTAAGGCATTGGTGATGTTTGCATTTACCCTCCTGTAAGCAACACTTTAACGTCTTACATTTTCTCTGATGATGTCACACAAAATTATCATGACAAATATTACCAGAGCAAAGTGTAACGGCCAACACTTTGTTCGCTCATTTTACGCTGTCTCTGACATAAGGAGTGCCTGAATAGCTTGGAAAAGTAACATCTCCTGGCCATCCCTTCATTTAACCAAGCTATTCAAGTATTCCTATGCCAGAGCAGTGCCAACTCTTGGAGGTCCCAGAGTGCAGCCAATGCCTTTGTGTGGTAGTTCTAAATTTTAATTGCACCTGAAAAACCTGGGCACCTAAGCAATGAGCCACAGCAAAAAGTAAAGAACAACAACAAAATAAAGCTGTTGTTAAATTTTAAACAATATTACTAATTGCCCAAAATGTCAATTTGATGTAGTTCTTTTCATGCAAGTATAAATTCAATTGTTAGTTATAATTGTTGGACCTCCTTGAGATAGTAACAACAAAATAAAGCAAGCTATCTGCACCTCAAAA
>TTN-206,,0,2556,1229318,1231873,GTGAGCAGCAACTTTTCTTATTTTAATAGTAGAGTCACTTTCTTATTGATCTCTGGCTCTGGATTATTTGTGTGTGCTAAATGCCTATGTACAAGTGTTTGTATGACTATTTCTTGCCAGTGCTGACCCATTATTTAAATCTGCTTGTTAAATTCTATTTTAAAATGTCTGAACATTTTTCCTTAAAAAGTTGAAAGCTTTATTATATCAGCTAAATGATTCCATGATTCAAATTGTTTAAGTTCACTTAATATTCTAAAAGTTGAGGTCTGAAATGTTGAGAGAAATGTTTACTTCTTTTCTAGACTCTCTTTGCCTGTTGAGAATGTTCAAGGTTATATTACTCAATGATAAAGTTAAGCACACCAAGAATAGCTCTGATAAAATGCATGTGGTATCAGCTACACCCTGATGACTTTTTAAGGGAATCAACTGCTGAGGTATCAGTTGCAGGACAGTGACAGAACACTTGCCTGCTGTCAGTCAACCTTGGAGAGTTTAGGAGAGTTTATTTTAAGAGCATGACATTTTAGACGCATACCTTCAGCCCCAGTTAGACAAAGGCCTGTGAAGAGCAAGTGCTAAGGCAATAAAATTTACCTAGACAATAGGAATGTAAGATCAATTTAAGCTGGTTAATTGCAACATAGTTGGAGATTTGGAATAAAATGATATAATTGTTTTCTAAAATATTCAGAATCTCTTCATGCATTTTAACTCAGCACACAGTCCAATTATATATTTTGAGATAAATGTTGACACTAAGAAGGGTAAGAAATAATGTTTAAAGGAAAGGTTTCTTACTTCTAAATACACTTTGATTTCTCATCTTCCTAGAATTTGATTACTAATTGTCAATGCCTGTAAATACATAGATATATAATTAGGTATTCTATGTCTAAGAGGACAGCTATTTTTAGATATACTAACTTATAAACAGACAAAGTTAGACACAGAAAGTTGTTCATCCCAAAGATAATATGCTACAAAAAGGAGTTTCTGACAAAAAAAATTTATGAAAGCTTTTGGATATTATCTGATTTTTCCAAATATAAATTTTATTGTCTCAGAGAATGCTGGTTTCATTTTTTTAACTAAGTAGAAGGTTACAGTAAGGAACAGAATTATCACTAAGAAGATTATTGCTCCATGAAGTTTTAGTAAACAAAGAATTTAATGAAAAATAGTAATGAAGTGATTGACAATTCAGAAATGTTCTATTTCAGAACAGAATAGTCATGTTGAATAATTAGGTATTTATGCATCAGAAAATTCTTCACATAATGTCTCTGAAACTGATAGGCAAAGTACTTTCTTGCACTTAACAAAATGACTTAACTGCAAATTTTATATTCGTTTCTTTGATGTTGAATATTTTACTTTATGAAAGCATAGGCCTTTTCACTTCATCTACATTTTACACCAGCCTTCCATTATTCAAAGTTTGCAAATTGTTCCATATTAAGAACTCAAGCCAGCATTTTTCTTTCAGAACTATAATAAACTTTGGCCTGTTCACTAAAATTTAAATTTTTCTGAATATTTACTTCAGCAGTAACAACATTTACTGCACAGTTACAGTATGAAGAAATGTTAAGAAATAGAAAGCACCGTATGCCGTCTACAAAAAGCTTGCATATTTGATAAGGCTTGCCAAAGCTTCTCCAGTCAGGAAAGAGATTACAAAGTTCAGATTTTTACTTCTGGCAACTATTTTAAGTAATCAGATAATGTCTGAATCAATGTCAACTTTATAAATATAGAGTGAACGAAAAATATTGGGGAGAAGGAAAATTTTTAAAATAATTTTCACTTACTAAGCTGATGCAGAGGTTTATTTATTTTAATTTTTTTTTTTTTTTTTTTTTGAGACAGAGTCTCATTCTGTCACCCAGGCTGGAGTGTGGTGGCACCATCTTTGCTCACTGCAACCTCCACCTCCTGGGTTTAAGCAATTCTCATGCCTCAGCCTCCCAAGTAGCTGGGACTACAGACATGGGCCACCACGCCTGGCTAATTTTTGTATTTGTAGTAGAGACAGGGGTTTCACCATGTTAGCCAAACTGGTCTCAAACTCCTGACCTCAAGTAATCCTCCCGCCTCGGCCTCCTAAAGTGCTGGGATTACCAGCATGAGCCACCACGCCAGGCCCAGAGGTTTATTTTACATTTATCACATGTCTTGTCTCTCTAATTACACTTCACTAACCCTGCATTGCTGTGGTTTTCTTCTTCAACTCTGAACCTGGTTTTCCACCATTGGTAAGACTGTATATTCCCTCTTTGACCACTAGGGTTCATTCCTTGTTCTGTTTGGCTAATACTTTTTTCCATTTCCCCTTACACTTGCTACTTTGGGTTAGGCTTTAAGTCAACTCAATGATGAACTATGCAAAACTGTTCAAGCCACAAAAGAGAAGACCTGCCCATCACTCTAGGCCCACAGATGACCTATGGAGCAATCCATTTGGAGAAACGTGTGTCTCTGCTATCTGCAAAGCAGCTCCAGAGTGACCCTTAGCTGGGACACCCTAATTTATTTTCTCTTCTTTTTCAG
>TTN-206,,0,2210,1231874,1234083,GTAAGCTCACACATTCACACTTTTGTTTTTTTTTCCTTTGCCTCCTCTCCAGTAAGTTAACGTTGCTGCAGGACTTGACGCCAAGTTTAAGCCCTGCTTTCACTTCGGAAAATTAGTCCAACACTATGGAAAGGTCATTTTAAGGGTATACCATTCACAGAGTACTGACAAAATCTGACAATATAATGGCTTGAAATGTTTTATTCATATTTATTATTCCACAAAGCAAAAATAATTAGTGTTGGATTAAAATTGCCGTTAGAATCCAGCAACTAAATAGGACCAAATTTAGTCATTCTATATTTGGGCTCAGCTGCAGAGCCAGACTGGAAGCCAAGAACTCAAGCCCAATAGAAGCCAGCCACAGAGCCATGGGGTAGGCAGTCTGGGCTGCCTGCTCTGGACACCTGAACTTCAGTTGGTTCACACGCAAAATAACAGTGCATCTAATTTTCCTCAGAGGCAGAGCTGTTCAGTAATTAACCAACTCCTCATTATTTTATTATTTTATTTTCAATCTTTATTGAGTGATTCTAATGAATTAAAAGACTTTCCAATCGTTTTGAAATGACAGAAAATAATATGCTTCTCGGGTGTCTCTATTTAAAAGGAAGCAAACACTAACCCTAGAATTTTATCTGAAAGGAAGTTCATCTCTTTTTTGCCTTCTTTTTCTTCCTCATAACTCAGTTTATGGATGGTTCAAAAAAATGCATGGTATCATCTTATGAAAAAATGGAGAGTAGTGTATGAACTATATTGTAAATAATTTTAAAATTAATCAATATTTTCTCTTTCTGTAGTATTGTAACGAGCCATGTAAGATGGATACGGATTAAAAAAAATCATGCTTAATTCTTAATTTAGTGCACTTCCATGGTTCATTGCCCACTTCTTTTTTAAAATTTTATGGCTTATAATAAAGATATAAAATAAAATTTCTTTTTTTCTCTTTTTTTCTATTATATGCACCAATCTTATTCATAACTGGATAATACTTTCTTTTACATTGTACAAATATCATATAATCATTGCTTATTTTCTATTGTACATATATAGACCAATGAAATTCCCTTTTCATTGGTCTATATATGTACAATAGAAAATAAGTCTTACCGACTTCCAAATAATTTACCTATTTATCTGGTAACACTCAGTAACTTCTGAACTGAGCAGAACACATATGACTTCAGTGGGAATTTGCCTCCTTGAGAAGTAGTGGAATCTGGCTACTTCATATCTTCTTGTTCCTTCAAACTATATGCAAATAAATTATTACAAAGACACTACTGAAAATATCCAATACCCATAAATCAGTCCAATAAACTATTTAATTGGCCATAGTGGGAGATGGGCTAATGTATAAACAACAAAATAGACTTTCTCTAGATTATCTTTACCTACCAGCGTAAGTAGATAGAGCATCAACCTTTATGCCAAGTGTGAAATAAATCATGCCCTGAATGTGCCTCGTACATTCTCAATGTACAGAGTTTTAATATATTTAAAACATCAAACCATGGACATGTAGTTCTTGGCTCTACAATTTATGGCAGATAAAGAGAATTTGGCTTTCTACCTGCAATTCCAATGATCCATGTTGTTCTGGAAGACTAGGTTTGGATTAGTCTCTTATGAGAAATTGCTTGTCCATGTTACAATGTTTTTACTGATTGCACTTGTGAAAGCAGAAGAGTCCAAGAAGACAGTGTCCCTGTAACCACAGAGGAGGGAGGAGGGCATGCCTCCTGGGCTTGTCAGGCAGAAACTGGAGATCAGTTTGCTGCTTTTGTTCTTCACTTGCTCTCAAAGAGGACAACAATCACTCTTTATTTCAAATTTTCCTTGGTTCTTCATTTTTATAAGTCCCTTTCATGATTTTAATGTTGTCTATTAAATTGCATCAGATAGAGCCCTAGGCAGGCAGGCAGGAGATGGAAATTCTAGTCCCCTCTGTGTCACTGCTAGCTGAAGGACCTTGGAAAAATCATTAGGCCTCTTTTGGTCTCAGTTTCCTCCCTTCCTGCCTTCCTAATGGTCTGCAGGTTTACACACTGATCATGCAACTGTAGGGTTTTCCCTATCATTAAGTGGCATTCCATGCTGGAAAGCTTTTACAGATTCGGACAAGGCAGTGAACATGATGGGACAGAGCAGAGGACTTTGTGGTGCCCATTCAAACATAAAGGTGAATTGTTCTTGCTCTTCAG
>TTN-206,,0,1455,1234084,1235538,GTAGGCTGCTGGGGACCTGCCAATCCTCTGCTCCCCCAGAGGACATCTCCAGCAAATTGGGAAAGGAGTCCAGAAAAAGCTATGGGCAGAGGTAGATGCAGCTCTTAAACTACAGAAGGGTCTACTGGAGGCTGAATTATTTATAACCAAGTTGTTTGCCTTTTGGAATTTAATTTTCCTCTAGAGTACATCGTAAAAGTGACTGAGAATCAGTTTCTCAATACACATATTAAACACTCAAAAGTATGTTAAGGAAATATTAAAAATCATGTTTCTCAGCAAGTAGAAAAGCTTGGAGCCTTGTTTATAAGTCCTTTAAGGAATAAGACATATTCTCCAGGGAAGTGTGAATCTCCAGGAATTCACACTTTAACAAGCATCCAGATAATTCTGATGCCGGTAGTCTACAGACCACCCATTTAAGAGGCATGTAAACATACCCAGAAGAAAATAAATGCTTGTTTATTATTCAAATGCATGACACTGTTTCCCCAGAAAACTTATCACCAATCTTAGTGGCCTCTGTTGTTTTTCTCTATCCTTTACTACCTAGTGAGACATTAGTATACAGAATATTGCATGCCTTTACATGTTTTATAACAATATCTTACATGAGCTACGTAAAGTTACATATGCTTATCCAATAAACTTTACCTTCAATGATGTTCAATTATAGGGCTATAATTGACCTAAGCAGAAACCACATCAAGTAACATCAGGTAGAACTTTAGCATGCACCCAGAAAATTCACAAATGGAAAATGCACAGGGTTGGCAGCACCTGCTGTTGTTTATTACTCAAAATCATGTCAAAGTTAATTCCACTCACTCCTCACACTTATAAAAAATTTCCTTCAACATAACCAAAAAAATCCCCTTTCTGTAACACAATTAAAATGAAGTAATGTTATTATTGGGATTAACGTTTTAAATGCAAGTAAATATTTGGGTTATTTGAATACCTATCAAGTTGGAGAAGGTTTAGAATTTTAAAAATTAAATTAAAAATGTAATGATTCTTTAAGTAACAGGTACACCCATCGTAGCAACCACTGGAATTCATTTTAATGCAACTTACTGGAATATGCAACATGGCTTTCACATATTAATAGAGCGCTAGATGTGAGGTAGAGGGGGAAGTACCAGAAAGATTCTCAAGAAATGTTATAACAAAATCTAGAGCTTTTATTTAAAACAAAGAAACAAAAGGTGGTGGCCTAAACTGCTCAGCAAAACAAAGCAAATAAAATAAAATATGGTGGTGAGAAAGCCTTCTGTAATCTCCTGGCTCCCATTCTTGCTGTCATTGCTGGGTGAGCTGGGTTCAAGGACATTCAAGGATGTTTAGATTGGCGAGTCATCACCTGGTTTTGGAATTGGAGCTGTGATTATTTAAAAATACCTTGTAGGGAGCACCCTGGCTCTCACTCTTGACTTTGTTCTCTTGTCCCCGCAG
>TTN-206,,0,484,1235539,1236022,GTACGTGCTGGAGGTTGAGGAACAGAGAGAAGGGGAGAGAGCTGGTTTGTGTCTAAATGGGGCCAAGCGTCCACTTGCCACCTCTCACAGCCCTGGGAAGAATGCTGTGAGCTGATATAAAAGCTGGCTTTTCGACACCCATGAAAAGTCCCTGAGATTCTAGTCAGGAGCGCAGAATAGAAGCAATCTGTGCTTATGAATCTCATTATAAACTGGAAAGGGTTTCAATTAAGTGATCTACATTTCCAAATTATTGGCAAATAATGAAATTTTAAAAAATCATTCTAAGTAAATTTTTATCTTGTAATGAACATTTTCTATTTTTAAACCTAATTTATATTCATGCAAAATCCAAAACTTTCTGCAATTTTCTCCATTGGGATATCCAGAAAATCTTTTTGACTTTGTAGTCAGAATTAACAGAATCTCTTTTAAAATGGGTCATTGTGCCCCCTCCCAAACATTCATCTTTCCCTTCCCACAG
>TTN-206,,0,93,1236023,1236115,GTATTTTTCTATACTGTTGGTTTTCAAGCCTTTCAGGCTGTTGCGTCCCCAGCTATTCCTCCTCAACGTGGGCTTTGTTTTAATCTTTTACAG
>TTN-206,,0,4234,1236116,1240349,GTAAAGCTGCCATAGAGAGAGCAGATTATTGCACATTTTGGAACTAGGTTTTGAAACGAGAAAGATTCCCTTGTCCCCCTCGCAGGGCATGCGACGCGGAGAGTGGTTCGCTTCTTCAGTGTCCCGCTGCTCAAACCTCTAGGGGAGCATACAAACGGGCAGGTTGTGGGGCTCCGTGTTCCTCTGGACATCCAGCCGCTTGTGTGTCTGCCTACTAGGGTCTCAGGGGTTTTTATAGGCATAGGGTGTGGGCGTGGCAGGTCAGGGTGATCTTGGGAAATGCAACATTTGGGCGGGAAGGCAGGAGTGTTTGTCCTCACCTAGGTCCATGGGCACAGGCCTCGCTAGGGACCACGCACTTCTCTTCCCAGCACTTCCCTGCCCTCCTCCCGTGTAAGTTTCATGCACTCAAAAATGTAGCAGGTGACAAAGGAGGTAAACCAAGAAGTTACTGAATATGATTTTCACAAATCCTCACTGTCCACAGGTAAATTGAAGACCCTTATAAACTTCTGAATTCTTATTTATATTTCATGTAATAAATATCTACTTTAGGGGCCAAAATATGGCACAGTGAAAGGAGAAGAGCACAGAAGTTAGAGTTCAAAGCCCTAAGGACAAATCAGCCTGATCACTTAACAGTTTGATTTAGGGCAATAAGTATAAATAATAAAATAATTGTTATTATATATGGATCACTTCCTCTATCAGATTGGAACTATACATACATTATCTCATTAAATGTTCACAACCTGTAAGAATTATTATCCTCAATGTTATTGATAGGTAACTGGAATTAAAGAAGTTAAGCAGTTTATTTAAGGTTTCAGTTGTGTCATCTGTAAATTAAAGAGAGTCACAATAAGAATGATCTCAAGCTGCATTTTGGGGCTTCAATGAGATAATTAGTTGAAAGTGCCTTGTAAATAGAAAATAATTATGCCAATATTCTTATATTCAGATGGTAAGTAAAACCTTTTAAATATTTTGCATATGCTTGTGTTATTTTATCTAGAAAATAAAATGGACTTCTATGCTTACTTAATATGGAAGTATTTTAGAAGGTGATCATGTATCATGATCAGGGCTCAGAAATTATATAATCAAGTGTAAATTGTCCACAACAGTTTTGAAAGTTTGGGATTTAGTTTATCATGATGAAACTTTTAATATGATGAAATGAAAAATGTACAAAATTTGAGCAAAGAAGTGTTTATTGATCAATTTAAATGAAATAAAAAACACATGGATGTTCCCTGCCAAGAAAATTTTTTATAAAAGAATAATAAGGAGATAGTTGACCTAAATAATATTCAAACATACTGTAAAGTTACTATAATCAGAACAGTATGGTATTGGTAAATGAATAGAAAAATACACCAGGGGAACAAAACAGAGAGTCCAGAAAGAGATCCAAGTATAATAGATCCAAGTATATAGGGAATTCAAAAAGCAAAGTGGCCTTTCAATTCAGGGGAGGGAGAGGTATTTTAATAAAGAATGCTGGTCCAATTAGCTATCCATCTGGAAGCAAACAAACATAAACCTCTGCCTCTCACTATTTACAGAATAAATTTCAGCTTGATTAAATAGTTAAAAAATGAAAAAAAAAGAGAAGACAATCTGCAAAAGCATTTATGGGTGAAAGCTTTTAAAAAGACAGTTACAGATTCAACTACATAAAAATCAACATGTATGTATGGCAAAAGCAAAAAGTCATTTCTAAACCAAACAGCACTTGTGAAAAAATTTTAAGACCTTTCTCCTCCTCAAGGTACTTCATTGCCTCTGCCATAAAAGTATCACAATAAACATAAAATGGCTACAAGGTAGACAACACCAGCCTAGAAACAGTATATAACATACAAAATTACGTAAGCTTATGCTGGATAAGACCCATAAACAAGCAAAATATTGAAATGGATTAAAAGAAATGGATCTGGGGGAATGTTTGCAACACTTACGACAAATAACCAATAAATGCACTAAATGCATTAAAAATCATCCACAAATTAATTTTTAAAGGAAAAAAATGCAACACAAAAAAAGACAAAAGATACAAAAAAGTATTTAACATAAGAGGCAATGTAAAAGTCCAATAAACATGTGAAAAAAAATGCTAGATGTTTTCCAATTTTTATTGTTTTAGCCACAAAAATGTAAAGATATTGGCAAACACTAACATGAAACCTTGAACAAAAAGCTTACTTTAAAAAACATGTCTAGCAGTCGAATAAAAAAAAATGTTCAGTCTCAGGCTAAATCCAAGTTTGCACACCATGAAATCACAACACAAGCCAAATGCAATTTCTTGAGGAGATAACAACCTAACTATATTTTAAAACCCAAGCCTAAGGGTCATTTAGAATCATGGAGTGTCCCTGATCCCATGGAGCATTTTGACCATCTTAGCAGTTTTGAAAGTTCATTAATAACCATCCAAATTGCCCCAAAATTTTGCTTTCCAATAATTAAGAAATAAAATGCCAATTTGCAGAGAAAATAATGGTTATCAAAGATAGACTGCTTCCTAAATATCTCATAGTTTAATCTTGATTTTTGTTGTAGAGTAAGGCAAACATATTTCATTGAATAAGGTGCATTGTATCTCGCTGTGACCAGGTGATTATTTTTTGTTGTAAGTACAGAAATAAGCACTCTCCTATAATGACCAAAATTACAATGATTTTCACAGTTATGGGCTTACCTGTGTCCTGCTGTTAATCAGTCATGTCATGCTAATCATGTCTTTAACTCTTTTTGAATTAAACCCATTTACTAAGTACAGCAAGAACAAGGCACAGGGTGAAACTTAAAAGCACATGTCTCTTTGCTTTTCTTCAGTTAGTGGAAACCACACATTATTCTAACTTGGTTTTTGTTATATTTCAAAGGCAGTCATGTTCAGAAAAGAGGCTTATTCCCTAGATTTCCCTTTAGTTTGATTACAACTTCATTTACAAAATGTAAATGGATTTTCACACAAAAAAAGCCATTCTTCGAGAAAATAAACATTTCTTCGTGAAACTGGTTAATGTTGTAATGTACTGTTAGGGTACTCTGTAAGTTAGAGAAAATATCAACTGTACCTTGAGCTTAATTAGAATAATCATTTCATGTATGATCAGTGTAAGCTAAATATCCTAGATAGTGACAAGATGCATTTATAAACATTTTCTTATATGCAGAATTAATAAAATGCAATGATAGGGCAATACTGCCACCTAGAGAGGAAAATGTAATAAGCCTTATTAAGAATTAAATCAGTTCTGAAAAAAATTTTACCTTACAATAGTTGGCCAATCCCCAGAATTATTGCTATAGATCAGAAATAGTCTTTTTTGGCCATCAGTGCTGGGATTTAGCACCCAAATTCTTCAACTGATGCTACTTGCACTTTGGATACACCTAAAAAGCAAACAATGAAAACTATTCTGGAAGAAGCAACTTTATCAATTTACCCAAAAATCACAGAATCATTAGTTTTTAAGTTAGTCAATTCCCACAATAACTCTAAAGATATTTAAAATAAGTCCAGAGTGCAATACAAGGGGGGCGAGTGTAAACAAATATGGAGGAAATTAAAAGTAGCTGTCCACAAACACTTCGGCTAAAGCAGCAATTTGCAAAGTGCACTGCACAACCTGTACCCAGCAACATGCTGCAGAAAGCTTCCTGAGGATGTGTCCCCCTGTCCTGGAAATTCACAAGGCATACTGACATAGTAAAGGCTGTGGGAAGTCCTGCAGGGGAAAAAAAAAAATGGCTTAAGCTGCTTAGTCAAGAGTGGCACAAGCATTTTGATTACAGAAACCTTTCTTCTTATAACACCTATTTGACATCCTCTAACCCCCCCAGAATTGGAATACAGAGATGAATTTGGAATACAGAGGTTGCTGGATTTGACATGTCTTTCCTTTGGCTGCATATTAAAGAAGTAGCTTTTTCTGTTGTGATTTTTTTTTTTTTTTAATGTGAGAAGGTGCAAGGCACAAAATCTCCAGCTTATTTGGAATTAAAGCTGATTCTCTTACAGGGTTACAGCAGATAAGAATAGGTTTATTGAGATTTAAAACAAATTACTTCCAAGTACATTATTTACCCTCTGAATGGGTTATGGAGGCACACATTTTAAAACTCTGCCTTAAAGCACTTCCAGCTTTTCATCTCATGATTCACATCCAGTTACCCCTCCTTGCTTTGACATTCTTGACCTCTGCCTTTTGGTTTTCAG
>TTN-206,,0,370,1240350,1240719,GTACTGTCAGAATGGTTTTGTTTTTCCTTATTTCACATTCTAGTTTCTCCAACTGGATTTCTGCCATGAAACTCAGTCTGTATAAATTGGAGGAAAAATGCATATGAACATAAAAATATAGCAGCAACTGAAGACCAAATTCAGTAGTCATGCTTTGTAAAACCATTTTTAATTAGGACAAAAGCTCCAATCTGTGAAGTTTCCATAATATACAGGTTTTAATGATACAGTCTCTGTATTTCTTGGCAATAATAAATGCTTATGTATGAGTGTATTTTGCTCTAGGTGGCTCAGTTTTCCAGTATGCTTTTTTATTTTCTACTGGGCATGTCATTTAAAAAAGTAATCTACTTGGTCATTTCTAATCTAG
>TTN-206,,0,857,1240720,1241576,GTACGTGCGAGGCTGCCATGGGGCACCCGCAGAGCCACGTCCTTCAGTGCACATTAACTCAACCACCATCCACTGAGCTTGGCATGCAGCTGTGCTCAATTCATTCTGAAGACAGCCTTGAGCCCAGCAGGGCCCAGACTTTTAGAACTTTCTGAGCAAAAGGTGGTCGGAGATGTCAAAGGTGTTGACAATGTGAGTATCACAAGAGCAGAGTAGGCCAGAAATACCTGGGCTATATGAGCAGGCAAAAGTCAACTATGGTATTCAAGGTAGGAAGGCAAAGAGTGGCCAGAGAAACAGAGACCAGTCAATTCCAGAGCTCAGTCACTGCACACACTGGATGTGGAAACTACTATTTCAGGGAAGGCATTACATTTCTCTAAGTTTCCCCAAAGGACTTTTGTTTTTACTTTTCTCAAAACAAACATGACACTTGATTCATAGCTGGAACAGTGTCATAAATCCAGGATAATGTCCCACCTCGCATTTGAATAGATTTTCTGTTACAGTTTAAAATCATTCCAGCTTTCCTCCTTATCCTCTTGTGTGACATTTATGTCTAAATCCTGACAGATTATTGTAACTTTTTTTTCTTTTCTGAGACAGAGTCTCGCTCTGTCACCCAGGCTAGAGTGCAGTGGCATGACCTCCGCTCACTGCAGCCTCCGCCTCCTGGGTTTAAGTGATTCTTGTGCCTCAGTCTCGTGAGTAGCTGGGATTACAGGTGTGCGCCACCACACCCAGCTAATTTTTGTATTTTTTAGTAGAGGATTTCACCATGTTGGCGAGGCTGGTCTTGAACTAATTTTTATGTAAGATGCATTAAGGTGTTTTCTTCCTTTCTCTATGAAAAGCAG
>TTN-206,,0,1206,1241577,1242782,GTGAAAATGGGTTTGTATTTTAAATTCACTGAGGTTCTTACAGGGGTCAACACAGATAATCACCTTTACCATGAAGAGTGTTGTTCCTTGGGCCACATGGTTGTTAGCATACTAATAAGATCCCCTTGTTGTATGTGTAAATTTCTGGGTACTGGATACCAAAGTTTGGTAGTGTCCCTGAATGCTCCCCTTGTGAGTATGAAAAAGAACTCTGTGAACATACACCAGGAGTAGAAACAGGGGTCTCATCACATTGATCTGGGGATGCACTAAGTATAAGACTATAGGGAGAGGACAGATGGCTAAAACCAGGAGGAAGAAATAGATGCTGAGGCAGGAATGGGGAAAAGTGGAGGAGACACTGAACTCACTTTGCTTTAGAAATCTTAGCAACTGCTTCCTGGCTCCTTCGGAAGACATTTGCACATGAGTTTGAAGTGGAATGGACAGCATGGCTTTAACAAGCCAAATGACCAGAAAAGGTGAAAAGGACAGCCCCATGGTTGGCGGCATTTGGGGACAGATTGGAAAATGCCAGTTAGTAGAGCTCTTGGCCAGTGGAACCAGTTGGCAGTTGGGTGGTTTGAGAAGATGAATTTCAAGTCCCTTTCAGCCTTGAGATCCTGTGTTTCAGTGATGAGATATTTGAGAATGGCAAAGAGGCAAATAGAGAAAACTGTCCCCCTACATACGCATATACCTTAGGTGCCCAGATGGAAACAGCATTCTTCACAGTATTTAGGAAAACTGACAAAACAAAAATATTGTATAAATGCAGATTATAAATTATCCATGCTTGATTTCTCACATGTAAAATAAAAAGATCAGACAAAATTACTTCTAAAGTCTTCCATTCTGATATATATTCTAAGATTACCTTTAGATGACAGAATTAGTACAGAATAATATTGCCATAGATCTATTTGTAAACATTGGAAGTCATTTTAAAGAAGACTACAATTCTGCTGTTCAAAACAAAGTGTTGAATTCAACTTTGTTTTCTCTAAGCAGCCTACATAATTTACAGTTTAAGGAGAGAAAGAGCATGATCTTATTTATGAACATGGGATTATTTATTTTATTTAGTGACATCTGCAGAAAAGGGATTTTACATCTTCAAATTCCTATGTTGTTATATTTAATAAACACCATATTATTTCATTGGGCATCAGGAAATAAAGTTTTTTCTTAAATCATTCTTTGCAG
>TTN-206,,0,1226,1242783,1244008,GTAAGTCTGATTTTCTAAATATTTTGTAGTTTGTTGACAATATCACATTACAGCCAGCTGCAGGTAGCTTATAGTCAAAACCCTTAAATGGAGAAGTCTTTGGTTGTATATTTTTTGTTATTGTTCCTCTATGTCTAGTATTGAAACTCAGGATGGAAATTATGTTCACATTGCACTATTTTCCACTCACTTGATCAGTTTTCAGGAGATTGTCTACAGAACAGTTTAGGGCACATCTATGAACTTTCTAGAACATACATAAATGGATGATAGATATCATGCCAGTCCAGTTACCCACCGGGACAGTTGGTTTCTTCGTGCATAGCCTAAGCCCTCAGTCACTTAGATTGTAATGCACAAACTTTACATGCACACACACATGCACACACACACACACACACACACACATATACACATACATCAGCCATAAACACCCCGAATAAATAGCAAGGGAAAGTGAGGATATGCCAGACATCGGAGAAAGCAAATACTTCCTCAAAAAAAAAAATTCCTTCAATTCACGGTTGATAAACAGTGACCTAGAAGCATTTGCTGCTGTTGTGCCGTAGAGCTGTGTGAGGACAATCTCAGTGTCACTAAAATCCACATCTCTCCCGTATGTGAAATCAAACCTTTAAGTGTCAGGAGAGAGGCATTTATCTTGAATTCTTCCATGTCAAAGAGGGCGCCTGTGCTCATCCTCCTTGAACTCAAGCTCTTTGCTGATCTTAGAGCTACTTTCTTTAAAGGTCCAGTTGAGAACCTTGTACACTTAAAAGGCTGACCAGAGGCTGCTGACTGAATTTCCCTCTCCTTACTGTGAGTGAGACATTTTGAAAGCAGCAAGAACCCTACTTAGGATAATCAAAGGCATAGAAATCCCCATTGCCATTGCAATGCTGGTGACTGGCAAGTTCAGCTGGCCTATGGTTTTCCAGCCACTTGTCAGCAGCCACCCACCGGGTTCCCTAACACGTTGACATGTCTCAAGATGAGATATGTTCAGTTCTAGGACAATTTGCTAAGGCGCATGTGGGCAGAAAAGAAGCCCATTCCTCAGGAAAGCAGTCTATGTATTAAGCACAAGTGTAGGCCCCTGAAATGGAAATCTGACATTTTATCGTTCACCACTAAGCATCCTGTATTTTCCTGAGTGTTTCAAGGATGTCTTCCCATTGCTTTTGTATCTTTTGAAACTCAAATCTTTATTTTACTCTAAACATCAG
>TTN-206,,0,592,1244009,1244600,GTGATGACTTCCTGCCAATGTGAAAGTCACTCTTGCACCATTTCATTTGCAAATCACCTACATTTTCATCATGGATCTTAATCATCACTTCTTCACTTCCACCTCTTCTTATAATGCAAATAGAAAATTTCTTTTCCCACACAGCTACCTTTCACTGTCAATTCATTCCTAACTTTCAGACTTTCTTTGGCTTGTTACTAATATAATATAATAATTCACTTTAATATCTTCCTATTGAAGCAGATGTCCGTAAACAAGTCAATTCATAATACAAAAAATTATGTGCTATTTACAGTGCTACTGAAATGTCTCAGAGATTGCAGTTTTAAAAAATGTGAAAAGTACAAAATAGCACTCATTAGTCTTTTATTGCTAATCACATTTTTTTCTTTTAAACTGGACTTATTGTTTTGATATTTTTGCCAGTGAAACAGTATGGATGATCAAAGTAACTCAAATGATATATTTTAGTGCAATTAAAATTTCCTTGAATAGGAAGAAATTTTGCCTCCTTTCTTTTTGACTTACGTTTCTTTTATTAAAGATTTATGGAATTTAATGACTATTTTCTTACTTTCTTTTGTATGATCAG
>TTN-206,,0,480,1244601,1245080,GTGAATACAGATATTTGAGCTGTGAAAAGTTCATCTTTAAACTAATTTCTAGTAAACTATTAACTACAATATGGTATGAATTATTAATCTGTATTTGCCTTTTAAAATCCCTAACTAAAAACAAAATGGTAAATATGAGACTGATTATCATTAATTTTATCTGCACATTTGATTTTCATCCATCTGTAACATTTATAATTCATTTTATTCACCATTATTCTTTGCATGAAGATTAGCATTTTTTAGCTTAATTTTTAAAAAGTGACACAGGGACTCATCTAGAGGTTTTTTAATAGCTAACATTTCTAAGTTTTGTGATTCTCAGTCAGTATATGTAGACATTGCCGGTGAAAGTTTATTTCTCTTGTGTATTTAACCCTGAATAACCATCTTGCATCCCCATGAGGAAGGGGGAAGGGTCATACTATGTGTGTTTGAAGCCCTGTTCAACTTAAATCTTGATTTTACTGTAATAATCAG
>TTN-206,,0,3218,1245081,1248298,GTGACTATTGTTGTTCCAAGTGTGAAATCCCCTATTATAATACATTAATACCACATATCATGTGAAATTCCTTATTGTAATACATTAATATCAAGTCTCTGAATTTCTTATGTATGAGTCACTATTAACCAAATTTATTTTTTAGACAATTAAATAATTGGAAACTAAAAAAATTTATTATTGTTAATATTACTACATATCCCTTTCTCCACTTATCTCTTCACCATTATTGTCAACATTTTATTAACATCTGGGAATCTTCCAGAAGTTGATTAAAATTGCATGCAGGCTAATTTTAAGAGGCCCATGAACATTTTTTAAAAACACGGAAGATGTATAAGTAAATGATGACTCTTACTCACTGTCAAGAAGATGTGTGTTTTGAAGGGTCATAAATTCAGTATATTATGTTATGGAGTATGACTTATTTCAGTAAATTACCCATAATTTTCTTTGTATGAAACTTTATCTTTTTTCCCTCCTGTAAATATCAGAGGAGAAGATAAGCTGAAAAAATTATAATGCATGCTGTAGCAGCTCCCACTAAAGCTAAACAAGATGCATATTAAAATCTAGAGAAGGAAGTATCCAAACAGAACAATTACACATAAGCCATGAAAAGATTACCGTATCTATTTGTAGCTATGAAATATCCATGAATTAAACTGTTTCCCATGACTCTGTCATTTACTCCAAATGAGCCATTTACCTAATTGTATTCTTTATTGCTAATATACCACTTGAAAATTAGCAACTAAAGTTTTTCCATTTCATTAGCAGGATGGCCTGAATCCTATTTGTATTTCCCTCAGTGTCATTTTCTGACTCTACATCTTTTTTTTCTAAGATATGATTTAAGATAAACTTTTTAAACCTTTACTCAAATCTAACATTTAATGGCATATCAGCCTTTCAGAAGTCTCATAAATGACAGAAATTCCACTATGCAACATACTTCATGAGTGATTAACTTTTTACTTTTGTTTCCATTCAAATTTTGTCATGAATTGACTATCTTGTTTTTGTTAAAAATTAGCTAAGGATGGAAGCTGAGAAAATGTTTATACCTGAAGTAGTAGTTACCACTGCAAAATCTGCTGAACCAGCCACACCGCCAATGACTAGAGAAGGATTCACTATTAAACAAAAACAAATACATCTTTTTCGAGAAGAGATGAAAACTGATGCTATGGAGGTGAAAAGTATTGTTTCATCCCATTTCATCATCAACTCTCATAACTTTTCATCCGTCGTGAATTGTGCTTCTAGTGTTCCATCTAATTGTTTAACTGATCAATAAAACAATAGAGATGGTTAGATTCAGTCCATCCTCCAGTTGAACAGTGAGCATTTCTAGTAGTGAAAAGTCAGACCAAATAATACTCTTCTTTATGTCTCCTAAATTTATTCTCAGCATTTAACTCGTATGAATTGGAGTATTCTAGTCCAATTTGTCTTCCTGCTTCTCTAGGTTACAAACATGTGAGAGATATCAAAGTCCACTAAGAAATAAAAGCGGTTACCAGCATACTCATTTGTAGTCCACCAATAAGTGTGTGTATATAAATCTGATATACAATAATTCAAGGAAAAAACAGACAGATGCTTCCTCAATTTAAAATATTTTACCATGATTAAGATTTTTCCATATGTTTAAAATCAAGAACAAAATTTAAATATTTCAGTTGTGTGATATTTAGTCATATGACAGTTTCTTTGACAGTTTCTTTTATCATTGTTAAAATAAAATTAAGACTTAAGCTGACTACTTCATAGCAGACTGGCTAAAAGGTTCAAATGAGATATAGTGGAAATGTGATCACACTACAATCAAAATAATATTTATTTATTTAGTGTTATCTGTCGAAGATGTTAACATTTTAAAATGTCTATACAATTAAAGTCAGCTCATTGCCAATATAGTTTTTAAAAAAGAAAAAAATAAATGGACAAACTTAACTCACCTAAGCCTCATGTGTATTTTATGTTTTTTTCTGAGATGATGCAATCTAAAGTGAAGATGGTATTTGCAGTCCTTCGAGGCAGATGAAATTGTTTGTGTCTTCCTAAAAGGAAGCCCTGGATAAAGCCCATGATCACTAAAGACCCAATTCCATCTCAGAAAAATCTCATTTATATCTTGAATGGTTCAGAGAATAATTTTTAAAGATATGCAGGTAGCATAGTTGAAGAATGTTTCTGATGCATTCTAGATTCTATTCACAGGTATAGAAAACTGAATATTAATAAAATTTTCCAATCTTACTTTTAAAATGCACTTTTAAAATGTACTTTTAAAATGAACATGGCTATGTGATTTTTGAGGTATGCTGTTTCCAAGTATCACATAGAATCATAATATCTAAGCCACATCAGCTAGTTTGCCTTCTTTAAAAGAGAACCTCCTCTGCAAATTGTATTTCCATTAATGTTCATCAGACTCAGAAACGAGAAAATAATATTTGTTTCATTCTTTGCTTTAACTCTCCATAATAATGAAAGTAAATTAAACTTCAATGTGAAAGGTTGTTCTCTTGAATCCAAACATGATAACACTTTCATTTTAATCACAATATTTTTATTTGCACGGGGTTCTCTTTGTCATCTGTGTGTTTTAAGAAAGGTATTTTCTGATAGATTAAACAATCTTACCCTTAGGGAATCATAAGTAAATTCATATGCTCACTCTGTGTTTGTGAGCTTTCATGTTATGTCCGATTTGCATGCAACCATATAACTCTGTAGTCACTGATTTTTCTGGACAGGATGATGACGGTATTTGAGTGCACTTATATCATCACTGTCACTGCATTAATACCAGACTAAATGGTCAACAAGATAATAAAAATAATCAGTGAAAAGAACCAGCTCCAAAATTCTGATTTTCCAATTGCTGATTGATTGTCTGCCTGGAAAAATTCTAGAAAATTTCAAAATCTTCTTGTGATTTTATGTTCATATTGTGATTGTCCTATGTTGTGTATATGTGATTTAATGTCTAGTATAATTAAGTAGGTGTACAGAGAGTATATCTAAATAGATGTCTGTACAATATAATAATCAATGAAATAGTCCCTAAAAGTGTTTCTGAGATACATTTCTAGACACGTTAACACTGCTGTATAATGTGGACGCCATCTGCCTGTCCTGATGCCCAGGAGATATTCCAGCCTGATCTCGATATTCCTATGTATTAATTCTGGAAACCTTGTCTCCAG
>TTN-206,,0,105,1248299,1248403,GTGAGTCTATACCTGCTGATTTTTCACCTTGTTCATGGTAAAGCAAGCCTCACTGCTGTGGTCATCTGGTGATCAATGGTATCACTGAGTTTCATTTCAATGCAG
>TTN-206,,0,1268,1248404,1249671,GTAAGAAGTTACAGAGCATGATACAGAAATGTTTAAAGGAAATAAGTATCTAACCTGTGAAACAGAGCATCTCTGGGGTAGGCCAATGGAGGATTCTTTTTTGGTGATGTGTGTGTGCGTGTGTTTGCATTCACAGTGGGCCCAGACACCCTAAAGATTTGGTTTCTGAAACTCGCCCAGGGGAGTGAGCCTAGAGTCACAAGTGGTTATCTTATACCTCTGAGGAGAGACAAATCCACACAGGCTTCTCTCTAGTTCACATTTCAGGGACAGCTCAAACTCAATTGTTTTGATTACTATTGTTCTAATGATTTTGTGAAAGGTAGTGTGTTACACAGCATAGTTTTACTTATGCTGTGAGACATTTCAGAGTAACTTAACTGTGAATGTGTTTCAATAATAAAGACAGACATTGAGAAATCATATATTTATATACTCAATATAGCAAGATGGAGAGGTGGTACTGTATGGTGGTCGGGTTGGATTGTGGAATCAAATAGCTCTGGATTAGTGCCCTATCTTCTCCCTTATAATCTCTGTCATCAGGAGAAAGTAAGCATACATGTAAAATGCAAGTAAAAAGGACATAAAAACCTGCAGTTGTCAGCATGTAATAAATCCTTGATATTAGTCACTATTGTTATTATACACATCCAAGAAATAGAACCCAAACCTTCTATGCCTTCAAAGAACTGTAAGTTACATATAATGCCTATATTTGATTTAGTCCCAAATTACAAAACAAATAACCATAGACCACAACAGAATAAAAGCAGTAAGGAAACCTTTAAAATATTTTTTCTGAATGTCTTCATGTTTACCTTTCACATAGATTTGTGGCTAAAACCCAAATGTACTATTGCAAAGTAGTTCTTAGGCATTTACCAACAATTTCAATAATTTCTTAATTTTGAATCTCCCACTGTGGTATTTTCAAAAGTGGCATTCATCGGAATGGTTAAGTGAAAATTCGTGACTAAGCTTTAGAAGATCCTGTCCTTTTATGATAAAAGCTGTAAAATAAGGAGTTCTGAATACAACTCTTTAAAAAAGATATTTTAAAATTTGTTTTACAAACTAACAGGCATGACAAGGAGCTTTATAATTGGCTTATCTCTAAATGACTTTTCATTAACTGTGTGATAATGAGTGCTAATGAGAACATTAAAGAACAGACCTTATAGAAAATAGGCTCAGACTCAGTCCAAGAGGGCTAGCCATCGGAGGATGGTTAAATGACTTTATTTTCTGACTCTGTTTCCATGTAG
>TTN-206,,0,284,1249672,1249955,GTTGGTCACTGGTTACCCGCTGTTACATGGTCCACTCCCATTGAGCAGGGCCAGGTGGTTGGCTAGTTTGTACTGAAAAGTAGCCAGTGGAGTCTTGCCTTTCTCCTTTGCCATACTAAGACTTGATTTTTATGGAGCATAGTATGGGTCAGAGATCATTTTCTCAAATTATTTTTATAATTATTTTTATATTTTTATAATTATATAATGTTGCATGAGCTAAGAGTTTATGAGATTTCCCTTAATTTCATGAGCATTTTGTAATATAATTTGTAAAAATCTAG
>TTN-206,,0,655,1249956,1250610,GTGAGTAAAGAAGTTGATAATGCTGGACCCTATTCATATCTCCTCAAATCATTTTAATACACGTTTGCAAAGATCAGTTTCTCAAATTAATACAAAAATGACATTAGTGAGCTTACAGATGCTCATTTTAAGACCGTATTTGGTCTGGAAGACCATATTTGACCATATTTGGCAAGGAAGAAGGGAATTCTATGTGGTACATCATTCATGGATTCAAAAGATTTAATGAGCTTCTAATATGCAGAAGGCATTATTGCAGGAGCTGTGCAGACATAAAGACCAATCCATCCCTCTTTGAAATATTTTCTTTGCCATCAGAGAAAATGTACACAAACAAGCATAATAAAATATATAAGGTGATAAACATCACAACAGAAGGAGAATCCATGGGAGGCATAGATTCATTCCAGTTGGTGATACCATGGCAAAGCTTTGTTGAATAGGTAGCATTTGCTATTGAGCCTTACAGCTCTTTACTAATATATTAGTATATTATATAAATATTAGTTTCTCTACTACTATTTCTGGAGTCCTGATTAAAAGGCCATTTTGTGGCAGTTGAAATGCATAAGTTCAAACTCTACATTTGTTACAAAACAGAAGTGATTAATGAATATGCACACGTATCATTATTTATTTTTTCTCCTCTCTTCAG
>TTN-206,,0,203,1250611,1250813,GTTAGTGGCCACCCTCCCACAGTCCTAATGCACATGCCATCACTTTCATCTGACACTCTTTTCCACAATATGGTTTCTGTGCACCTTGAAATGATGTCCCTTTTTGGAACTTGGGGGGAGATTATATGGTCAATTTAACTGTCAGTGCTAAGCAGGGGTCACTAAACATCTCATCTCAATGAGAAACTTTTGTCTTCTTTTAG
>TTN-206,,0,111,1250814,1250924,GTAAAATATTTTGCTAATTAGTAGCTGTTCTAGTACCATTTTGACTTTCAGCCCCACCAGTATTGGCAAATTGCAACCCGGAAGCTAATATGAGGGGAATTCTCTTTCCAG
>TTN-206,,0,948,1250925,1251872,GTATTTTGATGGCTGAATATAGAGTTCTCTGTGACTTGTATAATACGTGCATGAAGCCTAGAGTAGAATTTACTCACCCCACCGACCCTGAGCATAGGCTCTTTCATTGTGGAGCCTTCTTAGTTTGTTTTGAGGTATTTTTACATTTTTTTTGTGCAAAGTCTTCCTAAGAAATAAAGCTATGTGACAAAAGTGGATGGAAGATATATTTCTTTACATTATAGTTTAATTCATTGAGTTTGTGAAAGTAGAGAAAATATGGATTTTCACACAAACACACCCACACACACACACACACACACACACTTCCAGAAAAGATTTGAGACAATTTTCAATAAAAACATGTAATAACTAAGTGACTAAAAGATAGAAGAATAGCCATGTAATGAAGAAGAAAGCTAGTTATGCACAAAAATCTATGCTAGTAATTTTTCTTCAATTCAATATAAAATTTAGCTCTGAATATTTTGCAATTTAAGATAAAAAGAGCAACCTGGTAATCTAAAAATGTAGGTGCCGTACCTTCATAATAATAAATATAATGTACCAGAGAGTTAATACTGAAATATTTGAAGGAATTTATTGTTTTAATTATTCATTTGATCTCTGAATGAAATAATGAGAAAAATAACGAACAAAGAGAAAATACCTGTTGTTTAAGTGACCTGATCATTTGCTAACATAAACACTGAAAACCACTTAATTTCATGACTGATTCTAGCAATAAATATTCTTTAAAATGAATATTTTAACTTATTTGGCCCTAATTACTCATGTTCTTGCATTTTTCTCAATTTTCAGCAATCTTATAATCTATTGTGGAGCTTAGTCATATGTTTAGGGTCATTGAATTTTATACCACAGATCCACTCACAGATAAGTCCAATTATTTTACCCACAGAAGAGTTGTTGATAACTGATTTTTAAATTTTGTACATTTACATAAAG
>TTN-206,,0,915,1251873,1252787,GTAAGTGCAACTCCAGTTTCTATGTGCATGATAAGAACTGAAATACAAGGAGATAGCAGTGCTGTCCGTTTGCTGAAAAACCTGTTGCCACTTACTGGTTCTGATACTTTGCCCCAGTGTCTTTGCCTCAGTTGTATGGAAAATGTTTTAGACCACATGGCCTCAAAAACTATACTGTCATTAAACTTCTGAGGTTCTAGCAATAGTTTCTTTTTGTTGTATTTGTTTCTAGGCATATCATGCCTCTGAAAATGCAGAGATTCTAAATCCGGTTGCCTTCCAGGCCCAGGCAGGTAACAGTGAGCTCAATGAAAACAGTAGCAAACTGGAGAGTAGGTGCCCTGCCTCAAAGAGACAGTAGCTGTGTTGTTGCCAGGCATGCACCAGGCTGTTACCAGGCTCAGTGTTGCTAGAGCTCCTGATATCTTAAAGAAAACCTGGAAGTCAGGATTTTCAATGTTTATAACTTGAAAACAAATGTAACAGCTTTCATGCTAGACTGTTCACATTTACAGTGAACTGGCTCACACTCTGTTTCACTTGACCTACACAGTATCCCTTAGAGGAAATTACAATATTATCTTCATTTAGCAGATAAAGCACTCAATATTCAGGAAGGTAAATGAATTGTTAAAAGACACACAGCAAATTAGGAAGTCCTCCGTGGTAGATCCCCCCAAAACTGACTGCTAATATAAAATTCTTTCTACAATTGTAATGGCTGGTTGGATTTGTTAGTGTTAGTTTGGTTTCCAAATTCCATCTAGAAAATATTGAGCACTTCAATAGTAGATATTTGGAAAATTTGGTTTTTGGTTATCAACTTTCCCCAGTGTAGAGTTTACCTGAATGCATAGTGGTATGACTGTTTTCTAATAAGAGCATTAAAAATTAACTGATGTTCTTAACTCTTAG
>TTN-206,,0,537,1252788,1253324,GTGAGTATAAAAGTAATGACCAACCAAACAATTTCATAAATTATACTTTCCTTTTTTTATTTGATATTTTCATTTTCAAGTGATGAGCTCGGGGTTAGACAGCTATTAGAAGGTCCAAGTTCACTGTTGCTAAGTTTCCTTAATCTTCATGGTATGTTGCACCTGTGAGTTTAGAAATAGAGATTACATATAGGCCATAAATGTGACTTTAAAAATAGGGCTTATAATATATTAAGGAAAACACCAATATTAGCACAGCTGAGTTCATTCATGCCAAGATCTCTTCATCTGTGTGATAAGCTAATGTAACCTCTAACCCAAATCTAACTCCTGCTTTTGGAATACCTTTCTACCCAAGATGCCACAACATTCACTGGGAAAGATGACCATAATGCAGATTAAAACAAACAAACCAAAAAGTCCTCTAGATTCTTCTCCCAGCTAAAAACTTCAACAGTCTAGCTCAGATACATCTCCTTAAATAATTTATATCAGTAAGGATATGTATTTTTAACAGACCATAATCTTTTTGCATAG
>TTN-206,,0,110,1253325,1253434,GTAAAATATAAACATTTATCATAGCTCCTTGCCACAGTAAAGATACAAATTGGTTAAAATATAACTATTTGATGTAAATTTTATTCATACATGCATGGTATTCTTTGCAG
>TTN-206,,0,898,1253435,1254332,GTAAGACTTGTAATAATTTGGGTTATTTAGTATGTAAATTGTTTTCAAAACATCAAATAGTAGCAAATTGCTATTGTGTAAGAAGAAAATCGAGGGCTAAAATGGCACAGAAACTTACCATTGGCAACACCAACAATTGCCAGAAGTTTTTATTTCTTGCCCCTGTGTAAGATGAGCAAAGAATTTTCATCAGTGTAACATACTGTTTATTTTCCTAGTGCTATAGCTAATATCACAATAGCTCTTATTTGACACCTGATTTTTACATATGTAAATTTATACAACAGCCCTGCAATAAAAAGATGACTATTATTGGTTTGGAAATAGGAACACTGAGGCCCTGGGAATCTATGAAAATTGTCTTAATTCATCCAGCCTGTAAGCGGTGGTGCCAGCATTCAAACTCCAAGTCAGTCTGGCTGCAATGTGTAGATGGAGTCTTGTTTTGCTTTGTTTTGTTTCCAAATTCATTTCTATGTTTTCCTCCTCTGAGATAAAGAATGTGTATTTTTTATTTTTCCATAAATGTATTCATTGGTTTACTTATCCAACCAACATTTATTAGGATGTTTTAGTAGTTAAATCAAAAAAGTCTAGTGACTGATTAAATCCAAGTGGTAAGGAAAAGAGAGTATTGAGGATTATTCCAAGATTTTTGAGCCTGGGTACCTGGATATACTGAATGACTACCAGCTAAAATTGAGAATATAGGAAAAACATAGTTGTGGGGGCAACAATAATATATTCTATTTTAGATCTGAATGAGTTTGAGGTGCCTTCTAATACGTGCAAGAAGTAAATTCTAAAATAACATGAATAATGAATAAGACAAAATGAAGTTTGTTTTGCTGAGTTTTCTTTATGCCTCACGAAAGTATTGTGTGTCTTTGTTTTGCAG
>TTN-206,,0,119,1254333,1254451,GTAAGCGTGATAAGTTTTTGCTCATGAATCATAAAAACACAAAAACAAGCTTATGTATGCATCTAACAATTTTTAAAAACTATTTTAAAATCTACTTTCTTTTAAACATATTTTCACAG
>TTN-206,,0,102,1254452,1254553,GTAAAATGAGATAAAATAAAAATAAATGAATTTTCTTATCACTTGGGTTATAAACAGGTATTTCAGCCTTACTCCCTCTAAATCATGACCTTTCTCTTTCAG
>TTN-206,,0,99,1254554,1254652,GTAAGTATGGAAATAATAAAGCTAAGCTCATTATACAAATCCAATAACCAGGGAAGCTATACCACTATATTGATTATTCCCTCCCCCAACTTTTTATAG
>TTN-206,,0,153,1254653,1254805,GTAATTTGCATGTCTTTCCTTTGATGGACCTGTCTTTGTATTCAAGAATATCCATGAGTGTGTTTACTTTTATTTTCTTTCCCCATTCCTCAGGTTGAGAATTTAATTTAATATAATGTGCTCTCCCCTTTTTCCCCCACCTTTTTCTTGTAG
>TTN-206,,0,447,1254806,1255252,GTATTCAACAACGAAGGATTTCATTGTTTACCTAAGCTCTAAAGTCACCCTTAGCATGTGGTAAAATTAGCTATGCAATTTTTCTTTCATGAAACAATTATTTGGAAATTGACTATAAGTTTCATAGCCAGAATCATAAATTTATGTTCGTAATTAAGAATGTTAACAATTTGACCATTTGGATTTTTTAAAGTAGTATTATCTTGATTTTTAGCTTTTAAGTTTTTTATTGAAGCATAATTCTTTACTTTCAAAAATATTTAAAAATTAAAATAAAATAACTGCTTCTTATTGAAAATTTATCTCTCAGCCCATCAGCGGGTAGATATTAAGAATACACCTGATAGTATGGGGGAGATAAAAGACATACAAGACATCATCTCTATCCTAAGTCTAGATGCATACCTCTCCAAAAAAATTGATTTATCTTTCTGTTATACACTTCAG
>TTN-206,,0,96,1255253,1255348,GTAAGTCCTCCCATTCCTGTCAGCCTGCAGTGAGCATCATTATGGTTTATTGATAAAAAATGATCATAACATTCTTTTTCTCCCCATATTTCACAG
>TTN-206,,0,112,1255349,1255460,GTGAGTCCTAATTATAAAATTTTATGTTTACACTATTAAGCAACATAAAGAACTTCAAGGAGCAGACAATTTCAACAAAATTCATTCATCTTGTGTGTGTATGATTTTGCAG
>TTN-206,,0,92,1255461,1255552,GTAAGGATTATTCTACCTATCTAATAATTACTTTAAGCATTCTACTTTCCCAGTGTAACAATAACCAAGAGATTATTTTATTTTTTCCCCAG
>TTN-206,,0,1637,1255553,1257189,GTTGGTATATTTATTAACCTAAATTCTTACGAGGAGTGATTGTTATTTTAAGAAATTATTATTCATTTCCCCCAAAATTCCTTTCAGTTTCCCACTTCCATGCCTCTGCTTATGCTGTTCCCAAAGCCAATAGTACTTGCAACACCATTCCCACCAGCCTAAATTACAAATGTTCTTCTAGGCCTACCTCAAACGTCACCTTCTCCATTAAACCTTCCTTAATCTCTCCATTTGTATATGATCTCTTCCTCATCCAACCCCAGGATCACTTTATATGTGCCTCTTTCCTAGTGTTTATTATGCACTTGTCTTATTCCCCATTTCCTCTTTCAATATCAGTGTATAAACTCCTGAAATCTGGAATTCTATTTGTATATTCCAATATATTGCAAATGACAGATAATCAATTGGTGTTTGCTGTATTGAGCTTTATTTAAACTTCCTTACTCTAAAGAATTATTTCCTTTTTTAGCCATTCTTGCTTCTTTAGCCTTTGTGCCTTTTATTTTCTTCCTACTTTTTAATGAAATCAATAAATATTTTCAAAATACAGCTTAATGTAACTGTATTTCTTATGATATCATGTAGAAATAAGACCATCATTCAGTAGAATTTCTTAGCTTTACAATGAAGAATAAAAAATGTAAATCAATTGCCAGAAAAAACTAGAAGTCATCATTAATTTGTTTGGTTCATTACAGTTTAAATTTTGAGGAGTTGAGATGTTACATTCAGATCGTGTTGTCCATTACATCTAGTATTGAAGCAAGTCATATGGTAATGATTTGTCTTATTTGGTATGAAAGTTTCATGGTTTATACTTACTTACGTTATAAGATTTCTTCAGAGATCGGACCATGAAAAGACTTGTAAAACAAAATTTCAGATTCAGCATTTTTATACATTTAATATAAATTACATGTTTTAAATGTGTGGAAACAGGAATAAACTATGAACTCCTCTGTGATTTCACCCAGTGTTTTTAAAGTACCTACCATTGGTCAGACACTTGTAGAAACTCAGGACACAAAACTAAATAAGAAATGATTTTTTTCTTGAGAAATTCATAATTTAGAGAGGACAGATACATAAGCAACTAGCTTGTTAAAGCAGTAATTATTTCTGCTAATGGATGATAAGAGTGGAGGCAATGGGGTGAAACTTCATAGAATGGGCGACATTTGCCAACACAGTGATTTTTAATATATAGAAATCCTCAATGTAGTAGAAACATTGATGACTCGTACATTTTGTTTAGCAAATTTTTATGTAGTCAAAATATCAGATTCCCAGGAAATAATCATTAAAAGACCAAGTAAAATGCTTTTGAAGAAGAAGGAATTGGGTTAGAGACTATCCTGGTGGTATACTGTTCTAAGAATTTCCTATTAATTCAACAGTTATTTTTTCTTCACAAAACTTTTCTGATTCCAGTATTTCTCCTAATTATCAGTTATGCATACTTAGAATAAGGGATTTCTTTGGTACCTTCTCAATATGGGTAAAAACAATCATAGACATTTCATGATTTCAAAATCATGTTCTTAAATTTGATATTTTATATTTACTTCTGCAAAGATTTTCCCATTGTGTGAATATGTTTAAAGGACTCATACTGTACATCTCTTGTTCCAAAG
>TTN-206,,0,535,1257190,1257724,GCAAGTAACATAGGATTTGTCCTTTTCAAATCATATTACAATCTTGATCGTTATCGTTTTAAAAGACAAACGATATGGCCATTTTGGATACCATAAATTTTCATTTCATAAAGTCATTCTAGATCCTCTAAACCTTCCTGAGACACATTCCACAAGGTACAAAATTGCTTATCAAATGCGTTTATGCAAAAAAGCCATTTCTTAGGTTAAAGCTCTGTGAAACAGCTAAATCAGACACTGATTCTCCATTCGTCTTTCACCCTTCTCCAATCAGTCTATTATGCTGCTAATACATAGCTATGCAAACTTCATACTACTAAAGCATAGAAAAATCATTTCACGATGTACATGTCCAGTTGGATCCCAGGTTCCCCTAAATAATCTCAGGTGTTTTTTAAAACAGAGGTGCTGCATAACTGTAAAATGTTTGGTAGCCATTCTTTTGCAGGGTGAGTAAGCAATGATCTTGTTCAGGACTTCTTTTCCTTGATGATGTCATCTATATTTTCTAACCCAATCATAAATTTGTCTTTAG
>TTN-206,,0,91,1257725,1257815,GTAAGTTGATTTAGAAACACTTTTCAAGCAGTCAGCCCATGGTTACCATTAAGTTAACCCTATCACTGAATTGCTCCAATTTTCCTCTTAG
>TTN-206,,0,120,1257816,1257935,GTAAGTATCAGGCAGCCCCCTACAGCCCTTTCCTTAATGAACCCCATGTATCTATTTGTTTGGTTTCATCTACTTTTTAAACAAATTGTATTAACTGAAGTGCTCTTTGATTTTACCAAG
>TTN-206,,0,745,1257936,1258680,GTAAGTTAAAAAATATATATATATATATACACATATATATAAAATATCAAATATTCAGTAGATTCATTGATATTCTATATCCTACACTTTGCTGACCACTCAAAAATCCTTGATTGGGTGGGCAGGGTGGCTCAAGCCTGTAATCCCAGCACTTTGGGAGGCCAAGGCAGGAGAATCACTTGAGATCAAGATTTTGAGACCAGGCTGGGAAATACAATGAGATCCTGCCTCTAGCAAAGACAAAAGGAAAAAAAAAAATTAGCTGGGCATGGTGGCACACACTTGTAGTCCCAGCTACTCAGGAGGCTGAGGTGGGAAGATCGCTTGGGCCCAGAAGGCCAAGGCTGCAGTGAGCCACAATCACGGCACTGCACTGCAGCCTGGGCGACAAAGTGAGAACCTGCCTCAAAAAATAAAGAAAAAAAATTGTTAATTGAAACATCTAGTATGTGGTTACACTGAGTAAAGCACTAGTATCTCCACCTGGATAAAATGTTCCAGTTAGAGTAGCATTGAAAGGCTACCTGGAAAGATGCCTCAGTGTCTATCACTTGATCTTTCTGTTCCTCTGTGAGTTGGCACTGTCCTGTATAGTACATGGAAGGTATCAAAGCTTATATCTCTAAACTGTAATCTCCTCAACAGACGCACTAAAAACATTCCAAATTTTTATTCTGCACCTGTTATAACCCACATCATATTTACGTAAAGTCTCCTTGGGTGTTTTTTCTTTTCTCCTTTGCAG
>TTN-206,,0,517,1258681,1259197,GTATGGTTTCATACATATTAGATCCATAGAAAAAATGTCATACATGCTTTATAAAATTTAGTGTATCAATTAATGAATGGATAAATAAAATGTGGGATAGCCATACGATGGGATATCATTCAGCAATAAAAAGGAAGCACTACGATATGCTACAACATGGATGAACCTTTAAAACTTTATGCTAAGTGAAAGAAGCCAGAGACCATACAAAGACCACATATTGTATGATTCCATTTATATGAAATGTCCAAGATACACAAATCTATAGAGATGTAGATTGGTGGTTGCTTAGGTCTACAGGGGAGACAATAGAAAAGTCCTTGGGGTGATGGCTAAGGGTTACATGATTTCTTCTTGGGGAATGAGAATGTTCTAAAATTATGGTGATGGCTACACAATGATGAATACATGGAAATTCATTGAATTGTATACTTTAAATTGGTGGATTGTACAGTATGTGAATTATATCTCAATAAAGCTGTTAAAAATGTTAATTTTTCTACATGCTATTTTCCAG
>TTN-206,,0,89,1259198,1259286,GTCAGTTGTTTTGTCTTGCTACATTCCAGTAATTCCCAGTTTCCTCTGAATCACCATACGGTAAACTCGAATTTCCATTTCATCCATAG
>TTN-206,,0,1146,1259287,1260432,GTATTGTCTACATACTAAATGTTTTGAAAAATCATCAGTAGTCCATAATCTATCATTTTATATTTTAATGTTTCCCTTTTACATTTTCTAACCACCATCCTTTAAAGAATTAAATCAGCTCATTCTTACTTGGCTTAGACTCTCTTATGCTGACCTCAATTTAGTCACAGTTTCCACTCAGGGAATAAGGGTGTCCCTAGCAGCTGTCTAAATACGTTAATTAAAGCAGCTGTAGAAATTTCACTGTCTAATAAATGGCTGCTTGCCAAGCAGCACCAACCAGAAAAGAATTAAAATGTAAATCGTGAGGTTCACACATCAATTAGAATTAAGGAAATTTAGAACAAGGTGATATTTTCTCAGAAGGTTTCTATCTGTGGAGAGGCAAGTGTCAAGGAACTTAGTGGCTAGAAATACTTTCTGTGAAGTCTAAGAGAAAGCCCTGTCCAAGCCGTGCTGGGTTCCTGGCAAGGATGCTGGGCACTCTTGCTGTCGGCTGCATTTACAGAGCTTGTCCTCATAAGTGTCCACCATCCCAAATGATATAATGGAGGAAACATGTCTAGAGAAATACCAGTTGAGTTCAGCTTTATCATATTGCTCATCCAAAGAAAACCAGGCTTTACAGACTGTGGACTATAATGAAAAAGGCTTCAATGAGGACTCAGATAACCTGGAGATGTCTTCCATCATTTATTTGCCAATTCTGAACCTCAGTGTTCTCACTCTTAAAATGAGGATAATAATTCCTACCTAGCCCACAAAGTTATTATTCATATAAAATGAAATCAAATTAAGTAATAACTTTTTAGACAATAAAAAGCCCCCAAAGGTAAAGCATCATTATATCCCTTATTAGTAAATAAGAAGCAAACATTTAAGGATGAAATAATTGTCTCTTTGGGGCAGCTCCTTTCCTCCATGCAGCTGTAAACACAATTCTCTACAAGAGAAGTTTATGTACCATTTGTCCAATACTAGGCAGGAAAAATTAGAGAGTGCTATAATCAGCCAACTTATTACATTATAATATATTGGTTTCACATGCCATTCATTGACCAGTTTTAGAAATTGATTAACTGGGAGGAAACCAGAGCTTCAAGTTTTTGTTGTTGTTGTTGTTTTTTTATGTTGTTCCATCAACAG
>TTN-206,,0,1569,1260433,1262001,GTATGTAGGGACAGATTTCAGCATATTTTGTGGATCCATCAGAAATAATCCTCCTGTTTAAGTCACTAAATTCTTGTAACTTGAAGGAAATTTCTAAAGAACCTATGGTATTCATGTGGTTCCAGCTACATTTTTTTTCACATTATATCTATGGAAAAGGGAGGGCAGCTGTTAAAAGACCTATTGAGAAGTTATTTTCAGAAAGCACCTGATGGCCAGATCCTCATCTGGTTGCTCAAAACTATTGAACACCCATTGGGTGTCCATTTTCATATACCCCAGATGAGCTTCTAGATTCGCTGTTAAACTATTTTAGTTCTCTGCCCTCTGCCTGAACTGCTCAAGTCCTAGCAGCACTACCAAGTGAAAGGGGTGTTTCCAGCCTCTGATATGGAGTGCCTGGGAGAACTCAAAAGTCCTCTTTGAGACCCTGGAAGGCCTAGAGAGCCTCAGGCAATGTGGAACTCGATCCTCTCTACCCCAAGCTCTAAGAACAGGGGCTCTTACTTTGGACAGGGAATTCCACATGCTACCAAGCACTCCTGAGGAGCCTCTGAGCAGTCCCCAGGGAAGTGCTGTTAAACCTCTGCTCTCCTCATTAGAAATCTTAAGGCTGAATCTCAAGCTGACCTTGTTTTGAGTCTAACCTAGATGCAAGAGAAAAATGGAACCTCCCTTCCTATTCTCATCCTAGGCCATATCTCTTTGAATAAAATACCCCTGAGGCAGATGCAGGAACTCCAGGGGTAATCTCAAGATTCACAAAGATGAACCATATCGCCAGCATTCCCTAGGTTCCTAGAAGACCAAATGGTCATGGCATCCAGTTCTTATTATCTCTGTATTAGTAGTGGAGAAACTGAGGCACAGAAAAGTAAAGATCTTTTCTATGATAGTGTCAGAAACCAGCCTCACAGAAGTCATTTCTTCTAATTTCTGGGTTCCATGAACTAACCAGGTCCCCTCACTCATCACAGCACTGAGAATATGCTTTAGTTAGCAAAACAGGAAAGCTGAATTTGTTAAGTCTACCTAATGGCATTTAACTAGATCTGAAATAGTGTTAATTCAGTCATTCATTCAATACTTACTGATTGCATTTTACTGGCACTGGTACATAACAAAATGACTATGACATAAACACAAATACTTGCAAAACAAACAAACTGGAATGATATGAGCCTCTTCACCACATGATTTGTCCAAATGAATTTTAAAAATAGGTAGCACACGGAAGTTATTGTATAATTCATTCAGGTGTCCATCGCTAAGCCCCCACCACAAACAGAAACTGGGATAATCAGGTTAACTCGGCACTCTCAGCATGCCCCCCAAATATCAAAAATATCTTTCTGAAGCTATTCCCTCTGCATGTGGACAAATTCCAAGTGCTTTCTTCATTCTTAGCACAAAGAATGTTCTAATATTCTGAGGCAAGTAAAAATACCACAATTCCAAAATTTTGTCTCTGGATGTATAACTAGCCAGCAACAAATTAATGTAGAGTTTTGCATGCTCTCTTGTGTTTTTACACTTTTTCATGGGCTATTTGTCAACATTTACTCCTAG
>TTN-206,,0,224,1262002,1262225,GTAGGAATGCCTCGCTACTTCCAGCTGAAAATAAAACCTAAGAAGCAGGCTTTTGTCCTTTCCCAGTGCATTTAAAAATACAATTTGGAGCTCATAAAAGTAGATTGCTACCCAACTTTGAAAGCACTCTGCAGTGAAATAAATTAAGATAAACCTACATGCTCCCTTCTGTGAGGTCTCTATGGTGACTTAATCATGACAAATCTTGTGGTTTCTTTCTTTAG
>TTN-206,,0,5004,1262226,1267229,GTAGGTTTAAGAACAAAAGGTGTCATTGCCAATACTTACAAATAATTACATGGGAAAAACATTCTGTCAGCTTCTCCTCCATCACAAACATCTCTCATGCATAATTTGAAGCTTAATGGAAATCTAACAGAAAACTTATTTCAATTATTAAATTAAGAATTAGATAAGTGTTTTTCACTATTTTGTGCCCTTAATAATGGTTGTTTATGTTATGTTATGTGTTCTTTATCACAATAAAAAAATTAGTGTTTTTCACTAATATTAAAAAAGGTCATGTTCCCTTTATGATTGTAGCTGCACTTTAATTTCTTCATTGATAAAATACAATGACAAAACTAAAATTATTAGATTATAATAGCATCTACATATAATTCAAAAGAATAATACATTTATATAAGACATTATTCAGTCTATGGACAATGCTTGTGTGAAAGGTATCCTTTGGAAGACAATATCCTATAGTGGTCAAAAGTCGGGGCTTCATTGTCAAAGATGCTGAATTTGAATCTTGCCTTCAATATATATCATGTCTCTCGTTCTCCTTCTGTCATGAATACATTGAGTATATGATTGCATTCAATCCTAGAAAATATATTTTATGAGGCTAGGAATTCCGTTTTAGTGCCTAGAATTTGGCATCTGAAAAATAGTACCTGCTAGAAGGTAAGCTCTATGAAAACAAGAGTGGATGGTTGCCCCAGAATATCACCTGATACATAGTAGATACTCCATAAGTAATTGTTGACTGGACTAATTAATGATGGTTAAATGACTGTTACCAAACACTTAAGATTATTATCAAGATTAAGTTAGGTAACTCAAGTCAGCACATAGCACAGTGCTCATCATACAGTAATCAATCAGAGTTAGCTGCTACCATTTTTAATTGGGGCATGCTTCTCAAGTACCACCAGCCAATTTCCTCATCCCAGGAATCTGATCTTGGTAGAATGAGACAATATATGTGGAACCACTTCAAGTCATAACTGATTGTCTATAATCACAATTATTTGAGAGTTTCCCAGCCAAAGGGAAACTCTCAAAGCTTGGGCATCTCCCAGCCCTCTTATTAGGCTGATGCAAAAGTAATTGCAAAGTTGTATTGTTTTGTTTATTATGCTTCTCCCATTAGTTTATAATCCAATCTCTACCTTGTCAAGATTTATTTTTCTCAACAGGTTAGTACTTCAGTTGGTCTTCTGACCCAATTATTTCCTCCTCAGGAATGGAGATGGTGATCTAGAAATCTAATAGACCTATTTGATTTTATGAGCATAATTAAAAGATATAATGTATGTAAAGCACCTATAGGCATGGCTGCCAGGTAACTGGGGCTCAATACATTCATTTTATTATAGCCATAGAGAGGAATTATATAAACATCAATGTTTAGTATTGTATGGCCAGTATGGACAAATACCATAGACTGTATATTTGAGGGATAGTGTTCAAGAAATGCTAAATATTAATAAATGAGGACTGATTTGATAATATCCTACTAACACAATAATACAAAATATATTTTAAAAGCAAGTTCATTAAAGCTACACTAAATAATTTATCCATTTATTTAATTTTTAGAGGAATTTTTTAATATAAACATATATGTACATCATTCAAAGTAGTAATATTTGTCTTAACTATATTGGTATAGTGCTTTTAAGTCTATAACATATTAACATATGGTAGTATTGCCTTTAAAGTGTTGTAGAAATACACCTGAAGCACTCTACAAGACACCAATTGGGGTAGAAAGAGAAAAATTTCACTATCTTTTCTGCATAACCAATGTCTTTAAAAAGGTTTGAATAGGCTTTGTAAACTGAGAAGATCATTAACTTCCTATGTGTGGTAATATCTGTACACATATAGTGGTTTTAGCATCCTCTTATAAATTTGTTTTCTATATGAAAGAAATTAAATTCATTAAATAGAATGACCCTTCAAAAACTTGCCAACTCACATAGTTTCATACCACTGGGACTAAAAATATTTACAGAACTTCCTCTGGCCAGGTATTGCCTTAAGTAAGTGTAGCCCTGCTTTCCACAAATTGGAAAGAAATTGGGAGTCTTCAGAAGCTCCCATGTTCTTGGGGGTTGTAATACTTTCTGAAGCATGAAACGTGGCCCTGAGCAACCAGGTGCTGTTTCTAACAGCGAAAATGTTACCTATTGAAGGTCTCCAGTGCCACCTACTGGTAGAGGAGTAATTTGGAAAAGCAGAATCTTAAAATGTAAAAAAGCTATTTTTTTGCTGTTTATTCTACAGATGATGAGTCAGTGTCATTTGGAGGCTTACAGAGTGACAGCTAGCTAAACAGAAATGATGAATAATTAGTTTAACAATGATATTGTCTGTTATTCATTTAAGCATCTGTGCAATTTTAATTCTACCATTTATTGTTTCCCTGCTATTGAGATATTACCCTAGGTGCTGGGGTGCAGATCTTGCTCTTGCCTTTAAGGAGCTTGACATGTAGGTGAGGAGATGCATGCACACAACTATATCCCAAGGTTGTAAGTGCTATTAACAGGCCCACGTACTCATCATTCTCTGTCTGGGAGAGAGCCAGAGAAAGATGTGTGAACTGAGCATTGAAAAATATGTAGGATCATTGAACACAGTGGCATCCTATGATGAGAAAACAACATCTCCAAGTCATCAAAACTTGCAATAATGCTTCATGTGCTAGAAGCAAGTGGTTTAAGTACAGTTGGAAAGTGATATCATGAGTGGGTAAGAAGGCTGGATAATACAGCAAAGGCCGTGCTAAAGTTTTTGGTATTCTATGCTGAAGATTTTGGAATTGATCTTGTTTACATTTAGGAGACACTGCAGGATTTTTAAGCCCCTGGGTACCATGATCAGGTTTACTTTTTAGAAGTGATACTGTGATAGGGAAAGAAGGGATGGACAGATGTGGGAGGCAAGACTGGCAGTCAGGAACTGGAGAGAGATTATTACAATAGGCCTGGAGAGCGTGGATGAGGCCCTCAGCCAGGGCAGTCAGGAGAGACAAGTGGGGTATTGCAGAAGTAGTAATATGGGAGAAGAATGGCCTCAAAGAAGACACGAGAGGCTAATGAGTAACGCAGATCATGGCATCACAGCCACAAGCACCAAGTCCACTACCAAGAAAAGTTTTACCTGTTAACTCACTTATTGTGTGCAGTTCATGTCCAGTGGCAGTTCATGTGTATCCTGGTGCCTCATTCAGTTCACCAAAGGAAGAAGCTGTCAGTAGAAATAAGCAGAGAACCTTGTAAGAGGATGTACCATTGATGATCTCACACACACACACACACACACACACACACACACACACCCCTTCACACAAACTAAATAGGGGTGGTGTTTCATGTTATATCACATGGCACTGTCTTTTGGCGTGTTATTGAAGACAACGTTGCTTCCATCTGTGATGTTAGATATTCTTGCTATAATGACTGACTTGTGCCAGTGGCTTATAAAGCCCTTCCATGTGTGTTATATCATTTAATTCTCACAGCAATTATATGCAACGAATAGCCCATAAATTATTACGCATGCCATTTTACAAATGAAAAGACTAATCCAGAAAGCTTAAATGACATTTCCAAGGCCACACAGCTGACAAGTTGTAGTGTCAAGATTTCATTTTCTTTATATGTATATATTTTGATGGAGTCTTGCTCTGTCACCAGGCTGGAGATCTCGGCTCACTGCAACCTCCCCCTCCCGGGTTCAAGCTATTCTCCTGCCTGAGCCTCCTGAATAGCTGGGATTATAGGTGTGTGCCACCACACCTGGCTAATTTTTGTATTTTCAGGAGAGACTAGGTTTCACCACGTTCGTCAGGCTGTTCTCGAACTCCTGACCTCGTGATCTGCCCGCCTCAGCCTCCCAAAGTGCTGGGATTACAGGTGTGAAGCACCGCGCCTGGCCAGGATTTCATCTTCTACTTTACCTTACTATCTAAGGAACTGAACAGATTTGTTACTCTAAGAGGAGAACCTGCCATTTATACACATCTACCATCATGGGCAGGAGAGTAACTTTTATAGACAAGTATTGGCATTAAAATGCAGACAAATGCTAGATGATTGGACTATTAGAAGATCATCTTGGATGGTTTTGAGACCAAGAAGTGGTATAGTGACTGTGCTCCAAAAACAAGATGGCTTTGATTTTGGCTATTCAAACAGTTAACTAAAATTAAAGTGCATATCACCTACAATTATTACAACACAATAACCTGCTACTTTACTGTAATTTGGGTTTTTACTTTCTATTATTTTAAGATGGTTCAAATCCTTATATAGAAATAGCTAGCTTTATTATAATGTCTTATAACTGCCACTCTGAAAAGAGTCAAATGTATCTAAGATGCTCAAATACCATAATAAATCACCCTCTTTATTTAAAAAATTATTTTCTCTACAATTATTTGTGCCATATATACTGCGTACTGAAACCTTTTGCTCATTAGTAACAAAGATAGAGATTTTTTTTCTACAGCCTTCAAAGGTATCTATTTTAGACTTTTCATATCTTGATCTTCTCAGCTCTCTTTTTGATTGATTTTTCTGCAAACCAAAAGTGGAGATTTTTCTCATTTCCTGTCCCAGAAGGCAACTACAAGCCCAGATCAAACCTTTCCTGATGACTCTTCTTAGGACTGTCTTTTTCTCAAAGTCACTGAATATGTCAAAATCTTGTCTCTGCTTCCACTGCATGACATGCAAATGTCTAAAGAGAATGTAACTGAAGTTCTATCATTTTAAACATTACAACCAGTTCAACCTTAGGACAAGCTATATTTTTCTATCATTACATTTCCTTCTTGAAGATGAAAGGAAATCATTTAACAATAGTAGATATGGCATGCCCAGAGAAAAGTATCATGTTATTAAGTCAAATATGAAATGTAGGCACTAGTATTATTAACATTGTGTTTGCAGGTAAATTGTAAAAATCCACTCATTTTTGTGGTTGAAGTATCTCTTTTCTTTTGTGTCGCAG
>TTN-206,,0,1067,1267230,1268296,GTAAAGTAAAACAACTTTCAGAACCCCATTTAAATATAGATCGAATCTTAACAATGTCTGTAACAATTACTCAAGAGTTCATGTAAATCATTGTTGTTCCTACCATTCTCTTCTAATTCAACTAATTATTTCCCTGTTATATGCCATGGTCTCGCCTCTCCTTTACCACTTTTCATTGTGAATCATAGACCATCACGTTTCATTTGGCCCCGCTTTTTCTCTGTAACAATTTGTAATGTATTGCTGCTGTCACCAGCTGTCATGCTTCCTAATCAGCATGAATCAGAAGGGGGCGAAATATGCTGCATAAATAGGTAGATTTGTTTTCTCAATTGGCTAAGATAAAAATTAAATTTTAAAAACATCTAAGAGTGTTATCATCCTCCTATCATGCTGACACAATTTTGATTTCACAAAAGCTAGACCGTTTCAGGTCTGTACACCAGCGAGCTATATTCATCCTCCTCTCAAGAATGTCTTAGTGTTAAGAAGTCCAGTCCTAAAGTGGTTTAACATTTCTGTTAGTTGGGGCTCTTAAATTGTAATCAGAAACACTTCCTCAGTAACATGGGGAATTTGATTCAAACAAGGATAGCATTTTTATATAGTGGTACTATTTTTCCTGAGCAAATATAGTCTATGTAGTATTAAGTACATACAAATACATAAGGATTTAGAGAAACTATTTTTTTCTTAACCTTATGCATTAACTGTAACTAGATGTTTTTTTAAATAATGAATTTAAAGTGGTTTAAAATTAAAAAGTTGACTTTACAACAAGAGGAAGAAAGAAAAGAATATCCAAAACCCTGTTGGGTACTCCACTATTGCCTTCATGAACAATGTAGTGAAGTTCCTTAGCCCATTCATGTCTCAGCTTGCTTCTCTGGGAAATGGAAGTGAACTTGTGTGACTTCGAGTCAATAGTGACATACAAGGACAAGGCAGTAGGAGTGGACTGAATTCTAGTCCATTATTGAAATTTGTGACAAATCTGTAGACAACTCCAAATGAGTTCTGGTTTCAGTGCAAGGTAAGACATTAAAAATTGGTATGCTTCTTTTCAG
>TTN-206,,0,744,1268297,1269040,GTAAAGCCCATCTTGCTTCAAGGACTTTGATTTGCTGTATACCTCTCAGTCCCACTGTTACTAATGAGAGTCTCTGCTGTTTGTTTTATTGCATACTGTGGTCAGTCCATAACTTACTAATAAAATAACATGCAATAACTCCCGCTAGGTCCTCAATTATGGGTTAACCTACATACTTTAAATTTCACTGAAGTATGTGTTCTATGCACTAGAGAACCAATAATTATTTTATTAGGCACCACCTTTGCTTGGCTTCTTTACTCTTCTAAGCAATATTGTATCATTGCATCATTAAATGATCTATTTGCTGATTATTACTTACTGTACTTAAAGTAAGTACAGTATTACTTACTGTACTTAAAGTAAGTACAGTATTACTTACTGTACTTAAAGCATACAGTGGACGGAGAGCAAATGCTAACCCAAATACAGTCAGCTAGAGGGAGAGAGAGAAAGACAGACTGGGTCACTTTGGATAGCTGAAATGACAACAGAAAGAAGGAACCAGATACTGCATGGCATCTGCATGAGTCTTCATCAACCACTCAGCACTGAATCACCAGGAATGAATTTTCTTTTGTGTGATCCTGACATCTAGATCATATTGCATCTGGCATGCTGCTTTCAAGTGACAACTACGTCTTTCATCTTCATCTTCCATGCCATTTTGTGTTACTAACATGGGCAAGTGACAAAGCTTAGATCTTAATATTCTTTTCTTTTTCTTGTCACTTGATTATACAG
>TTN-206,,0,3041,1269041,1272081,GTTAATTGATTTTTAGCTATGACTTGCTTCATTTCATCCTCATCGCTTTATGCAGCTTTTCTGCCATGCAAATTCAATCGACGAATATATTAATTAGAATATCTCTAAATTAGCACCCTATTCATAAGTGACTTCTGAAAGTCAGCCAAGTCATTGGCCATGATTATCCTGAAAATTTAACTTACCAGTCTAGATTCAGAAAGTTTAATTTTTAAACGTAGGTTCGGGAAGCAAAGGTTTATTTCCTATGTGCTGCATTTTCTAATATTTACCAACGCACTACCAAGAAAGTGTAGCAAAGTTAAAATGTTGTATTCTGAGAAGTACTTATTGGGTATTTATTATTGTGCCAGATACTGTGGTAAATTTCAGTTTAATTGTTTTAATAGCAAGAGGTTCAACAATTCTTATCTCCTCTTTATTTTCACATCTGGAGGTTCTAGTTGTTTACAAAGGGGCCATGAAAATAGAAAATTGGGACCAAGTACAGTGACTCATGCCTGTAATCCCAGCACTTTGGGAGGCCGAGGCAGCCAGATCACTTGAGGTCAGGAGTTTGAGACCAGCCTGGCTAATATGGTGAAACCCCATCTCTACTAAAAATACAAAAATTAGCCAGGCATGTTGGATGTTGGTGCATGCCTGTAATCCCAACTACTCAGGAGGCTGAGGCCAGGAGAATCGCTTGAACCCAGGAGGCAGAGGTTGCAGTGAGCCGAAATAGGGTCACTGTACTCCAGCCTGGGCAACAGAACTAGACTCCATCTCCAAAAAAGAAAAATAGAAAATTGAAAATTGGGCACTGAAAATAACAAAGCTCTCTCTGGACCAAAATTAGAAGTCTCTAGATATTTCTCCATAAATGATGCTGCTTTTACAGGCTTAAAATCCTCCTGGAATTGTATAATTTTCTCATGGCAAGATCACAATTTTTGTCGTTATTGGGCTTGATTCTCCATTATGTCTGGAAGAGCAGGAATAAACTTGTCTGGGCAAGTAATAACTTCTTCCTCTTATCCATGGACTTTCCTTTTGGATATTAATGAAATGAGAAAAATATTTTTCAGGTGCCATAAGCCTGTGTTGTGTGCCCGTAGTCAAAACAGCTTCACTGAGTCTCATGGAAGGAAGCTGGTGGAATAAATTCAGGCATCTCCAGGGGTCTGTGGAAAGCTCTGGCCTCAAGTTCCTCCCTGATCCTGGCCATAGTGGTGTTAGGGATGAAAAGGGGGCAATGCAGTGCTATGTAGGTGCACAGCCATCTCTGCACAGAATTTTGAAACAGTGGCCTTTCTTCCTACCCAGTACAGAGAATACAGTTTATTGATTCATATAATGTATCCGCAACACCTACTCACCAAAAAGAGGTCTTATTCTTTCTTAATGAGATTTTGTTCTATAGCTATCTCTCATTCTGTCACCGTAGCCTACAAAGGCAATATCTCAAGAACTGAGGTCTAGTTATGTAAATTAGATAGAAAATTCCACCAGCCAGAGAGTTGACCCTCAATTTCACTACAGCTGCTGGCTAGCACAGTAATCACACAGAGTCACTATTTATTTGGAGGTGTTGTCTACAAGTCCTGTAGGTGACAGTGTGACAATTTTTTCAGTAATGTAATTGGGAGTTGGCTGTGTTGTGAAGGTGGGAGAAATGTAGATCTCTTAACTCACTTCCTAAAGAATCTAGTGCTATAGTGCGGTGTTTGACTGTCATATTCCCAGAATTGATTTGAACTCGGCTCTTTTGCCCTAGGATCTCCAGTTCATTCAGTTCCAATTGATAATATTATTAAAGTGTTCTTGAAGCAAAAGAATTTTTTTGAACATCCAACTGCCTTACTTGTACCTAAGAAAGTTGAAAGATAAGACATTTTTAGATGTTTGAAGAGTGAAAGATCAGGCACAGTTGTCTAATTATTTGACATAGGCCAGTCTTTATATGTTCCTTTTTTATTTTGGCTTAATAAGTTCATATAGGCTACAGAGTTATCCACCAAGATCAAGTAGGAATGTCAAACCCCTGGAAGTCTTTTTGAATACAGTTATTATGTGCATAATAAACATAAACATATCATATATAAGTTTCATGACTAACATGCTGCCTTTCCTTCTCATCCTAATGACATTCCATCTTCTCCACATTCAGCATGTTTTTCATTCTTACAAACACAGCTAATTTATGCCTTTCCCTAACTTTATTCTTACCTAGCAAAAGAATCGCAAGCCAGAGCACTTACAAAAATTACTCTGGGTTCTGACACTAAAAGTATTAAAACACTCAGAGAGTCACAAATTAAAACAACCCGTGAAGTAAAAAGAGAATCGTCAAAGAAAACATCAAGTTTGTCATTAACTTCATGCCAAAAACCGTAAGAAACTGAGAACAAGGGAATAAAGTCTACTGACAGGATACCACGTGGACTGAAGACTGAGAGTGATACGAGAGCCCCAGCCTTTCCCAAGGAGCTGCCCTAGATATGACTGTGTCTAAAAGCTGTGCATATTCCTTGTGGAATAAAAACAGTTTTGATAAGTCTTTGTTTTGTTTCTTAATATGTAATTTGGACTTCATGTAGTTCAAAGTTTGAAAGGTGATTCAAATCAAAGGAGTGTTTACTAGCAGGAAAAACTGAGAATAGCCCTCTGCTAAAGTAGCAATTTAGAAAATGCATGTTCTTTCTAAATGTGATTTCATCTCTTAGCAAGTGTTTAGTCAATAGGACATTTTTTAGAAAATAATATTCCTTCGGTTTGTAGATTGCTTTCTGCATGCATGTAAAGGCATGGGGAATTATAGAACTAAAAGTGGAAATTTCATGAAGAACCTAAAATAAAAATGTTTTAAATCTTTCTGTCAACATTGTCATGTGTTTTATCAGCTCAATAGTTTGTTTGGCATGGACTTTTTGGTAAATTTGGGGAATGTAGTTTTCTGTTGTTATAATAAAAAGAAAACTTTAATCATACAAGTCATGAATTGATGCAGAAAATATATGCAATTAATCACTAAAATCTCTTTATATGTTTTTCTATTTTAG
>TTN-206,,0,11202,1272082,1283283,GTATTGTTATAATGGATGTGAGATTTAAGTAGAAATTCTAAAGGATTAATAGGATCCTTGAGTTGCCTTCTTTCTCTTAGTATTATTGAGAAAAAAATGACATAGATATACAAATATATCTCTTAGAGTATATATTACTATGTCGCATGCTTGGTTTAGAATTTTGATGGTTACATGCATTTCACAGTAATTTATTGTAAGTTAATTTAAAATTTTGTATTTAAAATTTATCAGCCAAATTCAACTTTATGTTTGCAGTCATTTCCAAAAGTGTATATTAGGAGAAGTTGTCATCTTAATGCATGAAATCATGAAGTAGAAGTTTGTTTTCAAAATCACGGTGAATTACATTGAAAATAGACAATAACCTAGCTGTCATTCTCAGAATGCAATGTCATGAATGAATTATGATTGAAATGCTACTTTACTGAGGTTGTGTGAAAACATTACATTCCCATCTGGTTTACACTTCATTCACATATATCATTTTAACATTGATATGTCTCTTACACTGGCTTGCAGATAGCTGCCTTATGTGATCCTTATTGCCTGCTTTTCTTTGCATAACATTGTGACTTTATGGCTGTATTAGTTCGAATAAACGCCTTCTCATTTTATTTTAGCTAATTATTTATGGTTATAGTTCTTGTATATACTCTTTAAATAGTTGATTCTCAAAAATATAATAATTTAATCTACAATCAAAAGAATCAGAAAGGGCGTTTATTCCACTCTCTGCAAGTCAGGTAAGATTTTCCACTTAGCCATCAAAAGAACAAAGTTTTCCTGCTCTCAAAACAAATATGCACAGGAACATGTTATTTTGAAATGCATTTTTGCTTGTTCAAGAAGAAATTTCAACAGTTTGAAGAAAAGACCAGACAACGAACGATTTTCGTGTCAGAATCTTTTAAACAGAGCATGGTGTTGCGTTTATTCGAACAAATATGGTGAGTGAATTTTTCTATGGATTTGTGAGATCTGTAGCATGCAATTTATTTCATTTCCTATTTTGCAATTTTATTTACTTTCAACTTTTTCAAGTTCTATGGAAAATAGTAAAGGTTTTTTTTTTTTTTTCCAGAATTATTCTCTGAGGGGGAATCTGAACATTCAGAAAGGGATACACGTGACGCCTTTTCAGATTCTGAAGACATAGACCACAAATCCATGGCTGCTAAAAGATATGCAAGTAGAATATCATCTACAAGCTCCTGGCCTGAATATTTTAAGCCTTCTTTTACCCAGAAACTTACATTTAAATATGTTTTAGAGGGTGAACCGGTTGTTTTTACATGTAGATTAATTGCCTGTCCAACTCCAGAAATGACTTGGTTTCATAACAATCGGCCCATCCCAACAGGTCTTCGTCGGATTATAAAAGCTGAGAGTGATTTACACCATCACTCTTCCAGCTTAGAGATTAAAAGGGTCCAAGACAGAGATTCTGGAAGTTATAGGTTACTAGCAATTAATAGTGAAGGGTCTGCAGAATCAACTGCATCATTGCTTGTTATCCAAAAAGGGCAAGATGAGAAATATTTAGAATTTCTGAAAAGAGCAGAACGGACACATGAAAATGTGGAGGCTTTAGTTGAAAGGGGAGAAGATAGGATAAAGGTTGACCTGAGGTTTACTGGCTCTCCCTTTAACAAAAAACAAGATGTGGAACAAAAGGGAATGATGAGAACTATACATTTTAAGACAATGAGTTCTGCCAAGAAAACAGATTACATGTATGATGAAGAATATTTAGAAAGTAAATCTGACATAAGAGGTTGGCTTAATGTAGGTGAAAGTTTCCTGGACAAGGAGACCAAAGTGAAGTTGCAACGTTTAAGGGAGGCTAGAAAAACATTAATGGAGAAAAAGAAATTATCTCTTTTAGATACGTCTTCTGAAATAAGCTCAAGAACTTTGAGAAGTGAAGCTAGTGATAAAGATATTCTGTTCTCTAGAGAGGACATGAAAATCAGATCTATGTCTGATCTAGCTGAAAGTTATAAGGTAGATCATTCAGCTGAGAGTATTGTGCAAAATCCACATGCCCTTTCTAATCAAATGGATCAAAATATAGAATCTGAGGAACTTCCCACAAGCTTTCAAACTATTGTTGATGAAGAAATTTTCCAGACTGAAATAAGAATGAGCCAAGAAGCACTGGTAAAGGAAAGTCTACCAAAAGACCATTTATATGGTGAAATTCTAGTAAATGAAAATACCCAAGCAAGAGGACAGCTGGAAGAAATTATGGCCAATACTACAATTGGAGAGTCATCCACATATATCACTAATGTATGTGAGAAGGAGGAAGTATATGAGACTCCTGAAAATGTGTCTCAAGCTATTACACCACATGCCAGCGAATCTTTTGGTACACTTGTAAATGTTGAAGAAAGTGAAGAAATAGCTAGTGAAAGAATAAAAAAGGATGATTTGAGAGAATTACAACTCTCTGCTTCTACACGAATTGATGAATTCAAAACCGAACAGAAGGAAGAAAACATGAGATTTTTTGAAAATTCTTTTCGAAAACGCCCACAACGTTGCCCACCTTCATTTCTTCAAGAAATTGAATCTCAAGAAGTTTATGAAGGTGACAGTTGTAATTTTGTGTGTCATTTTCAAGGATATCCTCAACCTATAGTGACGTGGTATAACAATGACATGCCAATCCCACGTAATCAAAACTTTATCATTCATTCGTTGGAAAACTATTCAATATTAACTCTTTCATCTGTTCATCATCAGAATGAAGGTTCTATTACTTGTGTGCTATTTAACCAATATGGAACAGTAAAAACAACCAGTATGCTTAAAGTGAAAGCAAAACAAAAACATGATGTCAAAGCACATAAAGTCCCAGTGTTCCATGACTACTTGGATGAGGAAGAAGAGTTAGCATTGGTGTTTGACCAAGCAAAAGGCGCCCATCCATCTATGAGTCAAGAGGGCCAAACAAATCTTCATTTGTTAAAAACTAACCCACCAGTTCCTCCCTCTGGAGACACAGAATTGCTTTCCTTTCCTGTAGAAATTCAGGTAACAGCAGCTACTCCTATCCCAGAACAGGATAAAGAGTCTAAAGAAGTGTTTCAAACTGAGGAGCTGGAACCTAAAGCAATGCCTCAAGATCAAGTTACTCAATCACCAAAACACAGATTTGTATTTTTGTCTGATATTACTAATGAACCACCAAAAATGTTACAAGAAATGCCAAAGCATGCCAGGTGTAGAGAAGGGGATTCCATCATTCTTGAATGTTTAATATCTGGTGAGCCCCAGCCAGTTGTAACATGGTTTCAAAATGGAGTCCTTTTAAAGCAGAACCAGAAGTTTCAGTTTGAAGAAGTTAATTGTAGCCACCAATTATATATTAAGGATGTTAATTCTCAAGATTCTGGAAAATATAAATGTGTTGCTGAAAACAATTCAGGGGCAGTTGAAAGTGTTTCAGATCTAACAGTGGAGCCTGTCACTTATAGAGAAAATAGTCAATTCGAAAATATTGGTGAAATTTATGGAAAATATTCCAGAGATCAGCAACTGCAAGACCAGGGAGAATCTGTAAGGGCACATTTTTATGATTATCCAGCTGGTCCCTTTACTCCCTGGACAAATGTAAAAGAATATTCAGTAAGGGACTATTTTCAAAGCCTTGAGACTATTGAGCAAATAGACCAGAAAGAGCAGGTGCGTTGCATACCTTCTAGAGAAAAAATTCCCAGATTTGTGCATGGTGCTTCAAGAACCATAAAAATCAGCAAGCCCATCAGGGCTGAATTCATACAATGTCAGGCTGAAGGGAAAGAGAGACATGTAAGTGAAAAATCAAAGCTGCACCAAGCAGAGGGTACTGTTTATCCATTTGTTGATGATTTCAGTGATGTCACTATTAAGAAAGAAATAAGAAATAATTTTGGAAAACTTGGTAGATCAGAAAAGGAAAATGTACAAGAATGTGCCCAAAGTGACTATTTACCAAATATTCACTCTGAGAGAATTTCTGACAGTTACAATACAAAAGATTCATCTGCCATTGTATATGAAGAATCCCTTGGTGAAGAGATACACTACCCGGGGAAAAAGGTGAAGCATAGAATTATCGAATTTGAAAAATTACATGTAGAAAAAGGAGTTCTAGAAAAAAGACCTACCAGAACATCAATTGTTAATCCTCCTCAAAAGAAGATTGATGACAAAGCCTTTTCATTAAAGCAAAGAGAATCAAGATCAAGCAATCTAAATGCAAATATGTATCAGGCAGAGAAAATGTCTCCAAATACTGAATCAGATTCATCTAACATTGCAATAAATTTAAAGCTGCTTTCCTCTCAAACTCATAAAGAATTTGACGCACAAGAAAGGGAACAACAGGAAAAAATAAGTCTTATAGATAAACCTGCAATTTCTAAAAGAGCTGAACATGAATCACCTATTACATTTGACTTAAAGCAGTTTCACACTCAAATAAAACACACAGATGTGAAATTCCAAGAATTAGATAGTGGTCAACCAGAAGAAGCTTATTTTAAAATCCAACATCCTGCTGACACTGAGAACATTGTATTTGATCTAAAACAAATGTATTCTCATATAGGAGATCCAGCTCTGGAGTTCCAAGGGCAAGAAACTAGGGAACAGCAGGAAATACATTATAAAGAAAAAATTCCTAGCCCTGAAACGTTACAACCTGACACACACAATATCTCTAAAAGTGTGCAAAATAATGTATTTGCCAGTCAAGAAATTTCTTCCAGTCAAGAGCTTTCAAATAGAACTATGGTGGAGAAAAGTAGTATTGATGAAAATTCCATTTCTTTAGAAAAAGAAGTCCGACATGTACAGGAACAAAACTTAGACATTTTAAAAACTGATCTTTCTCTTAAATCCTTTTCTGAAGAAATCTATAGTGAATCATGTGCCCTACTTCCAACCTCATCTGCAGATATAGAAGAAACTGATCTTTCTGAGAAAAGTTGTCCTCTAGAAAATGGAGGCAGAAGTTCCATCTCACATTTGAAAAAAGCAGCAAGTGAGGAAAAGCCTTTAGGGGTTGGTGAAATGGAAGAAGAATGCACTCTAGAACCAGAGTTGGCAGCATTTCCAAAGCAGGATGGTGGGACACAGGAATATACAGATGCCACTTTGGAAGACCACAGAGGTGATGTTCAGGAAGCTGACACACTCCATAGACAGCTCTCCCTGAGTCAGTGCTTCCCACTCTTGATGACTGAAGAACAACAGAATCCAGGTGAACAAATAAGTACAAACATTCATGCCTCTGGAGAAGAAAAATGTTATGAAGAAGTTCAAGTTCAGAATGAAGCTTCTTTCTCCACTTTAGAAGGAGAAATGATAGAAACTAGTTTTTCTCAAAATATTCCTAAATTAGATGAGGCACATACCACTGAGGCAGCAGAATCTGAGACCTCCCTAACACAATATTTACTTGCTGCTGGAAAGCGTGAGGTTCCTGAAACTAAAGACACCAGAGACCAGGCAAAGCTTGTCCAGAGTGAATCAATCACTTCAATGGAGGTGGAAGAAGTAACTTTCAACACTGTGTATGAATACTACAACCAGAAACAGGAATCACTAGGTCGTCCACTTTCTCCTGAGTCTGACATTTCCATTGGTGTGGGAAGTACAACCAGTGAAGAAATATCTGAGTTAGATCAGTTTTATACCCCACCATCATCTGTTGAATATTTTGAATCTCCAAAGTCCCCTGACTTATATTTTAATCCTTCAGATATAACTAAACAATCCTCAATACATTCAGGAGGTGAGACAGTTGAAAGATATTCCACACCTTTAGGGGAAGTTGCTGAAAGATATTCAACACCTTCCGAAGGTGAGGTAGGAGAAAGATACTCCACACCCCCAGGGGAGACACTAGAGAGATACTCCACACCTCCAGGAGAGACTCTAGAGAGATACTCCACACCCCCAGGAGAGACTCTAGAGAGATATTCCACACCCCCAGGAGAGACTCTGGAGAGATACTCCACACCCCCAGGAGAGACTCTAGAGCGATATTCCACACCCCCAGGGGAGGCACTAGAGAGATATTCTATTCCTACTGGAGGACCAAACCCCACTGGTACTTTTAAAACATATCCATCAAAAATAGAAAGGGAAGACGGTACACCAAATGAGCATTTCTACACACCTACAGAAGAGAGGGGTTCAGCTTATGAAATATGGCGTTCCGATTCATTTGGTACACCCAATGAAGCCATTGAGCCAAAAGACAATGAAATGCCTCCATCTTTTATTGAACCTCTGACCAAAAGGAAGGTATATGAAAACACAACACTAGGCTTCATTGTTGAAGTTGAAGGTCTTCCAGTTCCTGGTGTGAAATGGTATCGAAATAAATCTTTACTAGAGCCAGATGAAAGAATCAAAATGGAAAGAGTGGGTAATGTGTGTTCACTGGAAATTTCTAACATTCAAAAAGGAGAAGGGGGAGAGTACATGTGTCATGCTGTAAACATCATAGGGGAAGCAAAGAGCTTTGCAAATGTAGACATAATGCCCCAGGAAGAAAGAGTGGTGGCACTACCACCTCCAGTAACACATCAGCATGTCATGGAGTTTGATTTGGAACACACCACATCATCAAGAACACCTTCTCCTCAAGAAATTGTCCTGGAAGTTGAATTAAGTGAAAAAGACGTTAAAGAATTTGAGAAGCAGGTGAAAATAGTGACAGTTCCCGAATTTACTCCTGACCATAAAAGTATGATTGTGAGTCTAGATGTTCTTCCATTTAATTTTGTAGATCCAAATATGGATTCAAGGGAGGGAGAAGACAAAGAACTAAAAATTGATTTAGAAGTATTTGAAATGCCTCCTCGCTTTATAATGCCTATTTGTGATTTTAAAATTCCAGAAAATTCAGATGCTGTATTCAAATGTTCAGTCATAGGGATCCCGACTCCCGAAGTTAAGTGGTATAAAGAATATATGTGTATTGAGCCAGATAATATTAAATACGTGATTAGCGAGGAGAAGGGAAGTCACACTCTTAAAATTCGAAATGTCTGTCTTTCTGATAGTGCAACATACAGGTGCAGAGCTGTGAATTGTGTAGGAGAGGCTATCTGTCGGGGATTCCTCACCATGGGAGATTCTGAAATATTTGCTGTGATAGCAAAGAAAAGCAAAGTGACTTTAAGCAGTTTAATGGAAGAATTGGTCTTAAAGAGCAACTACACAGACAGTTTTTTTGAATTTCAGGTGGTGGAAGGGCCTCCCAGGTTTATCAAAGGTATTTCTGACTGTTATGCACCAATAGGTACAGCAGCATATTTTCAGTGCTTAGTTCGTGGCTCTCCAAGACCCACGGTTTACTGGTACAAAGATGGAAAATTAGTCCAAGGAAGAAGGTTCACTGTTGAGGAAAGTGGCACAGGGTTCCATAACCTGTTTATAACAAGCTTAGTAAAGAGTGATGAAGGAGAGTATAGGTGTGTAGCTACAAACAAATCAGGAATGGCTGAGAGCTTTGCAGCACTCACCTTAACTTAAAATGTAATGTTTTAGTGCCTCAGTAATTATTAGCATTGATCTGAGTGCTTTCATATTTTCCAAATTATGTGGATCTAATAAACTTCCAAACAGGTCCACCATATTTGAATTCATTACCTTGGAGACCCCTAAAGAAATAATCTCTATGTAGAAATCTCATCTTTGTAATACATGTAAATATTTTGTTATCTGAACTGTGGAATCATCACTTGTGTCAATCATGCTGTGTAATATCAAACACAATTAAATCTCTCCTTGGCTACCTAATTGTTTGTACTTCTATTTACCCTCATGCCTCCTCCACAAAGTGTTTCAGTGGAATGGACTCTCTTTTAGCAGATAAACCATATATGCAAAAGTACAATGTAAAAGTGGAGACCATATCAGATGACCACGCAGACAAATTGGTAAGGGCAAATCTCTCTGCTCCCATTCTAAGTTATTTTTGGAATTTTAACCCCTTTGCATCCAAACTCATGTTTATTTACTTTGACTTAGAATAGGCAAAACAAACAACAAAAACCAGCTTCTCCCAATTGGCAACTAACTCTATAATCTGTTTGACATTTCAATCTTAATATATTAACTTCATCTCTTTTAAAAATGTTTTCGTTATTAATATTCCTCTTCATAAGTGCTTTAATTCTCACTGGCTTCAAGGGACCAATTGTGCTCTTTGTGGGCAGGGTTCACCTAGACATTTGCAAAATAAGCAAATAGATCTTTCCACTTTTGGAGATACCTTATTTTTCTCCATTTTTGAGATGACATCAAGTGTAAAATGCAGCAATAATTTAGTATTGGCCTGGGGAAAAAAGGGAAACTATCATATTGTGTTTACATATAGATTTTAAAACTGTATTCTGATTTCAGAATCTTTAAAATTTAAAAAAAGGTGGGATATTTTTAGAATTGAGACAATATGGTAATTTGTATTTCAGATTATATATAAATAACAAGATAACAAGCTTTCCTATCAGTTTCACTGAATTTCATCTTTAAAACGAATATAGCTTAATAAGCATTCAATTTTTATTGTGATGTTTATGTTTCTAAAGTAACTCTTTAATTTTGTCTTTTAAAATTAAAATAACAGTAAATTAACATACTCCTTAATATCTTACCTATATACTAATGTGGACCCAAGTCTTCTCATATAAGACTCGACAAATATAAAAAATTCTGAAAATGAAGGGTAGGACCAAAAGACCTTAGAGGTGATCATTCAACAATACAATTCTGTGTTAAGCTAATAGTAATTATTCTTAATACAATTTAGAATAAACTTTAATTTTGTAACAAAGGACGAGAGAAATAATATTACAATGAAAGATAAATTTTATCTCCCTCCACCTCTTAAATTACTTATTGTTACTTAATGGCTACATTTGTCACCTGCATTTAGCAATATTTAAGTACCATTATCATATTTAAAATGCTAATTTTAATTAGAAATGTAAACAATTTAAATTTAATTTTCAAAAGAATTCATATCCAATTATGTTTATTATGTTTCTTTCATCTATCAGTCTTTATTCTCAACATGGGAATTCTCTAACAGCTATCCAAATTAAAGAAGCAATAGAGACAATGTACAGAAAATAGGCAGAGCAGCCAGGCCTCCCCTGCCTCCCTCACAAAAAAAATTTTGAATTATCTGTTTGAGCCACCATAACTCATCAGCATAGATACACTATTGTAGAACAATCATTCCTGTTCCAACCAGTGAGCACACAATATCTGTGATAATAATTATAGACATAATGTAATATATCACATCACAAATTCCTGAAATAAAACTAATTCTATAGATTAGGAACTTAGAGATTTATTCTGCACTTAGTCACATAATGGATGTTAAAATTAACGAGAAACTCAGATTGAGGCAAACATGACAAGCATGCTTTACTCAAACATCATACAGCACAGCAACAGTTCAAACCTTGTTTCTTAAAAAAAGAGAAAGAGAGAAATAGAAAAATGTTTTTATGTCCTACTGGATTTCAGGAAGAGCTGAAAAACACTCTTATTCATATAGTAAAGAGGGCTTTGTTTGGTTTTGCTCATTAGAATTCTGTAATTCTGTTAGTTTCAAGTATGGTGAGCTTGAGTATACGCAGAATAACAGTGACTGAATAAAGAAAAGTAAGCCTTGGCTTACTTTAATTGTCATAGATAATGAAATGGAATTTTTTATTTTCTGACTCAATGGCACGTAACATAAAACCCCAAAATATTAATTTCTCTGATTCTGGATAAAGAATTTATTGTATTGCACATAGTTGAGTTTAGACAATTAATAGCTGCTACCACAACATGTAATTTTTTAAACTATGCCTTTCAAGTTTCAGCACATTTGAATTTCATTTACTATCCTTTTTATGGCTAATAATACCATGGCTTGAAGTAAAATATTTGCAAATAGTTCAACATAGTAGTGAGTAAGGGTATTTTAACTGTATTCACATTCACTCCCTTTACAGATATTTTGTGAGTTCAAGTGAAGGGAAAGGTAACGCGAATTATGTATTGTAGATTAAATGCGAAGTTAAGTGATCACCATTAATATGTAAAATTATCAATGGTTTTATGGTTTACTTAAAATAATAAATACCTGAATATGTATTCTGCATGCTATAGATGAGTTTCTCCAGTATTTTTACAGCCAGCAGACACTTGAGTCCTGTCTTCTAATGCTTATATGCTAGAACAGAAAGGAATTAAGGTGTAAGTCTATTTCATGTGATGCAAGTGAAGTCACCAAATAAAATCATAAAACTGCCTTTTGCTAAGGCAATAAAACTACTAATAACAGGCCTGTTCTACATAGCTAAGAGGTTTAATAAAAAATCGAATTCCTTGTTTAAAATTACATGTCTTTCATCCTGTCATCCAGGATACTGTTTAAAGAGTCTCTGTTATGCACTGCTTTGTTTCTTGCTCAGTGGTTCTGTATAGGTTTTCTTATACAATAAAATACAATGAACTTTTAATATTGGAGTTGTTTTCTCTTATTTTTGATTATCTTATTTTCTTGGCTAATGCCTTATTACAAAGGCTTTGTTCAAGTAATATGGTGATTTACATAGATGAAAGAAGGCCTGCATTTCTAGAAACTGAAAACAGTGGTTCTCTTACAAATCCAAATTAAACATTTCCTGTAGCCTCTTATTTTTAATAATGACTTTAGAGGCAGTAATTAGAACATCAATGGTTTATTTTGGAAATAATCAGTCTTTAACAAAGAAGATTATTCTTAACCTCAAGAAAACTCTAAATATAAATAACAATTCTGGATCTTTTTAGAAGTTGATTTAAATAATGCTGGATTATTATAACTATTTAATTAGCAGTTTTTCAAACTTTAAAATTGGAATTATATCTCAAGAAAAACTCATGAGAGCATTTTTAAAACATGAACTCTATCACAGATGAAGTGGATCAAAAATTGCTTTTGTACAGTATCTATAATTTTGCATAATTTTATATGTTAAGCTAAGAAAAATTTAGAAATGTGCTTTTTGATACATTAATCTTGGAATAATCTAATCATTCCAGGAATAAAGCAGAAGAAGGCCATCAACTGGTGTCTAATTCTTTGATTTCTATTTTTATATTAAATAAAATTTTATAGTAAAATAATAATCATTTTTCCCCATACAG
>TTN-206,,0,780,1283284,1284063,GTTGGATTTTAAGGATAAAATAGATCAAATGCTAACATTCACTGGATTGTAATGATTTAGCTTGCATCACTTAAATTTTCACTTATCTGCCACTTCCAGAATGTAATTTATTTAGAGTAAGAATGAAATCACAGACATAATCATGGTTATGAACTCACCTTTTCCCTTACTGCCCTGTTGGGTGCTATGCTATCATATCCATGGTACTATTTATTTTAAAAATAAAACATATTTTCATATGTTTCATAATACCAATAGATAAGCTTTTAGTTAATTTTCATATGAAGATAACTTTCATAATATGTAATAAAAAGTATCAGTGAACACCTAGCCACTCTGAAATCACTGGTCTCACCCTTAGATTTAAAATAACCATGATTAGTTGTCTGTTTCTTTTTTCTGTTTATTTTTTGTTGTTGTTTCACTTCATCACTTTATTTAGTATATCATGTTTCTTCACATTATTTTCAGTGTTCCCATTCAGCATGGTATATTTAAAGAATATATCATGTTGTTATGCATATAATCCAATAGCATCACATTTTTTCACAATTCACTGCAAAGCAATGATTGAATAGGTTTTTTTTAAAAAAAGCTTATTGTCTTCTTTTGCCTTCAATGATCTTTCTCATTTTCCAGTCACTTGCCTTAAACTGCTGTAATCCATCTCACCAATTTCAACTGTTTTACTCCATTAACAGCAACAAAAGTTAGAAGAAAAACAAAAATGTCATATGCCTGATAAGGAGGCATGTTAATGGACTCTACTTCCCTTTGCAG
>TTN-206,,0,2007,1284064,1286070,GTAAATGCCATACATTGGCACAGATGTTGTCACTTCATTTCATATTGTTGTCCTTTTTGCTTTCTGTACATGTGTGGGAAATGCTTGTATTACCAACTGGAGAGACCAACAACCAAGACAGTAACATGGTAGGTAGGTACTGCAGAGCCTATATGGGATAAGAAATCATTATTTACAGTCACATTTCTACTACTGACCAAAGAAAAAATAATTTATTATTTGAGAACAAAGTTAAGTAATCAAATGAGCTCAGCTTGGCCCTTCATATAAAACATATCAGGACAGTTTGGTGCCACTAAAAAAAAATAATGTCTCAATGTATTTAAAAATTTTAAATCAAATAACCAATTAAGAACAGAATTACAAACTTAAAAAAGTCAGTGTCTAAGTCTAAAATTAAATCCTAATGTAAGACAGGGAGCTAGTATAGGACTGAAAACTAGGATTCTCTCTAGGCATTTTTACTAATTTAAAAATAAGACGGCTGGGCACGGTGGCTCACGCTTGTAATCCCAGCACTTTGGGAGGCCAAGGCAGGCGGATCACAAGGTCAGGAGATCGAGACCATCCTGGCTAACACAGTGAAACCCGATCTCTACTAAAAATATAAAAAATTAGCCAGGCGTGGTGTCACGCACCTGTAGTCCCAGCTACTTGGGAGGCTGAGGCAGGAGAATTGCTTGAAGCCAGGAGGCAGAGGTTGCAGTAAGCCAGGATTGCACCACTGCTCTCCAGCCTGGGCAACATAGCGAGACTCCACCTAAAAAAAAAAAAAGAAAGAAAGAAAATAAGACAACTACACAAATATCCTATTCCCAATTTTCTAATTGATATGTAGGGTGACTTTCAAATAGTTAACACTCATCAAATACTTGAATGCCTTCATTAACCAAAATATTAGTAGCAAGCTTTTCTTCCTTTCTTCCTACCTTCTTTCCTTCCTTCCTTCCTTCCCTCCTTCCCTCCCTCCTCTCTATCTTTCTTTCTTTCTTTTCTTTCTTTCCCTCTTCCCAAGAGAAAGTGTGAGTATGAACTGTGGTTTGAGGACAGGGGTAGAGGTACAGTCAAGCCATACTTGGACTGTTGGGGAAGGCTGTCCCTTGGTCTTCTTTGTCAATGAGAATATCAAGGGGAAGGGCAAATGCAGCACATCTCTTGAATGTGAAAACGATGAGGTTCCCTATAGCTTCCTCTTCTCTACAATCCTTTTACGTGATCCTAAGAAAAACCCAGGCCCATGATGACCCAACCAGTGCTTTTCACTCTGGTCAAAATGTCTCCATAAAACCAAGTACATGATATTATTCATACTGACGCGTTTGGAAGTTTCTTTACTCAAATTAGGTCAATTTAGGAATGCGACTAATATTGAAGCTTCAGATAATAAGAGGAAAGGATAAGGAGGATGACTTAAAAAAATTAAAAAGAGAGGTTCTGAAAGTCTGGCTTCAAGATGCAGAATGGAAAGGGGAAGTTGCTGCTATTAAATATTTTTACAAGTTTGAGTTGGCCTAGAGGATGCATTCATAGTTAAGCCATATAAGAATTTCCAGGCAGTTGACATGAGGGTTAGAAAGACATTACAAAACTACTTCAATCTTCTTATCACTTAATATCCCTACTCTTCAGAAGAGTCAAATACATTTTCTTTATCTTCCTTACATAATCTTCTAATTTGCAGAATTAAAGTATCAGCTCAATAGCTTATCAAATAATTAAACAAGCAGCCACTAAAATGGACAAATCTTTAGTAATGTTACTTAATAAAGGAACGCTTGTCTTTTCTTTGATAGAGACAAGTAAAGTGATGTCTTGCTCCCTTATAAAGAACACTCTCATCCCTTTCCTTTGACAATCTTTTGTTCTTATTAACACATTACTCCATTTTAAATTATGGCTCATGTCTATCTAAAGACTTAACTCATCTTTTCTCTGTCTTGGAATATATAATTACAGCAAGTGCTTTGGTGGGGACTAAATGTAATGCTGGAAAAATTTCTTTTGCAG
>TTN-206,,0,522,1286071,1286592,GTAAGAAACGTGTGAATGTATTTTCTAGTCCCTTCTCTGCAAGGAATCCTCAGTAGAAAAACTGTTGGCAAACAATTCAGTCAGTACACTTTGTTATTAAAATAATGTCATTCAGCAAACATTATGGTTTGGGAAAGTCCTGGCATTGTTTGATTTTATTTTTTTAATCCTCTTCAAAGTTCACTTAACTTTTGTTCTTTTAAATTGTCTGCTATTAACAAAGCTTGCTTAAAATTTCTTCTAAGAAAAAACTCCAAGTGTCTGAGCAATTCTTAACTATCTTCTTTTATAAAATTCTTCTTTGTGTAGGTAGTCTGTTTATTGTTGTTTTATTTTAAATCAAGAGACTGGGAAAGTGTCTTAGAATGATAGGAACCTATTAAATGCACCACAGCTTTTACAGAAATTTTGTGGAGATATTTTATGTGTGTTGGGTCTCTTTGTTGTATATGTCTACTTTTCTTTTGCGGAGTTTATGTTTCAGATATCTTCTCCTTTTTCTTTTTTGTAAACTTCATGTAG
>TTN-206,,0,100,1286593,1286692,GTTTGTTTACTGAGTTTCCATCCAGTATTTTTCTGAGAAAAGATTTCCCTTTTAATTACTTATTACCCATTACTTACACAATGCTTTCATGCTTTTGTAG
>TTN-206,,0,435,1286693,1287127,GTTAGTGCTTGAAAAACTAATGTCTCTTTAATAAATTGTCAAACTAGCTTTCTTACCCCATGGAAGAAAAACTGGTACTTTCTTCTCTTGTCCTATCCTTTAAATTTGTTTTGTCTTGGTTTGACCTGGGACCTTGGGAACAAAGTCAGTAACTTTCACCTGGTCTTTTTCCCGAGACTAGTGTAAATATCTATTATCTGATAACAAAAGGGAATAATAAGCCATTTTGTCAGCTGACAAACATGTATCATCTATGCCTCTGTCTCTTGGATGGAATTATAATTATTCTTAACTTTTATTTCTTCTTCTAATTAACACTATGAAATAGTAGTATTGGGACAAGATAAATATAATCTTGAAAAAACTCTTAAATATAGATGGTGTTGAAAGTGTTTGGGAATTGATATGTTTTATATGCTCTCTTTCCTTAACTAG
>TTN-206,,0,96,1287128,1287223,GTTTGTGTAGGAACATTTAAACCTCAAATTGCTATTTAGAATTAAAGTGAAACCCTAACAAGCATTTAGGGTGCTAACTATTTCATACCATTGTAG
>TTN-206,,0,117,1287224,1287340,GTTAGTATTTTTAGAAAATGATGCTACATATGCATTTGAAACCCAACAAATGGCCTAAAGTCAATCACTGAGCACTCTTCTATATTGACCTTTTCTCCCTTCTTGTGCAACACACAG
>TTN-206,,0,115,1287341,1287455,GTTGGCTGGAGACTTTGCATTTTATCCTTATTAAAGATTATGTTCAAATTAAGTCATCTTCCCTTAGATCAACCCTCTTAACTCTTTGAAATTCTTTCTTATACCCCTTCTTCAG
>TTN-206,,0,92,1287456,1287547,GTTTGCATTGTTTTCTTGACATCTTTGTGCTAACCTTGTTATAAATTCTTTCCTCTTTCTCACATTTCTTAATAACTTCCTTCCTTCCACAG
>TTN-206,,0,94,1287548,1287641,GTTTGTGTTCACTTTGCCTCTTGTGTTGCCAAAGTTATGGCCCATGGCACAGACCCCTCCTCCCTTAATGCAAATCATTCCTTTTTTACTGTAG
>TTN-206,,0,109,1287642,1287750,GTTAGTGTTGGTTCCAGTGAGGGACTGGCTTTTCTGAAGAGTCAATTCTTTTTTTTAAGCCACTTTTGCTATAGGGATAATATTGATTGAGAATTCATTCTTCTGTTAG
>TTN-206,,0,101,1287751,1287851,GTTGGTTCAGAACGTTTGCCTTGGGTTTGAGGAAGAAATGCAGATGTAAGCCTTTCAGCAGGGTAATGCACAACCCACATCTATCCCTTTGTTTTCTACAG
>TTN-206,,0,132,1287852,1287983,GTTGGTATTGTTCTTCTACAGAGAGGATTGGGCATTTCCATGCTCCTTCTTCCCTTAAAATTTAAAAAAAAAAACAAAAACAAATTAGTAGATTGACCTTTTTTTGTTGTTGTTTGCTTTTTCATTGAATAG
>TTN-206,,0,133,1287984,1288116,GTTGGCAAATTTTATTTCCACTTATCAAGAACTTACAAAATATTTTTGTTTCATTTCTAAATTTTCACCTTTATTGCTAAGTTATAAAATAAAACTTCCTATTTTCTTTTGCTTGTTTTTTCTTTCACCTCAG
>TTN-206,,0,147,1288117,1288263,GTCTGGTCTCTACATCTCCTCACTTTCTTGCTTGTCTAGATTTTCTTGCCTGGGGTGGGCCGGGGCGGGGGACGCTTAAGACAGCAGTTTTGCCCAGTGACCTGTTTTTAAAAATATTCAACATCACAATTCTTTTTCCATCTTTAG
>TTN-206,,0,97,1288264,1288360,GTTCGTGAATGGAATCTATTCTCCATTTTGGCTGTGCTGCCTGATAAGTTTGGGGTCTTCCCTTGAGTAAGCTACTGTCTTCCTTTTGAATCTTTAG
>TTN-206,,0,118,1288361,1288478,GTCAGTTATACAAGAAGCAGCCTATCAAATAAAAATTCTGTAACGCTTTTAAATCTTATCATTATGGGTAGGAGTTACAATATGTTTCTTCTTTTCACACTCTCTTATTTAATCACAG
>TTN-206,,0,112,1288479,1288590,GTTTGTAAGCTATTCTCTTTCAAAGATAGTCTATAGCGACAGTTTCATTAGCAGACATTATTTCTAGTGGAGTTACCAATGTAACTCATCCACATTTTCATTTTTACTACAG
>TTN-206,,0,102,1288591,1288692,GTTTGTATCTTCACCCCAGTCAGCTTCCCTTATTTATAGTATGTCCTTTGTAAACAAATAGCAAGAGATTAATGGATGTGTTTTGCTGTTTGCATTGGACAG
>TTN-206,,0,246,1288693,1288938,GTTAGAATTTCTTTACCTCTTCTTGATTCTTCCTTGCGAATGCTTCTTAAATGTATCACTCTTGCCTTTGTATCCTTTAGAGCTAAAATCTCTATGATTCTGGTTCTTTAGATACATATTCATTGTGTTCAAGAAATATTCAGCCATTGCCTCTTTCCAAGAGTGTTTTCTTAAATGTCCATAAAACTGTCACAATAATTCAACTGCAAGCAATTTAATTAAATATATCTCTCTTAAAATCTATAG
>TTN-206,,0,213,1288939,1289151,GTGTGCAAATTTGATTCCTTTATGTTTCTGTCTGACTGTGTCTTTGGTTCTCTGTATTCAGTTACAATGTCTCTAAACAATCAAGAAAGTAGTATTCTTTCTAACATAGTAAACAGTATTTGCTCATGTTTTTCTCTTGCCTGTATACTATCTAATTTAACTATTGTTATTTATTTCTGTTCCCTGATACTCTCCTCTTTCCTGACTCTTTAG
>TTN-206,,0,1043,1289152,1290194,GTAGACATCTTGTTCTTGTGTTTCTCATTAAATGAAAACCACCTTCTCCCCTGGGTATTATAGCTCTTTATTCATTTACTATCATTTTAGTTTCCATTTGAGATCATAGAATATTTTTCTGAGCTAGTATTATTTCCCTTTTTAGATGGTTTCCTTCTTGAATTTTGCTTACATGTAACTAGTCATTATGAAATATTTTTGTTATTCCAGTGTCATAATTCTGATTACCTCAACACATTTGCCAAACATCAAACGTGATGTTTCAAAACTGCACAAAAAAATGAAGTAGGCATTTTAAAATTAGTCTTTTGCTTTCAATCAACTTACAGATATATCATTCTCACTATAATCTATATCATTAATAACAAGCACTTTTACTATATCTATGCAAAGTGAAAGCAATACAGGTTTTAAACTTATGTTTAAAACAGGACAATAATATTTTTTCCTTCTCTCTCAAGGATCACTTCCTATCCTTTAAAAATTATATGACTATACCTTGGTACAAATAGTATCTGTGTTTTTTTGCTGCAATTTTCCAGTGCTTTTTTTTTTTGTCACAAAGGCCAAGTTTGTCTTGTTTTAAGACAATTATTGCAGTAATCATTTGCTGAAATGGAAGACTTAGATCACGGATGTTGTGATGACTTCCAAGTGTCTGTTATAGAACATATACAAAAAAAATCATCCTTGAAATTAGAATTCCATACTTCATGCAAATCATTATTTATTGCTATACTTGCTTGTTTGCAATTTTTGTATCAATCTTTGTAGCCTAAGATACATCAGTAAGGTGTAGTAGATAGAATGTTGAACTGTTCAGTAACGACATCTAGGATCTATCTGGGTTCTCTGCCCATCTAGCTGGTTATCTTGTGAAGGCAAATGGCTTCTGAGGCTGTTATCCCATGAGAGTGTTAGTGCTGGACTCTACTTACCCATTAGAATATCTTAAACCTTTCTTCCAATTTAAAGACAAATAAAAAATTTTCATTTTGTGAAATTCAGTAGCCCAATTCATGAGAAATTCTTGTTTTTTGCAG
>TTN-206,,0,118,1290195,1290312,GTAAATATAGTTCATCCACATGGCAGAAATGTCATAAATGTGCAAAATCCTACTTTTTTCACTCTCGCATGATCTGGACAATCTTTTCAACAATTTCCATCCATCTTTTCCTGTTCAG
>TTN-206,,0,829,1290313,1291141,GTTGGTACAATAGCCCACGATAGAAACTGGTGCCAAATGCTGGAATGAATTACTAAGAGTTACTGGCAGATTCTTTTTCTGAGTTTCTTCTAGAACTATATTTATCCTCATCTATTTGAAAGGTCTAGAGGAAAGACATAGTTGATCTTTCAAACACTCTTTTCTGTTTCTGTGATTCTAACAAAAATTAGACATCTGTTTTATTGTTTAATAACTACCTGTCTATATCAATTAGCAGATACAATCATGACTCTCTTTGATTAAGCATGAAAGAATACAGAGCCCAGCATGTGCTACAAGAGTAATTGTTAAAACTAACAAGAACTCCAAAGGTTGGCATTTGATAGCAAAGCTTCCACATAAAATTAATGACAATTAAACAATTGTTTGAATAACAACTTTCAAAGAATTGTCTTTAGCACCTTAAGGTAGAGCAAAAATACCAAGTAATTCACAATAACCTGTAGACTTTGATCTACAGAGGGTCAAGTGGAAATCAATATATACTATCTAATGCACATTGTTTAAATTGTTTTGAAGTTGAGTCATGCACGAACATATATTTCTTAAGAATAATTGCTACATAAGACGACAGCAAGAGTGGTGGGAAAAACAAAAAATAAAGAAAAAACTGAAAAGAAAAAATATTAAAATAAAAAATAGCTATAATTCTATGACTGCATGTAATTATGGAATCACACTTTAAAGTCGAGAGAGAGAGCACCCTAACATAACCATCTCACTGGGAGAAACAATCTTAGTGAATGTGATAGTAGAGACAGAGTAAAGATCCCAGACTTTGACAGATGGATATCACGTTTTATTTCAG
>TTN-206,,0,116,1291142,1291257,GTTAGTTCTGCTGTTTTCTTCTGGTTGCTTATGCAAATTCCTTTTACAAGTTTCCTTCTTTCAAGTCTCTTCTATTCTTTCAAATCATGATGAGTCTCTTACCTTTCCTCACACAG
>TTN-206,,0,159,1291258,1291416,GTCAGTAGACAGTCAAACTTGTAAGGAATTTCTTACAAATTCCTCTTCAGGTGCACATCTATGTTGACAAACATTTGAAAGTGCTCTAATGTTTTATTCAAAATTGCAACTCCATCTGAAGCTTACAGGATCTTTTAATTGTTCTCCATGTCTATATAG
>TTN-206,,0,93,1291417,1291509,GTTTGCTCAAGTGGATTCACTTTTTCTGTTTTCTGTATACCGACATCCTTGTGTTTTTCTTGTGTTTAACTGCTGTGCTTTGTCACTTACTAG
>TTN-206,,0,108,1291510,1291617,GTGTGTTGTCTTATTGTCTCTTAAATCATTTGCATTCTTCTAACATGTAGCATAGTTTCTTTGATATTCATTAATTCCAGTTGCTAACTGTGAGCCTTTCTTCCTTAG
>TTN-206,,0,112,1291618,1291729,GTGATGATATTTTACAAATTAAAAAAATTCTTTTTTCCTTAACTCTTGTATCTTTATGGTGAACTTCTCATTTCATCTCCTAACACCTTAAGTATTACATGTCTCCCTACAG
>TTN-206,,0,124,1291730,1291853,GTTTGTTCACACGTCACTCTTTTTCTTTGCAAACTGTGGCTTCATATTTCATTGTCAAAGTAGAAACGACCAATGGCAAAAAAACAAACAAAAAATACACATTGCCTTTCTTCTCATCCTCCAG
>TTN-206,,0,644,1291854,1292497,GTATCATTCCATGACTTTTGACAATATTTGTTCCTTACCATATTTGCATAATTGTCTTATAAAAGTTTCTTTGGTTTTTAAATGTTTGAGAGAAACTAACTGGACATGTTAGAATTTGTGTATTAGTGTTGGAGGCAACATTAATCAAAGTTGTGTTTTCTCTTTATATTGTTCTTTACATTAGTGTAACTCTAAGTGTAATCTTATCAAAAAGTATTGTTTAATTGAAATTTGTTAAATGTTGTTTTAACTATCTAGTCCATTTTTTAATGCTTTCTTGTTATATGGCATTCTGATTTATCATTACTAAATGTTGATCAAATACATCTATAATACATTAACTTTTATGTTTTAACTTACATAGTCAAACTAAAAAAAAGAATCAACTAAATTCTCTATTAAAAATGCACATGTACCCTAAAACTTAAAGTATAATAATAATAAATTTTAAAAAACTAAAAAAAAAATGTTATGAGATTATTTAACTTAAAAGATAACTTATTTTACTGTAAAATCCTCAGAAAGTATATTCTTAATAACAAACCAGTTTAAATATAAATTTATGGGATCTTCAGCTACAAAAACAAGCTCTTTTAACATGTATAATAAATATCCCTTACTGACTGTTTTGTTTGGTTTACTAG
>TTN-206,,0,257,1292498,1292754,GTTAGACACACTAAGCTTCTTTGTTTCTTTATTCTCCTCTGATTTGGGCTCTTAGCAAAGTTATGAGTTCCAAAATAAAAGGATAATTAAGGTTATTTGGTTGCAATTCTTCAACAAGTTTTAATGAATTGTCATTTCTTGTGTCAGCATGTATTGTCATATGATCACACCAGTCACTCTTCAAGGTTCTAGATTTAATTTTTTTTTCCTTTATAGTAAGCAAGTGTTCTCATTGTTTATCTCCTTTTTTCTGGTAG
>TTN-206,,0,120,1292755,1292874,GTTTGTATACATGGACACAAAAATATATGCCCCTTCCTCCTATCTGTTCTTGCCTAACTAATAACTTGTGTGGCCATGATTCTCACATTTTTTCCTCTAACCACAAATTTCTTTCATCAG
>TTN-206,,0,150,1292875,1293024,GTTAGTAGCAAAGCACAGCCAGAGAAAAAATCAATTTACTTGATCCATGATCATTTTCCTCAAATATTCCTCTTATCCAGTAATTCAGTGATTGCACTCTTGAGTTTGAAAGGTTACTTTGTTTTCAATGCAAAATACTTCTTCTTTTAG
>TTN-206,,0,102,1293025,1293126,GTGAGTAGAATGAGATTTTTATGAATATACAATATTTCCAGGGGGTGGAGGGGCACAGAATAAAACTTCTCTTTAAACGCAAAACTACCCTTCCCCACATAG
>TTN-206,,0,190,1293127,1293316,GTCAGTGTGCAAGGATAAAGCTGCTGCTTCTCTAACACCTCTTTCATGTGGACGTGGTGCCTGCCTTCCCTGGAGTTTCTTTATTTTGTCTTCATGTTTAGTCTTAGCTCCCTTTTTTTAAGGAGCAAAAGCACTTCTCACTTGGATTTCTTTCTTCTCTTTATCTCCCCTTCCGCCTTGCAATATCTAG
>TTN-206,,0,94,1293317,1293410,GTTTGCTCTTTCCCCCAATATATACATCTTTTAAAATTTCTCTTAAGTCTTCATTAGAAGGCAAGAATTTTACCCACATGTTTTCTCCTTATAG
>TTN-206,,0,100,1293411,1293510,GTGTGTTGACAGCTACCTCTTTTTATTGCTCTCTTTCTTTTCAAACATCCTCTTTTACATGGCATGACTGACTTGCTGACTACCATCCTTTGTACCATAG
>TTN-206,,0,132,1293511,1293642,GTGATGGTGTTGTTTAACCTAGTGTGTGTGAACAGATTCATTTTCTTAAAAACGTTAAAACTTTTATGAATTGAAATATGTTGTGGATGCCTTCTCACCTGTAAATAAGGATTATCTGTAACTTCTTTACAG
>TTN-206,,0,140,1293643,1293782,GTGAGTAACTCACAGTACCCTCTTCATTGTAAAGCAGCTTCACTGCTCCAGGCCACCAAAAGGCTGGTGCCATTTAGTTTCTGCTCTGTATGTGAGAGCATGGAAATAAAAATCACCATGTTGGTCTTCATTCTTTTCAG
>TTN-206,,0,1320,1293783,1295102,GTACTTGTTAGAGTGAAGGAGCAAGATCTCTTTTACATTTTCAGTATCTTAAAATATAGGAGGGTGGGTGTGCTTGAGAGAGAGCTATGTTTAGGACCAGGGTCTAGTGATGAAAATGGATCAAGTGGATCAAGGACCTTCCAAATGGAGACAAGTATTTTTTAATTACTTTAAAAAAAAAATTTAAAACTAGGAAAACATGGACCAAAAGTCCATTTTAAGAGACTAAAAATAGAGACTAGAGAGAGATAACCGAAACTCTACAAAATTGCAAGAAAATCCTAGTTTGAAAGACGGTATCATAGGACAAAAGCGAAGTTATTGCAAATGACTTTTTTCCCACAGTACTTAGTAAATGAATGGATTTTGTCCCTCTAAGGCATAGCAAAGAGCCAAACTATCAAGCCCTTCAAGGAGAATTCAGATGAGAATGATAAGTTCAACTTACTTTCCTCCACTAGCCCCACTTAAATAATAGTGGAGGTCAGGGGCTGGGGAGTAAGTAGATCAGTATCTGCTATTATGGAAGGCAGTCATGTGTTTCTGCCACATGTTTATCGCTGCTACTGTCAGAAATTAAATAGTTCACTCAATGGACTGCTAGTCTAGTCCATTAGAGTATTTTTAAGGGTTTTTGTAGTGGTGGTTTATAAATATCTTGAAATTAAAATATAATTAGATTTAGCAGCCCATTTGCTCTATGACATATAGCTAATCACTTTTACTTCCCTATGCCTGAATTTTTTGCTTCAGTTAATGAGGAAATCATTACTCTCACACACTTCAAAGGAAAATTATGAAGGTTGAGGAAATACCCATTTAACACCTAAAAGAGGAAAATGGCATTTTAAAAATATTAAGATATCTGACCCACTTTGCCATTCCGGCTCTTCATGCTATGTAACTGATAGCATTGCAGCCTTAGGAAATAGTTCTCCACTGGTTCATATACAAGACAGTAATCAAATTCTCATTCCCCGTGGACCTCAGAGGGCTTCCACTGACAGATACATGCTATTATCTCTGATCTTGGCACTAGAGAAGGGACTCTTTTGCTGGGGAGAGGATGGCACAATAAAGAGTAATGTCTTTTTCTCCTTCTTTTAGTAATAATACTTGATGTGGATGCTTACAAAAACAAGCATATTTTATTTTAGAAATTTTCTATTTAGGTTTCATTTAACTCTTCTTCCTTGAACTGCATAAATTTGTTTTCCAGAGCTAAAGACCTCTCTAGCAAAGATTATTTTTTCCACCTCATCTTGAATTATATGCATCTGTTCCATCCCTTACCCTGTGTTTTTCCTCTTGGTTCCATAG
>TTN-206,,0,228,1295103,1295330,GTCAGCGCTCTCCCCACCTGTGTGTTTTTCACATTAGCCTCCTCTTTAATTGTCCTCTTAACTTCCTGTTTGACTCTTCAACGATGTTTTAAAATAGGGAAAGGACACAACAAAGAATTGAAAGTGTTTTTTTCACTCTCTATCTCTCTGATGGAGTGGAAGATTGATTCTTACTTTTAACTATATACTTACAGAATACATCCGTATTTTCCTTTTTTCCAATTTTAG
>TTN-206,,0,412,1295331,1295742,GTTAGATGGACTGCATTCACTTCTGCTCACTACTTCCCTTCTAATTGTAATACTCTGTTGCCCCCTCCACCCCAGCCCAGTCTTATCACTAGCAGCCTATTCCACTTTCCCTTTGTTTCCTCTCCAAGTCCTTTTCTGTTTAGTCTGCTTCCCTTTTCCAAATCCTACTGAATATCCTTTTAGATAATGTTGTAATTAGGTTTTGATTGGATTAAGAAAGCTGGAGTAGATGAGATATTCAACTTTCCTACTGAATACAAACTTTAATGTGTCCCTGCTCGCATCCACCAAAAATGCCTCTTAAATGGAAATAACACATTATCACTAGTTTGATTCCCGGCATTCACGATTTGAGCAAAATGCTGTCAGTCTCACAAATTTTAAAACCCAGGCTTTCCTCCTTTTTCATCAG
>TTN-206,,0,116,1295743,1295858,GTTAGTAAAAAGATGATGTTATCACAGATACAAGGCACACACTCACCAGGATCTGTATTTTCTTTAGTTTTTCAATTTGAGTTTAAAATATGGATATCTTTTACATTTCATTCCAG
>TTN-206,,0,524,1295859,1296382,GTTGGTTGATTTCTTGGGCTTTTCCTTCATCATTATAATAATGTAGTTCCTGATTTTCATAAATGTATATGGGTTGTTACATCTTCTATAGGATAACATGAGTCCGACATCTTCTGAATCAGCAAATTCAGAGGCAATACCATCTGTAGAATTAGAAGAAAACCATGTTCAAAAGTTATATCCCTTTCTTTTTGAGGAATTTCCAAAATGATGATAGGAATGAAAAATAGTCCCTGGATAAGGTTAAAGCAGTCTTCATTTATGCTGAAATAATTCACCACATAATTCTTCACGGCAAAGAGAGAACAAAATCCCTAGCAAGTCAACCATCACATTCTGCCCACTGATTCTCCAAGCTTTTGATAGTGTGAACCCATAGAGGAGTTTTTAATACCGTCACAAAAGAGCCAAATGGATCTAGGGATAGTCCATCAAAAAGACAGTTCTCTCTTCAAGTCATTTTATAATTGTTGTCCTTTGTTTTTTTTGTTTTGTTTTGTTTTGTTTTGTTTTGTATCATTCAG
>TTN-206,,0,109,1296383,1296491,GTCAGTTTACAAAACAGTAAAATGAATTGCATTTCATAGTTTATTAAGCATGTTTGTCATAACAATTCACAAATACTAAACCTTTTCTGATATGTGCTTTTGTGTTTAG
>TTN-206,,0,103,1296492,1296594,GTTTGTCAGACTGCTCTTCTAGATTTATACGATTAGTAATTAGATGTGTCTTTGTCTGTATGTATATGTGTTTGATTTTATATTTTCAATTTGGTCACTTTAG
>TTN-206,,0,92,1296595,1296686,GTTTGTCATGATTGCACATTTTTATCTTTGTATACAATCGATGATCTGGCATGTCTCCTTCATGACTGATTGATTATCTCTCTTGGCTGCAG
>TTN-206,,0,594,1296687,1297280,GTGATTGCAATATTTTTAAAGTGAACGAATTTGTGTTTCTTTTGAACAAGATTTAAAATGTCTGGGGAGGCCTATTTTTTAGGAAAATCTTTCCAAAGGCTTAAAATTCTGCTTAAGTAATCCTATTTACAGTTAGTGGCTTATCTTTTTCTATGGATTCTACAGAGAGATAATATGACTAAATCTTTAATTGGAAGGATTATGCAATCATTTGCTTCTATAATTAAATCTTTTTTAAAAAGTGACCATATATTTTTAAATTCCACCCCGTAAGTATCTCATGCAAATTGCTAGAAGGCAGTCTTTAAAATTACAGGAATCTGCTGCTTGCCCAGAGACATGCCTTCAGCCAACCAATTGCTTTATTGGTTTTCATACTGTTTTGCACCTACTGTGCATTAGGGTTGGTCTCAGAGTGATACTTTTGCTCCAGAAATCTATATGCTTTTCTTTATCTCCAAGTTAATTCAAGAGACATTAATAATTCCTGATTTTTAATAGAAATTGCATATATACGTGCGTTTGTATATATATAATTGTGAGAAGAGCATTTAGTAAATTAAAGTATTTGTTACTTTTATTCTGTTCCTACAG
>TTN-206,,0,139,1297281,1297419,GTTTGTGGATTCTTAAACTTTCATTTCTAGAATTAAAGTATTATAATCAAATATGAACTTAGGGAGAAATTTCTATTTCAGTAAACTGACATGGTCCAGATATTGAGCCTGAAACCTTGTCTTTCTGCTCTACTATTAG
>TTN-206,,0,778,1297420,1298197,GTATCGTTTATTTTGCAAGTGGTCCAACAAAAGTGTAATCATTTTGTAGTATAGCCTGAAGGTGTCGTTTTTATGATGATGAATGCAATTTAGGACATTTTTAAACAAATGAAAAGAAAATGTTTAAGAGGAAATAAGTTTATCTAGAGAAGAAGTCATTTTTTAAATCTGTATTTCTTTCTTTCCTCGAGACAGGATCTCATTCTGTCGCACAGGCTGGAGTACAGTGGCGTGATCTCAGTTCACTGCAACCTCTGCCTCCTGGGTTCAAGTGATTCTTGTGCCTCAGCCTCCTGAGTAGCTGGGATTACAGGCGCCTGCCACCATGACCAACTAATTTTTGTATTTTTTGGTAGAAACGGGGTTTCACCATGTTGGCCAGGTTGGTCTGGAGCTCCTGACCTCAAGTGATCCACCCGCCTTGGCCTCCCAAAGTGCTGGGATTACAGGCATGAGCCACCACACCCAGCTTATAATCTATATTTCTAAAACTTTATATATTCCCTATGATACTGAGACTACCCCTTCTTTTTACAAATTTGTGATTCTCTAAATGGCCATGAGTTACTTCTTATCATCCACCTTGTAAGTCAAAGAACAGTTTAGAATAAGCTCGTAGAAGGAGGCTGAAATGTTTAGGAACATATTCTGATATAGTGTATTTAGTTGGTTAGCCTTGATTTTTAACTAAAAATATGAGGGTTTTTTTTCTTGAAAAGCTTCATATTAGTAATCTGCTTCTAGCTTCTACTTCATATATCCTTGCAATTTCTTATAG
>TTN-206,,0,1752,1298198,1299949,GTGAGTTATCCTCACAGCCCCAACCTGTTGTGTTTTTCTTCACTGCCTGTTATATATCCATGAGCATTTCTTATGATATCTTGACCAAGTAAGTTATAACAAATATAAATACACATTATTTAACTGTGTATTTATCACTCCATATGTTTACTAAAAATATAAATTATTGTAATTTAATTATGTGGCTTCCCGAAGGAGGTGTCATTTAACGGACTAATATCTTAGGTTTCTAAATCATATCCTAAAATTCCTTTAGGTAGTTAGAAGTTTCAGCGTACTCTGAAATGTGTGCATATGTGACATATATTTTTATGAAGCACATTTGTTTTGAAATTTTTTTAATGTTCATCACCAAATATCACATTAACTTGACTATTATTGAGTTATATATTATATCACAGTCTGAAACTTTCTCCTTTCCAAGTGTATTTCTAAAGGATTATTGTTTAATGTATATTGCCCAAAGCGTTTGACCTGCAAACAAATATTAATCCCAGACAAAAGGGTAACATTTGCCCAAAAAGAAAAATAATGGGTAGAAAACATTGCATATCATTATGGAAGACATATTTAAATACACAATCATCGCTTGAGAAAATGAAATAGACCATGTTGTTTAAGGATATCTTTATCTGTTTCTCTTCACTGTAATGGCTTCCAGTAATTACAACATAGCTTCATCAAAATCACATTAAAAACTAACCTCCTAGAGCAGCCTGGAATTAATTACCAACTCTTATGATCTGGTTAGTTATCTCACAGTGCACAGGTAGTAAGTTATTATTAATAGGCTGATATCACTAATAAGTAAATATCACTGAGTTGTCTTAAAATTCCAGTTTCACCACTCATTTTGTGGAATTTAGATGCATTTAGTTTTAAAACACATTTTATAAAATGAAAAATATATACTTAGCAGTGGCTTATCTTCATGATTTACACTCATGATGGTTTTACCATGGGCAGATAAATGCTTTCTATAGAATTCTGAAGCTATTTATAAAATGTTTTTAAAGGATAGACATCAGAAGTTTTAATCTTTGCAATAACAAAAAAAATGGCCTTATTCTTTCTAGGTACAGGTCTCAGAACCATTGAACAAAATCATTACATAATACTGAGTTGTACATTGCCTTCCTATCATGTTACTCATCAATGTCTTCATCATTGGTCTTCAGTTAAACACTGAGCCTCAACTCCTAATTCCCTTGGGCTAAGATTGGATTTTAAATGCTACTGTGGCTGCATTTAATAGCTAAAGATGAACATCAGAGAAAATCACATATAAATATGTGGGCTCATGTATTACTCAAATGCTAGCTTTCTTTCCTAGAGGGTAGCAATCATTGCCGCTGGAGATAAGCAGAATTCCCAAATAAGCCCTTCATTTTCAGGGTTCAGCAAAAACACCGCTGTACACAGGTTTGAGAGAATTAATAGTGTGCTATATGGCAAAGAAGTTCATAGTAACTGCCAATGTCTGCAGTGCTTAGTAAGGACACAGAGGCTGGGGCAATTTGTGGGCAGCATGTGATGTGTTCTTTGCTTGTTTTTAAACCTTTATCTTTTTAAAAAATCCAACAAATTTAAACTATTGTCTTTAGAGAGGAATAAACCAGGCACATAATTCTGTCCTACTACAGCAACAGTGTTACCTGTTAGAGGCCAGTTTTTCTCTTTATTTGTTTCTCTTGTGGAATTTAATACTTTTTTGCCTTTATGTTCCTCATGAAAATACCTTTTCAATTCCAG
>TTN-206,,0,571,1299950,1300520,GTACAGACACCTCAAAAGTATTATGCAGCTCAAGCCAGCAACCACTCATGTTTATTTGCTTATTATGATTTCCCTAGAAATGGAATTAGATTTTTAGAAATATCAGTTGTTGCTCATCTGCAATTTGTAGGCTCCTTATTATAATTGAAATATTAGGTAATTTAACAGAAATAATGTCAATACAAAGTATCTGAAATTACTACAAGTTTACCACCCTATTTCTTGAACTTCTTTTCACCATATCCATTAAGATGTAATTAACGCAGTTCCAAAAATGATGCTATAATAATGCGATAGAAAGTAGGCTGTTGTGATACACCTGGAAAAAATAAAACCAAGTCTAAAAATATTGACACTACTAATATGATTATAGTTCAACCTTTGATAGCTATCATTAGCATAAATGTCTGAGAAGCTGCTTTATCTTCTGTAACCCACCCTTACATAGAAAGAGAATTCTGCAGTACTTACTTATCAAACTGCCAACCTCCTAAGGCTTATTTTACAAAGGGGGATATGTATTGTAATTCTGAGGTGATTGTAGTAACAAAACATGTAAATGTTTTTTCAG
>TTN-206,,0,122,1300521,1300642,GTAAGTGCACTTCATGAGAAGTACATCTTCATCTATCTTATACCTTTTACTTATGATTTAATTTTGGAAGAACTGATTTTAGAAAATTAAATTTTTATTCACTTGTTTTCATTATTCCTTAG
>TTN-206,,0,1096,1300643,1301738,GTGAGTTCAATAAAAACCACAAATCGTACAATCAGCCCTCCATATAAGTGGGTTCCGCATCCACAGTCAACCAGCCCCAGTGGAAAGTATTAAAGAACAAAAAATTTAAAAATACAAATAAACAATACAGCATAACAACCATTTACACAGCACTTACATTGTATTAGATATTATAAGTAATCTAGAGATGAAGCATATGGGAGGATGTGCATAGGTTACATGCAAATACTATGCCATTTTGCATCAGGGACTTGAGCATCTGGCCACAGGCCTCCTGAAGCCAATCTCCCAGGCATAGAGAGGGATGACTGTAATGTCCCATTCACAAAAAGAATCTCTCAAGAGTCATGGGCCATCCATCTCAAGATTCAGATTGTTAAAGAACATAGGCATATAGACATTTTCACAGAAGCAGATAAGCAAATACACAACATCTGGGTGTTCTTGTTTCATTAGAATCAATTTCCGAATTTAAGAGAAAGTTTTAAGAATGAGGTGAATGTCTATTAAGATTTTTAAACAAAAAGAAATGGCCTATAAAGAAACCCCAGTATTGTCTGTGCCTAGGTATGAAACTTTTTTTCTATATATGATTTCTTATGTTATGAATGGTTCTCTAAAACAACTGTTTTAAACATTTTCCATAATTATCATTCATTTCAATATGGTTCATTTTTCAACATAATTATTAAATTAAATCCACACTCAATTTCCACACATCGTTTCCGTGATATGTATACTATTCTATTATTAAAGTTTTCCATTGCTATTATTATTTTTTCTGATATTATAATTCATTAGCTAGGCTCTTTGGTTATAAAGTTTACAGAAATACTTCTATTATCCTTTCCCTTCTTAAAATTTTCATTCCTACATCTATATTTTATTACAATGGTCCTAATCCATCTGATCTTAATCGACTCCATCTCCAAACCCACATTTTTAAATTGTTTCACAGCTAACATGGTAAAATTAATATTTATTGAATAAAGAACATAGAAAACCTTAATGAAGTATATAATCTTTGAATGATGATAGACAATTAAAAATAAGTAGAAGACAGGTGTTTTATCCTTACTTTTTAAATTTTATTTAG
>TTN-206,,0,207,1301739,1301945,GTATGCTCCTTCATATATAGCATCATGCTAAAAAAGTCACATTTAAAACATCTCACATATTCCCTTTGAATTACCAGAATCCTATAGTTATATGACGTCATTTAATATGACCTAACCAGCATCCAGAATGGAAGCTGAATATAGTCATGCGTCCTCTAAATCAAATTTTGTTTCATCTGTAATGCCTATCATTTTTGTTCTTCTCAG
>TTN-206,,0,99,1301946,1302044,GTAAAAAGAATTATGTTGATAATAAAATGAACAAGTTATTATTGAGTATTATTATAAGGGAAGGAGTAACAAATGTGTTTTAATTCTTTATTCTCCTAG
>TTN-206,,0,102,1302045,1302146,GTAAGTTAGAAAAGGCTTATGAAATACTTGTGAGATTTAAATTACTGTTGAGCACATCTGCGTGTGATATTGAACAAAATGCGTGTTGTATCACATGAACAG
>TTN-206,,0,1483,1302147,1303629,GTGCGTGAAACACTATGGAGTCCTTGTGGGTACAGCATAGGTCAATGGCAAATGTTGTGCAGGACCCCTGCAACCCTACCTGTAGACACACACCAAAGTGGTCATGTGTTCTTATTTCCCAACACACGTTCTCATAGTATTCATCTCAAAGTTCATACAAAAGCACAAGGGAAATATTCAAATGAGTGTCAGTTCTTTTGCATCGTTCTTTTAGATTTTAATCTAGTCTAAGACATAATCTTTAACAGTTATTTCTGTCTAAAGTCTAAATTTCATGATTCTCATATCTAGGATTGTAGAAAGAAAGCTAGGAAAGGACAAGATCTCATAGATGTAAATCTGGAGGATCTTGGCTAGGAATTGATATTTTGTTTATAGGACTTAGTCTGACTTTCTCTGTACAAAATTATATAGATAACATAAACATGTCATGTGCAATTAGCAACTATTTTTCAAAAATATTTATTTCATTTTCAGATCATGTTTCAACCTTCTGAATCTCTGAAATTAAGTGAAATCTCAGAATTTAGGAGTAACAACATTCATTTCCTAATTGATTATACACATTTTCCAAAGACACCCTCAAACTGTATTGAGAAAAATTTTGGCTATGATAATAGCATCTGCTTTCAGCTATTGGTGCCCATTCGTAGTTGCTGAAACACAAATATATGACATTGGATTTACATAAGCATGTCAACTTTTCTGACTTACCTTACAATGAATATCAGTGACTGGTTGTATTTTAAATGGTTTTCAAATTAAAGGGCCAGCTGCAAGTACTAATTATTTTTTAAATAATTGATATTTTTAATATAATTCTTTAGTAAATAGAGCTCACCAGAGTACTGTGATTTCTAAGACTTTATGGTACTGTTATACATATAAGACCCTCCCCTCCAGCCTCTTCTAGAAAGCACTCCTGCCATCCACACACATACTTTGTTTGTGCCCATATGTACTTAGCAGATTTCTGAACTCTAAAATTTTTCTTTTTGAAATTTAGAAGTGCAGATTTCCGATTGCGTTTGAAATTATTTTACAGGAAAAGTTATACATATTAGATAAACAATTATAGATCCTGAATAGCAAAAATTATTTTACTGAGGCAAGAAAGAATTTCACAGAGGAATAAGTTGTAGAGTACAATCAAGTTTGTGTTCCCTAACACTTTTAAAATTTAATTTGACTTTGGGTCATTAGCTCTCTTTAGTATGTTCTTTATATAAATATTTTAAGAACTCACAATAATTTCTTTACACTTTGCTACATTCGACCAGCATGAATACACTTAAGAATTGGGATACTTTTTTGTTAGTGATGCAAAGAAGAGTGCATTTCTTCTCATTTTGGATTTTTGAACTTTTCTTGCTATTTTATAACTGGGTACAAAGATGGAGATTTTAAGTATCTGAGGTAAAAGCAAGTAAAAGAAATTCCTCTCTATATAATCTAACTTTGAACCCTCTTTGTACTTAAACAG
>TTN-206,,0,208,1303630,1303837,GTGATTTCATTGACAGTTTTCCAGTGAATGTATAATTTAAGCCTCGTCTGTTTTCTGTATTTCTACCCTGTATGCGCTCATGCTCTCATTCTATCTAGAATGCTTTTTTAGAAAAGACAAGTGTAAATAAACACATACGTATATTGAAGTAAAGAAGTGTTATTTGCAACATATCAGAAAACAAAAGTTGGATGATTTTTCACCCTAG
>TTN-206,,0,101,1303838,1303938,GTGAGGTAGCGCCATCAGAAAGCCACCCTGCCATCTTCGAAACACGTAGCCTACCTATACCATTCTGAACACAAAAATATCATTTTTTTTTTATTTTGCAG
>TTN-206,,0,452,1303939,1304390,GTAAGTTGTTTTGTAAAAATCAATCCTTGCTTACAATAAATTTGGCATAATTTTGTAAATCACAGAAGCCAAACTAAAATGTATAAGATATCTTTCTCTTTTGGGTAAAATATTTTTCAATAAAACTGTTATGCAGTAGAATTACTTTCAGTCAAATAATAAAATGTTAAACCTTGTGAGTCTGGCAAATTAGAGATAATAAGGTCTCACTCAGCTGATGCTAGAATCATGTTAAATAGAATAGCCACAGAATGAAACAAATTTTGACAGTGAACAAAACTTACCTGCGTGGTTGCATACAAAAGAATACTAATATTATTTTGTCTGTATATTAGATTCTGCCATTAGATATGCCTGACATATCTCAGGATCTAATAAATCAAACACACCTTAGTTTTCTAATAAATAGCTTGTTCTCAGTCTCTCTATGCTTATTACATGTCCCTTTCCAG
>TTN-206,,0,324,1304391,1304714,GTAAGACCCAGAACCTCAACATCTGAGCTTGGAGCAGCAATATTCTAGCACTAGGAATCTGTACGAAATTTTATACCAGCGACCAAACTGCAGCAGAGTCAGAACAAAACCTTCCATGTCATATTCTTCAGTGAGCAATTAGAAATTAAAGTAAAAAAAAAAAGTAGTTCCAGTTATAAATAAATGCTACTTTTATTTGTTCCGACTGATGAATTCGTACTATAATACCTATGAAGTACTGAAAGAAATGCATGAGACTTTTCATTATATTTTACGCAAAATAAGAAACTAAAACATGTTACTAACGGCATTTATTTTCTTCAG
>TTN-206,,0,2205,1304715,1306919,GTATTATACCTCATCTACCTAGATGTCGAAATAAGAATTTCACTCTGCTGACCCGAAAAATGTTGCTTAATACAACGCATTGGCCCTCTAGTGGTCAAGAGGTGGAATTGCCTTTCAAAATGTAAATTACTTTCTCAAAGTATTAGCTAACTAAATGTGTAAGTTATGTGCTTAAAACTCTGAAAATCATCAAACAAAATACTATTTTGGTATTAAAATATTTTATTTTAATGAAATTACTGAAACATTAATAGAGAACTAATTTAATGTTTCATATTTTCCTAACTACTATGTATAACAAAAAGAATAATGGAACCAATTTCTAGTGCAGCTTATAGAAATAAACCATAGTAGTTTACAGCCAAATTGCAAATTATAGCTTGTGGCTTTTCTCAATTTATAGTATTAACTACTCTTAAAAATTTACTATTTTGTCACATAAAATATGATTTAGAATACTTATGAAATATTTGACTTCTTTTGTACCTAAGGCATGATCTCACCAATAAAGAGATCTTAAGTGTTCCAAGGAATTGCTCCTCTCAAATACTCAGTAGAGAAGTTGTAGTATTTGTGTCCCAAAGCTTCTCAACTAAATTAGACAACAGATTTCCTGGGACTTTCTGGAGTTATAGGGAGTTCAGAAATGCTGTCAGAATTCTCCCAGCATGGTCAGAAAAAATTCTGTATGTCAAAATCACATTTTTCTATAGCTAAGTCACTACTACTGTATTAGATTCAAGGGGTGGAAATGGTAGGCCCTTAACACCCGCTATAATTGGCATTAAACGCTTGACCTATTTTTCAGCCAGCCTTAGAGGAAATTCAATTAGAAACTTCCAATTTTGTGACTAATGCAACCTCATTAACAAAGAGAAGCATTTTTATGATTCATACGAACATAAGCATTTTATCTAGCTGTGAGAACAGAGAGGAACAAGAATCAACAATCATAAATTGGATTTCCATTTCTATTTCTGTTGTCAAAAATAATAACTTATGTTAATGAATGATTTGTTCTTTGACTGGTAGTATCAACATGGCTAAGTTTGGTACTCACTGTGAAACTTGAGAAGTTAAATAATGTTTTAAAAATTAAAAAAGAGGCCTGGCGCGGTGGCTCACGCTTGTAATCCCAGCACTTTGGGAGGCCGAGGTGGGCGGATCACGAGGTCAGGAGATCGAGACCACGATGAAACCGCGTCTCTACTAAAAATACAAAAAATTAGCCGGGCGTGGTGGTGGGCACCTGTAGTCCCAGCTACTCAGAGAGGCTGAGGCAGGAGAATGGCGTGAACCCGGGAGGCGGAGCTTGCAATGAGCCGAGATCGAGCCACTGCACTCCAGCCTGGGTGACAGAGTGAGACTCCGTCTCAAAAAAAAAAAAAAAAAAAAATTAAAAAAGAGTGGGCTGGGCGCGGTGGCTCACGCCTGTAATCCCAGCACTTTGGGAGGCCGAGGCGGGCGGATCACAAGGTCAGGAGATCGAGACCATCTTGGCTAACACGGTGAAACCCCGTCTCTACTAAAAATACAAAAAATTAGCCGGGCGCGGTGGCGGGCGCCTGTAGTCCCAGCTACTCGGGAGGCTGAGGCAGGAGAATGGTGTGGACCTGGGAGGCGGAGCTTGCAGTGAGCCGAGATTGCGCCACTGCAATCCGGCCTGGGCTAAACAGCGGGACTCCGTCTCAAAAAAAAAAAAAAAAAAAAAAAAAAAAAAAAAAAAAAAAAAAAAAGAGTGTTATTTATTCATGAATACAAAAGGCCATAATCAAGTATGATTAGGAACCGTGGTTAAGGTATAACAGCTGCACAACAAAGGACTTTAAACCCACTTGTTACTCTTCCTCCTAACATATTTGTGTTCGTCCCTAAGGATGAAGCAAAGATGAAAATGTGTACTTTACTATTTATGATATCACTTAGATTCACACTCCATGTTCTGAAAACTTTAACTCTCAGCAGACATAAAATCAGTGAAGATGTAAGATCACAGTACATTTTCTATATCCCTCCAAAACAATTTTTTTGCATCTAGTCCTAGATCTTTCCAAAACAAATATCTTGTAGTAATATGCAGAATCTCGCTACTATCAACATATGGAAAAATAAAATATTTCAATAAAATTCCTAGTTTCCTGAAAGCATTTTAGTTACTTACACCAGAAATATTTTTTCTTTTTTTTTCTTTTTTTTTTTTTTTAG
>TTN-206,,0,1674,1306920,1308593,GTATTATAATTAATCAAAAAGCAGTCTTAACACTTTTTTCTTGGCCAAAACTTTTAAATTCTAAACAGTGGAGGGTGAAGGAAGGGTAAGAGTTTGCAATCACAAAATGGTACCTCTCCCTTCACTCACTTTCGCCCTCGTCTTTGACTCAGTCCTCACTCTCTCAACTCCTTTTTTCCCCCTTTTCTCTTTCCTGTCCTCCTGAGCCCCTGGGAACCAATGACAACACCAGTGTATTCTGGTTATTTCTGGATGAAAATTTAAAGAAGGTCTTGCCCAGAAATCCAACAGCTATTCTTTTTTTTTCTTTTTTATTTTATTGTAAATTGACTATTTACTATTGTGTATATATTTATGGGGTACAAAGTGATGTTATGATCTGTGAATACAATATGGAATAATTAAATCAAGCCAATTAACATATCCATCACCTCAAATACTTAACATTTTTGTGGTGAGAATATTTGAAATTTACTCTTAGCGATTTTGAAATGTACAGTACACTATTATTAACTATATTCACCACTCTGTGCAACAGATCTCAAGAAAAGCCATGTTTCTTCTGTCTAAGATTTTGTACCCTTTGACCAACATTTCCCCATTCCCTCAAATCCCCAGCCTCTGTAACCATCATTCTACTCTTTATGAATTCAACTTTTTTAGTTCCACATCTAAGTGAGAACTTACAGTCTTTGTCTTTCTGTGCCTGGCTTATTTCACTTAGCATAATCTCCAGTTCTATCCATGTTGTCACAAATGACAAAATTCCCTTTTTTTATAAGGCTGAATAGTATTCCATTGTGTATTTATATACCACCTTTTCCTTATGTATTCATCCATTGATGGACACTTAGGGTGTTTCCATAACTTGGTCTTTGTGAATAATGCTGCAATGAACATGGAAGTACCCAACAGCTGGTCTTGATAAAGTCACATCAATGTAAGATCAAGGGTTGCTGCTAATTTTAAGAGGTTGCTGCAACCCACCTCAGTATCTTTCCTGATTTAGGTGATCTAAATATCAATATTTGAAGAAAAAATACTTTATGAAGGAGGATCAATTCAAATCACTTTAACTTTCAATATATCCTCGAAGATTTTTAGGAAAACAGTTGGATAACTAAATTTAAACAAATAGTTTTAACTCATTTGACTAAGATTAGAGTACAGCAACCTCCATAAAGAAGGAAAATATGGAAACACAAGGCATCATTCATCATTCAGACTTTTCTGAGTGGTCATTTGTGAAACATCATGGAATAAGAGGACACTCAAAAAGCATGGATATTTCATGAACTTCATAGTTAATAATTGAAAAAGTCTAATGTGTTATTTTTAGCATTGGACATATTAAACATTCTCTTCATGCTTAATGTTAACTTATTAGAAATCAATCTAAACTAGAACCAATTTAAATGATCTTAAATCAATCTAAACTAGAATCAAACTTTGGCCTTTTGCATGTTTGATTTTTGTTAATATGGCCTTGCATAGCATTTCTAATGAGCTAGATTTGGAAATTATAGAAGCATTATTATGATTCCTGGAAGGGCTGGTGTATGAGTAGTAGTCATAGCTCCTACAAACAACTAACAATGATGTGGAGGATTAGTAAACATTAATAATAATGTAATCTAAAAATAAACACACATTTTTATGTTTTTAAACTCCCAG
>TTN-206,,0,851,1308594,1309444,GTAAATAAAGATAAATTATTTTTATTCTGTTTATTCCTGAGATTTGCACTTCTGCTAACTATTCTTATTTTAAATATTAGGCTTCCAACTTATTGAAAGTTGTGGAGTCTCCTCTGCTGTGTTAAATTTAGCATTAGAAATGATGGCTATTTCATATTGCCCCTTTCCCAGGAAAACAAACCCAGGCAGATGTTTATGCTGCCTCTGTGCAATGGTCTCAGAGAAAGAAGAAGTGAGGGCTAGAAAGGAAGGGCCATTCCTTATTTTTTTATTGTAGTTAACACAAATGTTAAGAGTCATATAAATAATGAGAGCCCTTAAGAACTTTAAAAATCTGTTATCTAAAAGTACCTAATTAACTTGGTTACATAATTTTAAATGTTGTTTTTATGAAACTGACTAAGGGATCATATGCAATAGTCAAAAACCTAGGTTTAAAATTAGAAATGTTTTTGAAATAATAATCAGAACTTTTTAAAAAGGTTAACTGTATAAATATGAAATATAAATTCCATGAACTTATCGAATATTAAAACTATTCCACTGGAAGAAACTAGGGGTTCTGCAAACTGGAGCTCTCATGGAATAATAGAAGGTGTGTCCATTTGATAATATTTATTGAATCCATTTTTTCATACTGGAAAAATCCTCAAATCAAGAGTAGAATGCATCTTGATACTCTACTATGTTCCATAGTCAAAAATTTAAATGGAACCAATACAAAAAAAAAAAACAAATTATCAATAAAATAGATCTGAAATACTGATGTTGTTTAACTAGGTAGATTTTTGTTTAGTGAAGCAGTTGGATGGATAGAATTAATATGCTAATAGTATCTTTATCTATTTTAG
>TTN-206,,0,454,1309445,1309898,GTATGTATAAACTGAATGACTTGTTTCCCTCTTTTCTTCATTTTTGCTCAGTTCATTAAATTTTCAATGCTATGAACCTGATTTGCAGTTTATGTGAAATAGTTAAAATGATCTTAGATTTTTTTAAGGTTAGAAATCTTTTAAAAGTTATTTTCCTCAGAGTTACTTTCATGCTTTGACATTACAAGCTAAATCATTTAGTCTTATTACTAACACTAAATTCCAAGTGCTAATTTCTAATGCAGAAGTTCAAGTTTTACTTTTACTGCCTTGTTGCATCTCTGCTTGATCCTGCTTCAAATCCTAGCACTAAGAATTGTGTTGGTAATAACGATCCCAAATATAATACTTCACACGATTATATATTATCCTTACCTTATCTCATTTGCAATTAACAACCTAAGAGAACTTACCTATTTAAGCATCCCTTCTTATTCCTGTGTTTTTATTTCAG
>TTN-206,,0,441,1309899,1310339,GTAAGTAATTAGAAATATTTAAATAGACTAGAGCATCAACATCATTATCATGGCTTGTTTGGCAGCAATGTATAAATCAGCAGTTCAATCCAATAGGCACAACTTCTTCTCTAAGCTTTATTGTGAATGATTTTTTTTTCTTAAAATTTCTATCTAATTGATTTCATTAAAAAATCAAAAGATGATAAAAATTGTAATGGTAAACTTAAATATAACCAAAATATGTTAAGTACAGAAACTTGTACCCAGAGTTCAAAGTTGTGCGTAAAGGTCAAAGAAAAAAAAACCGAACTCATCTCTCTCTTTAAAAAATGATACATGTATCTGCATATACACTTATAGGTGTGTATAAACACATATACACAGAGAGAGAGAGATAGAGAGAGAGAGAATTTTAATAGGAATTCTAAAAGTACTGCAATTTCTCTAAAATGCTTGCAG
>TTN-206,,0,152,1310340,1310491,GTATTATTTAAAACATTCCTAGCACCCATGTACACAAGTAATATGTTTACTGATCTATACTCACATTAGTTATTTATATAATCAAATACTTTTAAATTTTGTGCAAAGCAATATTCTTCAAAATACAAATATATTTGTACATATTTTTAAAG
>TTN-206,,0,590,1310492,1311081,GTATACATCTTTGTGTTTCAGCTACAAGTTCAAAATTTTTTTATTTATGTGTATGGACATGTGTACATATATTGCTAAGTAACTCACAAATCTGAAACGACCAAAAACAGCACATTTTTACATAATACAAATTTTATGTTGAGTTGCACATATGTTTAATTTAAATAGTAACATTATCTACTTTGTTTCTAGTTCTGCTTAAAAATTACATTTTTTTATTATAAAGAAGGTTTGTGTTTAATTAGTAGTTTGCTAACTTCACTATGCAATGCATTCCATTGCATATAATATTCCCTGTCCTCTTATTTATAGAAATAGACCCTAACAGATTTGGAAAAGCACAACATTGTGTGTGAAGAAGTTGTGTCTATTTGATTCTCATTTAAGAATGTTTGATGAAGGCTGCATGCATTGTTTGTCCCTATAGATCAAAACATGATTTGTTTTCTTGTCAATACTGAATTTGTTCTCAAGCTACCATATTAACCCACTCATTCTGTGTCTAAATACTTGAGTATAAAATCCATGTGTTTGATCTGATGTCTTGTACTAAAAAAAAGGAATACTAATGTGAAATACTCTCTTTAAAG
>TTN-206,,0,232,1311082,1311313,GTATAAGGCAAACTGGAATGTGGGGGCTCAAATGGAAGGGTTTTAGGCAGATTTTTATCCCTCTTGTTGTCTAATTTGTGATCGTGTAGACATTTCTGTCTCCTTGTAAATTCTGTCATCTTTTTCATTTCATGTTTGTCTCTGTTTTCATTTTTATTTTAATGTTCTTTGTAAATTACAATTACCACCCACAACATGGCATATCAGTAATTAAAATGTACATTTTTTTAAG
>TTN-206,,0,1028,1311314,1312341,GTATTAGTAATTCATTCTAAGTTTAAACTCTTTTAATAAAAATTAGTACAAATACCATAGTAAAACATTTATGTTAGTATTAAATAATAGATTTAGTCACAGTGTGCATACCTATAGCCACTATGTACAAAGGATGTGATGGGGGACGGGAAGAACCATGAGGAAGGCACAGGGGGAAAAAAGTGAAAATTATGGGAGGCTCCATTCCCTGCTTCAGAGAGTTTGCAATCTCGTAACCTGTTACTTGGAAATACAGTGTCCTGGAGCCAGTTCATGCTAGCTCACCAGAGCCTATGGTTACATTTTCAGGAATTTTGCCAGTCAGTAGTTTAACACCACCATTATTAAAAATTAGATTATGTAAATTTACAGTCCAATAAAGTATATTTTTAAATATTAATAAATACTCAAAACTCCTATTTTACTGCATTTTGTTCTTATCTGTGTTTCTGAGATTGTTTCCATCTTTGTGTCTGTGTGGTGGAAATGCCATATAATGTACTACTGCACATCTCTTTCCAACTCCAGGACAATGACATCACCTTGACAGCCAGGGTGGGAGGGAGTGTTTATACCACCTTGGAAATCGGAAATCTGCAAGCACTATAGATCAAGGCTCCACCCCCTCCATCCCACCCAAATTGTTAAACATTTAAGACACAAAAAAATCTAATGCAATTGTATTTATGAAACTGCTTTATAAAAGTAAAGGTTACAAAAAAAAAAACTAACTTCATAGTTATCGATGTTCATAAAAAGCTGGTTTCTGAGGAACTGACACAGGCACCTCCGAGGGAGGATTGCTCCTACCTGTTCCTGACAAAGTAGAGGCTTCTGCAGTTAAAGGTGACAGCAGTCACATTTTCTAATTAGCCATTCAGCCATCTTCATTTACTCTCATTTCTAAAGCATAATTTTCTTGCATTCAGTTGGTATAAAAAGGGAATCTCTATTTAATTCTAAGTCTTACAACAACATATGCCTTGTCAAATGCACACTTTCTCAAAAATGGCACTTTTCTTTTAAAG
>TTN-206,,0,397,1312342,1312738,GTAGAATAATATTTGTGAAAAAAATAATTCTTAGCATCCATCTTGTATCTTTTTCTATAAGATCTGTGTATTAACAAAATAGCATCTGTAAACCATCTATAATATATTTAATTCTGTGTATATTGATTTCATTTATTTGTGGTGATGTGTTATACAAGTATTGGTAACATTTCTAAACTCCAGATCACGCTAACTGGGTCTTTGTCTGCTTGTGTAATGTATGTAATGTCTATATGGTGTTGAGGTATTTAGCTTTCATTTCTACCACAAGTAGGCATATTTAAATTACTTCCTAATTCTCACACTGTTAGTGAAGATTTATGCTTTAATGTAATCTTAGATGTCTCAGAAGGTGACTAGAATATTCCACATTATTTCAACAATTGTATCTTTAAAG
>TTN-206,,0,2119,1312739,1314857,GTACGCCAGAGCCAATGATGGGGAGACTCTTTGCTCCAAGTGCCAGCCTTTTGCTTTCTACGATCTTCATATGTACTATGCTGCCTTTGTCTTTTGTCTCTTTTACATTCTTCTTGTGTTTTTACTGTTTGTCAGCTTCCGTGCCATGCTCTTGACATACTTTATTTATTATACTGAATATTCCTAAGACATCACCAAAAAGTATTGTTAAAGGAAGTAACTATGTCAAACTGCTATCTTACATTTTTAATATCTTCCCTCTTTTAGAGAAAGAGGAAATGTTTGTGAAACTTGTTTTCTACTGACATGTTTCTAGGAAAAAACCTTTCATCCTTCATAAATGTAACTTTTTCTTAATAAAAGCAGTTTCATGCATTATGAAGAGGTGGAGACAGGCAATGACAACTGGAGAGTGTCTGGCAGAACTGAATGTTAATTACATAAAGACGTACATAGTACCACGCTTCTTAAAAGTCAATAGTGGCGAGTCTTCAATAGTGGGGAACATACAGATTTTTTGAAGTTTACTTTCACCATTTTCTTGAGACCTTAACTGAGCTTCAGTATTTGCCATAAATGTTTCCGTTATCTAATTAGCTAGTCAAAGTACCTTTCACAGAGGTATGTTTGAATGAAAATGTGCTGCTGTGGTATATCACAAATCCCTTGCTTTGGTTTGTTTGGGATTTTTTTGGCGATAAAAGGCACTATCTTATTGAAGCACTGAAGCTACAATTGCACGCATCCATTCAGTTATAGAGAGACTCAGCAAGAATTCAACATTATCCAATTTAGGAGAAACCAGACCTAACTAAAATAGTACATTTTGAATAGTGTTCCCTTGGCCTGACTTTGCAATGTTTCTATTTTCTTCCTGAATCAAATATGCTTCTCTCTTTCTCAAACTCTTGGCTCTTTCAAAATTCTTTTGATTATCTAACCATTAAATACAAAGGTCATGTTAGTAAAACCAATACTAATACTAAAGCTACTTGAGACAGATCGTCTTAGATAAATTAAATCCATTGTTATTATGTACTACATTTCCCCATACAAAGCATAAAGAACCTTTTCTATATACTATCTGAACATTCTTGACTGTTTGTGTAATCACTAATTCGTTTTCAGCAAAGTCATATATGTCTTCTAAAGGAGACACAGAGGCATCTCTCATTTACTCATAAAAACAAATACACATAGTATAATAGCACGTATATATATATAAATACTGCATGTATATATAGCATAACATATACATATATAAATTAACAGCTATATAATTGCACCAAAATATTACAAATGCACGTGCAGAGGTGCAGGGATTCACAAAAGCTGCCAATATTGTATTTAAAATGAGAACAATTATTGCCAATAATGCATGCTGTTAAAATTCATCTTCCAATTAAAAAGTCAACATTATCCATTCTTAGAATAGATAAATCAAATACACTGTAAACATTTTTTAGGTTGAAAACCCTGTTCAAAACTCTAGAGCCCCTTAGAAAAAAAAAGCACAAATACACATACCCACAAAATTCTGCACACAAAGCTCTGTAAAGTCATTAACACATGGGTATCAGATTGAGAGACCTACTCTAGAGTGTTTCCTGAGTTTTGAATTCACTACAGGCACACCCCCCAAAAATGAGAGGAGAAATGTGGGGAAGAGAAGTAAGTTACACATATTCAACTATTCTAAGACTTCTTAGTCTTAGTCTAAAATAGTCTTAGATAAACTAAAGCCATTGTTATTAAGTACTCCATTTCTCAATACAAAGCGTAAAGAAGTTTTCTATATACCATATCCACATTCTTGATTGTTTGTGTCATCACTAATTTGTTTTTAGCAAGGTCATACAATATATAAAGGATGAATTCTGTGCACAACTTTGTTACATAACTCATTTTTGCCTAAATGCCTCTAAAACATTATTTGTGATATTTATCACATTGTGATCCTTGGAATAGTATAGTTAGTTTAATTTTCTGGATAATTTTGCTGATGCATAGATAATCCATAACAACATTAATGTACTACATAAAGATTTGTGCATGTGCCTATGTTCTTTCATAAAAGTGATATATGTCTGAACTAACATTGTGTTTCAAAAACTTTAAG
>TTN-206,,0,217,1314858,1315074,GTACAGTGGCTTTCGACGTAAAGCCCTATCTTTTATCTTTGATACAAAATATGTTGTGTTTAATTATCTGTTCATTGAGTTAGTTTAATTCTAAATGAATGTTTTGTGGTGAGAACTGAACAAAAGTGTCTGTCCACCCGTCTGCTTTCTTAAAAAAAATAACTGTGCATAGCTACTTTAGAAAATATAAAGTCAATTCTAAAAATGTCTCTTCAAG
>TTN-206,,0,141,1315075,1315215,GTACTTAATCCCATCTCCATGAAATAACCTTGTCTTTCCTTCAAGCCTCTTTAATTGCATGTCTTCTTTAATTGCCACTTCTATGTTGCTCATTTATTTGGCCTTTTTGACAAATTTTAAAATTCAATACTATCCTTTAAG
>TTN-206,,0,153,1315216,1315368,GTATTGTTTCTCCATCTTCCCAAGAACTGTCTTTATGTTCCAGTGATTTTGTTAGTTTTGTGATATGAGTGCACTGTGGGTGTATTTCTTTGTTTTGCACTGGGCTTCAATGAGATCACATTAAATTTCTAAAAGTGCATAATGTCTCTAAAG
>TTN-206,,0,274,1315369,1315642,GTAGGATTTGCCTCAATCCTCTGACAAAAAAAAAAAAAAAAAAAAAAAATCTTCGAGTGTGTTAAATTCTTGCTTTTTCCATCTGGTCTGTGCTTATACTGATCCATTGTCTCACTTGCAGTGAAACTTTTGTGTTTATGTCCTTGTGATATGTAACTTGTTTTCCCATTTTGCTAGTCAAAGTGGTGTACTGTGCAACTCTTCCCCAAATTCTAGAAAGTGAGAATTGTTAAAATTCTTGATTTTAAACTTCAACTTTAACACTTTCTTAAAG
>TTN-206,,0,452,1315643,1316094,GTATATAATCGGAAGTCAGGGGATAAATGAGTTTGTGTGTGTTTCCTCAAAGTCTCTTCTTCTTCCACATGTGATTGTTTACTTTAGAACATGTCCTCATCAGTTATTTCTCCTTATGTTGGTATTAGAATGTGTCTACCTTTTGTAGCCTTCTGGGACTGAGTCTTTTGTGTCTATGTTGGCCTTGAATCATTCGAAGGAAGTGGATGAGTCCCGAAAATGTTATAATTTTGAAAGTGGCCACACTTGGACATAACTCAAGTATCATTCTCAGTCTTGGGCTGTACTTGCCCTCATCTTAAATTAGCTTCCTCCTTCTTATAGTGAGGAAGTACCATGAAGCTATGTCCTAAGCAGATAGAAGAACAGTTATCCATCTGTAGTGACCACATGGCTGTATATACATCTGTATCTCAGCAGGCTGAATTTAAATGAAACCTTATCTTTTAAAG
>TTN-206,,0,2512,1316095,1318606,GTAAACAATGCAAATAAGCTAGAGATGATCTGGGGTTTTGATGAGGTGTTTTCTTTCACAAATTGTCTACAGACCAATGAAAAGAGACAGAAAAAAGTGACACAAATTCAGTGAACATCTACCAGTCTCATTAAATGAATATTTTGATCAAAACACAAGATTCAGGAGGATTATACTAGATTAGAGAAATCCAGTGTATTTCTTCTGCATCCCTTCTTACTTGCCTACATAGAATAAAAGAGGCTTCATATTTATATATAATTAATCAGGGCAGGTATCTCCATATACATATATCCTTTCATTAAACAGGACTTGGCTTCAGCATGGTGGGCTGGCATAAGCTTTACCTTAGTAGCCTAATGCCTAATTGGTGTTTCTCAAACATTGCTTGTACCACAATCCACAGACAGAAATATATTTTATATTATAATCCTTTAATTTTTTTATTCTAGGCATTTAAAAAATACAAGTTATAATCCATTAAGTCAATTGCAGAAGTCACTATAATGTCTTAAAATGTTTTAAAATGAGCAAGAAAATATATTACCTCATTACATTCCAGGAGTCAATGCCATATTTGTGAGTCTGAAGCCCTGAACACATAAGGCTTTCCTGTATTTTACATATGGAGAAAACCATTGTGTTATATATGGGATCAGACTGACTTGTTACTCAGATCTTTTCATACCTATAATGCTAATTATCTATAGTTTCTTAAGGACAGAACCAACAAACTATTCCATTGGGATATTTTTTCAATGAATTAAGGCAGCACCAGGTTTCCAACTAAAATCCAGCATTCTGGCTAGAGCCATGTGGCCAAAAGAACTTTCCTAAGAAAGTTCCTAAGGTCTGCTTTTAAAGAGAAATCAATAAGCTCCTTAACCAAACTAACTCTCTCCCCAGTGAGAAGATGAGTAGAATTGAAGTACATTTAGATGTCCCAAGTATCTGTTTTTATCTGTCTAATAAAAGATGGCACACCATGCCCCTTTTTTCACTTGGAACAAAAGCCCATGTAAAAATCCAAGGTGCCATAGTCTTAGTGGAATGCCTTGGAATAGGCCAAGATGGGACATGACTCCCAGGAGGAAATCCATTAACTCTGTTGTGCTTCCTGGAAGAGGCCATGATGGTGGACATAAGTCAGGAAGCTGGTAGATTTGAAGACGACTCCATCTTTTCTAAAAGTGTTTGTAAAACCAAACATAGTCTGATTTCAACTTTTGACACTATAAACTTCCTGTAGTACTCCAGACTCTAGTTAAAAGGAGAAACACTGTGATTATTTTTATGTTCTCATTATGCCCCAAAGATGGGTGGCTTGTTAGGTTTACTTTCAGCGTAAGGAGCAGATATGTTTTTAACCAGACACTTCTATTCCTTATTTAACTTTGACCAGGCATGGTGGCTCATGCCTATAATCCCAGTGCTTTGGGAGGCTGAGAAGGGAGGATTGCTTGAGCACAGGAGTTCAAGACCAGCCTATGCAACATAGCAAGCCCCATTCTACAAAAATTAAAAAAACAGCTAGGCATGGTGGCATGCACCTCTAGTCCCAGCTACTCAGGAGGCTGATGCAGGAGGATCATTTGAACCCAGGAGTTCGAGGTTACAGTGAGCTGTGATTACACCACTGCATTTTAGCCTGGGCAACAAAGCAAGACATTGTCTTAAAAAAAATTAAAACTGGCCGGGCGCGGTGGCTCACGCCTGTAATCCCAGCACTTTGGGAGGCCGAGGCGGGTGGATCACGAGGTCAGGAGATCGAGACCATCCCGGCTAAAACGGTGAAACCCCGTCTCTACTAAAAATACAAAAAATTAGCCGGGCGTAGTGGCGGGCGCCTGTAGTCCCAGCTACTTGGGAGGCTGAGGCAGGAGAATGGCGTGAACCCGGGAGGCGGAGCTTGCAGTGAGCCGAGATCCCGCCACTGCACTCCAGCCTGGGCGACAGAGCGAGACTCCGTCTCAAAAAAAAAAAAAAAAAAAAAAAAATTAAAACTGTATACACTTAGGCTCAAAAATCATGTGAAGCCTCCTGCCTCTTCTACCATACCTGCCCCACAAAACTGGCGGGGAAAACAATATGGAATATTATCTTACAATTCACTTAAATCCTCAAGTATGTTTCTGCCCTGTGGCCTTCAAATCTACAGTGCTCTGCTATTTGTGAAACTCATCTTCAAATTCTTCTGTTCTTATTAACTCAGCTATTATAATCGTTTCTTGTCCCGTACTTGTCCTGTCGTTGCTGTGGATATAAGCATTATTATCTGTATGACACATTTGAAAATTAAGTTAATGAAACCTATTTCCCATTTCCCATACTCTTCATTAACGCATGTGCTTTGATTAAAATGCTCTTTGAGTATTTTAAATAGGAACAAGCAGGGGTTTGGCAAGGGTTAAACTTTTGCTATTTTGATTACTCTTTGAAGTGATAAATTAAAGCTAAAAATAAACATGAAAAACACTGTAATTTATCTTCTTTAAAACTGCTGTCTTTAAAG
>TTN-206,,0,187,1318607,1318793,GTATGCTGACTCTTTAATTAGTTTTATCCCTATGTTAGCTTGTCTCCTTCTTTATGTTTCCTTATAGCTAATTTGTCATCCATATTGCAAATATTGATAAATATCATGTCTAATAAAAAGATCCCTTACACTTTTATCGAAAAGAAATCTAGACATTTCTACAAACATATTTTATAATCTTTTCAAG
>TTN-206,,0,263,1318794,1319056,GTATGATTTCTTTCAAAGAAATGCAACACTATTTATTTTAATGTATATAATAATACCTTCACATTTGCATAACTGTCTTATGCATAACAATTTGCATAACTGTCTACGTTTTGTCAGAACACATGTATGAACGTATTTACTGAGTATAGTCATTAACGTTTGTATATATGTGCAATCTTTTCAAAAAGTGAATGCTAAGCCCCACAACTGTGTCACTTCATATGTAAGGCAAACTCATATTCTTAAACCTAATCTTTCTAAAG
>TTN-206,,0,156,1319057,1319212,GTATATTGGATTTTATTTTATTCTCAAGACTGTCTTTTTTTAATCTTAAATTGATACATTCTTCAGATTTTTTAAACATTAACCAGAAAATAAGTGTGCCTGTGTTTAGTGTTTTCCATATCGTATGTTTGATGGTATTGCCTGGTATCTTTTAAG
>TTN-206,,0,252,1319213,1319464,GTAAACAAACCTCCCCAGCAGAAAAACTAGGAACATATGGCTTGTCTTTCTTTCTCTCTGCTGCTGTTCTTTGGGTCATACTGTTTATATGTTGGTGGGTGACAATGGTGTCTTTGGGTAGAGTATTACTTGTGATGTTTTTGTGTGTGTGCCTTGTAAATTCTTCTATTCTAAAATCACAGTACTTTCTGGCTAGTATATTTTTTACGTCCACTTTGATATAACTCCCTAATCCTAAAATTATCTTTTAAG
>TTN-206,,0,247,1319465,1319711,GTACATCCGCCCTTCCATTATGCACAATATTGTACTTGCCCTACTCTCTTTACCAAATACACTGGTTATGGGGGCTGGTTTTTGTTGTTGTTGTTGTTGTTGATGTTGTTGTTGTTGTTACAGTTGTTGTTTTATGTTTGAAATAATGAAAATGTCAAGTGTTTATGTTTGGGCTACTACTTTATGGCTGCCTTTTTGTGGTTTGAAAGAGGGAAACAATACTTTAAAGTGAAATCTCTCTTTAAAG
>TTN-206,,0,707,1319712,1320418,GTATACTGACTCTTAAAAAAAAAAAAAAAATCAAAATAAGCATCCAGACACTAAAACTAATCTAGTGGAATAGGTTCCATTAGAAAAAAAAAGACATAGTATAAAGTAAGCAATATAAGTTTGTTAATGCATATCACTTCAAAACTAAACATTTTTGATAACAGAAAGTACTTTTTTCTTAAAAAAAAGTGAGGCTTCTTCTAAACGTATGTGAATAATTTTCCTTAATCTGTATTTGTCTTCTAATGTCTTTTCCATATACTAAACTCATCTGCCTAGATGCTTGCTTTATGTGGCAATCTCTGATGAAATTTTTAATTTTTTCAATTCTGAATTTTCTACATTGTACCAATAGAGCTAAGGAAAATGTCTTAGAAGTGAGGTGAAGAAACTATTCATGTAACATAGGTTTCTGTCTAATGCTTCTACTTAGTTTGATAGTCATTATTTATGCTGTTTAGTTGTCTTTTTAAACTTTTATAAATACTACTTGATTTTCCTAAAATTATTCAATGTCTTTGACGTACTTCATATGTATATTAGAGTAAGTTTATTTCCAAGTCTATTGATTTTCTTGCTTTTTAAATGAAAGTTTAATCAGGCACTGTTATGGTTGTCTTTGTCCTTGAATTGTTTGAACAAAATTTCTCTTCACACACACATTTTCAGAATCTTGCAATTCACTTTTAATAATTACTCCTTTAAAG
>TTN-206,,0,307,1320419,1320725,GTATATTGAACTTTGATTAAGTAATGTGAGGCATGAAACTATCTGGCTCTTTGCCTTCTAGTTCCCAATCTGACTCCTATACTTTATTAGCTTATTGTTGATTAAGGGCAGGGTATATAACATTTGAAATCACAATTGCTAAATATACTCTATGATACCTTGACTGGCCAAAAAAGAACAGTCAGGGTCTCCCATAATCAGTGCATGAAACAAACGCAAAAGAATAAAATCAAAGCACATTGTTACTATCAGTCATCCTTAAAAGTGCTTTAAAGTAAAGTGCTGCCTGTTGTTAATATTGTTTCAG
>TTN-206,,0,958,1320726,1321683,GTATGAGCAAAACTGCAAACTCAAAACCACACTAAATATGTGCACACTCAAACAAGATAAAACAAGATAAATCATAACAAGATAAAAATTTGGATACCCAAAGAAATTTGGAAAGAACTTTGTTTCATTTCGCAAATGCGGAATTTTCTTCTTTGATAACTTCTAGAAAAAATTTTAAAAACCCTCTATAAATCTTAAGGTTATTGTTAGACTTTTGTTCCGGGAATAATCTAATACCCCCCTCATTTTTGCTCGTATGCAAAATAGCAAATGTCCCTAAGTTTCTTTTTCAAAAAGGTTACAAGTTTATCTTCAAGTGCCCGTGATCATTCTAGTACATGGTTAAAAATTTCTGAACATCCTTTATTCTAAAACTTGCTATTACGGAGTATGATAGGCTATTGAGAAAATGTATTTACCCACAGGGTTCCCATTATCAAAACTTGACAATGACTGCTTCAAAAGTTAAGATAGAGATGTAAGCTAACACAAGCTGTTGTGTTTTACCTAATGAAGGTCAAATTTGTTGGCATATAGTTTGGGCTTCAAATTGTTTATTTTACTCAAAGAATAAATCTCTATTGAAATTTTGAAATGAATCAATCTTATTTCACTTATTCAGTCTCTGATGTTTCATAGCCCAACTTTGAGAACATTCTACATAGTCTTACTGATAGCTTTAAAAAAACCATATTATAGGGGAGTTTCAGCCAGGAATTTATCTACCTGAAATGAAATGAGAATTTTAATATGTAAGAATTACCTAATTAAAGAAAATAGCAAGAAGGAAAGGGCAATATGAGCTTGTTCTGCTTGGATCTCTGATTCTTGCCTACTTCAATAGGCTATGGCTATACTGTAGATAAAAGATATTATTTCAATTATTTGATTCCTTTTAAGAAATGTTTAAACTTATATTCTAAGTCTAACATGAAATACCTTGTATGTACTTTTAAAG
>TTN-206,,0,210,1321684,1321893,GTAGAGTGAAAAAAACATTATTACCTGTAAGAGATCTTTGTTTCCTCCATGTCTGTCCTACTATAAAAATATATGTAAAAGTGGCAGTGTACAAATTATGTGTGTGTTTGGGAATATTATGTTGTATTTGTCTTTCTTAACTTTTTGTTCTTGCTAGCCTTGAGAAACCTGTTTCAATTTTTAAAATCTCTTAATATTGATATTTTGAAG
>TTN-206,,0,204,1321894,1322097,GTACATTACTGAGTAATAATCACCAAAAACAACTTTGTTATGTATGTTCTAAAATCATGTCTTCCTAGCCCGTCTGATGGTCTGTGTTTTTGCTGAGTAGGATGTTCTTGTCCTGATTCTTACATTTCAGTTTTTTATGTGTATTTATTACATAGTATTCAAGGAGTTGGTTTTAATGCTCTTTAATAATTAATATCTTTAAAG
>TTN-206,,0,747,1322098,1322844,GTATAATGATTTCCTTCCTCGATTGTGATCTTTTCTGATGCCTCTTTTGAAATTAATGTAACTATGATTCATTTCATTTTGTTGTTTCATGTCTTTTAAATTAGTTGTCAGCAGAATGTTGGATGTAAAAATGTGTAAATACAGGATAAGAAGATAATGCCTTTAAAAGGAAAAATTATTTCTAAATACATCCATAGCCTGTTAGCCAGTGGCTGTGTCCTGCCACATGGCTACAATACATATAAAATAGAATGTTTGGGTTTAAAATCAGTGACCGTTTGGCATATTCCTGATTTACCTAAATGATGTAATGATACCATAATATTCACCAAGCTTTGGTAACTGTTTATTCATTCTAAATTCATTTTGAAGATTTTTTTTAAAGCTAACCAGTTTCCAGTCATTTTCCCCCTGATTCATACTAAGTATGAAGTATACTAATTGAGAAGTAAATTTCACTTTTCAGGAAGGATATTTCTTTCAAGCAGAGATATTTGAACACTAAACCTCATTTCACATTTGGGCTCTGCTACTTCATGTTTACTTGGGTACTTCTGTGTACTTGTATTTATATGAAGCTCAGAATCCTTTCCACAGAGAGTATATAGTTTCTTAAAGATGAACAATCGCATATGTATCTCATTAAAGGAAGATACATTATTCTATCTGCTTAAAGTACAGCAAAACAAGCATTGGCTGGGTGGCCTTTTACTGACAATAAAATTTCCTTATACTTCATATTTCAAG
>TTN-206,,0,198,1322845,1323042,GTACCTAATGGCACTCATTTTAATGTTTTGTTCGTCTTTTGCTGTTGAATTCCTCTTCAGTTCTGTGTGTGAAAACTTCTTTTGTGGGAAAAGTAAATCTTGTCCTTTCTTCTGTTATAAATGGGCCTGTGTTTCTAAGGTGTCTTAATTTTGTTGAGTCATTGGCAAATGTCCAACTTAAAGATAATATCTTTAAAG
>TTN-206,,0,211,1323043,1323253,GTAGATGATGCCTCCTGCAAAGGGCTGTGCAACAGCATCTTTGGAGTTTGGGGGTCTGATTTGGTCAGATTCTGGGGGTTATTGGCAGCACCAATGATTGCTTACTTTAAAGCAGATATTTTTAGATGCTGAAATATGATTTCTACAGGTGCTTTTCACATTTTATTTCTTTCCTGCAAAATTTCCAACATTCTTAATAATATCTTTAAAG
>TTN-206,,0,182,1323254,1323435,GTACACCACCATTCATTGACGGGTATCTAAGAGACTTCATCTGCCTAGAAATAGTTAACTTTCTTCTGAGTTCAAAACCTTGTGTGTGTGTCACTGTCCGTTGTTAAAAAACATTAGCTGTGTTTTATATGGATGTGTTGTTACTAGTAGTTAGAACTTAACAATAAACAATATCTTTAAAG
>TTN-206,,0,508,1323436,1323943,GTACATCCTTATAATCCATCAGTGGAATAGCATGATAATTCACCCATGCAGCATAACTTGGTGAGCCATAGCAGATCTTTCCCCATGACAATATTAACAACATTAATGCCATGACAAGCGCCTCTCAACTGGCCACAGGAGCAGTTTACCCGGTATTCATCTCTGAATTTTACCATCAAATTATGCTTATGCTCAATGGTTGGCTCCTCCTCTTTAGTGGAAAGTTCTTCAAGTAAAATACATTCCTTTTGCATATCAAAATGGACAAAACCATCATTTACCAGGCATTGTGTCTTGTCTTTATCACCAGTCCACGTTTTTTTCGGTGTTTTTTATTTTAATTTTTGTGTATTTTCTGGCCTTTGTTTTGTGGCTATTATAATTTTCAGTCTTAAAGTGAAATTGATAGAATATCTATGCTGCTTCAGTTAAGGCCTTACATTGCCAGCCTTAAAATCTTAGCTATGGGTAAAAAATGTGACACTAACTCTATTTGATATCTTTGAAG
>TTN-206,,0,249,1323944,1324192,GTACATGAACTTGCAATGTTGCAATATTTTTATTTCACATTTGCATATGGGTAAAAATTAATTGGTTTAATTCTGTACTCTTTGGGATGCAACTCTTTAGAGAAAATTAAATATTTTATTTTAAAAATAAAATGCTTCTTGGAATACCTTTGTCATACTTTTATTACCTTATCTTAATCTTTTGAAACTATGCTTGGAATCAGTATTTTTATGTCGTATAAAATTTTTCTCTAAATCATTTCGTTAAAG
>TTN-206,,0,205,1324193,1324397,GTACATAATTTCATCACTTAGAGTACTTGGGGGAAAAAACTCACATCTATGTATACTCACATACAAATTTCCCCATTACATTGTACATTTTTAAAGTGTCTATCTGGTTAGAAATATGTCAGATATTTTGTGATTCTTTTTCATATCTATTGCTCTAAGACATTTTAAAAGAACATATTCCTAAATATAAATAATATCTTTAAAG
>TTN-206,,0,207,1324398,1324604,GTACATTAATCTGTAACAGAGCCATGGTAAAAGACAAAACTAACTGGTGTTATACAGCCTTACTAATTATAATTAATGCTTAGTATTTATGTTGATAATAATTGATGCTTTGTGATCACAGAATATTTGCCTTTCATAAGCTTCTTCATTGTTGTGAATATTTTACATAAAAGTGATGTTTGTACCCTTGAATAAATATCTTTAAAG
>TTN-206,,0,333,1324605,1324937,GTATAGCAGCTCTTCTTGGAATCATCAAGGCCTCTTTTGTGTTGAATTCTGCTTTCCCATCCTTTTGTTCATCTCCAGTTTTATCTATAATCCTTTACCCTCTGTGATTGACCACCTAAATCTTAGAAAACATTCCAGACATGTGTGTTCTTATTGTGTATCTGCCTTGTGTATCTGTCTATTGTAAATTATCTAAATGTCTTTTCAAATCACATATTATGTTTACATGTTTGTGGTCTTATCCTCACGTGTCTCTTTCATATATATATATATATATATATATATGACCATGTATATGTGGTTTTTAATGCCTTCAAATGAAATGTTTTTAAG
>TTN-206,,0,1205,1324938,1326142,GTACACCTCCCCAAAGTGAATACACATTGTTCACCCATAGCTTGGTCACATAAATTATGATGAAACTGGGTTTTAGGAAAATTATATTTACAAAATGGATAATCACACAGTTACATATTTACTTCTAACGATGTTCAGGAACACTGATATCTACTTTTTTCACTGATACAAAGCAGTATTCAAGAACAAAGATGAAAGGAAGCATTGTCCCAGAACTGATACAAAAGTTCTGATTTCATATCATTTGATTAAACATCATAGTTTTCATGGAGATATATTTAAATATATATGAATAAGTATACTATATATTTAAATGTATTGAAAACTATTATGAATAAATATTCTTAAATTTCTTCCTTCAACCATTTATATTAAATGCCTTTTTAACACCAGGCTAAAAAGAAAAAAAGATGAATGTATTTATCAAAACACAGAATAATAGTTATGTCTTCTAATACATATATATAAAGGGCAGCCCAACAGGTTTTGATTTTAGCGTTGACTTTACACCTTGTTGTATTACTCTCAGCGAGTCCTTTAACCAACCTGAGCCTGAAGTTATTTTCCTGTAAATTGGGGATGCTAATATCAGTCTTAATGGGCTCAGCTATTATGGTGAGAATTAAATAAAGTAAGGTATTAAAGTAGTCTATCATTGAATGAATAGTATCCAGATTTAACATATTCAATCAGCTCATAGTACAGGACAGAATTAATATATTTGTGCTTTAAAGCTCAATAATATTTTCTACAAAAGATGCTGGCATGGCTGCTTAAAATCAGCATAACCCTCGCATCAGGCCATATAGTTATATAATCAAATGAAATAGTAAAGCTGATCTTTTATTGGATATCAACGATTCAGAAATACTTTCTAGACAATAAATTACTAGTGAAATTTAAATGTATGAAATGATATTAGGTTGGTGCAAAAGTAATTGCGGTTTTTAGCATTAAAAGTAATGTCAAAACCGCAATTATTTTTGCACCACCCTAATAGCATCTGTCCTCTGATAATGACATATGCTGCTGGTCCCTTGCTTTACAAATCCCAATTACATTATAATATCTGGGCTCCCAACTAACATGACAGACCTGTCTTGAGCGACTGTTAACACATTGGTCTTTCTGGGTGTGGGGTCTTCTTGGTTTCTCTTTTTTTGTCCTTCAAAATAAATCCTTATCATGAAATGATGTCTTTAAAG
>TTN-206,,0,166,1326143,1326308,GTATTGCTATTCCGAAGTAAATTAGACTATGCCATTTCCTTCCTTCTCCTATAAAAGTCAAAATGTCCTGTTTCCGTATTTGTTAATACAACTTATATTACTGCTGTGTCTACTTGTCTTTGTGTGTGTGAAACTGAACTTATAAAATAAAATAATATTTTTAAAG
>TTN-206,,0,557,1326309,1326865,GTACATCATCCCATAACAGGGATATGTTTGCTGCACCGATGTTGAACTGTGGTTCTATCCACACAGGACACTCAACATAAATGTGTGCATTGTATGGTCTGTCATTCACATTCGTCATTTCTGACTCTTTTGCACCCAAGTTTGTGTTGTGTCCATTTTTTCACTTGGTGTTGGTGTGCTTTACATCGTTTCTCTATGTATGTTGTTTCTAAAAAATAAAAATATATCTTTAAAGAGCCAAAAATAACTAAGGAACTAGTCCCTGAAATACCCATTTCTTCATACCCATTTCTTCCTACAAAAAAAAAAAAGACAAAAGAAAAAAGAAATAGAGGCTCCAGCAGTAAAAAGTAGAATTTCTCTTTAATAAACCCTAAATCTTAAACCACAAACCTTTTTATTCTTTTCTCATTAACCGATTCTGTGAAATGTCAATGTTTCATCTTGTGTATGTGCCTTGTGATATTTACTCTCTTATGTTGGAAACTGGAAACGTGGTCTTTATTCTTCTTTGGTTCTTGCATTTTAAGTGTCTAAAATAATCAATGTCTCTCAAG
>TTN-206,,0,629,1326866,1327494,GTAGATAACTTTCTAAGAAAATAACATTTCAAAGTCATCCTTGTCTTATTATTGTCTAATATTTGAAGTAGGTAAATGTAAAATTTACCCCAGGAAATCAACATATTCAGATTCTAAAATAAATTATTATTAACCTAATAGAAATTGGGCAGGCAAATTAATATTATTTGAATCTCTTTGCATGTTCAGCCTGTTTGTCTGTTTGCTATTTGTTTTATTTTAATTAGAATTCATGAAGGGAAACTGTATTTGCTGTGGGAAATTTTTCATCAAATGACTTAGTAGGCAACTGTAAAATAAGCTTATCCAAGAGAAATTCCAGTTAAGCCTGAGTAACTGGTGCAGAAAATCTGATTTCTACCCCAAGTGGCTGTTTGACTTCAAACAAGTCTTTCATTAAAAAAAAAACAATAATAATTTTTTTATTATTATAAATTATCTGAAGTCCTTTCCAGTTCACAAATGCTGGGATATGCCTAACATATTTTGAAGACCCAGTAGAGATTTTTTAAGGACTAGTGAGTTTACACAAGCGTTTCGAAGGCTGAGCAGTTTTCAGATATTATCACTGTAGTCTAATATTCAAAATAATTATAAAAATAATTTACAAAATAATAATCTTTTTAAAG
>TTN-206,,0,603,1327495,1328097,GTATAACCGCTTTTAAGGATTGAACATTTAAAATTCCTGGTGTTCCAAATCTTTCTCAGTAGCTAAATCTAAGATTCACCAGTATGCTTTTCTTATATCGTATCCATGATAAAGTGAAGATTAATTATTCCTGGCACCTGAATCTATGTGTCCTTTTTTTACCCTAAATTTTTCTACAACATCTGCAATACAACTAAGAATGAGAGATTACTATTTTGTTATTGGCGATTGAATTTTTTTCTGACCAGGCCCTACTATAATAGTTTCTCCTAGATTTCAATCCTTAATTTTGTTTTTAATATTAATATGGGGGGAATCTATTTCTCTGGTGAAAGTGTTCATTTTTTAAGAAAAATCTTTAATTTACTATTCCTGAAGAGTGTGATAATATTTTGCATAATTGGTATTACATTTGCTTATAGGATTTCTAAGTAATATCCTTTACACCTCTAGGGTTCCTACTCCACATTTATTATTACCATTTAGGTTGCTAATATCTTTTAAAAATAAGTCAATGTTTTGTGATATTTATTTATTGGTATATGGGTGGTGTTCTGCTCATCACATGCCACTTTTCAAAATGTTCATAAAATTTCTTTTAAG
>TTN-206,,0,929,1328098,1329026,GTATATCAAATCCTCATTATTAATATCTTTAACTTCCCATTAATTTTCTTTCTTAAAAGCAACATTTTCTTTTTTGACTGCCTTCTTATAATCATTTAGATAGTGAACTGATTAAGGACCAGTAAAAATATAACTCATTCCATTTCTTTAATCTTTTCTAGGATGTTAACGAATAATTGTGTGCATGTGTTTACGTATGAATTATTCTAGAAGCTTCTTAACTGAGAATTTTAATATATTAGTATGTCTCTATATACTTATACACATAGCAATGGATCCCTCTTCCCCACATTTTAGATTTTATTCCATAAGTGGAACGGAGTTTTCTTCTGTGTTATAATAATTATTTTACTATATTTATTATTTTATGGAACAAACCTAATGCTTGGATAATAACTATTTTAAAGAGCCTCACGTCCCTTTTGTAATGTTTAGCCCAAGCATTCAAGGTTATTACAAAATGTCTACTTTTCCCTGCTTCCTAATTCACTTAATGCTTCAGACAGTGCTCTTAAGCAGTTAGATTATGCTGTCCCTGTCATAGTAGACTCCTCAGCTAATAGAAGAGTGCACAGCAGAAAGTGAGGCCAGTGTCAGGGCTTAAATACTCTACAATGGTAATCACTTCAAAAAAGTCTTCATCAAGTTAAAAATAGTAAAAGTGAGTCCATATTGGTAATCCCTGTTATTAAAAGAAAAAAAAAAGAATGGCACAGGTACTTTGTGGACATTTCTTCTTCTATAGGAATGTTAGAACAAATGAGTGATTTGAGAAAGTATCTTTATTGCCTCTAAAATGGATGTCCCACAGTACAGAGTGACTTCTGAAAAACTTTAATTATTGTAATGTTGGCGTTGTCTCTGGTGTTTTTATTTCATGTGTGTTATTGAACATTCTCAGCTAACTAAAACACCTAATATCTTTAAAG
>TTN-206,,0,153,1329027,1329179,GTACATCTTCTCTTTTAAACCTGACTTCCTCTTCTGTCTTTTTTCGTTAAGACTTTTATGTTTCATGTCTCTGTGTCTTGATTGTTTTTGATGATTTTTGTCTATGAAAGCTTGCTCTCGACAGTCCTAAATATTAAAACTGTATCTTTAAAG
>TTN-206,,0,139,1329180,1329318,GTATTTTTGGAAAGATCCTGGATTTTCGTGTATTGTTGCATGCAATCCTTTATTCAGTTTTAAAAATATATATTTTGAATGTACATCTTTATTTCTTCAGTGTTTAAAAAAATAAGTCTTAAAATAGATGCTCTTTCAG
>TTN-206,,0,800,1329319,1330118,GTATAGGGAATTCTTCAAATACTACAAATTCTTATATCTTGCTCTAACTTTCCTTTGAAAGTAAATTTTGTGTTCAGTTTGGAAGATTAGAAACCCCATGAAATACTTTAAACATGAGTTTAAACTAGTTGACACAAAGATTAATATCTCTTAACCACACGGAGTATAATTTTAGTAGATGATAGTAATATTTGATATCTACTTATCTAAGGAGGTCACTGTATGAATTTGGGGATTATTTTTTAAATCTGACTAAGAATGTTACACAATTGTTACAGGTACCAAAATAACTGACCAGTGTCATTGGTTAAGTGAAAAAGAAACTCCTCAGTTCACTGAGGAATTTACATGTTCAGGCAAAATAATCACTGCTTTAACATTTTAGTCAACTGTTCACAAACTGAGAAATACTTACCAAAAGCTTTTGCCAGTTTATGATACTTTCATTAGAGAAACAACATTAAGGAAGTGAAGTATTGTTAATGGCACCTGTATTCTAGCATACTGTGAAGACAAGCCATAGCACAAATAAGTTATCTGCAATACCACTCTAGATCTTGCACAAATTAACAATATATGTGTAATATGAAGGAATGTGTGTGTGTGTGTGTTTAGCATATATAGCAAATTACAATATACATGATATTTAGCAAATCAAATCTCTTTTGGAAATAAGTGTGTTATAAATTAAAAAAATATAGATAAAGAATTTTGTGACCCCTCATTGTACTAACGTTAGTAGTAGTGCTCCAAAATACTTCAAGAGTTCATTCTAAACCAAAATACTAATATCTTTGAAG
>TTN-206,,0,794,1330119,1330912,GTATCTTCTTTGTGAAAAATTACTACTTAACTTTACATACAATAGCACCTTGGTTGCTTTATAAGCACAAGTTTGCATTCCACTTGATGTCTTTCTTCTGTATTTCTTGTTTCTGACATGTCTAAAACAAACTAATATCTTTAAAGCAGCTGAGGGTCCAAGGGAAGTTCTACCAAAAAAAGACAGTCACTGTTGTTATACCTAAAACAACCAAAGCAAATATCTCTAGTAACCAAATAGTGAGCCCAAATTTCCTCCTTTGGTGCTATTTGGTTATATATTCACTAACATGCTTACTGATAAACACATGTTTTTCTATTTATTATTAATTATATTAACCTGGCAAATATAAATACATAGTGAATATGTGTTTAATGTTCTTGCTTTGTTCATTTTTGCAAATCTCTTAAATTTCACAATAGAAATAAAAACAGTATCTAATAAATAATATAAACTTATTTCTTTAAAGTCTCTGAAGCATGTGCGTAAGTTATCACTGAAGAGAAGGTAGCAACTCTTCCACAAAAACAAACAGTAATAGCACCAGCTGAAGGTGTACTGTTAATTTTTCTTCTCAAGTTCTTACCATTCTAACATGGGAAATTTCCCTGGATTTTTGTTATTATATATTTTTTAAATTCAATGCATTTGAAATACTGTAATGTATTTGATAAAGTGTTGTCTGCATTTTATATTGTTGCTGTGTTCTGTTCTGTGTTTATATCTCTCATGCTCTGCTTGTTAAAAAATTGTATATTTAAAAATAAAAGAAATTATTACTATTATCTTTAAAG
>TTN-206,,0,542,1330913,1331454,GTAACTGGCTTTTCTCATTCATCATTAATATAAAATCCTTTTTTATTCACTTACTATGTAAGAGAGACCTTTCTCTTCTCAATGCCACAAGATGGCTATGAATGACATAAACTTCAATTTATGTTCTATAACATAATCCTGCCTTTTGAGGCAATGTTTTAGGCGTAAAGACATAAGCCCAAAGTTATCATTTGTATTGATCCTCTTATTTAATAACTAAATAATATTGATCCCTCAACTTCTCTTTCAAAAATAATTCATTTTGGAAGCTCTTCTGAAGTAGCTCTGGAAAAAAAAAAGTGTGCTCTAAATGGCAATAGAAAATGATACTATCTCCAAAGAGCAAAGTGTTTCTGATATAATGAATCAAGAACTCATCGACAAAGCAATTCAGAGAAATGCAATGACTACATTTGACTTATAGTTGACTTATAATTGAGGGGTTTTTGGCGTTCATCTTGTTAGATGCCCCTTCTAGGCTTGCTATGTTTACACCCAACTATAATGTTCTGAAAAAATAAGATAAATAAATATCTTTAAAG
>TTN-206,,0,144,1331455,1331598,GTATACAGTGATGCTAATCAGAACATGAAATAATTCTTGGTTTAGTTTTTCATGGTTTAAAGTGAATGTGTGTGACATTAAATCCTTGTATTTCGTATCTTATATTTGTTATCTGTAACAATTAATATACTAATATCTTTAAAG
>TTN-206,,0,1651,1331599,1333249,GTGAGTGTAGAAAAATTAGTGGTTCTTTTTCGTTTCATTTATGTCCTTAAATTCACTATGTTTGTCTTTTTAGCTTTGAAAAGTAAATATACTAAACTCTTATAAAAGCCTAACATGCCACAAATATATGACTCAAATAATCTTAGTGTCTATTATCCTCAGACAAGTTATATTTCCTCACCAATTTAAAAAAGAAATACTCTACTTATCAGAGTGTATGATTTCAGAAAAGTCAGTTGTCTTGTTAAATTTTCCTAACCTATTCTGTATACAAGTGTCTTTTGCTTTGAAGCAATTTATTTTCTCAGATCATGAAGTAACTTAACTCCATAATATTTTAATTGGATTTTATAAAATCAAAATGTTTCACCATTATTTTTTTTTTTACTCTTGATAACCATAATTGGAAACATTTTGGCAAAACTGCTCAAAGGACCCTAGGTTTACAAGGCCACTCAAACCTCAAAAGAATTCTCACGACCTTTTTTTTTGGGGGGGGGTTTCATACAAAATTAGGTTTAAATAATTTGAATTATGAAATAATCCAAATAGTAAAATATTGTGAATAGAATACTGTTCAACAACCTGAATAGTAAAAGTGACAGTAGTCAAAATATTCTTCCTTTTTTTTTTTTTTTTGAGATGGAATCTCACTCTGCTGCACCCAGGCTGCAGTGCAGTGGCACGATCTTGGCTCACTGCAACCTCCGTCTCCTGGGTTCAAGCTATTCTCCTGCCCCAGCCTCCCGAGTGGCTGGGATTACAGGTGCCTACCACCAGGCCCGGCTAATTTTGTGTATTTTTAGTAGAGACAGGGTTTTACCATGTTGGTCAGGCTGGTCTCAAACTCCTGACCTCAGGTGACCCGCCCACCTCAGCCTCCCAAAGTGCTGGGATTACAGGCATGAGCCACTACACCAGACCCGCTTCCATTTTTTTTAATCTAAAAAATTTCCTGTTGAAACTCAACTTTCTTGTTGTTCATCCTGTTATACTAAGTTGGGATAAAATAATATAATCACTTCCTCCTTTGAATATCCTTTCTATTCTTGACTTTAGTTATTGTTTTCAGACAGTTTTTCTTTCTAAAGGCTGGAGAAATTTTTGTTGTCTTTATTTGCCTTATTTTCTAAGTATTTAATTTTTTTAATTTTCTGCCTCCAAACCCTAAATGGCTTTTACATTCATATTAAACTGTGAAACCATATATTAGATGTGATTTGAAAATATAGATAATGAGGCTTCTAGAAAGGGAAAAGACTTACATGAATTTCTAGTAGGTCAAATATCGGAGAATTCTCAATGTGCAATTCAGCATCTTCCCTGTTCTTTATAGACAAATCCATTAAAAATAAGACCAATAGGACAATTTTACCAATAACTTTCTTAAGGCAAAATGAAGAATTATATAGTCCTTGCCTGAACAATTCCTCCATTTTATTATCATCATCATAGAGAAATGCTTAGAGTCTTACATCATGAAACTGGGAGTGAGGCTATCCCCAGCCAATGCATTCTAGCCACTAATTTGCCTCTATGTGCTACTATTAATTTTGGTGATGAATGTGGTATTATATATTATATTTTTCTTAATACACTTCTTTATCCACCTTGAAACATCCTAATTATTTAAATACTAATATCTTTAAAG
>TTN-206,,0,112,1333250,1333361,GTATATAACACCAATGATCCACTCTGAAGAAAAATTATTTTTTGGCCCCTTTTAAAAAGCTCAATATTTTTCTTCACCATTTATAAATATAACTATACTCATATCTTTTAAG
>TTN-206,,0,122,1333362,1333483,GTATATTTCAAATACATCAAACCCAGATGAGTATCTTTAGCTTTATGACTCAAACATTGCATGCTTTTTATAATTTACTGTTTTTACAACTTTTAAATGTAAACCTACTAATATCTTTAAAG
>TTN-206,,0,334,1333484,1333817,GTATAATTCTCTAGTTAGGAAAATCTAAAGAAGAAAATATACTGTCTTCAGTCTGCAAAATATTTAATGTTTAATATACATTCTCACAACCTCTAATGTTAAAATACTGTGTTTAAAGGATCTGATATACCCACAACAAAGAATGACCTATGACTTGCCCCCAAGAAAGTCAAGTCCCACACATATAATATACAAAGATAAAATATTAGAACAAAAATAACATTTCTAACATAAAGATATCTGAAATGATATTAACATATCTAACTTTCTTAGTATGTCATGTCTTTATGCCTTTGCCTTTTCTCAATTAAAAAAAATACTAATATCTTTAAAG
>TTN-206,,0,1363,1333818,1335180,GTACAAGTTGGAAGAAAGTCACCTTTTTAATCTCATGTTTGCAGTTGTACTTAACACATGTAAAAATACTAATATCTTTTAAGCCAAAGTGGCTACAGTGGAAATCATTTCAGAGATGGATCCCCCAAGTAGAAGCTCAACCAAATGTATTCATGTCCCAGTGAGTCACTCAAGAGACAACAGAGGGAAAAAATACCTTTAGCTTATACACATGAAAGATAGTTGAGTCAGTGTATTTTTATGAGGACTCCAAAGAAAATATATATACACATATTATGATCAAAACATGTCTTAAAGAAAATATTAATTCAGTGTGAAGCTGATCTGTAATATCTCTACAAGATTAGAGCACCTGAGACCCTCCCAGAATATCCTCCAACCTAGGGAAAAATAATTCCAGTTAAAGCTGGAAATCTCCCCTCCATGTTCATTTGCTCCTCTCATAGCCTATCTTTTATTTTTCAAGCATCATTTTTTTTCATTTTGAATATCTTTAGATAAGTCAAAACATGAAAAAGCTTTAAAACCTCCAGAACAATAATTTCATCATAACACCCATGGTATTCTGTAATTTGAAGAATATCTGAATATTTTGATATTTTTTCTCAGTCTGGAATCTTTTGGTTGTTCTCCTCTCTCCTAAACTTGAAAAACACTCACCTTTTTAAGGTGCCTGAGGTGTGAATACAAAAAAATGCCGACCTAGATTTTTCGAAGTGGCTGTAATTTGTTTTTCTCAACATAATAGCTAGAGGTATAGCATTAATTATAATCAATGTTTCCACTTTCCATGATCTAGTTTTCTATGCATCTACCATTCCAAGAAATAAAATTACTAATACTGATAGTGCCTGAGGTGACCAAGAAAACAGCCGCTTATAACCAAATACTCACACTGCTACAAAAGATCCGATTCTGGGGGCGGGGAGTGGGAGAAGGTTCCCATCTGGAATGTTCTGTATGTGCAGTTAAGATGGGAACTCTTTACTCCTCTTCATAACTCCAAAGTACAATGCATTCATATCTTTAAAGTGCCTGAATCACCTCGAGAAATTGTCCCTGTAAAGGAAACACCCATGGCTGCTCCCCTTGAAATTGAAATACCTCCCACTAAAGGTATCGTTCATCCTGCCATTCCTTCCTTCATTTATTAGAGTGCTTAGCATGTACAGGGTGCTAGGGAACTGGAGAATAATAAACAAAGACAATTAATATGTGGTTCCTCTCCTCAAGATTGTATACCTCCTCAGATTCTTTAAAGGAATCATCTTTTTAGCCATAAATATCACTTTGGTTCAGCTCATTTAATTAATGTCTCCACTGATCCTTTTAACCTCTAACCATAATACTAATATCTTCAAAG
>TTN-206,,0,450,1335181,1335630,GTACGTTACCTCTGAACAAATGTGGAAGAAGAAATTATCTGTCCTCTGCTCTTAAAACTATGGTTTCTTCCTAATACTCTTCATAAATTCTAAATATAAACATACTAATATCTTTTAAGTGTCTGAGGTTCCACAGGAAGTTTCCTCTAAAAAGAAATTATTTATGGCTGTTTCTGCCAAAACAGAAAACACTCCTGCTGGAAGTATTCATTCAACAAATCCTTTATAATGAGAGTGTAGAGTGTCGCGAGAGCTCTGTGAGGTTCTGGAGGAGGGGGAGCACCTCCTCTCAAGGATCCACTAACCCCTTAAAAGACTTAGCCTATTGGTGGAACAAAGGGAGGATGGAGGAAAGAGAAGAAAATGTGGTTATATTTCCTAACTTATTGTGGTTACTGTTTTCCATTAATCATTTTAACTCTTAAATGTGAATTGCTAATATCTTTCAAG
>TTN-206,,0,114,1335631,1335744,GTACAAGTCACCATGCTCTCAGGGTCAAGAACTAGCTCTTGTAGTTTTGAGAATATTTTTGCTATTCCTAGTTATCTGCATAACACTAAACATAAAACTACTAATTTCTTAAAG
>TTN-206,,0,116,1335745,1335860,GTATATCTTGCTGGAAGCTTAGAGGGGTGGGAACATGTCTTTTCTTGTATAAATGTTTTTCCTGATTGTGTTGATTCTTGTAACTTCTAAATGTAAAATTATTAATATCTTCAAAG
>TTN-206,,0,361,1335861,1336221,GTACATTCTTAACTGTCTTTTTATGGTGGGATAGTGGGTGGGGCGATAGAAAGGACCACCTTTCTAGTTTTGAAAATTATTTTGATGTGTACATGTGAATCATGTCTGTGTTGACTCTTGCAACTCAAGTGTAAATGTATTAATATCTTCAAACTGCCTGAAGCTCCCAAAGAAATGGCTACCAAAAAGAAAATACCGGAAGTTCCTCCTCTAAAACCTGAAACACCACCTATTATGGGAACTTGTTACCACTGATCTCAGCTCAGGAGAAAAAAATAGCTCTTTTGTTCTTGAAAATGTCTTTGTATCTATCTAGTAATCTCTGTATTTTCTGAGTGTAAAAATACTAATATCTTTCAAG
>TTN-206,,0,112,1336222,1336333,GTATTTGTCACTGACTTTAGGCTTCAGAAGACCTAATTCTTCTGCTCTTGACAATATTTTTTTCTAGCGGTCTTCATAACACCTAAATGTAATTTCACTAATATCTTTCAAG
>TTN-206,,0,108,1336334,1336441,GTAGTTGCCACTGACCTTAGGCTTCAGATCTCATTCTTTTGCTCTTGAAGATATTTTTTCCAGTGGTCTTCATAACTTCTGAATGTAATTTTGCTAATATCTTTTAAG
>TTN-206,,0,110,1336442,1336551,GTATTTGTCACTGATTTTAGGCTTCAGATGATGTATCTCTTCTGCTCTGGAAAATATTTTTCTAGTGGTCTTCATAATGCCTAAATGTAATTTCACTAATATCTTTCAAG
>TTN-206,,0,83,1336552,1336634,GTAGACACCCTCTTGTTGCTGTGTTTGATATTGTTTGTTTGTCTTTACTTTGTCTAATAATGAAAATACTAATATCTTTAAAG
>TTN-206,,0,210,1336635,1336844,GTAATGCCAAAGCTATACAAACTATAGGAGAAAAATAACTGTTATTTTAACTAGGAAATTACATGTTAAAAATCCTACTACATAAAGATGATATAATTCTAAAGAAAACAAATGTCAATCGCTATCCAAAATATCTTGGTGGGTGTTTATATGCAAAAGGCATCCATCATTTTCACCTTTTCTAAACACAAATTACAAATATCTTTGAAG
>TTN-206,,0,153,1336845,1336997,GTAGGTATCATTACACATTGTCAGTCGGGGGGCCCTGGGGAAAGACTGCATAGAAGTGTCCGCCGATCTCACAAGTTGTATTTGCTTGGGTAAATGTGGAGTCGATATTCCCCCTTTATAGCTTCTAACTAAAAGATACTAATATCTTCAAAG
>TTN-206,,0,112,1336998,1337109,GTATTTATTCCCTCTCCTCTGCTAAGAAAAACTTATCGTCTGTACCCCTCACAATCACTGTAATATATACCTTCACCATTCATAAATTATAAAAATACTAATATCTTTCAAG
>TTN-206,,0,114,1337110,1337223,GTACATGTCAGCTCAACCTTATCCTGCAGAAGAAATCTCTCTTCCATTCCTGAAAACAATTTTAGTCCATTCCTCTTCATTAACCTAAGTATAAAACTACTAATATCTTTCAAG
>TTN-206,,0,115,1337224,1337338,GTACACTTTAGCCCTGACTTCATTCTGCAGAAGAGATATCTCCTCTCCTACTGTAAACAATTTTAGCCCATTTCTCTTCATTAACTTAAGTCTAAAACTACTAATATCTTTCAAG
>TTN-206,,0,113,1337339,1337451,GTATTTTTTACCCCTGTCCTTTTTCTGCAGAAGAAATATCTCTTCTGATCTTAGAAATATTTTACTCCATTTGTCTCATTAACCTAAGTGAAAAACTACTAATATCTTTCAAG
>TTN-206,,0,105,1337452,1337556,GTACTTGTCATTTGACCTTAAGCTTCAGAAGATCCAATTCCTCTGCTGTATATTTTGCTAGTAGTCTCCATAGCTCCACATGTAACTTTACTAATATCTTTTAAG
>TTN-206,,0,2503,1337557,1340059,GTATTTGTCACTGATTTTAGGCTTCAGATGATCTATCTCTTGTGCTCTGGAAAATATTTTTCTTTTTATATATATATATATTTTTATTATACTTTAAGTTCTAGGGTACATGTGCACAACGTGCAGGTTGTTACGTATGTATACATGTGCCATGTTGGTGTGCTGCACCCACTAACTCGTCATTTACATTAGGTATGTCTCCTAATGCTATCCCTCCCCCATCCCCCCACCTCACAACACACTCCGGTGTGTGGTGTCCCCCTTCCTGTATCCATGTGTTCTCATTGTTCAATTCCCACCTATGAATGAGAACATGCAATGTTTGGTTTTTTATCCTTGTGATAGTTTGCCAAGAATGATGGTTTCCAGTTTCATCCATGTCCCTACAAAGGACATGAACTCATCATTTTTTATGGCTGCATAGTATTCCATGGAGTATATGTGGAACATTTTCTTAATCCAGTCTATCATTGATGGACATTTGGGTTGGTTCCAAGTCTTTGCTAATATGAATAGTGCCGCAATAAACATACGTGTGCACGTGTCTTTATAGCAGCATGATTTATAATCCTTTGGGTATATACCCAGTAATGGGATGGCTGGGTCAAATGGTATTTCTAGTTCTAGATCCCTGAGGAATCGCCACACTGACTTCCACAATGGTTGAACTAGTTTACAGTCCCAGCAACATTGTAAAAGTGTTCCTATTGCTCCACATCCTCTCCAGCGCCTGTCGTTTCCTGACTTTTTAATGATCACCATTCTAACTGGTGTGAGATGGTATCTCATTGTGGTTTTGATTTGCATTTCTCTGATGGCCAGTGATGATGAGCATTTTTTCTTGTGTATTTTGGCTGCATAAATGTCTTTTTTTGAGAAGTGTCTGTTTGTATCCTTCGCCCACTTGTTGATGGGGTTGTTTTTTTCTTACACGTTTGTTTGAGTTCATTGTAGATTCTGGATATTAGCCCTTCGTCAGATGAGTAGATTGCAAAAATTTTCTCCCATTCTGTGGGTTGCCTGTTCATTCTGATGGTAGTTTCCTTTGCTGTGCAGAAGCTCTTTAGTTTAATTCGATCCTATCTGTCAATTTTGGCTTTTGTTACCATTGCTTTTGGTATTTTAGACATGAAGTCCTTGCCCATGCCTATGTCCTGAATGGTATTGCCTAGGTTTTCTTCTAGGGTTTTTATGGTTTTAGGTCTAACATTTAAGTCTTTACTCCATCTTGAATTAATTTTTGTGTAAGGTGTAAGGAAGGGATCCAATTTCAGCTTTCTACATATGGCTAGCCAGTTTTCCCAGCACCATTTGCTAAATAGGGAACCCTTTCCCCATTTCTTGTTTTTGTCAGGTTTGTCAAAGATCAGATGGTTGCAGATGTGTGGTATTATTCTGAGGGCTCTGTTCTGTTCCATTGGTCTATATCTCTGTTTTGGTACCAGTACCATGCTGTTTTGGTTACTGTAGCCTTGTAATACAGTAGCGTGACGCCTCCAGCTTTGTTCTTTTGGCTTAGGATTGACTTGGCAATGTGGGCTCTTTTTTGGTTCCATATGAACTTTAAAGTAGTTTTTTCCAATTCTGTGAAGAGAGTCATTGATAGCTTGACGGAGATGGCATTGAATCTATAAATTACCTTGGGCAGTATGGCCATTTTCACGGTATTAGTTCTTCCTATCCATGAGCATGGAATGTTCTTCCATTTGTGTCCTCTTTTATTTCGTTGAGCAGTGGTTTGTAGTTCTCCTTGAAGAGGTCCTTCACATCCCTTGTAAGTTGGATTCCTAGGTATTTTATTCTCTTTGAAGCAACTGTGAATGGGAGGTCACTCACGATTTGGCTCTCTGTTTGTCTGTTATTGGTGCATAAGAATGCTTGTGATCTTTGCACATTGATTTTGTATCCTGAGACTTTGCTGAAGTTGCTTATCAGCTTAAGGAGATTTTGGGCTGAGACGATGGGGTTTTCTAGATATACAATCATGCCATCTGCAAACAGGGACAATTTGACTTCCTCTTTTCCTTATTGAATACCCTTTATTTCTTTCTCCTGCCTGATTGCCCTGGCCAGAACTTCCAACACTATGTTGAATAGGAGTGGTGAGAGAGGGCATCCCTGTCTTGTGCCAGTTTTCAAAGGGAATGCTTCCAGTTTTTGCCCATTCAGTATGATACTGGCTGTGGGTTTGTCATAAATAGCTCTTATTATTTTGAGATACGTCCCATCAATACCTAATTTATTGAGAGTCTTTAGCATGAAGGGCTGTTGAATTTTGTCAAAGGCCCTTTCTGCATCTATTGAGATAATCATGTGGTTTTTGTCGTTGGTTCTGTTTATATGATGGATTACGTTTATTGATTTTTGTATGTTGAATCAGCCTTCCATCCCAGGGATGAAGCCCACTTGATCATGGTGGATAAGCTTTTTGATGTGCTGCTGGAAAATATTTTTCTAGTGGTCTTCATAATGCCTAAATGTAATTTCACTAATATCTTTCAAG
>TTN-206,,0,83,1340060,1340142,GTAGACACCCTCTTGTTGCTGTGTTTGATATTGTTTGTTTGTCTTTACTTTGTCTAATAATGAAAATACTAATATCTTTAAAG
>TTN-206,,0,210,1340143,1340352,GTAATGCCAAAGCTATACAAACTATAGGAGAAAAATAACTGTTATTTTAACTAGGAAATTACATGTTAAAAATCCTACTACATAAAGATGATATAATTCTAAAGAAAACAAATGTCAATCACTATCCAAAATATCTTGGTGGGTGTTTATATGCAAAAGGCATCCATCGTTTTCACCTTTTCTAAACACAAATTACAAATATCTTTGAAG
>TTN-206,,0,153,1340353,1340505,GTAGGTATCATTACACATTGTCAGTCGGGGGGCCCTGGGGAAAGACTGTATAGAAGTGTCCGCCGATCTCACAAGTTGTATTTGCTTGGGTAAATGTGGAGTCGATATTCCCCCTTTATAGCTTCTAACTAAAAGATACTAATATCTTCAAAG
>TTN-206,,0,112,1340506,1340617,GTATTTATTCCCTCTCCTCTGCTAAGAAAAACTTATCGTCTGTACCCCTCACAATCACTGTAATATATACCTTCACCATTCATAAATTATAAAAATACTAATATCTTTCAAG
>TTN-206,,0,114,1340618,1340731,GTACATGTCAGCTCAACCTTATCCTGCAGAAGAAATCTCTCTTCCATTCCTGAAAACAATTTTAGTCCATTCCTCTTCATTAACCTAAGTATAAAACTACTAATATCTTTCAAG
>TTN-206,,0,115,1340732,1340846,GTACACTTTAGCCCTGACTTCATTCTGCAGAAGAGATATCTCCTCTCCTACTGTAAACAATTTTAGCCCATTTCTCTTCATTAACTTAAGTCTAAAACTACTAATATCTTTCAAG
>TTN-206,,0,113,1340847,1340959,GTATTTTTTACCCCTGTCCTTTTTCTGCAGAAGAAATATCTCTTCTGATCTTAGAAATATTTTACTCCATTTGTCTCATTAACCTAAGTGAAAAACTACTAATATCTTTCAAG
>TTN-206,,0,105,1340960,1341064,GTACTTGTCATTTGACCTTAAGCTTCAGAAGATCCAATTCCTCTGCTGTATATTTTGCTAGTAGTCTCCATAGCTCCACATGTAACTTTACTAATATCTTTTAAG
>TTN-206,,0,2502,1341065,1343566,GTATTTGTCACTGATTTTAGGCTTCAGATGATCTATCTCTTGTGCTCTGGAAAATATTTTTCTTTTTATATATATATATATTTTTATTATACTTTAAGTTCTAGGGTACATGTGCACAACGTGCAGGTTGTTACGTATGTATACATGTGCCATGTTGGTGTGCTGCACCCACTAACTCGTCATTTACATTAGGTATGTCTCCTAATGCTATCCCTCCCCCATCCCCCCACCTCACAACACACTCCGGTGTGTGGTGTCCCCCTTCCTGTATCCATGTGTTCTCATTGTTCAATTCCCACCTATGAATGAGAACATGCAATGTTTGGTTTTTTATCCTTGTGATAGTTTGCCAAGAATGATGGTTTCCAGTTTCATCCATGTCCCTACAAAGGACATGAACTCATCATTTTTTATGGCTGCATAGTATTCCATGGAGTATATGTGGAACATTTTCTTAATCCAGTCTATCATTGATGGACATTTGGGTTGGTTCCAAGTCTTTGCTAATATGAATAGTGCCGCAATAAACATACGTGTGCACGTGTCTTTATAGCAGCATGATTTATAATCCTTTGGGTATATACCCAGTAATGGGATGGCTGGGTCAAATGGTATTTCTAGTTCTAGATCCCTGAGGAATCGCCACACTGACTTCCACAATGGTTGAACTAGTTTACAGTCCCAGCAACATTGTAAAAGTGTTCCTATTGCTCCACATCCTCTCCAGCGCCTGTCGTTTCCTGACTTTTTAATGATCACCATTCTAACTGGTGTGAGATGGTATCTCATTGTGGTTTTGATTTGCATTTCTCTGATGGCCAGTGATGATGAGCATTTTTTCTTGTGTATTTTGGCTGCATAAATGTCTTTTTTTGAGAAGTGTCTGTTTGTATCCTTCGCCCACTTGTTGATGGGGTTGTTTTTTTCTTACACGTTTGTTTGAGTTCATTGTAGATTCTGGATATTAGCCCTTCGTCAGATGAGTAGATTGCAAAAATTTTCTCCCATTCTGTGGGTTGCCTGTTCATTCTGATGGTAGTACCTTTGCTGTGCAGAAGCTCTTTAGTTTAATTCGATCCTATCTGTCAATTTTGGCTTTTGTTACCATTGCTTTTGGTATTTTAGACATGAAGTCCTTGCCCATGCCTATGTCCTGAATGGTATTGCCTAGGTTTTCTTCTAGGGTTTTTATGGTTTTAGGTCTAACATTTAAGTCTTTACTCCATCTTGAATTAATTTTTGTGTAAGGTGTAAGGAAGGGATCCAATTTCAGCTTTCTACATATGGCTAGCCAGTTTTCCCAGCACCATTTGCTAAATAGGGAACCCTTTCCCCATTTCTTGTTTTTGTCAGGTTTGTCAAAGATCAGATGGTTGCAGATGTGTGGTATTATTCTGAGGGCTCTGTTCTGTTCCATTGGTCTATATCTCTGTTTTGGTACCAGTACCATGCTGTTTTGGTTACTGTAGCCTTGTAATACAGTAGCGTGACGCCTCCAGCTTTGTTCTTTTGGCTTAGGATTGACTTGGCAATGTGGGCTCTTTTTTGGTTCCATATGAACTTTAAAGTAGTTTTTTCCAATTCTGTGAAGAGAGTCATTGATAGCTTGACGGAGATGGCATTGAATCTATAAATTACCTTGGGCAGTATGGCCATTTTCACGGTATTAGTTCTTCCTATCCATGAGCATGGAATGTTCTTCCATTTGTGTCCTCTTTTATTTCGTTGAGCAGTGGTTTGTAGTTCTCCTTGAAGAGGTCCTTCACATCCCTTGTAAGTTGGATTCCTAGGTATTTTATTCTCTTTGAAGCAACTGTGAATGGGAGGTCACTCACGATTTGGCTCTCTGTTTGTCTGTTATTGGTGCATAAGAATGCTTGTGATCTTTGCACATTGATTTTGTATCCTGAGACTTTGCTGAAGTTGCTTATCAGCTTAAGGAGATTTTGGGCTGAGACGATGGGGTTTTCTAGATATACAATCATGCCATCTGCAAACAGGGACAATTTGACTTCCTCTTTTCCTTATTGAATACCCTTTATTTCTTTCTCCTGCCTGATTGCCCTGGCCAGAACTTCCAACACTATGTTGAATAGGAGTGGTGAGAGAGGGCATCCCTGTCTTGTGCCAGTTTTCAAAGGGAATGCTTCCAGTTTTTGCCCATTCAGTATGATACTGGCTGTGGGTTTGTCATAAATAGCTCTTATTATTTTGAGATATGTCCCATCAATACCTAATTTATTGAGAGTCTTTAGCATGAAGGGCTGTTGAATTTTGTCAAAGGCCCTTTCTGCATCTATTGAGATAATCACGTGGTTTTTGTCGTTGGTTCTGTTTATATGATGGATTACGTTTATTGATTTTTGTATGTTGAATCAGCCTTCCATCCCAGGGATGAAGCCCACTTGATCATGGTGGATAAGCTTTTTGATGTGCTGCTGGAAAATATTTTTCTAGTGGTCTTCATAATGCCTAAATGTAATTTCACTAATATCTTTCAAG
>TTN-206,,0,83,1343567,1343649,GTAGACACCCTCTTGTTGCTGTGTTTGATATTGTTTGTTTGTCTTTACTTTGTCTAATAATGAAAATACTAATATCTTTAAAG
>TTN-206,,0,210,1343650,1343859,GTAATGCCAAAGCTATACAAACTATAGGAGAAAAATAACTGTTATTTTAACTAGGAAATTACATGTTAAAAATCCTACTACATAAAGATGATATAATTCTAAAGAAAACAAATGTCAATCACTATCCAAAATATCTTGGTGGGTGTTTATATGCAAAAGGCATCCATCATTTTCACCTTTTCTAAACACAAATTACAAATATCTTTGAAG
>TTN-206,,0,153,1343860,1344012,GTAGGTATCATTACACATTGTCAGTCGGGGGGCCCTGGGGAAAGACTGTATAGAAGTGTCCGCCGATCTCACAAGTTGTATTTGCTTGGGTAAATGTGGAGTCGATATTCCCCCTTTATAGCTTCTAACTAAAAGATACTAATATCTTCAAAG
>TTN-206,,0,112,1344013,1344124,GTATTTATTCCCTCTCCTCTGCTAAGAATAACTTACTGTCTGTACCCCTCACAATCACTGTAATATATACCTTCGCCATTCATAAATTATAAAAATACTAATATCTTTCAAG
>TTN-206,,0,114,1344125,1344238,GTACATGTCAGCTCAACCTTATCCTGCAGAAGAAATCTCTCTTCCATTCCTGAAAACAATTTTAGTCCATTCCTCTTCATTAACCTAAGTATAAAACTACTAATATCTTTCAAG
>TTN-206,,0,115,1344239,1344353,GTACACTTTAGCCCTGACTTCATTCTGCAGAAGAGATATCTCCTCTCCTACTGTAAACAATTTTAGCCCATTTCTCTTCATTAACTTAAGTCTAAAACTACTAATATCTTTCAAG
>TTN-206,,0,113,1344354,1344466,GTATTTTTTACCCCTGTCCTTTTTCTGCAGAAGAAATATCTCTTCTGATCTTAGAAATATTTTACTCCATTTGTCTCATTAACCTAAGTGAAAAACTACTAATATCTTTCAAG
>TTN-206,,0,105,1344467,1344571,GTACTTGTCATTTGACCTTAAGCTTCAGAAGATCCAATTCCTCTGCTGTATATTTTGCTAGTAGTCTCCATAGCTCTACATGTAACTTTACTAATATCTTTTAAG
>TTN-206,,0,113,1344572,1344684,GTATTTGTCACTGACCTTAGGCTTCAGATGATCTAATTCTTTTGCAGTTGAAGACATTTTGTTCCAGTGGTCTTCATAACCCCTAAATGTAATTTTACCTAATATCTTTTAAG
>TTN-206,,0,109,1344685,1344793,GTATTTGTCACTGGCTTTAGGCTTCAGAAGACTGAACTCTTCATTTCTTGAAAATACTTTTCTAGTGGTCTTCAAACTTCTAAATGTAATTTCACTAATATCTTTTAAG
>TTN-206,,0,111,1344794,1344904,GTATTTGTCACTGGCTTTAGGCTTCAGAAGATCAAACTCCTCTATTCTTGAAAATATTTTTTCTAGTGGTCTTCATAACCCCTAAATGTAATTTCACTAATATCTTTTAAG
>TTN-206,,0,111,1344905,1345015,GTATTTGTCATTGAGTTTAAGCGTCAGAAGATCTATCTCTTCTACTCTTGAAAATATTTTTCCTAATGGTCTTCATAACTTCTAAATGTAATTTCACTAATATCTTTTAAG
>TTN-206,,0,110,1345016,1345125,GTATTTGTCACTGATTTTAGGCTTCAGATGATCAAACTCTTCTGCTCTGGAAAGTATTTTTCTAGTGGTCTTCATAATGCCTAAATGTAATTTCACTATTATCTTTCAAG
>TTN-206,,0,84,1345126,1345209,GTAGACACCCTCATGGTGCTGTGTTTGATATTGTTTGTTTGTCTTTACTTTGTCTAACAATGAAAATAATAATATCTTTTAAAG
>TTN-206,,0,128,1345210,1345337,GTAATAATGAAACTATTCAAATTAGTGTTTTTTAAAAAAATCTTTCCTTAGTGTTGTAAAAACATTTTTTTGCAAACTATCTCAGTTTTAGTCAATTCTGGCATTAAAATGAGCTCATGTCTTTAAAG
>TTN-206,,0,134,1345338,1345471,GTACATGGCAAGAAAGCTGCTAGGACACCTCGGCCACTCTTTCCCCTTCCTGCCCTGATAATTCTGGGTGCTCTGAGCTTTTGTCTTGTTTCTCAATCTTCGTTCTTTCTAAAACATACCTTCTAATTCTTTAG
>TTN-206,,0,129,1345472,1345600,GTATTCCTCACTGCCACTAACTCCCTAACAAAAAACTTTCTTTGAAGTGTCATATTCTACTGTTCTGCTTCATGATTTTCACATTTCATTGAAACCATGAGCTTAAACAACTACTAATATCTTTTATAG
>TTN-206,,0,132,1345601,1345732,GTATATGTGGCTGTCCACTGTTTGATGGGGGCGGATGGAGCCCCCAGCTTCTAAAAGGGTTTTGTTCTGTGTAAATGTGATGAATGTTTACTGGTGATTGTTTCTAATGTTAAAATACTAATATATTTGAAG
>TTN-206,,0,408,1345733,1346140,GTACATGTCACTAATGAGATTCTGCAGAAAAGCACTCACCCTTGTCTAATAAGTCACCTATTATCAAACCTTTTGTTTGCGAGTCCTCTTAAATTTGCAACTACAAAACTGTCATTCTGGATTTTTAGGGTCTGAATACTTTTTAATAATTTTTTCATTGACTTTAAAAAGTGATATATTTACTTATTACAAGCATTGGAAAAGTTTACTAACTTGGTTCTTTTATTCTTAATAGGCCATATTTTCCTCCCCACTATATGAGGGTCCAAAGACAGATCACTGACCTTATTGTGAAATTTGTTCTTGGATCTGTCCCTGGGTTATTTGAGCAAAATGTGAAGTCGATGTGGTATAAATTTAATATACTTCTCAACTACTCATAAGAAAAATGAATTAATATCTTTAAAG
>TTN-206,,0,479,1346141,1346619,GTACACGTGAGACCGGTGATTAATGACCTTGCCACTTGCGACTATTTCTAATTTAAGCTTTGTTCTTCTTCCTTCCTAACTCATTATTTCTTGGTCATTTTCTAACCTTTAATTATTTGTCTTAATTCATCATTCTAAATTAGCTCCAATCTCAAATCTATTTTGGGTTATTGGTCCACAGTATCTACATAAGTCATAGTAAGCTATATTAAACAAAGCTTCTCCAATGTACATAGAAAGTAAGGCAGGAGAACTAATGATTATAAATGACATTAAACACTAAAAGGGCTTTGCAAGCATTTGAATCAATAGACAAAGAAGTCAGTGCAAATGAGATAGATTTTATCTAAACAAAAATAAGAGAAGGTATCAATTGAAACAAAGGAAGAAATCAAGATTACTATTTATCGTGTTTAGTGTTTGTCCATCTTAGAATATTGTTCCATACATTGAAATAAAATTAACTAATATCTTTAAAG
>TTN-206,,0,269,1346620,1346888,GTACAAAGCAGAATCCACTGTATGGGAAAATACAGTCATTTCATTTTTCATGTCTATATATCTTCCTTAAGGCAAAATATCAGTCTTGTATCTTGTTGCCTGAAATCTGACTACATTAAGAACAAAAGTTATTTCTACACATAAAACTTTGGACCCACAGAATTTGGTCCCACATATACCAAGAAATATGTGTGGTTTTTAATTCATTCATTAGCATTAAATTTTTCATTGTAATCACCTAATTCTAAAAGAAATTCCTATTATTCAAG
>TTN-206,,0,185,1346889,1347073,GTACTCATGTTAAAATGAATACTTCATTTTTGTGGTGTCTACAATTTTACACTCTTCTTATTGTGTGTTGTGTTGTATTATATGTTTGTTAACTCTTACCTATATGTTACAGTGTTGAATAAACTTGTATGTATATCTTACATCTCACAACTTTGTATTATTAAATGCTACTGATATCTTTAAAG
>TTN-206,,0,222,1347074,1347295,GTATTCACTTCATCGTTGGCATCATAAAAAAGAAAGTATTCTGATATCTTAAAGTGGAATCCAATAAGTTGTCCTCATTGTTGTTGCATAACTAAGGACAAAAATTTCCTTATTTTGCTTTCATTAATTTTAATGCTGCTCCAATAAATACAGGTTTTTTATTCTTAATATTTTAAAATGTTTTTAAATACTATTTTTAAAACAAAACTAATATCTTCAAAG
>TTN-206,,0,1783,1347296,1349078,GTACCTACCATGAAGAAAAAATAGATTTCTCTAACTGCTATTTAAGCATGTTAATAATAGGTCTTAGAGAAAAACATACTGAATGTGAATTTATGTTAAAACCATATTGCACAGAAAAAAGGGAAATAATGAAGGGAAAAAAATGAAACAGACAAGCAGGAGTGAAAAAATGAGTGGGATTCAGTTGTGCTGTGATATATCACATGGCTACAACTAGTAGAAAAGAACCTTCTCTCATTCAATGTGTAAAACAGCTCAATTCAACATATTTTGTTGAATGTTGACCATTAACAAGACATCATATTAGAAAAATTAAGGCCTGATTCTGTCTTCAAATAAGTTAAATCTGGTGAGAGGATAGAAAGATAACAGGACTCTAATACAGACAGGAAGTGATTACACATAGCAAGTGAATACAAAAGGGCTGCAGAAACACACGGCAAGAAAAGATTAAGTTCAGGCAGAGGCATCATGGGAAGCTGTGTTAAACTGAATTTAAATTTTGATGGACTTTTACATGTAGAAATTGAGGAAATAAGGCCGGATGTGGTGGCTCACGCCTGTCATCCCAACACTTGGGGAGGCCAAGGTGGGTGGATCACTTGAGGTCAGGAGTTCAAGACCAGCCTGGCCAACATGGTGAAACCCCGTCTCTACTAAAAATACAAAAATTAGCTGGGGGTGGTGATATGTGCCTGTAATCCCAGCTACTTGGGAGGCTGAGGCAGGAGAATTGCTTGAACCCAGGAGGCAGAGGTTGCAGTGAGCTGAGATAATGCCACTGCACTCCAGCTTGGGTGACAGAGTGAGCCTCTGTCTCAAAAAAATTAAAAAAAAGAAATTGAGGACATGATATCCCATGGAAAGGGAAGAGCATATTGAAAGGCACAGAGATAGAAGGGTCTAGAATGTTCAAGGATTGTCAAGTAAACTTATGTCAAGTAAACTCAATTTGAGTATGGATTGGCTGTGGAATGTCTTGAAAGATAATACCAGATATAAAGATGGGGTCATATTTTGGAGTACTTCAAATGCCAGTAAAAGGCTTGTACTTTTTTCTGTAGGCAATAGGAAGCTTCAAAGATTTTGAAGCAGGCTTACATATTAATAGGATTTGGGCTTTAGAAAGATAACTGGCAGCAATTTCAGCTACTAAATAGTAAAGACCCATTGCAATTATTTAAGGTCTTTAAGAGTTGGACAAGATCCGTGGCGGCAGAAATGGAAAGGGGGACTGGGTTTGAAAGAGATGGAGACTTAGTGGCCTCTGACCATTATCAAAACCATTAGGGAAATTGAGGAGCCCAAGATCATTGTAAGGTTTAAAGCTAGATGGCCAAAAGAATGGTTCATTGGGTCTCTGAACTAACGTTAGAGGAAAATGGTAGATGTGCTTTTCACCTTTAAAGCATAAAAGTTGGGAGTGTGTATCAGGAGCTTAAGAAAGAGATCAGGCCTAGAGATGTAGATCTTAAAGTCATTCACATGTAAATAAGAATTGAGTGTGCAGGAACAATTACTCAGAAAATGTAGAGCAAATTTTTTTAAGTGTCAAAGTTAGACCACCTTCATTTAAGTGTACACAGAGGACTAGAAGCAAATGAAGAAAGCTGAGAAGATTCATATATAAAATTAGGATGTCCAAAATGGTGCCATGTCTCAGAAGCCATTTTCCCCATGAAATCTAAGATGAAGCTCTTGCCCCTGCATTCTTTGCCTGCTCTTTAGACAATCTTGCATGTCTTCTAAATTCTTAATAGTAAACAAAATCATATCTTTAAAG
>TTN-206,,0,236,1349079,1349314,GTACACGGCTTCTCCATAAATCTTGGAAAGATGACAATTGTCTTCATCCTCTTGCTTTGATTGTAGATGAATCTTACGTATTTGTCTGTCTGTATTGAAGTTATTGATATTTGGGGGGTCATCTGAATAATCTGTTATAGAGTGTTACTTAATGTAACTAGGTTGATATGTTAGAATAGTAGTTGCAGTATTCTGTTCTAAATATAGTCTAAAATAAAATACTATGTTTTTTAAAG
>TTN-206,,0,504,1349315,1349818,GTATATATATATATATATATATACATTTTTTTAATCTCCTGAAGATTCCTGTTAGAATTACAAAAGCATTTACAGGACAATATTCCTTCTTGAAATTATATACAAGAGCAGTCTAGCATGTTTGACTGCTTTATTTTTGAAATAGTTACACTTCTTTTAAGTTAGAATCTTTAATTTAGTTACTGTTGTTGGTAATTACAATTTCCAAAAGGTACAGTTTACTGAAGCAAAATGGAATAATTGCCTTGGATCCTCAAATGATAACACGGTATCAAATTTTAAAAGTCATCTCATTTGCCATCAATATACATTGAATAATCTAATTAATAGGCAGTTCAAGTAAAAGAACTTTTTCTTATACGTGAATTTTTCTATACATGAATTTGTATGAATTGTATATTTTTATTTTGTGACTGTAATCTTTGCATCAATGTGAAATTTGTATGAGTCTTTTTGAAGAACTTTACATTGCAACCTCATCTCCTTTGTCAACATTCTTTAAAG
>TTN-206,,0,454,1349819,1350272,GTATTCAATCCAGTGGACTTAAATCTTCTTTATCATATTCTTTCTCTTGAAATGTATATGGTTTATGTTGTTGTACATATGTAGTATGTCTGTTCCCATTTGTATGTAAAGTATTCTTTGTTGTAAATGTGAGCCTCATTCTTAGGTTTCCATGTAACTTGTACTGTTTCTCTCATGTCAACTGTGGCTTGTCTGGATGCTTTGTTTGTTGTTGTTATTGGTGCCTTTGCTGTATTTCTCATCATCTTTGTAAAGGGTTGATATTTTTATGTTTTATGTTCTGTGTTTTATGTTGGATACTGGTATTACGTACCTTAAAAAGTAAACTTTGTACTTCATATATATATATATATATATATATATATATATATATATATATAATTTCTATTAAATATACTACATATCCACATGCTAACATATACATATACTAACACCTCTGAAATACTCTTTCAAG
>TTN-206,,0,1303,1350273,1351575,GTAAAAAATGCCACTTCCAAAGTTTTATTAGCCTGCTTCAAACTTCTATCCAGCCATCTGAAATGATGCTTGCAAGAAATGTATGACTTTTAGAAGTGTGTACTTTCAGACATGATTGTACTGTGAGATTGCATAGAGCTGTCTCTTCTGCTGCCCCATGGTTCCTGGGTTGCTTGTCATGCCATGCCTGCTGCTGCAAAAGTCAGAAAGTACATTGATAGCGTCATCCGGGATATCTGAATGCAGGCACTGTCCAATTAACTTTCTTTTGTGGAGTGGGGAGAAAGAGTTTTCTGATTTCAAAGCCTGATTGCTATACATATCATTGCGATCTTATGCTTAAGGAATGTATAAGAAATCCTTGCAAGATATTTTTAATATTGCAGTAACACATTTACATAAAAGCCAAAACTTTGTTCTTAAAGAATTGCATGTGCTTTTAAATATATTACAAGTAATATAGTTATGATTTCCAGTAGCTGATATGTGCCTATATATCATGAAAGGAAAGCATATGAATGACTTGTTACAGTTCCCCCATCTCTTTTTTTTTCTTGCAACTTAAAGAAGTGTTCTGTGTGGTTCTCAGGGGAGCTGGAAAGAGTGGTTATGAAGACATTTGGTATCCAGCATTTATTATTAAACTTCCCTTCCCCCTTCTTATATTTTGATTTTTCTATGAATTGACACAATGTTACTTAATTTTAAAAATATCAGTTTCTTTAAAAGCTGAAATAAACTGGCAGAAACATATTATTCTTATTTTAATAAAAAGTTGTCTTGTGACGTCATATGATTCCCCAATCTAAAATTATCTAGATATAATCTTAGATATGCACTTTCCCTATACAGACCTATGTATCTTCAAACCACAGTCTTCCAGCATAAGACATTGCTGCTGGTGATTCTTGCCCTCTACAACCCTCATAGCCATTAGGGGGACCTTCTGGCACCTCTTGAAAGGCCACCCATCTGTTAATTGACACTCCATGAAGACACACACATAAATACATTTCCCTTAATGTAAAATATATGCTTAAAGGAAAATTTCTTCCTCCTGCCAATAACAAAAATTGTCTTCTTTTTCTGCTGGTCTTTAATTAACTACTGAACTTTGGAGTAAAACTGCAGTCTGTTTTCATGGTTCGAATGCTGCTTGTATGTTCTTTGAAGGCTGTTCTTGGCTGTTATTAATGCTTTCTGGTTATAAGCAAAGCTTGGTTTTGATTCTTGGAGTAGAAAGTTAATCACTTGCTTCAGATTAAATATACAAATAACAAAAGTAAAATCATATTCTTTAAAG
>TTN-206,,0,2230,1351576,1353805,GTATTTCACAGGCTGAAAAATACATACTTATGTAGTACCCCTTTACCTGACTCCTTGCTCTTTCTGCCTCCATCGAATGTTCTGTCTCTCTTTTTCAATGATCAGAGAGTAGTCCCATTCATTTCTTATATTTCTGTGGCTTTTATGGTCCTGGCTCATGAGTGTTGCTTCCTTTGTCTCCCATCCATTTCATACATGTATAGACATGGTCTATCTTTGTCTCATCTACATATGTCTTCTTGCATTTTCCTAAACTTAAAAATAACAAATTTTACTGGTTAGCCAAAATTGATATCAAGAGACATATGAGATTAAAATGCTGAGAGCTAGTAGTAAACTGTTTTGACATTTCACCTGACATAAAAATTTTAGCCAATGTAATAAGCACTAAAAATAAGTCCTATCTTCCTTTTATATTATTAAGGTTATTTGTAGGGATTTCCTTAGGACTTTCATGTCACTCTCTTCTCACTGGCTCTAAGTCATTCTCTGAGGGGTACGGAACTCACATTTCAGAAAAATTTCCTTATTACTGTAGGTAATTTTTCAAAATGTATTTTTCTGTAAACAATATTTTCCCTAATAAGGTCTCATCTAAAATTAGACCCTAAAGAAAACTAAATGAATTATAAGAGTCTAGAAAACATCTATCAAAAATAAACATAATTTTTCTAATGGGTAGTAGTGTTCTGTTCAAGTAATCAACACATTCAGACCTAGAAATTAAGACTGTTTCTGGTCACTCTGAAATTTTGGGGAAAAAAGTCACCCATATAAATATACATTTCCTGATTTCATAAAGAGGCAATTACAAAATAATGTTATCATGGATATTGATCATAAACATTAAAATAGCATATAATCACATATAATGACTTTAAAAATAATAGCTACAATGTTGGGTTCTCAAACATCAATAAGATTTTTAAAATCAAATAATAATATAAAAAATGCACAGATATATTTTCACTATGTTCATTATATCAGTAAAGAAAATCTATATTATGCCTCCTCACTTTACATTAATTAGATGCATGTGCTTCCTTCTGGGTTTGAGCAATAAAAATAGTTATTAAGAAGATTGGTACCTCTAAAATAGTATTGAAGGCCAACACAATTTATCCTGGATAAAATACGTAATGTTTAACTTTAAAATTTTTACTTAAAATATTTGACATTAAAAAAATGATTATTCAAAACGAAATACATATTTGCCTATTGTAGGTTTAAATTTTTGAAATAAGAGTTAAGCAGTTATCTTTATCACATAAAAAACCATTTAATGAATTGCAAATATCTTGTTTAAAGCCCTAAATAGGAAGTTTTATAGAAATATCTAAAAATTCAGATTCCTAATAGCAAATAGTTACACAATACAAATAAATACTGTTTTAAATTAGATTTTAATTGACATTAGTAGAGAGGAAAATGGTTTAATAATCACCACGTGTTCCTTTCTTTCACCATTCAAATCTATGAGGGCCATAATAGCAAAAGAGGCTGCTCTATAAAATAGCATCATCCACCATGCTCAGTATTCACTGTAGACGCAACAGGAAATTTTGAATTCCTTGCGTTCCTTAATTTGAATGAATTTAAGAACATTTTCTTATTCATGAAAAACGAGCTTCCAACACCAGCTTTGAAATTTTATAATTCTATAATTTTAAATATTTTATCCAGCATTATTTCAAAAAGGAAATCTTAAGAAAGGCTACTCTTCTTCTGTTCAGAAAGTGAGATATGGCCCTTCCCCAGCATCAAAGTCACAAACCGGAACTCTTGGCCACCTTCTTCCCTCAGTGGAGAAGACTGAATGATGGCACTAACACTTGCCAGTATCATTTTCATACATTTAGTGGTTGGGTAGATAACATCGTAGATTTGGACAATCTACAATTGCAGTTTGGGACAAAGATGCTGTCAAGAACCCTGTAATTTGATGAAAGATTCATAAAGTCAGTATGGAGCAACATCCTCTACATGCATTTAAAATGAATACATTTGCCTGCAGTTAATGGAGTTGAATTTCATCACAAGGCTGTATAGATATTTGCAGAGGAGATAACTTGAAATGTATCATTTAAACTTAAATTCTGTGGTATTTATATGCAGCGAAAATTGTTACTTAATGCACTACAGTTAACTAGTTTTAGGAGAGACATTTTTCTTGTTGAAATTCCGTTTTTATATAAATTCACTTCAAAATTTGAAATCATATTCTTTTAAG
>TTN-206,,0,921,1353806,1354726,GTATAGTATTTTTCAACCATTCTGTCAGCGTTAAGTATATTTTAAAAATGAACTTGAAAGCTTACAAAATGTTTCTGTCCTTTGGTTTTCTTTGAATTGGTTCGCTATTTATCAAAATTTGTTTGTAGTTTCATTGAAAATTAAGAAAAATGTCATTTCCAGATCTTTTTTTTTAAAAAAAAAAGACAGAAATTTTGTGAGCATTCACAGTATTTTGAAATTTAAAATGTTAATAGACATAACTAAGTTGATAATATTCTAAACTAACAACAACTATGACTGCCATTTTCATAACCAAATTATGTAGTAAAGTACACTAAACCTATTAAATACCTTACATGAAACTACTTTAGCTTAAATTCAATATTCAGTTTTAAAGTGTGACACAGGATCACCACAACTAATAAATAACATTTTTAAAAAACTGAACATTTCTTTCTGACTAATAAAATATTAAAGAATGAGAAACAAGATAGTCAAATGAAGAATTAAGTTCTAACATTGTCTTCACATAGAATTACTGATTTTTAGGCTACATTTCTTCAGATATCTCTGCTTAAGTAAACTTTCTACTTATTTACATACTCATTAAATCATTAACATTTAATTATTATTATAATTCGTTGCTATTCAAATTATTCATTTTGTGTTGGAGCTGTTTCTCCCACAGACTTGTCTCAGAATAGACCCTCTATCTAGATAGAAACAAAGTAACTTTGAGTGCTATTATAATTGACAACCTTTGATTTTAAAAAAAACAAAACAAAAAACACTTTCGGTGTAAATGCTTACTTTCCAGAGTGCTAGGTAGCATGCTTTTTTTCATTTTCCTTGCTTTGTACATTATTTGCATTTGTCAAGCTTATTCAACATCTTCATTAGTTTGTCTTGGTTTACATATAAACCTTTTTGTCTTTAAAG
>TTN-206,,0,610,1354727,1355336,GTAGGAATCTCAGTGACAATTTGTAAGATTATCTTTTAACAAAATGGACATTTAACAAAAGGTTTATCTTGTAAACATAAATGAAGTTAGATGTAAACATGGCTTCATATTTCATCTGTGATGTAGTCTCTGTTTTCCATTGTCTGCTTTCTGTTTAAATATTTTTATAGTAATTCCCAAATCCATTCATGTATTTCCCTGCACTTCATTCTTATCATTACTTTGCAACTTAAGTTCTTCCAGTAGAAATGACTGAAATAATCAAGTGGCTATTCATGGGAGGGTGTCAGCAAAGGTTTCATAATCTGGGGGCTTTTAAATGGGTTGGTTTTTATCATTAGCCTATTCTCAAAGGGCAAAATTATTGGGAACTATTATAGAAGTGATTTAGAAGGAGAGAGCTAAGGGGAGTGGAAGATAAGTGGATGGAATAAAAGGAAGAAAAATAAATGGAAGCAGAGTCAAGAAAATAAAATAGAAATTACTTGATAAACTATAAGGTTTTTTAAAAAACCATCCATAGAGTTTTTGAAAAATAAATTGATATTTCAGATGAGGTGCTTCCTAAATATTCAAATATTAACACTGAAAAAATAATCTTATCTTAAAG
>TTN-206,,0,430,1355337,1355766,GTACAAATCTACTGTCATTCTTAGTTGTCTCTAAAAATGCAAATATGTATCATTTAAAATATCATTACACTGACATCAAGATTTGAACACATGACCTTAATCTGTTAATCACATATGGCTTAATTTTCTTTACCATCTCACTCTCCTATGCAATTGGCTAATGATTACTCAGTTGCTAAATAAGTTACCTGAAAAAAAATTGTATTTATGGGCAATGAGATAAATAACAACATTAAAACCAAGAACATTGCCTTACTATATTTTCCAAATATTTTGTTTAAAATGAAAACTAATCAAATACTTGATTTGATAATTATATGTATATAAATTCTAATATCTTCCAAGATACGTGGGCTTAATTTTAGTTTTGACTTTGTGAAAAACTTCAAAAATCCTGTAATAATCTGCCCTCTACTCTAAATTATTTCAG
>TTN-206,,0,259,1355767,1356025,GTGAGCAAGCTTATCCTCAATGTCAACAGCATATTCTTTCTGTATTCACACACATAACATGTACTTAATAAAAGATAGTAGGTGAAAGTCAGTATGTATCAAATGATTTCTAACGTCTCAAAATGCTTAATATACTATTCTCTTAAAAACTAGTTATTTGAAGATTTCAAAATTATATCAGAAGAGGCAAATAAGCTACCAAATAAGTTTTTAGGAAGTGACAAATTGATACACTAATGCAATGGACTTCTCTCTACAG
>TTN-206,,0,2279,1356026,1358304,GTATTTATCCTGTAGCTTTCTTTTTGCTAGTTTGTTTTGGTGACTTAATAAAAGTATTCACACTTGATTAAAATTCAAGCCCTGTTTATGCTGCAACATAGGTATCATTTCAACTTCGGAGGTTTATGGTAAGTTTCTACCTTTTCTTCATGTGATATCCTTTATCCACCTTGTCTCTTGCCCAGTGGGTGAATATTGTGCCTTAACTGGAATGTACGTTCCTGGGTTGCACCATTTCTTTCATATGCTTTGGAGATTAAGTAATGAATATGTTTGGGGCTGATAAAAACTAAGGAGACAGGCAGAGACCCTGTAAGGGTATACATATAAGAATCCCATGAAGCTTCAAATTTCCCTTATACCCTATTGGAACAATTTCTCTTTTTTAAAAAAGTGTGTATATTGGGATAATGTAAAAGTTCTGGAAATGGATAGTGTTGATGGTTGTACAATATTGTGAATGTATTTCATGCAACTGAATTGAATACTTAAAAATGGCTAAAATGGTAAATTTTATGTTAGGTATATTTTACCACAATAAGAAAGAAAAAGAAAAAAGAGACTCCATATTTCAGTCTTTTAATCTGTATAAGGAATTAGATCAATAATAATTTTCTTAAATGTTCTAACTTAATGATATAGGTATCTCAAGTCCAAACTTAAAGCACCTATTAATTGTATATGAACTATTTAGTATAGTTCATCATTTAAGTGATAATTTGAGATATAATTGATCAAAACTGATTTGATGTGTAATTGATAGTCATTGATAAACATACACATCCTGACTATTTGCCCTTTGGCTCACTATCTGGGTGATGAGATCACTCATATCCCAGACCTCAGCATCATGAAATATATCCACATAACAAAACTGCACATGCATCCCATGAGTTTAAAATAAAAGTTGAAATTATTTTTTTAAAAAAGAAACAACAAAACCAAAAATAAAACAAAGTAAATTTAAAGCGGGGGCGGTGGTGGTGGGGTGGGGAGAAGGCATGTATTGATAATTTTCTAAGATGTGAAGAATCTAAGATATTCAATATAATGCCTTGACAATTTGTTCCTATGGAAAAATGATCATCTCCACTGATAAAGCACAAAATAAAAAATTCAGGGTGAATTTAAAAAAAAAAAAAGAGAACTATTTGTTACATTCCACAGTGAGATGTGCATAGGCCCCGGGAATAACATTTAGAAATGTCCATAATAGTTTGACAGAGAAATTTTTTAATTTAATTTTCTGAACCTAATAATAAAAATTGGCTTATATCTTTAATAAATCAATAAATAAAACTATTTGGAAAAATTATATTATTTTAGATTATTAATTCAATAATTAGTCATTTTATATTTGTTTATATATTTTTATATAAATTATTTAGAAATTTTTTTATTTAAAATTATCTCAAAATATTTGGACATTACCATGTTTAATGACATAAAAAAATACACTATATTCTTTTGACTGTAGTTTAATTTTTAATATTTGTGTTATATTTTGTTGCTGATGTTTATGATTTGGGCATATTCTTTTAAACTTTTATAATGTCAACGTAGTACTTTTATTATTCAGAAAAAGGTGATGAACTGCTCTTGTCTAATTAAGTATGTATAAAAATAAAGCTATTCTCAGTTATCCTGGGGGCTGAAGCTAGAGAACTCATTCCACAGTTTATACTGTCCCTGTATTAATAATGGAATCAAACTCTAAATGTCAGAACTCTCTTGCTTCTGCCTTACTTCATTGTCTAAAGGAAATCTTCAAAGAAACTCATGCATGTGTGGTACATGGACTCTTTTTCCTTAGTCTTCCCTGGATTTGTTTGTCTGCCCAATTTAGACATAAAAAGAAAGGCTTTTGGTAACCTCTCAGCCATTTCCCTTTTCCCTACACTGATTTATTGACAAAACCTTATTTCCTTGGTTCACATAATCAGGACTTACATAAACATATAAAATATTTTGCACAGCTAGGCAGGAGCAAAACTTTTCCTCACAAGGCAACAGTAAGCCTTCCAAAAATGGGAAGATAATAAGGCACTTGCTGAAAGAAGTTGTTAATCCTAAATATGTTGGCAGTTTAGCTTGAGCTCTTCAGTCTCAGAATATGCCTTCCTGGAAATGTGATTATCCATAGAAGTCATATAAATGAAACCAATTTCTCTTTATGCGTTAATATTTATAATGGAGCATGACTCACCCTCCATGGTTTACTATTAAACATGAAATAAGTCCGAAAAGTGTTTAAATGCTGAGTTTTATTTTTATTTCAG
>TTN-206,,0,569,1358305,1358873,GTGAAATTCATTTTTCTAGTACTTGCATTGTAACCTTCCACTCTGAATTTCCAAAGTTCATATTCAAGGGGAAAAAAATTTCAAAATTCATAACAATTTTTATTTTTTCTAATTGATTCTACTAAAACTAGCATGTTTTCTGATATTTCAAATAATACTTTTAGTATTATGCAAGGAGATATATATATATATATATATATATATATATATATATATATATATCCAACTATATTTTAGCATAGTGAATCCCATAAGTTCTTAGCTTCATTTTTCATATGCATGGTATTTATACATGGCAGATAAAATAATTAGACATTAATCTGGCTATTTTATACTTCAGATTAAAACTTGAGAAAAGGGACATTTATTATTCATGGATTCCTTATACCATCTCATTTTCCTGCCTGAAACAAGGCAGTATAAACTCAATTGGCCTTTCAATTGCCTGGTCTTTAGTTTTCTCGTCTTCTAATTGCTTTACGGCTGGTTTTATCCAGCAGGCAGCCAAGTATGAACTTTCTGACTCCTAAGGAGATGCCAAATCAACTTTTTATTTTACTTTGAATTAG
>TTN-206,,0,156,1358874,1359029,GTAATTTCTAGTCTTCTGAACATAATCTATATTAAACTTTAATGTAACAAACCTTAGTAGCAACTTGCATTGTAGTTTTACAAAACCTCTTATTTCCAAGTTTTATTTCATTGAAAATATTGTATTTATTGAAATATATACTGAAATTCTCCATAG
>TTN-206,,0,247,1359030,1359276,GTTAGTACTTTCCTGGGAGATTTCGTTCTGCTTATTGTTACACTAAGAAAATGGAAGAAAGGACCTCGTTTCCCAGTATTACAATATCAGAAATCTTGTACCTAAGAGGGGAATAACAATATATCCTACAGTGGATTAATTATGCCCAGTATTGTGAAATTTTTCCTATTCCTGAAATTTACTAAGGAAGCTATGTATATTACTTGTTCAGACCTTAATCATTTTTTCTGATCTTATTTTCATATAG
>TTN-206,,0,135,1359277,1359411,GTATAAAATCTTACCTTTTATTCAAATTATAAGTTTTGCGTATGTGTAAAGCCAAATAACACACCAAAACACATAAAAGCAAAGCATCGTTGGGTTGTCTAAAGCATTATGTTACTTCATCCCTGACCAATACAG
>TTN-206,,0,315,1359412,1359726,GTGAGTAATTTCACATTTTAAATTGTTAGTCATATAAAATAACCACATCCAATATTCAGGATCTATATCCTAGATTCGGGTTGCTTTAATAATAATGGAGTTAATGGAGTCTTCTAAAGTCTCCAAGAAGGAAAGAAATTTTACGTATCATTTGGGGACAACTTGAACAATTTGTGTAAAATGTTATGACAGGGAATTCTCTGCTTACTTTTATTAGTAGTAATTTTTAAAACTCTATAGAAATTTGTATCTGAAACACTTCTCCTATAGGGAATTTATCTCTTTCAAATGGTTACTAAAACTATTGTTTTTCAG
>TTN-206,,0,93,1359727,1359819,GTATGGGGCTTTTAGAATTTGGGGAGGGGTCTCAACTTTATTTCACTTCCCTGTGCATTCTGAAAAGCCTCATTCTTAATGTCTGATTTTCAG
>TTN-206,,0,282,1359820,1360101,GTAAGCGAGCTAATGAGATCTGTGACATCCCATAAAGGCATGCAAATATATGACTTTAAAGATAGGACGCCAAGTTCTAAAAGCTGTGATAATGCATCACTAATTAACTTTCACAGTGTTACCAAAACAACCCCCCTTAATTTGTTTTTAGTGGAGCTCTATTTGGAAAGATGAATAAATAAGTGCCATGTGAAATGGGTCCCTTTTACTCAGGCAGATTAGAATGGAATCTTTCTGAAGGTGAATTGTGTTTCTGAGGCATTATCTATGCTTGCATTTCAG
>TTN-206,,0,140,1360102,1360241,GTAAATGTAACCAAGTATAACCAGATAGCCAGTTTCTGAATCATGGGAGTGGGGAGTAATAAAATATTTTGCAACCTTTTACTCTTTAATAAACTTTAATTTTCACATTCTTCTAATTTTATGCTAAATGTCTTTTACAG
>TTN-206,,0,86,1360242,1360327,GTGAGTTGCTCAACAATGTAAAATTTACCCTATCTGAATCTGCAGTTTATTAGTTCAGTCATGCTAACAAAACTGTATCATTTCAG
>TTN-206,,0,142,1360328,1360469,GTAAGTCAAGATTAGCTAATTATATAGGAGAGGGGTTGCTTGGTTGTGTAGGGTGAAAAAAGGCATAAAATATCTTGATGATTTGTAGGAATAACTATATAAATGATGTTCTTTCTTTCCTTCTAACCCTCACTCCAAACAG
>TTN-206,,0,125,1360470,1360594,GTATGCTCTACTTGTCAGCCACGTTTTTGTATTTTCTCTGCAAGACTTCCTGATACACCCCTGCATTGATCAAGGGTCATCAATGGAAACGTATTCTGACTTCATCCACTGTCCACTTCTTTCAG
>TTN-206,,0,112,1360595,1360706,GTAAATAGTTTTATCAAATAGTCCACCCCAAAATCATTTTTTTTGCCTTTAGTTTTATATTTCTTCTTTAAAGTGCTTCAATTAATAAGTTCTTTCTTTTTTTTCTTGATAG
>TTN-206,,0,846,1360707,1361552,GTAAGTGCTTTTTAAATTTTAATTTTACTGCATTAAATTCAACAGAAATTTGTGGAGTATCTATTCTATAAAATAGTCTTCTAAGTGTTATATTGCATGAAAGCAGCCCAACTCCTTAAGAAGCTATCACATATGTAATCAGGCTTATTTCTAAAACACTTTACCTTCATTACTATAAGTTAATGAAGATTCTAGCTTACACCCACAAAATAGCCAATTAAAAGCCAACTTAAAATTCTTCATTAATTATTGAGCCCTGTCATGTTTAAAATAGGAGTATATAAATACTTTCTATCTCTTCATTTTATCAAAATTATTTCAGAGGAATGTTTTTCAAGTTTCCCATAAGAGAAGATATTACATAATTTACATTAATAAGCCTCATTGTTTTTCTTGGCCACCTAATATCAACAAGATTAAACATGAAGGCTAACATATATAGACATGATTAAAGGCAAACTATTAATTGATTAAGAAAAACTAACAATGTGAACCTGAAAGCTTAAAAGTAAACTAGACATAATAGAGTTGCTAAGAATTAGAAATTTACCCAAATAATGGAGGAACACAAAATTGTATTTGAAGCTAAATTTCAGTCTTTTTAGCTACTGTTAATAAAATGTTTCAAAATTCAATATGAATGGATTAGATCTTGATAAATCCCACACACTGATTCCCTTCCTAATATTTAGAGAACTTTTGAACATAAACAGGTTAAATGATTGAACACTTGACACAATTTTAAAAGATACTCAGAACTCTGTGAGTTGTGTCTTAAACTTTCCAAGAGATTGTCATTTCCCTAAGGTGATTAATAAAAGCTTTTCACTTATACTTTACTTGCAG
>TTN-206,,0,90,1361553,1361642,GTAAGGAAATTTCCATGAGTTTCACTCTTGAAGCATTGGGGTTATTTGTGCCAGAGGCTAATGACCCATGCTGGCCCTTCACTTTTCTAG
>TTN-206,,0,436,1361643,1362078,GTAAGGCTATTTCTGAACTTGTCAACACCTAAAGGAGCTGTGTGAATTAGAAAAGAACAGGTGAAAGTCAGAGTGGATGCAGGACATTTAAAACATGATAGCAGTTTCTCTATCAGACCCTAAGCCAAAGAGAGATGTCAGGGTCTATGAATGGGCTCAGACTGGCACACTTGCATTACTTTTGATCCAGCAGAGTGAGTATAAGGTTGTAGATACTCTGTGATGCTGCTAGTTGGCTCAGAATTATACAGCTAAAATAAATGTGGCTTTCCTCTTAGTACTTGTAAGCTTTACTTCCTAAAAAAAGAGCTCAAAGTTATATAAAGTTTCATCACCATTTATTTGTTGCATTCCTTTAATTAAGATAATCTATCCTTAGAACAAAATTTCAAAGAAAATTATTTTCTATGAAAGTTTTTCTGTTTTGTTGGTACAG
>TTN-206,,0,797,1362079,1362875,GTAAGTATTGTATATTTTTCAGGGAAATTAAATAAACACTTTTTCAGAAAATGAATGTGAGTGAAATTAATTGGACCTATTTTATTAGTTAGAAAATATTATTAAAACACAAAAACTGGCTCTCTTGTATTTGCCACTTTGACATTCCAATACAGAAGTGGTTCAAATCGTAAAGTTTTGGAAATTTTGTTGACCTTGCCATTTGAACAAAAGAAAATTTAGCAAATCAGATTTTCCTGCTCTGTAGTCCTCTCATTGAAAGTAGATACACATACAATGAGAATCTAACTCAGAACCCTTAAAGACCACTTCCCTCAAGTGGCTGTGCAACTAGAGCACCAGAAAGACAAGCTTTGCTGTGTGGGCATTTTAGATTCAAGAAAGAAGGTGGGAAGCATTAGGCTAACGTTTCTGGAAGGTGCAAAGTGTTTGATGGATAGGGACAGCCTCTGATTGAGGGCCCCTTGTCCTCTCCCAATCAGAGTCTTAGTTATTTTGGAAGTCACATACCTTATGTAGCAAGAAGAACTTGACGCCTGGCAGAGAGACAGATGCAGCACAGATTTCTCGCTGACCTTGTACGTCAGAACGAAAGGGCCCCTACATATACTCGCTCTCTGGCTACCAGCTCTCCCCTTCTCAGCGCCGTGGGGCCACGTTCACGTGGGAGTTAAAATAGTGGCCAGTCCTGTGGCTTCTTGAAGAAAGCAACCATGAAGATTCATATCTAAGTCTCTATTTATTCTTTTGGGATTACAAAATGAGTAACGCAAAGCTGTTTCTTCCCTCTCGAAAAG
>TTN-206,,0,3904,1362876,1366779,GTAAAAAGCAGGCATGCCTTGTCTTTCCCGTTCTTTTTCTGGAGTTCTTCCACCTTCACTTGTATGTTCCTTATTCTTTGCTCTTTCTAATGTCTCTTCCTCTGTCTTTGCCTTTCTCTTTCCGCCTTTAGCCTGATTTCTGCTGAAACTGTAAAGCCAATTTTTTGCATTTTTTCTTAGGTTTAACCTGATGATTTTTTTATTGAAATTGAAATAAATTTAAAGTATGATCATGTTTTAGTTTTTTGAAGAAAAGACAAGACTCATTGACTATGAATGATAGTTTGATTAACCAGAAGGCAGGAAGGATCAAAAAGGCTTTCTGATTGCACGCTCTGCAGCCATGGTGCACATTAAGTTTTAAGACTAACGCTCTCCATCCTATTTAGTGTTCTGCATATAAGGGGATTAAGAGGAGAAGACTGAAATTCCATTTCGGGCAGTTGATCAAGTAGTTGAGATAACTTCTGGGCAGATTTGCTCTTCAAGCATTTCTCCAAAGCTATTTTTAACCTTCAAGTGCTCTGGGCTGTGCGATATCTGGAATGCAAGTGGACTATTTAAAGTGCAACTGATGGTACTGACAAGAAAGAAGGGCTCTGTGGTTATCCACATATGTGGATGAAATATTTTTTTTAAGCTTTGGTAAATAACTAGCTCCTGCTTTTAGCTTTTACTAACATTCTTTATGCCCAAGATTTTACCCATAAGTAAAAACTAAGGGATTATTCAGATAGGCCCACAATACAATTTGCCTAAATTGATCTATATGTTTTGTCCCCAGAAACAACATATGTCTTTAAATTATCTTGACAATCCATCATTAATTTTGAATTCTTAAAATAAAATATATGGAATATGTCCAGCCTGGGTTGGAAATAAAGCACAGGACAGTACATTGTTCTGTGACATATTCCCCCAATATTTCAGAAATACTATTAAATGTGCTATAAAGATCTCAACAAAAATCAAACTTTGAAGACTTAAAGGAATATAATTAAAAAGTGATTCAGTTTAACAAAAAGCCACAGCATTGACTGAAGTATTTGAAAGCAATGCCTTCAAGTAACTGCTTTGAAACAAACAAACAAACAACAACAACAACAACAAAACTAGTATTCCACTAAAGTGATTACAGGGTAATTCACCAGCAGTCATCTGATAGGTAACGCCTGCCTGTTATACAGATAATAAGATCTTCTTGGTCTCCTTTTCCAGTGACCAGAAAAAGCAGCAGTACATTCCATTTGTAGCATGGGAATTAAGTTACATATCACAAAACCTTCCTTACAATGAGGTCTTCTAAATATTGAACTGAGGGAGGCACCTCTACCTTCAAGCTTATTGTTTGAAAAAATATATTTTGCCTATCATGCATGATTTAATTAACTTCATGTCTAAAGGCAGAGAATTGGTTGCTTTTTCAAGATTCTTTCTAGATCTGCAAATTCATGATTTATATATAGGAACACTGCTTAAAGACAAATGATATTATTTTTTCATTACCAAATATCTTTTTGTCATAGTAAGAGCTTCTTATTAAAAGATCAGTCTCAGTTCTAATACAAAAACTGCACTATTTTAATTCAAATGTAGACTCCTAAAAATCTTATTCACATTTTATTTTTAAAAAATTCTCATTGTAACTAAAATTTTTTCTAGGGTTAGAAAGGATCAGTTTACTATAATTCTATAGGGCCCCTTTACATCTCTTTTGGCATAGGAATTTTAATCCTTTACTCTAGGCACCCGAAATACCTTAGCCTTTTGTGAACTTGCTCTTGCATTACTTAAATGTCTCTTTTCAAAAAGAACTTAAATATAAACTTTGAAGTAATAAAATCATTTTGTTACATGTGGCAGATTTTGTTTAAATTAAGTCTGTCAGAACAAACTTGCTCTTGTCAATGTAATTCCGAACTTTAATACTCATTTTATGTAAAAATTTTCGCCTTCAAAACTACAATAACCAAACAAGCAAAAACAAGCTGTAGGAATAGGAAATATGAAGAGAAACTTGTAGACATGAGTTGTTTGCATTTTTTCTTTGTTGTTGTAGTTGTTTTTGGCTGTCAGTTTAAGAAAGGACTGCCAAGTTCCAAATGGCATTTGATAATTTTAAAGTTAAATTTTAAATTTGATAAAATTAAAGTTTAAATACAAAACTTTAATAGTTTTGTCATGGTCATAAGCCTACCGTATTATATTAATATGCTTCCACTATAAATAAATATTTTTAAAATCTCTAACATTATTCTTACAATCTACTGCAAAATCTTCAACATTCATTTCATTGGTTTATTTTTATAAGGCACCTACCAGTTTTCCTTTTTTTTCTTTTAACATAGTGGAGGTAGATTGTATACAAGCTGTTTATTGAGACATACTGCATTCTGAGCAGTGTCCTAGAGTAGCTACAGAGGAACTCAGATGATAAAGCAACATAATATTAATAGATAAAATATATCTGTGGGTGGGTTAGAAACTGAGACACCTTTTCAAATAGCCAAAAGTTGCATGCCAAAATTTATACTGAAATGTTATTAAAAAAACAAATTTTTCCCATTTCAGCACCATGCCCTCGGATAAGTAGCTCTGTTCCAAGGGCATATTTAACTACCCCCTCCTAGCTGTTATTTTTCCTTATTATGTTTTTTGGCCACTCTCAATTATTAAGATAATTATGTGACTAACCATGCCCAGTTCTTAATTAAAGAAAACACTTTTAGATGAAACCTTATTTCTGATTCTTTTCTTTACACTAGCATAACAAATAGTTCCACTGGTGAAAAACTTTACATTATTTTTAACGCTAAGTAAACTCTTAAGCAGTGCAAAATCAGTCTGGATGACAGGGCACAGCTTCTTAGGAATTTTATATCATAGAACTGGAAGAACCCCCAAGTCTCTTATCTTTGCTGTCAGAATGACCCCTATCTGTCGCACCATTGACATCTGATTTTCCCATTCCTGATGCTTAGACACATGAAAAAGGAAGAAGAGTCCAACTTTCATTTGCAGTTTTGAACAAAATTAATAGGTTGTACAAATTATTTAATCACAGGTTTAATTGGTTTGCAAAATAAGTTTAATTGCTAAAATAAATGGGAAGAAGAGTTATAGCTTGTTGTTGCATGGCAAACACCTTACATACAGAACATAAGGTTTACTTTTAGCTTGCCATAGCTGATATTTTCTTTCATCCTTTCATGAATTCGCTTTTCTAAGTTCTTCCTTTATATGTATATAAGCCCAGGGGCAGAATGGGGGCACACATATATATACACATATACGTATATACTATATGTGCTGTATATCTACGCATATGCAAAAAAGACCACAAATGTAAACAGAAACTGGCCTGGGCAATTTCAATGTGAAAGGCCACCTAGTAATTATATAAAGGTAACTATGAAACCCTAAAATTTTCTTGAAAGATCCCAAACTGCATAGTATTCCATGGTGTATATGTGCCACATTTTCTTAATCCGGTCTATCATTGTTGGACATTTGGGTTGGTTCCAAGTCTTTGCTATTGTGAATAATGCCACAATAAACATACGTGTGCATGTGTCTTTACAGCAGCATGATTTATAGTCCTTATACCCAATGCTAGATGATGAGTTAGTGGGTGCAGGGCACCAGCATGGCACATGTATACATATGTAACTAACCTGCACATTGTGCACATGTACCCTAAAACTTAAAGTATAATAATAATAAATAAATTTAAAAAAAAGATCCCAAACTATTGGTTGAAATGATTTTTGAATGCATACGTGCTAAATAGATGATTATAAAACAACTTGGAAAGCTCTATTTCCATTTATTTTTATCTAAATGAATTAAATGCACCCATATACTAGATTGCTGTTTCATGTATTCTTTTTTTAAAAACAACTAG
>TTN-206,,0,541,1366780,1367320,GTAATTACAAGGCTTATTTTAAAAACATGTATAAGGCAGAGGCTCATGAACAATGCCAACTCTCAATTATCTTTATATGATGAGTACTATAGATGTTTAAAATCAACCAAATAATCAAAAGTCTGATTTTACTTTTTAGCATAACAAAATAATTCACAGACTATCTTTTTAAAGAGCCAAAATTGACTAGCATAGGTTTTACTTCCTCCTTCCATCTCTATTGTTTTTATTGCACATCCTAGATTTTCAAAAGCCAGCTGGAGGAAGAATTATTATCAAGCTAGGTATCCATCACTTTATTAACCAAGAGTTGGCTGTTATTTCCTTAATGTTTCCTAGTTTTTAAAAATGATTTTCCTCTTGTCTGTACAAATAATGATAAAATATCATTTTTAGAGGAAAATGTCTGAGTGTAATCAAAACTTGAAAATAAAACTTAGGACAGAACAAAGCCCTGGAGATGGCAGGGGAAAGTTGAGAAGGTACCAAAACTCTTGGAGAAGGAAAGGAGTACCTTGGCTAATGAGTATGATTCTTTCAG
>TTN-206,,0,1697,1367321,1369017,GTAAGTATTCTTCTTACAAAGGACTTTTCATTTGCAATTCTTTAATAACTACAACAACAAAACAACACAACACTTTTTGCATGCCCTTCTTGGCCTAACTGCATTTCTTGGCAACTTCTAGTATTGACACTGACCTAACCTGATCCTTTATGTGTTTAAAGAAAAAAAGAAAAGAAAAGTCTTATTCTATGTCTGGTCTGATTAATGATGGAGCAATCACTTTTCCCTATGCTTCTTTTCTCTCACTGAGTAGTGAGTAGATGTGCTCTTTGTCTACATGGGGTCAGCCTACTGTATGGATATCCTGATATGGATGAGGAGAAACTGAATTTTAAAGATAAGTAGGGAGTCCTAATTTTAAAAACAAAGTAAAAGTGATTTCCATGTGGAAGGAAAATGAATTTTCAGGTGTGGGGAACAACTAGAAAATGAGCATGAAATTTCAGTCTGAATAGGAGCATACTAGAGATCTGCTGTAATATGACAAAGCACATTCACATGATTCAATCTCTGAGAATAAGAATGGATAAGAAGATGGAGTGAGGCCCTGGATCTTTTGAGTCCTGGACTCTTTGAATGAAGAGAACTCTAATGGTTTTTAACATTACTTCTTCCTCTGGTGAAAAATGTAATGTCTTTTTTCAAAATGCCACATACTAGCTTATTTGTTTCATTCATTCCTTTGTCCAGTGATGACATTTTTCTGCAAATTTTTTGTGCAATATTTGTTTGTTTGGTTTGGTTGCTTCCCATCTGTCAACAGCTACAACCTAGTGACTCTGTGCTTCATGCATCTTGTACCATGTTTTTCTTACCACTTTGTGGTTGCTCTGCTCAAGCTTATGTCAAAGTAGCTTCTTGGGTCTCCTTCTTCACCTTGACATCTACCTTCACTCCAAGAAGGCTCAGCTGCAAGGAGCATATTTTCAAACCTATTAGACAGCATTTGTCTCAGAATCTTATTGCTCAAGAATGGTCATCTTGGGAAGGACTCACAGGGAGCTCTGAAAGAAGGAAGGGCAAGGGGGCAGCTCCCTAATCCTATACACCAGCTGAATTAATTCTACAGATGAATGAAATAACAGATGTAAAATCCTAATCACCCTCCCATACAAAACACATTGCTTTATTGCACTAATAGATGTTATGCCTGACTTATATGTGACGTCTTCAAAGCTGATTTTTTTAAAAAGCTAAATGTATGTTTCAATTACAGCCTCATGCCTCTTAGCCATACACAAGGCTGGCCATAGTGCTTCACGTGTTCTATCTTTGAATTCTGCTAATTTCTCAAAGATTGTGCTAAGTGCCTTAAATAAGACAATGTTTCTTTGCCACTGGTGTCTGAAGTTTCCTTTGACATTATCTTTCAAGTCTGGTGCAGTGCAAATGAAGATTTTTCCTCCAGCTATTATTCAAAAGAACTGAGATGGCTCCCTAGTATATATACTGTACACACACACATGCACACTAGTTGAACATATAGAATGCCACATAATTTTATGTAAACTAAAGAGATATCTAAAAAGCAAAGCATCATACCTGATGGGCAGCTTCAAGTGATTTCAAAGTCAGTTGTAGTCTATTAAGATGGAAAATCCCTAAAAAAGAGTCACTTTTTCTTAATGTATACTATGGTAATGTCAGAGTAAATTTCCAGAAACCTCATTTTGAATTCTGATGACATTCTCTTACAG
>TTN-206,,0,661,1369018,1369678,GTCTGTGACTGTATACCTGTCATCTTGTACTGTCAAATAACTTTATATTTACTTTTGGTCTAGCCAAAATGGAAAAAAAAAAGTTAGTCACAACTTCTCTGGTCACCACTTTACTTTTAAAGATAATTGTAGTATAAAATGTATTCTTGACTTTAATTGCTCTCTTTTTAGTATTATTAATTTACTATTACTTGAAAAACACTGGACTCACAATCAGGAGATTTAGATATTAGTTTGAACCATATGAAAGTGCTGTTTTCTTAGATCAGAAAGTCAAATATCAGCAATTATATTTCTTTCAACTAAGTACCTCCTGTTGCTATTAACTACCATTGGCAAGTTTCTTCAAGTCTGAGCCTTAGTTTACACATCCAAGAAGTTAGTCTGCATAATGTCTAAGGCTCACTATAGCTCTAAACTTATATGATCCCATTGTTTTTAATAACTGATAATAGTATCACAGCAGCTAACTTAACAGTAATTGGTAAGATTGTTCTTGCTTTTGGGGTTTGTTTATATTTGTGTCTGCCACCTTGGTTCTTCTTCACACTATGAAGTCTTGTTGGTTGCTTTCAGAAAAACTCAGGATCATAGTTTTTCTTAAGGACACCTGTGTGAAGGAACAACAAGAAAACTGATAATCTATTTATCTTAAATATAG
>TTN-206,,0,98,1369679,1369776,GTAAGAGTAAAGTCATTCTTTGTGAAGTATATGTGTTGGGAAAAAATAATAATTTCCAGCTTAACTCAATGTGGTTTTTGTTTTTTCAATGCTTGCAG
>TTN-206,,0,106,1369777,1369882,GTATGAAAACTACAGTGAATAATCTTTTATTTCTAACAATTCACACTTGCTAGATTTAAAGTACAAAGACATATGTTTCTAATATCTTGTAACTTTTTCTTCCCAG
>TTN-206,,0,108,1369883,1369990,GTAAGTTTGTTCTTGCTTTTAGGGTTTTTTGTTTGTTTGTTTGTTTTGTATTTGTATTTACCACTTTGATCATTATTCATACTATAAAGTCTTGTCGGTTGCTTTCAG
>TTN-206,,0,89,1369991,1370079,GTAAGTAATTTATATACCACTAGAGATTTTTTCATCAGTTTCTGTTATAAAAATAATTAAAATCAACATATTTTTCTCCTTTACAACAG
>TTN-206,,0,104,1370080,1370183,GTAAGCAAGATCTTTTTATTCTCTATTTCTGTAGCTATATATACACTTTTGACAATTTAGTGGCCATCATTGCAAGCTAACTGATAATCCAATGTCTCCTTTAG
>TTN-206,,0,100,1370184,1370283,GTACATATTAAGTGAAAAAACAATTCTAATGTTACCAATTTTTTAAAATTGTTAATCAAAATGTAAACATATTTGTATTTATTTCACATTTTCTTTCCAG
>TTN-206,,0,767,1370284,1371050,GTCAGTCCCTTTATTTTAAAATATCCTTCCAATATCACAGAGTTTAGATTTCAGATTTCACAGTTATTTAATGAGGTAATCCTTGTGAGGGTCTTTCATTTCTAGCAAGCCCTACCCACATGTTAACAACTCTAATTTTGCTCACTACAAAGTAAGTGTCTTGAGTAAGAGGAAATTAATAGCAATAATCTTTACATGCCAGAGCCTTGGACAGTTGCTAGTACATGATGACTATTTATGAACTTAGGCTACAACTAAGCTATCACCCTGAGAGTCTTGGCAAATCTAAAGACGGTCTTATACTCTCCTACTTTACAAACCCCTGTGTGCCTTTTAGGTATGTTCTCATCCTGACCCAGGACATCCTTATACACTGTCCTTATGAAAAAGCCATTAGTGTACCTCTCATTCATAAGAAAAAAGTTTCTCTGATTTATTGAACTAAGTATGCAGTGCCTACTCTATCAAAAAACAAAACAAAACATGTTTTGCACTACACTGAGTCCTATGTTACTATTTTTGGCAAGGAATGCATGTCTTATGATTTTATGCCATTCTCAATCCTCTACTCTCCAATCTAATTTGCACGCACAACAACAACAAAAAGCTATGAGAACTCTAAGCCACTTAGTTTTCTCTGCTATAAAGTTACTGTAGCTTACTTCCAAGGTTATGTAACCAATATTTTCTAATAAATGCATAATAACATGATGTAGCTTGGCTACGTTTAATAGTCGAAAGCGTTCACATGTTATCTTTCTCACTAG
>TTN-206,,0,92,1371051,1371142,GTAAGCCCTTGGGTCTCTCAGACTTAATTGGCAAAGCACAATTTAAAAGCAAGACAGCACACTAAAAAAATTCCTCTATATGTGAATTTCAG
>TTN-206,,0,107,1371143,1371249,GTAAGAAGTTTTAAGTAAATTCAAGTTAGCTTTTAAGTAAATTGCAGTCTTTGCCTTCATCATCGTTACCCCAAACTCATATTTTCTTCTTCTGTGGTGAAATCCAG
>TTN-206,,0,266,1371250,1371515,GTAAGCCCATCAAAAAAGGGAAATAATTACTGCATGAAATCCAGATATTAGGCCTATCAATTAAAATAAATCAAGTTAAATGAAAGTTAATAAAAAGGTAGAATATCATAAAAATTTGGATAAAGTTTTAGAAACCCAGACTGTGCCTACTTTACTTAGTGAATTTGATAAACCTGTTAATGAGGATGATATAATTGATTACAACACTGTTTTCATAAATTGTCACTAACGTAAATGGTATGCTCCAACTCCTTCTTTTATTCCAG
>TTN-206,,0,90,1371516,1371605,GTAGGTCATTTGCATATAAAAAAGAATATTCAATGTGGATCATGGACATAACTGTATGTGTTTTTTACAAATATTAATTCATAATCGTAG
>TTN-206,,0,106,1371606,1371711,GTAAATAGATATTTTATTTTTAGATCGGGGAATAGCACATAGCTACTTTGGGGCAACAGGGACTTAAATATGGCACTGCAAACTCATTAACTTTTCTTCTTTGTAG
>TTN-206,,0,98,1371712,1371809,GTAAGGAACAAAACATTTATCATCTAAGGTGATTTGGCAGTATTAACAAATATTAGTTCAGACTATTAACAGTGACTCGTGAGTGCATTTTTTTTCAG
>TTN-206,,0,690,1371810,1372499,GTGAGTTTTGAGCAGCACTGCATCAATGCCAAAAATGAGAGTAGGGGAAATCCCAGAAGGTTGGGATGCCATACAAAAGTCTTATGTGCTACAACTTCTTACCTTTACCTCACTGAAAATGTACAAAAACTTTTTAAGAATGCATCGGTGCTAATGCTTCCTGAGGTAGCTCAACCAAGGATTGTATAATTGTAATTGTCTTGTCTTGTGAGCCTTACCAAATTTGTAATAAAAAAAAAAATTCCCTACTGACTTGGTACCTGCTAAGTACCCAATATGTACCCATTAAGCTAGAAGTGGAAAGTAAATATTTATTTCCCTGGTGGTCACACTTCTTATTCCACTAGAATACCTTAGTTGACCTAATCAGCCATTATTTCCTTGTGTTTATATTAGTTACTATTCTTTACCCTGAATTAAAATCATATTTCTGATAAGCAAACTGGTAGAATCAACACCTCATTTGCCATCTTTTTTCATGTGTACAAACTATGAAGCAGTTTTTCTTATATTGAGTCAAATATTATCATGTATCCTACTTTGCAATTTTCCCTAATATGAAATTAATGTAAGAATAATCCCTAGCATTCAAAACAACTGCAGTTTGTATCCCTGGTCATGGTAAAAATCTTTTGGGTTGGCGAAAGGGTTTTTTGGAAATAACTGATTAACTGTATTTCTTTGTCCCAG
>TTN-206,,0,156,1372500,1372655,GTGAGTACATTCTTGATGATTTCTTACCTAATCTTGTTGCCTGTTTTTGCTTTTAGACCTAGAGTTGAAGTTATGGGGCAAGGCAGGGGTTGGCAATGTGAAGAGAACTGCATAGGTGGCCTGTGTAAGACTGACTCTCTCTTCCAAATGTTGTAG
>TTN-206,,0,338,1372656,1372993,GTAGGTTTTTAATTTGGCATGAGAGTAAATGTGTACTCCTAGTCACTAAAATGGGCTTTGTTGGGGAAAATTTAAATGTTTGTCTTTTTTCATTGAGAATCCTATGCTGCCGGTGTATCTGTCTGATTTTTAAAGGTGCTGCTGAATGTACTGCCTGCTCAGGGTTTTCATGACAGTATTGAAATGAAAATGTATTCAGTTATAGTGTTGAAGTAATCCAGGTTTAATTTAAAGACTAGTATTATACCAGGGGTTTGAATTTTTGAAAGATTATGAGTACTACACAATGAAACGATTATCGACATCACAGTAAAACATCCTATTCTGTTTTCTGACAG
>TTN-206,,0,93,1372994,1373086,GTATCTATTTTTGATTTTTGTCTTATCAAATAGGCCTCTGACCTTAAATCTGCTTGAACTTGATAACATCATAAATAATCTTTTCCAATTCAG
>TTN-206,,0,117,1373087,1373203,GTAAGGAAGGTTCTCATTTTAAAAGGGGATAAACTCTTTGCAGTTACTTTCTTGAAAGAAAAAAATAAAAAAAATGGTGAACAATTTTTTTTTCTGCATCTGTAATGCCATACACAG
>TTN-206,,0,114,1373204,1373317,GTAAGTTTCTCAATCAGCTGATAAAAAAAAAAGGATGCTTATGTCAAACTTGCATTTTGGTGTCATATTTATATACAGGACATATAACATTTTACACCATTATCCTGTCTATAG
>TTN-206,,0,474,1373318,1373791,GTATGCTCAGAATCCCCATCAAGATGTTAAGACAGCAGTATATTCAAATGTTTACTCTTTAGTATTCCTTGGGATTACAGATGATTATATATTACTAAAAAAATTTTAAACTACTTTTACTCATATTTTCTATTACCTCATAATTTGAAAAATTATATAAATTCCATTCAAGGGCACATTTCTTAGTTTACTCTAAAATATTAACCTTCAGGAAGTTTCAAAGTGTTTGATCCCCCAGTATATTATGATAATGACCACTGTCATAGATATTATAATTAGATTGGTATGTTTGGCCCAGTCTAAAGTGTGTGGCAGTTAAAAAGCAATTTTTAATTTATATTGAAGTGCTTTTCAGTTAAATTTCCAAATCACCTTTTCACAATTTAAATAAATTAGTCTCTTCTGTGTAAAATAAACATAGGCTTCTTCTGCTTCTTACCATGATGATACACATGCACTTTGTTCCTAATTCAG
>TTN-206,,0,88,1373792,1373879,GTATTATTTATATAATTTTTGTGGTTATTTCGAAGTTCATATGAACTCCTTTTTGACAAACCTAAACAATGATTTCATTGGCTTGCAG
>TTN-206,,0,196,1373880,1374075,GTAAGTCACTCTTGATGTCTGGGATATATAAATTCTTCTAATATCTGCCTGTGAGCTACGATATGAGAAAATATGAAAAATTCATTACTATTATTTCCTCCTGGCTACATTACTTCTTAATGACTGCCTGCACTTTCAGACTGACTATTGGGTAATAAAAAAAAAAATGAATTTGTTTTCCTTCCTTCTTTTTCAG
>TTN-206,,0,114,1374076,1374189,GTATGCTCTTGCACTTAATCTTTGTGACAATAAGTGCTCTCGCACTTAATTTTTGTGACAGGAGATTATCACCTTTCCTCTGGTTTTCCTAATCATTGTTTATTTTATTTTCAG
>TTN-206,,0,102,1374190,1374291,GTAGAATTTGAATTAATTCATAAAGAATAACTTACACTTGGCTGCAAATTCTTAACTGTGTTTTTTCATTAATGCTAATGAAATGCTTTGTTGTTTCAATAG
>TTN-206,,0,80,1374292,1374371,GTAAGTAGTGCTGATTATACACAAGATATTGTCTAGAACTTGATGAGACTGTGGATATGAATATTTCACTCTTTTCTCAG
>TTN-206,,0,100,1374372,1374471,GTAAGAGCACAAGGTCTTTTATAGTTAATAAAATACCCTTTATTCATGCATTGCATTTTGACATACTCTGTTTTTTGCTCTTTTGAATGATATCTTACAG
>TTN-206,,0,603,1374472,1375074,GTAATCATTCTTTGAAGAAAAACCAGACATTCTTCACATGTAGAGGAAATTAGTTAACTTTGCAGTGCTATTAATAATATAATTGGCTTCATGAACTGGCCACTTGTAAACTAAATGTCACTTCTGATTATGTCTTTCCATAGGAGAAGTAAAACAATTCTAAAGAGATGAAATCGCTAAACGCTTATTAGACTAATTTATACTAGTTTTAGTTAATTGCATGTGAAATACTAATTTAAATAACAGATATTAGCATACCCAAAGAGCATTGAAATGACCACAATTTTTTAATTGCACAGCTTCACATTTTCCCATAGTGTTCTTAACCAGGGATAGTAACATTTTCTGCATTCCCCCCAGCCCTGCAAATAATGTCTGGAAATTTGTGGGGCCATTTTTGCTTGGCACACAGACTTGAGGTAGATACCACTGACATTTAGTAGTTGGGAGCCAAGGATGCTAAATGCTCTGCAGTGTGAATGACACTCCAGCACATCAAAGATTATCCTACCCAAAATACAGATAGCCCCACTTAGAGACAAGTGCATTATTAAAATGCTGATTTTTCAGGATTACTAGAATAATTATCCATTTTTGTAATAG
>TTN-206,,0,103,1375075,1375177,GTAAGTTTGGACATGGATGCACTATGGCTAAGAACTAATAAACCATAGTTTTGTTTTAAGAAGGTGGTTTTCCTGATACTAACATTTTTTTCTTGTTCTTCAG
>TTN-206,,0,113,1375178,1375290,GTAAGTTTTGTTTCATGGAGTTGCCACTTTCCCATTTTGAAATAAATGAAAATAATGTTTTGTCAGTTATTTTCATCAGAATTGAAAACATTTATTGGTTATGATCACTATAG
>TTN-206,,0,299,1375291,1375589,GTGAGTCATTAAAACTACACTTTCCAATGGAAAAAGGTTTTAGTAAAACATAAAAATAAAAAGTTTGGGAGAGAGTTAAAAGAAATGGGACATAGCTTCAGCAAGTTATCCTCAATCATATTTTATCTGCTGGCCATGTAAAAGAAATCACCTGATCTTGTTATTTATTAGCTAATGGAATACAAAGATAGATGTGGGAAAACCACAAATCATGTCAGAGGAGCATGCTCACATTTATATTTTCCATAGCAACCCTTCCCACACAAATTTTTGATTACTGTTCTCTTCTGAAATATTAG
>TTN-206,,0,128,1375590,1375717,GTAAGTTTCCTTTGGCATCTAAAGTTTGCCTTTTTACCATGTACTTTGGTATATAATTACTACAGCTTTTAAAATTGCATTTTTATGTCATACTGGGAAATTTACTTCAAATGTTATTTTTTTATCAG
>TTN-206,,0,96,1375718,1375813,GTAAGTAGTTCCTTAAGAAGAAGGTGGAGTAGAACAAGCTATTGTACATTTTAAAACCATCAGGGAGTTTGATTTGTCTATCTTCATTCATTCTAG
>TTN-206,,0,99,1375814,1375912,GTACTTAACGTTATTGGAATAAAATTATGGATATTTTCTCTATATGGGACTATTTTTTAATCTTTCATGGGCTAATGCATGACTGTTCTCTTTCAACAG
>TTN-206,,0,86,1375913,1375998,GTAAGGAATGTTGCACTGATTTTCACAGGATTTTCCCAAGTGATACTATCTTATTACATTGATTTTTGGCTTTGTTTTGTTTTCAG
>TTN-206,,0,1307,1375999,1377305,GTAAAAGAGAAGGTTTCATTGTGTTTATAGAGTAATGTTTTGCTTCTAGTTATATTATTTACTGAGCTTTATGGCTTCAAACTCCCAACAGTCTCAAAATCTATAGCTAAAGAGTAATAAGAAAAGTAAATCAAAAAACTATTAGCAACATTAAAGATATCATATTTCCTATAATTTCAATGTAATTTGTGGCTGTAAGTATATTAATCATGCATGGTTTCTTGTACTGAAAAACTTGGATCTACAGGGGCTTAATAATAACCTAGAAGTAGTTTAGACATATTATATCTCTCCAGTAGAACACATTGGAAGTCGGGTTTTTAAAACTTACTAGCGTAGTAGTTAAAGAGAATTCAATGTTCTTCTAAAAGATTAGACAATTCCTGAGAATAAATGCCTTAGTCTTCCTCTATATTCAAAAAGTCCCCATACTGGAAGGATAGAGAGGCCCAAAACCAGAAACAGCCTCCAAAGAATAGAAAACCAACCAGAGGGAATCTCCCAGAAATCAATACGAAACACTAAAATTGCACACACAGTAATGCACACTGACATCCCATCTAAGAAAGCAAAGGCTTTGAGGAAGACCCATTCCTCAAGAGACAGAAGAACTTATTCCTTCACCATCACCCCCTGAAAAAAAAAAATACATCCTATATCACTGCTGCAGCTCATCTATGAACGTCCAATATACCACAGGCTGTGCCAGAGGCACCAGAACAGAGCTGAGCTTCCACTCCTTCTGGTTGCAATAACAGTCAACAAGTATGGATTGGGTCTAGTTTTACCACTGAAAGCTTAACTCTTAGTTTGGTCCTTCAGGAAAGAAAACTTCAGCAGCATTACATACATCCTCTTTCCACCATATTTTGAACCCACATGTGAGGCAACATGACTCAAAGTATGTTCATAGACATATCCACTATCTGTTAATAAAAGAAAAAACACTTTGCTCTCAGCTGGTCATTCAAAGCAAAGCTTCACAGACTTACTTTCCTAGTTCAGTAGAATTAGAAGCATCCCCAGTTACAAAGGTAAACAATCTAAAATGTTAAATTAAAAAAGCATACGTGCCCTTGATTTATTTTTCACTGATAATCTTGATGAAAAGTTTGCTAAGAAAAATTCTGTCTACATGAATGTCTATAATTTTGGCAACTGACAAGTTTTAGGAATGATTTTAAATAAGGATGTAAGGTTATGCCAAACAGAAGGCTATTTTTTACATAATTAAGTTGAAGTGAAATATTATTTCTTACATGAATATTTATCTCATGCTAATCATTTTCACTTGCCTCTGGCTAAAG
>TTN-206,,0,118,1377306,1377423,GTGCGGAATCTGAATATAATAATAATTTTAATGCATTTTACAGTGTGCCTTTATCCCATAAGTTGAAAAAAACATCCTTATGACTTTGTTACTGTTTTTCTTTCTCTTCTCTTTGCAG
>TTN-206,,0,88,1377424,1377511,GTAAGTGACTTGCTTTCTTACATCAAAAAGGCATCCAGTGTCTGTTTAAGAATTGCCTTCTCAATATTCTCTGTTGATTCCTTTCCAG
>TTN-206,,0,402,1377512,1377913,GTAAACTCTTCTGAATATTTTCTTATACACATTAAAAGTACATGACTCTGGTTTGATGCCATTTTAATATAACCTTGGAATTTGATAATTAAACTCAAAACCACACACGATAAGCTGTTATTTTGTTATTGTAGTGTTTAGCCCCACACACATAAGGCTCCTTAGTACATAGCGTTTGATACACAGATACTCTTTTAATTGAGATCCACTATCAGGTACAATACATCTACATATTTTTATTTTAAAAAAAGCTTTCTCCTTTTCTCTGTCTTCCCATGTTTTGAGTCTATATATTTATTTCTTCTTACAGTCATCCCTCCCAAAATAAGTTGAATTTTTAAATGAGTGAAAACCAACATAAGTATATTCTCTTCAATAAATTTCTGTTTTTCTAATTTCTAG
>TTN-206,,0,1285,1377914,1379198,GTAAGTATGCTTCCGTTTCTGGGGACTAATTTCTAAAGCACAAAGTCACTAAATGGATAATTCTGCCTTAAATTTCTTATATTTTTCTATGCCAAATTATTTTATTTATTAAAATAAAAAAGGTTCATGTTCACATAGACTATCGGAAGTATATATTTATGTGTGTATACATACATGCACAGATATATACATACACACATACATAAAATCATACAGTTTGTAAACTCTTGGATTAAACCAAATATTTTATGAGGAATCACAATAATAAAGACCTGGACTATAAACTCCTATGTCTTCTGATACTTTAAATAAATTTCTATCTCATTAGATACTGGGGAAATCATCTCTCCCACTAAACAGTCAGACCTTCCAGTAGGAATTCAACAAAAAACAGAATGTTGTTAGCTTTTCTATAATATTATTGAACAAAGATTTAGGATTCTCAGGCATAGTCTGTGAGGTCAAATAAGAGAGAAAAATTCTTCTAAAAGATCTGTGAGCAGATTCGTTCAAAAATTAAAAAATACTGTGGCCATAATAATTCATCCTATTTGCTACATATCTGATTAGATTCTCTATAGAAGAAAAATTCAATTATTTGTTAAAAAGAAAATTTTAAATACTCAAGTGCTATGTGGAGCATATATACCTATATAATGAGGTAGTTATTCATTCATTTGCAAACTAGTATTGAACATGTGCTTTGTGCAAGGATCTATATTAACCACTGGAGGGGGAAAAGTTAAGATTAAAAAGACAAGTACAGTAAAAGAATTTCTGTAATTGTAAAGCACTTTCAGAAAGGTAAAGGATTGTTATGGGATTATTGTAGACACTGATCCTGTCCCTAAAGGGCATTAAGATTAGTTTGTGTTCAAAGGTTTACTAGCTATTGATGGAATCCTTTTTAAATTTTCATATTGTGGCAAATTAAATTTAAATCATGTTTTCAGTAAAGGCTATTGTAGAATTTCTTCAAAGGGATCTCAAAAGTAAAGTAGTTTTTTACCAATCATGTATAAATAGAATGTAAATCTAACAAGATAGGAAGTAGTCTTTCTATTCCCAGTTAGTTGTTTGCTTTCTCTGTTTTTGCATTAATGCTAAAGGAAAATAGACCATTTCCTTTATTTCTCTTCTCTAGAAGGCAACTGTATTTCCTTTTAGCATTTCTATTTTAATATTTTAATAGATTAAAATAATATATGATCATGTGTAGTAAAAGACTCCAGCACTTCATCAGCTTCAAAATCTGATGAAGCTTTTTTTTTTCTTTTGTTATTAG
>TTN-206,,0,131,1379199,1379329,GTACTAGTACTTACTCAGTTTATGTATTCCTCTTTTGATCTTATTATGAAATTGATTAATTTACTGAAGATATTTCAATTACTTTTGACAAATATGAGCTAAATCCTGTTAAATTGTATGTGGTATTACAG
>TTN-206,,0,87,1379330,1379416,GTAGGAAAATAACCATTCTCCTCTTTTTTCCACTGAATCACTATAAGGAGTATTTATACTACAACTGACTGTCTCCTTTTCTAATAG
>TTN-206,,0,94,1379417,1379510,GTAAAAAAATAATAATTAAAATAATTCAGAATATGGTTGACTTCAATATTGCTATGATTTCATTCAATGTATGACTACTATTTTCTTTGTACAG
>TTN-206,,0,93,1379511,1379603,GTAAGAAAGACTTTGAAAGTTGCTACAGAATAAAAACAAATTATTTTTAAGCATTTAAGGAACGTTGCTTATATTGTGATTTACATCCAACAG
>TTN-206,,0,93,1379604,1379696,GTAAGCTTTAAAATCTAAATTTAAAATATCTTCTCAAAATTGAAGTATATTATTATAAACAACGCTTAATACTTCCTTTAATTATTTTTACAG
>TTN-206,,0,1003,1379697,1380699,GTAAGTACCAATGTACTGACAAAGAATGTCCTCCTTACAGCTGCCTTCCTAGGTGTTCAATAATAGTTCACAATTAAAAGAGCTATATCTGTACCTTAGGAAGCTACTATGGCTTGAATGTAGACATGGGCACATTACTTAATTACTCATTCCTTCAATTTCCACAGAATTTTCACATTCCCTTACCTGTTACCTTTTCCCTGTTCAAAGGAGATGATGTCTGTAATTTCCTCGCTGTAATTTTCCTCGCAGTCTGTTTTATTTATCAGAGGCTAAAGCAATTTCTCTGCATGCTCCTCAAAAGGGACAGAAAGTAACCAGTCATTTTCTTAGCAACTGCTGAGACCCATTTATCTTCACAATCAAGTTTTTATTTCTCTATATGAGAAAAGATATATCCATTTTAATGAAGTATATATATATATATATATATATATATATATGGTAATAATTCTTCCTCTGATAATTACCATCACTACTGTTGTGTATTTGTTTATTCTCTCATCTAAGTGTGAAGAAACTGTAGTCACTACCCTCTTTGAATATTTCTGTCCTAAATTTGTGCAAAATGGAAAATTGCTTTCCTTTTATTAACAGTTATATTTCTTAAAAGGGGAATTCACCTTCTTGTGTATCCCTTCATAATTCTGTGTAAATATTAAAGAGAGTATCCCATGATACTCTCCTACTACAATCTCCTCTCTTCCCTTTTGTCAGGATATGAGAATATAATAATACACATCATTACATGCATAATGATGCCAAATAAAGTGAGGCAAGCACAGATACATAGCCACATGTAGATCCAATAAAAGATGCTGACCCCGTGTACCTGCTCCCCAAACTAGCGTAATAGTGTTAAAGACAGAACCATTCTTTATATTGGGCTGAGCTACAAAGTCTGCCTACAGTGGATCCAAACAACTTTATAGTAACTGTGAATTCTACTTTCTATCCCTCAATGCTTTTTGCTCCTAATGACAACTTTTTTTAAATAATCTAG
>TTN-206,,0,108,1380700,1380807,GTAAAGACTGCATGGTTTGGTTAAAATTACTTGTTTTTCTGTTCATAAATAACATTTGGCTTTAAAATCATCTGAGTGATAAAGGGTTCCTTCTTTAAACCATTTTAG
>TTN-206,,0,83,1380808,1380890,GTAAGTAGGAGAACATTTTCACATACAAAGCCATTTTTACTTTTTTTTTAAATTTCTTATAATCAATATGATCTTTTTCACAG
>TTN-206,,0,93,1380891,1380983,GTAAGCCTGGAAACCATTCCTTTTTTTTAAATCTTATTTTCCAAAAGTGCCTTGGAAAAGTCAAGAATACTAACGTATACTGGCTCTTTGCAG
>TTN-206,,0,447,1380984,1381430,GTAGGAAAACTTGGCACTAAGGAAATGCACTATGAATAAACTAAAAAATGTCATAGTTATTCTCAATCCCATTAACTTCTGTCTATACTTTTTGGATTAAGAAATCAGGAAAATAGCATAATTTTAACTCACATTCCAAACATCTGTTAATGTCAGAAATCGAATCAAAAGTTAAGTCATGTTATTACTAATCTTTTGGTTATAAACCCTGGAATGTGGAATAAATAAATCAAGGTTTAATCATTTGACAATAATTTTAAAGCATAACTCCTGCCAAGTTATTCCATTCAGTGTTGCCTGTAATATCTGATCCCTAAAACCTAAACCAGCAACAATTTTCCCAGAGTAAACAGTTAAATAGGCTGCTGGTGATGCTTTAGGAAGCCATTAAAGCAAGAAGCTACAAAGAACTATTCTAATTATAAAATGTCTATGATTTCTCCCCAG
>TTN-206,,0,88,1381431,1381518,GTAATTATCAATCCTTCCTTATGCCATCAGTATTTATGTTTCAGATTGAAGGGGAAAAATCACATTTGTAATTTTCAATTGCTTCCAG
>TTN-206,,0,1728,1381519,1383246,GTAAATACTTTCAATTTGTCTGTGCAACTTTTTAAACCAACATTCTTATTATATTTACACAAAGCTATGCTGTATGCTGTGTAACAAACATTTTGGAAAATAAGAAAAATCACCCATAATCATGTTGAACATTATTAGAATTTTTAAAAATTTCCTCCTTACTTTTTTATTCTATGTGTATTCTGTATGGTGGGTGTAAGTTTACAAATTATATAATTGAGAAAACAGATGCTAACAAGAAGACATGCATCCATGTTTCCAGTGAACCTAAAGAGTGCATGTACACAATTCTCAAATTGCTAGAAGGCCATGAATATGTATTCTGAATCATGGCCCAGAATAAATATGGCTTTTTTATAGAACTTGCCCCCATAGTGTCTATTATGTTGTTATATAGTTTTCATAGAAGCAACTTTCCTTAAACTGTACATGAATGTTTAACAATCTGCAACTTTCCTTAAACTGTACATGAATGTTTAACAATTTGCCAGTGCTGACCATTTCACATCATGAGACTCTACCCCTATCGCTAAATTATCATAATAATGCAAAAACCTGTTTGAAGGGTTTCAGTATTCTAATTGAAGAGAAGCATCATAGTTGGTTATCAATATTGCATTTCTAGTCACTGAATATAGAGTTGAACTCTATGAGGCTTTTTCATGGCTCTCACTGGAGGCTTTAGTCCAGTGATTTGCTCAGAACACGAAGCCTTTCCACTCAGGGCTCTTTCTAAGCATGTCTCTAGGCACAACAATACTCCAGCCACAGTTTTTATGTGAAAATTGCCAGTTCTATGTTGAATATAATTAATATAAGAATGGCATAAGGAAAAATATTTCATTAAGCAGTAGCCCCACAAACTTTCAGGTTAGTTTCAAGCACCTAAAGCTCTTTTGCCTAATGGTTATTACTTTAATTTGAGAACTGGTACATTTCCACGTTAATTATTTGCAACCTCCTCAAAGTCATTCTGAAATTTGGGGCCTCCTATGCTGCTTGTTGATCCACTGGTCATCCAGAAATAAACCATCTCTCTCTCCGTTTCCCCTGCAGAGGAAACTGGACATAGAAACTGACTATGCCACTCTTACCCATCTCTTGTATCCCTCTGCATGCTTGCCTCCCAGCTCCCTCCTGTCCAACTCACAAATTGCTTTTAAAAAGCATTTTTATTTTCCCTTCAGCCTCTACTAAAACCATGGTAACCAATAACTGTTGCAAACCTACTTCATTAACAAATATGGGGCTTGATGCTATGGCTCACACCTGTAATCCCCTGACTTTGGGAGGCCAAGGCAGGTGGATCACTTGAGGTCAGGAGTTCGAGACCAGCCTGACCAACATGGTGAAACCCTGTCTCTACTAAAAATGCAAAAATTAGCCTGGTATGGTGGCACATGCCTGTAGTCCCAGCTACTTGGGAGGCTGAGGCAGGAGAATTGCTTGAACCTGGGAAGCGGAGGTTGCAGTGAGCTGAGATTGTGCCACTGAACTCCAGCCTGGGTGACAGAGCGAGACTCCCATCTCAAAAAAAAAAAAAAAAAAAAAAAGTGGTTGACTGTTTTTGTATTGACTAGATAGCAGAAGGAAAAACTAACTCAATTAGTAGACACAAAACCTTACTTTCTTCAAAACAACATTTTTGTCTCCTTTTAAAAAAACAAGTGTTGAGCATTATCTTTCATTGAAGGCAAACAGCTTGAATTATTTTCTTCTTATTTCCAG
>TTN-206,,0,860,1383247,1384106,GTAAGTAAAAAAAAAAAAATGTATACTTAATCACTTCTTTACTCATTTAGTACAAGACTATGGTGAAAAAATATGTGTATAAATGCCGTACATTTCATTCACTTGACAAGCAGTTATCACACAACTACTCAGTATCTGATTTGGTAGTATTTGGACAGTGATTGTGAAAGAGATTTTACAAATATGTATAATTCATTGAATTTCTTTTTGTTTTTTTTTTTCTTTTTGGTTTTGTTTTGACACATAGTCTTACTGTTACCGAGGCTGGAGTATAGTGTCATGATCTTGGCTCACTGCAACCTCCACCTCTGAGGTTCAAGTGATTCTTGTGTCTCAGTCTCCCGAGTAGCTGGGATTACAGACATGCACCACCATGCCCAGCTAATTTTTCTATTTCTAGTAGAGGCAGGGTTTTGCCATGTTGGCCAGGCTGGTCTCAAACTCCTGGCCTCAAGTGATCCACCTGCCTCGGCCTCCGAAAGTGCTGGCATTACCACTCCTAGTTCATTTATCAAATTTCTTCCATCTATACCTCACAGATTTTTTTTTAATTTCCCACTTAATGGCATTAATAGAAACTGAATTATTTTCCTACTTCTAAAACTACCAATTCTGAAGACCTTTCCTAAATTATTTTGCCTCAACAAACCTCTATTTCCTCATCTGTCAAGTGAAGAAATTCAATTGTATTGGGTCCTTTTTAACTCTAATAGTTTTATGATGAGATCTCTTTTGCTATTTATGGGAGCAGAGAGTTTAATGTTTAAATGCAATCTTCAGAAAAGGAATATTCACTACATCCTACTACATTCTTAATGTGACATTTTTTTCTACCACAATTCCTATACTTATATTCGCAG
>TTN-206,,0,101,1384107,1384207,GTATGTGTCTACTACAATTTATACTTCTGAAACTTGCACATTTGTAGATTTGTAATAAGACATCAATAAAAATGACTTGCCTTTATAATTACAAATTTTAG
>TTN-206,,0,93,1384208,1384300,GTAAGTCTTATTTAGTGGAAAGAATAGATCTTCTGTTCTTTCAAAAGCAGAAATGGCAATAACATTTTGTGCCATGATTTTTTTTTTCTGCAG
>TTN-206,,0,92,1384301,1384392,GTATGCATTATGTTTCTTTTTAGTGATTCAATGCTTGATAAAACTAATATAAAGAAATAAATTTCTAACGCATTTTCCAACATTTGTTACAG
>TTN-206,,0,89,1384393,1384481,GTATAGTATTAATGGATTTATTCAGTTTTCATGTTATCTAACTTTGTTTTCAGCTATATGCTAATTCGTTTTTTACTTTTATTTTTTAG
>TTN-206,,0,114,1384482,1384595,GTGAGTAAAATGCTCTCACTTGTGTTTGCAAGGAAAATAGATGTCTGATTGTATGTGTTTAATTGTAATCTGCATTATGGATCAAATCTGAGTGTTCTGTTCTCTTTATTCTAG
>TTN-206,,0,101,1384596,1384696,GTAAGAATTTTACTACTTAGGCCATTAAAAATAAATTTTGATAATTTTGAGCTCTTATATGGATAAAATTACTTATCAAACTGTTATTTAACACTTTTTAG
>TTN-206,,0,85,1384697,1384781,GTAAGTTGCTTTCTCTGAATACAAAACTATTGTTTGACTGTCTTTAAGAATATTACTTTTTCATCATAACTTCTTCTTTGAAAAG
>TTN-206,,0,94,1384782,1384875,GTAATTTTTGGACTAGCAGTATTACCTTATTTCTTTTTAAAATTATTCATATAGGTGAAAATCAAAATCTAATTTTTTCATGTTTACTTTTCAG
>TTN-206,,0,318,1384876,1385193,GTAGGATGTCCTTGTTTTTTCTGATATTACAGCAACTCTTAATCTCAAGCACAGAAGTATTCGATAAATAAGTTAATGTAACATCTAAATCTGTAACATCCAAACTGTATTTAGCAAATATTTTTCCAAATAGACCTTTTACCAAAATACCTAAAAGGTACAAACAATAGTAGATTCTCATTTTTATGAAGGAAAATAAAGAGGACACTAATTGAAAAATTGGATGACCTATATTTGATTAACTGAGAATAGGCTATATAAAATTACACATTGAAGTATCACTAGTAGTAGTTAACTATATGTATATTTTACTTTCAG
>TTN-206,,0,98,1385194,1385291,GTAAGTCCTTCCCTTAGCATGTGATTCATTCACACTTAATTTCTTATGATTTCCCCACATTCTGAAAAATCAATTAATGACCTTAATGTCATTTGCAG
>TTN-206,,0,98,1385292,1385389,GTGGGTTACTAAAATGCTTCTCCCTCCCACTTCAAAAATGAATTTGTTAATAGGGATGCTGAGGAGACATGTATATCTGATTTTATGATTCTTTACAG
>TTN-206,,0,310,1385390,1385699,GTAAGTATTATGCTTTCTTCCTCCTTTTAACCCCAGTCTCCTATTTTAGCAAGGTCAAGATACTAATACCATTTTAATCCACTTCTGAAAGAGATTTCATTTGTAGAGACCGAAATAGTGTAATAAATATCTATCTCACTCATGAAACACTTTTTTGATCTGTCTCATCTTATATGTTTTGCTTTTAATGTACTGAACTACAGGTTCTATGTACATTGGAGCAAATCCATACTAAAACTCTTATGTACATTAACAAAGGGGATTTGATTAGGTTACCTAGGTAATCTTCTAAATTATGTTTTTCTTCTAG
>TTN-206,,0,1157,1385700,1386856,GTAAGTAGTCTTTGCTTCATTTATGTCATGTGGTAAGTTTATTAGAATTTCTTCTTTTATATGTAGACATTTCTCCCTGAGGAATCTAGCTCTAGAAATTCTTGAAAAACAGTAGAGAACAGTGGCTTTCAAACACATGAGTGGGCCAAAAACACACAGTAAATAAACTTATACAAACACATATATAACTAAAAAACATTTCCTGAAACAATACCCATTTATTATCATGTGCATTCTTATGTTTTCTACCCTATTCTGTGTTTTTAAAAATATTGGCTGTACAACAAACATATGAAGAAAAGCTCATCACCACTGGTCACTAGAGAAATGCAAATCAAAACCACAATGAGATACCATCTCACACCAGTTAGAATGGTGATCACTAAAAAGTCAGGAAACAACAGGTGCTAGAGAGGATGTGGAGAAATAGGAAAGCTTTTACACTGTTGGTGGGAGTGTAAATTAGTTCAACCATTATGGAAGACAGTGTGGCGATTCCTCAAGGATCTAGAACCAGAAATACCATTTGACCCAGCAATCTCATTACTGGGTATATACCCAAAGGATTATAAATCATTCTACTATAAAGACACATGCACATGTATGTTTATTGTGGCACTGTTCACAATAGCAAAGACTTGGAACCAACCCAAATGCCCATCAATGACAGACTGGATAAAGAAAATGTGGCACCACATTTACACCACAGGATACTACGCAGCCATAAAAAAGGATGAGTTCATGTCCTTTGCAGGGACATGGATGAAGCTGGAAACCATCATTCTCAGCAAACACAAGAACAGAAAACCAAACACCACATGTTCTCACTCATAAGTGGGAGCTGAACAATGAAAACACATGGACACAGGGAGGGGAGCATCACACACTGGGGCCTGTCAGGGGTTGGGAGGCTAGGGGAAGGATAGCATTAGGAGAATACCTAATGTAGACGATGTGTTGATGGGTGCAGCAAATCACCATGGCACATGTATACCTATGTAACAAGCCTGCACATTCTGCATATGTATCCCAGAACTTAAAGTATATATTAAAAAAAATTGGTGGTAATACAAGCATTAATTTGCACCAGTATAGCTCTCCACCAGAAGAAACTTATCCACCTTCCCAAAATTAATATCTTTTCATTTTACTTTCAG
>TTN-206,,0,103,1386857,1386959,GTAAGTTAAGTATTAGACAAATGGCCATCTAAATATGAAGCTCAGAAATATTTTTACGTATCAAATCCTTGTTCTTACATTTCTTTCCTCTTGGTTCATGTAG
>TTN-206,,0,90,1386960,1387049,GTATGTTTTTGTGAAGGAGAAAAAAAGTTGTTTTCTTTCTAGTTTGTTACTTAATGTAGAAACTGACATCTTCCTTGTCTTCATCTCCAG
>TTN-206,,0,369,1387050,1387418,GTAAGTTTTGGGGTTTTTTTATTGTTGTTGTTGTTTTAGTATTATGGAGGCACATTTAAATCTCGGAGTCTAAGATTTGGACTCCAAGACACAGAGAGTAGTAGAGATCTGAAGATTACAACTCCCATTTAAGAATATGTTCTATCTCTTACAATGAAGATGACATATTAAAAAAAGAAAAGGACATATAATTTCCTTTAAAGCATACAGCAAGGACTCAAAAGTGCATACTAGTTGGACGGTTATTAAAATGGGATAATTGTCTTCCTGTTGAGCTTGTTACTTAGCAGCAGGGATGATAATGTGAAATATGGAAGTTTAAACTTCTGCTGGTAAGATAAATGGTGAGTGTACCTCTTTTTGTTTTAG
>TTN-206,,0,379,1387419,1387797,GTAAGATTCTGCTGAGTATTATAGGCAAAGATGTAACAGCATTCATGATGGTCATTTTTCCTAATAAAAAACTAAATATACACCTAAGGAAAAAAGGAAAATTAAAATGATGTTTTGTATATAGACACAAACATTATGATTATGGAGAATCATAATAACATGCTAAATTAAAAAGCAAGATACACAACTGTGGCAACTATATAATTTCAATAGTTATTCAATAGTGCAGTTATTATTTGTCTATTAAAAATAAACAAAATGAAATAACACTAAAATTCCATTCTTGAAAGAAGCAGCATATGAATTTCCCACTATTATTAATAAGGATTACATAATATAGCTTTGCATACATTAAGTCCTTTATCTTATTTCTTTCCAG
>TTN-206,,0,347,1387798,1388144,GTAACTAATAAACTTCATTGGAATCCCATATTTTACTTTGGATAATGGGATGTAAATAGGATTTACAGAATAATGTGGGAGAAGACATTCATATTCTAATGTGTATTTCCTATGCACAGAATTATTCTTATGACAGAACCACGTTTTAGAGTTAAAAAGAGCTTTAGAAATCACATATTTCAATTACCTAATTTTACAAGTGAAGAAACTAAGATTCTAAAAAATTAACTAACCTCCTAGGTCATATAGGAAATTGACAATAGAAAGACTGCAGCCCAGGTCTCCAGACCTCTACTCTATACTCATTCCCCATTCCACATATTCACTCTTCTTCCTTATTCCTTCAG
>TTN-206,,0,87,1388145,1388231,GTAGGAACATTTCCCGGTGGTTTTTCATTTTATTTTTTAAAATTATCTTTTAGCCTGGGAAATTAACTTTTCAATCAATTTCTGCAG
>TTN-206,,0,101,1388232,1388332,GTAAGTGTTCATGAACGAGTTCCATATCCTGTGTTAAAAGCAGCATTAAACACCCAGGAAGGAAGTTTTCATGAAAATTTCCTATCATTATTTATTCTCAG
>TTN-206,,0,889,1388333,1389221,GTAAGTATTACCAGGGGGAGTACATAAGGCTTTTCCTATTAATCATATTCTAAGAGGGAGACTAGAACTCCCTTAGGTAGATTAATTTATTAACAAGGTGTAGAGCTGGTAACTCCAAGAGTACTTTTTAGGAGAGCTGGGTGGGTACTTTACGGTATTGTGGAACAGGCAAATCAAATGCACATGATTTGTGGTTTTGAAAAGCTTTTCATATATATAAGAATTTCCTGTCTTCAAAAGACATGAAATGAGAGAATTTTATTGGAATGTAAGAATTTTATTTTAGGAATAAAGAGGCCTTTTAACTAAGTAGTGAGCTATTTACTATTCTTAGGGTTTCTGTTTTCCAATCCACCATCTCCCTAAGTATGTGACTGGTGGGCTCTCCATCTTAATTTCCCTTCTTCTTATTTCTTCTATTTGCTTATCCTCCATGATAATTTCCCCTTTATTTGAATTACTTGATATTATATGTCACCCTCCAGGTACTTTTCTTCCTACTATGAAATAATAAAGAGAGCTAGAATATGTGGCAGAATACCTTCATGGAATATAGAAAGGAAAAAACAAGAATGAAAGGGAGCCAAAAATCAATCGTCTACTTTCCTTTTAATATATGTAGCATTTCAGAGTACATAAGGCTCATGAAAGAGGAGGTACAGATCCTCCGGGGGGAAAACCTGGTTAAGCCTAAAGCATAGTGGAAAATGGAAAGATCAACAATTAGTACAGAACAGAAAAATGATTTTGAGGATTGTATTAAGGAAGTTTTAAAGAACAAGAAATCAGCTCTAGAAAATAAATGTATTTTAGGAGTGACAAGGCCAGTCCCTGGAAATACATTTGACTATTAAATTTTTATTTAACTTCTTCACCCAAAATTAAACAG
>TTN-206,,0,92,1389222,1389313,GTAAGTCTATTTCAAAAAAGAATCATATATATTTTAAAATAGCTTATGTATTTTTTACACATTCATTTCTTATTTACCTACTATTTATCCAG
>TTN-206,,0,90,1389314,1389403,GTAAGCAAATGAACCATCATCCCATCATTTTGAGTTATATCCTTCCTTTGTTATATGGGGCTTACACTTATCATTTCTCCTTTGCTTTAG
>TTN-206,,0,167,1389404,1389570,GTAAGGCTCTATGCACACATCTTCATTTTTCCTTTATTGTCATCGAAAGTGCACTCTTGTGTCCCACTCACTAGCTTATCTAAAAATCCGTTAAAAGCTAGAACTATTTGAAAAAGTTAATCGCCTGGCCTTAAAAATAACAGTAATTTATCTCTGCTATTTTACAG
>TTN-206,,0,90,1389571,1389660,GTAAGTGTCTTAAATTCAGAAGACGTAAAGCAAAACACGGTTTTGAGGAGGCTTCTTATTATAAATCTTGCATTATCTACTTTTTTCTAG
>TTN-206,,0,425,1389661,1390085,GTATTTTGTTTGTTCTTATCCTACAGCTTTTACATCAAGATTCCTCACAAATATTTCCCTGAGAACAGTTGAACATGTGCTTATCGATAACATTATCTGCTTATACAGAAATGTGTTTTTATTTCAGTACATATGGTTAATGTTTAATTTTATTGAAAATATCCTAATGTAATAGTTAATAAAGTATTTCTTAATTATAATATCTATTTTTGTAAGTTAAAATTGTTCACCAAAAAAGACAACAACTATGCATATTCCAAGAGGAAAAAAAAAATGGCACTATGCTTGGGTAATAAAAGTATAGATACTAGCAAGAATGACTACTTGTTCAATATATATGGATATGTATAAATAATTTGGGCAACACATATATATTGTAAAATCAAGCTGCATTTATACTTGATACATCCCTGGGTCTTTTGTAG
>TTN-206,,0,89,1390086,1390174,GTAAGTCATTATATGAAGAAAAACCCAGGTGCATGTTTTACATGAAGAAAACTGGTATTTGTTTGACTGGTTTTGCTTTTATGTTTTAG
>TTN-206,,0,91,1390175,1390265,GTAGGTCCATTTTACTTTTTATGTACTTTTTTTTTTAAAGCAAATTAAGCCTCCTTCCTTTTCTGATTAAAATGTATTTTTTTCTTTGCAG
>TTN-206,,0,91,1390266,1390356,GTATGTAGAGCATGTGAGGGAATTGACATGGAAACATTTATAGCAGAGTTTAGGAAATCATGGATTTCTAATAAATTTGCTTCCTTTTCAG
>TTN-206,,0,112,1390357,1390468,GTTAGTATTTGTCTTTTTCAACACCGTTCATTCCAGAGTGCCAATATTTTATCTAAATTACCCAAAAGCCAAACTCTGAATATATACTTTTGTGTCTTTGTTTCTTTCTCAG
>TTN-206,,0,673,1390469,1391141,GTATGTTTTAAGAATAAGGAAATTCTACATATCCACGTTAATTTTGCTAGAATAGTGTGAGTCATTCTAATTAGTCGTTATTTCATCTTAAATGCTTTTGGGTTCACACCCTTCACACCCCAAACTATTCATACTATGGCACAAAATGGAATCTCTAGTGAAGAGTCTTTCATTGATTAAAAAAACAGAAATTTACGTAGCTAAAATTGGATAATATATGTTGAATTTAAGTATTATTGAATCTAACTGTATATATATGTAGGTATACATGTTTATATATATATATACACAGATTATATATATATAGTATGTGTGTATGACATATATCATATGTGTGTATGTGCGTGTGTACAGAAATTGTATATAAAGTTTTTTAAAAGATTGTTCATCTTGTTCCTCTTTTTTATCCCCATGGTGAATTTGGAGTAAATTTTATCATTTAATCTGGTCATTTTACCCTTAATTTGGATTTGAATGCTATAGCATGTAATGACATAGCTTGTGGGAGCCTTGGTTGGTTCAGAAGCAAAATGGGTTATGTAAAAAGGAAGACTAAAATCAACATAAAAATATGGCCTTCATTTAAAAGTTTTCTTTTGACAATACATGAAGAGTGCACATTTAAAAGTGCTGTAATAATTATTCACTTTCTTTTGATGCTTTGTTTTCTTAG
>TTN-206,,0,105,1391142,1391246,GTATGTCTAATTTTGTGTAGAAGCAAAATTTGAAATTATTTGCATTGATTTATGTTAATTTTCAGAAACACTTTTTCACTTTCACTTTCTATACTCATTTTTCAG
>TTN-206,,0,92,1391247,1391338,GTAAGTTGTCCAACTTTTCAAAGATCCAGGTTTTCTTTTACCATAAATGTGTTATTGTCTGTACTAATCTATAGGATTTCTCTCTTTTGTAG
>TTN-206,,0,108,1391339,1391446,GTACGTATTTGTCATGGGAAGGGCAGTTCTGATAACAAAAATGCAAATCTTACTTCTGCGAAGCAAAATATTATAAGTGCCGCTAATCTGCTTCTCTTATTACCACAG
>TTN-206,,0,1695,1391447,1393141,GTAAGCATGCTTAGCACTTTGAATCAAAATTGCTATTTAACTCAGTATTTCCGCATACCTTTTCCTGGTTCTAATCCTATAGAATAACTTTTACTCTGTGCCTTAATGGGGTTTTTGGAAGAAATTATGGACTAGCTGGGAGTCTGAGGAAAATTCCTTAAATACCTTTCCAGCCCTCTTGACTTGACTGTAAAGTGAGAGATTTAGACCTCAGGATATCTATGGGCCTTTCCAACTTCAACCTTTTATGATTGATTGTATGAGTTGGTGCTTTCATTCTGTTTTAAATTATCAGAGTCAATAATTAAACCATGGTTGAGTTCCTAGAGAATATTGCTCTTAAATAAGCCACAGACTAAACAGAGACTTCATTTTTTGGTTTTTTTTTTTTTGTTTGTTTGTTTGTTTGTTTGTTTTGAGACAGAGTCTCACTCTGTCGCCCAGGCTGTAGTGCAGTGGCACGGTCTTGGTTCACTGCAACTTCCGCCTCCTGGGCTCAAACGATTCTCGTGCCTCAGTCACCTGAGTAGCTGGGATTACAGGCATGCCCCACCACACCCAGCTAATTTTTTGTATTTTTAGTAGGGACGGAGTTTCACCATGTTGGCCAGGCAGGTCTCAACCTCCTGACCTCAGGTGATCCACCCACCTCGGCCTCCCAAAGTGTTGGGATTACAGGTGTGAGCCACCATGCCTGGTCTAAACACAGACTTTGATGATGATAGTATTAGCAGCAGCTAACATTTATTGAGGAATTTTCATGAATTCTTTCCCTTAGTTCTCACAGCCCTCATATTAGCCATCTTATAGAAGGGAAACTGAGGCTGAGAGTGCTTTTGTAACTTCCCCGTTAGGGATGGAGTGGGAATTCAGACAGACAGACTTCAGAGCCCTCTCTATCATGGTTAGTCCAAAATGCGTATTCTTCACCATTCTGGAAAATAAGTGGCACATTCAACTCAACAATGTTTTGAAAATTAAAACGTCATGAGAGTCAGGTATCCTGTGACACTTTACCTAAAAGATCTCCATTTGCTAAGAGAAAATTGAGCCACTGTAGTGTCTGGGCAAAAGTATCCACTTCCATCTTCATGCTGAGAATCTCAGGGCTGTTCATTATTTATGAATCAGGCTTTGTGGATACTGAATCAGTGTTTATGAGAGTATAAAGCAAGTCGAATTTAGTTATCTTTCTTGATAATTCCAAACAGCATGGCAGAAAATCTGTCCAGTAATTATGTAGCTCTGTGGGTAGAGAATTCAGACTTTAAGTGTCTGACATGAACCATCCACACTTGGATATCAGTGAACTGGGATGGGAAAAGAAAAAGAATAGGAGGTGCGTAGAAGAAAAGGAAAGAAAAGCTAAAGTGAAAGGAAATGTTTTAACAGCTTCTTCCATGATGTTCTCACTACCATATCCCATTTCTTCACTGGAATAAAGCAACTAATGGACTTTAAAACACATGTAAAAGGTGCTTAAGTCCCTGCACAACTCACAGTCTTTCTACCCCATCTGAGATAGAAGAGTGGCCTATAAATTTTTAATTTTTAAATAATAATTGCATAGAATTATAATGATGGTGTGTGTGTATAATTTAATAATGGCCAATGACCTTACTTTAAGGTTGGTGCAACTATTTTTTTTTCCATCCTTATAATATTTTAAATATTTCTCATCTGTTTTTCTTGCAG
>TTN-206,,0,112,1393142,1393253,GTAGGTGCTGAATACAGACCACTGTCATATTACATTTGCCTAAAGCTTAGTAATTTTGAACAAGTAGGCTTTAAAGAAGTACTAACATCGTGTTTTGTCCTTTCACTGATAG
>TTN-206,,0,236,1393254,1393489,GTGAGACATGATTTCATTAGAAAACTGAAACGTGAAAAATTTAAAAATAAACTACGCTAACCTGTGCATATGCTTTAATTTTCTTTTATATAACACCTGTCTCATTACCATCCTTTTCACAAGGTGAAAAATATAAAAAATAAAACCAATGTTCTTGGAAAGAATGCGAACATCAAAGGTATAATTTATCAGTAATGTGGATTCTTGTACCTTGTTTTCCCTTCCTTTCTAAATAG
>TTN-206,,0,106,1393490,1393595,GTAAGTGCTCATACCTGCAGCATCTTCACCTGTGTCTTCTATATTCACCTGTGTGACTAAATTGTACATGATTGTGTAATTATTTTATTGTGAATGGCCATTCCAG
>TTN-206,,0,105,1393596,1393700,GTATGTACCTACTGGTTTGATTATGTTTTTTAATAAGCATACTTCCAGGAAATCACTCTTTTTTGCTTTTAAAATTCACTGTATGTATCCATTTTATGTCTACAG
>TTN-206,,0,369,1393701,1394069,GTAAGTGATTATTATTCAAATACATTTAGTTTAGCAATTGAACATATTAGAAACAAATATATCAAGGAATGCTTTTCTTCTCTGCATCACCTTCTTACATATCTTCTTGTCACTAGAGAACTGGTCATGTAAAGCAAGAGGAATTATTTTAAGTCAGTCTAATAAACTAATTTGAAGTTCATTTTAAAGACTATGAAATGGAAAGTTGAAATTAATGACCAATATGAGTTTGGGAGATTGAATAAATTACTTATTATAAAAATTTTACTTATTTATTAAAATTATAGAATAATTGTATTGTTCTTCCATGGATGATTAAGACCTGGTTACAAATGTAATGATGCATTTACCTTCCTTATAATTTTTTAG
>TTN-206,,0,693,1394070,1394762,GTAAGCATTTACAACTTATTTCCAATGAGACTAAGAGCATTCACATTTTTAAAAAACACATTTGGCCCCTGGCCTGTAAAATGGTAACAGAAACAAATTACCCAAGGTTGCTAAGTGGATGAATTATGTCTTTCTACCTTTCAGATGAAAAGAAGAAAAAAATAATTGGCATCAATTATTTTTTCTATTATTTCACTCCATTCCCATATAAAGAGCATGCAGCAAGTGGGAATGAGTTTTTAGCTTTGTAATTTTCGCCACTTAACAGTACATAAAGAAAAGGTTCTCGAGAATAAGTGTCCATCTTTACTGAAGTTATTAAAATACAACATACATCCAACAACACAATCATCCCCTTGCTTGAATGCAGCTGATGGCCTCTTAAAAGAACTTGTGTGACTGTGCAGCAGTATTAGGAAGTACATGATCTGTAAATGTTTCACTTTCCTTTTTACAAAGAGCAATGCAAAATTAAAAACATGACAGGCATTACAAAGGGAATAATAATAGGCAAATATTTAACCCCATAGTCCAAATTCTCAATTATCAATCCTACTTTCAAAATAGGCTTTGGTAGCACAGTAGAAGTCACTACTCTTCCTGGCCTTGTGATATGGCACTACTGAAAAATATATATTTATGTATGTCTTTATTAAGCCAAACTAATACATAGTATTTCTCTTTCTTTTATAG
>TTN-206,,0,116,1394763,1394878,GTACTTTTAAAATAGCTTCTTAATGCTACAATTTATGAACTTGGATTAGAGACATGCCTAGTTGTATTTTAATGGACAAGGAAAAAGAAACTAACTCTAGAAACTTTTTCTTATAG
>TTN-206,,0,96,1394879,1394974,GTAAGTTTGCGTTTTTACTAAGCGGTACTATGTCAAAAGTTTAACCTTCCAAGCAAATGCATCTAATTGATTTGGGGTTTTGTTTTTGTTTTACAG
>TTN-206,,0,101,1394975,1395075,GTAAGAAAAATAAAAATCCTATTTCAAAGTCTCTATTATTAAATGTTTCCCCTGAATTTTATAAAATTGTATTCATACTTAATACCTTTGTTTATATTTAG
>TTN-206,,0,97,1395076,1395172,GTATGTATCACAATTTAAGGGCATATTTGTTTATTATTACTGATTCTAGTAGAACTCAGAGTGGTATATTTTAACCTTATTTTTGCATCCCTTCCAG
>TTN-206,,0,97,1395173,1395269,GTAGGAAATAGTCAACATTCTCCTTTTTAAAATTATCTCAATTTATGTGAAAATAAACTCTCAGATATTCATTCATATCTGTTTTGCCTACTGACAG
>TTN-206,,0,95,1395270,1395364,GTAAGCATGTCAAATGTTCTCACATTTATATAGCATTTTCCAGTGTGGGCAGAAAGAATGATCTTCATCATGGCTTGTCATTACACCTGTTTCAG
>TTN-206,,0,126,1395365,1395490,GTAAGTATTAACACTTTTAAATAATTTGACAGTTGAAATGTAATAGAATCAGGGGGAGAAGGGAGAAGGGCAGTCTTATCAATAGTAATTTTGTGCAATTCTCATCATCCTTATTTTCATAAACAG
>TTN-206,,0,881,1395491,1396371,GTGAGCTCCAAGAATCATACATAAATACAATGCTCCTCAAAACTATATGACAGATAATTTTCCAACACACAATCTCTAAGAATTTTTAGAATTTATGAATGGTCTAGAAAAGCACATGCTTATTTGCATGATCATAAATATAGCTTAAGTCAGAGAACATTTTAACTATTACATCTGTTAAGTTAGCAATTAGAATTGCTAAAAGTTGTACAGCATTTTCCAATTAATGAAAAAATATTCTATCAATATGAAAAGAATCTATTTTATAAATTTTCCTTAGAGAAAAATGCATTGTACTGTAATAACTGAAAAGAAAAATGGCAAAACTCCTTTTAAGAAGAGGTTTAGCAGGAACATACAGTTTCTAGTGGTTTCATAAGTTACTGACAAAGTAATTGTGACAAGAGCTTCAAAAATAAGTGGCAAATCCTTTTACAGAGTCTGAGCCCAAGAACTATAAAGGAATAGTCACTGGGACTGAATTGGGGAAGCTAAGGAAACCAATTCTTGTATTCATTAGAAATGTATTGGTGGCAAGTGATACTAACCCAGTGAAAGATAAGCAACTAAAGAAAAGTCCCTAAGAATGGGTACTTTAAGTAATGAGCTTAGCTAATAGAGAACACACAGTAAAGCTGGCCAAAGAAGTAGGGAAGAAATATCTACTTTCCTAAAGCAATTTAATTCTTAAGATAATAATATTAAATTATAATGTGGCACTCTGTGCTGTCCTATAATATCAGGAGCCCAGTTAATAAAGATTATCTTGGTGAGTGTGGACAAGAGCAATAATGCCTTTGTGAGTCTTGAAAACAAAAAATACAAATCTCAACATTTCCTTATTTGCCTAATATCTGCATCTCACTTTTTAAATTCCACAG
>TTN-206,,0,85,1396372,1396456,GTATTTATCACAGAAGCTTTTAGGTGAATTATTTTCTTCTCACACCTGTCCATGAATTAATTAAATTTTGTCATTAACTTTCCAG
>TTN-206,,0,171,1396457,1396627,GTAAGCATTTTACTTAAAATTGGCTATACAATGAGTAGATCCTCTAAAACAATATAGCTTGACCTATGATTGATCACCTCTCTAGAAAGGAACTATGTTGATTATATTTCCCCAAGAAAAAAAAAGCTATCAGGCAAATAGGAAATATGAATCTTTCATTCTGTTTTTCAG
>TTN-206,,0,119,1396628,1396746,GTATGTACCAAATAGCCAAAAAAAAAAAAAAAGTAAAGTAAAATGAAAACATTCAGAATTCGTAACAATTTACCATAAAAATAATGCTTAAGAATAAATGCCTGATTTCTTTCCCATAG
>TTN-206,,0,98,1396747,1396844,GTAAGGATGTGTGACAAAGATACAAGCAAGTTGATGTTCAGTCACCCAATTTTGATTTGAAGTAAAAATTAATTTCCTGTATTTCTTCTCTTTCATAG
>TTN-206,,0,679,1396845,1397523,GTAAGTCCACAGGCCCTTCCACCACTCTCCCCACCTCTGATTCTGAATGTTAACAAAAAAGAATTTGTTTTTAATATGCCCTAATGTAAATAAAAATAGGTCACAAAATTAACCCTGTGGTCTTTCTAAGGTTTCTAAACCTCCTTTTCTCAGGTTTCTAAACCTCCTTTTCTCAGAGGTTTTCAACACACTTAGGCTTGATTTTTTTTTTAATATCTTCACTCTTATGAAAGAGAAGAGGAGGGAGTTAGGAAGAAAGGAATGGAAGGAAGAAAAGAGAGAAGGGAAGGAGGAAGAGAGGAAAGGAAGGAGGACTGGCAATGTTATAGTGAGAAAAAAATACAGAGTGCATGCTTAATAAATGTAGAATTGAAGAAAATGAGGAACAGCAAGGAAAGTACAAAATTAAACCTCAGCATCATGCAATATACCCATGTAACAAACTGCACATGTACCCCTGAAGCTAAAAGTCAAAAATTTTTAATAAAAATAATTAAATAATTAAATGATTTAAATTAAAATTTACAAATAGTACAAAAGTGAAACTATTGGAAAAATAGTCATGTGCCTTATGTACCTTTTAAAATACCAACCAAAACCTAAGGAAAACACAAATATATGAGTCATTGTTTTAACGTATTCATATTGCCATATCGTGTTAACCTCTGTCTTGCTGCAG
>TTN-206,,0,911,1397524,1398434,GTAAGGACATTTTGTATCAGTCAAATTGATTGAGTTACAATTTATATGTGGGAAAATTCACCTTTTTGAAATATATAGTTCTATGACTTTTGAAAAATGTACTGTTTTGTAATCACCACCACAATCAAAATGTGGAATATTTTTATTACCCCGTAAAGTTCCCTTGTGTCCGTTTGTAATCAGTCCCTTCCCCACCCCAGCTGCTAGCGATTTCTGGCAAATAATTTTTAATATTCTTCTCTGGAGTCAATTTCCACTTCTTTAAGATGAGATTCATAATATATGCTTTCTATCACACTTAAAATTTTAAAACAAGTTAATATTTCTGGAAGCACTTTAAAAACTGCTGATAAATGTAAGATAATAATAGTGATTACAAATGAAGCACATTTAAGAGAAAGGAAAGTGAAAAAATGTTAAGTATTTTTAGCTGATAAAATGAATAAAATTTTCTTTTTTCTTTCTTTTGTTTTTTTGTGTTTTTTTGAGACAGAGTCTCACTCTGTCACCCAGGCTGGAGTGCAGTGGCATGATCTTGGCTCACTGCAACCTCTGTCTCCCAGGTTCAAGCAATTCTTCTGCCTCAGCCTCCTGAGTAGCTGGGATTACAGGTGCCTGCCACCACGCATGGCTAATTTTTATGTTTTTAGTAGAGACGCGGTTTCACCATGTTGGCCAGGCTGGTCTTGAACTAACTCCTGACCTCAAGTATCTGCCCACCTTGGCCTCCCAACTTGCTGTGATTACAGGCATGAGCCACCACACCCAGCCATGAATAAAATTTTCACAAGACAAAAAAACAGGCTAATGTTAACAGTCCGTTTCAACAACTCATTGAATTTGTTAGGTGGCACAGCTAATTTTCAACTTTGCAGCAACTTTAACCAGTATATTCTTATTCTTATTCTCAG
>TTN-206,,0,101,1398435,1398535,GTGAGACATATGATCATTTGCTTTCTGCAATAATTGCCATAGACTTATTTCTTAGTCCCCCTACCCCAAATGCTAAATTGAAACCCTACCTTTTTTTCCAG
>TTN-206,,0,130,1398536,1398665,GTAAGTGCCCTTTCAACCACAAAATTATAAACATTATTTCAGCACTTTTCTGTTTTTAAATGAAAGTCATTGGCTTATAATACTTGGGACTGTATTCTAATACATGTGTGCTTTCCACTTATATTTACAG
>TTN-206,,0,106,1398666,1398771,GTAAGGAATTCAGAAGAAGGGGTTAAATTAAAGAAGCAAGCCATGTTTGGTCCTTTTATTTCACCAGTAAAGCTGACTCCCTTTTCATTATTTTAAAATATTTCAG
>TTN-206,,0,622,1398772,1399393,GTAAGTAGCCTTTGGTTCTCTACTTATGATTTACAAACTAAACAAGTTAAGGCTAATTCCCCCTCTATACTAAGTAGAACCCTGGAAAGCTTTATTGGAGAGCAAGTGTTAAGAAAGAAAAGCAAGTACACACACAGGAAATATGACAAGTTCTACAGGAAACCATTCCAAGCACACAACCTCAGCAGATGTTAGATGGAGTGAACTGAGCACTTTCCTTGAGTAATTCCCTCTAATGCAATGGTTTCTTTTTAAAAATATTTCCCAACAAGATTTGAAAGGTCAACAATTGTATGCCACTTCAATGAACCTAAGTAAGGGCAAGAATACTACAGAATTATAGAGAGAATTTACAGTCCCTTAAAAGCCTATACATTATTAATCCCCTTCCAATCATAAAGAGAAAAAAACACTCTACATAAAATGTGACGATGTGCTCATTGAATCCCTATTTACCATATGATCCTAGGAAAATCACTTCAAAGAGTTTTTAAGAATTAGGCTAATATGTAAATCATGGTATGTGTCAGTAAATAAGGTAAATTCATTCCTGATATACAAGGACAAAGGATTACAGATTGAGTATTAACAGTCACTTAATATTATCTTTCATATTGTTCAG
>TTN-206,,0,98,1399394,1399491,GTATTTTATTTTTATTTTCAGTGCTTTTTATTTTTAAAGAAAAAAAAATCTCAAAAACACACTATGAAAACCACCACAATTGTATTTTCCCCCAACAG
>TTN-206,,0,362,1399492,1399853,GTGAGTACAACTTGATTTCTGTATCTTCCTATGGTAAAGTTCCATCTTTGCATAAAATTCTTTTAAACAGAAAGAAATTTTGAAAGGAAATAGCAAAGATTCAGATAAAGTACAAGTGCCTTTTCTTTCACTTTAATTGAATGTTTGCATATCTAAAAGGAGAAATATATATCCTAACCCCATTGTAAAAATAGAACTTTGGTTTTTGATATGTCTTAGTATAAAGTAACCAATTTCATCTTTCTGGAATAGCTATTTTTTAACAAAATTTTGGACTCATATAACATTCTTTTTTAAAAAAATAAGCTTTAATAAAGCTGCCTGTTTCATCTCATGACTCAAATCTTTTTTTTGTTTAATAG
>TTN-206,,0,132,1399854,1399985,GTAAAAATAAATAAATTATCATCAAGTTGAGGCTAAATGAGTTATTAACTTGGGGGTGGAGGCTATTGCACTTAAACACATACTGTTAGATGTTGCTAAATTATATTCTTTTTTTTTTTTTTTCTGATACAG
>TTN-206,,0,124,1399986,1400109,GTAACCAGTTCTTAAATGTCTCTTTCTTTTATCTTCTAAAATATTTTATCTTCTAAATTCAGCTTCCCAAAAAAAGCTTAAAATGAAATCACTTTTTAAAACACAAATCATTTGCATTCTACAG
>TTN-206,,0,740,1400110,1400849,GTAGGTTGGCTTTTGTTTTTACCCACATTTCTTCAGAAGATAATATTAGGGAAATATTTTCAAACATCCCCCCTTATATACACATACAAGAAAGTATTAAAATAAAATTATTTTCCTAATTCCAGAATACAATTTGTACACCAAAGCAGAAACACACATTTGAAGTTAGCATATGCTTTTCTATGAGCATAAAAAGCAGTTATTAAGTACCTAGTTATATGTGGTATTATATAAGATTCCATAGTGTCAGCCCCTGCTCCCAGGAATATTTAAGAATAAAGTCAGTGAATATACAAAATGGCACTACTTGCCTAAACCTTCACAGTTGCTAATTTTCCAAAGCAGTGCAAAGTTAATTAAAGAACTATTTCTATTTTACCAATTAAAATTAGTTTGCTTTCATTTCAATCTTCTGAAAGATAATTTAATGTTTTGGTTACTCAAAATCTCCCAAATCCACTTATCTCCTAAATCCGTTGACTATTCTTTTCAAGACTTTTTTCCTTAAGTCATATGAATCATCTTTGGCTCAGTTTAGTTTAAGGAATCATTACAGTGATCTCAAAAGTCACACATGATAATTTTCCAAAAGTGGAACTGAGAAAGTATTAGGTATTACCTACATTGCATGAAGAAGTTGACTTTTTTTCTTTTTATGTTTTTCACACGCAGAATCTAGAAGAGTAAAAGGTGGGGGTCTCTTTCTAATTAAGTTTGCCTTACAGAGGTTTCTTTTTTAG
>TTN-206,,0,100,1400850,1400949,GTAAGTTTAATTATGAATATATTATTGAAGAAAAACTAAAATACCATGTCTTCCACATCTGAAGAACTTCAACATTTCTTTTCTTTTTCCTTTGTCTTAG
>TTN-206,,0,525,1400950,1401474,GTAAGTATCTCCTCACCCTTCTTCCTTACATGTTTAAGGCCTTTAGATCGTTTTTTTGCCTCTCTTTCAAGCACAGAAAACTCTAAGAAGCCTTATTAAATTCCATGTGAAAGAGGGACAGCCAACTGATGTGAATTCATTCTTGTAGTCAAACTTTCTTTATAGCTACACAGAAACTTGGATAGATTACATTTCAAAGTAAAGCTACCAACTGCCGTGTAACATTTATTTGCAGGATGCACAATATGTCAATTACTTTCTATATGACTAATCATTTTTCTCCTAGTGATTCCTAGCACCTGCATGTAATGTAATGATAGAAATATAAGGATTCATGTTTTGGAGACATTGAGCTAGCTCTTGACAAATGTATGTATATATGTATTTGCTTATGCTTCAACAGCAAATTGTTTGGGTTATGCTGCTGTGTGTGTGTTGAAGTTTCCATTTCTGTAAGTCAGCGTCATATGTCATCAATTAACCAGATGTCATTGATGTTCACTGTGTATCTGCTATGCTCCACAG
>TTN-206,,0,138,1401475,1401612,GTGAGCAATAAAATTACTGGTAGAGGTAGACAAGCCAAGTAACATGGTGTAGTCTTTAGTACACACAATTCAGTAGAAAGCAAATCTTTATTTTTTTCAGTGATTCTAAGACCTTTTTTTTGTCATTGTTCCATAAAG
>TTN-207,ENSE00001465556,1,212,1401613,1401824,GAGCAGTCGTGCATTCCCAGCCTCGCCTCGGGTGTAGGGATTGCATAGAAAAGCAAAACTACACAGTCTTGACTGTGTAGTTTTGTTTTTAGGATTAGAGGCTCACCGATTCATGTCGGAGATGGTCAGAAAAACCAACTCTCCATAGGACGTCGTTTCAGAAGCAACCTTGGGCTTAGTCCCACCCTTTTTAGGCACTCTTGAGAAATCAG
>TTN-207,ENSE00003502146,1,104,1401825,1401928,AGTGCCTAGAAAGATGACAACTCAAGCACCGACGTTTACGCAGCCGTTACAAAGCGTTGTGGTACTGGAGGGTAGTACCGCAACCTTTGAGGCTCACATTAGTG
>TTN-207,ENSE00003807606,1,204,1401929,1402132,GTTTTCCAGTTCCTGAGGTGAGCTGGTTTAGGGATGGCCAGGTGATTTCCACTTCCACTCTGCCCGGCGTGCAGATCTCCTTTAGCGATGGCCGCGCTAAACTGACGATCCCCGCCGTGACTAAAGCCAACAGTGGACGATATTCCCTGAAAGCCACCAATGGATCTGGACAAGCGACTAGTACTGCTGAGCTTCTCGTGAAAG
>TTN-207,ENSE00003810976,1,288,1402133,1402420,CTGAGACAGCACCACCCAACTTCGTTCAACGACTGCAGAGCATGACCGTGAGACAAGGAAGCCAAGTGAGACTCCAAGTGAGAGTGACTGGAATCCCTACACCTGTGGTGAAGTTCTACCGGGATGGAGCCGAAATCCAGAGCTCCCTTGATTTCCAAATTTCACAAGAAGGCGACCTCTACAGCTTACTGATTGCAGAAGCATACCCTGAGGACTCAGGGACCTATTCAGTAAATGCCACCAATAGCGTTGGAAGAGCTACTTCGACTGCTGAATTACTGGTTCAAG
>TTN-207,ENSE00003809662,1,86,1402421,1402506,GTGAAGAAGAAGTACCTGCTAAAAAGACAAAGACAATTGTTTCGACTGCTCAGATCTCAGAATCAAGACAAACCCGAATTGAAAAG
>TTN-207,ENSE00003809782,1,245,1402507,1402751,AAGATTGAAGCCCACTTTGATGCCAGATCAATTGCAACAGTTGAGATGGTCATAGATGGTGCCGCTGGGCAACAGCTGCCACATAAAACACCTCCCAGGATTCCTCCGAAGCCAAAGTCAAGATCCCCAACACCACCGTCTATTGCTGCCAAAGCACAGCTGGCTCGGCAGCAGTCCCCATCGCCCATAAGACACTCCCCTTCCCCGGTCAGACACGTGCGGGCACCGACCCCATCTCCGGTCAG
>TTN-207,ENSE00003805863,1,331,1402752,1403082,GTCCGTGTCTCCAGCAGCAAGAATCTCCACATCCCCCATCAGGTCTGTTAGGTCTCCATTGCTCATGCGTAAGACTCAGGCATCCACCGTGGCCACAGGTCCTGAAGTGCCTCCCCCTTGGAAGCAAGAGGGCTACGTGGCCTCCTCATCTGAGGCTGAGATGAGAGAGACAACGCTGACAACCTCTACTCAGATCAGGACAGAAGAGAGATGGGAAGGGAGATACGGTGTCCAGGAGCAAGTGACCATCAGTGGTGCTGCGGGTGCTGCCGCCAGTGTGTCGGCCAGTGCTAGCTACGCAGCAGAGGCTGTTGCCACTGGTGCTAAAGAG
>TTN-207,ENSE00003803639,1,153,1403083,1403235,GTGAAACAAGATGCTGACAAAAGTGCAGCTGTTGCGACTGTTGTTGCTGCCGTTGATATGGCCAGAGTGAGAGAACCAGTGATCAGCGCTGTAGAGCAGACTGCTCAGAGGACAACCACGACTGCTGTGCACATCCAACCTGCTCAAGAACAG
>TTN-207,ENSE00003810843,1,138,1403236,1403373,GTAAGAAAGGAAGCGGAGAAGACTGCTGTAACTAAGGTAGTAGTGGCCGCCGATAAAGCCAAGGAACAAGAATTAAAATCAAGAACCAAAGAAGTAATTACCACAAAGCAAGAGCAGATGCACGTAACTCATGAGCAG
>TTN-207,ENSE00003803899,1,126,1403374,1403499,ATAAGAAAAGAAACTGAAAAAACATTTGTACCAAAGGTAGTAATTTCCGCAGCTAAAGCCAAAGAACAAGAAACTAGAATTTCTGAAGAAATTACTAAGAAACAGAAACAAGTAACTCAAGAAGCA
>TTN-207,ENSE00003808716,1,138,1403500,1403637,ATAAGACAGGAAACTGAGATAACTGCTGCATCCATGGTGGTAGTTGCCACTGCAAAGTCCACAAAACTAGAAACAGTCCCGGGAGCTCAAGAAGAAACTACCACACAACAAGATCAAATGCACCTAAGTTATGAAAAG
>TTN-207,ENSE00003809802,1,138,1403638,1403775,ATAATGAAGGAAACTAGGAAAACAGTTGTACCTAAAGTCATAGTTGCCACACCCAAAGTCAAAGAACAAGATTTAGTATCAAGAGGTAGAGAAGGCATTACTACCAAAAGAGAACAAGTGCAAATAACTCAGGAGAAG
>TTN-207,ENSE00003805623,1,138,1403776,1403913,ATGAGAAAGGAAGCCGAGAAAACTGCCTTGTCTACAATAGCAGTTGCTACTGCTAAAGCCAAAGAACAAGAAACAATACTGAGAACTAGAGAAACTATGGCTACTAGACAAGAACAAATCCAAGTTACCCATGGAAAG
>TTN-207,ENSE00003801659,1,294,1403914,1404207,GTGGACGTTGGAAAAAAGGCTGAAGCTGTAGCAACAGTTGTTGCTGCAGTAGACCAGGCCCGAGTCAGAGAGCCCAGAGAGCCTGGGCATCTTGAAGAATCCTATGCTCAGCAGACCACTTTGGAGTACGGATATAAGGAACGCATTTCCGCCGCAAAGGTAGCTGAGCCTCCCCAACGTCCAGCCTCAGAACCCCACGTTGTCCCTAAAGCAGTCAAGCCTAGAGTAATCCAGGCTCCTTCTGAGACTCATATCAAAACTACTGATCAAAAGGGAATGCACATATCATCACAG
>TTN-207,ENSE00003804455,1,123,1404208,1404330,ATCAAGAAAACTACAGATCTAACAACGGAAAGATTAGTCCATGTGGATAAACGCCCCCGCACAGCTAGCCCTCACTTTACTGTTTCAAAAATTTCTGTTCCTAAGACAGAACATGGATATGAG
>TTN-207,ENSE00003810306,1,282,1404331,1404612,GCATCAATAGCCGGTAGTGCTATTGCCACATTACAAAAAGAGTTGTCAGCCACATCTTCTGCTCAGAAGATCACCAAATCGGTGAAGGCTCCTACTGTGAAGCCCAGTGAGACTAGAGTAAGGGCAGAGCCCACACCCTTGCCACAGTTCCCCTTCGCTGACACACCAGATACTTACAAGAGTGAAGCTGGCGTTGAGGTGAAAAAGGAAGTAGGGGTGAGCATCACTGGCACCACCGTCCGTGAAGAGCGCTTTGAAGTACTGCACGGACGCGAAGCCAAG
>TTN-207,ENSE00003805296,1,66,1404613,1404678,GTAACAGAAACAGCAAGAGTACCAGCACCTGTTGAAATTCCTGTTACTCCACCAACTTTGGTCTCG
>TTN-207,ENSE00003806123,1,259,1404679,1404937,GGCTTAAAAAATGTGACTGTCATAGAAGGTGAATCTGTCACCTTGGAGTGCCACATCTCTGGATACCCATCCCCGACAGTGACATGGTACAGGGAAGACTACCAAATCGAAAGTTCCATTGACTTCCAGATAACCTTCCAGAGTGGAATTGCTCGTCTTATGATTCGCGAAGCATTTGCGGAAGACAGCGGGCGATTTACTTGCAGTGCTGTAAATGAGGCTGGAACCGTCAGCACATCCTGCTATCTGGCTGTGCAGG
>TTN-207,ENSE00003808554,1,64,1404938,1405001,TGTCAGAAGAATTTGAAAAGGAAACCACAGCCGTGACTGAGAAATTTACTACAGAAGAGAAACG
>TTN-207,ENSE00003804962,1,216,1405002,1405217,CTTTGTTGAGTCAAGAGATGTGGTTATGACTGATACTAGCCTCACAGAGGAACAAGCAGGGCCTGGAGAACCTGCCGCGCCTTACTTTATTACAAAACCAGTGGTCCAGAAACTGGTGGAAGGTGGGAGCGTGGTGTTTGGATGCCAAGTTGGCGGCAACCCAAAGCCCCATGTATACTGGAAAAAATCTGGTGTTCCTCTAACCACTGGATACAG
>TTN-207,ENSE00003804165,1,143,1405218,1405360,ATACAAAGTGAGTTACAACAAACAAACCGGTGAATGCAAGCTGGTGATTTCTATGACTTTTGCTGATGATGCTGGAGAATACACTATTGTTGTTCGCAATAAGCATGGAGAAACTTCTGCATCTGCTTCCTTGCTTGAAGAAG
>TTN-207,ENSE00003802603,1,206,1405361,1405566,CTGATTATGAGTTACTGATGAAGTCCCAGCAAGAAATGCTTTATCAGACACAAGTGACTGCATTTGTTCAAGAACCTAAAGTTGGAGAAACAGCACCTGGATTTGTATACTCTGAGTATGAAAAAGAGTATGAAAAAGAACAAGCCTTAATTAGGAAGAAAATGGCCAAAGATACTGTAGTGGTCAGAACTTATGTAGAAGATCAG
>TTN-207,ENSE00003807963,1,234,1405567,1405800,GAATTCCATATTTCTTCCTTTGAAGAGAGACTTATTAAAGAAATTGAATATAGAATAATAAAGACTACATTAGAAGAACTTCTTGAAGAAGATGGAGAAGAAAAGATGGCAGTTGACATTTCTGAATCTGAAGCTGTTGAATCAGGATTTGATTCAAGAATCAAGAATTATAGAATTCTTGAGGGGATGGGTGTCACTTTTCATTGCAAGATGTCTGGATATCCATTACCAAAG
>TTN-207,ENSE00003808968,1,245,1405801,1406045,ATTGCTTGGTACAAAGATGGCAAGCGCATCAAACATGGAGAAAGATACCAAATGGACTTTCTACAAGATGGCAGAGCTAGTCTGCGTATACCTGTTGTTCTTCCAGAAGATGAAGGAATCTACACTGCATTTGCCAGCAATATTAAAGGAAATGCAATTTGCTCAGGGAAATTGTATGTGGAGCCTGCTGCACCACTTGGAGCTCCGACTTACATTCCCACACTAGAGCCAGTGAGCAGAATCAG
>TTN-207,ENSE00003802614,1,272,1406046,1406317,ATCTCTCTCTCCACGTTCAGTGAGCAGGTCTCCTATACGCATGTCTCCTGCACGGATGTCACCTGCAAGGATGTCTCCTGCACGGATGTCCCCTGCAAGAATGTCCCCTGGACGTAGGCTGGAGGAGACAGATGAGTCACAACTTGAGAGACTATATAAACCAGTCTTTGTGTTAAAACCTGTTTCTTTCAAATGTTTAGAAGGGCAAACTGCCAGATTTGACTTAAAGGTTGTTGGTAGACCTATGCCAGAGACGTTCTGGTTTCATGATG
>TTN-207,ENSE00003811446,1,165,1406318,1406482,GCCAGCAAATTGTCAATGACTATACCCATAAAGTAGTCATTAAAGAAGATGGTACTCAATCACTAATTATTGTCCCTGCCACACCCAGTGATTCTGGGGAATGGACTGTGGTTGCCCAAAACAGGGCAGGCAGATCTTCAATTTCAGTGATTTTAACTGTGGAAG
>TTN-207,ENSE00003805710,1,169,1406483,1406651,CTGTGGAACATCAGGTAAAACCGATGTTTGTAGAAAAACTGAAAAATGTCAATATAAAGGAAGGTTCCCGACTTGAAATGAAAGTCAGAGCTACGGGTAACCCCAACCCTGACATTGTATGGTTGAAAAACAGTGACATCATTGTGCCTCATAAATATCCCAAAATCAG
>TTN-207,ENSE00003809358,1,1694,1406652,1408345,AATTGAAGGAACCAAGGGAGAAGCTGCCCTTAAAATCGATTCCACTGTCAGCCAAGATTCTGCCTGGTATACTGCGACTGCTATTAATAAAGCTGGCAGAGACACTACAAGATGCAAAGTAAATGTTGAAGTTGAGTTTGCAGAGCCTGAGCCAGAGAGAAAGTTAATCATCCCACGGGGGACATATAGAGCAAAGGAGATTGCAGCCCCAGAACTGGAGCCCCTCCATTTGCGATATGGCCAAGAGCAATGGGAAGAAGGTGATCTCTATGACAAAGAGAAACAACAGAAACCATTTTTCAAGAAAAAACTCACTTCCTTAAGACTTAAGCGCTTTGGGCCTGCCCACTTTGAATGCAGGCTAACACCCATTGGTGACCCAACGATGGTGGTGGAGTGGCTCCATGATGGAAAGCCACTTGAAGCAGCCAACAGGCTCCGTATGATCAATGAATTTGGGTACTGCAGCCTTGATTATGGCGTTGCATATTCTAGAGACAGTGGTATCATTACTTGCAGAGCCACTAACAAATATGGAACAGATCACACATCTGCTACCCTTATTGTTAAAGATGAGAAAAGTCTTGTGGAAGAATCCCAATTGCCTGAGGGGAGGAAAGGCTTACAGAGAATTGAAGAATTAGAGAGAATGGCTCATGAAGGTGCACTTACAGGTGTAACAACAGATCAGAAAGAAAAGCAAAAGCCAGACATTGTCTTGTACCCAGAGCCAGTTAGAGTACTTGAAGGGGAGACTGCAAGGTTCCGCTGCAGGGTAACAGGCTACCCTCAGCCCAAAGTCAACTGGTACCTCAATGGACAGCTCATCCGCAAAAGCAAAAGGTTCAGAGTTCGCTATGATGGTATCCATTACCTGGACATCGTGGACTGCAAATCATATGACACAGGTGAAGTGAAGGTCACCGCGGAAAATCCTGAAGGTGTGATAGAGCATAAAGTGAAGCTTGAGATTCAACAGAGGGAAGATTTTAGGTCTGTCCTTAGGAGAGCTCCTGAACCAAGGCCTGAGTTTCACGTACATGAACCAGGAAAGCTTCAGTTTGAAGTACAAAAAGTGGATAGACCTGTTGACACCACTGAAACCAAAGAAGTTGTGAAGTTGAAAAGGGCTGAAAGAATTACCCATGAAAAAGTGCCTGAAGAGTCGGAAGAGCTGCGCAGTAAATTCAAGCGCAGAACAGAAGAGGGCTATTATGAAGCCATTACCGCTGTGGAGCTCAAGTCTCGAAAGAAGGATGAATCCTATGAGGAACTCCTCAGGAAGACAAAAGATGAACTTCTCCACTGGACCAAAGAGTTAACTGAAGAGGAAAAGAAAGCTCTTGCCGAAGAAGGCAAAATCACGATTCCAACTTTTAAACCTGACAAGATTGAACTAAGTCCTAGTATGGAGGCTCCAAAAATCTTCGAAAGAATCCAGAGCCAAACAGTGGGCCAAGGATCTGATGCACACTTCCGGGTCAGAGTCGTGGGGAAACCAGACCCCGAATGTGAATGGTACAAAAATGGTGTCAAAATTGAACGGTCTGACCGGATCTACTGGTACTGGCCCGAAGACAATGTTTGTGAATTGGTCATAAGAGATGTGACTGCTGAGGACTCTGCCAGCATCATGGTAAAAGCCATCAACATAGCTGGAGAAACCTCCAGTCACGCATTCTTACTTGTCCAAG
>TTN-207,ENSE00003809440,1,282,1408346,1408627,CCAAGCAATTGATCACTTTCACACAGGAATTACAAGATGTTGTTGCTAAGGAAAAAGACACTATGGCAACCTTTGAATGTGAAACTTCAGAACCATTTGTCAAAGTGAAATGGTATAAAGATGGTATGGAGGTTCATGAGGGAGATAAATACAGGATGCACTCTGACAGAAAGGTTCACTTCCTCTCCATACTGACCATTGATACGTCTGATGCTGAAGATTACAGCTGTGTACTTGTGGAAGATGAAAATGTCAAAACGACTGCTAAACTTATTGTTGAAG
>TTN-207,ENSE00003802960,1,267,1408628,1408894,GTGCAGTTGTTGAGTTTGTGAAAGAACTTCAGGACATAGAAGTTCCAGAATCATATTCAGGAGAATTAGAGTGCATTGTATCCCCAGAAAATATAGAAGGAAAATGGTATCATAATGATGTGGAGCTTAAATCCAATGGCAAATATACAATTACATCTCGTCGTGGACGTCAGAACCTCACGGTCAAGGATGTAACCAAGGAGGACCAGGGAGAATACAGCTTTGTCATCGACGGGAAAAAGACAACCTGTAAATTAAAGATGAAAC
>TTN-207,ENSE00003804241,1,273,1408895,1409167,CCCGCCCCATTGCTATCCTACAAGGACTTAGTGACCAAAAAGTCTGTGAGGGTGACATTGTTCAGCTTGAAGTTAAAGTCTCCTTGGAAAGTGTGGAAGGCGTCTGGATGAAAGACGGCCAAGAAGTGCAGCCCAGTGACAGGGTTCACATTGTGATAGACAAACAATCTCATATGCTGCTCATTGAAGACATGACTAAGGAAGATGCTGGAAATTACTCTTTCACCATTCCAGCCCTTGGCCTCTCCACCAGTGGGCGTGTCTCTGTCTATA
>TTN-207,ENSE00003806988,1,264,1409168,1409431,GTGTGGACGTGATAACACCTCTAAAAGATGTTAATGTGATTGAAGGCACCAAGGCTGTGCTTGAATGTAAGGTGTCAGTCCCTGATGTGACTTCTGTTAAGTGGTACTTAAATGATGAACAAATCAAGCCTGATGACCGTGTACAGGCCATTGTGAAAGGTACTAAACAGCGACTAGTCATTAACCGAACTCATGCTTCAGACGAAGGACCTTACAAGCTGATAGTTGGCAGAGTTGAAACCAACTGTAATCTCTCTGTAGAAA
>TTN-207,ENSE00003804968,1,261,1409432,1409692,AAATTAAAATTATCAGAGGTCTTCGTGACCTTACCTGTACAGAAACTCAAAATGTGGTGTTTGAGGTTGAGCTGTCCCACTCTGGAATTGATGTCCTGTGGAATTTTAAGGACAAGGAAATCAAGCCCAGTTCTAAATATAAAATTGAAGCACATGGAAAAATATATAAATTGACAGTTCTAAATATGATGAAAGATGATGAAGGAAAATACACATTTTACGCGGGAGAAAATATGACATCTGGAAAACTTACTGTGGCAG
>TTN-207,ENSE00003809850,1,261,1409693,1409953,GTGGGGCCATCTCCAAGCCACTCACAGATCAGACCGTAGCTGAATCCCAGGAAGCTGTGTTTGAATGTGAAGTTGCCAACCCAGATTCCAAAGGCGAATGGTTGAGGGATGGCAAACACCTACCACTGACTAACAACATCAGAAGTGAGTCTGATGGCCACAAAAGGAGACTTATCATTGCTGCCACCAAATTAGATGACATTGGAGAATATACCTACAAGGTGGCCACCTCCAAAACATCTGCCAAACTCAAAGTTGAAG
>TTN-207,ENSE00003806479,1,264,1409954,1410217,CTGTCAAAATTAAGAAGACTCTGAAGAACCTCACAGTGACAGAAACACAGGATGCTGTTTTCACTGTCGAGCTTACACACCCTAATGTCAAAGGTGTCCAGTGGATCAAAAATGGAGTTGTGCTGGAATCCAATGAAAAGTATGCTATCTCTGTCAAAGGAACAATTTACTCTCTGAGGATTAAAAACTGTGCCATCGTGGATGAGTCTGTTTATGGCTTCAGGCTTGGAAGGCTTGGAGCCAGTGCCAGACTGCACGTGGAGA
>TTN-207,ENSE00003804523,1,261,1410218,1410478,CTGTCAAGATCATTAAAAAGCCAAAGGATGTGACAGCCTTGGAAAATGCCACTGTTGCCTTTGAAGTTAGTGTTTCCCATGACACTGTTCCAGTAAAATGGTTCCATAAGAGTGTGGAAATTAAGCCAAGTGACAAACACAGACTGGTCTCAGAAAGGAAAGTCCACAAGCTGATGCTGCAGAACATCTCCCCCTCAGATGCTGGGGAATACACAGCTGTGGTCGGGCAATTGGAATGCAAAGCAAAACTGTTTGTGGAGA
>TTN-207,ENSE00003807378,1,261,1410479,1410739,CATTACATATTACAAAAACCATGAAAAATATCGAGGTGCCTGAGACCAAAACTGCCTCTTTTGAGTGTGAGGTGTCCCACTTCAATGTCCCTTCCATGTGGCTGAAGAATGGTGTGGAAATTGAGATGAGTGAAAAGTTCAAGATAGTTGTGCAGGGAAAACTCCATCAGCTGATCATCATGAACACCAGCACAGAGGACTCGGCAGAATACACATTTGTCTGTGGCAATGACCAAGTCAGTGCCACCCTGACAGTCACCC
>TTN-207,ENSE00003807271,1,261,1410740,1411000,CAATCATGATTACTTCCATGCTGAAAGACATCAACGCTGAAGAAAAAGACACTATTACTTTTGAGGTGACAGTGAACTATGAAGGCATCTCTTACAAATGGTTAAAGAATGGTGTGGAAATCAAATCAACTGACAAGTGCCAGATGAGAACCAAAAAGCTCACACACTCACTGAACATCAGGAATGTTCACTTTGGGGATGCTGCTGACTACACCTTTGTGGCTGGAAAAGCAACATCAACAGCCACACTTTATGTGGAAG
>TTN-207,ENSE00003808172,1,142,1411001,1411142,CTCGTCATATAGAATTTAGGAAACACATTAAGGACATTAAGGTACTGGAGAAGAAGCGAGCCATGTTTGAATGTGAAGTTTCTGAACCTGACATCACTGTACAGTGGATGAAAGATGACCAGGAACTGCAGATCACAGACAG
>TTN-207,ENSE00003808223,1,166,1411143,1411308,AATAAAGATTCAGAAGGAGAAATATGTCCACCGCCTTCTGATCCCATCCACCCGGATGTCTGATGCTGGGAAGTACACAGTGGTGGCAGGAGGCAACGTGTCAACTGCAAAACTCTTTGTAGAAGGCAGAGATGTTCGCATCCGAAGTATTAAAAAGGAGGTTCAG
>TTN-207,ENSE00003810851,1,232,1411309,1411540,GTCATTGAGAAACAGCGTGCTGTTGTTGAATTTGAGGTCAATGAAGACGATGTTGATGCCCACTGGTATAAAGATGGCATTGAAATCAATTTCCAAGTTCAAGAACGACACAAATATGTAGTGGAAAGAAGAATCCACCGAATGTTTATCTCTGAGACCAGACAGAGCGATGCAGGAGAATACACCTTTGTGGCAGGAAGGAACAGGAGTTCTGTCACTCTCTATGTCAATG
>TTN-207,ENSE00003802092,1,285,1411541,1411825,CTCCTGAACCGCCCCAAGTTCTGCAGGAGCTCCAGCCTGTCACTGTGCAGTCTGGCAAGCCTGCCCGCTTCTGTGCCGTGATATCCGGAAGACCACAGCCCAAAATTTCCTGGTACAAGGAAGAGCAGCTGCTTTCCACTGGCTTCAAGTGCAAATTTCTTCATGATGGGCAAGAATACACGCTTTTGCTAATTGAAGCCTTCCCAGAGGATGCGGCAGTCTATACCTGTGAAGCCAAGAATGACTATGGTGTTGCCACAACATCAGCTTCACTCTCAGTGGAAG
>TTN-207,ENSE00003807103,1,126,1411826,1411951,TTCCAGAAGTTGTGTCTCCTGATCAGGAAATGCCTGTTTATCCACCTGCCATCATCACCCCGCTTCAGGACACTGTCACTTCTGAAGGGCAGCCAGCCCGTTTTCAATGCCGGGTTTCTGGAACAG
>TTN-207,ENSE00003801355,1,189,1411952,1412140,ATCTAAAAGTGTCGTGGTACAGCAAAGACAAGAAAATCAAGCCATCTCGGTTCTTTAGAATGACTCAATTTGAAGACACTTATCAACTGGAAATTGCCGAAGCTTATCCAGAAGATGAAGGAACTTACACGTTTGTTGCTAGTAATGCTGTAGGCCAAGTATCAAGCACAGCCAACCTGAGTCTGGAAG
>TTN-207,ENSE00004024281,1,375,1412141,1412515,GATTTAGCAAATTTGAAGAAAATACATCAAACTCCCAATGGCATGTCTCTTTATCAGTTTCATTTAAGAAGGAGCCCCTTGGCCAAAAGCCCAGCTTCATCCAGCCTCTGTCAAGCCTCAGGGTGCACAACGGGGAGACAGTCAGATTTCATGCGAGGGTTTCTGGCATTCCCAAGCCAGAAATCCAATGGTTTCATAACCAGCAGCTAATTCTACCAACAAAAGATGTAGTTTTCCATTTTGAGGAGTCCACAGGCATGGCTTTAATGCTTATAGTTGATGCTTACTCAGAGCATGCTGGGCAGTACTCTTGCAAAGCAGCCAATAGTGCTGGGGAAGCCACTTGTGCAGCTACACTCACAGTGACTCCAAAAG
>TTN-207,ENSE00004024285,1,576,1412516,1413091,TGCAAGCCCTAGATAGGCAAAGTTCTGGGAAAGATGTAAGAGAGTCCACCAAGTCCCAGGCAGTGGCAGATTCCTCTTTCACAAAGGAGGAGAGCAAAATATCTCAAAAGGAAATTAAGTCATTTCAAGGATCATCATATGAATATGAAGTGCAGGTTTTTGAAAGTGTATCTCAAAGTTCCATCCACACAGCTGCATCTGTTCAAGATACACAGTTGTGCCATACTGCATCCCTTTCACAAATTGCAGAAAGCACTGAGCTATCTAAGGAATGTGCTAAAGAGTCCACGGGTGAGGCGCCCAAGATTTTCCTGCATCTTCAGGACGTCACTGTAAAGTGCGGTGACACGGCTCAATTCCTCTGTGTTTTAAAAGATGATTCTTTCATTGATGTAACCTGGACTCACGAAGGTGCAAAGATAGAGGAATCCGAGAGACTGAAACAATCACAAAATGGAAATATTCAGTTTCTTACCATATGTAATGTTCAGCTGGTAGACCAAGGACTATACAGCTGCATTGTACACAATGACTGTGGAGAGAGGACAACGTCAGCAGTACTAAGTGTAGAAGGTG
>TTN-207,ENSE00003810791,1,57,1413092,1413148,CTCCTGAATCAATTTTGCATGAGAGGATTGAACAAGAGATTGAGATGGAAATGAAAG
>TTN-207,ENSE00004024265,1,2781,1413149,1415929,AGTTTTCTAGTTCTTTTCTGTCTGCCGAGGAAGAAGGACTTCATAGCGCCGAACTTCAATTATCTAAAATAAATGAAACACTTGAACTTTTGTCTGAATCTCCAGTTTACCCAACTAAATTTGATTCCGAAAAGGAAGGCACTGGCCCAATTTTCATCAAAGAAGTGTCAAATGCTGATATAAGCATGGGGGATGTGGCTACACTGTCTGTAACTGTCATTGGCATCCCCAAACCTAAAATTCAGTGGTTCTTTAATGGAGTGCTATTAACCCCTTCTGCTGACTACAAATTTGTTTTTGACGGTGATGATCATAGCCTGATCATTCTGTTCACCAAATTGGAGGATGAGGGAGAGTATACATGTATGGCCAGTAATGACTATGGAAAGACAATATGTAGTGCCTATCTAAAAATTAATTCCAAAGGAGAGGGTCACAAAGACACTGAAACAGAATCAGCAGTGGCAAAATCTCTGGAAAAGCTGGGAGGTCCTTGTCCTCCTCACTTCCTTAAGGAGTTAAAACCAATTCGCTGTGCTCAAGGGCTTCCTGCCATCTTTGAGTACACAGTGGTTGGAGAGCCTGCCCCTACTGTTACATGGTTCAAAGAAAACAAGCAGCTTTGCACCAGTGTTTATTACACTATCATTCATAACCCTAATGGCTCTGGAACTTTCATTGTCAATGACCCTCAGAGGGAAGACAGTGGCCTCTATATCTGTAAAGCAGAGAATATGTTGGGTGAGTCCACCTGTGCAGCAGAGCTGCTTGTGCTTCTGGAAGACACAGACATGACTGATACCCCCTGCAAAGCAAAGTCCACACCAGAGGCTCCTGAGGATTTTCCACAGACACCCTTAAAGGGTCCCGCAGTTGAAGCACTTGACTCAGAGCAGGAAATTGCAACGTTTGTAAAAGACACCATTTTGAAAGCTGCTTTAATTACAGAAGAAAACCAGCAACTATCTTATGAGCATATTGCTAAAGCCAATGAATTGAGCAGTCAGCTTCCTTTGGGAGCTCAGGAATTGCAATCCATTTTGGAGCAAGACAAGCTCACTCCTGAAAGCACCAGGGAATTTCTTTGCATCAATGGCAGTATTCACTTTCAGCCTCTCAAGGAACCATCTCCCAACCTACAGCTGCAGATTGTACAGTCCCAGAAAACCTTCTCCAAAGAAGGTATTCTAATGCCTGAAGAGCCTGAGACACAGGCAGTTCTATCAGATACCGAGAAAATCTTCCCAAGTGCCATGTCCATAGAACAAATTAATTCATTAACAGTTGAGCCTCTGAAAACTTTATTAGCTGAACCTGAAGGGAATTATCCACAGTCTTCAATAGAACCTCCAATGCATTCTTATCTAACCTCTGTGGCTGAGGAAGTACTTTCACCAAAAGAAAAGACAGTATCTGACACCAACAGAGAGCAAAGAGTGACTCTTCAAAAGCAAGAGGCACAAAGTGCGCTCATCTTGAGTCAGAGCTTAGCTGAGGGACACGTGGAGAGTCTCCAGAGTCCTGATGTCATGATCTCTCAGGTAAACTATGAGCCCCTAGTCCCTTCAGAACACTCATGCACAGAAGGAGGTAAAATTTTGATAGAAAGTGCAAATCCACTGGAAAATGCAGGGCAAGATTCTGCGGTCAGAATTGAGGAAGGCAAGTCCTTAAGATTTCCACTAGCACTTGAAGAAAAGCAGGTACTGCTCAAAGAAGAGCATTCTGACAACGTGGTGATGCCCCCAGACCAAATCATTGAGTCTAAAAGAGAGCCCGTGGCAATAAAGAAAGTGCAGGAGGTACAGGGAAGGGACCTTCTTTCTAAGGAAAGCTTGCTTTCTGGTATTCCAGAAGAGCAGAGATTAAACCTGAAAATTCAAATCTGCCGGGCTTTGCAAGCAGCCGTGGCCAGCGAGCAGCCAGGTCTTTTCTCTGAGTGGCTAAGAAATATTGAAAAGGTGGAGGTCGAGGCTGTAAACATCACCCAAGAGCCCAGACACATCATGTGCATGTACCTTGTTACTTCGGCAAAGTCTGTAACAGAAGAAGTAACCATCATTATTGAAGATGTTGATCCTCAAATGGCTAACCTGAAAATGGAACTTAGGGATGCTTTGTGTGCTATTATATATGAGGAAATAGACATCCTAACAGCTGAGGGTCCTAGAATTCAGCAAGGAGCCAAAACAAGTTTGCAAGAAGAAATGGATTCTTTTTCAGGTTCACAGAAGGTTGAACCCATTACTGAACCAGAAGTTGAATCTAAATATCTGATCTCAACTGAAGAGGTCAGTTATTTTAACGTGCAAAGTAGGGTTAAATATTTGGATGCCACACCTGTCACTAAAGGGGTTGCTTCAGCTGTTGTCTCTGACGAAAAACAAGATGAGAGTCTGAAACCATCAGAGGAAAAAGAGGAGTCTTCCTCTGAAAGTGGTACTGAGGAGGTTGCTACAGTAAAGATACAGGAAGCTGAGGGTGGCTTAATCAAAGAGGATGGCCCCATGATACATACACCTTTAGTGGACACTGTTTCTGAGGAAGGTGATATTGTACACCTCACAACATCCATAACAAATGCTAAAGAGGTGAATTGGTATTTTGAGAATAAACTGGTGCCTTCAGATGAAAAGTTCAAGTGTTTACAAGATCAAAATACATATACGCTAGTCATCGACAAAGTAAATACCGAAGACCATCAAGGAGAGTATGTCTGTGAGGCCTTGAATGACAGCGGAAAAACAGCAACTTCAGCCAAACTCACTGTAGTAAAAAGAG
>TTN-207,ENSE00003805227,1,279,1415930,1416208,CTGCCCCAGTGATCAAGAGGAAAATCGAACCCCTGGAAGTAGCACTGGGCCACCTAGCCAAATTCACCTGTGAGATCCAAAGTGCTCCCAATGTCCGGTTCCAGTGGTTTAAAGCTGGCCGAGAAATTTATGAGAGTGACAAGTGTTCTATTCGATCTTCAAAGTATATCTCCAGCCTTGAAATCCTGAGAACCCAGGTGGTTGACTGCGGCGAGTATACATGCAAAGCTTCCAATGAGTATGGCAGTGTCAGCTGTACAGCCACACTAACTGTGACAG
>TTN-207,ENSE00003808619,1,564,1416209,1416772,AGGCATATCCACCAACCTTTCTCTCCAGACCTAAGTCCCTTACAACTTTTGTGGGTAAGGCAGCCAAGTTCATCTGCACAGTGACAGGGACTCCTGTGATAGAAACCATTTGGCAGAAAGATGGTGCTGCACTCTCACCTTCACCTAACTGGAGGATTTCCGACGCAGAAAACAAACACATTTTAGAACTCTCAAACCTTACCATTCAAGATAGAGGAGTTTATTCTTGTAAGGCTTCCAACAAGTTTGGAGCAGACATCTGCCAAGCAGAGTTGATCATCATTGATAAGCCACATTTCATTAAAGAATTAGAGCCTGTGCAGTCCGCTATCAATAAGAAGGTCCACCTTGAGTGCCAAGTAGATGAAGACAGAAAAGTCACAGTTACGTGGAGCAAAGATGGGCAAAAACTCCCCCCAGGGAAAGATTATAAGATCTGTTTTGAAGATAAAATAGCAACACTTGAGATTCCTTTGGCCAAACTGAAAGATTCAGGAACCTATGTCTGTACAGCTTCAAATGAGGCTGGAAGCAGCTCCTGCTCAGCCACAGTCACTGTCAGAG
>TTN-207,ENSE00003811334,1,282,1416773,1417054,AGCCACCATCCTTCGTGAAGAAGGTGGATCCCTCTTATTTAATGCTCCCAGGTGAATCAGCACGCCTCCATTGCAAGCTGAAAGGCTCACCTGTGATCCAGGTTACTTGGTTTAAAAATAACAAAGAACTCAGTGAAAGTAACACAGTCCGAATGTATTTTGTCAATTCTGAGGCTATACTTGATATTACGGATGTAAAAGTTGAAGACAGTGGGAGTTACTCATGTGAAGCAGTGAATGACGTCGGCAGTGATAGCTGCAGTACTGAAATAGTTATCAAAG
>TTN-207,ENSE00003807496,1,279,1417055,1417333,AACCTCCTTCTTTCATCAAAACTCTTGAGCCTGCAGACATAGTGAGAGGAACAAATGCTCTACTTCAGTGTGAAGTCTCAGGCACTGGACCATTTGAAATTAGCTGGTTCAAAGACAAGAAACAAATTCGAAGTAGTAAAAAATACAGATTGTTTTCTCAGAAGTCTCTTGTGTGTCTGGAGATCTTTTCGTTTAATAGTGCAGATGTTGGTGAATATGAATGTGTTGTTGCTAATGAAGTCGGCAAGTGTGGCTGCATGGCAACCCACTTACTCAAAG
>TTN-207,ENSE00003806831,1,279,1417334,1417612,AACCTCCAACCTTTGTAAAGAAAGTAGATGATTTGATTGCACTAGGAGGACAAACCGTTACCCTGCAAGCTGCTGTGAGAGGGTCAGAGCCCATTTCTGTCACATGGATGAAAGGTCAAGAGGTCATCAGAGAAGACGGAAAAATCAAAATGAGCTTTTCCAATGGTGTTGCAGTCTTGATAATCCCTGATGTTCAGATTAGTTTTGGAGGCAAATACACGTGCCTGGCTGAAAATGAAGCTGGAAGCCAAACATCTGTTGGGGAATTAATAGTTAAAG
>TTN-207,ENSE00003801788,1,279,1417613,1417891,AACCTGCCAAAATCATTGAGCGAGCAGAACTGATCCAGGTGACAGCAGGAGATCCCGCCACACTGGAGTACACAGTGGCAGGCACGCCAGAACTGAAGCCCAAATGGTACAAAGATGGGAGACCCTTGGTCGCCAGTAAAAAATACCGAATAAGTTTTAAAAACAATGTTGCCCAGCTCAAATTTTATTCAGCTGAGCTGCACGACAGTGGCCAATACACATTTGAGATTTCCAATGAAGTGGGCAGCAGCTCCTGTGAGACTACATTCACTGTATTAG
>TTN-207,ENSE00003804186,1,288,1417892,1418179,ATCGAGACATTGCTCCATTTTTTACCAAACCCTTGCGCAACGTGGATAGTGTTGTTAATGGTACCTGCAGACTGGACTGCAAAATTGCAGGCTCCCTCCCCATGAGGGTGTCCTGGTTTAAGGATGGCAAAGAAATAGCTGCTTCTGACAGATACAGGATAGCATTTGTGGAAGGCACAGCCTCTTTGGAGATCATCAGAGTAGACATGAATGATGCAGGGAATTTCACTTGTCGAGCCACAAATTCCGTGGGAAGCAAAGACAGCAGTGGAGCCCTGATTGTGCAAG
>TTN-207,ENSE00003805178,1,279,1418180,1418458,AACCACCCAGTTTTGTAACTAAACCCGGCTCAAAGGATGTTCTGCCTGGCTCAGCAGTCTGCCTGAAGAGCACTTTCCAAGGATCTACTCCTCTCACAATCAGATGGTTTAAGGGCAACAAAGAGCTGGTTTCTGGTGGAAGCTGCTATATTACCAAAGAAGCTTTAGAGAGTTCCCTGGAACTCTATTTAGTAAAAACCTCTGATTCGGGCACGTACACATGTAAAGTCAGCAATGTCGCTGGAGGGGTGGAATGCAGTGCAAACTTGTTTGTAAAAG
>TTN-207,ENSE00003806856,1,282,1418459,1418740,AACCTGCCACATTTGTTGAAAAGTTAGAGCCATCACAGCTGTTAAAGAAGGGAGATGCCACCCAGCTAGCCTGCAAAGTAACTGGTACCCCTCCAATTAAAATAACATGGTTTGCAAATGATAGAGAAATTAAGGAGAGCAGCAAACACAGAATGTCTTTTGTGGAGTCTACTGCAGTTCTAAGACTGACAGATGTTGGCATCGAAGACAGTGGTGAATATATGTGTGAGGCCCAAAATGAGGCTGGCAGTGACCACTGCAGTAGCATTGTAATAGTCAAAG
>TTN-207,ENSE00003804074,1,279,1418741,1419019,AGTCACCTTATTTTACCAAGGAATTTAAGCCAATTGAAGTCTTAAAGGAGTACGATGTCATGTTGCTGGCTGAGGTGGCAGGCACTCCTCCCTTTGAGATCACTTGGTTCAAAGATAACACAATCCTGCGAAGTGGTAGAAAGTATAAGACTTTCATTCAGGATCATCTGGTTAGCCTGCAGATCCTCAAGTTTGTAGCTGCAGATGCTGGCGAATACCAGTGTCGGGTGACCAATGAGGTGGGCAGCAGCATCTGCAGTGCCAGGGTGACTTTAAGAG
>TTN-207,ENSE00003807057,1,279,1419020,1419298,AACCCCCATCCTTCATAAAGAAGATCGAGAGTACCAGCTCCCTCCGGGGAGGCACAGCTGCCTTCCAGGCCACTCTGAAGGGCTCCTTGCCAATTACGGTGACTTGGCTAAAAGACAGCGATGAAATCACTGAAGACGATAATATAAGAATGACCTTTGAGAACAATGTGGCCAGTTTGTACCTCAGTGGCATTGAAGTCAAGCATGATGGGAAATATGTCTGTCAGGCCAAAAATGATGCAGGAATACAAAGATGTTCTGCATTACTCTCAGTAAAAG
>TTN-207,ENSE00003807032,1,279,1419299,1419577,AACCTGCAACAATCACCGAGGAAGCTGTGTCTATAGATGTCACCCAAGGAGACCCAGCCACTTTGCAGGTTAAATTTTCAGGGACTAAGGAGATTACAGCCAAATGGTTTAAAGATGGCCAAGAACTGACCCTGGGCTCAAAATATAAAATCAGTGTCACTGATACAGTCTCAATACTGAAGATTATTTCTACAGAAAAGAAAGATAGTGGAGAATATACTTTCGAGGTCCAAAATGATGTTGGGAGGAGCAGCTGCAAGGCTAGAATTAATGTATTAG
>TTN-207,ENSE00003810010,1,288,1419578,1419865,ATCTTATCATACCTCCTTCATTCACCAAAAAGCTGAAGAAAATGGACAGCATTAAAGGTTCTTTCATTGATTTAGAATGTATAGTGGCTGGGTCACATCCCATAAGCATCCAGTGGTTCAAAGATGACCAAGAAATATCAGCTAGTGAAAAGTACAAATTCTCTTTTCATGACAATACTGCCTTCTTGGAAATCAGCCAGCTGGAAGGTACAGACAGTGGGACATACACTTGTTCTGCCACAAATAAGGCAGGGCACAACCAATGCAGTGGGCATCTGACAGTCAAAG
>TTN-207,ENSE00003805733,1,279,1419866,1420144,AACCCCCTTACTTTGTGGAAAAGCCACAGTCACAAGATGTCAATCCCAACACAAGGGTACAGTTAAAGGCTCTTGTGGGTGGCACTGCACCCATGACAATAAAGTGGTTTAAAGATAACAAAGAGTTACACTCAGGAGCAGCCCGCTCAGTTTGGAAGGATGACACCTCTACCAGTCTAGAGCTCTTTGCAGCCAAAGCTACCGATTCTGGAACCTACATTTGCCAACTAAGCAATGATGTTGGCACAGCAACCAGCAAAGCCACTCTCTTTGTAAAAG
>TTN-207,ENSE00003805836,1,282,1420145,1420426,AACCTCCTCAATTCATTAAGAAGCCCAGTCCAGTCTTAGTGCTGAGGAATGGACAGTCAACAACATTTGAATGCCAAATAACAGGCACTCCTAAAATCCGAGTGTCTTGGTATCTAGACGGGAATGAAATAACAGCCATTCAGAAACATGGCATTTCCTTCATTGATGGTTTAGCCACTTTCCAGATTTCTGGTGCCAGGGTAGAAAATAGTGGGACTTATGTGTGTGAAGCTCGAAATGACGCAGGCACGGCGAGCTGCAGCATTGAACTCAAAGTGAAAG
>TTN-207,ENSE00003802637,1,279,1420427,1420705,AACCCCCCACCTTTATCAGAGAGCTGAAGCCTGTGGAGGTAGTAAAATATAGTGACGTGGAGCTGGAGTGTGAAGTTACGGGAACACCTCCGTTTGAAGTCACTTGGCTGAAGAATAACAGGGAAATTCGAAGCAGCAAAAAATACACATTGACCGACAGAGTGTCTGTGTTTAACCTCCATATAACCAAGTGTGACCCTTCAGACACTGGGGAATACCAGTGCATTGTATCCAATGAAGGCGGCAGCTGCTCATGCAGTACTAGAGTTGCCCTGAAAG
>TTN-207,ENSE00003809504,1,279,1420706,1420984,AACCACCATCATTCATTAAGAAGATAGAAAATACCACTACTGTTTTGAAAAGTTCTGCCACCTTTCAGAGTACCGTGGCAGGTTCTCCTCCTATTTCTATAACCTGGCTAAAGGATGATCAGATTCTTGATGAAGATGATAATGTCTATATTTCATTTGTGGACAGTGTGGCCACACTTCAAATCAGAAGTGTGGATAATGGACACAGTGGGAGATATACCTGTCAAGCCAAGAATGAGTCAGGAGTTGAGAGGTGTTATGCTTTCCTTTTAGTACAAG
>TTN-207,ENSE00003802968,1,279,1420985,1421263,AACCAGCTCAAATCGTAGAGAAAGCTAAATCAGTTGATGTTACGGAGAAAGATCCCATGACCTTGGAATGTGTTGTGGCTGGAACACCAGAACTCAAAGTGAAATGGCTTAAAGACGGGAAACAAATAGTTCCCAGTAGATACTTTTCAATGAGTTTTGAAAATAACGTGGCCAGTTTTAGAATTCAGTCAGTAATGAAGCAGGACAGCGGTCAGTACACTTTCAAGGTGGAAAATGACTTCGGAAGCAGTAGCTGTGATGCCTACTTAAGAGTGCTAG
>TTN-207,ENSE00003810612,1,288,1421264,1421551,ATCAAAATATTCCTCCATCATTCACCAAAAAATTAACCAAAATGGATAAAGTTCTGGGCTCTTCTATTCATATGGAGTGCAAGGTGTCTGGTTCACTTCCCATTAGTGCTCAGTGGTTTAAGGATGGAAAAGAAATATCTACAAGTGCAAAATACAGACTTGTGTGCCATGAGAGATCTGTGTCTCTGGAAGTTAATAATCTGGAATTAGAAGATACTGCAAATTACACATGCAAAGTGTCAAATGTAGCAGGAGATGATGCATGCAGTGGCATCTTAACTGTGAAAG
>TTN-207,ENSE00003806423,1,279,1421552,1421830,AACCACCAAGCTTCCTAGTGAAACCTGGGCGACAGCAAGCCATACCTGATTCTACAGTGGAATTTAAGGCAATACTAAAAGGAACACCACCATTTAAAATAAAATGGTTTAAGGATGATGTGGAACTTGTCTCAGGTCCTAAATGTTTCATTGGCTTGGAAGGGTCGACTAGCTTCTTAAATCTCTACTCAGTGGATGCTTCTAAGACTGGACAGTATACTTGCCATGTTACCAATGATGTTGGTAGCGACTCTTGTACTACGATGTTGCTTGTGACAG
>TTN-207,ENSE00003805536,1,282,1421831,1422112,AACCACCAAAGTTTGTAAAGAAATTAGAAGCCTCCAAAATTGTGAAAGCAGGTGACTCTTCACGACTTGAATGCAAGATAGCTGGATCCCCAGAAATCAGAGTTGTGTGGTTCCGAAATGAACATGAACTTCCAGCCAGTGATAAGTACAGAATGACTTTCATTGACTCAGTGGCCGTCATACAGATGAACAATCTCAGTACTGAGGACAGTGGAGATTTCATTTGTGAGGCTCAGAATCCCGCTGGCAGCACAAGCTGCAGTACCAAGGTTATAGTAAAAG
>TTN-207,ENSE00003807762,1,279,1422113,1422391,AGCCACCTGTTTTTAGCAGCTTCCCTCCTATAGTAGAAACCCTTAAAAATGCTGAAGTCAGTCTTGAATGTGAACTTTCGGGAACACCACCGTTTGAGGTGGTATGGTACAAAGACAAGCGGCAACTCAGAAGCAGCAAGAAATACAAGATTGCATCCAAAAACTTCCACACAAGTATTCACATTCTCAATGTGGACACTTCAGACATCGGTGAATACCACTGCAAAGCACAGAATGAAGTGGGAAGTGATACTTGTGTTTGTACTGTAAAATTGAAAG
>TTN-207,ENSE00003809887,1,282,1422392,1422673,AACCACCAAGATTTGTCTCCAAACTGAACAGCCTCACTGTTGTAGCCGGAGAGCCTGCTGAATTACAAGCATCCATAGAAGGCGCCCAGCCTATTTTTGTCCAGTGGCTTAAAGAGAAGGAAGAAGTGATTAGAGAAAGTGAAAACATCAGGATTACATTTGTGGAAAATGTTGCAACTCTACAGTTTGCAAAAGCAGAGCCAGCTAATGCTGGAAAGTATATCTGCCAAATCAAGAATGATGGTGGAATGAGGGAGAACATGGCCACACTGATGGTCTTAG
>TTN-207,ENSE00003811356,1,279,1422674,1422952,AGCCCGCAGTCATTGTTGAGAAGGCAGGACCGATGACGGTGACTGTAGGAGAAACGTGCACTCTGGAGTGTAAGGTGGCTGGCACTCCGGAACTCTCTGTTGAATGGTACAAGGATGGAAAGCTGTTGACCAGCAGCCAAAAACACAAATTTAGCTTCTACAACAAAATCTCTTCCTTAAGGATTCTCTCAGTTGAAAGGCAAGATGCAGGCACATACACTTTCCAGGTTCAAAATAATGTTGGGAAAAGCAGCTGCACAGCTGTGGTTGATGTTTCAG
>TTN-207,ENSE00003804298,1,288,1422953,1423240,ACCGAGCAGTTCCTCCCTCTTTCACACGAAGACTGAAAAATACTGGTGGGGTGTTAGGTGCTTCTTGCATCTTGGAATGCAAAGTAGCTGGATCATCACCTATTTCAGTTGCCTGGTTTCATGAGAAAACCAAGATTGTCAGTGGAGCAAAGTACCAAACCACATTTTCAGATAATGTCTGCACATTGCAGTTGAATTCTCTGGATTCCTCAGATATGGGCAATTACACATGCGTGGCTGCTAATGTCGCTGGGTCTGATGAATGTCGTGCAGTGCTAACTGTACAAG
>TTN-207,ENSE00003807700,1,279,1423241,1423519,AACCACCCTCTTTTGTGAAAGAACCTGAACCTTTGGAAGTACTACCAGGCAAAAATGTAACCTTCACAAGCGTTATTAGAGGAACCCCTCCATTCAAAGTCAACTGGTTCAGAGGTGCCAGAGAACTAGTGAAAGGAGACCGGTGCAACATCTATTTTGAAGACACTGTGGCAGAACTGGAATTATTTAATATTGACATATCTCAGAGTGGGGAATACACCTGTGTGGTTTCTAACAACGCTGGCCAAGCATCTTGCACTACCCGTCTCTTTGTGAAAG
>TTN-207,ENSE00003803086,1,279,1423520,1423798,AACCAGCTGCATTTTTGAAGAGATTAAGTGATCATTCTGTAGAACCAGGGAAGTCCATAATTCTGGAGAGCACCTACACTGGAACACTTCCAATTTCTGTCACTTGGAAAAAGGATGGTTTTAACATAACTACCTCTGAAAAATGTAACATAGTCACAACAGAGAAAACTTGTATCCTGGAAATTCTGAATAGCACAAAAAGAGATGCAGGGCAGTATTCCTGCGAGATTGAAAATGAGGCAGGAAGGGATGTTTGTGGAGCTCTGGTATCTACATTAG
>TTN-207,ENSE00003806655,1,279,1423799,1424077,AACCGCCTTATTTTGTTACGGAACTGGAACCTCTGGAGGCAGCAGTTGGAGATTCGGTTTCTTTACAATGCCAAGTTGCTGGGACACCAGAAATTACAGTGTCTTGGTACAAAGGAGATACCAAATTACGGCCAACTCCTGAATACAGGACCTACTTTACAAACAATGTGGCCACACTTGTTTTTAATAAAGTGAACATCAATGACAGTGGAGAGTACACATGCAAAGCAGAAAATAGTATAGGAACTGCTTCTTCTAAGACTGTGTTCAGAATTCAAG
>TTN-207,ENSE00003805355,1,288,1424078,1424365,AGCGCCAACTCCCACCTTCTTTTGCAAGACAATTAAAGGACATTGAACAAACTGTGGGGTTACCTGTTACACTCACTTGTCGATTAAATGGCTCTGCACCCATCCAAGTGTGCTGGTATAGAGATGGAGTACTTTTAAGAGACGATGAAAATCTACAGACTTCATTTGTAGATAATGTGGCAACTTTAAAAATTTTGCAAACTGACTTGAGTCACTCTGGCCAGTACTCTTGCTCAGCTTCCAACCCACTTGGAACAGCATCTTCTAGTGCTAGACTCACAGCAAGAG
>TTN-207,ENSE00003804884,1,288,1424366,1424653,AACCCAAGAAATCTCCCTTCTTTGACATCAAGCCTGTATCTATAGATGTTATTGCTGGAGAAAGTGCTGATTTTGAGTGTCATGTTACTGGTGCTCAACCGATGCGAATCACTTGGTCAAAAGATAACAAGGAGATCCGTCCTGGAGGAAACTATACAATCACATGTGTGGGAAACACTCCTCATTTGAGAATTCTTAAAGTAGGCAAAGGAGACTCTGGTCAATATACTTGCCAAGCAACCAATGATGTTGGCAAAGACATGTGCTCAGCTCAGCTCAGTGTAAAAG
>TTN-207,ENSE00003805805,1,282,1424654,1424935,AACCTCCAAAGTTTGTTAAGAAATTAGAAGCTTCAAAAGTTGCAAAGCAGGGAGAATCCATTCAACTGGAATGTAAAATAAGTGGCTCCCCAGAAATCAAAGTTTCATGGTTCCGAAATGACAGCGAACTTCATGAAAGTTGGAAATACAACATGTCATTCATTAATTCTGTGGCATTGCTTACGATCAATGAAGCTAGTGCTGAAGACAGCGGGGACTACATTTGTGAGGCTCATAATGGTGTTGGTGACGCCAGCTGCAGCACAGCGTTGACAGTGAAAG
>TTN-207,ENSE00003803146,1,279,1424936,1425214,CACCTCCTGTTTTCACCCAGAAGCCTTCTCCAGTAGGAGCTCTTAAAGGTTCTGATGTGATTCTCCAATGTGAAATTTCGGGAACTCCCCCATTTGAAGTAGTATGGGTTAAAGATCGAAAGCAGGTTAGAAACAGCAAGAAATTTAAAATCACTTCAAAACATTTTGATACAAGTCTTCATATCCTTAATCTTGAAGCCTCCGATGTCGGGGAATATCACTGCAAAGCTACTAATGAGGTGGGAAGTGACACGTGTTCTTGCTCTGTCAAGTTCAAAG
>TTN-207,ENSE00003806016,1,282,1425215,1425496,AACCTCCACGATTCGTGAAAAAGCTAAGTGACACCTCAACCCTTATTGGGGATGCTGTTGAGTTACGGGCCATAGTGGAGGGCTTCCAGCCAATTTCTGTTGTCTGGCTGAAAGATAGAGGTGAAGTCATCAGAGAGAGTGAAAATACCAGGATTTCATTCATTGATAACATTGCAACCCTCCAGCTGGGGAGTCCAGAAGCATCTAATTCTGGAAAATATATATGCCAAATCAAAAACGATGCTGGAATGAGAGAATGCTCTGCAGTCTTGACTGTACTAG
>TTN-207,ENSE00003808302,1,279,1425497,1425775,AACCAGCAAGAATCATAGAGAAGCCCGAACCCATGACTGTCACTACTGGAAATCCTTTTGCATTAGAGTGTGTAGTGACTGGAACACCAGAACTCTCAGCCAAGTGGTTCAAAGATGGAAGAGAATTGTCTGCAGACAGCAAACATCACATTACATTCATCAATAAAGTGGCTTCCCTTAAAATCCCCTGTGCCGAAATGAGTGACAAAGGATTATATAGCTTTGAAGTGAAAAACAGTGTTGGCAAAAGTAACTGCACTGTATCCGTCCATGTTTCTG
>TTN-207,ENSE00003802442,1,288,1425776,1426063,ATCGGATTGTGCCTCCTTCCTTCATCCGCAAGCTGAAAGACGTGAATGCCATCCTGGGGGCCTCAGTTGTTTTGGAGTGCCGAGTCTCTGGCTCAGCCCCGATTTCAGTTGGCTGGTTTCAGGATGGAAATGAGATTGTTAGTGGGCCCAAATGTCAGTCCAGCTTTTCGGAAAACGTCTGTACTTTGAATCTGAGCTTGTTGGAGCCCTCCGACACAGGCATATACACGTGTGTGGCTGCCAATGTAGCTGGTTCCGATGAGTGCTCAGCAGTCCTGACTGTGCAAG
>TTN-207,ENSE00003809965,1,279,1426064,1426342,AACCACCATCTTTTGAACAAACCCCTGATTCTGTGGAAGTTTTGCCTGGAATGAGCCTCACATTCACCAGTGTCATCAGAGGCACCCCTCCTTTCAAGGTCAAGTGGTTTAAAGGCAGCAGGGAACTGGTGCCTGGGGAGTCATGCAACATCTCTCTGGAAGATTTTGTCACAGAACTGGAGTTGTTTGAGGTGCAGCCATTAGAAAGTGGAGACTATTCTTGCCTCGTTACAAATGATGCTGGCAGTGCTTCCTGTACCACACATCTTTTTGTGAAAG
>TTN-207,ENSE00003809650,1,279,1426343,1426621,AACCAGCCACCTTTGTGAAAAGATTGGCTGATTTCAGTGTTGAGACAGGAAGCCCCATAGTTCTCGAGGCCACATACACTGGCACACCTCCAATCTCAGTGAGCTGGATAAAGGACGAGTATCTTATTTCACAATCTGAGAGATGCAGTATTACTATGACAGAAAAATCTACCATACTGGAAATTCTTGAGAGCACAATAGAGGATTATGCACAGTACAGCTGCCTGATAGAAAATGAGGCTGGTCAAGATATCTGTGAAGCTCTGGTGTCTGTCTTAG
>TTN-207,ENSE00003810498,1,279,1426622,1426900,AACCACCGTACTTTATTGAACCTCTGGAACATGTGGAAGCAGTCATTGGAGAACCTGCAACTTTACAGTGTAAAGTGGATGGAACTCCAGAAATTAGAATTTCTTGGTATAAAGAACACACAAAGCTACGATCAGCTCCTGCATATAAAATGCAATTCAAAAATAACGTTGCTTCCTTAGTAATCAACAAAGTGGATCACAGTGATGTGGGAGAGTATTCATGCAAGGCAGACAACAGTGTGGGGGCAGTCGCTTCTTCAGCTGTGCTTGTTATCAAAG
>TTN-207,ENSE00003807178,1,288,1426901,1427188,CGCGCAAACTTCCACCTTTCTTTGCAAGAAAACTGAAAGACGTTCATGAGACTCTAGGCTTCCCAGTTGCATTTGAATGCCGCATCAATGGCTCAGAACCTCTTCAAGTGTCTTGGTACAAGGATGGGGTTCTTTTGAAAGATGATGCTAATTTGCAGACATCTTTTGTTCATAATGTAGCAACTCTTCAGATTTTACAAACTGACCAGAGCCACATAGGGCAGTATAATTGCTCTGCTTCTAATCCTCTTGGGACTGCTTCATCCAGTGCCAAGCTCATTCTCTCAG
>TTN-207,ENSE00003808579,1,288,1427189,1427476,AGCATGAAGTGCCTCCTTTCTTTGATCTAAAGCCTGTATCAGTAGATCTTGCTCTTGGAGAAAGTGGTACTTTTAAATGTCATGTAACTGGGACTGCACCAATCAAAATCACTTGGGCCAAAGATAACCGAGAGATTCGCCCTGGAGGCAACTACAAGATGACTTTGGTAGAAAATACTGCCACTCTGACAGTTCTCAAAGTAGGCAAAGGCGATGCCGGGCAGTACACCTGCTATGCAAGCAACATCGCTGGAAAAGACTCTTGTTCTGCTCAGCTGGGTGTACAAG
>TTN-207,ENSE00003801249,1,282,1427477,1427758,AACCACCCAGGTTCATTAAGAAGCTAGAACCTTCAAGAATTGTGAAACAGGATGAATTCACAAGGTATGAATGCAAAATCGGTGGGTCTCCAGAAATCAAAGTTTTATGGTATAAGGACGAGACTGAAATTCAAGAGAGCAGTAAATTCAGAATGTCATTCGTTGACTCGGTGGCTGTGCTGGAAATGCACAATCTCAGTGTTGAAGACAGTGGAGACTACACCTGTGAGGCCCACAATGCAGCAGGCAGTGCCAGCAGCAGCACATCCTTAAAAGTTAAAG
>TTN-207,ENSE00003810208,1,279,1427759,1428037,AACCACCCATTTTCCGCAAAAAGCCTCATCCTATAGAGACACTGAAAGGAGCTGATGTTCACCTTGAATGTGAGCTTCAGGGCACTCCCCCATTTCACGTTTCTTGGTATAAAGACAAGAGAGAACTTAGGAGCGGCAAGAAGTACAAGATAATGTCTGAGAACTTCCTAACCAGTATCCACATCCTGAATGTCGATGCTGCAGACATTGGGGAATATCAGTGTAAAGCCACAAATGATGTGGGAAGCGACACTTGCGTTGGTTCCATCGCTCTCAAAG
>TTN-207,ENSE00003802440,1,282,1428038,1428319,CACCACCAAGATTTGTGAAGAAGCTCAGTGACATATCTACTGTCGTTGGTAAAGAAGTTCAGCTGCAGACTACCATTGAAGGCGCTGAACCCATTTCAGTGGTGTGGTTCAAAGATAAGGGAGAAATCGTTAGAGAAAGTGACAACATATGGATTTCTTATTCAGAAAACATTGCAACCTTACAGTTTTCAAGAGTGGAACCAGCCAATGCTGGAAAATACACTTGTCAGATCAAAAACGATGCTGGGATGCAAGAGTGCTTCGCCACGCTATCCGTTCTCG
>TTN-207,ENSE00003802351,1,279,1428320,1428598,AGCCTGCAACAATTGTAGAAAAGCCAGAATCCATAAAAGTTACCACGGGAGACACCTGTACCTTGGAGTGTACAGTAGCTGGCACCCCTGAACTCAGTACTAAGTGGTTTAAGGATGGAAAAGAGCTAACAAGTGACAACAAATACAAAATAAGCTTCTTCAACAAAGTATCCGGCCTTAAGATCATCAATGTAGCACCGAGTGACAGTGGGGTATACAGTTTTGAGGTGCAGAACCCTGTTGGCAAAGACAGCTGCACAGCTTCATTGCAGGTTTCAG
>TTN-207,ENSE00003807933,1,288,1428599,1428886,ACCGAACCGTTCCTCCTTCATTCACAAGAAAATTGAAAGAGACAAATGGTCTATCCGGCTCCTCAGTTGTAATGGAGTGTAAAGTCTATGGGTCACCTCCAATCTCTGTCTCCTGGTTCCATGAAGGAAATGAGATCAGTAGTGGAAGGAAATACCAGACCACCCTGACAGATAATACTTGTGCTTTAACTGTGAACATGCTGGAAGAATCAGACAGTGGTGACTACACATGTATAGCTACTAATATGGCTGGTTCTGATGAATGTAGTGCTCCTTTGACTGTGAGAG
>TTN-207,ENSE00003804939,1,279,1428887,1429165,AACCACCATCTTTTGTTCAGAAACCTGATCCCATGGATGTTTTAACTGGGACCAATGTAACTTTCACAAGTATCGTAAAAGGAACACCTCCTTTCAGTGTTAGCTGGTTCAAAGGTAGCAGTGAACTAGTACCAGGTGACAGATGCAACGTGTCTTTGGAGGATTCAGTTGCTGAACTGGAGTTGTTCGATGTAGATACATCACAAAGTGGAGAATATACTTGCATAGTTAGCAATGAAGCTGGCAAGGCTTCTTGTACAACACATCTCTACATAAAAG
>TTN-207,ENSE00003810094,1,279,1429166,1429444,CCCCAGCCAAATTTGTGAAGAGGCTGAATGATTACAGCATAGAGAAAGGAAAACCCCTGATCCTAGAGGGTACATTCACTGGAACTCCTCCCATTTCGGTTACCTGGAAGAAAAATGGCATAAATGTAACTCCTTCTCAGAGGTGTAATATAACTACGACTGAAAAATCGGCAATCCTGGAAATTCCAAGTAGCACAGTAGAGGATGCAGGACAATACAACTGCTACATTGAAAATGCCTCTGGAAAAGATTCCTGTTCAGCACAAATACTCATACTAG
>TTN-207,ENSE00003811103,1,279,1429445,1429723,AACCACCGTATTTTGTCAAGCAGTTGGAGCCGGTTAAGGTGTCTGTTGGAGATTCTGCCTCTCTACAATGCCAGCTTGCTGGAACCCCTGAAATTGGGGTATCCTGGTATAAAGGAGATACAAAATTGAGACCCACTACGACTTACAAAATGCATTTTAGGAATAATGTTGCTACACTGGTTTTCAACCAGGTTGATATTAATGATAGTGGAGAATATATCTGCAAAGCTGAAAACAGCGTGGGAGAAGTTTCTGCATCAACTTTCCTTACCGTTCAAG
>TTN-207,ENSE00003801476,1,288,1429724,1430011,AGCAAAAACTTCCACCATCATTTTCTCGACAATTGAGAGATGTTCAAGAAACAGTTGGACTGCCAGTTGTTTTTGATTGTGCCATAAGTGGATCAGAACCTATCTCCGTGTCTTGGTATAAAGACGGCAAGCCATTGAAAGACAGCCCAAATGTACAAACATCATTTTTAGACAATACAGCCACACTCAATATTTTTAAAACTGACCGGAGCCTTGCAGGCCAGTATTCCTGCACAGCTACAAACCCTATAGGCTCTGCTTCTTCCAGTGCCAGGCTCATTCTCACAG
>TTN-207,ENSE00003808430,1,288,1430012,1430299,AGGGGAAGAACCCACCCTTCTTTGACATCCGTCTTGCCCCTGTGGATGCTGTGGTGGGAGAAAGTGCTGACTTTGAGTGCCACGTCACGGGCACACAACCGATAAAGGTCAGCTGGGCCAAAGACAGCAGAGAAATACGAAGTGGCGGAAAGTACCAGATTAGTTATCTGGAAAACAGCGCCCACCTGACAGTCCTCAAAGTAGACAAAGGAGATTCTGGACAATATACCTGCTATGCTGTGAATGAAGTGGGAAAAGACTCTTGCACAGCTCAGCTGAATATAAAAG
>TTN-207,ENSE00003809007,1,291,1430300,1430590,AGCGGCTCATCCCACCAAGTTTCACTAAAAGACTCTCAGAGACAGTAGAAGAAACAGAAGGGAATTCTTTCAAACTTGAGGGACGTGTGGCTGGTTCCCAACCTATAACTGTTGCCTGGTACAAAAATAATATAGAGATACAACCAACTTCTAACTGTGAAATAACATTCAAGAACAACACGTTAGTGCTGCAAGTCAGGAAAGCAGGCATGAACGACGCTGGTTTGTACACATGCAAAGTGTCCAATGATGCAGGCTCTGCTCTGTGCACGTCTTCAATCGTCATCAAAG
>TTN-207,ENSE00003803910,1,288,1430591,1430878,AACCTAAGAAGCCACCTGTATTTGATCAGCACCTTACTCCAGTAACAGTGAGTGAAGGAGAATACGTGCAGCTCAGCTGCCATGTCCAGGGATCTGAGCCAATTAGGATCCAGTGGTTGAAGGCTGGCAGGGAAATAAAGCCTTCAGACAGATGCAGCTTCAGCTTTGCTAGTGGGACAGCTGTACTGGAACTCAGAGATGTGGCTAAAGCAGATTCGGGAGATTATGTGTGTAAAGCTTCAAATGTGGCTGGAAGTGACACTACCAAATCAAAAGTGACCATTAAAG
>TTN-207,ENSE00003804245,1,93,1430879,1430971,ACAAACCAGCTGTGGCCCCAGCAACCAAGAAAGCTGCGGTAGATGGAAGACTCTTTTTTGTGTCAGAACCTCAGAGTATCAGAGTCGTAGAAA
>TTN-207,ENSE00003801649,1,286,1430972,1431257,AAACCACTGCGACCTTCATTGCAAAAGTTGGAGGTGACCCAATCCCAAATGTTAAATGGACAAAAGGGAAGTGGAGACAGCTGAACCAAGGAGGTCGTGTTTTCATCCACCAAAAAGGCGATGAAGCAAAACTGGAGATTAGGGACACCACAAAAACTGATTCTGGGTTATACCGATGCGTGGCATTTAACGAACATGGTGAAATTGAAAGTAATGTTAACTTACAGGTGGATGAAAGGAAGAAACAAGAGAAAATTGAAGGCGATCTTAGAGCAATGCTGAAAAA
>TTN-207,ENSE00003805371,1,184,1431258,1431441,GACTCCAATCTTAAAGAAAGGAGCTGGAGAAGAAGAGGAAATTGATATCATGGAACTTCTCAAAAATGTTGATCCTAAAGAATATGAAAAATATGCCCGCATGTATGGAATCACTGACTTCCGAGGTCTTCTTCAAGCATTTGAACTGCTCAAGCAAAGCCAAGAAGAAGAGACACATAGACTG
>TTN-207,ENSE00003802112,1,90,1431442,1431531,GAAATTGAGGAAATAGAGAGGTCAGAGAGGGACGAAAAGGAATTTGAGGAACTTGTATCATTTATTCAGCAAAGACTGTCACAGACAGAG
>TTN-207,ENSE00003810323,1,268,1431532,1431799,CCTGTCACTCTGATCAAGGACATTGAAAATCAGACAGTTTTGAAAGATAATGATGCTGTCTTTGAAATTGACATTAAAATTAATTATCCAGAAATCAAGCTTTCGTGGTACAAAGGAACTGAAAAACTGGAACCCAGTGATAAATTTGAAATAAGCATTGATGGTGACCGACATACACTCAGAGTCAAAAACTGTCAACTTAAAGACCAGGGCAATTATCGATTGGTTTGTGGTCCACACATCGCTAGCGCTAAACTAACTGTAATTG
>TTN-207,ENSE00003810781,1,261,1431800,1432060,AGCCTGCATGGGAACGGCATCTTCAGGATGTGACTCTGAAAGAAGGCCAGACTTGCACCATGACATGCCAATTTTCTGTACCAAATGTAAAATCTGAATGGTTCAGAAATGGCAGAATCCTTAAACCCCAAGGTAGACATAAAACAGAAGTGGAACACAAAGTCCATAAATTGACCATTGCAGATGTTCGAGCAGAAGACCAGGGTCAGTACACCTGCAAATATGAAGACCTTGAAACTTCAGCAGAACTCAGAATCGAAG
>TTN-207,ENSE00003805599,1,210,1432061,1432270,CTGAACCAATTCAGTTTACAAAGCGCATACAGAACATCGTGGTGAGTGAGCATCAGTCTGCCACCTTTGAGTGTGAAGTGTCCTTTGATGATGCCATTGTAACATGGTACAAAGGACCAACAGAACTGACAGAGAGCCAGAAATACAACTTCAGGAATGATGGCCGCTGCCATTATATGACCATCCACAATGTGACCCCAGACGATGAAG
>TTN-207,ENSE00003809461,1,78,1432271,1432348,GTGTCTACTCGGTCATCGCTCGGCTGGAGCCAAGAGGTGAAGCAAGAAGCACGGCAGAGCTGTACCTAACGACGAAAG
>TTN-207,ENSE00003805821,1,27,1432349,1432375,AAATCAAACTTGAGCTGAAGCCTCCTG
>TTN-207,ENSE00003803485,1,60,1432376,1432435,ATATTCCTGACTCCAGAGTTCCAATCCCAACCATGCCTATCAGAGCAGTGCCACCAGAAG
>TTN-207,ENSE00003803812,1,84,1432436,1432519,AAATCCCTCCTGTGGTTGCTCCTCCTATCCCCCTTTTGCTACCAACACCCGAAGAAAAGAAACCACCACCAAAACGTATTGAAG
>TTN-207,ENSE00003804844,1,72,1432520,1432591,TTACCAAAAAGGCTGTGAAGAAAGATGCCAAAAAAGTTGTTGCAAAGCCCAAAGAGATGACACCACGTGAAG
>TTN-207,ENSE00003810688,1,48,1432592,1432639,AGATTGTCAAGAAGCCTCCACCTCCTACTACCTTAATTCCAGCAAAAG
>TTN-207,ENSE00003806388,1,405,1432640,1433044,CTCCTGAAATCATTGATGTATCCTCTAAAGCTGAAGAAGTAAAAATAATGACTATAACCAGAAAGAAAGAGGTTCAGAAAGAAAAAGAAGCTGTGTATGAGAAAAAGCAAGCAGTCCACAAGGAGAAGAGAGTCTTCATTGAATCTTTCGAAGAACCTTATGACGAACTGGAGGTAGAACCATACACAGAGCCATTTGAACAACCTTATTATGAAGAACCAGATGAAGACTATGAAGAGATTAAGGTAGAAGCTAAAAAAGAAGTTCACGAGGAATGGGAAGAAGATTTTGAAGAAGGGCAAGAATACTATGAAAGGGAAGAAGGCTATGACGAAGGGGAGGAAGAGTGGGAAGAGGCTTACCAAGAAAGGGAAGTAATTCAAGTTCAAAAGGAGGTCTATGAAG
>TTN-207,ENSE00003803093,1,63,1433045,1433107,AATCACATGAGAGAAAAGTTCCAGCCAAAGTACCTGAAAAGAAAGCACCACCACCTCCTAAAG
>TTN-207,ENSE00003802009,1,78,1433108,1433185,TTATAAAGAAGCCAGTAATTGAAAAAATTGAAAAGACTTCTCGAAGAATGGAGGAAGAAAAAGTTCAAGTCACCAAAG
>TTN-207,ENSE00003806356,1,78,1433186,1433263,TACCTGAAGTTTCAAAGAAGATTGTTCCACAAAAACCTTCCCGGACTCCAGTACAGGAAGAAGTTATTGAAGTGAAAG
>TTN-207,ENSE00003803112,1,87,1433264,1433350,TACCAGCTGTGCATACAAAGAAGATGGTTATTTCAGAAGAAAAGATGTTCTTTGCTTCTCACACAGAGGAGGAGGTGTCAGTCACAG
>TTN-207,ENSE00003811115,1,81,1433351,1433431,TCCCCGAGGTACAAAAGGAAATTGTTACTGAAGAGAAAATTCACGTTGCCATTTCCAAAAGGGTTGAACCACCACCTAAAG
>TTN-207,ENSE00003810048,1,84,1433432,1433515,TCCCTGAGCTACCTGAGAAACCAGCTCCAGAAGAAGTGGCCCCTGTTCCTATCCCTAAAAAAGTGGAGCCCCCAGCACCAAAAG
>TTN-207,ENSE00003809302,1,84,1433516,1433599,TTCCTGAGGTTCCCAAGAAACCCGTGCCAGAGGAGAAAAAGCCAGTTCCTGTGCCTAAGAAGGAACCTGCTGCTCCCCCAAAAG
>TTN-207,ENSE00003811271,1,84,1433600,1433683,TCCCAGAGGTGCCAAAGAAACCTGTCCCTGAAGAAAAGATTCCCGTTCCTGTTGCAAAGAAAAAGGAAGCTCCCCCAGCTAAAG
>TTN-207,ENSE00003811169,1,81,1433684,1433764,TTCCTGAAGTACAGAAGGGAGTTGTGACAGAAGAAAAAATAACCATTGTAACTCAAAGAGAGGAATCTCCACCACCAGCAG
>TTN-207,ENSE00003802187,1,84,1433765,1433848,TGCCAGAAATACCAAAGAAGAAAGTTCCTGAAGAAAGGAAACCTGTTCCTCGGAAGGAGGAAGAAGTTCCACCACCACCAAAAG
>TTN-207,ENSE00003810484,1,84,1433849,1433932,TGCCAGCTCTGCCTAAGAAACCCGTCCCAGAGGAGAAAGTTGCAGTGCCAGTTCCTGTCGCTAAGAAAGCTCCTCCTCCCCGAG
>TTN-207,ENSE00003810121,1,102,1433933,1434034,CTGAAGTCTCTAAGAAAACTGTTGTAGAAGAAAAGAGATTTGTTGCTGAAGAAAAACTATCCTTCGCAGTTCCTCAAAGAGTGGAAGTCACGCGGCACGAAG
>TTN-207,ENSE00003805410,1,114,1434035,1434148,TATCTGCAGAGGAGGAATGGAGTTACTCAGAAGAGGAGGAAGGTGTGTCCATTTCAGTTTATAGAGAAGAAGAAAGAGAGGAGGAGGAAGAAGCAGAGGTTACAGAATATGAAG
>TTN-207,ENSE00003801264,1,81,1434149,1434229,TGATGGAAGAGCCTGAGGAATATGTTGTGGAAGAAAAGCTGCACATTATTTCTAAGAGAGTGGAAGCTGAGCCAGCTGAAG
>TTN-207,ENSE00003805756,1,78,1434230,1434307,TGACAGAGAGGCAGGAGAAGAAAATTGTACTGAAACCAAAAATTCCTGCTAAAATAGAGGAGCCTCCACCGGCTAAAG
>TTN-207,ENSE00003808334,1,84,1434308,1434391,TTCCTGAAGCACCTAAGAAAATTGTGCCAGAAAAGAAAGTTCCTGCTCCAGTTCCTAAAAAGGAAAAGGTGCCCCCACCTAAAG
>TTN-207,ENSE00003808052,1,84,1434392,1434475,TGCCAGAAGAGCCAAAGAAACCAGTTCCAGAAAAAAAGGTTCCTCCAAAAGTCATTAAGATGGAAGAACCTCTCCCAGCCAAAG
>TTN-207,ENSE00003803067,1,84,1434476,1434559,TGACTGAGAGGCACATGCAAATTACCCAGGAAGAAAAAGTTCTTGTTGCTGTAACTAAAAAAGAGGCGCCTCCAAAAGCAAGAG
>TTN-207,ENSE00003808806,1,84,1434560,1434643,TGCCAGAGGAACCGAAGAGAGCTGTCCCAGAAGAAAAAGTTCTGAAACTCAAACCTAAAAGAGAGGAGGAACCACCAGCTAAAG
>TTN-207,ENSE00003805330,1,81,1434644,1434724,TGACTGAATTCAGAAAAAGAGTGGTTAAAGAAGAAAAAGTATCAATTGAAGCTCCAAAAAGAGAACCTCAACCCATCAAAG
>TTN-207,ENSE00003807878,1,207,1434725,1434931,AAGTAACTATAATGGAAGAGAAAGAAAGGGCTTATACCCTAGAAGAAGAAGCTGTTTCAGTACAACGGGAAGAAGAATATGAGGAATATGAAGAATATGATTATAAAGAATTTGAGGAGTATGAACCAACAGAAGAATATGACCAATATGAAGAATACGAGGAGCGGGAGTATGAACGATATGAAGAGCATGAAGAATACATCACAG
>TTN-207,ENSE00003806244,1,78,1434932,1435009,AACCAGAGAAGCCTATCCCTGTAAAGCCTGTCCCAGAAGAACCAGTTCCCACAAAACCAAAGGCCCCACCGGCTAAAG
>TTN-207,ENSE00003810594,1,75,1435010,1435084,TGCTGAAGAAAGCTGTCCCTGAAGAAAAAGTACCAGTGCCCATTCCTAAGAAACTCAAACCTCCACCACCCAAAG
>TTN-207,ENSE00003809388,1,93,1435085,1435177,TGCCTGAAGAACCAAAGAAAGTTTTTGAGGAAAAAATACGTATTTCAATTACCAAACGTGAAAAAGAGCAGGTGACTGAACCCGCTGCTAAAG
>TTN-207,ENSE00003807405,1,78,1435178,1435255,TGCCCATGAAGCCCAAGAGGGTTGTCGCAGAAGAAAAAGTACCTGTCCCTAGAAAAGAAGTAGCACCACCTGTTAGAG
>TTN-207,ENSE00003810081,1,162,1435256,1435417,TGCCAGAAGTGCCTAAAGAACTTGAACCAGAAGAGGTTGCCTTTGAAGAGGAAGTTGTAACCCATGTAGAAGAATATCTTGTAGAAGAAGAAGAAGAGTACATTCATGAAGAAGAGGAGTTCATAACTGAGGAAGAAGTGGTGCCAGTGATACCAGTCAAAG
>TTN-207,ENSE00003806496,1,84,1435418,1435501,TGCCTGAGGTACCCAGGAAACCTGTTCCAGAAGAGAAGAAACCTGTTCCTGTTCCCAAGAAGAAGGAAGCTCCACCGGCAAAAG
>TTN-207,ENSE00003802498,1,78,1435502,1435579,TGCCTGAGGTTCCTAAGAAGCCAGAGGAGAAAGTTCCTGTGCTTATTCCTAAAAAGGAGAAGCCTCCGCCAGCAAAAG
>TTN-207,ENSE00003809653,1,84,1435580,1435663,TTCCTGAAGTGCCCAAGAAACCTGTGCCAGAGGAGAAAGTACCAGTACCAGTTCCTAAAAAGGTGGAAGCTCCACCTGCCAAAG
>TTN-207,ENSE00003810862,1,84,1435664,1435747,TGCCAGAGGTACCCAAGAAGCCTGTGCCTGAGAAGAAGGTGCCAGTTCCTGCTCCTAAGAAAGTGGAGGCTCCACCTGCAAAAG
>TTN-207,ENSE00003805059,1,84,1435748,1435831,TGCCAGAGGTGCCCAAGAAGCTCATCCCAGAAGAAAAGAAACCAACACCTGTTCCGAAAAAAGTGGAAGCACCACCACCCAAAG
>TTN-207,ENSE00003801382,1,297,1435832,1436128,TGCCAAAGAAACGTGAACCAGTTCCAGTTCCTGTAGCTCTACCTCAGGAAGAGGAAGTTCTATTTGAAGAAGAAATTGTTCCTGAAGAGGAAGTTCTACCTGAGGAAGAGGAAGTTCTACCTGAGGAAGAGGAAGTTCTACCTGAAGAAGAGGAAGTTCTACCTGAAGAAGAGGAAATTCCACCTGAGGAAGAGGAAGTTCCTCCCGAAGAAGAATATGTACCTGAGGAAGAAGAATTTGTACCTGAAGAAGAAGTCCTTCCAGAAGTTAAACCTAAGGTGCCAGTACCTGCACCAG
>TTN-207,ENSE00004025982,1,87,1436129,1436215,TGCCTGAAGTGCCAAAGAAACCTGTACCAGAGAAGAAAGTCCCTGTTCCCGCCCCTAAAAAAGTGGAACCTCCACCACCACCCAAAG
>TTN-207,ENSE00003805240,1,75,1436216,1436290,TGCCTGAAATTAAGAAGAAAGTGACAGAGAAGAAAGTGGTCATTCCCAAGAAAGAGGAGGCTCCCCCTGCCAAAG
>TTN-207,ENSE00004025997,1,84,1436291,1436374,TGTCTGTGGTACCTAAGAAACCTGAGCCAGAAAAGAAGGTCCCTCCTCCTGGTCTTAAGAAAGCAGTGGCCCCTCCTGCCAAAG
>TTN-207,ENSE00003804875,1,75,1436375,1436449,TTCCTGAGGTGCCTAAGAAGGTGGAAGAAAAACGAATCATTCTCCCTAAAGAAGAGGAAGTTCTACCAGTTGAAG
>TTN-207,ENSE00003801552,1,96,1436450,1436545,TGACTGAGGAGCCTGAAGAAGAGCCTATTTCAGAAGAAGAAATCCCAGAAGAACCACCTAGCATAGAGGAAGTTGAAGAGGTGGCACCACCTAGAG
>TTN-207,ENSE00003804385,1,78,1436546,1436623,TGCCTGAAGTGATTAAGAAAGCAGTACCTGAAGCACCTACTCCTGTTCCTAAAAAAGTGGAGGCACCACCAGCTAAAG
>TTN-207,ENSE00003805135,1,69,1436624,1436692,TGTCAAAGAAAATTCCTGAGGAAAAAGTACCTGTTCCTGTTCAGAAAAAAGAGGCACCCCCAGCCAAAG
>TTN-207,ENSE00003808243,1,75,1436693,1436767,TGCCTGAAGTACCAAAGAAAGTCCCAGAAAAGAAAGTCCTTGTGCCTAAAAAGGAAGCTGTTCCCCCAGCTAAAG
>TTN-207,ENSE00003808353,1,297,1436768,1437064,GGAGAACTGTCCTTGAAGAAAAAGTATCAGTTGCCTTCCGCCAAGAAGTAGTAGTAAAAGAAAGACTAGAATTAGAAGTAGTAGAAGCAGAAGTGGAAGAAATTCCGGAAGAAGAAGAGTTCCATGAAGTTGAAGAATATTTTGAAGAAGGCGAGTTTCATGAAGTAGAAGAATTCATCAAATTAGAACAACATAGAGTTGAAGAAGAACACAGAGTTGAAAAAGTTCATAGGGTAATAGAAGTTTTTGAGGCTGAAGAAGTGGAAGTATTTGAAAAACCAAAAGCTCCACCTAAAG
>TTN-207,ENSE00003807571,1,81,1437065,1437145,GGCCTGAGATATCTGAGAAAATCATCCCTCCAAAAAAACCGCCCACTAAAGTTGTTCCTCGAAAAGAGCCACCAGCTAAAG
>TTN-207,ENSE00003808118,1,78,1437146,1437223,TACCGGAGGTGCCTAAGAAAATTGTGGTAGAAGAAAAAGTACGTGTTCCTGAAGAGCCCAGAGTTCCACCAACTAAAG
>TTN-207,ENSE00004025978,1,84,1437224,1437307,CACCCGAAGTACCCAAGAAAATTGTCCCAGAAGAAAAAGTTCGTGAAGCTGTTCTGAAAAAGCCTGAAGTTCCACCAGCTAAAG
>TTN-207,ENSE00004026002,1,75,1437308,1437382,TTCCTGGGATGCCTAAGAAAAGTGTTCAAGAAGAAAAATCACCTATTGTTATTTCTGAAGACACAGAGATGTACA
>TTN-207,ENSE00004025998,1,84,1437383,1437466,TTTATGAAGCATCTGAAGAAGCAGTCCTAGAAGAAAAAGTACTTGTGACTCAACCTCAAAAGACAAAACCCAAACTAGCAAAAG
>TTN-207,ENSE00004025971,1,84,1437467,1437550,TGCCTGAGCCACCCAAGAAAGTTGTTCCAGAAGACAAAATATATGTGACTATTCCTAAAAAGAGAGAAACACCAGCAACTAAAG
>TTN-207,ENSE00001725280,1,84,1437551,1437634,AACCTGATACAACCAGAGGCATTTTTCCAGAGGTGGAGCCACCTGAGGCTATTCCTGAAATTCCAGAACATCCTCCAACTGAAG
>TTN-207,ENSE00004024308,1,78,1437635,1437712,AGTTTGAAGTCTTCAAGGAAGTCATTCCAGAGGGAGAAACTCCTATTGTTAAAAGAAGAAAAACACCATCACCAACAG
>TTN-207,ENSE00004025995,1,84,1437713,1437796,TGCCTGAATCACCTCGAGAAATTGTCCCTGTAAAGGAAACACCCATGGCTGCTCCCCTTGAAATTGAAATACCTCCCACTAAAG
>TTN-207,ENSE00004024272,1,84,1437797,1437880,CACCAGAAGCTATGAAAGAAGTTGTCCCTGAAATGAAAATATTTGAGGATGTACCTGAAGAGCCAGAAACTCCACGTATGAAAA
>TTN-207,ENSE00004024280,1,75,1437881,1437955,CGCCCGAAGCTCCTCAAGAAATTATTCCTGCCAAGACAGTTCCTTCCAAAAAAAGAGAACCCCCATCAGTTAAAG
>TTN-207,ENSE00004024279,1,84,1437956,1438039,TGCCTGAAGCTCTCCAAGAAATTGTCCCTGAAAAGAAAACGCTTGTGGTTCCTCTCAGAAAGCCTGAAGTCCTTCCTGATGAAG
>TTN-207,ENSE00004024286,1,78,1438040,1438117,TGCCGGAGGCTCTCAGAGAAGTTGTCCCGGAAAAGAAAGTGCATCCTCCCCAAAGGGCTGAAGTTGTACCTGTCAAAG
>TTN-207,ENSE00004024310,1,84,1438118,1438201,TGCACGAAGCTCCCAAAGAGATTATCCCTGAAAAGAAAGTGTCGGTGGTGCCTCCTAAAAAGCCTGAAGTCCCACCTGTTAAAG
>TTN-207,ENSE00004024305,1,84,1438202,1438285,TGCCAGAAGCTTCCAAAGAGGTTATCCGCGAAGAGAAAGTGCCCTTGGCTCCTCCTAAAGAGCCTGAAGTCCCACCTGTTAAAG
>TTN-207,ENSE00004024294,1,84,1438286,1438369,TACCAGAGCCTCCCAAAGAAGTAGTTCCTGAAAAGAAAGCGCCAGTGGCTCCTCCTAAAGAGCCTGAAGTCCCACCTGTTAAAG
>TTN-207,ENSE00004025974,1,84,1438370,1438453,TGCCTGAGGCTCCCAAAGAAGTTGTTCCTGAAAAGAAAGTGCCAGTGCCTCCTCCTAAAAAGCCTGAAGTGCCACCCACAAAAG
>TTN-207,ENSE00004025967,1,84,1438454,1438537,TCCCAGAGGTGCCAAAGGCAGCTGTCCCAGAAAAGAAGTTGCCTGAAGCTATTCCTCCCAAACCGGAAAGTCCTCCCCCTGAAG
>TTN-207,ENSE00003807304,1,90,1438538,1438627,TGCCTGAAGTGCTGCCACCGAAGGAAGTGGTCCCAGAAAAGAAAGTACCGGTGCCTCCTGCCAAAAAGCCAGAAGCTCCACCTCCTAAAG
>TTN-207,ENSE00004026001,1,84,1438628,1438711,TTCCTGAAGCTCCTAAAGAAGTTGTACTTGAAAAGAAAGCATCTGTGGCTGTGCCCAAAAAACCGGAAGCCCCACGTGCAAAAG
>TTN-207,ENSE00004025988,1,84,1438712,1438795,TGCCTGAAGCTGCTCAAGAAGTTGTCCCAGAAAAGAAAATTCCCAAGGCACCAATCAAAAAACCAGAAGCCCCCGCAGTTACAG
>TTN-207,ENSE00004025983,1,81,1438796,1438876,TGCCAGAAGTTCCTCAAGAAGCCACAGAAAAAGAAATTCCCGTGGCTCCACCCAAAAAACCAGAAGCTCCAATTGTCCCAG
>TTN-207,ENSE00004025976,1,81,1438877,1438957,TGCCTGAAGCTCAAGAAGTTGTCCCAGAAAAGAAAGTTCCTAAGGCTCCTCCCACAAAACCAGAAGCCCCACCTGCCACAG
>TTN-207,ENSE00004025986,1,81,1438958,1439038,TGCCTGAAGTCCCACAAGAAATTGTGCCAGAAAAGAAAACACTGGTGCTTCCTAAAAAGCCAGAAGTTCCACCTGTTACAG
>TTN-207,ENSE00004025969,1,84,1439039,1439122,TGCCAGAGGCTCCCAAAGAAGTTGTCCTTGAAAAGAAAGTGCCCTCGGCTCCTCCTAAAAAGCCTGAAGTCCCACCTGTTAAAG
>TTN-207,ENSE00003802745,1,84,1439123,1439206,TGCCTGAGGCTCCCAAAGAAGTTGTTCCTGAAAAGAAAGTGCCAGTGCCTCCTCCTAAAAAGCCTGAAGTGCCACCCACAAAAG
>TTN-207,ENSE00003809569,1,84,1439207,1439290,TCCCAGAGGTGCCAAAGGCAGCTGTCCCAGAAAAGAAGGTGCCTGAAGCTATTCCTCCCAAACCGGAAAGTCCTCCCCCTGAAG
>TTN-207,ENSE00004025984,1,90,1439291,1439380,TGCCTGAAGTGCTGCCACCGAAGGAAGTGGTCCCAGAAAAGAAAGTACCGGTGCCTCCTGCCAAAAAGCCAGAAGCTCCACCTCCTAAAG
>TTN-207,ENSE00004026000,1,84,1439381,1439464,TTCCTGAAGCTCCTAAAGAAGTTGTACTTGAAAAGAAAGCATCTGTGGCTGTGCCCAAAAAACCGGAAGCCCCACGTGCAAAAG
>TTN-207,ENSE00004025966,1,84,1439465,1439548,TGCCTGAAGCTGCTCAAGAAGTTGTCCCAGAAAAGAAAATTCCCAAGGCACCAATCAAAAAACCAGAAGCCCCCGCAGTTACAG
>TTN-207,ENSE00004025973,1,81,1439549,1439629,TGCCAGAAGTTCCTCAAGAAGCCGCAGAAAAAGAAATTCCCGTGGCTCCACCCAAAAAACCAGAAGCTCCGATTGTCCCAG
>TTN-207,ENSE00004025979,1,81,1439630,1439710,TGCCTGAAGCTCAAGAAGTTGTCCCAGAAAAGAAAGTTCCTAAGGCTCCTCCCACAAAACCAGAAGCCCCACCTGCCACAG
>TTN-207,ENSE00004025981,1,81,1439711,1439791,TGCCTGAAGTCCCACAAGAAATTGTGCCAGAAAAGAAAACACTGGTGCTTCCTAAAAAGCCAGAAGTTCCACCTGTTACAG
>TTN-207,ENSE00004025970,1,84,1439792,1439875,TGCCAGAGGCTCCCAAAGAAGTTGTCCTTGAAAAGAAAGTGCCCTCGACTCCTCCTAAAAAGCCTGAAGTCCCACCTGTTAAAG
>TTN-207,ENSE00004025993,1,84,1439876,1439959,TGCCTGAGGCTCCCAAAGAAGTTGTTCCTGAAAAGAAAGTGCCAGTGCCTCCTCCTAAAAAGCCTGAAGTGCCACCCACAAAAG
>TTN-207,ENSE00004025989,1,84,1439960,1440043,TCCCAGAGGTGCCAAAGGCAGCTGTCCCAGAAAAGAAGGTGCCTGAAGCTATTCCTCCCAAACCGGAAAGTCCTCCCCCTGAAG
>TTN-207,ENSE00004025987,1,90,1440044,1440133,TGCCTGAAGTGCTGCCACCGAAGGAAGTGGTCCCAGAAAAGAAAGTACCGGTGCCTCCTGCCAAAAAGCCAGAAGCTCCACCTCCTAAAG
>TTN-207,ENSE00004025975,1,84,1440134,1440217,TTCCTGAAGCTCCTAAAGAAGTTGTACTTGAAAAGAAAGTATCTGTGGCTGTGCCCAAAAAACCGGAAGCCCCACGTGCAAAAG
>TTN-207,ENSE00004026003,1,84,1440218,1440301,TGCCTGAAGCTGCTCAAGAAGTTGTCCCAGAAAAGAAAATTCCCAAGGCACCAATCAAAAAACCAGAAGCCCCCGCAGTTACAG
>TTN-207,ENSE00004025980,1,81,1440302,1440382,TGCCAGAAGTTCCTCAAGAAGCCGCAGAAAAAGAAATTCCCGTGGCTCCACCCAAAAAACCAGAAGCTCCAATTGTCCCAG
>TTN-207,ENSE00004025994,1,81,1440383,1440463,TGCCTGAAGCTCAAGAAGTTGTCCCAGAAAAGAAAGTTCCTAAGGCTCCTCCCACAAAACCAGAAGCCCCACCTGCCACAG
>TTN-207,ENSE00004025996,1,81,1440464,1440544,TGCCTGAAGTCCCACAAGAAATTGTGCCAGAAAAGAAAACACTGGTGCTTCCTAAAAAGCCAGAAGTTCCACCTGTTACAG
>TTN-207,ENSE00004025990,1,84,1440545,1440628,TGCCAGAGGCTCCCAAAGAAGTTGTCCTTGAAAAGAAAGTGCCCTTGGCTCCTCCTAAAAAGCCTGAAGTCCCACCTGTTAAAG
>TTN-207,ENSE00004026004,1,84,1440629,1440712,TGCCAGAGGCTCCCAAAGAAGTTGTTCCTGAAAAGAAAGTGCCAGTGACTCCTCCTAAAAAACCTGAAGTCCCACCTGTTAAAG
>TTN-207,ENSE00004025977,1,84,1440713,1440796,TGCCAGAGGCTCCCATAGAGGTTGTTCCTGAAAAGAAAATGCCCTTGGCTCCTCCTAAAAAGCCTGAAGTCCCTCCTGTTAAAG
>TTN-207,ENSE00004025991,1,84,1440797,1440880,TACCAGAGGCTCCCAAAGAGGTTGTTCCTGAAAAGAAAGTGCCCTCGGCTCCTCCTAAAAAGCCTGAAGTCCCACCTGTTAAAG
>TTN-207,ENSE00003806373,1,84,1440881,1440964,TGCCAGAGGCTCCGAAAGAAGTTGTTCCTGAAAAGAAAGTGCCAGCGGCTCCTCCTAAAAAGCCTGAAGTCACACCTGTTAAAG
>TTN-207,ENSE00003807489,1,84,1440965,1441048,TGCCTGAGGCTCCCAAAGAAGTTGTTCCTGAAAAGAAAGTGCCAGTGCCTCCTCCTAAAAAGCCTGAAGTGCCACCCACAAAAG
>TTN-207,ENSE00003805050,1,84,1441049,1441132,TCCCAGAGGTGCCAAAGGTAGCTGTCCCAGAAAAGAAGGTGCCTGAAGCTATTCCTCCCAAACCGGAAAGTCCTCCCCCTGAAG
>TTN-207,ENSE00003808824,1,84,1441133,1441216,TGTTCGAGGAGCCTGAGGAAGTTGCCCTAGAAGAGCCTCCTGCTGAAGTTGTGGAAGAGCCAGAGCCAGCGGCGCCTCCACAAG
>TTN-207,ENSE00003807203,1,84,1441217,1441300,TGACCGTACCACCTAAGAAACCTGTCCCAGAAAAGAAAGCACCTGCTGTCGTTGCCAAAAAACCTGAACTACCACCAGTGAAAG
>TTN-207,ENSE00003811260,1,84,1441301,1441384,TGCCCGAGGTGCCCAAGGAGGTTGTTCCTGAAAAGAAGGTGCCTCTGGTGGTTCCCAAAAAGCCAGAAGCCCCACCTGCTAAAG
>TTN-207,ENSE00003806229,1,78,1441385,1441462,TGCCTGAAGTTCCAAAAGAAGTTGTTCCAGAAAAGAAAGTAGCTGTTCCCAAAAAGCCAGAAGTCCCACCAGCAAAAG
>TTN-207,ENSE00003807893,1,84,1441463,1441546,TGCCAGAAGTGCCAAAGAAACCTGTCTTGGAAGAGAAACCAGCTGTTCCTGTTCCAGAAAGAGCGGAGTCTCCTCCCCCAGAAG
>TTN-207,ENSE00003809515,1,108,1441547,1441654,TATATGAAGAACCTGAGGAAATTGCTCCTGAAGAGGAAATTGCTCCTGAAGAGGAAAAGCCAGTTCCTGTTGCAGAAGAGGAGGAACCAGAGGTTCCACCTCCAGCAG
>TTN-207,ENSE00003804845,1,78,1441655,1441732,TGCCTGAAGAGCCCAAGAAGATCATCCCAGAGAAGAAAGTTCCTGTCATCAAAAAACCAGAAGCACCGCCTCCTAAAG
>TTN-207,ENSE00003806702,1,111,1441733,1441843,AACCTGAACCTGAAAAGGTTATTGAGAAGCCAAAACTCAAACCAAGACCCCCACCTCCTCCACCTGCTCCACCTAAGGAAGATGTGAAGGAGAAAATATTCCAACTTAAAG
>TTN-207,ENSE00003809179,1,69,1441844,1441912,CTATTCCAAAGAAGAAAGTTCCTGAAAAACCTCAGGTTCCAGAAAAAGTGGAGCTTACACCTCTGAAAG
>TTN-207,ENSE00003807205,1,90,1441913,1442002,TACCAGAACCACCACCTCCAAAACCTGTTGAAGAGGTTGAAGTACCTACTGTTACAAAAAGGGAAAGGAAGATTCCTGAACCAACAAAAG
>TTN-207,ENSE00003806747,1,63,1442003,1442065,TGCCTGAAATCAAGCCAGCAATACCTCTCCCTGCACCTGAACCGAAACCAAAGCCCGAAGCAG
>TTN-207,ENSE00003810755,1,90,1442066,1442155,AAGTGAAAACAATCAAACCACCTCCTGTGGAACCTGAACCAACCCCCATCGCTGCCCCAGTAACAGTGCCAGTGGTTGGAAAGAAAGCAG
>TTN-207,ENSE00003806122,1,51,1442156,1442206,AAGCCAAAGCACCTAAGGAAGAGGCTGCCAAGCCAAAAGGTCCTATCAAAG
>TTN-207,ENSE00003804858,1,402,1442207,1442608,GTGTACCCAAAAAGACTCCTTCACCAATAGAAGCCGAAAGGAGAAAGTTAAGGCCAGGAAGTGGTGGAGAGAAACCTCCTGATGAAGCCCCGTTCACCTACCAGCTAAAGGCTGTGCCACTGAAGTTTGTGAAAGAAATCAAAGACATCATCTTGACAGAATCAGAGTTCGTTGGCTCTTCAGCAATCTTTGAATGTTTGGTCTCCCCTTCCACTGCAATTACAACCTGGATGAAAGACGGTAGCAATATCCGTGAGAGTCCCAAGCACAGGTTTATTGCAGATGGTAAAGACAGAAAGCTGCACATCATTGATGTTCAACTTTCCGATGCTGGTGAATACACCTGTGTTTTACGTTTGGGAAACAAAGAAAAGACCTCCACGGCTAAACTTGTTGTAGAAG
>TTN-207,ENSE00003803996,1,279,1442609,1442887,AACTTCCTGTGCGTTTTGTAAAAACACTGGAAGAGGAAGTCACAGTGGTCAAAGGACAGCCATTGTACTTGAGCTGCGAGTTAAACAAAGAGCGTGACGTGGTCTGGAGGAAGGATGGCAAGATTGTGGTGGAGAAACCTGGCCGAATTGTGCCAGGCGTCATTGGCTTGATGCGGGCTCTGACCATCAACGATGCAGATGACACAGATGCTGGAACATACACAGTTACTGTGGAAAACGCCAACAACCTGGAGTGTTCATCTTGCGTAAAAGTAGTAG
>TTN-207,ENSE00003807976,1,276,1442888,1443163,AAGTCATTAGAGATTGGCTGGTGAAACCTATACGAGACCAGCATGTGAAACCCAAGGGGACAGCTATTTTTGCCTGTGATATAGCAAAAGATACTCCAAACATTAAGTGGTTCAAAGGATATGATGAAATCCCTGCGGAACCAAATGATAAGACTGAAATACTGAGAGATGGAAATCATCTGTACCTCAAAATTAAGAATGCTATGCCAGAAGATATTGCTGAGTATGCAGTGGAAATTGAAGGAAAAAGATACCCTGCAAAGCTGACACTTGGAG
>TTN-207,ENSE00003804328,1,140,1443164,1443303,AGCGTGAAGTTGAACTGCTTAAACCAATAGAGGACGTTACCATTTATGAGAAAGAAAGTGCAAGCTTTGATGCAGAAATCTCAGAGGCAGACATTCCTGGACAATGGAAACTGAAAGGAGAACTTCTAAGGCCCTCACCT
>TTN-207,ENSE00003802254,1,127,1443304,1443430,ACTTGTGAAATCAAAGCAGAAGGTGGAAAACGCTTCTTAACTTTGCACAAAGTCAAACTGGACCAAGCTGGTGAAGTCCTCTACCAGGCCCTTAATGCAATTACAACTGCCATTTTGACAGTAAAAG
>TTN-207,ENSE00003811410,1,264,1443431,1443694,AAATCGAACTTGACTTTGCTGTGCCCCTGAAGGATGTCACTGTTCCAGAAAGGCGACAGGCTCGATTCGAATGTGTCCTCACCCGAGAGGCAAATGTTATATGGTCCAAAGGACCTGATATAATTAAGTCATCTGACAAATTTGATATCATCGCTGATGGAAAGAAACATATTCTTGTTATTAATGATTCTCAATTTGATGATGAAGGGGTCTATACTGCTGAGGTGGAGGGCAAGAAGACCTCAGCTCGGTTGTTTGTCACAG
>TTN-207,ENSE00003805150,1,267,1443695,1443961,GTATAAGACTGAAATTCATGTCACCTCTTGAAGATCAAACAGTAAAAGAAGGTGAAACAGCAACTTTTGTTTGTGAACTTTCTCATGAAAAAATGCATGTAGTCTGGTTCAAAAATGATGCCAAACTCCATACAAGCAGAACAGTACTCATCTCTTCTGAGGGCAAGACTCACAAATTGGAAATGAAAGAAGTGACATTGGATGATATATCTCAGATAAAAGCTCAAGTCAAGGAGCTGAGCTCCACAGCACAGCTGAAGGTCTTAG
>TTN-207,ENSE00003801907,1,264,1443962,1444225,AGGCCGATCCCTACTTCACTGTGAAATTACATGACAAAACTGCAGTGGAGAAGGATGAGATTACTTTGAAGTGTGAAGTGAGCAAAGATGTACCAGTGAAATGGTTCAAAGATGGTGAAGAGATTGTCCCTTCACCCAAATATTCTATCAAGGCAGATGGCCTGCGCCGCATCTTAAAAATCAAAAAGGCGGACCTTAAAGATAAAGGCGAATATGTGTGTGACTGTGGCACAGACAAGACCAAGGCAAATGTTACTGTTGAGG
>TTN-207,ENSE00003802031,1,140,1444226,1444365,CTCGACTAATAAAAGTGGAAAAGCCTCTGTACGGAGTAGAGGTGTTTGTTGGTGAAACAGCCCACTTTGAAATTGAACTTTCTGAACCTGATGTTCACGGCCAGTGGAAGCTGAAAGGACAGCCTTTGACAGCTTCCCCT
>TTN-207,ENSE00003811443,1,127,1444366,1444492,GACTGTGAAATCATTGAGGATGGAAAGAAGCATATTCTGATCCTTCATAACTGTCAGCTGGGTATGACAGGAGAGGTTTCCTTCCAGGCTGCTAATGCCAAATCTGCAGCCAATCTGAAAGTGAAAG
>TTN-207,ENSE00003811384,1,267,1444493,1444759,AATTGCCTCTTATCTTCATCACACCTCTCAGTGATGTTAAAGTCTTCGAGAAAGATGAGGCTAAGTTTGAGTGTGAAGTATCCAGGGAGCCCAAAACATTCCGTTGGCTAAAAGGAACCCAGGAAATCACAGGTGATGACAGATTTGAGCTTATAAAGGATGGCACTAAGCATTCAATGGTGATCAAGTCAGCTGCTTTTGAAGATGAAGCAAAATACATGTTTGAAGCTGAAGATAAGCACACAAGTGGCAAACTGATCATTGAAG
>TTN-207,ENSE00003801954,1,267,1444760,1445026,GAATCCGGCTCAAATTCCTCACCCCTCTCAAAGATGTAACTGCCAAAGAGAAGGAAAGTGCTGTATTTACTGTGGAGTTATCTCATGATAACATCCGAGTTAAATGGTTCAAGAATGACCAGCGCCTACACACCACCAGGTCGGTCTCAATGCAAGACGAAGGGAAAACTCATTCGATCACATTCAAAGACCTGTCTATTGATGACACCTCCCAAATTAGAGTAGAAGCTATGGGGATGAGTTCAGAAGCTAAACTCACTGTGCTTG
>TTN-207,ENSE00003809996,1,267,1445027,1445293,AGGGAGACCCATATTTTACAGGAAAACTTCAAGATTATACTGGTGTAGAGAAAGATGAAGTTATTCTACAGTGTGAAATTAGCAAAGCAGATGCACCAGTGAAATGGTTTAAGGATGGGAAGGAAATAAAGCCATCCAAAAATGCTGTTATTAAGGCAGATGGCAAGAAACGCATGCTAATCCTAAAGAAAGCCTTGAAATCAGATATTGGACAGTACACCTGTGACTGTGGGACAGATAAGACCTCAGGAAAACTTGACATTGAGG
>TTN-207,ENSE00003804589,1,140,1445294,1445433,ATCGGGAAATTAAACTGGTGCGACCCCTGCACAGTGTGGAGGTGATGGAGACTGAGACAGCACGCTTTGAAACCGAAATCTCTGAAGATGATATCCACGCCAACTGGAAACTCAAGGGAGAGGCCCTACTCCAAACACCT
>TTN-207,ENSE00003805931,1,127,1445434,1445560,GATTGTGAAATTAAGGAAGAAGGCAAAATACACTCCCTTGTTTTGCACAACTGTCGCCTGGACCAGACGGGTGGGGTGGATTTCCAAGCTGCCAATGTTAAATCTAGTGCCCACCTCCGAGTTAAGC
>TTN-207,ENSE00003811344,1,143,1445561,1445703,CACGAGTAATTGGTCTTCTGAGGCCTTTAAAGGATGTCACCGTGACTGCAGGGGAAACAGCCACCTTCGACTGCGAGCTCTCCTACGAAGATATCCCAGTGGAATGGTATCTCAAAGGGAAGAAACTAGAGCCCAGCGATAAG
>TTN-207,ENSE00003802375,1,124,1445704,1445827,GTGGTCCCACGTTCAGAAGGAAAAGTTCATACACTTACTCTGAGGGATGTAAAGTTAGAAGATGCTGGGGAAGTCCAACTAACAGCAAAAGATTTCAAAACTCACGCCAACCTCTTTGTGAAAG
>TTN-207,ENSE00003806733,1,267,1445828,1446094,AACCCCCAGTTGAATTCACTAAGCCTCTTGAGGACCAGACGGTCGAAGAGGGAGCCACTGCAGTGCTGGAGTGTGAAGTCTCCAGAGAAAATGCTAAGGTGAAATGGTTCAAAAATGGGACAGAAATCCTCAAAAGCAAGAAGTATGAAATTGTTGCTGATGGCAGGGTCAGAAAACTTGTTATACATGACTGTACCCCAGAGGATATTAAAACATACACTTGTGATGCTAAGGATTTTAAGACTTCCTGTAACCTGAATGTCGTGC
>TTN-207,ENSE00003807497,1,98,1446095,1446192,CTCCTCATGTGGAATTCTTAAGACCACTCACCGACCTTCAAGTTAGAGAAAAAGAAATGGCTCGATTTGAGTGTGAACTTTCCCGAGAAAATGCTAAG
>TTN-207,ENSE00003802530,1,169,1446193,1446361,GTTAAGTGGTTTAAAGATGGTGCTGAAATTAAAAAGGGCAAAAAATATGACATCATATCCAAGGGAGCAGTGCGCATTCTTGTCATCAACAAATGTCTACTGGATGATGAAGCTGAATATTCCTGTGAAGTAAGGACAGCGAGAACTTCTGGCATGCTGACAGTTCTGG
>TTN-207,ENSE00003811387,1,267,1446362,1446628,AAGAAGAAGCTGTCTTTACCAAAAATCTTGCCAACATTGAAGTTAGTGAAACAGACACTATAAAACTGGTTTGTGAAGTCTCCAAACCTGGCGCAGAAGTGATTTGGTATAAAGGGGATGAGGAGATCATTGAAACAGGAAGATATGAAATACTGACTGAAGGACGGAAGAGAATCCTGGTCATTCAGAACGCTCACCTTGAGGATGCTGGCAACTACAACTGTCGACTCCCAAGCTCTCGAACCGATGGCAAAGTCAAAGTACATG
>TTN-207,ENSE00003802653,1,267,1446629,1446895,AACTGGCTGCTGAATTTATCTCAAAGCCTCAAAACCTTGAAATACTTGAAGGAGAAAAGGCTGAATTTGTCTGCTCTATATCAAAAGAAAGCTTTCCAGTCCAGTGGAAGAGGGATGATAAGACACTTGAATCTGGAGATAAATATGACGTTATTGCTGATGGTAAAAAGAGGGTCCTAGTTGTGAAAGATGCCACATTACAAGATATGGGCACTTACGTTGTCATGGTAGGGGCCGCCAGAGCAGCAGCTCACTTGACAGTCATTG
>TTN-207,ENSE00003802540,1,279,1446896,1447174,AAAAACTCAGGATCGTAGTTCCTCTTAAGGACACCCGGGTGAAGGAACAACAGGAAGTTGTCTTCAACTGTGAAGTCAATACTGAAGGTGCCAAAGCCAAATGGTTCAGAAATGAAGAAGCTATATTTGATAGTTCAAAATACATCATTCTCCAAAAAGACCTAGTCTACACCCTCAGAATTAGAGATGCACACTTAGATGACCAAGCCAACTATAATGTGTCTTTGACCAATCACAGAGGTGAAAATGTTAAAAGTGCAGCCAATCTAATAGTAGAAG
>TTN-207,ENSE00003802874,1,409,1447175,1447583,AGGAAGACCTTAGGATTGTTGAGCCTCTTAAAGATATTGAAACAATGGAGAAGAAATCTGTCACATTCTGGTGCAAGGTGAATCGTCTCAATGTAACACTGAAGTGGACCAAAAATGGTGAAGAAGTGCCTTTTGACAACCGTGTCTCATACAGAGTTGATAAGTACAAGCACATGTTAACCATTAAAGACTGTGGCTTCCCAGATGAAGGTGAATACATTGTCACTGCTGGACAAGATAAATCTGTTGCTGAGCTTCTCATCATAGAAGCCCCGACAGAATTTGTGGAACACTTGGAAGATCAGACAGTCACTGAGTTCGATGACGCTGTCTTCTCCTGCCAGCTCTCCAGAGAGAAAGCCAATGTAAAATGGTACAGAAATGGGAGAGAAATCAAAGAAGGCAAAAA
>TTN-207,ENSE00003804130,1,125,1447584,1447708,ATACAAATTTGAAAAAGATGGAAGTATACACAGACTCATTATAAAAGATTGCAGGCTGGATGATGAGTGTGAATATGCTTGCGGGGTAGAAGACAGGAAGTCTCGTGCTAGACTTTTTGTGGAAG
>TTN-207,ENSE00003807647,1,267,1447709,1447975,AAATTCCTGTTGAGATCATCAGGCCTCCACAAGATATTCTTGAAGCCCCTGGTGCTGATGTTGTCTTTTTAGCAGAACTCAATAAAGATAAGGTGGAAGTCCAATGGCTAAGAAATAACATGGTTGTTGTCCAGGGTGATAAACACCAGATGATGAGTGAAGGAAAGATACATCGACTACAGATTTGTGATATTAAGCCCCGTGACCAGGGTGAATACAGATTTATTGCCAAAGACAAAGAAGCCAGAGCTAAGCTTGAACTGGCAG
>TTN-207,ENSE00003802353,1,270,1447976,1448245,CTGCACCAAAAATCAAGACAGCTGACCAAGACCTTGTGGTTGATGTTGGCAAGCCTCTGACAATGGTGGTGCCATATGATGCCTACCCCAAAGCAGAAGCTGAATGGTTTAAAGAAAATGAACCTTTATCTACAAAAACCATTGATACTACGGCTGAACAAACTTCTTTCAGAATTTTAGAAGCCAAGAAAGGAGACAAAGGGAGGTATAAAATTGTGCTTCAGAACAAACATGGAAAAGCAGAAGGATTCATCAATTTAAAAGTTATTG
>TTN-207,ENSE00003809195,1,303,1448246,1448548,ATGTTCCTGGGCCAGTACGTAACTTAGAAGTGACAGAAACATTTGATGGTGAAGTGAGCCTTGCTTGGGAAGAACCTTTAACTGATGGTGGAAGCAAAATCATAGGTTACGTTGTTGAAAGACGTGACATTAAGAGAAAGACCTGGGTTCTGGCCACAGACCGTGCAGAGAGTTGTGAGTTTACTGTCACTGGTCTACAGAAAGGAGGAGTTGAGTACCTATTCCGTGTGAGTGCAAGAAACAGAGTTGGCACTGGTGAGCCAGTAGAAACTGACAATCCTGTAGAAGCAAGGAGTAAATATG
>TTN-207,ENSE00003803170,1,303,1448549,1448851,ATGTTCCAGGCCCTCCTTTGAATGTAACCATCACTGATGTGAATCGATTTGGTGTCTCACTGACATGGGAACCACCAGAGTATGATGGAGGTGCTGAGATCACAAACTACGTCATTGAATTAAGAGACAAGACTTCTATCAGGTGGGATACTGCCATGACTGTGAGAGCTGAAGACCTGTCTGCAACTGTTACTGATGTGGTAGAAGGACAGGAGTACAGTTTCCGAGTGAGAGCCCAAAATCGAATTGGAGTTGGAAAACCAAGTGCAGCCACACCCTTCGTCAAAGTTGCTGATCCAATTG
>TTN-207,ENSE00003806295,1,188,1448852,1449039,AGAGACCAAGTCCTCCTGTAAACCTAACTTCCTCAGATCAGACTCAGTCATCAGTTCAGCTCAAATGGGAACCTCCTCTGAAAGATGGAGGAAGCCCAATATTAGGCTATATAATTGAGCGATGCGAAGAAGGAAAAGATAATTGGATTCGTTGCAATATGAAACTTGTCCCTGAACTGACTTACAAG
>TTN-207,ENSE00003810732,1,115,1449040,1449154,GTTACCGGATTGGAAAAAGGAAATAAATATTTATATAGAGTATCTGCAGAAAATAAAGCTGGTGTTTCAGATCCATCTGAAATTCTTGGTCCTCTCACCGCTGACGATGCATTTG
>TTN-207,ENSE00003809985,1,285,1449155,1449439,TTGAACCAACAATGGATTTAAGTGCATTTAAAGATGGTCTGGAAGTTATTGTCCCAAATCCTATCACGATCCTGGTTCCAAGTACAGGCTATCCAAGGCCAACTGCAACCTGGTGTTTTGGAGATAAAGTACTAGAAACAGGGGACCGGGTGAAAATGAAGACCTTGTCTGCCTATGCCGAACTTGTCATTTCTCCAAGTGAACGTTCAGACAAGGGCATTTATACACTGAAATTAGAAAACCGTGTGAAAACAATTTCTGGGGAAATTGATGTCAATGTAATTG
>TTN-207,ENSE00003808828,1,152,1449440,1449591,CTCGCCCAAGTGCACCCAAAGAATTGAAATTTGGTGATATAACCAAGGACTCAGTACATTTGACTTGGGAACCACCTGATGATGATGGAGGAAGTCCGTTAACTGGATACGTTGTTGAAAAACGAGAAGTCAGCCGGAAAACATGGACTAAA
>TTN-207,ENSE00003803811,1,148,1449592,1449739,GTTATGGACTTTGTGACTGATCTAGAATTCACAGTTCCTGATCTTGTTCAAGGAAAAGAGTACTTATTTAAAGTTTGTGCTCGTAACAAATGTGGCCCTGGAGAACCTGCATATGTTGATGAACCTGTAAATATGTCAACTCCTGCAA
>TTN-207,ENSE00003803944,1,178,1449740,1449917,CGGTACCTGACCCACCAGAGAATGTTAAATGGAGAGATCGAACAGCCAATAGCATCTTCTTAACATGGGATCCACCTAAAAATGATGGTGGTTCACGCATCAAAGGATATATAGTTGAAAGATGTCCACGTGGTTCTGATAAATGGGTTGCCTGTGGAGAACCTGTTGCAGAAACAAA
>TTN-207,ENSE00003802090,1,122,1449918,1450039,AATGGAAGTGACAGGTCTTGAGGAAGGCAAATGGTATGCCTACCGCGTGAAGGCCTTAAACAGGCAGGGTGCTAGCAAACCAAGCAGACCCACAGAGGAAATCCAGGCTGTGGACACACAAG
>TTN-207,ENSE00003809522,1,288,1450040,1450327,AGGCCCCAGAAATCTTCCTCGATGTGAAGCTCCTTGCTGGTCTCACTGTAAAAGCTGGGACCAAGATTGAACTTCCTGCCACCGTAACCGGAAAACCTGAACCTAAAATAACTTGGACAAAGGCTGATATGATTCTGAAGCAGGACAAAAGAATTACCATTGAAAATGTCCCTAAGAAATCCACAGTGACTATTGTTGATAGTAAGAGAAGTGACACTGGCACATATATCATTGAGGCTGTGAATGTGTGTGGCCGGGCCACTGCTGTGGTGGAAGTGAACGTCTTAG
>TTN-207,ENSE00003804879,1,297,1450328,1450624,ATAAACCCGGACCACCAGCTGCCTTTGACATCACAGATGTAACCAATGAGTCATGTCTTCTAACATGGAACCCACCACGCGATGATGGTGGATCTAAGATCACAAACTATGTTGTGGAGAGACGAGCAACTGATAGTGAAGTGTGGCACAAGCTCTCATCCACCGTCAAGGATACAAACTTCAAGGCCACCAAATTAATCCCCAATAAAGAGTACATCTTCAGAGTTGCTGCAGAAAACATGTATGGTGTTGGTGAACCAGTTCAGGCCTCTCCAATAACAGCCAAATATCAGTTTG
>TTN-207,ENSE00003809410,1,187,1450625,1450811,ATCCACCTGGTCCTCCAACTCGCCTAGAACCTTCTGATATCACTAAAGACGCAGTGACTCTCACATGGTGTGAGCCAGATGATGATGGTGGCAGCCCAATCACAGGATACTGGGTTGAAAGACTGGATCCTGATACAGATAAATGGGTTAGATGCAATAAGATGCCAGTAAAGGACACAACATACAG
>TTN-207,ENSE00003808827,1,116,1450812,1450927,AGTGAAAGGTCTCACTAATAAGAAAAAATACAGATTCCGTGTGTTGGCTGAAAATCTTGCTGGACCTGGAAAACCAAGCAAATCAACTGAACCAATCTTAATAAAGGATCCCATAG
>TTN-207,ENSE00003806136,1,300,1450928,1451227,ATCCTCCATGGCCCCCTGGAAAACCAACTGTAAAAGATGTAGGCAAAACATCAGTAAGGTTGAATTGGACAAAACCAGAACATGATGGAGGTGCAAAGATTGAGTCTTATGTCATTGAAATGCTGAAGACTGGAACAGATGAGTGGGTCAGAGTGGCGGAAGGGGTTCCCACCACTCAGCACTTGCTCCCAGGGCTCATGGAAGGACAGGAATACTCATTCCGAGTTAGAGCTGTGAATAAGGCTGGGGAAAGTGAACCCAGTGAACCCAGTGACCCTGTGCTTTGCCGGGAGAAGCTAT
>TTN-207,ENSE00003804290,1,300,1451228,1451527,ATCCTCCATCACCACCACGCTGGCTTGAAGTTATTAATATCACAAAAAATACAGCAGACCTAAAATGGACAGTTCCTGAGAAAGATGGAGGGTCCCCCATCACCAACTACATTGTGGAAAAGAGAGACGTCAGGCGAAAAGGCTGGCAAACAGTGGATACCACTGTCAAGGACACCAAGTGCACAGTCACCCCACTGACTGAGGGCTCTTTATATGTGTTCCGAGTTGCTGCAGAAAATGCTATAGGACAAAGCGACTACACCGAAATTGAGGACTCTGTGCTGGCCAAAGACACCTTTA
>TTN-207,ENSE00003803723,1,106,1451528,1451633,CCACTCCTGGACCACCCTACGCCCTGGCAGTGGTTGATGTGACAAAACGACATGTTGACCTAAAGTGGGAGCCACCTAAAAATGATGGTGGAAGACCAATACAGAG
>TTN-207,ENSE00003805819,1,197,1451634,1451830,ATATGTCATTGAGAAGAAAGAAAGGTTAGGTACCCGTTGGGTGAAAGCTGGAAAGACTGCAGGACCTGACTGTAACTTCAGAGTAACTGATGTCATCGAAGGAACAGAGGTCCAGTTTCAGGTTCGGGCTGAAAATGAAGCTGGAGTTGGCCACCCAAGTGAACCCACAGAAATCCTATCCATTGAAGATCCAACAA
>TTN-207,ENSE00003806467,1,306,1451831,1452136,GTCCTCCCTCACCACCCCTTGACCTACATGTGACTGATGCTGGGAGAAAACACATTGCCATTGCTTGGAAGCCTCCAGAGAAAAATGGTGGAAGTCCTATCATAGGATACCATGTTGAAATGTGTCCAGTAGGCACTGAGAAATGGATGAGAGTTAATTCTCGCCCAATAAAGGACTTGAAATTCAAGGTTGAAGAAGGTGTTGTTCCTGACAAAGAATATGTCCTGAGAGTGAGAGCAGTCAATGCTATTGGTGTCAGCGAGCCATCTGAAATCTCTGAAAATGTGGTTGCCAAAGACCCAGACT
>TTN-207,ENSE00003808061,1,279,1452137,1452415,GCAAGCCAACAATTGACCTGGAGACTCATGACATTATTGTTATTGAAGGTGAAAAGTTAAGCATTCCTGTTCCCTTCAGAGCTGTCCCAGTTCCAACTGTTAGTTGGCATAAAGATGGCAAAGAAGTTAAAGCAAGTGATAGATTAACAATGAAGAATGATCACATCTCTGCACACCTTGAAGTTCCCAAGAGTGTCCGTGCAGATGCCGGAATTTATACCATTACACTGGAGAATAAGCTCGGCTCAGCAACAGCCTCAATCAATGTCAAAGTCATAG
>TTN-207,ENSE00003811164,1,300,1452416,1452715,GCCTACCTGGACCATGCAAAGATATTAAAGCAAGTGACATTACCAAGAGTTCTTGTAAGTTAACTTGGGAACCTCCAGAATTTGATGGTGGAACCCCAATTCTTCATTATGTCCTGGAGCGCAGAGAAGCTGGGAGGAGAACATATATACCAGTCATGTCTGGTGAGAACAAACTGTCATGGACTGTGAAGGATCTCATACCAAATGGTGAATACTTCTTCCGTGTTAAAGCAGTCAACAAGGTTGGTGGAGGAGAATATATTGAACTGAAAAATCCAGTCATTGCTCAAGATCCAAAGC
>TTN-207,ENSE00003805132,1,303,1452716,1453018,AACCCCCTGATCCACCTGTAGATGTAGAGGTTCATAATCCTACAGCGGAGGCAATGACTATTACATGGAAGCCACCTTTGTATGATGGAGGGAGCAAGATAATGGGCTACATCATAGAGAAGATTGCTAAGGGTGAAGAAAGGTGGAAGAGATGCAATGAACACCTGGTACCAATCCTGACCTATACAGCAAAAGGACTTGAAGAGGGGAAAGAGTACCAATTCCGTGTGCGAGCAGAGAACGCCGCGGGTATTAGTGAACCTTCTCGGGCTACTCCTCCAACCAAAGCTGTAGATCCCATTG
>TTN-207,ENSE00003805056,1,363,1453019,1453381,ATGCCCCCAAAGTCATTCTGAGAACAAGCCTAGAAGTGAAACGAGGTGATGAAATAGCACTTGATGCAAGTATTTCTGGATCACCTTACCCAACTATTACATGGATAAAGGATGAAAATGTTATTGTACCAGAGGAAATTAAGAAGCGTGCAGCACCCTTGGTTAGGAGAAGGAAGGGTGAAGTTCAAGAAGAAGAACCATTTGTCCTGCCTCTGACACAGCGTTTGAGTATTGACAACAGCAAAAAGGGAGAATCTCAGCTACGCGTCCGAGATTCTCTCCGACCTGACCATGGTCTGTATATGATCAAAGTTGAAAATGACCACGGTATTGCAAAAGCTCCTTGTACTGTCAGTGTGTTAG
>TTN-207,ENSE00003811138,1,303,1453382,1453684,ATACACCGGGACCACCAATCAACTTTGTATTTGAAGATATCAGAAAGACCTCAGTCCTTTGTAAATGGGAACCACCCCTTGATGATGGTGGCAGTGAAATCATAAACTACACTTTGGAAAAGAAAGACAAGACAAAACCCGACTCAGAATGGATTGTTGTCACTTCAACACTTAGACATTGCAAATATTCAGTAACAAAACTGATTGAAGGAAAAGAGTACCTCTTCCGTGTAAGAGCTGAAAACAGATTTGGGCCAGGTCCACCATGTGTTTCAAAGCCACTTGTGGCTAAAGATCCATTTG
>TTN-207,ENSE00003809346,1,300,1453685,1453984,GACCACCTGATGCACCAGATAAGCCCATTGTGGAAGATGTTACCAGCAACAGTATGCTAGTGAAATGGAATGAACCAAAAGATAATGGAAGCCCCATTTTGGGTTACTGGCTTGAAAAACGTGAAGTTAACAGTACACATTGGTCTCGTGTCAACAAAAGCCTTCTGAATGCCTTGAAAGCCAATGTAGATGGCTTATTAGAAGGACTCACCTATGTCTTCAGAGTATGTGCTGAAAATGCAGCTGGACCTGGAAAGTTCAGTCCACCTTCAGATCCCAAAACAGCACATGATCCAATCT
>TTN-207,ENSE00003806782,1,297,1453985,1454281,CTCCTCCTGGGCCACCTATCCCAAGAGTCACTGACACAAGCTCTACAACTATTGAACTAGAATGGGAACCCCCAGCTTTCAATGGTGGTGGGGAAATTGTTGGCTATTTTGTTGATAAGCAGTTGGTTGGCACAAATGAATGGTCACGCTGCACAGAGAAGATGATCAAGGTCCGTCAGTACACCGTCAAAGAAATCCGAGAGGGTGCTGATTACAAACTTCGGGTGAGTGCTGTCAATGCCGCAGGGGAAGGACCGCCTGGAGAAACACAACCTGTTACTGTGGCTGAACCACAAG
>TTN-207,ENSE00003804121,1,285,1454282,1454566,AGCCTCCAGCTGTGGAACTGGATGTTTCTGTCAAGGGTGGAATACAAATAATGGCTGGGAAGACTCTTAGAATTCCAGCTGTGGTGACTGGTCGCCCTGTACCTACAAAAGTATGGACCAAAGAAGAAGGGGAGCTGGATAAAGACCGTGTTGTAATAGACAACGTTGGAACCAAATCTGAACTAATTATCAAGGATGCACTGCGAAAAGACCATGGCAGATATGTGATTACAGCTACAAATAGCTGTGGTTCCAAATTTGCAGCAGCCAGGGTAGAAGTTTTTG
>TTN-207,ENSE00003804454,1,294,1454567,1454860,ATGTCCCTGGTCCAGTTCTTGACTTAAAACCTGTTGTAACAAACAGAAAAATGTGTCTACTTAACTGGTCTGATCCAGAAGATGATGGAGGAAGTGAAATAACAGGCTTTATCATTGAAAGAAAAGATGCCAAGATGCATACTTGGAGACAACCAATAGAGACTGAGAGATCTAAATGTGACATCACAGGTCTGCTTGAGGGACAAGAATATAAGTTCCGTGTTATTGCCAAGAACAAGTTTGGCTGTGGCCCTCCTGTTGAAATAGGACCAATTCTTGCAGTTGATCCACTAG
>TTN-207,ENSE00003803420,1,300,1454861,1455160,GTCCTCCAACATCTCCAGAGAGGCTCACATACACTGAAAGGACAAAGTCCACTATCACACTTGACTGGAAAGAGCCCCGCAGTAATGGTGGCAGTCCCATCCAAGGATATATCATTGAAAAACGGCGTCATGACAAACCTGACTTTGAAAGAGTTAACAAGCGACTCTGCCCAACCACATCTTTTCTGGTTGAAAATCTTGATGAACACCAAATGTATGAGTTCCGTGTCAAAGCTGTCAATGAAATTGGTGAAAGTGAACCATCCCTACCTCTTAATGTAGTCATACAAGATGATGAAG
>TTN-207,ENSE00003809028,1,309,1455161,1455469,TGCCTCCAACTATTAAGTTGCGTCTGAGTGTTCGAGGAGACACTATCAAAGTTAAGGCAGGAGAGCCTGTCCACATCCCTGCAGATGTGACAGGCCTTCCAATGCCTAAGATTGAATGGTCCAAAAATGAAACTGTAATTGAAAAACCCACTGATGCACTTCAGATAACCAAGGAAGAGGTATCCCGAAGTGAGGCAAAAACTGAGCTTAGCATTCCCAAAGCGGTCCGGGAGGACAAAGGCACTTACACAGTTACTGCTTCCAATCGCCTTGGCTCAGTGTTCCGAAATGTTCACGTTGAAGTATATG
>TTN-207,ENSE00003801894,1,191,1455470,1455660,ACCGCCCATCCCCACCAAGAAATCTTGCTGTTACTGACATTAAAGCTGAATCTTGCTACTTGACATGGGATGCCCCTCTTGATAATGGTGGCAGTGAAATCACCCATTATGTTATTGACAAACGTGATGCAAGTAGGAAGAAAGCAGAATGGGAGGAAGTCACCAACACTGCTGTAGAGAAAAGATATGGG
>TTN-207,ENSE00003809851,1,430,1455661,1456090,ATCTGGAAACTTATCCCCAATGGTCAGTATGAGTTCCGAGTCAGGGCAGTGAATAAATATGGAATCAGTGATGAGTGCAAATCAGATAAAGTAGTCATTCAAGATCCTTATCGCCTTCCTGGACCTCCAGGAAAACCAAAAGTTTTGGCACGCACCAAAGGATCAATGCTAGTGAGCTGGACTCCTCCTTTGGACAATGGTGGCTCTCCAATTACTGGCTACTGGCTGGAGAAAAGAGAAGAGGGAAGTCCTTATTGGTCACGTGTTAGCCGAGCACCAATAACCAAAGTGGGATTGAAAGGCGTGGAATTTAATGTTCCTCGTTTGCTTGAAGGCGTTAAATACCAGTTCAGAGCCATGGCAATAAATGCTGCAGGAATTGGTCCTCCCAGTGAACCATCAGATCCAGAGGTTGCAGGAGATCCCATAT
>TTN-207,ENSE00003808594,1,309,1456091,1456399,TTCCACCGGGGCCACCTTCTTGCCCAGAAGTTAAAGATAAAACGAAGTCAAGCATCTCACTAGGATGGAAACCTCCAGCCAAAGATGGTGGCAGCCCAATCAAAGGATACATTGTAGAAATGCAAGAAGAAGGTACTACTGACTGGAAAAGAGTAAATGAACCAGACAAACTTATAACTACCTGTGAATGTGTGGTGCCTAATCTGAAAGAGCTCAGGAAGTACAGATTCAGAGTGAAAGCTGTCAATGAAGCTGGTGAATCTGAACCAAGTGATACAACTGGGGAGATCCCTGCCACTGATATTCAAG
>TTN-207,ENSE00003810473,1,149,1456400,1456548,AGGAACCAGAAGTTTTCATTGACATTGGAGCACAGGACTGTCTGGTTTGTAAAGCTGGCTCACAGATTAGGATTCCTGCTGTCATCAAGGGACGCCCAACACCAAAATCATCTTGGGAATTTGATGGAAAGGCAAAGAAAGCAATGAAG
>TTN-207,ENSE00003801625,1,33,1456549,1456581,GATGGAGTTCATGACATACCCGAAGATGCACAG
>TTN-207,ENSE00003802643,1,130,1456582,1456711,CTGGAGACTGCTGAAAACTCCTCAGTAATTATTATTCCGGAGTGTAAACGATCTCATACAGGCAAATACAGCATCACAGCCAAGAATAAAGCAGGACAAAAGACTGCAAATTGCAGAGTTAAAGTCATGG
>TTN-207,ENSE00003804239,1,300,1456712,1457011,ATGTACCAGGCCCACCCAAAGATCTGAAAGTCAGTGATATCACAAGGGGTAGTTGCAGACTTTCATGGAAGATGCCAGACGACGATGGAGGAGACAGGATCAAAGGCTATGTTATTGAGAAGAGGACTATTGATGGAAAAGCCTGGACCAAAGTCAATCCAGACTGTGGAAGCACCACATTTGTAGTGCCTGATCTCCTCTCTGAACAGCAATATTTCTTCCGTGTGCGAGCAGAAAACCGTTTTGGTATTGGCCCACCTGTGGAAACCATTCAGAGGACCACTGCCAGAGATCCGATAT
>TTN-207,ENSE00003806278,1,318,1457012,1457329,ATCCTCCTGATCCTCCTATTAAACTCAAGATTGGCCTCATCACAAAGAACACAGTGCATCTGTCATGGAAACCCCCGAAGAATGATGGGGGCTCCCCTGTTACCCACTATATTGTTGAGTGCCTTGCATGGGACCCTACTGGGACAAAGAAAGAAGCCTGGAGGCAGTGCAATAAGCGTGATGTGGAAGAACTGCAATTTACTGTTGAAGACCTAGTAGAGGGTGGGGAATATGAATTCCGAGTCAAAGCTGTCAATGCTGCAGGAGTCAGCAAGCCTTCAGCCACTGTTGGCCCTGTGACTGTCAAAGACCAGACAT
>TTN-207,ENSE00003801391,1,297,1457330,1457626,GCCCACCATCAATTGATCTAAAAGAATTCATGGAGGTTGAAGAAGGAACCAATGTTAACATTGTGGCCAAAATTAAAGGTGTGCCATTCCCGACACTAACCTGGTTTAAAGCTCCTCCAAAGAAGCCTGATAACAAAGAACCTGTTCTCTATGACACCCATGTCAACAAACTGGTGGTAGATGATACTTGCACTTTAGTTATTCCGCAGTCTCGCAGGAGTGACACTGGCTTATATACCATCACAGCTGTAAATAATCTGGGAACAGCATCAAAGGAGATGAGACTGAATGTCCTGG
>TTN-207,ENSE00003806021,1,300,1457627,1457926,GTCGTCCTGGCCCTCCAGTGGGACCCATAAAATTTGAATCTGTTTCAGCAGATCAAATGACACTATCTTGGTTTCCACCTAAAGATGATGGTGGGTCTAAGATTACAAACTATGTAATTGAGAAAAGAGAAGCTAACAGGAAGACATGGGTCCATGTCTCCAGTGAACCTAAGGAGTGCACGTACACGATTCCCAAATTGCTAGAAGGCCATGAATATGTATTCCGAATCATGGCCCAGAATAAATATGGCATTGGAGAACCTCTTGACAGTGAACCTGAAACAGCAAGAAACCTCTTCT
>TTN-207,ENSE00003803442,1,315,1457927,1458241,CTGTCCCTGGAGCACCAGATAAACCAACAGTTAGCAGCGTGACTCGTAACTCCATGACTGTCAACTGGGAAGAGCCAGAATATGATGGAGGCTCTCCTGTGACAGGGTACTGGCTGGAAATGAAAGACACCACTTCAAAGAGATGGAAGAGAGTTAACCGAGATCCTATCAAAGCCATGACTTTGGGTGTTTCTTATAAAGTGACTGGTCTTATTGAAGGTTCCGACTATCAATTCCGGGTATATGCAATCAATGCTGCTGGCGTGGGTCCAGCAAGTCTGCCATCAGACCCAGCGACTGCTAGAGATCCAATTG
>TTN-207,ENSE00003801787,1,149,1458242,1458390,CCCCTCCTGGTCCTCCATTTCCCAAAGTGACAGATTGGACTAAATCATCTGCAGATCTGGAGTGGTCTCCCCCACTAAAAGATGGTGGATCCAAAGTAACTGGATACATCGTTGAATATAAAGAAGAAGGAAAAGAAGAATGGGAAAAG
>TTN-207,ENSE00003802004,1,151,1458391,1458541,GGTAAAGATAAAGAAGTGAGAGGAACAAAGCTTGTTGTGACAGGATTAAAGGAAGGAGCATTCTACAAATTTAGAGTTAGAGCAGTCAACATTGCTGGCATTGGAGAACCTGGAGAGGTCACAGATGTCATTGAAATGAAGGACAGACTTG
>TTN-207,ENSE00003808790,1,282,1458542,1458823,TTTCACCTGACCTTCAGCTAGATGCCAGTGTCAGAGATAGAATTGTTGTCCATGCTGGAGGGGTGATCCGAATCATTGCCTATGTGTCTGGAAAGCCTCCTCCAACCGTCACCTGGAACATGAATGAAAGAACCTTACCTCAAGAAGCCACCATTGAGACCACAGCCATTAGCTCATCCATGGTCATCAAGAACTGCCAGAGGAGCCATCAAGGCGTCTATTCTCTTCTTGCCAAAAATGAAGCCGGAGAAAGAAAGAAGACAATTATTGTTGATGTATTAG
>TTN-207,ENSE00003807896,1,303,1458824,1459126,ATGTTCCAGGTCCCGTTGGAACACCATTCCTAGCTCACAACCTAACCAATGAGTCCTGCAAACTGACATGGTTTTCTCCAGAAGATGATGGAGGCTCTCCAATCACCAATTATGTCATTGAAAAGCGTGAATCTGACCGCAGAGCATGGACCCCAGTGACATATACAGTTACCCGACAAAATGCTACTGTCCAGGGTCTCATTCAAGGAAAAGCCTACTTTTTCCGAATTGCGGCTGAAAATAGTATTGGCATGGGTCCATTTGTTGAGACATCAGAGGCACTTGTTATCAGAGAGCCAATAA
>TTN-207,ENSE00003801753,1,303,1459127,1459429,CTGTACCAGAGCGTCCTGAAGACCTGGAAGTCAAAGAAGTTACTAAAAATACTGTAACTTTGACTTGGAATCCTCCTAAGTATGATGGTGGGTCAGAAATTATTAACTATGTCCTAGAAAGTCGGCTCATTGGGACTGAGAAGTTCCACAAAGTTACAAATGACAACTTGCTTAGCAGAAAATACACTGTTAAAGGCTTAAAAGAAGGTGATACCTATGAGTACCGTGTCAGTGCTGTCAACATTGTTGGACAAGGCAAACCATCATTTTGCACCAAACCAATTACTTGCAAGGATGAGCTGG
>TTN-207,ENSE00003807039,1,282,1459430,1459711,CACCCCCAACGCTTCACCTCGACTTCAGAGATAAGCTCACGATTCGAGTTGGTGAAGCTTTTGCCCTCACTGGCCGTTACTCAGGCAAACCAAAGCCTAAGGTTTCCTGGTTCAAAGATGAAGCTGATGTGCTGGAAGATGATCGCACTCATATAAAGACTACACCAGCAACACTTGCTTTAGAGAAGATCAAGGCCAAACGTTCAGATTCCGGCAAATACTGTGTGGTTGTGGAGAACAGTACAGGCTCTAGGAAAGGTTTCTGTCAAGTTAATGTTGTTG
>TTN-207,ENSE00003804106,1,300,1459712,1460011,ACCGTCCTGGACCACCAGTAGGACCAGTTAGTTTTGATGAGGTGACCAAAGATTACATGGTTATCTCTTGGAAGCCTCCTTTAGATGATGGAGGCAGTAAAATCACCAATTATATTATTGAGAAGAAGGAAGTGGGTAAAGACGTCTGGATGCCAGTGACATCTGCAAGTGCTAAAACAACATGCAAAGTTTCTAAACTACTTGAAGGAAAAGATTATATTTTCCGGATACATGCTGAAAATCTGTATGGAATAAGTGATCCTCTGGTGTCTGATTCAATGAAAGCCAAAGATCGTTTCA
>TTN-207,ENSE00003801817,1,303,1460012,1460314,GGGTTCCTGATGCACCTGATCAGCCAATTGTTACAGAAGTTACCAAAGACTCTGCATTAGTAACCTGGAATAAGCCACATGATGGAGGAAAACCCATCACAAACTACATCCTGGAAAAGAGAGAAACTATGTCTAAACGATGGGCTAGAGTTACCAAAGATCCTATTCATCCATACACTAAATTTAGGGTTCCTGATCTTCTAGAAGGATGTCAGTATGAATTCCGGGTTTCTGCAGAAAATGAAATTGGTATTGGAGATCCAAGCCCACCATCCAAACCAGTCTTTGCTAAAGATCCAATTG
>TTN-207,ENSE00003810564,1,309,1460315,1460623,CTAAACCAAGTCCACCTGTTAATCCTGAAGCAATAGATACAACATGCAATTCAGTCGATCTAACTTGGCAGCCACCACGTCATGATGGTGGGAGCAAGATTCTGGGTTATATTGTTGAGTACCAGAAAGTTGGAGATGAAGAGTGGAGAAGAGCCAATCACACCCCTGAGTCATGTCCTGAAACTAAATATAAAGTCACCGGTCTTCGGGACGGTCAAACCTATAAGTTTAGAGTGTTAGCAGTCAATGCAGCTGGTGAATCAGATCCAGCTCATGTTCCGGAGCCAGTCCTAGTAAAAGACAGGCTTG
>TTN-207,ENSE00003807476,1,282,1460624,1460905,AACCCCCTGAGTTGATTCTTGATGCCAACATGGCAAGAGAACAACACATTAAAGTTGGTGATACTCTAAGACTTAGTGCCATCATCAAAGGAGTGCCATTCCCAAAAGTAACTTGGAAAAAAGAAGACAGAGATGCTCCAACTAAAGCAAGAATTGATGTGACTCCAGTTGGTAGCAAGCTTGAAATTCGTAATGCTGCCCATGAAGATGGTGGAATTTATTCTTTAACAGTGGAGAATCCAGCTGGTTCAAAAACTGTCTCAGTAAAAGTACTTGTATTAG
>TTN-207,ENSE00003807363,1,300,1460906,1461205,ATAAACCTGGGCCACCTAGAGATCTGGAAGTCAGTGAAATTAGGAAAGATTCATGTTACCTTACTTGGAAAGAACCACTGGATGATGGTGGTTCTGTTATTACCAATTATGTGGTTGAGAGGAGAGATGTTGCCAGCGCCCAGTGGTCACCTCTCTCAGCTACATCAAAGAAAAAGAGTCACTTCGCTAAGCATCTGAATGAAGGCAACCAGTACCTCTTCCGAGTAGCTGCGGAGAACCAGTATGGACGTGGTCCTTTTGTTGAAACACCAAAACCAATCAAGGCTTTGGATCCTCTCC
>TTN-207,ENSE00003808994,1,294,1461206,1461499,ATCCCCCAGGGCCACCCAAGGACCTGCACCATGTAGATGTTGACAAGACTGAAGTCTCCCTAGTCTGGAATAAGCCGGATCGTGATGGTGGTTCTCCAATCACTGGATATTTGGTAGAATATCAAGAAGAAGGCACCCAGGACTGGATTAAATTTAAGACTGTGACAAACTTAGAGTGTGTGGTTACTGGACTACAACAAGGAAAGACCTATAGATTCCGTGTAAAAGCTGAAAACATTGTGGGTCTTGGTCTCCCTGACACAACTATCCCGATAGAATGTCAAGAAAAACTAG
>TTN-207,ENSE00003810188,1,2967,1461500,1464466,TGCCTCCATCCGTGGAGCTAGATGTGAAATTAATTGAAGGTCTTGTGGTAAAGGCTGGAACCACAGTCAGATTCCCTGCTATTATAAGAGGTGTGCCTGTTCCTACTGCAAAGTGGACAACCGATGGGAGTGAGATTAAAACCGATGAGCACTACACAGTTGAAACAGACAACTTCTCATCAGTACTTACCATTAAGAACTGCTTAAGGAGAGACACTGGGGAATATCAAATCACAGTTTCCAATGCAGCCGGTAGCAAAACAGTAGCCGTACATCTTACTGTTCTTGATGTTCCTGGGCCACCAACAGGTCCTATTAATATTCTGGATGTTACTCCTGAACACATGACTATCTCATGGCAGCCACCTAAGGATGATGGAGGAAGCCCTGTGATAAATTATATTGTTGAGAAACAAGATACAAGGAAAGACACGTGGGGTGTTGTCTCTTCCGGAAGCAGTAAGACAAAGCTGAAAATCCCACATCTGCAGAAGGGCTGTGAATATGTTTTCCGAGTTAGAGCAGAGAATAAGATAGGTGTTGGTCCTCCCCTTGACTCCACACCTACTGTTGCTAAGCATAAATTTAGTCCTCCGTCTCCTCCTGGTAAACCAGTGGTTACTGACATTACTGAAAATGCAGCAACAGTGTCTTGGACCCTGCCAAAATCTGATGGTGGCAGTCCAATAACTGGCTACTATATGGAACGTCGAGAAGTAACTGGCAAATGGGTGAGGGTCAACAAAACACCTATCGCTGACCTGAAGTTCAGAGTGACTGGACTCTATGAAGGAAATACATATGAGTTTAGAGTTTTTGCTGAAAATCTTGCAGGACTAAGCAAACCATCCCCAAGTTCTGATCCAATAAAAGCTTGCCGGCCCATCAAACCACCTGGACCACCTATTAATCCTAAACTGAAAGACAAGAGCAGAGAAACAGCTGATTTGGTGTGGACAAAGCCTCTCAGTGATGGTGGTAGCCCCATTCTAGGATATGTAGTGGAATGTCAGAAACCTGGCACAGCACAATGGAACAGGATTAATAAAGATGAACTCATTAGGCAATGTGCCTTTAGGGTACCTGGACTAATTGAAGGAAATGAGTACAGATTCCGTATAAAGGCAGCTAATATTGTAGGAGAGGGTGAGCCAAGAGAACTAGCAGAATCTGTGATTGCAAAAGATATCCTTCATCCTCCAGAAGTAGAACTTGATGTTACTTGTCGTGATGTTATTACCGTGAGAGTAGGCCAAACTATCCGCATTCTAGCTCGAGTCAAAGGCAGACCTGAACCAGACATAACTTGGACTAAGGAAGGCAAAGTATTGGTCCGAGAAAAGAGGGTGGACCTTATTCAGGATCTACCTCGTGTTGAGTTACAAATTAAAGAAGCTGTTAGAGCTGATCATGGCAAGTATATCATCTCAGCTAAGAACAGCAGTGGACATGCCCAAGGTTCAGCCATCGTTAACGTCCTTGACAGACCTGGGCCTTGCCAGAATTTGAAGGTTACCAATGTAACCAAAGAGAACTGTACAATTTCTTGGGAAAACCCACTAGATAATGGTGGCTCAGAAATAACAAACTTCATAGTAGAATATCGCAAACCAAACCAGAAAGGCTGGTCAATTGTTGCATCAGATGTCACTAAACGATTAATCAAGGCCAACCTTTTAGCCAACAATGAATACTATTTCCGAGTTTGTGCAGAGAATAAAGTAGGTGTTGGGCCAACCATCGAAACAAAAACTCCCATTCTGGCTATTAACCCTATTGACAGACCAGGTGAGCCTGAAAACCTTCACATTGCAGATAAAGGAAAGACATTTGTCTATCTAAAGTGGCGGAGGCCTGACTATGATGGTGGCAGTCCAAATCTGTCATATCATGTTGAGAGAAGGCTTAAGGGCTCCGATGACTGGGAAAGAGTGCATAAAGGAAGCATTAAAGAAACTCACTACATGGTTGACAGATGTGTTGAAAACCAGATTTATGAGTTCAGAGTGCAAACAAAGAATGAAGGTGGGGAAAGTGACTGGGTGAAGACAGAGGAAGTTGTTGTGAAAGAAGACTTACAAAAACCAGTACTTGATCTGAAATTAAGTGGGGTCCTAACTGTCAAAGCAGGGGACACCATTAGGCTTGAGGCAGGGGTTAGAGGCAAACCATTCCCAGAAGTTGCATGGACCAAGGACAAAGACGCTACAGACTTAACAAGATCACCAAGGGTCAAGATTGATACCCGTGCTGATTCATCTAAATTTTCTCTTACTAAAGCAAAGCGAAGTGATGGGGGTAAATATGTAGTTACGGCAACTAACACGGCTGGCAGTTTTGTGGCCTATGCCACTGTCAATGTTTTAGATAAGCCTGGTCCTGTGAGAAATCTGAAAATTGTTGATGTGTCCAGTGATAGGTGTACTGTTTGCTGGGATCCACCAGAAGATGATGGTGGCTGTGAAATCCAAAATTATATTCTAGAAAAATGTGAGACAAAGCGAATGGTTTGGTCTACCTATTCTGCTACTGTCTTGACACCTGGTACTACAGTAACACGTCTCATAGAAGGAAATGAATATATTTTCAGAGTCCGTGCAGAAAATAAAATAGGCACAGGGCCTCCAACAGAAAGTAAACCAGTCATAGCCAAAACCAAGTATGATAAACCTGGTCGCCCTGATCCCCCAGAAGTCACTAAAGTAAGCAAAGAAGAGATGACTGTGGTTTGGAATCCACCTGAATATGATGGTGGAAAGTCTATAACTGGATACTTTTTGGAGAAAAAGGAAAAGCATTCAACACGATGGGTCCCTGTCAACAAGAGTGCAATCCCTGAGAGACGTATGAAAGTACAGAATCTCCTCCCAGACCATGAATATCAGTTCCGTGTCAAGGCAGAAAATGAAATTGGAATTGGAGAACCAAGCTTGCCTTCAAGACCGGTGGTGGCAAAAGACCCCATAG
>TTN-207,ENSE00003811401,1,321,1464467,1464787,AGCCACCTGGTCCACCAACCAATTTCAGAGTGGTTGATACAACCAAACATTCCATAACTCTTGGGTGGGGAAAACCAGTCTATGATGGTGGTGCACCGATCATTGGATATGTTGTGGAAATGAGACCAAAAATAGCAGATGCGTCTCCTGATGAAGGCTGGAAACGGTGTAATGCTGCAGCACAGCTTGTACGCAAGGAATTCACTGTTACCAGCTTGGATGAAAACCAGGAATATGAGTTCAGGGTGTGTGCCCAAAACCAAGTTGGTATTGGGCGCCCTGCAGAGCTAAAGGAAGCTATCAAACCTAAAGAAATACTAG
>TTN-207,ENSE00003805661,1,285,1464788,1465072,AACCTCCGGAGATTGATTTGGATGCCAGCATGAGGAAACTGGTCATAGTGAGAGCAGGATGCCCTATTCGTCTCTTTGCTATAGTGAGAGGACGACCAGCCCCTAAAGTCACTTGGCGAAAAGTTGGCATTGATAATGTGGTCAGAAAAGGACAAGTTGATCTGGTTGACACTATGGCCTTCCTTGTCATCCCCAATTCTACCCGTGATGACTCAGGAAAATATTCCTTAACACTTGTGAACCCAGCAGGAGAAAAGGCTGTATTCGTAAATGTCAGAGTATTAG
>TTN-207,ENSE00003804742,1,300,1465073,1465372,ACACTCCTGGGCCTGTGTCTGATTTAAAAGTTTCAGATGTCACTAAAACATCATGCCATGTGTCCTGGGCCCCTCCTGAAAACGACGGTGGGAGCCAAGTGACACATTATATCGTGGAGAAACGTGAGGCAGACAGAAAGACATGGTCGACCGTTACCCCAGAAGTTAAGAAAACAAGCTTCCATGTAACCAATCTTGTCCCTGGGAATGAGTATTACTTCAGAGTAACTGCTGTCAACGAATATGGCCCTGGCGTCCCAACAGATGTCCCAAAACCAGTGCTTGCATCAGATCCTCTAA
>TTN-207,ENSE00003810357,1,303,1465373,1465675,GTGAGCCGGATCCCCCAAGGAAATTAGAAGTGACTGAAATGACCAAGAACAGTGCCACCTTAGCCTGGTTACCTCCCCTACGTGATGGAGGTGCTAAAATCGATGGCTACATCACTAGTTACAGAGAAGAAGAGCAGCCTGCAGATCGCTGGACAGAGTACTCAGTGGTAAAAGATCTGAGCCTTGTTGTCACTGGCCTAAAGGAAGGAAAGAAATACAAATTTAGAGTAGCGGCCAGAAATGCTGTTGGAGTCAGTTTGCCAAGAGAAGCTGAAGGAGTGTATGAAGCCAAAGAACAACTGT
>TTN-207,ENSE00003801707,1,276,1465676,1465951,TGCCACCAAAGATCCTTATGCCAGAGCAAATAACTATCAAAGCTGGGAAAAAACTCCGAATTGAAGCCCATGTGTATGGAAAGCCTCATCCCACCTGTAAATGGAAAAAAGGAGAAGATGAAGTTGTCACATCCAGCCACCTGGCAGTGCATAAAGCAGACAGCTCTTCAATTCTGATCATAAAAGATGTGACTAGGAAAGACAGTGGTTACTACAGCCTCACAGCAGAGAACAGTTCTGGGACAGACACTCAGAAAATCAAAGTTGTAGTCATGG
>TTN-207,ENSE00003810399,1,300,1465952,1466251,ATGCCCCCGGCCCCCCTCAGCCTCCATTTGACATTTCTGATATAGACGCTGATGCTTGCTCCCTGTCATGGCACATCCCTCTGGAGGACGGAGGCAGTAACATCACCAATTATATAGTGGAGAAGTGTGATGTAAGCCGAGGTGACTGGGTCACGGCTCTAGCTTCAGTCACAAAAACTTCCTGCAGGGTTGGAAAGCTGATCCCAGGCCAGGAGTACATCTTCCGGGTCCGTGCTGAAAACCGATTTGGCATTTCAGAGCCTCTCACATCTCCAAAGATGGTTGCGCAGTTCCCATTTG
>TTN-207,ENSE00003810448,1,303,1466252,1466554,GTGTTCCTAGTGAACCAAAGAATGCACGAGTCACCAAAGTCAACAAGGACTGTATTTTTGTTGCTTGGGACAGACCAGATAGTGATGGAGGGAGCCCCATTATTGGTTATCTGATTGAACGCAAGGAAAGAAACAGTTTGCTGTGGGTGAAAGCCAATGATACTCTTGTCCGGTCAACTGAATATCCTTGTGCTGGCCTTGTAGAAGGTCTTGAGTATTCATTCAGAATCTATGCCCTAAACAAAGCTGGATCCAGCCCACCCAGCAAACCCACAGAATATGTAACTGCAAGAATGCCAGTTG
>TTN-207,ENSE00003802505,1,300,1466555,1466854,ATCCTCCTGGGAAACCTGAGGTTATTGATGTCACCAAGAGTACTGTATCTCTGATCTGGGCTCGTCCAAAGCATGATGGAGGCAGTAAAATTATTGGCTATTTCGTAGAAGCTTGCAAACTTCCTGGTGATAAATGGGTACGGTGCAATACTGCACCTCACCAGATTCCCCAGGAAGAGTACACAGCTACTGGCCTAGAAGAGAAAGCTCAGTATCAATTTAGAGCTATTGCCAGGACCGCGGTAAACATTAGCCCACCTTCTGAACCTTCTGATCCAGTGACTATCCTCGCAGAAAATG
>TTN-207,ENSE00003806397,1,288,1466855,1467142,TCCCTCCCAGGATAGACCTGAGTGTGGCTATGAAATCTTTGCTTACTGTGAAAGCTGGAACTAATGTCTGCTTGGATGCTACTGTTTTTGGTAAACCGATGCCAACAGTTTCTTGGAAAAAAGATGGCACACTGCTAAAACCAGCAGAAGGCATAAAGATGGCCATGCAGCGGAATCTGTGCACCTTGGAGCTATTCAGCGTGAACCGGAAGGACTCAGGAGACTATACCATTACTGCTGAAAATTCAAGTGGTTCTAAATCAGCCACCATTAAGCTTAAAGTGTTAG
>TTN-207,ENSE00003807889,1,297,1467143,1467439,ATAAACCGGGTCCTCCAGCATCTGTTAAAATCAACAAAATGTATTCAGATCGTGCTATGCTTTCTTGGGAACCGCCTCTTGAAGATGGAGGCTCAGAAATCACCAACTATATTGTTGACAAACGTGAAACAAGCAGGCCCAACTGGGCTCAAGTCTCTGCAACTGTGCCTATCACCAGCTGCAGCGTGGAGAAACTTATAGAGGGCCATGAGTATCAGTTCCGTATTTGTGCTGAAAATAAATATGGAGTAGGCGATCCAGTCTTCACTGAACCAGCAATTGCCAAAAACCCATATG
>TTN-207,ENSE00003811290,1,303,1467440,1467742,ACCCACCAGGACGCTGTGATCCTCCTGTTATTAGCAACATAACCAAAGATCACATGACAGTCAGCTGGAAGCCACCAGCAGATGATGGGGGCTCACCCATCACTGGCTATTTGCTTGAAAAGCGGGAAACCCAGGCTGTTAACTGGACTAAGGTCAACAGAAAACCTATTATAGAAAGAACATTAAAAGCAACAGGTCTTCAAGAAGGTACCGAATATGAGTTCCGTGTTACAGCTATAAATAAAGCTGGACCAGGCAAACCCAGTGACGCATCCAAGGCCGCTTATGCTCGGGACCCTCAGT
>TTN-207,ENSE00003808853,1,306,1467743,1468048,ATCCTCCTGGCCCACCGGCTTTCCCTAAAGTATATGATACAACTCGCAGCTCTGTGAGTCTATCTTGGGGCAAGCCAGCCTATGACGGCGGCAGCCCTATCATTGGTTATCTCGTTGAAGTAAAACGGGCTGACTCCGATAACTGGGTGAGGTGCAACTTACCACAGAATCTACAGAAAACCCGCTTTGAGGTTACTGGCCTGATGGAAGACACACAATATCAATTCCGTGTGTATGCCGTTAATAAGATTGGATACAGTGACCCCAGTGATGTGCCAGATAAACACTATCCCAAGGACATCTTAA
>TTN-207,ENSE00003807542,1,288,1468049,1468336,TTCCACCTGAGGGAGAACTTGATGCGGACTTAAGGAAGACACTCATATTACGTGCTGGAGTTACTATGAGACTATATGTACCAGTAAAAGGACGCCCACCTCCAAAGATTACTTGGTCTAAACCAAATGTCAATCTAAGAGACAGGATTGGACTGGACATAAAGTCAACTGACTTTGACACTTTCTTGCGCTGTGAAAATGTGAACAAATATGATGCAGGAAAATATATCTTAACCCTGGAGAACAGCTGTGGTAAAAAGGAATATACCATTGTTGTGAAAGTGCTTG
>TTN-207,ENSE00003810775,1,291,1468337,1468627,ATACTCCTGGGCCACCTGTCAATGTGACTGTTAAGGAAATATCCAAAGACTCTGCTTATGTTACCTGGGAGCCTCCCATTATTGATGGCGGAAGCCCCATCATAAACTATGTGGTACAAAAACGTGATGCAGAGAGGAAATCCTGGTCTACAGTGACAACTGAGTGCTCCAAAACAAGCTTCAGAGTAGCTAATTTGGAGGAGGGAAAATCCTACTTCTTCCGAGTGTTTGCTGAAAATGAGTATGGCATTGGTGATCCCGGTGAAACTCGTGATGCTGTCAAAGCTTCCC
>TTN-207,ENSE00003811210,1,288,1468628,1468915,AAACTCCTGGACCAGTTGTGGACCTGAAAGTGAGGTCTGTATCTAAGTCATCCTGTAGCATTGGCTGGAAAAAGCCTCACAGTGATGGTGGAAGTCGGATTATTGGATATGTAGTTGATTTCCTGACTGAAGAAAATAAGTGGCAACGAGTTATGAAATCCTTAAGCCTACAGTACTCTGCAAAAGATTTGACTGAAGGGAAGGAATATACCTTCAGAGTGAGTGCTGAGAATGAAAATGGAGAAGGAACCCCAAGCGAAATCACTGTTGTGGCAAGGGATGATGTTG
>TTN-207,ENSE00003805436,1,588,1468916,1469503,TGGCTCCTGATCTTGACTTAAAGGGTCTACCTGATTTGTGCTACTTGGCTAAAGAAAACAGCAACTTCCGGCTTAAGATCCCCATAAAAGGCAAGCCAGCTCCATCAGTCTCCTGGAAGAAAGGGGAAGATCCTCTAGCAACTGACACTAGAGTCAGTGTTGAGTCATCTGCGGTTAACACAACTCTTATAGTGTACGATTGCCAAAAATCTGATGCTGGAAAATACACAATCACACTTAAGAATGTTGCTGGCACCAAGGAAGGAACTATCTCCATAAAGGTTGTTGGCAAGCCTGGCATCCCCACTGGACCAATCAAATTTGATGAAGTCACAGCAGAAGCCATGACCTTAAAGTGGGCTCCTCCAAAGGATGATGGAGGTTCTGAAATCACCAACTATATCCTAGAGAAGAGGGATTCTGTGAACAACAAGTGGGTGACGTGCGCCTCAGCTGTCCAGAAAACCACCTTTAGAGTAACCAGACTTCATGAGGGCATGGAATATACCTTCAGGGTCAGTGCCGAAAATAAATATGGTGTAGGGGAAGGCCTGAAATCGGAGCCAATTGTTGCGAGACATCCATTTG
>TTN-207,ENSE00003808777,1,105,1469504,1469608,ATGTGCCTGATGCTCCCCCACCTCCCAATATTGTGGATGTCAGACACGATTCAGTATCTCTAACTTGGACTGACCCCAAGAAAACTGGTGGTTCTCCAATTACAG
>TTN-207,ENSE00003806939,1,198,1469609,1469806,GGTATCATCTCGAGTTCAAGGAAAGAAACAGCCTTTTGTGGAAGAGAGCTAACAAGACTCCGATAAGGATGAGAGACTTTAAAGTGACAGGATTAACTGAAGGTCTTGAATATGAATTCCGAGTTATGGCAATCAATTTAGCAGGTGTGGGCAAGCCAAGCCTACCATCAGAGCCTGTTGTGGCACTGGACCCAATTG
>TTN-207,ENSE00003811024,1,297,1469807,1470103,ATCCTCCTGGAAAACCTGAGGTTATTAACATAACAAGGAATTCAGTGACTCTCATTTGGACTGAACCTAAATATGACGGTGGTCATAAGTTAACTGGATATATAGTGGAGAAGCGAGATCTACCTTCGAAGTCTTGGATGAAAGCCAACCATGTTAATGTCCCAGAATGTGCCTTTACTGTAACTGACCTTGTTGAGGGTGGAAAATATGAATTCAGAATTAGAGCAAAGAATACAGCAGGTGCTATCAGTGCTCCATCAGAAAGTACAGAAACCATTATTTGCAAGGATGAATACG
>TTN-207,ENSE00003803896,1,588,1470104,1470691,AGGCACCAACAATTGTCCTTGATCCCACAATAAAAGATGGGCTAACAATTAAAGCAGGGGATACCATTGTTTTGAATGCCATTAGCATTCTTGGCAAACCCCTTCCAAAATCAAGTTGGTCCAAGGCAGGAAAAGACATTAGACCATCAGATATCACTCAGATAACTTCAACCCCAACATCTTCCATGCTTACTATCAAGTATGCCACTAGAAAAGATGCGGGTGAATATACCATCACTGCTACCAATCCTTTTGGCACGAAGGTGGAACATGTGAAGGTAACAGTCCTTGATGTACCTGGTCCCCCAGGTCCTGTTGAAATCAGTAATGTTTCTGCTGAAAAAGCAACACTTACATGGACACCTCCCTTGGAAGATGGCGGCTCACCAATTAAGTCCTATATACTTGAAAAGAGAGAAACCAGCCGACTTTTGTGGACAGTGGTTTCTGAAGATATTCAGTCTTGCAGGCATGTGGCAACCAAACTTATCCAAGGAAATGAGTACATCTTCCGGGTCTCAGCTGTAAACCACTATGGCAAAGGAGAACCTGTACAGTCTGAACCTGTCAAAATGGTAGACAGATTTG
>TTN-207,ENSE00003807419,1,303,1470692,1470994,GTCCCCCTGGCCCTCCTGAAAAACCAGAGGTATCAAATGTCACTAAGAACACTGCCACTGTCAGCTGGAAAAGGCCAGTGGATGATGGTGGCAGCGAAATTACAGGATATCATGTAGAAAGGAGAGAAAAGAAAAGCCTGCGATGGGTGAGAGCAATAAAAACACCAGTTTCCGATCTCAGGTGCAAAGTAACAGGACTGCAAGAAGGAAGCACCTACGAATTCCGTGTCAGTGCAGAAAACAGAGCAGGAATTGGTCCACCCAGTGAGGCTTCAGATTCTGTTCTGATGAAAGATGCAGCAT
>TTN-207,ENSE00003811193,1,17106,1470995,1488100,ATCCTCCAGGACCACCTTCAAATCCGCATGTCACTGATACTACCAAGAAATCTGCTTCTTTGGCATGGGGCAAGCCTCATTATGATGGTGGACTTGAAATCACTGGCTATGTCGTGGAGCATCAAAAAGTAGGAGACGAGGCCTGGATAAAAGATACCACAGGAACCGCCCTCAGAATCACTCAGTTCGTTGTTCCTGATCTTCAGACTAAAGAAAAATACAACTTCAGAATCAGTGCCATCAACGATGCAGGTGTTGGGGAGCCAGCGGTGATTCCAGATGTTGAAATCGTAGAACGGGAGATGGCTCCTGATTTTGAACTAGATGCCGAGCTTCGAAGAACACTTGTTGTTAGAGCAGGACTCAGTATTAGGATATTTGTGCCAATTAAAGGTCGTCCTGCTCCTGAAGTGACATGGACCAAAGATAACATCAACCTGAAAAACCGAGCCAACATTGAAAATACGGAATCATTTACTCTTCTGATTATCCCAGAATGTAACAGATATGATACCGGTAAATTTGTCATGACCATTGAAAACCCGGCTGGGAAGAAAAGTGGCTTTGTGAACGTCAGAGTCTTGGACACGCCAGGCCCAGTCCTCAACCTGCGGCCTACAGACATCACAAAGGACAGTGTCACCCTGCACTGGGACCTCCCTCTGATAGATGGAGGCTCACGTATAACAAACTACATTGTAGAGAAACGTGAAGCAACACGGAAATCTTATTCCACAGCCACCACTAAGTGCCATAAATGCACATATAAAGTTACCGGCTTGTCTGAAGGGTGTGAATATTTCTTCAGAGTGATGGCAGAGAATGAATATGGAATTGGTGAGCCAACAGAAACTACAGAGCCCGTAAAAGCCTCTGAAGCACCATCTCCACCAGACAGCCTTAACATCATGGACATAACTAAGAGCACCGTCAGCCTGGCATGGCCTAAGCCCAAACACGATGGTGGCAGCAAGATCACTGGCTATGTGATTGAAGCCCAAAGAAAAGGCTCTGACCAGTGGACCCACATCACAACCGTGAAAGGGTTAGAATGTGTTGTGAGGAATCTAACTGAAGGAGAGGAATATACCTTCCAAGTGATGGCAGTGAACAGCGCGGGGAGAAGTGCCCCTAGAGAAAGCAGACCCGTCATTGTCAAGGAGCAGACAATGCTTCCAGAGCTGGATCTCCGTGGCATCTATCAGAAACTGGTCATTGCCAAAGCTGGTGACAACATCAAAGTTGAAATTCCAGTGCTCGGTCGACCGAAGCCCACAGTGACATGGAAAAAAGGAGACCAAATTCTTAAACAGACACAGAGAGTTAATTTTGAAACCACAGCGACTTCAACCATTTTAAATATCAATGAGTGTGTCAGAAGTGATAGTGGGCCCTATCCATTAACAGCAAGGAACATTGTAGGAGAGGTTGGTGATGTCATCACCATTCAAGTCCATGATATCCCAGGGCCACCTACTGGACCAATCAAATTTGATGAAGTTTCATCTGATTTTGTAACCTTCTCTTGGGACCCACCTGAGAACGATGGTGGTGTACCAATAAGCAACTATGTAGTGGAAATGCGGCAGACTGACAGTACTACCTGGGTTGAGTTAGCAACCACCGTTATACGTACTACCTATAAAGCCACCCGCCTTACTACTGGATTAGAGTATCAGTTCCGTGTAAAAGCTCAGAATAGATATGGAGTTGGACCAGGCATCACATCAGCATGCATAGTTGCCAACTATCCATTTAAGGTTCCTGGACCTCCTGGTACCCCTCAGGTAACTGCAGTTACCAAGGATTCAATGACAATTAGCTGGCATGAGCCACTTTCTGATGGTGGAAGCCCCATTTTAGGATATCATGTTGAAAGAAAAGAACGAAATGGTATTCTCTGGCAGACTGTGAGCAAAGCTTTAGTACCAGGCAACATTTTCAAATCAAGTGGACTTACAGATGGTATTGCTTATGAGTTCCGGGTGATTGCAGAAAACATGGCAGGCAAAAGTAAGCCAAGCAAGCCATCAGAACCTATGTTGGCTCTGGATCCCATTGACCCACCTGGAAAACCAGTACCTCTAAATATTACAAGACACACAGTAACACTTAAATGGGCTAAGCCTGAATATACTGGGGGCTTTAAAATTACCAGTTATATCGTTGAAAAGAGAGACCTTCCTAATGGACGGTGGCTGAAGGCCAACTTCAGCAACATTTTGGAGAATGAATTTACAGTCAGTGGCCTAACAGAAGATGCTGCATATGAATTCCGTGTGATCGCCAAAAATGCTGCAGGTGCCATCAGTCCACCATCTGAGCCATCTGATGCTATCACTTGCAGGGATGATGTTGAGGCACCAAAGATAAAGGTGGATGTTAAATTTAAGGACACGGTTATATTAAAAGCAGGTGAAGCATTCAGACTGGAAGCTGATGTTTCAGGCCGCCCACCTCCAACAATGGAATGGAGCAAAGATGGAAAAGAGCTGGAAGGCACAGCAAAGTTAGAAATAAAAATTGCAGATTTCTCTACTAATCTGGTAAACAAAGATTCAACAAGAAGGGATAGTGGTGCCTATACCCTTACAGCGACTAATCCTGGTGGCTTTGCTAAACACATTTTCAATGTCAAAGTTCTTGACAGACCAGGCCCACCTGAAGGACCTTTGGCTGTAACTGAAGTGACATCAGAAAAGTGTGTACTATCATGGTTCCCTCCACTGGATGATGGAGGTGCCAAAATTGATCATTACATAGTACAGAAACGTGAAACCAGCAGATTGGCATGGACAAATGTAGCCTCAGAAGTCCAAGTAACAAAGCTAAAGGTCACTAAACTCTTGAAAGGCAATGAATACATATTCCGTGTCATGGCTGTAAATAAATATGGAGTGGGAGAGCCACTGGAATCAGAGCCTGTGCTTGCAGTGAATCCTTATGGACCCCCTGATCCGCCCAAAAACCCTGAAGTGACAACTATTACTAAAGATTCGATGGTTGTCTGCTGGGGACATCCTGATTCTGATGGTGGAAGTGAAATCATCAATTATATTGTGGAACGGCGTGATAAAGCTGGCCAACGCTGGATTAAATGCAACAAAAAAACTCTTACTGATTTAAGATATAAAGTGTCTGGACTGACAGAAGGACATGAATATGAGTTCAGGATTATGGCTGAAAATGCTGCTGGAATTAGTGCACCAAGTCCTACCAGTCCATTTTACAAGGCTTGTGACACTGTGTTTAAACCTGGACCACCAGGTAACCCACGTGTTCTGGATACAAGCAGATCATCCATTTCAATCGCTTGGAATAAACCTATCTATGATGGTGGTTCAGAAATCACTGGGTATATGGTTGAGATTGCCCTGCCAGAGGAAGATGAATGGCAGATTGTCACTCCACCAGCAGGACTCAAGGCAACTTCGTATACTATCACTGGCCTCACAGAGAATCAGGAATATAAGATCCGCATCTATGCCATGAATTCCGAAGGACTTGGGGAACCTGCCCTTGTTCCTGGAACTCCAAAGGCTGAAGACAGAATGCTGCCTCCAGAAATTGAACTGGATGCTGACCTGCGCAAAGTTGTTACTATAAGGGCCTGCTGCACCCTGAGACTTTTTGTTCCCATCAAAGGAAGGCCTGCACCTGAGGTGAAGTGGGCCCGGGACCATGGAGAATCTTTAGATAAAGCTAGCATCGAATCCACAAGCTCTTACACCCTGCTTATTGTTGGAAATGTAAACAGATTTGACAGTGGCAAATATATACTAACTGTAGAAAATAGTTCAGGCAGCAAGTCTGCATTTGTCAATGTTAGAGTTCTCGATACACCAGGCCCCCCACAGGATCTGAAGGTAAAAGAGGTCACTAAGACATCTGTCACACTCACATGGGACCCACCTCTCCTTGATGGAGGTTCAAAAATCAAGAACTATATTGTTGAAAAGCGGGAATCAACAAGAAAAGCATATTCAACTGTTGCAACAAACTGCCACAAGACTTCCTGGAAGGTAGACCAGCTTCAAGAAGGCTGTAGCTACTATTTCAGGGTTCTCGCAGAAAATGAATATGGCATTGGGCTGCCTGCTGAAACCGCAGAATCTGTGAAAGCATCAGAACGACCTCTTCCTCCAGGAAAAATAACTTTGATGGATGTCACAAGAAATAGTGTGTCACTCTCTTGGGAGAAACCAGAGCATGATGGAGGCAGCCGAATTCTAGGCTACATTGTGGAGATGCAGACCAAAGGCAGTGACAAATGGGCCACGTGTGCCACAGTCAAGGTCACTGAAGCCACTATCACTGGATTAATTCAGGGTGAAGAATACTCTTTCCGTGTTTCAGCTCAGAATGAAAAGGGCATCAGTGATCCTAGACAACTGAGTGTGCCAGTGATCGCCAAAGATCTTGTCATTCCACCAGCCTTCAAACTCCTGTTCAATACTTTCACTGTACTGGCAGGTGAAGACCTAAAAGTTGATGTTCCATTCATTGGCCGCCCTACCCCAGCTGTAACCTGGCATAAAGATAATGTACCACTGAAGCAGACAACTAGAGTAAATGCAGAGAGCACAGAAAATAATTCACTACTGACAATAAAGGACGCCTGCCGAGAAGATGTTGGCCATTATGTGGTTAAACTGACTAACTCAGCTGGTGAAGCTATTGAAACCCTTAATGTTATCGTTCTTGACAAACCAGGGCCTCCAACTGGACCAGTTAAAATGGATGAAGTGACAGCTGATAGTATTACTCTTTCCTGGGGCCCACCCAAGTATGATGGTGGAAGTTCTATCAATAATTACATTGTTGAGAAACGGGACACTTCCACAACCACCTGGCAAATTGTATCAGCTACAGTTGCAAGGACAACAATAAAGGCTTGCAGACTGAAGACTGGATGTGAATATCAGTTTAGAATTGCAGCTGAAAACAGATATGGGAAGAGTACCTACCTCAATTCAGAGCCTACTGTAGCCCAATATCCATTCAAAGTTCCTGGTCCTCCTGGCACTCCAGTTGTCACACTGTCCTCCAGGGACAGCATGGAAGTACAATGGAATGAGCCAATCAGTGATGGAGGAAGTAGAGTCATTGGCTATCATCTAGAACGCAAGGAAAGAAATAGCATCCTCTGGGTTAAGTTGAATAAAACACCTATTCCTCAAACCAAGTTTAAGACAACTGGCCTTGAAGAAGGTGTTGAATATGAATTTAGAGTCTCTGCAGAGAACATCGTGGGCATTGGCAAGCCGAGTAAAGTATCAGAATGTTATGTGGCTCGTGACCCATGTGATCCACCAGGACGGCCAGAGGCAATCATTGTCACAAGGAATTCTGTGACTCTTCAGTGGAAGAAACCCACCTATGACGGTGGAAGCAAGATCACTGGTTATATTGTTGAGAAGAAAGAATTACCTGAGGGCCGTTGGATGAAAGCCAGTTTTACAAATATTATTGACACTCATTTTGAAGTAACTGGCCTAGTTGAAGATCACAGATATGAGTTCCGGGTTATAGCCCGAAATGCCGCAGGAGTGTTTAGTGAGCCTTCAGAAAGCACAGGAGCAATAACAGCTAGAGATGAGGTAGATCCACCACGAATAAGTATGGATCCAAAATACAAAGACACAATCGTGGTTCATGCTGGTGAATCATTCAAGGTTGATGCAGATATTTATGGCAAACCAATACCAACCATTCAGTGGATAAAAGGTGATCAGGAGCTTTCAAACACAGCTCGATTAGAAATAAAGAGCACCGACTTTGCCACCAGTCTCAGTGTAAAAGATGCAGTACGTGTCGACAGTGGAAATTACATACTGAAGGCCAAAAATGTTGCAGGAGAAAGATCAGTTACTGTGAATGTCAAGGTTCTTGACAGACCAGGGCCACCTGAAGGACCTGTTGTTATCTCAGGAGTTACAGCAGAAAAATGCACACTAGCTTGGAAACCCCCACTTCAGGATGGTGGGAGTGACATCATAAATTATATTGTGGAAAGGAGAGAAACCAGCCGCTTAGTTTGGACTGTGGTTGATGCCAATGTGCAGACTCTCAGCTGCAAGGTTACTAAGCTTCTTGAAGGCAATGAATATACTTTCCGTATAATGGCAGTAAACAAATATGGTGTTGGTGAACCTCTTGAATCTGAGCCAGTAGTTGCCAAGAATCCATTTGTAGTACCAGATGCACCAAAAGCTCCAGAAGTCACAACAGTGACCAAGGACTCAATGATTGTTGTATGGGAAAGACCAGCATCTGATGGTGGTAGTGAAATTCTTGGATATGTTCTTGAGAAACGGGATAAAGAAGGCATTAGATGGACAAGATGCCATAAGCGTCTGATTGGAGAGTTGCGCCTGAGAGTAACTGGACTCATAGAAAATCACGATTATGAGTTCAGAGTTTCTGCTGAGAATGCTGCTGGACTTAGTGAACCAAGCCCTCCTTCTGCTTACCAAAAGGCTTGTGATCCTATTTATAAACCAGGACCCCCAAACAACCCCAAAGTCATAGACATAACCAGATCTTCAGTATTCCTTTCTTGGAGCAAACCAATATATGATGGTGGCTGTGAAATTCAAGGATACATTGTTGAAAAATGTGATGTGAGTGTTGGTGAATGGACAATGTGCACTCCACCAACAGGAATTAATAAAACAAACATAGAAGTAGAGAAGCTGTTGGAAAAGCATGAATACAACTTCCGTATCTGTGCTATTAATAAAGCTGGAGTTGGAGAACATGCTGACGTCCCTGGACCTATTATAGTTGAAGAAAAATTAGAAGCACCAGACATTGATCTTGACCTAGAACTAAGGAAAATCATAAATATAAGGGCAGGTGGCTCCTTAAGGTTATTTGTTCCTATAAAAGGTCGTCCTACACCAGAAGTTAAATGGGGAAAGGTGGATGGTGAAATCCGAGATGCAGCTATAATTGATGTCACTAGCAGTTTCACCTCTCTTGTTCTTGACAATGTCAACCGATATGATAGTGGAAAATATACGCTTACATTAGAAAACAGCAGTGGAACAAAGTCTGCCTTTGTTACTGTGAGAGTTCTGGACACGCCAAGTCCACCTGTTAACCTGAAAGTCACAGAAATCACCAAAGACTCAGTATCAATTACATGGGAACCTCCTTTGTTGGATGGGGGATCCAAAATAAAAAATTACATTGTTGAGAAACGTGAAGCCACAAGAAAATCATATGCTGCTGTTGTAACTAACTGCCATAAGAATTCTTGGAAAATCGATCAGCTCCAAGAAGGTTGCAGTTATTACTTTAGAGTCACAGCTGAGAATGAGTATGGTATTGGCCTTCCTGCCCAGACTGCTGATCCAATTAAGGTTGCAGAAGTGCCACAACCTCCTGGAAAAATAACTGTGGATGATGTCACCAGAAACAGTGTCTCTCTGAGTTGGACAAAACCTGAACATGATGGTGGCAGTAAAATCATTCAGTATATTGTGGAAATGCAAGCTAAACACAGTGAGAAATGGTCAGAGTGTGCTCGAGTAAAGTCTCTTCAGGCAGTAATTACCAACCTAACTCAAGGGGAAGAATATCTTTTTAGAGTTGTTGCTGTAAATGAAAAGGGGAGAAGTGATCCTCGGTCCCTTGCAGTTCCAATAGTTGCCAAAGATCTGGTAATTGAGCCAGATGTAAAACCTGCATTCAGTAGTTACAGTGTACAGGTTGGCCAAGATTTGAAAATAGAAGTGCCAATTTCTGGACGTCCTAAGCCAACCATTACCTGGACTAAAGATGGTCTCCCACTGAAGCAGACCACAAGAATCAATGTTACCGATTCACTGGATCTCACCACACTCAGTATTAAAGAAACTCATAAGGATGATGGTGGACAATATGGAATCACAGTTGCCAATGTTGTTGGTCAGAAGACAGCATCCATCGAAATTGTAACTCTAGATAAACCTGATCCTCCAAAAGGACCTGTTAAATTTGATGACGTCAGTGCTGAAAGTATTACATTATCTTGGAACCCTCCATTATATACAGGGGGCTGCCAAATCACCAACTACATTGTTCAGAAAAGAGATACAACCACCACAGTATGGGATGTTGTTTCTGCTACTGTTGCTAGAACTACACTCAAAGTGACCAAACTGAAAACTGGTACAGAATACCAATTTAGAATATTTGCCGAAAACAGATATGGACAAAGCTTTGCCTTAGAGTCTGATCCAATTGTAGCTCAATATCCCTACAAAGAACCAGGCCCTCCAGGTACACCATTTGCCACAGCCATTTCCAAAGACTCCATGGTCATACAGTGGCATGAACCAGTCAACAATGGTGGAAGCCCCGTCATAGGTTACCACCTGGAGAGAAAAGAAAGAAACAGTATTTTGTGGACAAAGGTCAACAAAACTATTATTCATGACACCCAATTCAAAGCACAGAATCTTGAAGAAGGCATTGAATATGAATTCAGAGTGTATGCTGAAAATATTGTTGGTGTAGGCAAAGCAAGCAAGAATTCTGAATGCTATGTAGCCAGAGATCCCTGTGACCCACCAGGAACCCCAGAACCAATAATGGTTAAAAGAAATGAAATCACTTTACAGTGGACCAAACCTGTGTATGATGGTGGAAGTATGATTACAGGCTACATTGTAGAGAAACGTGATTTGCCTGATGGTCGTTGGATGAAAGCTAGCTTTACAAATGTCATTGAAACTCAATTTACTGTGTCAGGTCTTACTGAAGATCAAAGATATGAATTCAGAGTCATTGCAAAGAATGCAGCTGGTGCAATAAGTAAACCCTCTGACAGTACTGGACCAATAACTGCCAAGGATGAGGTTGAACTCCCAAGAATTTCAATGGATCCAAAATTCAGAGACACAATTGTGGTAAATGCTGGAGAAACATTCAGACTTGAGGCTGATGTCCATGGAAAGCCCCTACCTACCATTGAGTGGTTAAGAGGAGATAAGGAAATTGAAGAATCTGCTAGATGTGAAATAAAGAACACAGATTTCAAGGCTTTACTTATTGTAAAAGATGCAATTAGAATTGATGGTGGGCAGTATATTTTAAGAGCTTCCAATGTTGCAGGTTCTAAGTCATTCCCAGTAAATGTAAAAGTATTAGATAGACCAGGACCTCCAGAAGGGCCAGTCCAGGTTACTGGAGTCACTTCTGAAAAATGCTCTTTAACATGGTCTCCACCACTTCAAGATGGTGGCAGTGACATTTCTCACTATGTTGTTGAAAAGCGAGAAACCAGTCGACTTGCCTGGACTGTTGTTGCTTCAGAAGTTGTGACCAATTCTCTGAAAGTTACCAAACTCTTAGAAGGTAATGAATATGTTTTCCGTATAATGGCTGTCAACAAATATGGTGTTGGAGAGCCTTTGGAATCTGCACCAGTACTAATGAAAAATCCATTTGTGCTTCCTGGACCACCAAAAAGCTTGGAAGTCACAAATATTGCCAAAGACTCCATGACCGTCTGTTGGAACCGTCCAGATAGTGATGGTGGAAGTGAGATTATTGGTTACATTGTAGAGAAAAGAGACAGAAGTGGCATTCGATGGATAAAATGTAATAAACGCCGCATTACAGATTTGCGTCTAAGAGTGACAGGATTAACAGAAGATCATGAGTATGAATTCAGGGTCTCTGCAGAAAATGCTGCTGGAGTTGGGGAACCAAGTCCAGCTACAGTTTATTATAAAGCCTGTGATCCTGTGTTCAAACCTGGCCCACCTACCAATGCACACATTGTAGACACCACTAAAAATTCAATCACACTTGCCTGGGGTAAACCCATCTATGATGGCGGCAGTGAGATCTTGGGATATGTAGTAGAAATCTGTAAAGCAGATGAAGAAGAATGGCAAATAGTTACTCCACAGACTGGCCTGAGAGTCACTCGATTTGAAATTTCAAAACTCACTGAACACCAAGAGTATAAAATACGAGTCTGTGCCCTCAACAAAGTTGGTTTAGGTGAGGCTACATCAGTTCCTGGTACTGTGAAACCAGAAGATAAACTTGAAGCACCTGAACTTGACCTTGACTCCGAATTAAGAAAAGGAATTGTTGTAAGAGCTGGTGGATCTGCCAGAATTCACATTCCATTCAAAGGTCGTCCAACGCCTGAGATCACTTGGTCTCGAGAGGAAGGTGAATTCACAGATAAGGTCCAAATTGAAAAGGGAGTAAACTATACCCAACTATCAATAGATAACTGTGATAGAAATGATGCTGGAAAATACATTCTTAAGTTGGAAAACAGCAGTGGATCAAAGTCTGCTTTTGTAACTGTGAAAGTTCTTGACACTCCAGGACCACCACAGAATTTGGCAGTCAAAGAAGTGAGAAAAGATTCTGCCTTCCTGGTATGGGAGCCACCCATCATTGATGGAGGGGCAAAGGTCAAGAACTATGTGATTGACAAACGTGAGTCAACCAGAAAAGCGTATGCTAATGTGAGTAGTAAATGCAGCAAAACAAGTTTTAAAGTGGAAAACCTTACAGAAGGAGCCATTTATTACTTCAGAGTCATGGCTGAAAATGAATTTGGAGTTGGTGTTCCAGTGGAAACTGTTGATGCCGTGAAAGCTGCTGAACCTCCTTCCCCACCAGGAAAGGTTACACTCACTGATGTGTCCCAGACCAGTGCATCACTTATGTGGGAGAAACCTGAACATGATGGCGGTAGCAGAGTCCTGGGGTACGTTGTTGAAATGCAGCCCAAAGGAACTGAAAAATGGAGCATTGTGGCTGAATCCAAAGTCTGTAATGCAGTTGTTACTGGTTTGAGTTCTGGACAAGAATATCAGTTCCGTGTCAAGGCTTATAATGAGAAAGGAAAAAGCGATCCAAGAGTGTTGGGTGTTCCTGTCATAGCCAAGGACTTGACTATACAGCCTAGTTTAAAGTTACCATTTAACACATATAGTATCCAAGCTGGAGAAGATCTTAAAATAGAAATTCCAGTTATAGGCCGACCAAGACCTAACATTTCTTGGGTCAAAGATGGTGAGCCTCTTAAACAGACAACAAGAGTAAACGTTGAAGAAACAGCTACCTCAACTGTTTTGCACATTAAAGAAGGTAACAAAGATGACTTTGGAAAATACACCGTAACGGCAACAAATAGTGCAGGCACAGCAACAGAAAATCTCAGTGTTATCGTTTTAGAAAAGCCTGGACCTCCAGTTGGCCCAGTTCGGTTTGATGAAGTTAGTGCAGACTTTGTAGTCATATCTTGGGAACCTCCAGCCTATACTGGTGGCTGCCAAATAAGCAACTACATTGTAGAGAAGCGAGATACAACCACCACCACTTGGCACATGGTATCAGCAACAGTTGCAAGAACAACAATTAAAATAACCAAACTGAAAACAGGCACGGAGTACCAGTTTAGAATTTTTGCTGAAAACAGGTATGGAAAAAGTGCCCCACTGGATTCTAAGGCAGTTATTGTACAATATCCATTTAAAGAACCTGGACCACCTGGAACTCCTTTTGTGACATCAATCTCAAAAGATCAGATGCTTGTGCAATGGCATGAGCCAGTGAATGATGGAGGCACCAAAATTATTGGCTACCATCTTGAACAGAAAGAAAAGAACAGTATTTTATGGGTCAAGTTAAATAAGACCCCCATTCAGGACACCAAATTCAAAACAACTGGGCTTGATGAGGGCCTTGAGTATGAGTTCAAAGTTTCTGCTGAAAATATTGTTGGCATTGGCAAGCCTAGCAAAGTGTCAGAATGCTTTGTTGCTCGTGATCCATGTGACCCACCTGGTCGCCCTGAAGCCATTGTTATTACAAGAAACAATGTCACACTGAAATGGAAGAAACCTGCCTATGATGGTGGTAGCAAAATAACAGGTTATATTGTAGAAAAGAAAGATCTACCTGATGGCCGCTGGATGAAAGCCAGCTTTACCAACGTATTAGAAACTGAATTTACAGTGAGTGGACTTGTAGAAGACCAAAGATATGAATTTAGAGTAATTGCAAGAAATGCAGCTGGAAACTTTAGTGAACCATCTGATAGTAGTGGTGCCATTACTGCAAGAGATGAAATTGATGCACCAAATGCCTCTCTGGATCCAAAATATAAAGATGTCATCGTTGTTCATGCAGGAGAGACTTTTGTTCTTGAAGCCGACATCCGTGGCAAACCTATACCTGATGTTGTTTGGTCAAAAGATGGAAAAGAACTTGAAGAAACAGCTGCTAGAATGGAAATTAAATCTACTATTCAGAAAACAACTCTTGTTGTCAAAGACTGTATACGGACTGATGGAGGACAATATATTCTGAAACTCAGCAATGTTGGTGGTACAAAGTCTATACCCATCACTGTAAAGGTACTTGACAGGCCAGGGCCTCCTGAAGGGCCTCTGAAAGTTACTGGAGTTACTGCGGAAAAATGTTACCTGGCATGGAACCCACCTTTGCAAGATGGTGGTGCTAATATTTCACATTACATCATTGAAAAGAGGGAGACAAGCCGACTCTCTTGGACCCAGGTTTCAACTGAGGTACAGGCCCTTAACTACAAAGTTACTAAACTTCTTCCTGGTAATGAGTACATTTTCCGTGTCATGGCTGTGAATAAATATGGAATTGGAGAGCCCTTGGAATCTGGGCCTGTTACGGCCTGTAATCCTTATAAGCCACCAGGTCCTCCCTCAACACCTGAAGTCTCAGCAATCACCAAAGATTCTATGGTAGTAACATGGGCACGCCCAGTAGACGACGGAGGTACCGAAATTGAGGGCTACATTCTTGAAAAACGAGATAAGGAAGGCGTTAGATGGACCAAGTGCAACAAGAAAACATTAACGGATCTGCGGCTCAGGGTAACTGGTCTTACCGAAGGCCATTCCTATGAATTCAGAGTTGCTGCTGAAAATGCAGCTGGTGTGGGAGAACCTAGTGAGCCATCTGTTTTCTACCGTGCGTGTGATGCCTTGTATCCACCAGGTCCCCCAAGCAATCCAAAAGTGACGGACACTTCCAGATCTTCTGTCTCCCTGGCATGGAGTAAGCCAATTTATGATGGTGGCGCACCTGTTAAAGGCTATGTTGTAGAGGTCAAAGAAGCTGCTGCGGATGAATGGACAACCTGCACTCCACCAACAGGATTACAAGGAAAGCAGTTCACAGTGACCAAGCTTAAAGAAAACACTGAATATAACTTCCGTATTTGTGCCATCAATTCTGAAGGTGTAGGTGAACCTGCAACTCTACCTGGCTCAGTGGTTGCTCAGGAGAGGATAGAGCCACCAGAAATAGAACTCGATGCTGATCTCAGAAAGGTGGTCGTTCTGCGTGCAAGTGCTACTTTACGCTTATTTGTCACTATCAAAGGTCGACCAGAACCCGAAGTTAAATGGGAAAAGGCAGAAGGCATTCTCACTGACAGGGCTCAGATAGAGGTGACCAGCTCATTTACAATGTTGGTGATTGATAATGTTACCAGATTTGACAGTGGTCGGTATAATCTGACATTAGAAAATAATAGTGGCTCCAAAACAGCTTTTGTTAACGTCAGAGTTCTTGACTCACCAAGTGCCCCTGTGAATTTGACCATAAGAGAAGTGAAGAAAGACTCAGTGACGTTGTCCTGGGAACCACCACTTATTGATGGTGGAGCTAAGATTACAAACTACATTGTCGAAAAACGAGAAACTACAAGAAAAGCCTATGCTACCATTACAAATAATTGCACTAAAACTACTTTCAGAATTGAAAATCTACAAGAAGGATGTTCTTACTACTTCCGAGTCTTGGCTTCCAATGAATATGGGATTGGTTTGCCAGCTGAAACAACAGAACCCGTTAAAGTGTCTGAACCACCCCTCCCACCTGGAAGAGTAACTCTTGTTGATGTGACCCGTAATACAGCTACAATTAAGTGGGAGAAACCAGAAAGTGATGGTGGCAGCAAAATTACTGGTTATGTGGTTGAAATGCAGACTAAAGGGAGTGAAAAGTGGAGCACCTGCACACAAGTTAAGACTCTAGAAGCAACTATATCTGGCTTAACTGCAGGAGAAGAGTATGTCTTCAGGGTAGCTGCAGTTAACGAAAAGGGAAGAAGTGATCCAAGACAACTTGGAGTGCCAGTAATTGCAAGGGATATTGAAATAAAGCCTTCAGTTGAGCTTCCTTTCCATACTTTCAATGTAAAGGCTAGAGAACAACTTAAGATTGATGTGCCATTCAAAGGAAGACCTCAAGCTACTGTGAACTGGAGAAAAGATGGTCAGACTCTTAAAGAGACAACTAGAGTCAATGTTTCTTCTTCAAAGACTGTAACATCACTATCTATTAAGGAAGCTTCAAAGGAAGATGTTGGAACTTATGAATTATGTGTTTCAAACAGTGCTGGATCCATAACAGTTCCTATTACTATAATTGTCCTTGACAGACCAGGACCTCCAGGTCCTATACGTATTGATGAGGTTAGTTGTGACAGCATAACCATTTCTTGGAATCCTCCAGAATATGATGGTGGCTGCCAAATTAGCAATTACATTGTTGAAAAGAAAGAAACCACCTCTACAACATGGCACATAGTTTCACAAGCAGTTGCAAGAACATCCATTAAAATAGTTCGCCTGACAACAGGAAGTGAGTATCAGTTCCGTGTTTGTGCAGAAAACCGCTATGGAAAGAGCTCCTACAGTGAATCTTCAGCTGTTGTTGCAGAGTATCCATTCAGTCCCCCAGGTCCTCCTGGTACTCCTAAAGTTGTGCATGCCACAAAATCTACCATGCTTGTAACCTGGCAAGTGCCAGTTAATGATGGAGGAAGTCGAGTAATTGGCTATCATCTTGAGTATAAAGAAAGAAGCAGCATTCTTTGGTCAAAAGCAAATAAAATCCTCATTGCTGATACTCAAATGAAAGTCTCCGGCCTTGATGAAGGACTGATGTATGAGTATCGTGTATATGCTGAAAATATTGCTGGAATTGGTAAATGCAGTAAATCTTGTGAACCAGTCCCTGCAAGAGATCCTTGTGACCCTCCTGGACAACCTGAAGTCACAAATATCACAAGAAAATCAGTGTCACTTAAATGGTCTAAACCACATTATGATGGTGGAGCTAAGATCACAGGATACATTGTTGAACGCAGAGAACTACCAGATGGCCGGTGGCTGAAGTGCAATTATACTAATATACAAGAAACATACTTTGAAGTAACTGAACTTACTGAAGATCAGCGTTATGAATTCCGGGTTTTTGCAAGGAATGCTGCTGACTCAGTTAGTGAGCCATCTGAATCCACTGGGCCTATTATAGTTAAAGATGATGTTGAGCCTCCAAGAGTTATGATGGATGTCAAGTTCCGAGACGTTATTGTTGTCAAAGCTGGAGAGGTCCTTAAGATAAATGCAGACATTGCAGGGCGACCTCTGCCAGTAATTTCCTGGGCCAAGGATGGTATAGAAATTGAAGAAAGAGCAAGAACAGAAATCATCTCAACAGACAATCATACTTTGTTAACAGTTAAAGACTGTATAAGACGAGACACTGGGCAATATGTACTAACACTGAAGAATGTTGCCGGCACTCGGTCTGTGGCCGTTAATTGCAAAGTACTTGATAAGCCTGGTCCACCAGCAGGACCACTTGAAATAAATGGCCTCACTGCTGAGAAATGCTCTCTTTCCTGGGGACGTCCCCAAGAAGATGGTGGTGCAGATATCGACTATTACATCGTAGAAAAACGTGAAACAAGCCACCTTGCATGGACAATATGTGAAGGAGAGTTACAGATGACATCCTGTAAAGTAACCAAGTTACTCAAAGGCAATGAATATATATTTAGAGTAACTGGTGTTAATAAATATGGTGTTGGTGAGCCCCTAGAGAGTGTAGCTATAAAGGCACTAGATCCATTTACAGTTCCAAGTCCACCCACGTCTTTGGAAATTACTTCTGTGACCAAAGAATCTATGACACTTTGCTGGTCAAGACCCGAGAGTGATGGAGGTAGTGAAATATCTGGATATATAATTGAAAGGCGAGAGAAAAATAGCCTAAGATGGGTGCGTGTAAACAAAAAACCAGTTTATGATCTAAGAGTGAAATCAACAGGACTTCGGGAAGGATGTGAATATGAATATCGTGTTTATGCAGAAAATGCTGCTGGCCTAAGTCTTCCAAGTGAAACCTCTCCCTTAATTAGGGCAGAAGATCCAGTGTTCCTACCATCTCCTCCATCCAAACCCAAAATTGTGGACTCAGGCAAGACAACTATAACTATTGCCTGGGTTAAGCCGCTGTTTGATGGTGGGGCCCCGATAACTGGATATACTGTAGAATACAAAAAATCTGATGACACTGACTGGAAAACTTCCATTCAGAGCTTACGAGGGACAGAATATACAATAAGCGGACTAACAACAGGAGCTGAATATGTTTTCAGAGTAAAATCTGTCAATAAGGTTGGTGCTAGTGACCCCAGTGATAGCTCTGACCCTCAGATAGCAAAGGAAAGAGAAGAAGAACCTTTATTTGATATTGACAGTGAAATGAGGAAGACCTTGATTGTCAAGGCTGGTGCCTCATTTACCATGACTGTGCCTTTCCGAGGAAGACCAGTACCCAATGTCTTGTGGAGTAAGCCAGACACTGACCTCCGTACTAGAGCTTATGTTGATACCACAGACTCTCGTACATCACTGACCATTGAAAATGCCAACAGAAATGACTCTGGAAAGTACACATTAACAATTCAGAATGTTTTGAGTGCTGCTTCACTGACCTTAGTTGTCAAAGTTTTAGATACCCCAGGTCCTCCAACCAACATTACTGTGCAAGATGTAACCAAAGAGTCTGCAGTGTTATCCTGGGATGTTCCTGAAAACGATGGTGGAGCACCAGTGAAGAATTACCACATAGAAAAACGTGAGGCCAGCAAGAAAGCATGGGTCTCTGTGACCAACAACTGTAACCGCCTCTCCTACAAAGTTACCAATTTACAAGAAGGAGCTATCTATTACTTCAGAGTCTCTGGAGAAAATGAGTTTGGTGTTGGTATACCAGCTGAAACAAAGGAAGGAGTAAAAATAACAG
>TTN-207,ENSE00003802597,1,297,1488101,1488397,AAAAACCAAGCCCACCTGAAAAACTTGGAGTAACAAGTATATCCAAAGACAGTGTTTCCCTGACCTGGCTGAAGCCTGAACATGATGGCGGAAGCAGAATTGTACACTATGTCGTTGAAGCACTAGAAAAAGGACAGAAAAACTGGGTTAAATGTGCAGTGGCAAAGTCAACCCATCACGTTGTTTCCGGTCTGAGAGAGAATTCTGAATACTTTTTCCGAGTGTTTGCTGAAAATCAAGCTGGCCTGAGTGACCCGAGAGAGCTTCTGCTTCCTGTTCTTATTAAGGAGCAACTAG
>TTN-207,ENSE00003802941,1,588,1488398,1488985,AACCACCTGAAATTGATATGAAGAATTTCCCAAGTCACACTGTATATGTTAGAGCTGGTTCAAACCTTAAAGTTGACATTCCAATCTCTGGAAAACCACTTCCCAAAGTGACCTTATCAAGAGATGGTGTCCCCCTTAAGGCAACCATGAGATTTAATACCGAAATTACTGCTGAGAACCTGACCATCAATCTCAAAGAAAGTGTTACAGCTGACGCTGGGAGATATGAAATCACTGCTGCCAACTCCAGTGGTACAACCAAAGCTTTCATTAACATTGTTGTGCTAGACAGGCCTGGTCCTCCAACTGGCCCTGTTGTTATTAGTGATATAACTGAAGAAAGTGTGACTCTCAAATGGGAGCCACCTAAGTATGACGGTGGAAGTCAAGTTACCAACTACATTCTACTCAAAAGAGAAACAAGTACTGCAGTGTGGACTGAAGTGTCTGCAACAGTTGCAAGAACCATGATGAAAGTCATGAAACTGACCACAGGAGAAGAATACCAATTCCGCATCAAGGCAGAAAACCGCTTTGGCATCAGTGATCATATAGATTCAGCTTGTGTGACTGTCAAACTACCATACA
>TTN-207,ENSE00003808789,1,303,1488986,1489288,CAACACCTGGACCACCATCTACACCATGGGTCACTAATGTTACTCGAGAAAGCATCACTGTGGGCTGGCATGAACCAGTGTCAAATGGAGGCAGTGCAGTCGTAGGCTATCACCTGGAAATGAAAGACAGAAACAGTATTTTATGGCAAAAAGCCAACAAACTGGTCATCCGCACAACTCACTTCAAAGTCACAACAATCAGTGCTGGACTTATTTATGAATTCAGGGTGTATGCAGAAAATGCTGCTGGAGTTGGAAAACCTAGCCATCCTTCTGAACCAGTCTTGGCAATTGATGCTTGTG
>TTN-207,ENSE00003806587,1,297,1489289,1489585,AACCCCCAAGAAATGTTCGTATCACTGATATTTCAAAGAACTCTGTCAGCCTTTCATGGCAACAACCAGCTTTCGATGGAGGTAGCAAGATTACAGGCTACATTGTTGAGAGACGTGACCTTCCAGATGGCAGATGGACCAAGGCCAGCTTCACCAATGTTACTGAAACTCAATTCATCATCTCTGGCTTGACTCAGAATTCCCAGTATGAATTCCGTGTCTTTGCTAGGAATGCTGTTGGTTCCATTAGCAATCCATCTGAGGTTGTAGGGCCCATTACTTGCATCGATTCTTATG
>TTN-207,ENSE00003807681,1,288,1489586,1489873,GTGGTCCTGTAATTGATTTGCCTCTAGAATATACAGAAGTTGTCAAATACAGAGCAGGTACATCTGTGAAGCTCAGAGCTGGCATTTCTGGCAAACCTGCGCCTACTATTGAGTGGTATAAAGATGATAAAGAATTACAAACCAATGCACTGGTGTGTGTTGAAAATACCACGGACCTCGCATCTATACTCATCAAAGATGCCGATCGCCTTAATAGTGGATGCTATGAATTAAAACTAAGGAATGCCATGGGCTCAGCCTCAGCCACCATCAGAGTACAGATCCTTG
>TTN-207,ENSE00003811102,1,300,1489874,1490173,ACAAACCAGGCCCACCTGGTGGACCAATTGAATTTAAGACTGTAACTGCTGAGAAGATCACCCTTCTCTGGCGGCCTCCAGCTGATGATGGTGGTGCAAAAATCACTCACTACATTGTGGAAAAGCGTGAGACAAGCCGCGTTGTGTGGTCTATGGTGTCTGAACATTTGGAAGAGTGCATCATTACAACCACCAAAATTATCAAAGGAAATGAATACATCTTCCGGGTCCGAGCCGTGAACAAATATGGAATTGGCGAGCCACTGGAATCTGATTCCGTTGTAGCCAAGAACGCATTTG
>TTN-207,ENSE00003802386,1,303,1490174,1490476,TTACACCTGGGCCACCAGGCATACCAGAAGTGACAAAGATTACCAAGAATTCGATGACTGTTGTATGGAGCAGGCCAATTGCAGATGGCGGTAGTGATATAAGTGGCTATTTCCTTGAAAAACGAGACAAGAAGAGCCTAGGATGGTTTAAAGTACTAAAAGAGACTATCCGTGACACCAGACAAAAAGTAACAGGACTCACAGAAAACAGTGACTATCAATACAGAGTTTGTGCTGTAAACGCTGCTGGACAGGGTCCATTTTCTGAACCATCTGAATTCTACAAAGCTGCTGATCCTATTG
>TTN-207,ENSE00003809908,1,306,1490477,1490782,ATCCTCCAGGTCCACCTGCTAAGATAAGAATCGCAGATTCAACCAAGTCATCCATCACCCTTGGCTGGAGTAAGCCTGTCTATGATGGGGGCAGTGCTGTTACTGGGTATGTTGTCGAGATAAGACAAGGAGAGGAAGAGGAATGGACTACTGTCTCTACCAAAGGAGAGGTCAGAACTACAGAATATGTGGTATCCAACCTGAAACCTGGAGTCAATTACTACTTCCGGGTATCTGCTGTAAACTGTGCTGGACAAGGAGAACCTATAGAAATGAATGAACCTGTACAAGCTAAAGATATACTTG
>TTN-207,ENSE00003808993,1,1767,1490783,1492549,AGGCACCAGAGATTGACCTGGATGTGGCTCTCAGAACTTCTGTTATTGCCAAAGCTGGTGAAGATGTACAAGTGTTGATTCCCTTTAAAGGCAGACCTCCACCTACTGTCACATGGAGAAAAGATGAGAAGAATCTTGGCAGTGATGCCAGATACAGCATTGAAAACACTGATTCATCCTCATTACTCACCATTCCTCAAGTTACTCGCAATGATACAGGAAAATATATTCTCACAATAGAAAATGGAGTTGGTGAACCTAAGTCTTCAACTGTGAGTGTTAAAGTGCTTGACACACCAGCTGCCTGCCAGAAACTACAGGTTAAACATGTTTCTCGAGGCACAGTCACTTTGCTCTGGGATCCTCCTCTCATTGATGGAGGATCTCCAATAATTAATTATGTCATTGAAAAGAGAGATGCCACCAAGAGAACATGGTCTGTCGTGTCACACAAATGTTCTAGCACATCCTTCAAGCTAATAGATTTGTCGGAGAAGACTCCATTCTTCTTCAGAGTTCTTGCAGAAAATGAAATTGGAATTGGGGAACCCTGTGAAACTACAGAGCCAGTGAAGGCTGCTGAAGTACCAGCTCCTATACGTGATCTCTCAATGAAAGACTCAACAAAGACATCTGTCATCCTCAGCTGGACCAAACCTGACTTTGATGGTGGTAGCGTCATCACAGAATATGTTGTAGAAAGGAAAGGTAAAGGTGAACAGACGTGGTCCCACGCTGGCATAAGTAAGACATGTGAAATTGAGGTTAGCCAACTTAAGGAGCAGTCAGTCCTGGAGTTCAGAGTGTTTGCCAAAAATGAGAAAGGACTGAGTGATCCTGTCACTATTGGGCCAATTACAGTGAAAGAACTTATTATTACACCTGAAGTTGACCTGTCAGATATCCCTGGGGCACAAGTCACTGTGAGAATTGGGCACAATGTGCACCTTGAATTACCTTATAAGGGAAAACCCAAACCATCCATCAGTTGGCTGAAAGATGGCTTGCCACTGAAAGAAAGTGAATTTGTTCGCTTCAGTAAAACTGAAAACAAAATTACTTTGAGTATTAAGAATGCCAAGAAGGAGCATGGAGGAAAATACACTGTTATTCTTGATAATGCAGTGTGTAGAATTGCAGTCCCCATTACAGTCATCACCCTTGGCCCACCATCAAAGCCCAAAGGACCCATTCGATTTGATGAAATCAAGGCTGATAGTGTCATCCTGTCATGGGATGTACCTGAAGATAATGGAGGAGGAGAAATTACTTGTTACAGCATCGAGAAGCGGGAAACTTCACAAACTAACTGGAAGATGGTGTGTTCAAGTGTTGCCAGAACGACTTTCAAAGTTCCTAATCTAGTCAAAGATGCTGAGTACCAGTTTAGAGTGAGAGCAGAAAACAGATACGGAGTCAGCCAACCACTTGTCTCAAGCATTATTGTGGCAAAACACCAGTTCAGGATTCCTGGTCCCCCAGGAAAGCCAGTTATATACAATGTGACTTCTGATGGCATGTCACTAACTTGGGATGCTCCAGTTTATGATGGTGGTTCAGAAGTTACTGGATTCCATGTTGAAAAGAAAGAAAGAAATAGCATCCTCTGGCAAAAAGTTAATACATCACCAATCTCTGGAAGAGAATATAGAGCCACTGGACTGGTAGAAGGTCTGGATTACCAATTCCGTGTATATGCTGAAAATTCTGCTGGCCTAAGCTCACCTAGTGACCCAAGCAAATTTACCTTAGCTGTTTCTCCAGTAG
>TTN-207,ENSE00003811205,1,294,1492550,1492843,ACCCACCTGGCACTCCTGACTACATTGATGTCACCCGGGAAACCATCACACTTAAATGGAACCCACCATTGCGTGATGGAGGCAGTAAGATTGTGGGCTATAGCATTGAGAAACGGCAAGGAAATGAACGCTGGGTGAGATGCAACTTTACTGACGTCAGTGAATGTCAGTACACAGTTACAGGACTCAGTCCTGGGGATCGCTATGAGTTCAGAATAATTGCAAGAAATGCTGTTGGAACTATAAGCCCGCCCTCACAGTCTTCTGGCATTATTATGACAAGAGATGAAAATG
>TTN-207,ENSE00003808021,1,288,1492844,1493131,TTCCACCAATAGTAGAGTTTGGCCCTGAATACTTTGATGGTCTCATTATTAAGTCCGGAGAGAGCCTTAGAATTAAAGCTTTGGTACAAGGAAGACCAGTGCCTCGAGTAACTTGGTTCAAAGATGGAGTGGAAATCGAAAAGAGGATGAATATGGAAATAACCGACGTACTTGGATCCACCAGCCTATTTGTTAGAGATGCTACTCGGGACCATCGTGGTGTATACACAGTGGAAGCCAAAAATGCATCTGGTTCTGCAAAAGCAGAAATTAAAGTGAAAGTACAAG
>TTN-207,ENSE00003804355,1,300,1493132,1493431,ATACACCAGGAAAAGTAGTTGGGCCAATAAGATTCACCAATATTACTGGGGAGAAGATGACTCTGTGGTGGGATGCCCCACTCAATGACGGTTGTGCTCCCATAACCCACTACATCATTGAAAAACGGGAAACCAGCAGACTTGCCTGGGCACTAATTGAGGATAAATGTGAAGCCCAAAGTTACACTGCCATTAAACTAATAAACGGCAATGAATACCAATTCCGTGTTTCTGCAGTTAACAAGTTTGGTGTTGGCAGGCCACTTGATTCTGATCCAGTGGTTGCTCAAATACAATATA
>TTN-207,ENSE00003807046,1,2067,1493432,1495498,CTGTTCCTGATGCCCCTGGCATTCCAGAACCTAGCAACATAACAGGCAACAGCATTACCCTGACATGGGCAAGGCCAGAATCAGATGGTGGCAGTGAAATTCAACAGTATATCCTTGAAAGAAGAGAAAAGAAAAGCACAAGATGGGTAAAAGTGATCAGCAAACGACCAATCTCTGAAACAAGATTCAAAGTCACTGGTCTGACAGAAGGCAATGAGTATGAATTCCATGTCATGGCTGAAAATGCTGCAGGAGTTGGACCTGCAAGTGGCATCTCAAGACTCATTAAATGTAGAGAGCCCGTCAACCCACCAGGTCCTCCCACAGTGGTCAAAGTAACAGACACATCAAAGACAACTGTGAGCTTAGAATGGTCCAAACCAGTGTTTGATGGTGGCATGGAAATAATTGGGTATATTATTGAAATGTGTAAGGCCGACTTAGGAGACTGGCACAAGGTGAATGCAGAGGCATGTGTGAAAACAAGATATACAGTCACTGATCTACAAGCAGGTGAAGAATACAAATTCCGAGTTAGTGCTATCAATGGTGCTGGAAAAGGCGACAGCTGTGAAGTGACTGGCACAATTAAAGCAGTTGACCGGTTAACAGCTCCTGAGTTAGACATAGATGCAAACTTCAAACAGACTCATGTTGTTAGAGCTGGGGCCAGTATTCGCCTCTTCATTGCCTACCAAGGTAGACCTACTCCTACAGCTGTGTGGAGCAAACCAGACTCTAACCTTAGCCTTCGGGCTGATATCCATACAACAGATTCCTTCAGCACCCTCACTGTGGAAAACTGCAACAGAAATGATGCAGGGAAATATACCCTTACTGTGGAAAACAACAGTGGTAGTAAGTCAATCACATTCACCGTGAAAGTGCTAGACACTCCAGGCCCACCTGGCCCAATTACCTTCAAAGATGTGACCCGGGGATCTGCTACATTGATGTGGGATGCCCCTCTTCTTGACGGTGGTGCCCGAATCCATCATTATGTGGTAGAGAAACGAGAGGCAAGTCGCCGTAGTTGGCAGGTTATCAGTGAAAAATGCACTCGTCAGATCTTCAAGGTCAATGACCTGGCCGAAGGTGTTCCGTACTATTTCCGTGTTTCTGCAGTAAATGAGTATGGTGTTGGTGAGCCCTATGAAATGCCAGAACCAATTGTAGCCACAGAACAGCCTGCTCCACCTAGGAGACTTGATGTTGTTGATACTAGCAAATCCTCCGCAGTCTTAGCTTGGCTTAAACCTGACCACGATGGAGGCAGCCGGATCACTGGCTACCTGCTTGAAATGAGACAAAAGGGATCTGACTTCTGGGTTGAAGCTGGTCACACCAAACAGCTAACTTTCACAGTAGAGCGTCTTGTTGAGAAAACTGAATATGAATTCCGTGTGAAGGCCAAGAATGATGCTGGCTATAGTGAACCCAGAGAAGCCTTCTCTTCTGTCATCATTAAGGAGCCTCAAATCGAGCCCACTGCTGACCTCACTGGAATTACCAATCAGCTTATAACTTGCAAAGCAGGAAGCCCATTTACCATTGACGTACCAATCAGTGGTCGTCCTGCCCCCAAAGTAACATGGAAACTGGAAGAAATGAGACTTAAAGAGACAGATCGAGTGAGCATTACAACAACAAAAGACAGAACCACACTGACTGTAAAGGACAGCATGAGAGGTGACTCTGGAAGATACTTCTTGACCCTGGAAAATACAGCTGGTGTTAAAACATTTAGCGTCACAGTTGTGGTCATTGGAAGGCCAGGTCCAGTAACCGGCCCCATTGAGGTCTCATCTGTCTCAGCTGAATCGTGTGTCCTGTCATGGGGAGAACCTAAAGATGGAGGAGGCACTGAAATTACTAATTACATAGTTGAAAAGCGTGAATCGGGTACAACAGCTTGGCAGCTTGTCAATTCCAGTGTCAAGCGCACTCAAATTAAAGTCACTCATCTCACAAAATACATGGAATATTCTTTCCGTGTCAGTTCAGAGAACAGATTTGGTGTCAGCAAACCTCTAGAATCAGCACCAATAATTGCTGAACATCCATTTG
>TTN-207,ENSE00003810611,1,303,1495499,1495801,TCCCACCAAGCGCTCCTACCAGACCTGAGGTCTACCATGTGTCTGCCAATGCCATGTCTATTCGTTGGGAAGAACCCTACCACGATGGTGGCAGTAAAATCATTGGCTACTGGGTTGAGAAGAAAGAACGTAATACAATTCTTTGGGTGAAAGAAAACAAAGTGCCATGCTTAGAGTGCAACTACAAAGTAACTGGTTTAGTAGAAGGACTGGAATATCAGTTCAGAACTTATGCACTCAATGCTGCAGGTGTTAGCAAGGCCAGCGAAGCTTCAAGACCTATAATGGCTCAAAATCCAGTTG
>TTN-207,ENSE00003803222,1,306,1495802,1496107,ATGCACCAGGCAGACCAGAGGTGACAGATGTCACAAGATCAACAGTATCACTGATTTGGTCTGCCCCAGCGTATGATGGAGGCAGCAAGGTTGTGGGCTACATCATAGAGCGTAAGCCAGTCAGTGAGGTAGGAGATGGTCGCTGGCTGAAGTGCAACTACACCATTGTATCTGACAATTTCTTCACCGTGACTGCTCTCAGTGAAGGAGACACTTATGAGTTCCGTGTGTTAGCCAAGAATGCAGCAGGCGTAATTAGCAAAGGGTCTGAATCTACAGGCCCTGTCACTTGCCGAGATGAATACG
>TTN-207,ENSE00003801213,1,291,1496108,1496398,CTCCACCCAAAGCCGAACTGGATGCCCGATTACACGGTGATCTGGTTACCATCAGAGCAGGTTCTGATCTTGTTCTGGATGCTGCAGTTGGTGGCAAACCTGAACCCAAAATTATCTGGACCAAAGGAGACAAGGAGCTAGATCTCTGTGAAAAAGTCTCTTTGCAGTATACTGGCAAACGAGCAACTGCTGTGATCAAGTTCTGTGACAGAAGTGACAGTGGAAAATACACTTTAACAGTGAAAAATGCCAGCGGGACCAAGGCCGTGTCTGTCATGGTCAAAGTGCTTG
>TTN-207,ENSE00003809128,1,297,1496399,1496695,ATTCCCCTGGCCCATGTGGAAAGCTCACCGTCAGCAGAGTAACACAGGAGAAGTGCACTTTAGCCTGGAGCCTTCCGCAGGAAGACGGAGGAGCAGAAATCACTCACTACATCGTGGAAAGACGCGAGACTAGCAGGCTCAACTGGGTGATTGTTGAAGGCGAATGCCCAACCCTATCCTATGTCGTTACCAGGCTCATCAAGAACAATGAGTACATATTCCGAGTGAGGGCAGTAAACAAATATGGCCCTGGTGTGCCTGTTGAATCAGAGCCAATTGTAGCCAGAAACTCATTCA
>TTN-207,ENSE00003803385,1,306,1496696,1497001,CTATTCCATCACCACCCGGCATACCTGAAGAAGTTGGGACTGGCAAAGAGCATATCATCATTCAGTGGACAAAACCTGAATCTGATGGTGGCAATGAAATCAGCAACTACCTAGTAGACAAACGTGAGAAGAAGAGCCTGCGCTGGACACGTGTCAACAAAGACTATGTGGTGTATGATACCAGGCTGAAGGTGACCAGCCTGATGGAGGGTTGTGATTACCAGTTCCGGGTGACCGCAGTGAATGCAGCTGGTAACAGTGAGCCCAGCGAAGCTTCCAACTTCATCTCATGCAGAGAACCATCAT
>TTN-207,ENSE00003807140,1,306,1497002,1497307,ATACCCCTGGACCACCTTCTGCTCCAAGAGTTGTGGATACCACCAAACACAGCATTAGTTTGGCATGGACCAAACCCATGTACGATGGTGGTACTGACATTGTAGGATATGTTCTGGAAATGCAAGAGAAGGACACTGATCAGTGGTACCGAGTGCATACCAATGCCACAATAAGAAATACTGAATTCACTGTGCCAGACCTTAAAATGGGCCAGAAATATTCCTTCAGAGTTGCTGCCGTGAACGTGAAGGGTATGAGCGAATACAGCGAATCAATTGCTGAAATTGAGCCCGTGGAAAGAATAG
>TTN-207,ENSE00003809946,1,282,1497308,1497589,AAATACCAGATCTTGAGCTTGCAGATGATCTAAAGAAGACTGTGACCATCAGGGCTGGGGCCTCCTTGCGCTTGATGGTGTCTGTATCTGGAAGACCACCTCCTGTCATAACGTGGAGCAAGCAGGGCATTGACCTTGCAAGCCGGGCAATTATTGACACCACTGAGAGCTACTCATTGCTAATAGTGGACAAAGTTAATCGGTACGATGCTGGAAAATACACAATTGAAGCTGAAAACCAATCTGGCAAGAAATCAGCAACAGTCCTTGTTAAAGTCTATG
>TTN-207,ENSE00003810384,1,594,1497590,1498183,ATACTCCTGGTCCCTGTCCTTCAGTGAAAGTTAAGGAAGTATCAAGAGATTCTGTGACTATAACTTGGGAAATTCCCACGATTGATGGTGGAGCTCCAGTCAACAATTACATCGTTGAGAAGCGTGAAGCTGCTATGAGAGCATTCAAAACAGTAACTACCAAATGCAGCAAGACACTTTACAGAATTTCTGGACTTGTAGAAGGAACCATGTACTATTTCAGAGTGCTGCCAGAAAATATTTATGGCATTGGAGAACCTTGTGAAACATCTGATGCAGTACTGGTCTCAGAAGTGCCTTTGGTGCCTGCAAAGCTAGAAGTGGTCGATGTCACCAAATCCACTGTTACCCTTGCCTGGGAAAAACCACTCTACGATGGTGGTAGCCGACTCACTGGATATGTTCTCGAGGCCTGCAAAGCTGGCACAGAGAGATGGATGAAGGTTGTCACCTTAAAACCCACAGTCCTAGAGCACACTGTTACTTCCTTAAATGAAGGTGAACAATACTTATTTAGAATAAGGGCACAAAATGAGAAAGGTGTGTCAGAACCAAGAGAGACTGTCACAGCCGTGACTGTACAAGACCTCAGAG
>TTN-207,ENSE00003802641,1,288,1498184,1498471,TGTTGCCAACAATCGATCTTTCTACAATGCCTCAGAAGACCATCCATGTCCCAGCTGGCAGACCAGTAGAGCTGGTGATACCTATTGCTGGCCGTCCACCTCCTGCTGCTTCCTGGTTCTTTGCTGGTTCTAAACTGAGAGAATCAGAGCGTGTCACAGTTGAAACTCACACTAAAGTAGCTAAATTAACCATCCGTGAAACCACTATCAGAGATACTGGAGAATACACACTTGAATTGAAGAATGTTACCGGAACTACTTCAGAAACCATTAAAGTTATCATTCTTG
>TTN-207,ENSE00003806194,1,300,1498472,1498771,ACAAGCCTGGTCCACCAACAGGACCTATTAAGATTGATGAAATTGATGCTACATCAATTACCATTTCCTGGGAACCACCTGAATTGGACGGTGGTGCTCCACTGAGTGGTTATGTGGTAGAACAACGTGACGCTCATCGTCCAGGATGGCTGCCCGTTTCTGAATCAGTGACTAGGTCCACGTTTAAGTTTACCAGACTCACCGAAGGAAATGAGTATGTGTTCCGTGTGGCTGCAACAAACCGCTTCGGGATTGGCTCTTACTTGCAGTCTGAGGTCATAGAGTGTCGCAGCAGCATCC
>TTN-207,ENSE00003805894,1,303,1498772,1499074,GTATTCCTGGACCCCCAGAAACATTACAGATATTTGATGTTTCCCGTGATGGCATGACACTTACTTGGTACCCACCAGAGGATGACGGTGGCTCCCAAGTGACTGGATATATTGTGGAGCGCAAAGAAGTGAGAGCAGATCGATGGGTCCGTGTAAATAAAGTACCTGTGACAATGACACGGTACCGCTCCACTGGCCTTACTGAAGGCTTAGAATATGAACACCGTGTCACAGCCATTAATGCAAGAGGGTCTGGGAAACCAAGTCGTCCTTCCAAACCCATCGTTGCCATGGATCCAATTG
>TTN-207,ENSE00003808643,1,303,1499075,1499377,CTCCTCCAGGAAAGCCACAAAACCCAAGAGTTACTGATACAACAAGGACATCAGTCTCCCTGGCCTGGAGTGTTCCAGAAGATGAAGGAGGATCTAAAGTCACAGGCTACTTGATTGAAATGCAAAAAGTAGATCAACATGAATGGACCAAGTGTAACACCACTCCAACCAAGATTCGAGAGTATACTCTAACACACCTACCTCAGGGTGCAGAATACAGGTTCCGCGTCCTAGCTTGTAATGCTGGTGGACCTGGTGAGCCTGCTGAGGTACCAGGAACAGTCAAAGTCACTGAAATGCTTG
>TTN-207,ENSE00003805779,1,585,1499378,1499962,AATATCCTGATTATGAACTTGATGAAAGATACCAAGAAGGTATCTTTGTAAGGCAAGGTGGCGTCATCAGACTTACCATACCAATCAAAGGAAAACCATTCCCAATATGTAAATGGACCAAGGAAGGCCAGGATATTAGTAAGCGTGCCATGATTGCAACATCTGAAACACACACTGAGCTTGTGATCAAAGAAGCAGACAGGGGTGATTCTGGCACTTATGACCTGGTTCTGGAAAATAAATGTGGCAAGAAGGCTGTCTACATCAAGGTCAGGGTGATAGGAAGTCCCAACAGTCCAGAAGGGCCACTGGAATATGATGACATCCAAGTCCGCTCTGTGAGGGTCAGCTGGAGACCTCCTGCTGATGATGGTGGTGCTGACATCTTAGGCTACATCCTCGAGAGACGAGAAGTGCCTAAAGCCGCCTGGTATACCATTGATTCCAGAGTCCGAGGTACATCTCTGGTGGTAAAAGGCCTCAAAGAGAATGTAGAATACCATTTCCGTGTTTCAGCAGAAAACCAGTTTGGCATAAGCAAACCCTTGAAATCTGAGGAACCAGTCACACCAAAAACACCATTGA
>TTN-207,ENSE00003806836,1,306,1499963,1500268,ATCCTCCAGAACCTCCAAGCAATCCTCCAGAAGTACTCGATGTAACCAAGAGTTCTGTTAGCTTGTCCTGGTCCCGGCCCAAAGATGATGGTGGTTCTAGAGTCACAGGCTACTACATCGAACGCAAAGAGACATCCACTGACAAGTGGGTCAGACACAACAAGACTCAGATCACCACCACAATGTACACTGTCACAGGGCTTGTTCCCGATGCTGAGTATCAGTTCCGCATCATCGCACAGAATGATGTTGGCCTGAGTGAGACCAGCCCTGCTTCTGAACCAGTTGTTTGCAAAGATCCATTTG
>TTN-207,ENSE00003810204,1,300,1500269,1500568,ATAAACCAAGCCAACCAGGAGAACTTGAGATTCTTTCAATATCCAAAGATAGTGTCACTCTACAGTGGGAGAAACCTGAATGTGATGGTGGTAAAGAAATTCTTGGATACTGGGTTGAATATAGACAGTCTGGAGACAGTGCCTGGAAGAAGAGCAATAAGGAACGTATTAAGGACAAGCAATTCACAATAGGAGGTTTGCTGGAAGCTACTGAGTATGAATTCAGGGTTTTTGCTGAGAATGAGACTGGGCTGAGCAGACCTCGCAGAACTGCTATGTCTATAAAGACTAAACTCACAT
>TTN-207,ENSE00003805486,1,576,1500569,1501144,CTGGAGAGGCCCCAGGAATACGCAAAGAAATGAAGGATGTTACCACAAAATTGGGTGAAGCTGCTCAACTCTCATGCCAGATTGTTGGAAGGCCTCTTCCTGACATTAAATGGTACAGATTTGGTAAAGAGCTCATACAAAGCCGGAAATACAAAATGTCTTCAGATGGACGCACACACACTCTTACAGTAATGACAGAGGAACAGGAAGATGAAGGTGTTTATACCTGCATAGCCACCAATGAGGTTGGAGAAGTAGAAACCAGTAGTAAGCTTCTCCTGCAAGCAACACCGCAGTTCCATCCTGGTTACCCACTGAAAGAGAAATATTATGGAGCTGTGGGTTCCACACTTCGGCTTCATGTTATGTACATTGGTCGTCCAGTACCTGCCATGACTTGGTTCCATGGTCAGAAACTTTTGCAAAACTCAGAAAACATTACTATTGAAAACACTGAGCACTATACTCATCTTGTCATGAAGAATGTCCAACGTAAGACTCATGCTGGGAAATACAAAGTCCAGCTCAGCAATGTTTTTGGAACAGTTGATGCCATCCTTGATGTGGAAATACAAG
>TTN-207,ENSE00003801306,1,306,1501145,1501450,ATAAACCAGACAAACCTACAGGACCAATTGTGATCGAAGCTCTATTGAAGAACTCCGCAGTGATCAGCTGGAAACCACCCGCAGATGACGGAGGCTCCTGGATCACCAACTATGTGGTGGAAAAATGTGAGGCCAAGGAGGGGGCTGAATGGCAATTGGTGTCTTCAGCCATCTCAGTGACAACCTGTAGAATTGTGAACCTCACAGAAAATGCTGGCTATTACTTCCGGGTTTCAGCTCAGAACACTTTCGGCATCAGTGACCCTCTAGAAGTGTCCTCAGTTGTGATCATTAAGAGTCCATTTG
>TTN-207,ENSE00003808123,1,594,1501451,1502044,AAAAGCCAGGTGCTCCTGGCAAACCAACTATTACTGCTGTCACAAAAGATTCTTGTGTTGTGGCCTGGAAGCCACCTGCCAGTGATGGAGGTGCAAAGATTAGAAATTACTACCTTGAGAAGCGTGAGAAGAAGCAGAATAAATGGATTTCTGTGACAACAGAAGAAATTCGAGAAACTGTCTTTTCAGTGAAAAACCTTATTGAAGGTCTTGAATACGAGTTTCGTGTGAAATGTGAAAATCTAGGTGGGGAAAGTGAATGGAGTGAAATATCAGAACCCATCACTCCCAAATCTGATGTCCCAATTCAGGCACCACACTTTAAAGAGGAACTGAGAAATCTAAATGTCAGATATCAGAGCAATGCTACCTTGGTCTGCAAAGTGACTGGTCATCCAAAACCTATCGTCAAATGGTACAGACAAGGCAAAGAAATCATTGCAGATGGATTAAAATATAGGATTCAAGAATTTAAGGGTGGCTACCACCAGCTCATCATTGCAAGTGTCACAGATGATGATGCCACAGTTTACCAAGTCAGAGCTACCAACCAAGGGGGATCTGTGTCTGGCACTGCCTCCTTGGAAGTGGAAG
>TTN-207,ENSE00003808212,1,5609,1502045,1507653,TTCCAGCTAAGATACACTTACCTAAAACTCTTGAAGGCATGGGAGCAGTTCATGCTCTCCGAGGTGAAGTGGTCAGCATCAAGATTCCTTTCAGTGGCAAACCAGATCCTGTGATCACCTGGCAGAAAGGACAAGATCTCATTGACAATAATGGCCACTACCAAGTTATTGTCACAAGATCCTTCACATCACTTGTTTTCCCCAATGGGGTAGAGAGAAAAGATGCTGGTTTCTATGTGGTCTGTGCTAAAAACAGATTTGGAATTGATCAGAAGACAGTTGAACTGGATGTGGCTGATGTTCCTGACCCACCCAGAGGAGTCAAAGTTAGTGATGTCTCACGAGATTCTGTCAACTTAACATGGACTGAGCCAGCCTCTGATGGTGGCAGCAAAATCACCAACTACATTGTTGAAAAATGTGCAACTACTGCAGAAAGATGGCTCCGTGTAGGACAGGCCCGAGAAACACGTTATACCGTGATCAACTTATTTGGAAAAACAAGTTACCAGTTCCGGGTAATAGCTGAAAATAAATTTGGTCTGAGCAAGCCTTCAGAGCCTTCAGAACCAACCATAACCAAAGAAGATAAGACCAGAGCTATGAACTATGATGAAGAGGTAGATGAAACCAGGGAAGTCTCCATGACTAAAGCATCTCACTCTTCAACCAAGGAACTCTATGAGAAATATATGATTGCTGAAGATCTTGGGCGTGGTGAGTTTGGAATTGTCCATCGTTGTGTTGAAACATCCTCAAAGAAGACATACATGGCCAAATTTGTTAAAGTCAAAGGGACTGATCAGGTTTTGGTAAAGAAGGAAATTTCCATTCTGAATATTGCTAGGCATAGAAACATCTTACACCTCCATGAATCATTTGAAAGCATGGAAGAATTAGTTATGATCTTTGAGTTTATATCAGGACTTGACATATTTGAGCGCATTAACACAAGTGCTTTTGAACTTAATGAAAGAGAAATTGTAAGTTATGTTCACCAGGTCTGTGAAGCACTTCAGTTTTTACACAGTCATAATATTGGACACTTTGACATTAGACCAGAAAATATCATTTACCAAACCAGAAGAAGCTCTACCATTAAAATCATAGAATTTGGTCAAGCCCGTCAGCTGAAACCAGGGGACAACTTCAGGCTTCTATTCACTGCCCCAGAATACTATGCACCTGAAGTCCACCAGCATGATGTTGTCAGCACAGCCACAGACATGTGGTCACTTGGAACACTGGTATATGTGCTATTGAGTGGTATCAACCCATTCCTGGCTGAAACTAACCAACAGATCATTGAGAATATCATGAATGCTGAATATACTTTCGATGAGGAAGCATTCAAAGAGATTAGCATTGAAGCCATGGATTTTGTTGACCGGTTGTTAGTGAAAGAGAGGAAATCTCGCATGACAGCATCGGAGGCTCTCCAGCACCCATGGTTGAAGCAGAAGATAGAAAGAGTCAGTACTAAAGTTATCAGAACATTAAAACACCGGCGTTATTACCACACCCTGATCAAGAAAGACCTCAACATGGTTGTGTCAGCAGCCCGGATCTCCTGTGGTGGTGCAATTCGATCTCAGAAGGGAGTGAGTGTTGCTAAAGTTAAAGTGGCATCCATTGAAATTGGCCCAGTTTCTGGGCAGATAATGCATGCAGTTGGTGAAGAAGGAGGACATGTCAAATATGTATGCAAAATTGAAAATTATGATCAGTCTACCCAAGTGACTTGGTACTTTGGCGTCCGACAGCTGGAGAACAGTGAGAAATACGAAATCACCTACGAAGATGGAGTGGCCATCCTCTATGTCAAAGACATTACCAAATTAGATGATGGTACCTACAGATGCAAAGTAGTCAATGACTATGGTGAAGACAGTTCTTATGCAGAGCTATTTGTTAAAGGTGTGAGAGAAGTCTATGACTATTACTGCCGTAGAACCATGAAGAAAATTAAGCGCAGAACAGACACAATGAGACTCCTGGAAAGGCCACCAGAATTTACCCTGCCTCTCTATAATAAGACAGCTTATGTAGGTGAAAATGTCCGGTTTGGAGTAACTATAACTGTCCACCCAGAGCCTCATGTAACATGGTATAAATCAGGTCAGAAAATCAAACCAGGTGACAATGACAAGAAGTACACATTTGAGTCAGACAAGGGTCTTTACCAATTAACAATCAACAGTGTCACTACAGATGATGACGCTGAATATACTGTTGTGGCAAGGAACAAATATGGTGAAGACAGCTGTAAAGCAAAGCTGACAGTAACCCTACACCCACCTCCAACAGATAGTACCTTAAGACCCATGTTCAAAAGGTTACTGGCAAATGCAGAATGCCAAGAAGGCCAAAGTGTCTGCTTTGAGATCAGAGTGTCTGGCATCCCCCCACCAACATTAAAATGGGAGAAAGATGGTCAGCCACTGTCCCTCGGGCCTAACATTGAAATTATCCATGAAGGCTTGGATTATTATGCTCTGCACATCAGGGACACTTTGCCTGAAGACACGGGTTATTATAGAGTCACAGCCACTAACACAGCTGGGTCCACCAGCTGCCAGGCTCACCTACAAGTGGAACGCCTGAGGTACAAGAAACAGGAATTCAAGAGTAAGGAGGAGCATGAGCGACACGTACAAAAACAAATTGACAAAACCCTCAGAATGGCTGAAATTCTTTCTGGAACTGAAAGTGTACCACTGACACAGGTAGCTAAAGAGGCTCTGAGAGAAGCTGCTGTCCTTTATAAACCGGCTGTAAGCACCAAGACTGTAAAAGGGGAATTCAGACTTGAGATAGAAGAAAAGAAGGAGGAGAGAAAACTCCGGATGCCTTATGATGTACCAGAGCCACGCAAGTATAAGCAGACTACCATAGAAGAAGACCAACGCATCAAGCAGTTCGTGCCCATGTCTGACATGAAGTGGTATAAAAAGATACGTGATCAGTATGAAATGCCTGGGAAACTTGACAGAGTTGTACAGAAACGACCCAAGCGCATCCGCCTTTCAAGATGGGAACAGTTCTATGTGATGCCTCTTCCACGCATTACAGATCAATACAGACCTAAATGGCGTATTCCTAAACTGTCCCAAGATGATCTTGAGATAGTGAGACCAGCCCGCCGGCGTACACCTTCTCCTGATTATGACTTTTACTACCGACCTAGAAGACGTTCTCTTGGGGACATCTCTGATGAAGAATTACTCCTCCCCATTGATGACTACTTAGCAATGAAAAGAACAGAGGAAGAGAGGCTGCGTCTTGAAGAAGAGCTTGAGTTAGGTTTTTCAGCTTCACCCCCAAGTCGAAGCCCTCCACACTTTGAGCTTTCTAGCCTACGTTACTCTTCACCACAAGCTCATGTCAAGGTGGAGGAAACAAGAAAAGACTTCAGGTATTCAACCTATCACATCCCAACGAAGGCTGAAGCTAGTACAAGTTATGCAGAACTGAGGGAACGGCATGCCCAGGCTGCGTACAGACAGCCAAAGCAACGGCAAAGAATCATGGCTGAGAGGGAGGATGAAGAGTTGCTTCGCCCAGTTACGACCACCCAGCATCTCTCAGAATACAAAAGCGAACTTGACTTCATGTCAAAGGAGGAAAAGTCTAGAAAGAAATCAAGGCGACAAAGAGAAGTGACAGAAATAACAGAAATTGAGGAAGAATACGAAATCTCAAAACATGCTCAAAGAGAATCATCCTCATCTGCGTCTAGACTACTGAGACGACGGCGCTCCCTGTCTCCAACTTATATTGAGTTAATGAGGCCAGTGTCTGAGCTGATCCGGTCACGTCCACAACCGGCTGAGGAATACGAAGATGACACAGAAAGAAGGTCACCTACTCCAGAGAGAACTCGCCCACGATCCCCCAGCCCTGTGTCTAGTGAGAGATCACTCTCGAGATTTGAGAGGTCTGCAAGATTTGATATCTTTTCCAGGTATGAGTCCATGAAAGCTGCTTTAAAAACTCAGAAGACATCAGAAAGGAAGTATGAAGTTTTGAGTCAGCAGCCTTTCACACTGGACCATGCCCCTCGAATCACACTGAGAATGCGCTCGCACAGGGTACCATGTGGCCAAAATACACGTTTTATTTTAAATGTTCAGTCTAAGCCAACTGCCGAGGTTAAATGGTACCACAATGGTGTGGAACTCCAAGAAAGCAGTAAGATTCATTACACCAACACGAGTGGAGTCCTCACCCTGGAAATTCTGGACTGTCATACTGATGACAGTGGAACCTACCGTGCTGTGTGCACCAACTACAAGGGCGAAGCTTCTGACTATGCAACGTTGGACGTGACAGGAGGGGATTATACCACCTATGCTTCCCAACGCAGAGATGAAGAGGTCCCCAGATCTGTTTTCCCTGAGCTGACAAGAACAGAGGCGTATGCTGTTTCATCATTTAAGAAAACATCTGAGATGGAAGCTTCGTCTTCTGTCAGGGAAGTGAAATCACAGATGACGGAGACAAGGGAAAGTCTCTCCTCATATGAACACTCTGCATCTGCAGAAATGAAAAGTGCTGCATTAGAAGAAAAGTCACTGGAAGAAAAATCCACAACCAGAAAGATCAAGACGACTTTGGCAGCAAGAATTCTAACAAAGCCACGGTCCATGACCGTCTACGAGGGCGAGTCTGCAAGGTTTTCTTGTGACACCGATGGTGAGCCGGTACCAACTGTGACCTGGCTGCGTAAAGGACAAGTGCTAAGTACTTCTGCCCGCCACCAAGTGACCACCACAAAGTACAAATCAACCTTTGAGATCTCTTCAGTCCAGGCTTCCGATGAGGGCAATTACAGCGTGGTGGTAGAAAACAGTGAAGGGAAACAAGAAGCAGAGTTCACTCTGACTATTCAAAAGGCCAGGGTAACTGAAAAGGCTGTGACATCACCACCAAGAGTCAAATCCCCAGAGCCTCGGGTGAAATCCCCAGAAGCAGTTAAGTCTCCAAAACGAGTGAAATCTCCAGAACCTTCTCACCCGAAAGCCGTATCACCCACAGAGACAAAACCAACACCAACAGAGAAAGTTCAGCACCTCCCAGTCTCTGCCCCACCAAAGATTACTCAGTTCCTGAAAGCAGAAGCTTCTAAAGAGATTGCAAAACTGACCTGTGTGGTTGAAAGCAGTGTATTAAGGGCAAAAGAGGTCACCTGGTATAAAGATGGCAAGAAACTGAAGGAAAATGGGCATTTCCAGTTTCATTATTCAGCAGATGGTACCTATGAGCTCAAAATCAATAACCTCACTGAATCTGATCAAGGAGAATATGTTTGTGAGATTTCTGGTGAAGGTGGAACGTCTAAAACCAACTTACAATTTATGGGGCAAGCCTTTAAGAGTATCCATGAGAAGGTATCAAAAATATCAGAAACTAAGAAATCAGATCAGAAAACCACTGAGTCAACAGTAACCAGAAAAACTGAACCAAAAGCTCCTGAACCAATTTCCTCAAAACCAGTAATTGTTACTGGGTTGCAGGATACAACTGTTTCTTCAGACAGTGTTGCTAAATTTGCAGTTAAGGCTACTGGAGAACCCCGGCCAACTGCCATCTGGACAAAAGATGGAAAG
>TTN-207,ENSE00003811220,1,157,1507654,1507810,GCCATTACACAAGGAGGTAAATATAAACTCTCTGAAGACAAGGGAGGGTTCTTCTTAGAAATTCATAAGACTGATACTTCTGACAGTGGACTTTATACTTGTACAGTAAAAAATTCAGCTGGATCTGTGTCCTCTAGCTGCAAATTAACAATAAAAG
>TTN-207,ENSE00003801641,1,692,1507811,1508502,CTATAAAAGATACTGAGGCACAGAAAGTCTCTACACAAAAGACTTCTGAAATTACACCTCAGAAGAAAGCTGTTGTCCAAGAGGAAATTTCCCAAAAAGCCCTAAGGTCTGAAGAAATTAAGATGTCAGAGGCAAAATCTCAAGAAAAGTTAGCCCTCAAAGAGGAAGCTTCAAAGGTTCTGATTTCTGAAGAAGTCAAGAAATCAGCAGCAACCTCCCTGGAAAAATCCATTGTCCATGAGGAAATCACTAAAACATCACAGGCATCAGAAGAAGTCAGAACTCATGCTGAGATTAAAGCATTTTCTACTCAGATGAGCATAAACGAAGGTCAAAGACTGGTTTTAAAAGCCAACATTGCTGGTGCCACTGATGTGAAATGGGTACTGAATGGCGTAGAGCTTACCAACTCTGAGGAGTACCGATATGGTGTCTCAGGCAGCGATCAGACCCTAACCATCAAGCAAGCCAGTCACAGAGATGAAGGAATCCTCACCTGCATAAGCAAAACCAAGGAAGGAATCGTCAAGTGTCAGTATGATTTGACACTGAGCAAAGAACTCTCAGATGCTCCAGCCTTCATCTCACAGCCTAGATCTCAAAATATTAATGAAGGACAAAATGTTCTCTTTACTTGTGAAATCAGTGGCGAGCCATCCCCTGAAATCGAATGGTTTAAAAACAACCTGCCA
>TTN-207,ENSE00003801638,1,154,1508503,1508656,ATTTCTATTTCTTCAAATGTCAGCATAAGCCGCTCCAGAAATGTATACTCCCTTGAAATCCGAAATGCATCAGTCAGCGACAGTGGAAAGTACACAATTAAGGCCAAAAATTTCCGTGGCCAGTGTTCAGCTACAGCTTCCTTAATGGTCCTTC
>TTN-207,ENSE00003805382,1,303,1508657,1508959,CTCTAGTTGAAGAACCTTCCAGAGAGGTAGTATTGAGAACAAGTGGTGACACAAGCTTGCAAGGAAGCTTCTCGTCTCAGTCAGTCCAAATGTCTGCCTCCAAGCAGGAGGCCTCCTTCAGCAGTTTCAGCAGCAGCAGTGCTAGCAGCATGACTGAGATGAAATTTGCAAGCATGTCTGCCCAAAGCATGTCCTCCATGCAAGAGTCCTTTGTAGAAATGAGTTCCAGCAGCTTTATGGGAATATCTAATATGACACAACTGGAAAGCTCAACTAGTAAAATGCTTAAAGCAGGCATAAGAG
>TTN-207,ENSE00003809884,1,1319,1508960,1510278,GAATTCCGCCTAAAATTGAAGCTCTTCCATCTGATATCAGCATTGATGAAGGCAAAGTTCTAACAGTAGCCTGTGCTTTCACGGGTGAGCCTACCCCAGAAGTAACATGGTCCTGTGGTGGAAGAAAAATCCACAGTCAAGAACAGGGGAGGTTCCACATTGAAAACACAGATGACCTGACAACCCTGATCATCATGGACGTACAGAAACAAGATGGTGGACTTTATACCCTGAGTTTAGGGAATGAATTTGGATCTGACTCTGCCACTGTGAATATACATATTCGATCCATTTAAGAGGGCCTGTGCCCTTATACTCTACACTCATTCTTAACTTTTCGCAAACGTTTCACACGGACTAATCTTTCTGAACTGTAAATATTTAAAGAAAAAAAAGTAGTTTTGTATCAACCTAAATGAGTCAAAGTTCAAAAATATTCATTTCAATCTTTTCATAATTGTTGACCTAAGAATATAATACATTTGCTAGTGACATGTACATACTGTATATAGCCGGATTAACGGTTATAAAGTTTTGTACCATTTATTTTATGACATTTTACAATGTAAGTTTTGAAACTAACTGTTGGTAGGAGAAAGTTTCTTATGGAACGAATACCCTGCTCAACATTTAATCAATCTTTGTGCCTCAACATACTGTTGATGTCTAAGTATGCCTCAGTGGGTTGAGAAAATCCCCATTGAAGATGTCCTGTCCACCTAAAAGAGAATGATGCTGTGCATATCACTTGATATGTGCACCAATACCTACTGAATCAGAAATGTAAGGCATTGGTGATGTTTGCATTTACCCTCCTGTAAGCAACACTTTAACGTCTTACATTTTCTCTGATGATGTCACACAAAATTATCATGACAAATATTACCAGAGCAAAGTGTAACGGCCAACACTTTGTTCGCTCATTTTACGCTGTCTCTGACATAAGGAGTGCCTGAATAGCTTGGAAAAGTAACATCTCCTGGCCATCCCTTCATTTAACCAAGCTATTCAAGTATTCCTATGCCAGAGCAGTGCCAACTCTTGGAGGTCCCAGAGTGCAGCCAATGCCTTTGTGTGGTAGTTCTAAATTTTAATTGCACCTGAAAAACCTGGGCACCTAAGCAATGAGCCACAGCAAAAAGTAAAGAACAACAACAAAATAAAGCTGTTGTTAAATTTTAAACAATATTACTAATTGCCCAAAATGTCAATTTGATGTAGTTCTTTTCATGCAAGTATAAATTCAATTGTTAGTTATAATTGTTGGACCTCCTTGAGATAGTAACAACAAAATAAAGCAAGCTATCTGCACCTCAAAA
>TTN-207,,0,2556,1510279,1512834,GTGAGCAGCAACTTTTCTTATTTTAATAGTAGAGTCACTTTCTTATTGATCTCTGGCTCTGGATTATTTGTGTGTGCTAAATGCCTATGTACAAGTGTTTGTATGACTATTTCTTGCCAGTGCTGACCCATTATTTAAATCTGCTTGTTAAATTCTATTTTAAAATGTCTGAACATTTTTCCTTAAAAAGTTGAAAGCTTTATTATATCAGCTAAATGATTCCATGATTCAAATTGTTTAAGTTCACTTAATATTCTAAAAGTTGAGGTCTGAAATGTTGAGAGAAATGTTTACTTCTTTTCTAGACTCTCTTTGCCTGTTGAGAATGTTCAAGGTTATATTACTCAATGATAAAGTTAAGCACACCAAGAATAGCTCTGATAAAATGCATGTGGTATCAGCTACACCCTGATGACTTTTTAAGGGAATCAACTGCTGAGGTATCAGTTGCAGGACAGTGACAGAACACTTGCCTGCTGTCAGTCAACCTTGGAGAGTTTAGGAGAGTTTATTTTAAGAGCATGACATTTTAGACGCATACCTTCAGCCCCAGTTAGACAAAGGCCTGTGAAGAGCAAGTGCTAAGGCAATAAAATTTACCTAGACAATAGGAATGTAAGATCAATTTAAGCTGGTTAATTGCAACATAGTTGGAGATTTGGAATAAAATGATATAATTGTTTTCTAAAATATTCAGAATCTCTTCATGCATTTTAACTCAGCACACAGTCCAATTATATATTTTGAGATAAATGTTGACACTAAGAAGGGTAAGAAATAATGTTTAAAGGAAAGGTTTCTTACTTCTAAATACACTTTGATTTCTCATCTTCCTAGAATTTGATTACTAATTGTCAATGCCTGTAAATACATAGATATATAATTAGGTATTCTATGTCTAAGAGGACAGCTATTTTTAGATATACTAACTTATAAACAGACAAAGTTAGACACAGAAAGTTGTTCATCCCAAAGATAATATGCTACAAAAAGGAGTTTCTGACAAAAAAAATTTATGAAAGCTTTTGGATATTATCTGATTTTTCCAAATATAAATTTTATTGTCTCAGAGAATGCTGGTTTCATTTTTTTAACTAAGTAGAAGGTTACAGTAAGGAACAGAATTATCACTAAGAAGATTATTGCTCCATGAAGTTTTAGTAAACAAAGAATTTAATGAAAAATAGTAATGAAGTGATTGACAATTCAGAAATGTTCTATTTCAGAACAGAATAGTCATGTTGAATAATTAGGTATTTATGCATCAGAAAATTCTTCACATAATGTCTCTGAAACTGATAGGCAAAGTACTTTCTTGCACTTAACAAAATGACTTAACTGCAAATTTTATATTCGTTTCTTTGATGTTGAATATTTTACTTTATGAAAGCATAGGCCTTTTCACTTCATCTACATTTTACACCAGCCTTCCATTATTCAAAGTTTGCAAATTGTTCCATATTAAGAACTCAAGCCAGCATTTTTCTTTCAGAACTATAATAAACTTTGGCCTGTTCACTAAAATTTAAATTTTTCTGAATATTTACTTCAGCAGTAACAACATTTACTGCACAGTTACAGTATGAAGAAATGTTAAGAAATAGAAAGCACCGTATGCCGTCTACAAAAAGCTTGCATATTTGATAAGGCTTGCCAAAGCTTCTCCAGTCAGGAAAGAGATTACAAAGTTCAGATTTTTACTTCTGGCAACTATTTTAAGTAATCAGATAATGTCTGAATCAATGTCAACTTTATAAATATAGAGTGAACGAAAAATATTGGGGAGAAGGAAAATTTTTAAAATAATTTTCACTTACTAAGCTGATGCAGAGGTTTATTTATTTTAATTTTTTTTTTTTTTTTTTTTTGAGACAGAGTCTCATTCTGTCACCCAGGCTGGAGTGTGGTGGCACCATCTTTGCTCACTGCAACCTCCACCTCCTGGGTTTAAGCAATTCTCATGCCTCAGCCTCCCAAGTAGCTGGGACTACAGACATGGGCCACCACGCCTGGCTAATTTTTGTATTTGTAGTAGAGACAGGGGTTTCACCATGTTAGCCAAACTGGTCTCAAACTCCTGACCTCAAGTAATCCTCCCGCCTCGGCCTCCTAAAGTGCTGGGATTACCAGCATGAGCCACCACGCCAGGCCCAGAGGTTTATTTTACATTTATCACATGTCTTGTCTCTCTAATTACACTTCACTAACCCTGCATTGCTGTGGTTTTCTTCTTCAACTCTGAACCTGGTTTTCCACCATTGGTAAGACTGTATATTCCCTCTTTGACCACTAGGGTTCATTCCTTGTTCTGTTTGGCTAATACTTTTTTCCATTTCCCCTTACACTTGCTACTTTGGGTTAGGCTTTAAGTCAACTCAATGATGAACTATGCAAAACTGTTCAAGCCACAAAAGAGAAGACCTGCCCATCACTCTAGGCCCACAGATGACCTATGGAGCAATCCATTTGGAGAAACGTGTGTCTCTGCTATCTGCAAAGCAGCTCCAGAGTGACCCTTAGCTGGGACACCCTAATTTATTTTCTCTTCTTTTTCAG
>TTN-207,,0,2210,1512835,1515044,GTAAGCTCACACATTCACACTTTTGTTTTTTTTTCCTTTGCCTCCTCTCCAGTAAGTTAACGTTGCTGCAGGACTTGACGCCAAGTTTAAGCCCTGCTTTCACTTCGGAAAATTAGTCCAACACTATGGAAAGGTCATTTTAAGGGTATACCATTCACAGAGTACTGACAAAATCTGACAATATAATGGCTTGAAATGTTTTATTCATATTTATTATTCCACAAAGCAAAAATAATTAGTGTTGGATTAAAATTGCCGTTAGAATCCAGCAACTAAATAGGACCAAATTTAGTCATTCTATATTTGGGCTCAGCTGCAGAGCCAGACTGGAAGCCAAGAACTCAAGCCCAATAGAAGCCAGCCACAGAGCCATGGGGTAGGCAGTCTGGGCTGCCTGCTCTGGACACCTGAACTTCAGTTGGTTCACACGCAAAATAACAGTGCATCTAATTTTCCTCAGAGGCAGAGCTGTTCAGTAATTAACCAACTCCTCATTATTTTATTATTTTATTTTCAATCTTTATTGAGTGATTCTAATGAATTAAAAGACTTTCCAATCGTTTTGAAATGACAGAAAATAATATGCTTCTCGGGTGTCTCTATTTAAAAGGAAGCAAACACTAACCCTAGAATTTTATCTGAAAGGAAGTTCATCTCTTTTTTGCCTTCTTTTTCTTCCTCATAACTCAGTTTATGGATGGTTCAAAAAAATGCATGGTATCATCTTATGAAAAAATGGAGAGTAGTGTATGAACTATATTGTAAATAATTTTAAAATTAATCAATATTTTCTCTTTCTGTAGTATTGTAACGAGCCATGTAAGATGGATACGGATTAAAAAAAATCATGCTTAATTCTTAATTTAGTGCACTTCCATGGTTCATTGCCCACTTCTTTTTTAAAATTTTATGGCTTATAATAAAGATATAAAATAAAATTTCTTTTTTTCTCTTTTTTTCTATTATATGCACCAATCTTATTCATAACTGGATAATACTTTCTTTTACATTGTACAAATATCATATAATCATTGCTTATTTTCTATTGTACATATATAGACCAATGAAATTCCCTTTTCATTGGTCTATATATGTACAATAGAAAATAAGTCTTACCGACTTCCAAATAATTTACCTATTTATCTGGTAACACTCAGTAACTTCTGAACTGAGCAGAACACATATGACTTCAGTGGGAATTTGCCTCCTTGAGAAGTAGTGGAATCTGGCTACTTCATATCTTCTTGTTCCTTCAAACTATATGCAAATAAATTATTACAAAGACACTACTGAAAATATCCAATACCCATAAATCAGTCCAATAAACTATTTAATTGGCCATAGTGGGAGATGGGCTAATGTATAAACAACAAAATAGACTTTCTCTAGATTATCTTTACCTACCAGCGTAAGTAGATAGAGCATCAACCTTTATGCCAAGTGTGAAATAAATCATGCCCTGAATGTGCCTCGTACATTCTCAATGTACAGAGTTTTAATATATTTAAAACATCAAACCATGGACATGTAGTTCTTGGCTCTACAATTTATGGCAGATAAAGAGAATTTGGCTTTCTACCTGCAATTCCAATGATCCATGTTGTTCTGGAAGACTAGGTTTGGATTAGTCTCTTATGAGAAATTGCTTGTCCATGTTACAATGTTTTTACTGATTGCACTTGTGAAAGCAGAAGAGTCCAAGAAGACAGTGTCCCTGTAACCACAGAGGAGGGAGGAGGGCATGCCTCCTGGGCTTGTCAGGCAGAAACTGGAGATCAGTTTGCTGCTTTTGTTCTTCACTTGCTCTCAAAGAGGACAACAATCACTCTTTATTTCAAATTTTCCTTGGTTCTTCATTTTTATAAGTCCCTTTCATGATTTTAATGTTGTCTATTAAATTGCATCAGATAGAGCCCTAGGCAGGCAGGCAGGAGATGGAAATTCTAGTCCCCTCTGTGTCACTGCTAGCTGAAGGACCTTGGAAAAATCATTAGGCCTCTTTTGGTCTCAGTTTCCTCCCTTCCTGCCTTCCTAATGGTCTGCAGGTTTACACACTGATCATGCAACTGTAGGGTTTTCCCTATCATTAAGTGGCATTCCATGCTGGAAAGCTTTTACAGATTCGGACAAGGCAGTGAACATGATGGGACAGAGCAGAGGACTTTGTGGTGCCCATTCAAACATAAAGGTGAATTGTTCTTGCTCTTCAG
>TTN-207,,0,1455,1515045,1516499,GTAGGCTGCTGGGGACCTGCCAATCCTCTGCTCCCCCAGAGGACATCTCCAGCAAATTGGGAAAGGAGTCCAGAAAAAGCTATGGGCAGAGGTAGATGCAGCTCTTAAACTACAGAAGGGTCTACTGGAGGCTGAATTATTTATAACCAAGTTGTTTGCCTTTTGGAATTTAATTTTCCTCTAGAGTACATCGTAAAAGTGACTGAGAATCAGTTTCTCAATACACATATTAAACACTCAAAAGTATGTTAAGGAAATATTAAAAATCATGTTTCTCAGCAAGTAGAAAAGCTTGGAGCCTTGTTTATAAGTCCTTTAAGGAATAAGACATATTCTCCAGGGAAGTGTGAATCTCCAGGAATTCACACTTTAACAAGCATCCAGATAATTCTGATGCCGGTAGTCTACAGACCACCCATTTAAGAGGCATGTAAACATACCCAGAAGAAAATAAATGCTTGTTTATTATTCAAATGCATGACACTGTTTCCCCAGAAAACTTATCACCAATCTTAGTGGCCTCTGTTGTTTTTCTCTATCCTTTACTACCTAGTGAGACATTAGTATACAGAATATTGCATGCCTTTACATGTTTTATAACAATATCTTACATGAGCTACGTAAAGTTACATATGCTTATCCAATAAACTTTACCTTCAATGATGTTCAATTATAGGGCTATAATTGACCTAAGCAGAAACCACATCAAGTAACATCAGGTAGAACTTTAGCATGCACCCAGAAAATTCACAAATGGAAAATGCACAGGGTTGGCAGCACCTGCTGTTGTTTATTACTCAAAATCATGTCAAAGTTAATTCCACTCACTCCTCACACTTATAAAAAATTTCCTTCAACATAACCAAAAAAATCCCCTTTCTGTAACACAATTAAAATGAAGTAATGTTATTATTGGGATTAACGTTTTAAATGCAAGTAAATATTTGGGTTATTTGAATACCTATCAAGTTGGAGAAGGTTTAGAATTTTAAAAATTAAATTAAAAATGTAATGATTCTTTAAGTAACAGGTACACCCATCGTAGCAACCACTGGAATTCATTTTAATGCAACTTACTGGAATATGCAACATGGCTTTCACATATTAATAGAGCGCTAGATGTGAGGTAGAGGGGGAAGTACCAGAAAGATTCTCAAGAAATGTTATAACAAAATCTAGAGCTTTTATTTAAAACAAAGAAACAAAAGGTGGTGGCCTAAACTGCTCAGCAAAACAAAGCAAATAAAATAAAATATGGTGGTGAGAAAGCCTTCTGTAATCTCCTGGCTCCCATTCTTGCTGTCATTGCTGGGTGAGCTGGGTTCAAGGACATTCAAGGATGTTTAGATTGGCGAGTCATCACCTGGTTTTGGAATTGGAGCTGTGATTATTTAAAAATACCTTGTAGGGAGCACCCTGGCTCTCACTCTTGACTTTGTTCTCTTGTCCCCGCAG
>TTN-207,,0,484,1516500,1516983,GTACGTGCTGGAGGTTGAGGAACAGAGAGAAGGGGAGAGAGCTGGTTTGTGTCTAAATGGGGCCAAGCGTCCACTTGCCACCTCTCACAGCCCTGGGAAGAATGCTGTGAGCTGATATAAAAGCTGGCTTTTCGACACCCATGAAAAGTCCCTGAGATTCTAGTCAGGAGCGCAGAATAGAAGCAATCTGTGCTTATGAATCTCATTATAAACTGGAAAGGGTTTCAATTAAGTGATCTACATTTCCAAATTATTGGCAAATAATGAAATTTTAAAAAATCATTCTAAGTAAATTTTTATCTTGTAATGAACATTTTCTATTTTTAAACCTAATTTATATTCATGCAAAATCCAAAACTTTCTGCAATTTTCTCCATTGGGATATCCAGAAAATCTTTTTGACTTTGTAGTCAGAATTAACAGAATCTCTTTTAAAATGGGTCATTGTGCCCCCTCCCAAACATTCATCTTTCCCTTCCCACAG
>TTN-207,,0,93,1516984,1517076,GTATTTTTCTATACTGTTGGTTTTCAAGCCTTTCAGGCTGTTGCGTCCCCAGCTATTCCTCCTCAACGTGGGCTTTGTTTTAATCTTTTACAG
>TTN-207,,0,4234,1517077,1521310,GTAAAGCTGCCATAGAGAGAGCAGATTATTGCACATTTTGGAACTAGGTTTTGAAACGAGAAAGATTCCCTTGTCCCCCTCGCAGGGCATGCGACGCGGAGAGTGGTTCGCTTCTTCAGTGTCCCGCTGCTCAAACCTCTAGGGGAGCATACAAACGGGCAGGTTGTGGGGCTCCGTGTTCCTCTGGACATCCAGCCGCTTGTGTGTCTGCCTACTAGGGTCTCAGGGGTTTTTATAGGCATAGGGTGTGGGCGTGGCAGGTCAGGGTGATCTTGGGAAATGCAACATTTGGGCGGGAAGGCAGGAGTGTTTGTCCTCACCTAGGTCCATGGGCACAGGCCTCGCTAGGGACCACGCACTTCTCTTCCCAGCACTTCCCTGCCCTCCTCCCGTGTAAGTTTCATGCACTCAAAAATGTAGCAGGTGACAAAGGAGGTAAACCAAGAAGTTACTGAATATGATTTTCACAAATCCTCACTGTCCACAGGTAAATTGAAGACCCTTATAAACTTCTGAATTCTTATTTATATTTCATGTAATAAATATCTACTTTAGGGGCCAAAATATGGCACAGTGAAAGGAGAAGAGCACAGAAGTTAGAGTTCAAAGCCCTAAGGACAAATCAGCCTGATCACTTAACAGTTTGATTTAGGGCAATAAGTATAAATAATAAAATAATTGTTATTATATATGGATCACTTCCTCTATCAGATTGGAACTATACATACATTATCTCATTAAATGTTCACAACCTGTAAGAATTATTATCCTCAATGTTATTGATAGGTAACTGGAATTAAAGAAGTTAAGCAGTTTATTTAAGGTTTCAGTTGTGTCATCTGTAAATTAAAGAGAGTCACAATAAGAATGATCTCAAGCTGCATTTTGGGGCTTCAATGAGATAATTAGTTGAAAGTGCCTTGTAAATAGAAAATAATTATGCCAATATTCTTATATTCAGATGGTAAGTAAAACCTTTTAAATATTTTGCATATGCTTGTGTTATTTTATCTAGAAAATAAAATGGACTTCTATGCTTACTTAATATGGAAGTATTTTAGAAGGTGATCATGTATCATGATCAGGGCTCAGAAATTATATAATCAAGTGTAAATTGTCCACAACAGTTTTGAAAGTTTGGGATTTAGTTTATCATGATGAAACTTTTAATATGATGAAATGAAAAATGTACAAAATTTGAGCAAAGAAGTGTTTATTGATCAATTTAAATGAAATAAAAAACACATGGATGTTCCCTGCCAAGAAAATTTTTTATAAAAGAATAATAAGGAGATAGTTGACCTAAATAATATTCAAACATACTGTAAAGTTACTATAATCAGAACAGTATGGTATTGGTAAATGAATAGAAAAATACACCAGGGGAACAAAACAGAGAGTCCAGAAAGAGATCCAAGTATAATAGATCCAAGTATATAGGGAATTCAAAAAGCAAAGTGGCCTTTCAATTCAGGGGAGGGAGAGGTATTTTAATAAAGAATGCTGGTCCAATTAGCTATCCATCTGGAAGCAAACAAACATAAACCTCTGCCTCTCACTATTTACAGAATAAATTTCAGCTTGATTAAATAGTTAAAAAATGAAAAAAAAAGAGAAGACAATCTGCAAAAGCATTTATGGGTGAAAGCTTTTAAAAAGACAGTTACAGATTCAACTACATAAAAATCAACATGTATGTATGGCAAAAGCAAAAAGTCATTTCTAAACCAAACAGCACTTGTGAAAAAATTTTAAGACCTTTCTCCTCCTCAAGGTACTTCATTGCCTCTGCCATAAAAGTATCACAATAAACATAAAATGGCTACAAGGTAGACAACACCAGCCTAGAAACAGTATATAACATACAAAATTACGTAAGCTTATGCTGGATAAGACCCATAAACAAGCAAAATATTGAAATGGATTAAAAGAAATGGATCTGGGGGAATGTTTGCAACACTTACGACAAATAACCAATAAATGCACTAAATGCATTAAAAATCATCCACAAATTAATTTTTAAAGGAAAAAAATGCAACACAAAAAAAGACAAAAGATACAAAAAAGTATTTAACATAAGAGGCAATGTAAAAGTCCAATAAACATGTGAAAAAAAATGCTAGATGTTTTCCAATTTTTATTGTTTTAGCCACAAAAATGTAAAGATATTGGCAAACACTAACATGAAACCTTGAACAAAAAGCTTACTTTAAAAAACATGTCTAGCAGTCGAATAAAAAAAAATGTTCAGTCTCAGGCTAAATCCAAGTTTGCACACCATGAAATCACAACACAAGCCAAATGCAATTTCTTGAGGAGATAACAACCTAACTATATTTTAAAACCCAAGCCTAAGGGTCATTTAGAATCATGGAGTGTCCCTGATCCCATGGAGCATTTTGACCATCTTAGCAGTTTTGAAAGTTCATTAATAACCATCCAAATTGCCCCAAAATTTTGCTTTCCAATAATTAAGAAATAAAATGCCAATTTGCAGAGAAAATAATGGTTATCAAAGATAGACTGCTTCCTAAATATCTCATAGTTTAATCTTGATTTTTGTTGTAGAGTAAGGCAAACATATTTCATTGAATAAGGTGCATTGTATCTCGCTGTGACCAGGTGATTATTTTTTGTTGTAAGTACAGAAATAAGCACTCTCCTATAATGACCAAAATTACAATGATTTTCACAGTTATGGGCTTACCTGTGTCCTGCTGTTAATCAGTCATGTCATGCTAATCATGTCTTTAACTCTTTTTGAATTAAACCCATTTACTAAGTACAGCAAGAACAAGGCACAGGGTGAAACTTAAAAGCACATGTCTCTTTGCTTTTCTTCAGTTAGTGGAAACCACACATTATTCTAACTTGGTTTTTGTTATATTTCAAAGGCAGTCATGTTCAGAAAAGAGGCTTATTCCCTAGATTTCCCTTTAGTTTGATTACAACTTCATTTACAAAATGTAAATGGATTTTCACACAAAAAAAGCCATTCTTCGAGAAAATAAACATTTCTTCGTGAAACTGGTTAATGTTGTAATGTACTGTTAGGGTACTCTGTAAGTTAGAGAAAATATCAACTGTACCTTGAGCTTAATTAGAATAATCATTTCATGTATGATCAGTGTAAGCTAAATATCCTAGATAGTGACAAGATGCATTTATAAACATTTTCTTATATGCAGAATTAATAAAATGCAATGATAGGGCAATACTGCCACCTAGAGAGGAAAATGTAATAAGCCTTATTAAGAATTAAATCAGTTCTGAAAAAAATTTTACCTTACAATAGTTGGCCAATCCCCAGAATTATTGCTATAGATCAGAAATAGTCTTTTTTGGCCATCAGTGCTGGGATTTAGCACCCAAATTCTTCAACTGATGCTACTTGCACTTTGGATACACCTAAAAAGCAAACAATGAAAACTATTCTGGAAGAAGCAACTTTATCAATTTACCCAAAAATCACAGAATCATTAGTTTTTAAGTTAGTCAATTCCCACAATAACTCTAAAGATATTTAAAATAAGTCCAGAGTGCAATACAAGGGGGGCGAGTGTAAACAAATATGGAGGAAATTAAAAGTAGCTGTCCACAAACACTTCGGCTAAAGCAGCAATTTGCAAAGTGCACTGCACAACCTGTACCCAGCAACATGCTGCAGAAAGCTTCCTGAGGATGTGTCCCCCTGTCCTGGAAATTCACAAGGCATACTGACATAGTAAAGGCTGTGGGAAGTCCTGCAGGGGAAAAAAAAAAATGGCTTAAGCTGCTTAGTCAAGAGTGGCACAAGCATTTTGATTACAGAAACCTTTCTTCTTATAACACCTATTTGACATCCTCTAACCCCCCCAGAATTGGAATACAGAGATGAATTTGGAATACAGAGGTTGCTGGATTTGACATGTCTTTCCTTTGGCTGCATATTAAAGAAGTAGCTTTTTCTGTTGTGATTTTTTTTTTTTTTTAATGTGAGAAGGTGCAAGGCACAAAATCTCCAGCTTATTTGGAATTAAAGCTGATTCTCTTACAGGGTTACAGCAGATAAGAATAGGTTTATTGAGATTTAAAACAAATTACTTCCAAGTACATTATTTACCCTCTGAATGGGTTATGGAGGCACACATTTTAAAACTCTGCCTTAAAGCACTTCCAGCTTTTCATCTCATGATTCACATCCAGTTACCCCTCCTTGCTTTGACATTCTTGACCTCTGCCTTTTGGTTTTCAG
>TTN-207,,0,370,1521311,1521680,GTACTGTCAGAATGGTTTTGTTTTTCCTTATTTCACATTCTAGTTTCTCCAACTGGATTTCTGCCATGAAACTCAGTCTGTATAAATTGGAGGAAAAATGCATATGAACATAAAAATATAGCAGCAACTGAAGACCAAATTCAGTAGTCATGCTTTGTAAAACCATTTTTAATTAGGACAAAAGCTCCAATCTGTGAAGTTTCCATAATATACAGGTTTTAATGATACAGTCTCTGTATTTCTTGGCAATAATAAATGCTTATGTATGAGTGTATTTTGCTCTAGGTGGCTCAGTTTTCCAGTATGCTTTTTTATTTTCTACTGGGCATGTCATTTAAAAAAGTAATCTACTTGGTCATTTCTAATCTAG
>TTN-207,,0,857,1521681,1522537,GTACGTGCGAGGCTGCCATGGGGCACCCGCAGAGCCACGTCCTTCAGTGCACATTAACTCAACCACCATCCACTGAGCTTGGCATGCAGCTGTGCTCAATTCATTCTGAAGACAGCCTTGAGCCCAGCAGGGCCCAGACTTTTAGAACTTTCTGAGCAAAAGGTGGTCGGAGATGTCAAAGGTGTTGACAATGTGAGTATCACAAGAGCAGAGTAGGCCAGAAATACCTGGGCTATATGAGCAGGCAAAAGTCAACTATGGTATTCAAGGTAGGAAGGCAAAGAGTGGCCAGAGAAACAGAGACCAGTCAATTCCAGAGCTCAGTCACTGCACACACTGGATGTGGAAACTACTATTTCAGGGAAGGCATTACATTTCTCTAAGTTTCCCCAAAGGACTTTTGTTTTTACTTTTCTCAAAACAAACATGACACTTGATTCATAGCTGGAACAGTGTCATAAATCCAGGATAATGTCCCACCTCGCATTTGAATAGATTTTCTGTTACAGTTTAAAATCATTCCAGCTTTCCTCCTTATCCTCTTGTGTGACATTTATGTCTAAATCCTGACAGATTATTGTAACTTTTTTTTCTTTTCTGAGACAGAGTCTCGCTCTGTCACCCAGGCTAGAGTGCAGTGGCATGACCTCCGCTCACTGCAGCCTCCGCCTCCTGGGTTTAAGTGATTCTTGTGCCTCAGTCTCGTGAGTAGCTGGGATTACAGGTGTGCGCCACCACACCCAGCTAATTTTTGTATTTTTTAGTAGAGGATTTCACCATGTTGGCGAGGCTGGTCTTGAACTAATTTTTATGTAAGATGCATTAAGGTGTTTTCTTCCTTTCTCTATGAAAAGCAG
>TTN-207,,0,1206,1522538,1523743,GTGAAAATGGGTTTGTATTTTAAATTCACTGAGGTTCTTACAGGGGTCAACACAGATAATCACCTTTACCATGAAGAGTGTTGTTCCTTGGGCCACATGGTTGTTAGCATACTAATAAGATCCCCTTGTTGTATGTGTAAATTTCTGGGTACTGGATACCAAAGTTTGGTAGTGTCCCTGAATGCTCCCCTTGTGAGTATGAAAAAGAACTCTGTGAACATACACCAGGAGTAGAAACAGGGGTCTCATCACATTGATCTGGGGATGCACTAAGTATAAGACTATAGGGAGAGGACAGATGGCTAAAACCAGGAGGAAGAAATAGATGCTGAGGCAGGAATGGGGAAAAGTGGAGGAGACACTGAACTCACTTTGCTTTAGAAATCTTAGCAACTGCTTCCTGGCTCCTTCGGAAGACATTTGCACATGAGTTTGAAGTGGAATGGACAGCATGGCTTTAACAAGCCAAATGACCAGAAAAGGTGAAAAGGACAGCCCCATGGTTGGCGGCATTTGGGGACAGATTGGAAAATGCCAGTTAGTAGAGCTCTTGGCCAGTGGAACCAGTTGGCAGTTGGGTGGTTTGAGAAGATGAATTTCAAGTCCCTTTCAGCCTTGAGATCCTGTGTTTCAGTGATGAGATATTTGAGAATGGCAAAGAGGCAAATAGAGAAAACTGTCCCCCTACATACGCATATACCTTAGGTGCCCAGATGGAAACAGCATTCTTCACAGTATTTAGGAAAACTGACAAAACAAAAATATTGTATAAATGCAGATTATAAATTATCCATGCTTGATTTCTCACATGTAAAATAAAAAGATCAGACAAAATTACTTCTAAAGTCTTCCATTCTGATATATATTCTAAGATTACCTTTAGATGACAGAATTAGTACAGAATAATATTGCCATAGATCTATTTGTAAACATTGGAAGTCATTTTAAAGAAGACTACAATTCTGCTGTTCAAAACAAAGTGTTGAATTCAACTTTGTTTTCTCTAAGCAGCCTACATAATTTACAGTTTAAGGAGAGAAAGAGCATGATCTTATTTATGAACATGGGATTATTTATTTTATTTAGTGACATCTGCAGAAAAGGGATTTTACATCTTCAAATTCCTATGTTGTTATATTTAATAAACACCATATTATTTCATTGGGCATCAGGAAATAAAGTTTTTTCTTAAATCATTCTTTGCAG
>TTN-207,,0,1226,1523744,1524969,GTAAGTCTGATTTTCTAAATATTTTGTAGTTTGTTGACAATATCACATTACAGCCAGCTGCAGGTAGCTTATAGTCAAAACCCTTAAATGGAGAAGTCTTTGGTTGTATATTTTTTGTTATTGTTCCTCTATGTCTAGTATTGAAACTCAGGATGGAAATTATGTTCACATTGCACTATTTTCCACTCACTTGATCAGTTTTCAGGAGATTGTCTACAGAACAGTTTAGGGCACATCTATGAACTTTCTAGAACATACATAAATGGATGATAGATATCATGCCAGTCCAGTTACCCACCGGGACAGTTGGTTTCTTCGTGCATAGCCTAAGCCCTCAGTCACTTAGATTGTAATGCACAAACTTTACATGCACACACACATGCACACACACACACACACACACACACATATACACATACATCAGCCATAAACACCCCGAATAAATAGCAAGGGAAAGTGAGGATATGCCAGACATCGGAGAAAGCAAATACTTCCTCAAAAAAAAAAATTCCTTCAATTCACGGTTGATAAACAGTGACCTAGAAGCATTTGCTGCTGTTGTGCCGTAGAGCTGTGTGAGGACAATCTCAGTGTCACTAAAATCCACATCTCTCCCGTATGTGAAATCAAACCTTTAAGTGTCAGGAGAGAGGCATTTATCTTGAATTCTTCCATGTCAAAGAGGGCGCCTGTGCTCATCCTCCTTGAACTCAAGCTCTTTGCTGATCTTAGAGCTACTTTCTTTAAAGGTCCAGTTGAGAACCTTGTACACTTAAAAGGCTGACCAGAGGCTGCTGACTGAATTTCCCTCTCCTTACTGTGAGTGAGACATTTTGAAAGCAGCAAGAACCCTACTTAGGATAATCAAAGGCATAGAAATCCCCATTGCCATTGCAATGCTGGTGACTGGCAAGTTCAGCTGGCCTATGGTTTTCCAGCCACTTGTCAGCAGCCACCCACCGGGTTCCCTAACACGTTGACATGTCTCAAGATGAGATATGTTCAGTTCTAGGACAATTTGCTAAGGCGCATGTGGGCAGAAAAGAAGCCCATTCCTCAGGAAAGCAGTCTATGTATTAAGCACAAGTGTAGGCCCCTGAAATGGAAATCTGACATTTTATCGTTCACCACTAAGCATCCTGTATTTTCCTGAGTGTTTCAAGGATGTCTTCCCATTGCTTTTGTATCTTTTGAAACTCAAATCTTTATTTTACTCTAAACATCAG
>TTN-207,,0,592,1524970,1525561,GTGATGACTTCCTGCCAATGTGAAAGTCACTCTTGCACCATTTCATTTGCAAATCACCTACATTTTCATCATGGATCTTAATCATCACTTCTTCACTTCCACCTCTTCTTATAATGCAAATAGAAAATTTCTTTTCCCACACAGCTACCTTTCACTGTCAATTCATTCCTAACTTTCAGACTTTCTTTGGCTTGTTACTAATATAATATAATAATTCACTTTAATATCTTCCTATTGAAGCAGATGTCCGTAAACAAGTCAATTCATAATACAAAAAATTATGTGCTATTTACAGTGCTACTGAAATGTCTCAGAGATTGCAGTTTTAAAAAATGTGAAAAGTACAAAATAGCACTCATTAGTCTTTTATTGCTAATCACATTTTTTTCTTTTAAACTGGACTTATTGTTTTGATATTTTTGCCAGTGAAACAGTATGGATGATCAAAGTAACTCAAATGATATATTTTAGTGCAATTAAAATTTCCTTGAATAGGAAGAAATTTTGCCTCCTTTCTTTTTGACTTACGTTTCTTTTATTAAAGATTTATGGAATTTAATGACTATTTTCTTACTTTCTTTTGTATGATCAG
>TTN-207,,0,480,1525562,1526041,GTGAATACAGATATTTGAGCTGTGAAAAGTTCATCTTTAAACTAATTTCTAGTAAACTATTAACTACAATATGGTATGAATTATTAATCTGTATTTGCCTTTTAAAATCCCTAACTAAAAACAAAATGGTAAATATGAGACTGATTATCATTAATTTTATCTGCACATTTGATTTTCATCCATCTGTAACATTTATAATTCATTTTATTCACCATTATTCTTTGCATGAAGATTAGCATTTTTTAGCTTAATTTTTAAAAAGTGACACAGGGACTCATCTAGAGGTTTTTTAATAGCTAACATTTCTAAGTTTTGTGATTCTCAGTCAGTATATGTAGACATTGCCGGTGAAAGTTTATTTCTCTTGTGTATTTAACCCTGAATAACCATCTTGCATCCCCATGAGGAAGGGGGAAGGGTCATACTATGTGTGTTTGAAGCCCTGTTCAACTTAAATCTTGATTTTACTGTAATAATCAG
>TTN-207,,0,3218,1526042,1529259,GTGACTATTGTTGTTCCAAGTGTGAAATCCCCTATTATAATACATTAATACCACATATCATGTGAAATTCCTTATTGTAATACATTAATATCAAGTCTCTGAATTTCTTATGTATGAGTCACTATTAACCAAATTTATTTTTTAGACAATTAAATAATTGGAAACTAAAAAAATTTATTATTGTTAATATTACTACATATCCCTTTCTCCACTTATCTCTTCACCATTATTGTCAACATTTTATTAACATCTGGGAATCTTCCAGAAGTTGATTAAAATTGCATGCAGGCTAATTTTAAGAGGCCCATGAACATTTTTTAAAAACACGGAAGATGTATAAGTAAATGATGACTCTTACTCACTGTCAAGAAGATGTGTGTTTTGAAGGGTCATAAATTCAGTATATTATGTTATGGAGTATGACTTATTTCAGTAAATTACCCATAATTTTCTTTGTATGAAACTTTATCTTTTTTCCCTCCTGTAAATATCAGAGGAGAAGATAAGCTGAAAAAATTATAATGCATGCTGTAGCAGCTCCCACTAAAGCTAAACAAGATGCATATTAAAATCTAGAGAAGGAAGTATCCAAACAGAACAATTACACATAAGCCATGAAAAGATTACCGTATCTATTTGTAGCTATGAAATATCCATGAATTAAACTGTTTCCCATGACTCTGTCATTTACTCCAAATGAGCCATTTACCTAATTGTATTCTTTATTGCTAATATACCACTTGAAAATTAGCAACTAAAGTTTTTCCATTTCATTAGCAGGATGGCCTGAATCCTATTTGTATTTCCCTCAGTGTCATTTTCTGACTCTACATCTTTTTTTTCTAAGATATGATTTAAGATAAACTTTTTAAACCTTTACTCAAATCTAACATTTAATGGCATATCAGCCTTTCAGAAGTCTCATAAATGACAGAAATTCCACTATGCAACATACTTCATGAGTGATTAACTTTTTACTTTTGTTTCCATTCAAATTTTGTCATGAATTGACTATCTTGTTTTTGTTAAAAATTAGCTAAGGATGGAAGCTGAGAAAATGTTTATACCTGAAGTAGTAGTTACCACTGCAAAATCTGCTGAACCAGCCACACCGCCAATGACTAGAGAAGGATTCACTATTAAACAAAAACAAATACATCTTTTTCGAGAAGAGATGAAAACTGATGCTATGGAGGTGAAAAGTATTGTTTCATCCCATTTCATCATCAACTCTCATAACTTTTCATCCGTCGTGAATTGTGCTTCTAGTGTTCCATCTAATTGTTTAACTGATCAATAAAACAATAGAGATGGTTAGATTCAGTCCATCCTCCAGTTGAACAGTGAGCATTTCTAGTAGTGAAAAGTCAGACCAAATAATACTCTTCTTTATGTCTCCTAAATTTATTCTCAGCATTTAACTCGTATGAATTGGAGTATTCTAGTCCAATTTGTCTTCCTGCTTCTCTAGGTTACAAACATGTGAGAGATATCAAAGTCCACTAAGAAATAAAAGCGGTTACCAGCATACTCATTTGTAGTCCACCAATAAGTGTGTGTATATAAATCTGATATACAATAATTCAAGGAAAAAACAGACAGATGCTTCCTCAATTTAAAATATTTTACCATGATTAAGATTTTTCCATATGTTTAAAATCAAGAACAAAATTTAAATATTTCAGTTGTGTGATATTTAGTCATATGACAGTTTCTTTGACAGTTTCTTTTATCATTGTTAAAATAAAATTAAGACTTAAGCTGACTACTTCATAGCAGACTGGCTAAAAGGTTCAAATGAGATATAGTGGAAATGTGATCACACTACAATCAAAATAATATTTATTTATTTAGTGTTATCTGTCGAAGATGTTAACATTTTAAAATGTCTATACAATTAAAGTCAGCTCATTGCCAATATAGTTTTTAAAAAAGAAAAAAATAAATGGACAAACTTAACTCACCTAAGCCTCATGTGTATTTTATGTTTTTTTCTGAGATGATGCAATCTAAAGTGAAGATGGTATTTGCAGTCCTTCGAGGCAGATGAAATTGTTTGTGTCTTCCTAAAAGGAAGCCCTGGATAAAGCCCATGATCACTAAAGACCCAATTCCATCTCAGAAAAATCTCATTTATATCTTGAATGGTTCAGAGAATAATTTTTAAAGATATGCAGGTAGCATAGTTGAAGAATGTTTCTGATGCATTCTAGATTCTATTCACAGGTATAGAAAACTGAATATTAATAAAATTTTCCAATCTTACTTTTAAAATGCACTTTTAAAATGTACTTTTAAAATGAACATGGCTATGTGATTTTTGAGGTATGCTGTTTCCAAGTATCACATAGAATCATAATATCTAAGCCACATCAGCTAGTTTGCCTTCTTTAAAAGAGAACCTCCTCTGCAAATTGTATTTCCATTAATGTTCATCAGACTCAGAAACGAGAAAATAATATTTGTTTCATTCTTTGCTTTAACTCTCCATAATAATGAAAGTAAATTAAACTTCAATGTGAAAGGTTGTTCTCTTGAATCCAAACATGATAACACTTTCATTTTAATCACAATATTTTTATTTGCACGGGGTTCTCTTTGTCATCTGTGTGTTTTAAGAAAGGTATTTTCTGATAGATTAAACAATCTTACCCTTAGGGAATCATAAGTAAATTCATATGCTCACTCTGTGTTTGTGAGCTTTCATGTTATGTCCGATTTGCATGCAACCATATAACTCTGTAGTCACTGATTTTTCTGGACAGGATGATGACGGTATTTGAGTGCACTTATATCATCACTGTCACTGCATTAATACCAGACTAAATGGTCAACAAGATAATAAAAATAATCAGTGAAAAGAACCAGCTCCAAAATTCTGATTTTCCAATTGCTGATTGATTGTCTGCCTGGAAAAATTCTAGAAAATTTCAAAATCTTCTTGTGATTTTATGTTCATATTGTGATTGTCCTATGTTGTGTATATGTGATTTAATGTCTAGTATAATTAAGTAGGTGTACAGAGAGTATATCTAAATAGATGTCTGTACAATATAATAATCAATGAAATAGTCCCTAAAAGTGTTTCTGAGATACATTTCTAGACACGTTAACACTGCTGTATAATGTGGACGCCATCTGCCTGTCCTGATGCCCAGGAGATATTCCAGCCTGATCTCGATATTCCTATGTATTAATTCTGGAAACCTTGTCTCCAG
>TTN-207,,0,105,1529260,1529364,GTGAGTCTATACCTGCTGATTTTTCACCTTGTTCATGGTAAAGCAAGCCTCACTGCTGTGGTCATCTGGTGATCAATGGTATCACTGAGTTTCATTTCAATGCAG
>TTN-207,,0,1268,1529365,1530632,GTAAGAAGTTACAGAGCATGATACAGAAATGTTTAAAGGAAATAAGTATCTAACCTGTGAAACAGAGCATCTCTGGGGTAGGCCAATGGAGGATTCTTTTTTGGTGATGTGTGTGTGCGTGTGTTTGCATTCACAGTGGGCCCAGACACCCTAAAGATTTGGTTTCTGAAACTCGCCCAGGGGAGTGAGCCTAGAGTCACAAGTGGTTATCTTATACCTCTGAGGAGAGACAAATCCACACAGGCTTCTCTCTAGTTCACATTTCAGGGACAGCTCAAACTCAATTGTTTTGATTACTATTGTTCTAATGATTTTGTGAAAGGTAGTGTGTTACACAGCATAGTTTTACTTATGCTGTGAGACATTTCAGAGTAACTTAACTGTGAATGTGTTTCAATAATAAAGACAGACATTGAGAAATCATATATTTATATACTCAATATAGCAAGATGGAGAGGTGGTACTGTATGGTGGTCGGGTTGGATTGTGGAATCAAATAGCTCTGGATTAGTGCCCTATCTTCTCCCTTATAATCTCTGTCATCAGGAGAAAGTAAGCATACATGTAAAATGCAAGTAAAAAGGACATAAAAACCTGCAGTTGTCAGCATGTAATAAATCCTTGATATTAGTCACTATTGTTATTATACACATCCAAGAAATAGAACCCAAACCTTCTATGCCTTCAAAGAACTGTAAGTTACATATAATGCCTATATTTGATTTAGTCCCAAATTACAAAACAAATAACCATAGACCACAACAGAATAAAAGCAGTAAGGAAACCTTTAAAATATTTTTTCTGAATGTCTTCATGTTTACCTTTCACATAGATTTGTGGCTAAAACCCAAATGTACTATTGCAAAGTAGTTCTTAGGCATTTACCAACAATTTCAATAATTTCTTAATTTTGAATCTCCCACTGTGGTATTTTCAAAAGTGGCATTCATCGGAATGGTTAAGTGAAAATTCGTGACTAAGCTTTAGAAGATCCTGTCCTTTTATGATAAAAGCTGTAAAATAAGGAGTTCTGAATACAACTCTTTAAAAAAGATATTTTAAAATTTGTTTTACAAACTAACAGGCATGACAAGGAGCTTTATAATTGGCTTATCTCTAAATGACTTTTCATTAACTGTGTGATAATGAGTGCTAATGAGAACATTAAAGAACAGACCTTATAGAAAATAGGCTCAGACTCAGTCCAAGAGGGCTAGCCATCGGAGGATGGTTAAATGACTTTATTTTCTGACTCTGTTTCCATGTAG
>TTN-207,,0,284,1530633,1530916,GTTGGTCACTGGTTACCCGCTGTTACATGGTCCACTCCCATTGAGCAGGGCCAGGTGGTTGGCTAGTTTGTACTGAAAAGTAGCCAGTGGAGTCTTGCCTTTCTCCTTTGCCATACTAAGACTTGATTTTTATGGAGCATAGTATGGGTCAGAGATCATTTTCTCAAATTATTTTTATAATTATTTTTATATTTTTATAATTATATAATGTTGCATGAGCTAAGAGTTTATGAGATTTCCCTTAATTTCATGAGCATTTTGTAATATAATTTGTAAAAATCTAG
>TTN-207,,0,655,1530917,1531571,GTGAGTAAAGAAGTTGATAATGCTGGACCCTATTCATATCTCCTCAAATCATTTTAATACACGTTTGCAAAGATCAGTTTCTCAAATTAATACAAAAATGACATTAGTGAGCTTACAGATGCTCATTTTAAGACCGTATTTGGTCTGGAAGACCATATTTGACCATATTTGGCAAGGAAGAAGGGAATTCTATGTGGTACATCATTCATGGATTCAAAAGATTTAATGAGCTTCTAATATGCAGAAGGCATTATTGCAGGAGCTGTGCAGACATAAAGACCAATCCATCCCTCTTTGAAATATTTTCTTTGCCATCAGAGAAAATGTACACAAACAAGCATAATAAAATATATAAGGTGATAAACATCACAACAGAAGGAGAATCCATGGGAGGCATAGATTCATTCCAGTTGGTGATACCATGGCAAAGCTTTGTTGAATAGGTAGCATTTGCTATTGAGCCTTACAGCTCTTTACTAATATATTAGTATATTATATAAATATTAGTTTCTCTACTACTATTTCTGGAGTCCTGATTAAAAGGCCATTTTGTGGCAGTTGAAATGCATAAGTTCAAACTCTACATTTGTTACAAAACAGAAGTGATTAATGAATATGCACACGTATCATTATTTATTTTTTCTCCTCTCTTCAG
>TTN-207,,0,203,1531572,1531774,GTTAGTGGCCACCCTCCCACAGTCCTAATGCACATGCCATCACTTTCATCTGACACTCTTTTCCACAATATGGTTTCTGTGCACCTTGAAATGATGTCCCTTTTTGGAACTTGGGGGGAGATTATATGGTCAATTTAACTGTCAGTGCTAAGCAGGGGTCACTAAACATCTCATCTCAATGAGAAACTTTTGTCTTCTTTTAG
>TTN-207,,0,111,1531775,1531885,GTAAAATATTTTGCTAATTAGTAGCTGTTCTAGTACCATTTTGACTTTCAGCCCCACCAGTATTGGCAAATTGCAACCCGGAAGCTAATATGAGGGGAATTCTCTTTCCAG
>TTN-207,,0,948,1531886,1532833,GTATTTTGATGGCTGAATATAGAGTTCTCTGTGACTTGTATAATACGTGCATGAAGCCTAGAGTAGAATTTACTCACCCCACCGACCCTGAGCATAGGCTCTTTCATTGTGGAGCCTTCTTAGTTTGTTTTGAGGTATTTTTACATTTTTTTTGTGCAAAGTCTTCCTAAGAAATAAAGCTATGTGACAAAAGTGGATGGAAGATATATTTCTTTACATTATAGTTTAATTCATTGAGTTTGTGAAAGTAGAGAAAATATGGATTTTCACACAAACACACCCACACACACACACACACACACACACTTCCAGAAAAGATTTGAGACAATTTTCAATAAAAACATGTAATAACTAAGTGACTAAAAGATAGAAGAATAGCCATGTAATGAAGAAGAAAGCTAGTTATGCACAAAAATCTATGCTAGTAATTTTTCTTCAATTCAATATAAAATTTAGCTCTGAATATTTTGCAATTTAAGATAAAAAGAGCAACCTGGTAATCTAAAAATGTAGGTGCCGTACCTTCATAATAATAAATATAATGTACCAGAGAGTTAATACTGAAATATTTGAAGGAATTTATTGTTTTAATTATTCATTTGATCTCTGAATGAAATAATGAGAAAAATAACGAACAAAGAGAAAATACCTGTTGTTTAAGTGACCTGATCATTTGCTAACATAAACACTGAAAACCACTTAATTTCATGACTGATTCTAGCAATAAATATTCTTTAAAATGAATATTTTAACTTATTTGGCCCTAATTACTCATGTTCTTGCATTTTTCTCAATTTTCAGCAATCTTATAATCTATTGTGGAGCTTAGTCATATGTTTAGGGTCATTGAATTTTATACCACAGATCCACTCACAGATAAGTCCAATTATTTTACCCACAGAAGAGTTGTTGATAACTGATTTTTAAATTTTGTACATTTACATAAAG
>TTN-207,,0,915,1532834,1533748,GTAAGTGCAACTCCAGTTTCTATGTGCATGATAAGAACTGAAATACAAGGAGATAGCAGTGCTGTCCGTTTGCTGAAAAACCTGTTGCCACTTACTGGTTCTGATACTTTGCCCCAGTGTCTTTGCCTCAGTTGTATGGAAAATGTTTTAGACCACATGGCCTCAAAAACTATACTGTCATTAAACTTCTGAGGTTCTAGCAATAGTTTCTTTTTGTTGTATTTGTTTCTAGGCATATCATGCCTCTGAAAATGCAGAGATTCTAAATCCGGTTGCCTTCCAGGCCCAGGCAGGTAACAGTGAGCTCAATGAAAACAGTAGCAAACTGGAGAGTAGGTGCCCTGCCTCAAAGAGACAGTAGCTGTGTTGTTGCCAGGCATGCACCAGGCTGTTACCAGGCTCAGTGTTGCTAGAGCTCCTGATATCTTAAAGAAAACCTGGAAGTCAGGATTTTCAATGTTTATAACTTGAAAACAAATGTAACAGCTTTCATGCTAGACTGTTCACATTTACAGTGAACTGGCTCACACTCTGTTTCACTTGACCTACACAGTATCCCTTAGAGGAAATTACAATATTATCTTCATTTAGCAGATAAAGCACTCAATATTCAGGAAGGTAAATGAATTGTTAAAAGACACACAGCAAATTAGGAAGTCCTCCGTGGTAGATCCCCCCAAAACTGACTGCTAATATAAAATTCTTTCTACAATTGTAATGGCTGGTTGGATTTGTTAGTGTTAGTTTGGTTTCCAAATTCCATCTAGAAAATATTGAGCACTTCAATAGTAGATATTTGGAAAATTTGGTTTTTGGTTATCAACTTTCCCCAGTGTAGAGTTTACCTGAATGCATAGTGGTATGACTGTTTTCTAATAAGAGCATTAAAAATTAACTGATGTTCTTAACTCTTAG
>TTN-207,,0,537,1533749,1534285,GTGAGTATAAAAGTAATGACCAACCAAACAATTTCATAAATTATACTTTCCTTTTTTTATTTGATATTTTCATTTTCAAGTGATGAGCTCGGGGTTAGACAGCTATTAGAAGGTCCAAGTTCACTGTTGCTAAGTTTCCTTAATCTTCATGGTATGTTGCACCTGTGAGTTTAGAAATAGAGATTACATATAGGCCATAAATGTGACTTTAAAAATAGGGCTTATAATATATTAAGGAAAACACCAATATTAGCACAGCTGAGTTCATTCATGCCAAGATCTCTTCATCTGTGTGATAAGCTAATGTAACCTCTAACCCAAATCTAACTCCTGCTTTTGGAATACCTTTCTACCCAAGATGCCACAACATTCACTGGGAAAGATGACCATAATGCAGATTAAAACAAACAAACCAAAAAGTCCTCTAGATTCTTCTCCCAGCTAAAAACTTCAACAGTCTAGCTCAGATACATCTCCTTAAATAATTTATATCAGTAAGGATATGTATTTTTAACAGACCATAATCTTTTTGCATAG
>TTN-207,,0,110,1534286,1534395,GTAAAATATAAACATTTATCATAGCTCCTTGCCACAGTAAAGATACAAATTGGTTAAAATATAACTATTTGATGTAAATTTTATTCATACATGCATGGTATTCTTTGCAG
>TTN-207,,0,898,1534396,1535293,GTAAGACTTGTAATAATTTGGGTTATTTAGTATGTAAATTGTTTTCAAAACATCAAATAGTAGCAAATTGCTATTGTGTAAGAAGAAAATCGAGGGCTAAAATGGCACAGAAACTTACCATTGGCAACACCAACAATTGCCAGAAGTTTTTATTTCTTGCCCCTGTGTAAGATGAGCAAAGAATTTTCATCAGTGTAACATACTGTTTATTTTCCTAGTGCTATAGCTAATATCACAATAGCTCTTATTTGACACCTGATTTTTACATATGTAAATTTATACAACAGCCCTGCAATAAAAAGATGACTATTATTGGTTTGGAAATAGGAACACTGAGGCCCTGGGAATCTATGAAAATTGTCTTAATTCATCCAGCCTGTAAGCGGTGGTGCCAGCATTCAAACTCCAAGTCAGTCTGGCTGCAATGTGTAGATGGAGTCTTGTTTTGCTTTGTTTTGTTTCCAAATTCATTTCTATGTTTTCCTCCTCTGAGATAAAGAATGTGTATTTTTTATTTTTCCATAAATGTATTCATTGGTTTACTTATCCAACCAACATTTATTAGGATGTTTTAGTAGTTAAATCAAAAAAGTCTAGTGACTGATTAAATCCAAGTGGTAAGGAAAAGAGAGTATTGAGGATTATTCCAAGATTTTTGAGCCTGGGTACCTGGATATACTGAATGACTACCAGCTAAAATTGAGAATATAGGAAAAACATAGTTGTGGGGGCAACAATAATATATTCTATTTTAGATCTGAATGAGTTTGAGGTGCCTTCTAATACGTGCAAGAAGTAAATTCTAAAATAACATGAATAATGAATAAGACAAAATGAAGTTTGTTTTGCTGAGTTTTCTTTATGCCTCACGAAAGTATTGTGTGTCTTTGTTTTGCAG
>TTN-207,,0,119,1535294,1535412,GTAAGCGTGATAAGTTTTTGCTCATGAATCATAAAAACACAAAAACAAGCTTATGTATGCATCTAACAATTTTTAAAAACTATTTTAAAATCTACTTTCTTTTAAACATATTTTCACAG
>TTN-207,,0,102,1535413,1535514,GTAAAATGAGATAAAATAAAAATAAATGAATTTTCTTATCACTTGGGTTATAAACAGGTATTTCAGCCTTACTCCCTCTAAATCATGACCTTTCTCTTTCAG
>TTN-207,,0,99,1535515,1535613,GTAAGTATGGAAATAATAAAGCTAAGCTCATTATACAAATCCAATAACCAGGGAAGCTATACCACTATATTGATTATTCCCTCCCCCAACTTTTTATAG
>TTN-207,,0,153,1535614,1535766,GTAATTTGCATGTCTTTCCTTTGATGGACCTGTCTTTGTATTCAAGAATATCCATGAGTGTGTTTACTTTTATTTTCTTTCCCCATTCCTCAGGTTGAGAATTTAATTTAATATAATGTGCTCTCCCCTTTTTCCCCCACCTTTTTCTTGTAG
>TTN-207,,0,447,1535767,1536213,GTATTCAACAACGAAGGATTTCATTGTTTACCTAAGCTCTAAAGTCACCCTTAGCATGTGGTAAAATTAGCTATGCAATTTTTCTTTCATGAAACAATTATTTGGAAATTGACTATAAGTTTCATAGCCAGAATCATAAATTTATGTTCGTAATTAAGAATGTTAACAATTTGACCATTTGGATTTTTTAAAGTAGTATTATCTTGATTTTTAGCTTTTAAGTTTTTTATTGAAGCATAATTCTTTACTTTCAAAAATATTTAAAAATTAAAATAAAATAACTGCTTCTTATTGAAAATTTATCTCTCAGCCCATCAGCGGGTAGATATTAAGAATACACCTGATAGTATGGGGGAGATAAAAGACATACAAGACATCATCTCTATCCTAAGTCTAGATGCATACCTCTCCAAAAAAATTGATTTATCTTTCTGTTATACACTTCAG
>TTN-207,,0,96,1536214,1536309,GTAAGTCCTCCCATTCCTGTCAGCCTGCAGTGAGCATCATTATGGTTTATTGATAAAAAATGATCATAACATTCTTTTTCTCCCCATATTTCACAG
>TTN-207,,0,112,1536310,1536421,GTGAGTCCTAATTATAAAATTTTATGTTTACACTATTAAGCAACATAAAGAACTTCAAGGAGCAGACAATTTCAACAAAATTCATTCATCTTGTGTGTGTATGATTTTGCAG
>TTN-207,,0,92,1536422,1536513,GTAAGGATTATTCTACCTATCTAATAATTACTTTAAGCATTCTACTTTCCCAGTGTAACAATAACCAAGAGATTATTTTATTTTTTCCCCAG
>TTN-207,,0,1637,1536514,1538150,GTTGGTATATTTATTAACCTAAATTCTTACGAGGAGTGATTGTTATTTTAAGAAATTATTATTCATTTCCCCCAAAATTCCTTTCAGTTTCCCACTTCCATGCCTCTGCTTATGCTGTTCCCAAAGCCAATAGTACTTGCAACACCATTCCCACCAGCCTAAATTACAAATGTTCTTCTAGGCCTACCTCAAACGTCACCTTCTCCATTAAACCTTCCTTAATCTCTCCATTTGTATATGATCTCTTCCTCATCCAACCCCAGGATCACTTTATATGTGCCTCTTTCCTAGTGTTTATTATGCACTTGTCTTATTCCCCATTTCCTCTTTCAATATCAGTGTATAAACTCCTGAAATCTGGAATTCTATTTGTATATTCCAATATATTGCAAATGACAGATAATCAATTGGTGTTTGCTGTATTGAGCTTTATTTAAACTTCCTTACTCTAAAGAATTATTTCCTTTTTTAGCCATTCTTGCTTCTTTAGCCTTTGTGCCTTTTATTTTCTTCCTACTTTTTAATGAAATCAATAAATATTTTCAAAATACAGCTTAATGTAACTGTATTTCTTATGATATCATGTAGAAATAAGACCATCATTCAGTAGAATTTCTTAGCTTTACAATGAAGAATAAAAAATGTAAATCAATTGCCAGAAAAAACTAGAAGTCATCATTAATTTGTTTGGTTCATTACAGTTTAAATTTTGAGGAGTTGAGATGTTACATTCAGATCGTGTTGTCCATTACATCTAGTATTGAAGCAAGTCATATGGTAATGATTTGTCTTATTTGGTATGAAAGTTTCATGGTTTATACTTACTTACGTTATAAGATTTCTTCAGAGATCGGACCATGAAAAGACTTGTAAAACAAAATTTCAGATTCAGCATTTTTATACATTTAATATAAATTACATGTTTTAAATGTGTGGAAACAGGAATAAACTATGAACTCCTCTGTGATTTCACCCAGTGTTTTTAAAGTACCTACCATTGGTCAGACACTTGTAGAAACTCAGGACACAAAACTAAATAAGAAATGATTTTTTTCTTGAGAAATTCATAATTTAGAGAGGACAGATACATAAGCAACTAGCTTGTTAAAGCAGTAATTATTTCTGCTAATGGATGATAAGAGTGGAGGCAATGGGGTGAAACTTCATAGAATGGGCGACATTTGCCAACACAGTGATTTTTAATATATAGAAATCCTCAATGTAGTAGAAACATTGATGACTCGTACATTTTGTTTAGCAAATTTTTATGTAGTCAAAATATCAGATTCCCAGGAAATAATCATTAAAAGACCAAGTAAAATGCTTTTGAAGAAGAAGGAATTGGGTTAGAGACTATCCTGGTGGTATACTGTTCTAAGAATTTCCTATTAATTCAACAGTTATTTTTTCTTCACAAAACTTTTCTGATTCCAGTATTTCTCCTAATTATCAGTTATGCATACTTAGAATAAGGGATTTCTTTGGTACCTTCTCAATATGGGTAAAAACAATCATAGACATTTCATGATTTCAAAATCATGTTCTTAAATTTGATATTTTATATTTACTTCTGCAAAGATTTTCCCATTGTGTGAATATGTTTAAAGGACTCATACTGTACATCTCTTGTTCCAAAG
>TTN-207,,0,535,1538151,1538685,GCAAGTAACATAGGATTTGTCCTTTTCAAATCATATTACAATCTTGATCGTTATCGTTTTAAAAGACAAACGATATGGCCATTTTGGATACCATAAATTTTCATTTCATAAAGTCATTCTAGATCCTCTAAACCTTCCTGAGACACATTCCACAAGGTACAAAATTGCTTATCAAATGCGTTTATGCAAAAAAGCCATTTCTTAGGTTAAAGCTCTGTGAAACAGCTAAATCAGACACTGATTCTCCATTCGTCTTTCACCCTTCTCCAATCAGTCTATTATGCTGCTAATACATAGCTATGCAAACTTCATACTACTAAAGCATAGAAAAATCATTTCACGATGTACATGTCCAGTTGGATCCCAGGTTCCCCTAAATAATCTCAGGTGTTTTTTAAAACAGAGGTGCTGCATAACTGTAAAATGTTTGGTAGCCATTCTTTTGCAGGGTGAGTAAGCAATGATCTTGTTCAGGACTTCTTTTCCTTGATGATGTCATCTATATTTTCTAACCCAATCATAAATTTGTCTTTAG
>TTN-207,,0,91,1538686,1538776,GTAAGTTGATTTAGAAACACTTTTCAAGCAGTCAGCCCATGGTTACCATTAAGTTAACCCTATCACTGAATTGCTCCAATTTTCCTCTTAG
>TTN-207,,0,120,1538777,1538896,GTAAGTATCAGGCAGCCCCCTACAGCCCTTTCCTTAATGAACCCCATGTATCTATTTGTTTGGTTTCATCTACTTTTTAAACAAATTGTATTAACTGAAGTGCTCTTTGATTTTACCAAG
>TTN-207,,0,745,1538897,1539641,GTAAGTTAAAAAATATATATATATATATACACATATATATAAAATATCAAATATTCAGTAGATTCATTGATATTCTATATCCTACACTTTGCTGACCACTCAAAAATCCTTGATTGGGTGGGCAGGGTGGCTCAAGCCTGTAATCCCAGCACTTTGGGAGGCCAAGGCAGGAGAATCACTTGAGATCAAGATTTTGAGACCAGGCTGGGAAATACAATGAGATCCTGCCTCTAGCAAAGACAAAAGGAAAAAAAAAAATTAGCTGGGCATGGTGGCACACACTTGTAGTCCCAGCTACTCAGGAGGCTGAGGTGGGAAGATCGCTTGGGCCCAGAAGGCCAAGGCTGCAGTGAGCCACAATCACGGCACTGCACTGCAGCCTGGGCGACAAAGTGAGAACCTGCCTCAAAAAATAAAGAAAAAAAATTGTTAATTGAAACATCTAGTATGTGGTTACACTGAGTAAAGCACTAGTATCTCCACCTGGATAAAATGTTCCAGTTAGAGTAGCATTGAAAGGCTACCTGGAAAGATGCCTCAGTGTCTATCACTTGATCTTTCTGTTCCTCTGTGAGTTGGCACTGTCCTGTATAGTACATGGAAGGTATCAAAGCTTATATCTCTAAACTGTAATCTCCTCAACAGACGCACTAAAAACATTCCAAATTTTTATTCTGCACCTGTTATAACCCACATCATATTTACGTAAAGTCTCCTTGGGTGTTTTTTCTTTTCTCCTTTGCAG
>TTN-207,,0,517,1539642,1540158,GTATGGTTTCATACATATTAGATCCATAGAAAAAATGTCATACATGCTTTATAAAATTTAGTGTATCAATTAATGAATGGATAAATAAAATGTGGGATAGCCATACGATGGGATATCATTCAGCAATAAAAAGGAAGCACTACGATATGCTACAACATGGATGAACCTTTAAAACTTTATGCTAAGTGAAAGAAGCCAGAGACCATACAAAGACCACATATTGTATGATTCCATTTATATGAAATGTCCAAGATACACAAATCTATAGAGATGTAGATTGGTGGTTGCTTAGGTCTACAGGGGAGACAATAGAAAAGTCCTTGGGGTGATGGCTAAGGGTTACATGATTTCTTCTTGGGGAATGAGAATGTTCTAAAATTATGGTGATGGCTACACAATGATGAATACATGGAAATTCATTGAATTGTATACTTTAAATTGGTGGATTGTACAGTATGTGAATTATATCTCAATAAAGCTGTTAAAAATGTTAATTTTTCTACATGCTATTTTCCAG
>TTN-207,,0,89,1540159,1540247,GTCAGTTGTTTTGTCTTGCTACATTCCAGTAATTCCCAGTTTCCTCTGAATCACCATACGGTAAACTCGAATTTCCATTTCATCCATAG
>TTN-207,,0,1146,1540248,1541393,GTATTGTCTACATACTAAATGTTTTGAAAAATCATCAGTAGTCCATAATCTATCATTTTATATTTTAATGTTTCCCTTTTACATTTTCTAACCACCATCCTTTAAAGAATTAAATCAGCTCATTCTTACTTGGCTTAGACTCTCTTATGCTGACCTCAATTTAGTCACAGTTTCCACTCAGGGAATAAGGGTGTCCCTAGCAGCTGTCTAAATACGTTAATTAAAGCAGCTGTAGAAATTTCACTGTCTAATAAATGGCTGCTTGCCAAGCAGCACCAACCAGAAAAGAATTAAAATGTAAATCGTGAGGTTCACACATCAATTAGAATTAAGGAAATTTAGAACAAGGTGATATTTTCTCAGAAGGTTTCTATCTGTGGAGAGGCAAGTGTCAAGGAACTTAGTGGCTAGAAATACTTTCTGTGAAGTCTAAGAGAAAGCCCTGTCCAAGCCGTGCTGGGTTCCTGGCAAGGATGCTGGGCACTCTTGCTGTCGGCTGCATTTACAGAGCTTGTCCTCATAAGTGTCCACCATCCCAAATGATATAATGGAGGAAACATGTCTAGAGAAATACCAGTTGAGTTCAGCTTTATCATATTGCTCATCCAAAGAAAACCAGGCTTTACAGACTGTGGACTATAATGAAAAAGGCTTCAATGAGGACTCAGATAACCTGGAGATGTCTTCCATCATTTATTTGCCAATTCTGAACCTCAGTGTTCTCACTCTTAAAATGAGGATAATAATTCCTACCTAGCCCACAAAGTTATTATTCATATAAAATGAAATCAAATTAAGTAATAACTTTTTAGACAATAAAAAGCCCCCAAAGGTAAAGCATCATTATATCCCTTATTAGTAAATAAGAAGCAAACATTTAAGGATGAAATAATTGTCTCTTTGGGGCAGCTCCTTTCCTCCATGCAGCTGTAAACACAATTCTCTACAAGAGAAGTTTATGTACCATTTGTCCAATACTAGGCAGGAAAAATTAGAGAGTGCTATAATCAGCCAACTTATTACATTATAATATATTGGTTTCACATGCCATTCATTGACCAGTTTTAGAAATTGATTAACTGGGAGGAAACCAGAGCTTCAAGTTTTTGTTGTTGTTGTTGTTTTTTTATGTTGTTCCATCAACAG
>TTN-207,,0,1569,1541394,1542962,GTATGTAGGGACAGATTTCAGCATATTTTGTGGATCCATCAGAAATAATCCTCCTGTTTAAGTCACTAAATTCTTGTAACTTGAAGGAAATTTCTAAAGAACCTATGGTATTCATGTGGTTCCAGCTACATTTTTTTTCACATTATATCTATGGAAAAGGGAGGGCAGCTGTTAAAAGACCTATTGAGAAGTTATTTTCAGAAAGCACCTGATGGCCAGATCCTCATCTGGTTGCTCAAAACTATTGAACACCCATTGGGTGTCCATTTTCATATACCCCAGATGAGCTTCTAGATTCGCTGTTAAACTATTTTAGTTCTCTGCCCTCTGCCTGAACTGCTCAAGTCCTAGCAGCACTACCAAGTGAAAGGGGTGTTTCCAGCCTCTGATATGGAGTGCCTGGGAGAACTCAAAAGTCCTCTTTGAGACCCTGGAAGGCCTAGAGAGCCTCAGGCAATGTGGAACTCGATCCTCTCTACCCCAAGCTCTAAGAACAGGGGCTCTTACTTTGGACAGGGAATTCCACATGCTACCAAGCACTCCTGAGGAGCCTCTGAGCAGTCCCCAGGGAAGTGCTGTTAAACCTCTGCTCTCCTCATTAGAAATCTTAAGGCTGAATCTCAAGCTGACCTTGTTTTGAGTCTAACCTAGATGCAAGAGAAAAATGGAACCTCCCTTCCTATTCTCATCCTAGGCCATATCTCTTTGAATAAAATACCCCTGAGGCAGATGCAGGAACTCCAGGGGTAATCTCAAGATTCACAAAGATGAACCATATCGCCAGCATTCCCTAGGTTCCTAGAAGACCAAATGGTCATGGCATCCAGTTCTTATTATCTCTGTATTAGTAGTGGAGAAACTGAGGCACAGAAAAGTAAAGATCTTTTCTATGATAGTGTCAGAAACCAGCCTCACAGAAGTCATTTCTTCTAATTTCTGGGTTCCATGAACTAACCAGGTCCCCTCACTCATCACAGCACTGAGAATATGCTTTAGTTAGCAAAACAGGAAAGCTGAATTTGTTAAGTCTACCTAATGGCATTTAACTAGATCTGAAATAGTGTTAATTCAGTCATTCATTCAATACTTACTGATTGCATTTTACTGGCACTGGTACATAACAAAATGACTATGACATAAACACAAATACTTGCAAAACAAACAAACTGGAATGATATGAGCCTCTTCACCACATGATTTGTCCAAATGAATTTTAAAAATAGGTAGCACACGGAAGTTATTGTATAATTCATTCAGGTGTCCATCGCTAAGCCCCCACCACAAACAGAAACTGGGATAATCAGGTTAACTCGGCACTCTCAGCATGCCCCCCAAATATCAAAAATATCTTTCTGAAGCTATTCCCTCTGCATGTGGACAAATTCCAAGTGCTTTCTTCATTCTTAGCACAAAGAATGTTCTAATATTCTGAGGCAAGTAAAAATACCACAATTCCAAAATTTTGTCTCTGGATGTATAACTAGCCAGCAACAAATTAATGTAGAGTTTTGCATGCTCTCTTGTGTTTTTACACTTTTTCATGGGCTATTTGTCAACATTTACTCCTAG
>TTN-207,,0,224,1542963,1543186,GTAGGAATGCCTCGCTACTTCCAGCTGAAAATAAAACCTAAGAAGCAGGCTTTTGTCCTTTCCCAGTGCATTTAAAAATACAATTTGGAGCTCATAAAAGTAGATTGCTACCCAACTTTGAAAGCACTCTGCAGTGAAATAAATTAAGATAAACCTACATGCTCCCTTCTGTGAGGTCTCTATGGTGACTTAATCATGACAAATCTTGTGGTTTCTTTCTTTAG
>TTN-207,,0,5004,1543187,1548190,GTAGGTTTAAGAACAAAAGGTGTCATTGCCAATACTTACAAATAATTACATGGGAAAAACATTCTGTCAGCTTCTCCTCCATCACAAACATCTCTCATGCATAATTTGAAGCTTAATGGAAATCTAACAGAAAACTTATTTCAATTATTAAATTAAGAATTAGATAAGTGTTTTTCACTATTTTGTGCCCTTAATAATGGTTGTTTATGTTATGTTATGTGTTCTTTATCACAATAAAAAAATTAGTGTTTTTCACTAATATTAAAAAAGGTCATGTTCCCTTTATGATTGTAGCTGCACTTTAATTTCTTCATTGATAAAATACAATGACAAAACTAAAATTATTAGATTATAATAGCATCTACATATAATTCAAAAGAATAATACATTTATATAAGACATTATTCAGTCTATGGACAATGCTTGTGTGAAAGGTATCCTTTGGAAGACAATATCCTATAGTGGTCAAAAGTCGGGGCTTCATTGTCAAAGATGCTGAATTTGAATCTTGCCTTCAATATATATCATGTCTCTCGTTCTCCTTCTGTCATGAATACATTGAGTATATGATTGCATTCAATCCTAGAAAATATATTTTATGAGGCTAGGAATTCCGTTTTAGTGCCTAGAATTTGGCATCTGAAAAATAGTACCTGCTAGAAGGTAAGCTCTATGAAAACAAGAGTGGATGGTTGCCCCAGAATATCACCTGATACATAGTAGATACTCCATAAGTAATTGTTGACTGGACTAATTAATGATGGTTAAATGACTGTTACCAAACACTTAAGATTATTATCAAGATTAAGTTAGGTAACTCAAGTCAGCACATAGCACAGTGCTCATCATACAGTAATCAATCAGAGTTAGCTGCTACCATTTTTAATTGGGGCATGCTTCTCAAGTACCACCAGCCAATTTCCTCATCCCAGGAATCTGATCTTGGTAGAATGAGACAATATATGTGGAACCACTTCAAGTCATAACTGATTGTCTATAATCACAATTATTTGAGAGTTTCCCAGCCAAAGGGAAACTCTCAAAGCTTGGGCATCTCCCAGCCCTCTTATTAGGCTGATGCAAAAGTAATTGCAAAGTTGTATTGTTTTGTTTATTATGCTTCTCCCATTAGTTTATAATCCAATCTCTACCTTGTCAAGATTTATTTTTCTCAACAGGTTAGTACTTCAGTTGGTCTTCTGACCCAATTATTTCCTCCTCAGGAATGGAGATGGTGATCTAGAAATCTAATAGACCTATTTGATTTTATGAGCATAATTAAAAGATATAATGTATGTAAAGCACCTATAGGCATGGCTGCCAGGTAACTGGGGCTCAATACATTCATTTTATTATAGCCATAGAGAGGAATTATATAAACATCAATGTTTAGTATTGTATGGCCAGTATGGACAAATACCATAGACTGTATATTTGAGGGATAGTGTTCAAGAAATGCTAAATATTAATAAATGAGGACTGATTTGATAATATCCTACTAACACAATAATACAAAATATATTTTAAAAGCAAGTTCATTAAAGCTACACTAAATAATTTATCCATTTATTTAATTTTTAGAGGAATTTTTTAATATAAACATATATGTACATCATTCAAAGTAGTAATATTTGTCTTAACTATATTGGTATAGTGCTTTTAAGTCTATAACATATTAACATATGGTAGTATTGCCTTTAAAGTGTTGTAGAAATACACCTGAAGCACTCTACAAGACACCAATTGGGGTAGAAAGAGAAAAATTTCACTATCTTTTCTGCATAACCAATGTCTTTAAAAAGGTTTGAATAGGCTTTGTAAACTGAGAAGATCATTAACTTCCTATGTGTGGTAATATCTGTACACATATAGTGGTTTTAGCATCCTCTTATAAATTTGTTTTCTATATGAAAGAAATTAAATTCATTAAATAGAATGACCCTTCAAAAACTTGCCAACTCACATAGTTTCATACCACTGGGACTAAAAATATTTACAGAACTTCCTCTGGCCAGGTATTGCCTTAAGTAAGTGTAGCCCTGCTTTCCACAAATTGGAAAGAAATTGGGAGTCTTCAGAAGCTCCCATGTTCTTGGGGGTTGTAATACTTTCTGAAGCATGAAACGTGGCCCTGAGCAACCAGGTGCTGTTTCTAACAGCGAAAATGTTACCTATTGAAGGTCTCCAGTGCCACCTACTGGTAGAGGAGTAATTTGGAAAAGCAGAATCTTAAAATGTAAAAAAGCTATTTTTTTGCTGTTTATTCTACAGATGATGAGTCAGTGTCATTTGGAGGCTTACAGAGTGACAGCTAGCTAAACAGAAATGATGAATAATTAGTTTAACAATGATATTGTCTGTTATTCATTTAAGCATCTGTGCAATTTTAATTCTACCATTTATTGTTTCCCTGCTATTGAGATATTACCCTAGGTGCTGGGGTGCAGATCTTGCTCTTGCCTTTAAGGAGCTTGACATGTAGGTGAGGAGATGCATGCACACAACTATATCCCAAGGTTGTAAGTGCTATTAACAGGCCCACGTACTCATCATTCTCTGTCTGGGAGAGAGCCAGAGAAAGATGTGTGAACTGAGCATTGAAAAATATGTAGGATCATTGAACACAGTGGCATCCTATGATGAGAAAACAACATCTCCAAGTCATCAAAACTTGCAATAATGCTTCATGTGCTAGAAGCAAGTGGTTTAAGTACAGTTGGAAAGTGATATCATGAGTGGGTAAGAAGGCTGGATAATACAGCAAAGGCCGTGCTAAAGTTTTTGGTATTCTATGCTGAAGATTTTGGAATTGATCTTGTTTACATTTAGGAGACACTGCAGGATTTTTAAGCCCCTGGGTACCATGATCAGGTTTACTTTTTAGAAGTGATACTGTGATAGGGAAAGAAGGGATGGACAGATGTGGGAGGCAAGACTGGCAGTCAGGAACTGGAGAGAGATTATTACAATAGGCCTGGAGAGCGTGGATGAGGCCCTCAGCCAGGGCAGTCAGGAGAGACAAGTGGGGTATTGCAGAAGTAGTAATATGGGAGAAGAATGGCCTCAAAGAAGACACGAGAGGCTAATGAGTAACGCAGATCATGGCATCACAGCCACAAGCACCAAGTCCACTACCAAGAAAAGTTTTACCTGTTAACTCACTTATTGTGTGCAGTTCATGTCCAGTGGCAGTTCATGTGTATCCTGGTGCCTCATTCAGTTCACCAAAGGAAGAAGCTGTCAGTAGAAATAAGCAGAGAACCTTGTAAGAGGATGTACCATTGATGATCTCACACACACACACACACACACACACACACACACACACCCCTTCACACAAACTAAATAGGGGTGGTGTTTCATGTTATATCACATGGCACTGTCTTTTGGCGTGTTATTGAAGACAACGTTGCTTCCATCTGTGATGTTAGATATTCTTGCTATAATGACTGACTTGTGCCAGTGGCTTATAAAGCCCTTCCATGTGTGTTATATCATTTAATTCTCACAGCAATTATATGCAACGAATAGCCCATAAATTATTACGCATGCCATTTTACAAATGAAAAGACTAATCCAGAAAGCTTAAATGACATTTCCAAGGCCACACAGCTGACAAGTTGTAGTGTCAAGATTTCATTTTCTTTATATGTATATATTTTGATGGAGTCTTGCTCTGTCACCAGGCTGGAGATCTCGGCTCACTGCAACCTCCCCCTCCCGGGTTCAAGCTATTCTCCTGCCTGAGCCTCCTGAATAGCTGGGATTATAGGTGTGTGCCACCACACCTGGCTAATTTTTGTATTTTCAGGAGAGACTAGGTTTCACCACGTTCGTCAGGCTGTTCTCGAACTCCTGACCTCGTGATCTGCCCGCCTCAGCCTCCCAAAGTGCTGGGATTACAGGTGTGAAGCACCGCGCCTGGCCAGGATTTCATCTTCTACTTTACCTTACTATCTAAGGAACTGAACAGATTTGTTACTCTAAGAGGAGAACCTGCCATTTATACACATCTACCATCATGGGCAGGAGAGTAACTTTTATAGACAAGTATTGGCATTAAAATGCAGACAAATGCTAGATGATTGGACTATTAGAAGATCATCTTGGATGGTTTTGAGACCAAGAAGTGGTATAGTGACTGTGCTCCAAAAACAAGATGGCTTTGATTTTGGCTATTCAAACAGTTAACTAAAATTAAAGTGCATATCACCTACAATTATTACAACACAATAACCTGCTACTTTACTGTAATTTGGGTTTTTACTTTCTATTATTTTAAGATGGTTCAAATCCTTATATAGAAATAGCTAGCTTTATTATAATGTCTTATAACTGCCACTCTGAAAAGAGTCAAATGTATCTAAGATGCTCAAATACCATAATAAATCACCCTCTTTATTTAAAAAATTATTTTCTCTACAATTATTTGTGCCATATATACTGCGTACTGAAACCTTTTGCTCATTAGTAACAAAGATAGAGATTTTTTTTCTACAGCCTTCAAAGGTATCTATTTTAGACTTTTCATATCTTGATCTTCTCAGCTCTCTTTTTGATTGATTTTTCTGCAAACCAAAAGTGGAGATTTTTCTCATTTCCTGTCCCAGAAGGCAACTACAAGCCCAGATCAAACCTTTCCTGATGACTCTTCTTAGGACTGTCTTTTTCTCAAAGTCACTGAATATGTCAAAATCTTGTCTCTGCTTCCACTGCATGACATGCAAATGTCTAAAGAGAATGTAACTGAAGTTCTATCATTTTAAACATTACAACCAGTTCAACCTTAGGACAAGCTATATTTTTCTATCATTACATTTCCTTCTTGAAGATGAAAGGAAATCATTTAACAATAGTAGATATGGCATGCCCAGAGAAAAGTATCATGTTATTAAGTCAAATATGAAATGTAGGCACTAGTATTATTAACATTGTGTTTGCAGGTAAATTGTAAAAATCCACTCATTTTTGTGGTTGAAGTATCTCTTTTCTTTTGTGTCGCAG
>TTN-207,,0,1067,1548191,1549257,GTAAAGTAAAACAACTTTCAGAACCCCATTTAAATATAGATCGAATCTTAACAATGTCTGTAACAATTACTCAAGAGTTCATGTAAATCATTGTTGTTCCTACCATTCTCTTCTAATTCAACTAATTATTTCCCTGTTATATGCCATGGTCTCGCCTCTCCTTTACCACTTTTCATTGTGAATCATAGACCATCACGTTTCATTTGGCCCCGCTTTTTCTCTGTAACAATTTGTAATGTATTGCTGCTGTCACCAGCTGTCATGCTTCCTAATCAGCATGAATCAGAAGGGGGCGAAATATGCTGCATAAATAGGTAGATTTGTTTTCTCAATTGGCTAAGATAAAAATTAAATTTTAAAAACATCTAAGAGTGTTATCATCCTCCTATCATGCTGACACAATTTTGATTTCACAAAAGCTAGACCGTTTCAGGTCTGTACACCAGCGAGCTATATTCATCCTCCTCTCAAGAATGTCTTAGTGTTAAGAAGTCCAGTCCTAAAGTGGTTTAACATTTCTGTTAGTTGGGGCTCTTAAATTGTAATCAGAAACACTTCCTCAGTAACATGGGGAATTTGATTCAAACAAGGATAGCATTTTTATATAGTGGTACTATTTTTCCTGAGCAAATATAGTCTATGTAGTATTAAGTACATACAAATACATAAGGATTTAGAGAAACTATTTTTTTCTTAACCTTATGCATTAACTGTAACTAGATGTTTTTTTAAATAATGAATTTAAAGTGGTTTAAAATTAAAAAGTTGACTTTACAACAAGAGGAAGAAAGAAAAGAATATCCAAAACCCTGTTGGGTACTCCACTATTGCCTTCATGAACAATGTAGTGAAGTTCCTTAGCCCATTCATGTCTCAGCTTGCTTCTCTGGGAAATGGAAGTGAACTTGTGTGACTTCGAGTCAATAGTGACATACAAGGACAAGGCAGTAGGAGTGGACTGAATTCTAGTCCATTATTGAAATTTGTGACAAATCTGTAGACAACTCCAAATGAGTTCTGGTTTCAGTGCAAGGTAAGACATTAAAAATTGGTATGCTTCTTTTCAG
>TTN-207,,0,744,1549258,1550001,GTAAAGCCCATCTTGCTTCAAGGACTTTGATTTGCTGTATACCTCTCAGTCCCACTGTTACTAATGAGAGTCTCTGCTGTTTGTTTTATTGCATACTGTGGTCAGTCCATAACTTACTAATAAAATAACATGCAATAACTCCCGCTAGGTCCTCAATTATGGGTTAACCTACATACTTTAAATTTCACTGAAGTATGTGTTCTATGCACTAGAGAACCAATAATTATTTTATTAGGCACCACCTTTGCTTGGCTTCTTTACTCTTCTAAGCAATATTGTATCATTGCATCATTAAATGATCTATTTGCTGATTATTACTTACTGTACTTAAAGTAAGTACAGTATTACTTACTGTACTTAAAGTAAGTACAGTATTACTTACTGTACTTAAAGCATACAGTGGACGGAGAGCAAATGCTAACCCAAATACAGTCAGCTAGAGGGAGAGAGAGAAAGACAGACTGGGTCACTTTGGATAGCTGAAATGACAACAGAAAGAAGGAACCAGATACTGCATGGCATCTGCATGAGTCTTCATCAACCACTCAGCACTGAATCACCAGGAATGAATTTTCTTTTGTGTGATCCTGACATCTAGATCATATTGCATCTGGCATGCTGCTTTCAAGTGACAACTACGTCTTTCATCTTCATCTTCCATGCCATTTTGTGTTACTAACATGGGCAAGTGACAAAGCTTAGATCTTAATATTCTTTTCTTTTTCTTGTCACTTGATTATACAG
>TTN-207,,0,3041,1550002,1553042,GTTAATTGATTTTTAGCTATGACTTGCTTCATTTCATCCTCATCGCTTTATGCAGCTTTTCTGCCATGCAAATTCAATCGACGAATATATTAATTAGAATATCTCTAAATTAGCACCCTATTCATAAGTGACTTCTGAAAGTCAGCCAAGTCATTGGCCATGATTATCCTGAAAATTTAACTTACCAGTCTAGATTCAGAAAGTTTAATTTTTAAACGTAGGTTCGGGAAGCAAAGGTTTATTTCCTATGTGCTGCATTTTCTAATATTTACCAACGCACTACCAAGAAAGTGTAGCAAAGTTAAAATGTTGTATTCTGAGAAGTACTTATTGGGTATTTATTATTGTGCCAGATACTGTGGTAAATTTCAGTTTAATTGTTTTAATAGCAAGAGGTTCAACAATTCTTATCTCCTCTTTATTTTCACATCTGGAGGTTCTAGTTGTTTACAAAGGGGCCATGAAAATAGAAAATTGGGACCAAGTACAGTGACTCATGCCTGTAATCCCAGCACTTTGGGAGGCCGAGGCAGCCAGATCACTTGAGGTCAGGAGTTTGAGACCAGCCTGGCTAATATGGTGAAACCCCATCTCTACTAAAAATACAAAAATTAGCCAGGCATGTTGGATGTTGGTGCATGCCTGTAATCCCAACTACTCAGGAGGCTGAGGCCAGGAGAATCGCTTGAACCCAGGAGGCAGAGGTTGCAGTGAGCCGAAATAGGGTCACTGTACTCCAGCCTGGGCAACAGAACTAGACTCCATCTCCAAAAAAGAAAAATAGAAAATTGAAAATTGGGCACTGAAAATAACAAAGCTCTCTCTGGACCAAAATTAGAAGTCTCTAGATATTTCTCCATAAATGATGCTGCTTTTACAGGCTTAAAATCCTCCTGGAATTGTATAATTTTCTCATGGCAAGATCACAATTTTTGTCGTTATTGGGCTTGATTCTCCATTATGTCTGGAAGAGCAGGAATAAACTTGTCTGGGCAAGTAATAACTTCTTCCTCTTATCCATGGACTTTCCTTTTGGATATTAATGAAATGAGAAAAATATTTTTCAGGTGCCATAAGCCTGTGTTGTGTGCCCGTAGTCAAAACAGCTTCACTGAGTCTCATGGAAGGAAGCTGGTGGAATAAATTCAGGCATCTCCAGGGGTCTGTGGAAAGCTCTGGCCTCAAGTTCCTCCCTGATCCTGGCCATAGTGGTGTTAGGGATGAAAAGGGGGCAATGCAGTGCTATGTAGGTGCACAGCCATCTCTGCACAGAATTTTGAAACAGTGGCCTTTCTTCCTACCCAGTACAGAGAATACAGTTTATTGATTCATATAATGTATCCGCAACACCTACTCACCAAAAAGAGGTCTTATTCTTTCTTAATGAGATTTTGTTCTATAGCTATCTCTCATTCTGTCACCGTAGCCTACAAAGGCAATATCTCAAGAACTGAGGTCTAGTTATGTAAATTAGATAGAAAATTCCACCAGCCAGAGAGTTGACCCTCAATTTCACTACAGCTGCTGGCTAGCACAGTAATCACACAGAGTCACTATTTATTTGGAGGTGTTGTCTACAAGTCCTGTAGGTGACAGTGTGACAATTTTTTCAGTAATGTAATTGGGAGTTGGCTGTGTTGTGAAGGTGGGAGAAATGTAGATCTCTTAACTCACTTCCTAAAGAATCTAGTGCTATAGTGCGGTGTTTGACTGTCATATTCCCAGAATTGATTTGAACTCGGCTCTTTTGCCCTAGGATCTCCAGTTCATTCAGTTCCAATTGATAATATTATTAAAGTGTTCTTGAAGCAAAAGAATTTTTTTGAACATCCAACTGCCTTACTTGTACCTAAGAAAGTTGAAAGATAAGACATTTTTAGATGTTTGAAGAGTGAAAGATCAGGCACAGTTGTCTAATTATTTGACATAGGCCAGTCTTTATATGTTCCTTTTTTATTTTGGCTTAATAAGTTCATATAGGCTACAGAGTTATCCACCAAGATCAAGTAGGAATGTCAAACCCCTGGAAGTCTTTTTGAATACAGTTATTATGTGCATAATAAACATAAACATATCATATATAAGTTTCATGACTAACATGCTGCCTTTCCTTCTCATCCTAATGACATTCCATCTTCTCCACATTCAGCATGTTTTTCATTCTTACAAACACAGCTAATTTATGCCTTTCCCTAACTTTATTCTTACCTAGCAAAAGAATCGCAAGCCAGAGCACTTACAAAAATTACTCTGGGTTCTGACACTAAAAGTATTAAAACACTCAGAGAGTCACAAATTAAAACAACCCGTGAAGTAAAAAGAGAATCGTCAAAGAAAACATCAAGTTTGTCATTAACTTCATGCCAAAAACCGTAAGAAACTGAGAACAAGGGAATAAAGTCTACTGACAGGATACCACGTGGACTGAAGACTGAGAGTGATACGAGAGCCCCAGCCTTTCCCAAGGAGCTGCCCTAGATATGACTGTGTCTAAAAGCTGTGCATATTCCTTGTGGAATAAAAACAGTTTTGATAAGTCTTTGTTTTGTTTCTTAATATGTAATTTGGACTTCATGTAGTTCAAAGTTTGAAAGGTGATTCAAATCAAAGGAGTGTTTACTAGCAGGAAAAACTGAGAATAGCCCTCTGCTAAAGTAGCAATTTAGAAAATGCATGTTCTTTCTAAATGTGATTTCATCTCTTAGCAAGTGTTTAGTCAATAGGACATTTTTTAGAAAATAATATTCCTTCGGTTTGTAGATTGCTTTCTGCATGCATGTAAAGGCATGGGGAATTATAGAACTAAAAGTGGAAATTTCATGAAGAACCTAAAATAAAAATGTTTTAAATCTTTCTGTCAACATTGTCATGTGTTTTATCAGCTCAATAGTTTGTTTGGCATGGACTTTTTGGTAAATTTGGGGAATGTAGTTTTCTGTTGTTATAATAAAAAGAAAACTTTAATCATACAAGTCATGAATTGATGCAGAAAATATATGCAATTAATCACTAAAATCTCTTTATATGTTTTTCTATTTTAG
>TTN-207,,0,11202,1553043,1564244,GTATTGTTATAATGGATGTGAGATTTAAGTAGAAATTCTAAAGGATTAATAGGATCCTTGAGTTGCCTTCTTTCTCTTAGTATTATTGAGAAAAAAATGACATAGATATACAAATATATCTCTTAGAGTATATATTACTATGTCGCATGCTTGGTTTAGAATTTTGATGGTTACATGCATTTCACAGTAATTTATTGTAAGTTAATTTAAAATTTTGTATTTAAAATTTATCAGCCAAATTCAACTTTATGTTTGCAGTCATTTCCAAAAGTGTATATTAGGAGAAGTTGTCATCTTAATGCATGAAATCATGAAGTAGAAGTTTGTTTTCAAAATCACGGTGAATTACATTGAAAATAGACAATAACCTAGCTGTCATTCTCAGAATGCAATGTCATGAATGAATTATGATTGAAATGCTACTTTACTGAGGTTGTGTGAAAACATTACATTCCCATCTGGTTTACACTTCATTCACATATATCATTTTAACATTGATATGTCTCTTACACTGGCTTGCAGATAGCTGCCTTATGTGATCCTTATTGCCTGCTTTTCTTTGCATAACATTGTGACTTTATGGCTGTATTAGTTCGAATAAACGCCTTCTCATTTTATTTTAGCTAATTATTTATGGTTATAGTTCTTGTATATACTCTTTAAATAGTTGATTCTCAAAAATATAATAATTTAATCTACAATCAAAAGAATCAGAAAGGGCGTTTATTCCACTCTCTGCAAGTCAGGTAAGATTTTCCACTTAGCCATCAAAAGAACAAAGTTTTCCTGCTCTCAAAACAAATATGCACAGGAACATGTTATTTTGAAATGCATTTTTGCTTGTTCAAGAAGAAATTTCAACAGTTTGAAGAAAAGACCAGACAACGAACGATTTTCGTGTCAGAATCTTTTAAACAGAGCATGGTGTTGCGTTTATTCGAACAAATATGGTGAGTGAATTTTTCTATGGATTTGTGAGATCTGTAGCATGCAATTTATTTCATTTCCTATTTTGCAATTTTATTTACTTTCAACTTTTTCAAGTTCTATGGAAAATAGTAAAGGTTTTTTTTTTTTTTTCCAGAATTATTCTCTGAGGGGGAATCTGAACATTCAGAAAGGGATACACGTGACGCCTTTTCAGATTCTGAAGACATAGACCACAAATCCATGGCTGCTAAAAGATATGCAAGTAGAATATCATCTACAAGCTCCTGGCCTGAATATTTTAAGCCTTCTTTTACCCAGAAACTTACATTTAAATATGTTTTAGAGGGTGAACCGGTTGTTTTTACATGTAGATTAATTGCCTGTCCAACTCCAGAAATGACTTGGTTTCATAACAATCGGCCCATCCCAACAGGTCTTCGTCGGATTATAAAAGCTGAGAGTGATTTACACCATCACTCTTCCAGCTTAGAGATTAAAAGGGTCCAAGACAGAGATTCTGGAAGTTATAGGTTACTAGCAATTAATAGTGAAGGGTCTGCAGAATCAACTGCATCATTGCTTGTTATCCAAAAAGGGCAAGATGAGAAATATTTAGAATTTCTGAAAAGAGCAGAACGGACACATGAAAATGTGGAGGCTTTAGTTGAAAGGGGAGAAGATAGGATAAAGGTTGACCTGAGGTTTACTGGCTCTCCCTTTAACAAAAAACAAGATGTGGAACAAAAGGGAATGATGAGAACTATACATTTTAAGACAATGAGTTCTGCCAAGAAAACAGATTACATGTATGATGAAGAATATTTAGAAAGTAAATCTGACATAAGAGGTTGGCTTAATGTAGGTGAAAGTTTCCTGGACAAGGAGACCAAAGTGAAGTTGCAACGTTTAAGGGAGGCTAGAAAAACATTAATGGAGAAAAAGAAATTATCTCTTTTAGATACGTCTTCTGAAATAAGCTCAAGAACTTTGAGAAGTGAAGCTAGTGATAAAGATATTCTGTTCTCTAGAGAGGACATGAAAATCAGATCTATGTCTGATCTAGCTGAAAGTTATAAGGTAGATCATTCAGCTGAGAGTATTGTGCAAAATCCACATGCCCTTTCTAATCAAATGGATCAAAATATAGAATCTGAGGAACTTCCCACAAGCTTTCAAACTATTGTTGATGAAGAAATTTTCCAGACTGAAATAAGAATGAGCCAAGAAGCACTGGTAAAGGAAAGTCTACCAAAAGACCATTTATATGGTGAAATTCTAGTAAATGAAAATACCCAAGCAAGAGGACAGCTGGAAGAAATTATGGCCAATACTACAATTGGAGAGTCATCCACATATATCACTAATGTATGTGAGAAGGAGGAAGTATATGAGACTCCTGAAAATGTGTCTCAAGCTATTACACCACATGCCAGCGAATCTTTTGGTACACTTGTAAATGTTGAAGAAAGTGAAGAAATAGCTAGTGAAAGAATAAAAAAGGATGATTTGAGAGAATTACAACTCTCTGCTTCTACACGAATTGATGAATTCAAAACCGAACAGAAGGAAGAAAACATGAGATTTTTTGAAAATTCTTTTCGAAAACGCCCACAACGTTGCCCACCTTCATTTCTTCAAGAAATTGAATCTCAAGAAGTTTATGAAGGTGACAGTTGTAATTTTGTGTGTCATTTTCAAGGATATCCTCAACCTATAGTGACGTGGTATAACAATGACATGCCAATCCCACGTAATCAAAACTTTATCATTCATTCGTTGGAAAACTATTCAATATTAACTCTTTCATCTGTTCATCATCAGAATGAAGGTTCTATTACTTGTGTGCTATTTAACCAATATGGAACAGTAAAAACAACCAGTATGCTTAAAGTGAAAGCAAAACAAAAACATGATGTCAAAGCACATAAAGTCCCAGTGTTCCATGACTACTTGGATGAGGAAGAAGAGTTAGCATTGGTGTTTGACCAAGCAAAAGGCGCCCATCCATCTATGAGTCAAGAGGGCCAAACAAATCTTCATTTGTTAAAAACTAACCCACCAGTTCCTCCCTCTGGAGACACAGAATTGCTTTCCTTTCCTGTAGAAATTCAGGTAACAGCAGCTACTCCTATCCCAGAACAGGATAAAGAGTCTAAAGAAGTGTTTCAAACTGAGGAGCTGGAACCTAAAGCAATGCCTCAAGATCAAGTTACTCAATCACCAAAACACAGATTTGTATTTTTGTCTGATATTACTAATGAACCACCAAAAATGTTACAAGAAATGCCAAAGCATGCCAGGTGTAGAGAAGGGGATTCCATCATTCTTGAATGTTTAATATCTGGTGAGCCCCAGCCAGTTGTAACATGGTTTCAAAATGGAGTCCTTTTAAAGCAGAACCAGAAGTTTCAGTTTGAAGAAGTTAATTGTAGCCACCAATTATATATTAAGGATGTTAATTCTCAAGATTCTGGAAAATATAAATGTGTTGCTGAAAACAATTCAGGGGCAGTTGAAAGTGTTTCAGATCTAACAGTGGAGCCTGTCACTTATAGAGAAAATAGTCAATTCGAAAATATTGGTGAAATTTATGGAAAATATTCCAGAGATCAGCAACTGCAAGACCAGGGAGAATCTGTAAGGGCACATTTTTATGATTATCCAGCTGGTCCCTTTACTCCCTGGACAAATGTAAAAGAATATTCAGTAAGGGACTATTTTCAAAGCCTTGAGACTATTGAGCAAATAGACCAGAAAGAGCAGGTGCGTTGCATACCTTCTAGAGAAAAAATTCCCAGATTTGTGCATGGTGCTTCAAGAACCATAAAAATCAGCAAGCCCATCAGGGCTGAATTCATACAATGTCAGGCTGAAGGGAAAGAGAGACATGTAAGTGAAAAATCAAAGCTGCACCAAGCAGAGGGTACTGTTTATCCATTTGTTGATGATTTCAGTGATGTCACTATTAAGAAAGAAATAAGAAATAATTTTGGAAAACTTGGTAGATCAGAAAAGGAAAATGTACAAGAATGTGCCCAAAGTGACTATTTACCAAATATTCACTCTGAGAGAATTTCTGACAGTTACAATACAAAAGATTCATCTGCCATTGTATATGAAGAATCCCTTGGTGAAGAGATACACTACCCGGGGAAAAAGGTGAAGCATAGAATTATCGAATTTGAAAAATTACATGTAGAAAAAGGAGTTCTAGAAAAAAGACCTACCAGAACATCAATTGTTAATCCTCCTCAAAAGAAGATTGATGACAAAGCCTTTTCATTAAAGCAAAGAGAATCAAGATCAAGCAATCTAAATGCAAATATGTATCAGGCAGAGAAAATGTCTCCAAATACTGAATCAGATTCATCTAACATTGCAATAAATTTAAAGCTGCTTTCCTCTCAAACTCATAAAGAATTTGACGCACAAGAAAGGGAACAACAGGAAAAAATAAGTCTTATAGATAAACCTGCAATTTCTAAAAGAGCTGAACATGAATCACCTATTACATTTGACTTAAAGCAGTTTCACACTCAAATAAAACACACAGATGTGAAATTCCAAGAATTAGATAGTGGTCAACCAGAAGAAGCTTATTTTAAAATCCAACATCCTGCTGACACTGAGAACATTGTATTTGATCTAAAACAAATGTATTCTCATATAGGAGATCCAGCTCTGGAGTTCCAAGGGCAAGAAACTAGGGAACAGCAGGAAATACATTATAAAGAAAAAATTCCTAGCCCTGAAACGTTACAACCTGACACACACAATATCTCTAAAAGTGTGCAAAATAATGTATTTGCCAGTCAAGAAATTTCTTCCAGTCAAGAGCTTTCAAATAGAACTATGGTGGAGAAAAGTAGTATTGATGAAAATTCCATTTCTTTAGAAAAAGAAGTCCGACATGTACAGGAACAAAACTTAGACATTTTAAAAACTGATCTTTCTCTTAAATCCTTTTCTGAAGAAATCTATAGTGAATCATGTGCCCTACTTCCAACCTCATCTGCAGATATAGAAGAAACTGATCTTTCTGAGAAAAGTTGTCCTCTAGAAAATGGAGGCAGAAGTTCCATCTCACATTTGAAAAAAGCAGCAAGTGAGGAAAAGCCTTTAGGGGTTGGTGAAATGGAAGAAGAATGCACTCTAGAACCAGAGTTGGCAGCATTTCCAAAGCAGGATGGTGGGACACAGGAATATACAGATGCCACTTTGGAAGACCACAGAGGTGATGTTCAGGAAGCTGACACACTCCATAGACAGCTCTCCCTGAGTCAGTGCTTCCCACTCTTGATGACTGAAGAACAACAGAATCCAGGTGAACAAATAAGTACAAACATTCATGCCTCTGGAGAAGAAAAATGTTATGAAGAAGTTCAAGTTCAGAATGAAGCTTCTTTCTCCACTTTAGAAGGAGAAATGATAGAAACTAGTTTTTCTCAAAATATTCCTAAATTAGATGAGGCACATACCACTGAGGCAGCAGAATCTGAGACCTCCCTAACACAATATTTACTTGCTGCTGGAAAGCGTGAGGTTCCTGAAACTAAAGACACCAGAGACCAGGCAAAGCTTGTCCAGAGTGAATCAATCACTTCAATGGAGGTGGAAGAAGTAACTTTCAACACTGTGTATGAATACTACAACCAGAAACAGGAATCACTAGGTCGTCCACTTTCTCCTGAGTCTGACATTTCCATTGGTGTGGGAAGTACAACCAGTGAAGAAATATCTGAGTTAGATCAGTTTTATACCCCACCATCATCTGTTGAATATTTTGAATCTCCAAAGTCCCCTGACTTATATTTTAATCCTTCAGATATAACTAAACAATCCTCAATACATTCAGGAGGTGAGACAGTTGAAAGATATTCCACACCTTTAGGGGAAGTTGCTGAAAGATATTCAACACCTTCCGAAGGTGAGGTAGGAGAAAGATACTCCACACCCCCAGGGGAGACACTAGAGAGATACTCCACACCTCCAGGAGAGACTCTAGAGAGATACTCCACACCCCCAGGAGAGACTCTAGAGAGATATTCCACACCCCCAGGAGAGACTCTGGAGAGATACTCCACACCCCCAGGAGAGACTCTAGAGCGATATTCCACACCCCCAGGGGAGGCACTAGAGAGATATTCTATTCCTACTGGAGGACCAAACCCCACTGGTACTTTTAAAACATATCCATCAAAAATAGAAAGGGAAGACGGTACACCAAATGAGCATTTCTACACACCTACAGAAGAGAGGGGTTCAGCTTATGAAATATGGCGTTCCGATTCATTTGGTACACCCAATGAAGCCATTGAGCCAAAAGACAATGAAATGCCTCCATCTTTTATTGAACCTCTGACCAAAAGGAAGGTATATGAAAACACAACACTAGGCTTCATTGTTGAAGTTGAAGGTCTTCCAGTTCCTGGTGTGAAATGGTATCGAAATAAATCTTTACTAGAGCCAGATGAAAGAATCAAAATGGAAAGAGTGGGTAATGTGTGTTCACTGGAAATTTCTAACATTCAAAAAGGAGAAGGGGGAGAGTACATGTGTCATGCTGTAAACATCATAGGGGAAGCAAAGAGCTTTGCAAATGTAGACATAATGCCCCAGGAAGAAAGAGTGGTGGCACTACCACCTCCAGTAACACATCAGCATGTCATGGAGTTTGATTTGGAACACACCACATCATCAAGAACACCTTCTCCTCAAGAAATTGTCCTGGAAGTTGAATTAAGTGAAAAAGACGTTAAAGAATTTGAGAAGCAGGTGAAAATAGTGACAGTTCCCGAATTTACTCCTGACCATAAAAGTATGATTGTGAGTCTAGATGTTCTTCCATTTAATTTTGTAGATCCAAATATGGATTCAAGGGAGGGAGAAGACAAAGAACTAAAAATTGATTTAGAAGTATTTGAAATGCCTCCTCGCTTTATAATGCCTATTTGTGATTTTAAAATTCCAGAAAATTCAGATGCTGTATTCAAATGTTCAGTCATAGGGATCCCGACTCCCGAAGTTAAGTGGTATAAAGAATATATGTGTATTGAGCCAGATAATATTAAATACGTGATTAGCGAGGAGAAGGGAAGTCACACTCTTAAAATTCGAAATGTCTGTCTTTCTGATAGTGCAACATACAGGTGCAGAGCTGTGAATTGTGTAGGAGAGGCTATCTGTCGGGGATTCCTCACCATGGGAGATTCTGAAATATTTGCTGTGATAGCAAAGAAAAGCAAAGTGACTTTAAGCAGTTTAATGGAAGAATTGGTCTTAAAGAGCAACTACACAGACAGTTTTTTTGAATTTCAGGTGGTGGAAGGGCCTCCCAGGTTTATCAAAGGTATTTCTGACTGTTATGCACCAATAGGTACAGCAGCATATTTTCAGTGCTTAGTTCGTGGCTCTCCAAGACCCACGGTTTACTGGTACAAAGATGGAAAATTAGTCCAAGGAAGAAGGTTCACTGTTGAGGAAAGTGGCACAGGGTTCCATAACCTGTTTATAACAAGCTTAGTAAAGAGTGATGAAGGAGAGTATAGGTGTGTAGCTACAAACAAATCAGGAATGGCTGAGAGCTTTGCAGCACTCACCTTAACTTAAAATGTAATGTTTTAGTGCCTCAGTAATTATTAGCATTGATCTGAGTGCTTTCATATTTTCCAAATTATGTGGATCTAATAAACTTCCAAACAGGTCCACCATATTTGAATTCATTACCTTGGAGACCCCTAAAGAAATAATCTCTATGTAGAAATCTCATCTTTGTAATACATGTAAATATTTTGTTATCTGAACTGTGGAATCATCACTTGTGTCAATCATGCTGTGTAATATCAAACACAATTAAATCTCTCCTTGGCTACCTAATTGTTTGTACTTCTATTTACCCTCATGCCTCCTCCACAAAGTGTTTCAGTGGAATGGACTCTCTTTTAGCAGATAAACCATATATGCAAAAGTACAATGTAAAAGTGGAGACCATATCAGATGACCACGCAGACAAATTGGTAAGGGCAAATCTCTCTGCTCCCATTCTAAGTTATTTTTGGAATTTTAACCCCTTTGCATCCAAACTCATGTTTATTTACTTTGACTTAGAATAGGCAAAACAAACAACAAAAACCAGCTTCTCCCAATTGGCAACTAACTCTATAATCTGTTTGACATTTCAATCTTAATATATTAACTTCATCTCTTTTAAAAATGTTTTCGTTATTAATATTCCTCTTCATAAGTGCTTTAATTCTCACTGGCTTCAAGGGACCAATTGTGCTCTTTGTGGGCAGGGTTCACCTAGACATTTGCAAAATAAGCAAATAGATCTTTCCACTTTTGGAGATACCTTATTTTTCTCCATTTTTGAGATGACATCAAGTGTAAAATGCAGCAATAATTTAGTATTGGCCTGGGGAAAAAAGGGAAACTATCATATTGTGTTTACATATAGATTTTAAAACTGTATTCTGATTTCAGAATCTTTAAAATTTAAAAAAAGGTGGGATATTTTTAGAATTGAGACAATATGGTAATTTGTATTTCAGATTATATATAAATAACAAGATAACAAGCTTTCCTATCAGTTTCACTGAATTTCATCTTTAAAACGAATATAGCTTAATAAGCATTCAATTTTTATTGTGATGTTTATGTTTCTAAAGTAACTCTTTAATTTTGTCTTTTAAAATTAAAATAACAGTAAATTAACATACTCCTTAATATCTTACCTATATACTAATGTGGACCCAAGTCTTCTCATATAAGACTCGACAAATATAAAAAATTCTGAAAATGAAGGGTAGGACCAAAAGACCTTAGAGGTGATCATTCAACAATACAATTCTGTGTTAAGCTAATAGTAATTATTCTTAATACAATTTAGAATAAACTTTAATTTTGTAACAAAGGACGAGAGAAATAATATTACAATGAAAGATAAATTTTATCTCCCTCCACCTCTTAAATTACTTATTGTTACTTAATGGCTACATTTGTCACCTGCATTTAGCAATATTTAAGTACCATTATCATATTTAAAATGCTAATTTTAATTAGAAATGTAAACAATTTAAATTTAATTTTCAAAAGAATTCATATCCAATTATGTTTATTATGTTTCTTTCATCTATCAGTCTTTATTCTCAACATGGGAATTCTCTAACAGCTATCCAAATTAAAGAAGCAATAGAGACAATGTACAGAAAATAGGCAGAGCAGCCAGGCCTCCCCTGCCTCCCTCACAAAAAAAATTTTGAATTATCTGTTTGAGCCACCATAACTCATCAGCATAGATACACTATTGTAGAACAATCATTCCTGTTCCAACCAGTGAGCACACAATATCTGTGATAATAATTATAGACATAATGTAATATATCACATCACAAATTCCTGAAATAAAACTAATTCTATAGATTAGGAACTTAGAGATTTATTCTGCACTTAGTCACATAATGGATGTTAAAATTAACGAGAAACTCAGATTGAGGCAAACATGACAAGCATGCTTTACTCAAACATCATACAGCACAGCAACAGTTCAAACCTTGTTTCTTAAAAAAAGAGAAAGAGAGAAATAGAAAAATGTTTTTATGTCCTACTGGATTTCAGGAAGAGCTGAAAAACACTCTTATTCATATAGTAAAGAGGGCTTTGTTTGGTTTTGCTCATTAGAATTCTGTAATTCTGTTAGTTTCAAGTATGGTGAGCTTGAGTATACGCAGAATAACAGTGACTGAATAAAGAAAAGTAAGCCTTGGCTTACTTTAATTGTCATAGATAATGAAATGGAATTTTTTATTTTCTGACTCAATGGCACGTAACATAAAACCCCAAAATATTAATTTCTCTGATTCTGGATAAAGAATTTATTGTATTGCACATAGTTGAGTTTAGACAATTAATAGCTGCTACCACAACATGTAATTTTTTAAACTATGCCTTTCAAGTTTCAGCACATTTGAATTTCATTTACTATCCTTTTTATGGCTAATAATACCATGGCTTGAAGTAAAATATTTGCAAATAGTTCAACATAGTAGTGAGTAAGGGTATTTTAACTGTATTCACATTCACTCCCTTTACAGATATTTTGTGAGTTCAAGTGAAGGGAAAGGTAACGCGAATTATGTATTGTAGATTAAATGCGAAGTTAAGTGATCACCATTAATATGTAAAATTATCAATGGTTTTATGGTTTACTTAAAATAATAAATACCTGAATATGTATTCTGCATGCTATAGATGAGTTTCTCCAGTATTTTTACAGCCAGCAGACACTTGAGTCCTGTCTTCTAATGCTTATATGCTAGAACAGAAAGGAATTAAGGTGTAAGTCTATTTCATGTGATGCAAGTGAAGTCACCAAATAAAATCATAAAACTGCCTTTTGCTAAGGCAATAAAACTACTAATAACAGGCCTGTTCTACATAGCTAAGAGGTTTAATAAAAAATCGAATTCCTTGTTTAAAATTACATGTCTTTCATCCTGTCATCCAGGATACTGTTTAAAGAGTCTCTGTTATGCACTGCTTTGTTTCTTGCTCAGTGGTTCTGTATAGGTTTTCTTATACAATAAAATACAATGAACTTTTAATATTGGAGTTGTTTTCTCTTATTTTTGATTATCTTATTTTCTTGGCTAATGCCTTATTACAAAGGCTTTGTTCAAGTAATATGGTGATTTACATAGATGAAAGAAGGCCTGCATTTCTAGAAACTGAAAACAGTGGTTCTCTTACAAATCCAAATTAAACATTTCCTGTAGCCTCTTATTTTTAATAATGACTTTAGAGGCAGTAATTAGAACATCAATGGTTTATTTTGGAAATAATCAGTCTTTAACAAAGAAGATTATTCTTAACCTCAAGAAAACTCTAAATATAAATAACAATTCTGGATCTTTTTAGAAGTTGATTTAAATAATGCTGGATTATTATAACTATTTAATTAGCAGTTTTTCAAACTTTAAAATTGGAATTATATCTCAAGAAAAACTCATGAGAGCATTTTTAAAACATGAACTCTATCACAGATGAAGTGGATCAAAAATTGCTTTTGTACAGTATCTATAATTTTGCATAATTTTATATGTTAAGCTAAGAAAAATTTAGAAATGTGCTTTTTGATACATTAATCTTGGAATAATCTAATCATTCCAGGAATAAAGCAGAAGAAGGCCATCAACTGGTGTCTAATTCTTTGATTTCTATTTTTATATTAAATAAAATTTTATAGTAAAATAATAATCATTTTTCCCCATACAG
>TTN-207,,0,780,1564245,1565024,GTTGGATTTTAAGGATAAAATAGATCAAATGCTAACATTCACTGGATTGTAATGATTTAGCTTGCATCACTTAAATTTTCACTTATCTGCCACTTCCAGAATGTAATTTATTTAGAGTAAGAATGAAATCACAGACATAATCATGGTTATGAACTCACCTTTTCCCTTACTGCCCTGTTGGGTGCTATGCTATCATATCCATGGTACTATTTATTTTAAAAATAAAACATATTTTCATATGTTTCATAATACCAATAGATAAGCTTTTAGTTAATTTTCATATGAAGATAACTTTCATAATATGTAATAAAAAGTATCAGTGAACACCTAGCCACTCTGAAATCACTGGTCTCACCCTTAGATTTAAAATAACCATGATTAGTTGTCTGTTTCTTTTTTCTGTTTATTTTTTGTTGTTGTTTCACTTCATCACTTTATTTAGTATATCATGTTTCTTCACATTATTTTCAGTGTTCCCATTCAGCATGGTATATTTAAAGAATATATCATGTTGTTATGCATATAATCCAATAGCATCACATTTTTTCACAATTCACTGCAAAGCAATGATTGAATAGGTTTTTTTTAAAAAAAGCTTATTGTCTTCTTTTGCCTTCAATGATCTTTCTCATTTTCCAGTCACTTGCCTTAAACTGCTGTAATCCATCTCACCAATTTCAACTGTTTTACTCCATTAACAGCAACAAAAGTTAGAAGAAAAACAAAAATGTCATATGCCTGATAAGGAGGCATGTTAATGGACTCTACTTCCCTTTGCAG
>TTN-207,,0,2007,1565025,1567031,GTAAATGCCATACATTGGCACAGATGTTGTCACTTCATTTCATATTGTTGTCCTTTTTGCTTTCTGTACATGTGTGGGAAATGCTTGTATTACCAACTGGAGAGACCAACAACCAAGACAGTAACATGGTAGGTAGGTACTGCAGAGCCTATATGGGATAAGAAATCATTATTTACAGTCACATTTCTACTACTGACCAAAGAAAAAATAATTTATTATTTGAGAACAAAGTTAAGTAATCAAATGAGCTCAGCTTGGCCCTTCATATAAAACATATCAGGACAGTTTGGTGCCACTAAAAAAAAATAATGTCTCAATGTATTTAAAAATTTTAAATCAAATAACCAATTAAGAACAGAATTACAAACTTAAAAAAGTCAGTGTCTAAGTCTAAAATTAAATCCTAATGTAAGACAGGGAGCTAGTATAGGACTGAAAACTAGGATTCTCTCTAGGCATTTTTACTAATTTAAAAATAAGACGGCTGGGCACGGTGGCTCACGCTTGTAATCCCAGCACTTTGGGAGGCCAAGGCAGGCGGATCACAAGGTCAGGAGATCGAGACCATCCTGGCTAACACAGTGAAACCCGATCTCTACTAAAAATATAAAAAATTAGCCAGGCGTGGTGTCACGCACCTGTAGTCCCAGCTACTTGGGAGGCTGAGGCAGGAGAATTGCTTGAAGCCAGGAGGCAGAGGTTGCAGTAAGCCAGGATTGCACCACTGCTCTCCAGCCTGGGCAACATAGCGAGACTCCACCTAAAAAAAAAAAAAGAAAGAAAGAAAATAAGACAACTACACAAATATCCTATTCCCAATTTTCTAATTGATATGTAGGGTGACTTTCAAATAGTTAACACTCATCAAATACTTGAATGCCTTCATTAACCAAAATATTAGTAGCAAGCTTTTCTTCCTTTCTTCCTACCTTCTTTCCTTCCTTCCTTCCTTCCCTCCTTCCCTCCCTCCTCTCTATCTTTCTTTCTTTCTTTTCTTTCTTTCCCTCTTCCCAAGAGAAAGTGTGAGTATGAACTGTGGTTTGAGGACAGGGGTAGAGGTACAGTCAAGCCATACTTGGACTGTTGGGGAAGGCTGTCCCTTGGTCTTCTTTGTCAATGAGAATATCAAGGGGAAGGGCAAATGCAGCACATCTCTTGAATGTGAAAACGATGAGGTTCCCTATAGCTTCCTCTTCTCTACAATCCTTTTACGTGATCCTAAGAAAAACCCAGGCCCATGATGACCCAACCAGTGCTTTTCACTCTGGTCAAAATGTCTCCATAAAACCAAGTACATGATATTATTCATACTGACGCGTTTGGAAGTTTCTTTACTCAAATTAGGTCAATTTAGGAATGCGACTAATATTGAAGCTTCAGATAATAAGAGGAAAGGATAAGGAGGATGACTTAAAAAAATTAAAAAGAGAGGTTCTGAAAGTCTGGCTTCAAGATGCAGAATGGAAAGGGGAAGTTGCTGCTATTAAATATTTTTACAAGTTTGAGTTGGCCTAGAGGATGCATTCATAGTTAAGCCATATAAGAATTTCCAGGCAGTTGACATGAGGGTTAGAAAGACATTACAAAACTACTTCAATCTTCTTATCACTTAATATCCCTACTCTTCAGAAGAGTCAAATACATTTTCTTTATCTTCCTTACATAATCTTCTAATTTGCAGAATTAAAGTATCAGCTCAATAGCTTATCAAATAATTAAACAAGCAGCCACTAAAATGGACAAATCTTTAGTAATGTTACTTAATAAAGGAACGCTTGTCTTTTCTTTGATAGAGACAAGTAAAGTGATGTCTTGCTCCCTTATAAAGAACACTCTCATCCCTTTCCTTTGACAATCTTTTGTTCTTATTAACACATTACTCCATTTTAAATTATGGCTCATGTCTATCTAAAGACTTAACTCATCTTTTCTCTGTCTTGGAATATATAATTACAGCAAGTGCTTTGGTGGGGACTAAATGTAATGCTGGAAAAATTTCTTTTGCAG
>TTN-207,,0,522,1567032,1567553,GTAAGAAACGTGTGAATGTATTTTCTAGTCCCTTCTCTGCAAGGAATCCTCAGTAGAAAAACTGTTGGCAAACAATTCAGTCAGTACACTTTGTTATTAAAATAATGTCATTCAGCAAACATTATGGTTTGGGAAAGTCCTGGCATTGTTTGATTTTATTTTTTTAATCCTCTTCAAAGTTCACTTAACTTTTGTTCTTTTAAATTGTCTGCTATTAACAAAGCTTGCTTAAAATTTCTTCTAAGAAAAAACTCCAAGTGTCTGAGCAATTCTTAACTATCTTCTTTTATAAAATTCTTCTTTGTGTAGGTAGTCTGTTTATTGTTGTTTTATTTTAAATCAAGAGACTGGGAAAGTGTCTTAGAATGATAGGAACCTATTAAATGCACCACAGCTTTTACAGAAATTTTGTGGAGATATTTTATGTGTGTTGGGTCTCTTTGTTGTATATGTCTACTTTTCTTTTGCGGAGTTTATGTTTCAGATATCTTCTCCTTTTTCTTTTTTGTAAACTTCATGTAG
>TTN-207,,0,100,1567554,1567653,GTTTGTTTACTGAGTTTCCATCCAGTATTTTTCTGAGAAAAGATTTCCCTTTTAATTACTTATTACCCATTACTTACACAATGCTTTCATGCTTTTGTAG
>TTN-207,,0,435,1567654,1568088,GTTAGTGCTTGAAAAACTAATGTCTCTTTAATAAATTGTCAAACTAGCTTTCTTACCCCATGGAAGAAAAACTGGTACTTTCTTCTCTTGTCCTATCCTTTAAATTTGTTTTGTCTTGGTTTGACCTGGGACCTTGGGAACAAAGTCAGTAACTTTCACCTGGTCTTTTTCCCGAGACTAGTGTAAATATCTATTATCTGATAACAAAAGGGAATAATAAGCCATTTTGTCAGCTGACAAACATGTATCATCTATGCCTCTGTCTCTTGGATGGAATTATAATTATTCTTAACTTTTATTTCTTCTTCTAATTAACACTATGAAATAGTAGTATTGGGACAAGATAAATATAATCTTGAAAAAACTCTTAAATATAGATGGTGTTGAAAGTGTTTGGGAATTGATATGTTTTATATGCTCTCTTTCCTTAACTAG
>TTN-207,,0,96,1568089,1568184,GTTTGTGTAGGAACATTTAAACCTCAAATTGCTATTTAGAATTAAAGTGAAACCCTAACAAGCATTTAGGGTGCTAACTATTTCATACCATTGTAG
>TTN-207,,0,117,1568185,1568301,GTTAGTATTTTTAGAAAATGATGCTACATATGCATTTGAAACCCAACAAATGGCCTAAAGTCAATCACTGAGCACTCTTCTATATTGACCTTTTCTCCCTTCTTGTGCAACACACAG
>TTN-207,,0,115,1568302,1568416,GTTGGCTGGAGACTTTGCATTTTATCCTTATTAAAGATTATGTTCAAATTAAGTCATCTTCCCTTAGATCAACCCTCTTAACTCTTTGAAATTCTTTCTTATACCCCTTCTTCAG
>TTN-207,,0,92,1568417,1568508,GTTTGCATTGTTTTCTTGACATCTTTGTGCTAACCTTGTTATAAATTCTTTCCTCTTTCTCACATTTCTTAATAACTTCCTTCCTTCCACAG
>TTN-207,,0,94,1568509,1568602,GTTTGTGTTCACTTTGCCTCTTGTGTTGCCAAAGTTATGGCCCATGGCACAGACCCCTCCTCCCTTAATGCAAATCATTCCTTTTTTACTGTAG
>TTN-207,,0,109,1568603,1568711,GTTAGTGTTGGTTCCAGTGAGGGACTGGCTTTTCTGAAGAGTCAATTCTTTTTTTTAAGCCACTTTTGCTATAGGGATAATATTGATTGAGAATTCATTCTTCTGTTAG
>TTN-207,,0,101,1568712,1568812,GTTGGTTCAGAACGTTTGCCTTGGGTTTGAGGAAGAAATGCAGATGTAAGCCTTTCAGCAGGGTAATGCACAACCCACATCTATCCCTTTGTTTTCTACAG
>TTN-207,,0,132,1568813,1568944,GTTGGTATTGTTCTTCTACAGAGAGGATTGGGCATTTCCATGCTCCTTCTTCCCTTAAAATTTAAAAAAAAAAACAAAAACAAATTAGTAGATTGACCTTTTTTTGTTGTTGTTTGCTTTTTCATTGAATAG
>TTN-207,,0,133,1568945,1569077,GTTGGCAAATTTTATTTCCACTTATCAAGAACTTACAAAATATTTTTGTTTCATTTCTAAATTTTCACCTTTATTGCTAAGTTATAAAATAAAACTTCCTATTTTCTTTTGCTTGTTTTTTCTTTCACCTCAG
>TTN-207,,0,147,1569078,1569224,GTCTGGTCTCTACATCTCCTCACTTTCTTGCTTGTCTAGATTTTCTTGCCTGGGGTGGGCCGGGGCGGGGGACGCTTAAGACAGCAGTTTTGCCCAGTGACCTGTTTTTAAAAATATTCAACATCACAATTCTTTTTCCATCTTTAG
>TTN-207,,0,97,1569225,1569321,GTTCGTGAATGGAATCTATTCTCCATTTTGGCTGTGCTGCCTGATAAGTTTGGGGTCTTCCCTTGAGTAAGCTACTGTCTTCCTTTTGAATCTTTAG
>TTN-207,,0,118,1569322,1569439,GTCAGTTATACAAGAAGCAGCCTATCAAATAAAAATTCTGTAACGCTTTTAAATCTTATCATTATGGGTAGGAGTTACAATATGTTTCTTCTTTTCACACTCTCTTATTTAATCACAG
>TTN-207,,0,112,1569440,1569551,GTTTGTAAGCTATTCTCTTTCAAAGATAGTCTATAGCGACAGTTTCATTAGCAGACATTATTTCTAGTGGAGTTACCAATGTAACTCATCCACATTTTCATTTTTACTACAG
>TTN-207,,0,102,1569552,1569653,GTTTGTATCTTCACCCCAGTCAGCTTCCCTTATTTATAGTATGTCCTTTGTAAACAAATAGCAAGAGATTAATGGATGTGTTTTGCTGTTTGCATTGGACAG
>TTN-207,,0,246,1569654,1569899,GTTAGAATTTCTTTACCTCTTCTTGATTCTTCCTTGCGAATGCTTCTTAAATGTATCACTCTTGCCTTTGTATCCTTTAGAGCTAAAATCTCTATGATTCTGGTTCTTTAGATACATATTCATTGTGTTCAAGAAATATTCAGCCATTGCCTCTTTCCAAGAGTGTTTTCTTAAATGTCCATAAAACTGTCACAATAATTCAACTGCAAGCAATTTAATTAAATATATCTCTCTTAAAATCTATAG
>TTN-207,,0,213,1569900,1570112,GTGTGCAAATTTGATTCCTTTATGTTTCTGTCTGACTGTGTCTTTGGTTCTCTGTATTCAGTTACAATGTCTCTAAACAATCAAGAAAGTAGTATTCTTTCTAACATAGTAAACAGTATTTGCTCATGTTTTTCTCTTGCCTGTATACTATCTAATTTAACTATTGTTATTTATTTCTGTTCCCTGATACTCTCCTCTTTCCTGACTCTTTAG
>TTN-207,,0,1043,1570113,1571155,GTAGACATCTTGTTCTTGTGTTTCTCATTAAATGAAAACCACCTTCTCCCCTGGGTATTATAGCTCTTTATTCATTTACTATCATTTTAGTTTCCATTTGAGATCATAGAATATTTTTCTGAGCTAGTATTATTTCCCTTTTTAGATGGTTTCCTTCTTGAATTTTGCTTACATGTAACTAGTCATTATGAAATATTTTTGTTATTCCAGTGTCATAATTCTGATTACCTCAACACATTTGCCAAACATCAAACGTGATGTTTCAAAACTGCACAAAAAAATGAAGTAGGCATTTTAAAATTAGTCTTTTGCTTTCAATCAACTTACAGATATATCATTCTCACTATAATCTATATCATTAATAACAAGCACTTTTACTATATCTATGCAAAGTGAAAGCAATACAGGTTTTAAACTTATGTTTAAAACAGGACAATAATATTTTTTCCTTCTCTCTCAAGGATCACTTCCTATCCTTTAAAAATTATATGACTATACCTTGGTACAAATAGTATCTGTGTTTTTTTGCTGCAATTTTCCAGTGCTTTTTTTTTTTGTCACAAAGGCCAAGTTTGTCTTGTTTTAAGACAATTATTGCAGTAATCATTTGCTGAAATGGAAGACTTAGATCACGGATGTTGTGATGACTTCCAAGTGTCTGTTATAGAACATATACAAAAAAAATCATCCTTGAAATTAGAATTCCATACTTCATGCAAATCATTATTTATTGCTATACTTGCTTGTTTGCAATTTTTGTATCAATCTTTGTAGCCTAAGATACATCAGTAAGGTGTAGTAGATAGAATGTTGAACTGTTCAGTAACGACATCTAGGATCTATCTGGGTTCTCTGCCCATCTAGCTGGTTATCTTGTGAAGGCAAATGGCTTCTGAGGCTGTTATCCCATGAGAGTGTTAGTGCTGGACTCTACTTACCCATTAGAATATCTTAAACCTTTCTTCCAATTTAAAGACAAATAAAAAATTTTCATTTTGTGAAATTCAGTAGCCCAATTCATGAGAAATTCTTGTTTTTTGCAG
>TTN-207,,0,118,1571156,1571273,GTAAATATAGTTCATCCACATGGCAGAAATGTCATAAATGTGCAAAATCCTACTTTTTTCACTCTCGCATGATCTGGACAATCTTTTCAACAATTTCCATCCATCTTTTCCTGTTCAG
>TTN-207,,0,829,1571274,1572102,GTTGGTACAATAGCCCACGATAGAAACTGGTGCCAAATGCTGGAATGAATTACTAAGAGTTACTGGCAGATTCTTTTTCTGAGTTTCTTCTAGAACTATATTTATCCTCATCTATTTGAAAGGTCTAGAGGAAAGACATAGTTGATCTTTCAAACACTCTTTTCTGTTTCTGTGATTCTAACAAAAATTAGACATCTGTTTTATTGTTTAATAACTACCTGTCTATATCAATTAGCAGATACAATCATGACTCTCTTTGATTAAGCATGAAAGAATACAGAGCCCAGCATGTGCTACAAGAGTAATTGTTAAAACTAACAAGAACTCCAAAGGTTGGCATTTGATAGCAAAGCTTCCACATAAAATTAATGACAATTAAACAATTGTTTGAATAACAACTTTCAAAGAATTGTCTTTAGCACCTTAAGGTAGAGCAAAAATACCAAGTAATTCACAATAACCTGTAGACTTTGATCTACAGAGGGTCAAGTGGAAATCAATATATACTATCTAATGCACATTGTTTAAATTGTTTTGAAGTTGAGTCATGCACGAACATATATTTCTTAAGAATAATTGCTACATAAGACGACAGCAAGAGTGGTGGGAAAAACAAAAAATAAAGAAAAAACTGAAAAGAAAAAATATTAAAATAAAAAATAGCTATAATTCTATGACTGCATGTAATTATGGAATCACACTTTAAAGTCGAGAGAGAGAGCACCCTAACATAACCATCTCACTGGGAGAAACAATCTTAGTGAATGTGATAGTAGAGACAGAGTAAAGATCCCAGACTTTGACAGATGGATATCACGTTTTATTTCAG
>TTN-207,,0,116,1572103,1572218,GTTAGTTCTGCTGTTTTCTTCTGGTTGCTTATGCAAATTCCTTTTACAAGTTTCCTTCTTTCAAGTCTCTTCTATTCTTTCAAATCATGATGAGTCTCTTACCTTTCCTCACACAG
>TTN-207,,0,159,1572219,1572377,GTCAGTAGACAGTCAAACTTGTAAGGAATTTCTTACAAATTCCTCTTCAGGTGCACATCTATGTTGACAAACATTTGAAAGTGCTCTAATGTTTTATTCAAAATTGCAACTCCATCTGAAGCTTACAGGATCTTTTAATTGTTCTCCATGTCTATATAG
>TTN-207,,0,93,1572378,1572470,GTTTGCTCAAGTGGATTCACTTTTTCTGTTTTCTGTATACCGACATCCTTGTGTTTTTCTTGTGTTTAACTGCTGTGCTTTGTCACTTACTAG
>TTN-207,,0,108,1572471,1572578,GTGTGTTGTCTTATTGTCTCTTAAATCATTTGCATTCTTCTAACATGTAGCATAGTTTCTTTGATATTCATTAATTCCAGTTGCTAACTGTGAGCCTTTCTTCCTTAG
>TTN-207,,0,112,1572579,1572690,GTGATGATATTTTACAAATTAAAAAAATTCTTTTTTCCTTAACTCTTGTATCTTTATGGTGAACTTCTCATTTCATCTCCTAACACCTTAAGTATTACATGTCTCCCTACAG
>TTN-207,,0,124,1572691,1572814,GTTTGTTCACACGTCACTCTTTTTCTTTGCAAACTGTGGCTTCATATTTCATTGTCAAAGTAGAAACGACCAATGGCAAAAAAACAAACAAAAAATACACATTGCCTTTCTTCTCATCCTCCAG
>TTN-207,,0,644,1572815,1573458,GTATCATTCCATGACTTTTGACAATATTTGTTCCTTACCATATTTGCATAATTGTCTTATAAAAGTTTCTTTGGTTTTTAAATGTTTGAGAGAAACTAACTGGACATGTTAGAATTTGTGTATTAGTGTTGGAGGCAACATTAATCAAAGTTGTGTTTTCTCTTTATATTGTTCTTTACATTAGTGTAACTCTAAGTGTAATCTTATCAAAAAGTATTGTTTAATTGAAATTTGTTAAATGTTGTTTTAACTATCTAGTCCATTTTTTAATGCTTTCTTGTTATATGGCATTCTGATTTATCATTACTAAATGTTGATCAAATACATCTATAATACATTAACTTTTATGTTTTAACTTACATAGTCAAACTAAAAAAAAGAATCAACTAAATTCTCTATTAAAAATGCACATGTACCCTAAAACTTAAAGTATAATAATAATAAATTTTAAAAAACTAAAAAAAAAATGTTATGAGATTATTTAACTTAAAAGATAACTTATTTTACTGTAAAATCCTCAGAAAGTATATTCTTAATAACAAACCAGTTTAAATATAAATTTATGGGATCTTCAGCTACAAAAACAAGCTCTTTTAACATGTATAATAAATATCCCTTACTGACTGTTTTGTTTGGTTTACTAG
>TTN-207,,0,257,1573459,1573715,GTTAGACACACTAAGCTTCTTTGTTTCTTTATTCTCCTCTGATTTGGGCTCTTAGCAAAGTTATGAGTTCCAAAATAAAAGGATAATTAAGGTTATTTGGTTGCAATTCTTCAACAAGTTTTAATGAATTGTCATTTCTTGTGTCAGCATGTATTGTCATATGATCACACCAGTCACTCTTCAAGGTTCTAGATTTAATTTTTTTTTCCTTTATAGTAAGCAAGTGTTCTCATTGTTTATCTCCTTTTTTCTGGTAG
>TTN-207,,0,120,1573716,1573835,GTTTGTATACATGGACACAAAAATATATGCCCCTTCCTCCTATCTGTTCTTGCCTAACTAATAACTTGTGTGGCCATGATTCTCACATTTTTTCCTCTAACCACAAATTTCTTTCATCAG
>TTN-207,,0,150,1573836,1573985,GTTAGTAGCAAAGCACAGCCAGAGAAAAAATCAATTTACTTGATCCATGATCATTTTCCTCAAATATTCCTCTTATCCAGTAATTCAGTGATTGCACTCTTGAGTTTGAAAGGTTACTTTGTTTTCAATGCAAAATACTTCTTCTTTTAG
>TTN-207,,0,102,1573986,1574087,GTGAGTAGAATGAGATTTTTATGAATATACAATATTTCCAGGGGGTGGAGGGGCACAGAATAAAACTTCTCTTTAAACGCAAAACTACCCTTCCCCACATAG
>TTN-207,,0,190,1574088,1574277,GTCAGTGTGCAAGGATAAAGCTGCTGCTTCTCTAACACCTCTTTCATGTGGACGTGGTGCCTGCCTTCCCTGGAGTTTCTTTATTTTGTCTTCATGTTTAGTCTTAGCTCCCTTTTTTTAAGGAGCAAAAGCACTTCTCACTTGGATTTCTTTCTTCTCTTTATCTCCCCTTCCGCCTTGCAATATCTAG
>TTN-207,,0,94,1574278,1574371,GTTTGCTCTTTCCCCCAATATATACATCTTTTAAAATTTCTCTTAAGTCTTCATTAGAAGGCAAGAATTTTACCCACATGTTTTCTCCTTATAG
>TTN-207,,0,100,1574372,1574471,GTGTGTTGACAGCTACCTCTTTTTATTGCTCTCTTTCTTTTCAAACATCCTCTTTTACATGGCATGACTGACTTGCTGACTACCATCCTTTGTACCATAG
>TTN-207,,0,132,1574472,1574603,GTGATGGTGTTGTTTAACCTAGTGTGTGTGAACAGATTCATTTTCTTAAAAACGTTAAAACTTTTATGAATTGAAATATGTTGTGGATGCCTTCTCACCTGTAAATAAGGATTATCTGTAACTTCTTTACAG
>TTN-207,,0,140,1574604,1574743,GTGAGTAACTCACAGTACCCTCTTCATTGTAAAGCAGCTTCACTGCTCCAGGCCACCAAAAGGCTGGTGCCATTTAGTTTCTGCTCTGTATGTGAGAGCATGGAAATAAAAATCACCATGTTGGTCTTCATTCTTTTCAG
>TTN-207,,0,1320,1574744,1576063,GTACTTGTTAGAGTGAAGGAGCAAGATCTCTTTTACATTTTCAGTATCTTAAAATATAGGAGGGTGGGTGTGCTTGAGAGAGAGCTATGTTTAGGACCAGGGTCTAGTGATGAAAATGGATCAAGTGGATCAAGGACCTTCCAAATGGAGACAAGTATTTTTTAATTACTTTAAAAAAAAAATTTAAAACTAGGAAAACATGGACCAAAAGTCCATTTTAAGAGACTAAAAATAGAGACTAGAGAGAGATAACCGAAACTCTACAAAATTGCAAGAAAATCCTAGTTTGAAAGACGGTATCATAGGACAAAAGCGAAGTTATTGCAAATGACTTTTTTCCCACAGTACTTAGTAAATGAATGGATTTTGTCCCTCTAAGGCATAGCAAAGAGCCAAACTATCAAGCCCTTCAAGGAGAATTCAGATGAGAATGATAAGTTCAACTTACTTTCCTCCACTAGCCCCACTTAAATAATAGTGGAGGTCAGGGGCTGGGGAGTAAGTAGATCAGTATCTGCTATTATGGAAGGCAGTCATGTGTTTCTGCCACATGTTTATCGCTGCTACTGTCAGAAATTAAATAGTTCACTCAATGGACTGCTAGTCTAGTCCATTAGAGTATTTTTAAGGGTTTTTGTAGTGGTGGTTTATAAATATCTTGAAATTAAAATATAATTAGATTTAGCAGCCCATTTGCTCTATGACATATAGCTAATCACTTTTACTTCCCTATGCCTGAATTTTTTGCTTCAGTTAATGAGGAAATCATTACTCTCACACACTTCAAAGGAAAATTATGAAGGTTGAGGAAATACCCATTTAACACCTAAAAGAGGAAAATGGCATTTTAAAAATATTAAGATATCTGACCCACTTTGCCATTCCGGCTCTTCATGCTATGTAACTGATAGCATTGCAGCCTTAGGAAATAGTTCTCCACTGGTTCATATACAAGACAGTAATCAAATTCTCATTCCCCGTGGACCTCAGAGGGCTTCCACTGACAGATACATGCTATTATCTCTGATCTTGGCACTAGAGAAGGGACTCTTTTGCTGGGGAGAGGATGGCACAATAAAGAGTAATGTCTTTTTCTCCTTCTTTTAGTAATAATACTTGATGTGGATGCTTACAAAAACAAGCATATTTTATTTTAGAAATTTTCTATTTAGGTTTCATTTAACTCTTCTTCCTTGAACTGCATAAATTTGTTTTCCAGAGCTAAAGACCTCTCTAGCAAAGATTATTTTTTCCACCTCATCTTGAATTATATGCATCTGTTCCATCCCTTACCCTGTGTTTTTCCTCTTGGTTCCATAG
>TTN-207,,0,228,1576064,1576291,GTCAGCGCTCTCCCCACCTGTGTGTTTTTCACATTAGCCTCCTCTTTAATTGTCCTCTTAACTTCCTGTTTGACTCTTCAACGATGTTTTAAAATAGGGAAAGGACACAACAAAGAATTGAAAGTGTTTTTTTCACTCTCTATCTCTCTGATGGAGTGGAAGATTGATTCTTACTTTTAACTATATACTTACAGAATACATCCGTATTTTCCTTTTTTCCAATTTTAG
>TTN-207,,0,412,1576292,1576703,GTTAGATGGACTGCATTCACTTCTGCTCACTACTTCCCTTCTAATTGTAATACTCTGTTGCCCCCTCCACCCCAGCCCAGTCTTATCACTAGCAGCCTATTCCACTTTCCCTTTGTTTCCTCTCCAAGTCCTTTTCTGTTTAGTCTGCTTCCCTTTTCCAAATCCTACTGAATATCCTTTTAGATAATGTTGTAATTAGGTTTTGATTGGATTAAGAAAGCTGGAGTAGATGAGATATTCAACTTTCCTACTGAATACAAACTTTAATGTGTCCCTGCTCGCATCCACCAAAAATGCCTCTTAAATGGAAATAACACATTATCACTAGTTTGATTCCCGGCATTCACGATTTGAGCAAAATGCTGTCAGTCTCACAAATTTTAAAACCCAGGCTTTCCTCCTTTTTCATCAG
>TTN-207,,0,116,1576704,1576819,GTTAGTAAAAAGATGATGTTATCACAGATACAAGGCACACACTCACCAGGATCTGTATTTTCTTTAGTTTTTCAATTTGAGTTTAAAATATGGATATCTTTTACATTTCATTCCAG
>TTN-207,,0,524,1576820,1577343,GTTGGTTGATTTCTTGGGCTTTTCCTTCATCATTATAATAATGTAGTTCCTGATTTTCATAAATGTATATGGGTTGTTACATCTTCTATAGGATAACATGAGTCCGACATCTTCTGAATCAGCAAATTCAGAGGCAATACCATCTGTAGAATTAGAAGAAAACCATGTTCAAAAGTTATATCCCTTTCTTTTTGAGGAATTTCCAAAATGATGATAGGAATGAAAAATAGTCCCTGGATAAGGTTAAAGCAGTCTTCATTTATGCTGAAATAATTCACCACATAATTCTTCACGGCAAAGAGAGAACAAAATCCCTAGCAAGTCAACCATCACATTCTGCCCACTGATTCTCCAAGCTTTTGATAGTGTGAACCCATAGAGGAGTTTTTAATACCGTCACAAAAGAGCCAAATGGATCTAGGGATAGTCCATCAAAAAGACAGTTCTCTCTTCAAGTCATTTTATAATTGTTGTCCTTTGTTTTTTTTGTTTTGTTTTGTTTTGTTTTGTTTTGTATCATTCAG
>TTN-207,,0,109,1577344,1577452,GTCAGTTTACAAAACAGTAAAATGAATTGCATTTCATAGTTTATTAAGCATGTTTGTCATAACAATTCACAAATACTAAACCTTTTCTGATATGTGCTTTTGTGTTTAG
>TTN-207,,0,103,1577453,1577555,GTTTGTCAGACTGCTCTTCTAGATTTATACGATTAGTAATTAGATGTGTCTTTGTCTGTATGTATATGTGTTTGATTTTATATTTTCAATTTGGTCACTTTAG
>TTN-207,,0,92,1577556,1577647,GTTTGTCATGATTGCACATTTTTATCTTTGTATACAATCGATGATCTGGCATGTCTCCTTCATGACTGATTGATTATCTCTCTTGGCTGCAG
>TTN-207,,0,594,1577648,1578241,GTGATTGCAATATTTTTAAAGTGAACGAATTTGTGTTTCTTTTGAACAAGATTTAAAATGTCTGGGGAGGCCTATTTTTTAGGAAAATCTTTCCAAAGGCTTAAAATTCTGCTTAAGTAATCCTATTTACAGTTAGTGGCTTATCTTTTTCTATGGATTCTACAGAGAGATAATATGACTAAATCTTTAATTGGAAGGATTATGCAATCATTTGCTTCTATAATTAAATCTTTTTTAAAAAGTGACCATATATTTTTAAATTCCACCCCGTAAGTATCTCATGCAAATTGCTAGAAGGCAGTCTTTAAAATTACAGGAATCTGCTGCTTGCCCAGAGACATGCCTTCAGCCAACCAATTGCTTTATTGGTTTTCATACTGTTTTGCACCTACTGTGCATTAGGGTTGGTCTCAGAGTGATACTTTTGCTCCAGAAATCTATATGCTTTTCTTTATCTCCAAGTTAATTCAAGAGACATTAATAATTCCTGATTTTTAATAGAAATTGCATATATACGTGCGTTTGTATATATATAATTGTGAGAAGAGCATTTAGTAAATTAAAGTATTTGTTACTTTTATTCTGTTCCTACAG
>TTN-207,,0,139,1578242,1578380,GTTTGTGGATTCTTAAACTTTCATTTCTAGAATTAAAGTATTATAATCAAATATGAACTTAGGGAGAAATTTCTATTTCAGTAAACTGACATGGTCCAGATATTGAGCCTGAAACCTTGTCTTTCTGCTCTACTATTAG
>TTN-207,,0,778,1578381,1579158,GTATCGTTTATTTTGCAAGTGGTCCAACAAAAGTGTAATCATTTTGTAGTATAGCCTGAAGGTGTCGTTTTTATGATGATGAATGCAATTTAGGACATTTTTAAACAAATGAAAAGAAAATGTTTAAGAGGAAATAAGTTTATCTAGAGAAGAAGTCATTTTTTAAATCTGTATTTCTTTCTTTCCTCGAGACAGGATCTCATTCTGTCGCACAGGCTGGAGTACAGTGGCGTGATCTCAGTTCACTGCAACCTCTGCCTCCTGGGTTCAAGTGATTCTTGTGCCTCAGCCTCCTGAGTAGCTGGGATTACAGGCGCCTGCCACCATGACCAACTAATTTTTGTATTTTTTGGTAGAAACGGGGTTTCACCATGTTGGCCAGGTTGGTCTGGAGCTCCTGACCTCAAGTGATCCACCCGCCTTGGCCTCCCAAAGTGCTGGGATTACAGGCATGAGCCACCACACCCAGCTTATAATCTATATTTCTAAAACTTTATATATTCCCTATGATACTGAGACTACCCCTTCTTTTTACAAATTTGTGATTCTCTAAATGGCCATGAGTTACTTCTTATCATCCACCTTGTAAGTCAAAGAACAGTTTAGAATAAGCTCGTAGAAGGAGGCTGAAATGTTTAGGAACATATTCTGATATAGTGTATTTAGTTGGTTAGCCTTGATTTTTAACTAAAAATATGAGGGTTTTTTTTCTTGAAAAGCTTCATATTAGTAATCTGCTTCTAGCTTCTACTTCATATATCCTTGCAATTTCTTATAG
>TTN-207,,0,1752,1579159,1580910,GTGAGTTATCCTCACAGCCCCAACCTGTTGTGTTTTTCTTCACTGCCTGTTATATATCCATGAGCATTTCTTATGATATCTTGACCAAGTAAGTTATAACAAATATAAATACACATTATTTAACTGTGTATTTATCACTCCATATGTTTACTAAAAATATAAATTATTGTAATTTAATTATGTGGCTTCCCGAAGGAGGTGTCATTTAACGGACTAATATCTTAGGTTTCTAAATCATATCCTAAAATTCCTTTAGGTAGTTAGAAGTTTCAGCGTACTCTGAAATGTGTGCATATGTGACATATATTTTTATGAAGCACATTTGTTTTGAAATTTTTTTAATGTTCATCACCAAATATCACATTAACTTGACTATTATTGAGTTATATATTATATCACAGTCTGAAACTTTCTCCTTTCCAAGTGTATTTCTAAAGGATTATTGTTTAATGTATATTGCCCAAAGCGTTTGACCTGCAAACAAATATTAATCCCAGACAAAAGGGTAACATTTGCCCAAAAAGAAAAATAATGGGTAGAAAACATTGCATATCATTATGGAAGACATATTTAAATACACAATCATCGCTTGAGAAAATGAAATAGACCATGTTGTTTAAGGATATCTTTATCTGTTTCTCTTCACTGTAATGGCTTCCAGTAATTACAACATAGCTTCATCAAAATCACATTAAAAACTAACCTCCTAGAGCAGCCTGGAATTAATTACCAACTCTTATGATCTGGTTAGTTATCTCACAGTGCACAGGTAGTAAGTTATTATTAATAGGCTGATATCACTAATAAGTAAATATCACTGAGTTGTCTTAAAATTCCAGTTTCACCACTCATTTTGTGGAATTTAGATGCATTTAGTTTTAAAACACATTTTATAAAATGAAAAATATATACTTAGCAGTGGCTTATCTTCATGATTTACACTCATGATGGTTTTACCATGGGCAGATAAATGCTTTCTATAGAATTCTGAAGCTATTTATAAAATGTTTTTAAAGGATAGACATCAGAAGTTTTAATCTTTGCAATAACAAAAAAAATGGCCTTATTCTTTCTAGGTACAGGTCTCAGAACCATTGAACAAAATCATTACATAATACTGAGTTGTACATTGCCTTCCTATCATGTTACTCATCAATGTCTTCATCATTGGTCTTCAGTTAAACACTGAGCCTCAACTCCTAATTCCCTTGGGCTAAGATTGGATTTTAAATGCTACTGTGGCTGCATTTAATAGCTAAAGATGAACATCAGAGAAAATCACATATAAATATGTGGGCTCATGTATTACTCAAATGCTAGCTTTCTTTCCTAGAGGGTAGCAATCATTGCCGCTGGAGATAAGCAGAATTCCCAAATAAGCCCTTCATTTTCAGGGTTCAGCAAAAACACCGCTGTACACAGGTTTGAGAGAATTAATAGTGTGCTATATGGCAAAGAAGTTCATAGTAACTGCCAATGTCTGCAGTGCTTAGTAAGGACACAGAGGCTGGGGCAATTTGTGGGCAGCATGTGATGTGTTCTTTGCTTGTTTTTAAACCTTTATCTTTTTAAAAAATCCAACAAATTTAAACTATTGTCTTTAGAGAGGAATAAACCAGGCACATAATTCTGTCCTACTACAGCAACAGTGTTACCTGTTAGAGGCCAGTTTTTCTCTTTATTTGTTTCTCTTGTGGAATTTAATACTTTTTTGCCTTTATGTTCCTCATGAAAATACCTTTTCAATTCCAG
>TTN-207,,0,571,1580911,1581481,GTACAGACACCTCAAAAGTATTATGCAGCTCAAGCCAGCAACCACTCATGTTTATTTGCTTATTATGATTTCCCTAGAAATGGAATTAGATTTTTAGAAATATCAGTTGTTGCTCATCTGCAATTTGTAGGCTCCTTATTATAATTGAAATATTAGGTAATTTAACAGAAATAATGTCAATACAAAGTATCTGAAATTACTACAAGTTTACCACCCTATTTCTTGAACTTCTTTTCACCATATCCATTAAGATGTAATTAACGCAGTTCCAAAAATGATGCTATAATAATGCGATAGAAAGTAGGCTGTTGTGATACACCTGGAAAAAATAAAACCAAGTCTAAAAATATTGACACTACTAATATGATTATAGTTCAACCTTTGATAGCTATCATTAGCATAAATGTCTGAGAAGCTGCTTTATCTTCTGTAACCCACCCTTACATAGAAAGAGAATTCTGCAGTACTTACTTATCAAACTGCCAACCTCCTAAGGCTTATTTTACAAAGGGGGATATGTATTGTAATTCTGAGGTGATTGTAGTAACAAAACATGTAAATGTTTTTTCAG
>TTN-207,,0,122,1581482,1581603,GTAAGTGCACTTCATGAGAAGTACATCTTCATCTATCTTATACCTTTTACTTATGATTTAATTTTGGAAGAACTGATTTTAGAAAATTAAATTTTTATTCACTTGTTTTCATTATTCCTTAG
>TTN-207,,0,1096,1581604,1582699,GTGAGTTCAATAAAAACCACAAATCGTACAATCAGCCCTCCATATAAGTGGGTTCCGCATCCACAGTCAACCAGCCCCAGTGGAAAGTATTAAAGAACAAAAAATTTAAAAATACAAATAAACAATACAGCATAACAACCATTTACACAGCACTTACATTGTATTAGATATTATAAGTAATCTAGAGATGAAGCATATGGGAGGATGTGCATAGGTTACATGCAAATACTATGCCATTTTGCATCAGGGACTTGAGCATCTGGCCACAGGCCTCCTGAAGCCAATCTCCCAGGCATAGAGAGGGATGACTGTAATGTCCCATTCACAAAAAGAATCTCTCAAGAGTCATGGGCCATCCATCTCAAGATTCAGATTGTTAAAGAACATAGGCATATAGACATTTTCACAGAAGCAGATAAGCAAATACACAACATCTGGGTGTTCTTGTTTCATTAGAATCAATTTCCGAATTTAAGAGAAAGTTTTAAGAATGAGGTGAATGTCTATTAAGATTTTTAAACAAAAAGAAATGGCCTATAAAGAAACCCCAGTATTGTCTGTGCCTAGGTATGAAACTTTTTTTCTATATATGATTTCTTATGTTATGAATGGTTCTCTAAAACAACTGTTTTAAACATTTTCCATAATTATCATTCATTTCAATATGGTTCATTTTTCAACATAATTATTAAATTAAATCCACACTCAATTTCCACACATCGTTTCCGTGATATGTATACTATTCTATTATTAAAGTTTTCCATTGCTATTATTATTTTTTCTGATATTATAATTCATTAGCTAGGCTCTTTGGTTATAAAGTTTACAGAAATACTTCTATTATCCTTTCCCTTCTTAAAATTTTCATTCCTACATCTATATTTTATTACAATGGTCCTAATCCATCTGATCTTAATCGACTCCATCTCCAAACCCACATTTTTAAATTGTTTCACAGCTAACATGGTAAAATTAATATTTATTGAATAAAGAACATAGAAAACCTTAATGAAGTATATAATCTTTGAATGATGATAGACAATTAAAAATAAGTAGAAGACAGGTGTTTTATCCTTACTTTTTAAATTTTATTTAG
>TTN-207,,0,207,1582700,1582906,GTATGCTCCTTCATATATAGCATCATGCTAAAAAAGTCACATTTAAAACATCTCACATATTCCCTTTGAATTACCAGAATCCTATAGTTATATGACGTCATTTAATATGACCTAACCAGCATCCAGAATGGAAGCTGAATATAGTCATGCGTCCTCTAAATCAAATTTTGTTTCATCTGTAATGCCTATCATTTTTGTTCTTCTCAG
>TTN-207,,0,99,1582907,1583005,GTAAAAAGAATTATGTTGATAATAAAATGAACAAGTTATTATTGAGTATTATTATAAGGGAAGGAGTAACAAATGTGTTTTAATTCTTTATTCTCCTAG
>TTN-207,,0,102,1583006,1583107,GTAAGTTAGAAAAGGCTTATGAAATACTTGTGAGATTTAAATTACTGTTGAGCACATCTGCGTGTGATATTGAACAAAATGCGTGTTGTATCACATGAACAG
>TTN-207,,0,1483,1583108,1584590,GTGCGTGAAACACTATGGAGTCCTTGTGGGTACAGCATAGGTCAATGGCAAATGTTGTGCAGGACCCCTGCAACCCTACCTGTAGACACACACCAAAGTGGTCATGTGTTCTTATTTCCCAACACACGTTCTCATAGTATTCATCTCAAAGTTCATACAAAAGCACAAGGGAAATATTCAAATGAGTGTCAGTTCTTTTGCATCGTTCTTTTAGATTTTAATCTAGTCTAAGACATAATCTTTAACAGTTATTTCTGTCTAAAGTCTAAATTTCATGATTCTCATATCTAGGATTGTAGAAAGAAAGCTAGGAAAGGACAAGATCTCATAGATGTAAATCTGGAGGATCTTGGCTAGGAATTGATATTTTGTTTATAGGACTTAGTCTGACTTTCTCTGTACAAAATTATATAGATAACATAAACATGTCATGTGCAATTAGCAACTATTTTTCAAAAATATTTATTTCATTTTCAGATCATGTTTCAACCTTCTGAATCTCTGAAATTAAGTGAAATCTCAGAATTTAGGAGTAACAACATTCATTTCCTAATTGATTATACACATTTTCCAAAGACACCCTCAAACTGTATTGAGAAAAATTTTGGCTATGATAATAGCATCTGCTTTCAGCTATTGGTGCCCATTCGTAGTTGCTGAAACACAAATATATGACATTGGATTTACATAAGCATGTCAACTTTTCTGACTTACCTTACAATGAATATCAGTGACTGGTTGTATTTTAAATGGTTTTCAAATTAAAGGGCCAGCTGCAAGTACTAATTATTTTTTAAATAATTGATATTTTTAATATAATTCTTTAGTAAATAGAGCTCACCAGAGTACTGTGATTTCTAAGACTTTATGGTACTGTTATACATATAAGACCCTCCCCTCCAGCCTCTTCTAGAAAGCACTCCTGCCATCCACACACATACTTTGTTTGTGCCCATATGTACTTAGCAGATTTCTGAACTCTAAAATTTTTCTTTTTGAAATTTAGAAGTGCAGATTTCCGATTGCGTTTGAAATTATTTTACAGGAAAAGTTATACATATTAGATAAACAATTATAGATCCTGAATAGCAAAAATTATTTTACTGAGGCAAGAAAGAATTTCACAGAGGAATAAGTTGTAGAGTACAATCAAGTTTGTGTTCCCTAACACTTTTAAAATTTAATTTGACTTTGGGTCATTAGCTCTCTTTAGTATGTTCTTTATATAAATATTTTAAGAACTCACAATAATTTCTTTACACTTTGCTACATTCGACCAGCATGAATACACTTAAGAATTGGGATACTTTTTTGTTAGTGATGCAAAGAAGAGTGCATTTCTTCTCATTTTGGATTTTTGAACTTTTCTTGCTATTTTATAACTGGGTACAAAGATGGAGATTTTAAGTATCTGAGGTAAAAGCAAGTAAAAGAAATTCCTCTCTATATAATCTAACTTTGAACCCTCTTTGTACTTAAACAG
>TTN-207,,0,208,1584591,1584798,GTGATTTCATTGACAGTTTTCCAGTGAATGTATAATTTAAGCCTCGTCTGTTTTCTGTATTTCTACCCTGTATGCGCTCATGCTCTCATTCTATCTAGAATGCTTTTTTAGAAAAGACAAGTGTAAATAAACACATACGTATATTGAAGTAAAGAAGTGTTATTTGCAACATATCAGAAAACAAAAGTTGGATGATTTTTCACCCTAG
>TTN-207,,0,101,1584799,1584899,GTGAGGTAGCGCCATCAGAAAGCCACCCTGCCATCTTCGAAACACGTAGCCTACCTATACCATTCTGAACACAAAAATATCATTTTTTTTTTATTTTGCAG
>TTN-207,,0,452,1584900,1585351,GTAAGTTGTTTTGTAAAAATCAATCCTTGCTTACAATAAATTTGGCATAATTTTGTAAATCACAGAAGCCAAACTAAAATGTATAAGATATCTTTCTCTTTTGGGTAAAATATTTTTCAATAAAACTGTTATGCAGTAGAATTACTTTCAGTCAAATAATAAAATGTTAAACCTTGTGAGTCTGGCAAATTAGAGATAATAAGGTCTCACTCAGCTGATGCTAGAATCATGTTAAATAGAATAGCCACAGAATGAAACAAATTTTGACAGTGAACAAAACTTACCTGCGTGGTTGCATACAAAAGAATACTAATATTATTTTGTCTGTATATTAGATTCTGCCATTAGATATGCCTGACATATCTCAGGATCTAATAAATCAAACACACCTTAGTTTTCTAATAAATAGCTTGTTCTCAGTCTCTCTATGCTTATTACATGTCCCTTTCCAG
>TTN-207,,0,324,1585352,1585675,GTAAGACCCAGAACCTCAACATCTGAGCTTGGAGCAGCAATATTCTAGCACTAGGAATCTGTACGAAATTTTATACCAGCGACCAAACTGCAGCAGAGTCAGAACAAAACCTTCCATGTCATATTCTTCAGTGAGCAATTAGAAATTAAAGTAAAAAAAAAAAGTAGTTCCAGTTATAAATAAATGCTACTTTTATTTGTTCCGACTGATGAATTCGTACTATAATACCTATGAAGTACTGAAAGAAATGCATGAGACTTTTCATTATATTTTACGCAAAATAAGAAACTAAAACATGTTACTAACGGCATTTATTTTCTTCAG
>TTN-207,,0,2205,1585676,1587880,GTATTATACCTCATCTACCTAGATGTCGAAATAAGAATTTCACTCTGCTGACCCGAAAAATGTTGCTTAATACAACGCATTGGCCCTCTAGTGGTCAAGAGGTGGAATTGCCTTTCAAAATGTAAATTACTTTCTCAAAGTATTAGCTAACTAAATGTGTAAGTTATGTGCTTAAAACTCTGAAAATCATCAAACAAAATACTATTTTGGTATTAAAATATTTTATTTTAATGAAATTACTGAAACATTAATAGAGAACTAATTTAATGTTTCATATTTTCCTAACTACTATGTATAACAAAAAGAATAATGGAACCAATTTCTAGTGCAGCTTATAGAAATAAACCATAGTAGTTTACAGCCAAATTGCAAATTATAGCTTGTGGCTTTTCTCAATTTATAGTATTAACTACTCTTAAAAATTTACTATTTTGTCACATAAAATATGATTTAGAATACTTATGAAATATTTGACTTCTTTTGTACCTAAGGCATGATCTCACCAATAAAGAGATCTTAAGTGTTCCAAGGAATTGCTCCTCTCAAATACTCAGTAGAGAAGTTGTAGTATTTGTGTCCCAAAGCTTCTCAACTAAATTAGACAACAGATTTCCTGGGACTTTCTGGAGTTATAGGGAGTTCAGAAATGCTGTCAGAATTCTCCCAGCATGGTCAGAAAAAATTCTGTATGTCAAAATCACATTTTTCTATAGCTAAGTCACTACTACTGTATTAGATTCAAGGGGTGGAAATGGTAGGCCCTTAACACCCGCTATAATTGGCATTAAACGCTTGACCTATTTTTCAGCCAGCCTTAGAGGAAATTCAATTAGAAACTTCCAATTTTGTGACTAATGCAACCTCATTAACAAAGAGAAGCATTTTTATGATTCATACGAACATAAGCATTTTATCTAGCTGTGAGAACAGAGAGGAACAAGAATCAACAATCATAAATTGGATTTCCATTTCTATTTCTGTTGTCAAAAATAATAACTTATGTTAATGAATGATTTGTTCTTTGACTGGTAGTATCAACATGGCTAAGTTTGGTACTCACTGTGAAACTTGAGAAGTTAAATAATGTTTTAAAAATTAAAAAAGAGGCCTGGCGCGGTGGCTCACGCTTGTAATCCCAGCACTTTGGGAGGCCGAGGTGGGCGGATCACGAGGTCAGGAGATCGAGACCACGATGAAACCGCGTCTCTACTAAAAATACAAAAAATTAGCCGGGCGTGGTGGTGGGCACCTGTAGTCCCAGCTACTCAGAGAGGCTGAGGCAGGAGAATGGCGTGAACCCGGGAGGCGGAGCTTGCAATGAGCCGAGATCGAGCCACTGCACTCCAGCCTGGGTGACAGAGTGAGACTCCGTCTCAAAAAAAAAAAAAAAAAAAAATTAAAAAAGAGTGGGCTGGGCGCGGTGGCTCACGCCTGTAATCCCAGCACTTTGGGAGGCCGAGGCGGGCGGATCACAAGGTCAGGAGATCGAGACCATCTTGGCTAACACGGTGAAACCCCGTCTCTACTAAAAATACAAAAAATTAGCCGGGCGCGGTGGCGGGCGCCTGTAGTCCCAGCTACTCGGGAGGCTGAGGCAGGAGAATGGTGTGGACCTGGGAGGCGGAGCTTGCAGTGAGCCGAGATTGCGCCACTGCAATCCGGCCTGGGCTAAACAGCGGGACTCCGTCTCAAAAAAAAAAAAAAAAAAAAAAAAAAAAAAAAAAAAAAAAAAAAAAGAGTGTTATTTATTCATGAATACAAAAGGCCATAATCAAGTATGATTAGGAACCGTGGTTAAGGTATAACAGCTGCACAACAAAGGACTTTAAACCCACTTGTTACTCTTCCTCCTAACATATTTGTGTTCGTCCCTAAGGATGAAGCAAAGATGAAAATGTGTACTTTACTATTTATGATATCACTTAGATTCACACTCCATGTTCTGAAAACTTTAACTCTCAGCAGACATAAAATCAGTGAAGATGTAAGATCACAGTACATTTTCTATATCCCTCCAAAACAATTTTTTTGCATCTAGTCCTAGATCTTTCCAAAACAAATATCTTGTAGTAATATGCAGAATCTCGCTACTATCAACATATGGAAAAATAAAATATTTCAATAAAATTCCTAGTTTCCTGAAAGCATTTTAGTTACTTACACCAGAAATATTTTTTCTTTTTTTTTCTTTTTTTTTTTTTTTAG
>TTN-207,,0,1674,1587881,1589554,GTATTATAATTAATCAAAAAGCAGTCTTAACACTTTTTTCTTGGCCAAAACTTTTAAATTCTAAACAGTGGAGGGTGAAGGAAGGGTAAGAGTTTGCAATCACAAAATGGTACCTCTCCCTTCACTCACTTTCGCCCTCGTCTTTGACTCAGTCCTCACTCTCTCAACTCCTTTTTTCCCCCTTTTCTCTTTCCTGTCCTCCTGAGCCCCTGGGAACCAATGACAACACCAGTGTATTCTGGTTATTTCTGGATGAAAATTTAAAGAAGGTCTTGCCCAGAAATCCAACAGCTATTCTTTTTTTTTCTTTTTTATTTTATTGTAAATTGACTATTTACTATTGTGTATATATTTATGGGGTACAAAGTGATGTTATGATCTGTGAATACAATATGGAATAATTAAATCAAGCCAATTAACATATCCATCACCTCAAATACTTAACATTTTTGTGGTGAGAATATTTGAAATTTACTCTTAGCGATTTTGAAATGTACAGTACACTATTATTAACTATATTCACCACTCTGTGCAACAGATCTCAAGAAAAGCCATGTTTCTTCTGTCTAAGATTTTGTACCCTTTGACCAACATTTCCCCATTCCCTCAAATCCCCAGCCTCTGTAACCATCATTCTACTCTTTATGAATTCAACTTTTTTAGTTCCACATCTAAGTGAGAACTTACAGTCTTTGTCTTTCTGTGCCTGGCTTATTTCACTTAGCATAATCTCCAGTTCTATCCATGTTGTCACAAATGACAAAATTCCCTTTTTTTATAAGGCTGAATAGTATTCCATTGTGTATTTATATACCACCTTTTCCTTATGTATTCATCCATTGATGGACACTTAGGGTGTTTCCATAACTTGGTCTTTGTGAATAATGCTGCAATGAACATGGAAGTACCCAACAGCTGGTCTTGATAAAGTCACATCAATGTAAGATCAAGGGTTGCTGCTAATTTTAAGAGGTTGCTGCAACCCACCTCAGTATCTTTCCTGATTTAGGTGATCTAAATATCAATATTTGAAGAAAAAATACTTTATGAAGGAGGATCAATTCAAATCACTTTAACTTTCAATATATCCTCGAAGATTTTTAGGAAAACAGTTGGATAACTAAATTTAAACAAATAGTTTTAACTCATTTGACTAAGATTAGAGTACAGCAACCTCCATAAAGAAGGAAAATATGGAAACACAAGGCATCATTCATCATTCAGACTTTTCTGAGTGGTCATTTGTGAAACATCATGGAATAAGAGGACACTCAAAAAGCATGGATATTTCATGAACTTCATAGTTAATAATTGAAAAAGTCTAATGTGTTATTTTTAGCATTGGACATATTAAACATTCTCTTCATGCTTAATGTTAACTTATTAGAAATCAATCTAAACTAGAACCAATTTAAATGATCTTAAATCAATCTAAACTAGAATCAAACTTTGGCCTTTTGCATGTTTGATTTTTGTTAATATGGCCTTGCATAGCATTTCTAATGAGCTAGATTTGGAAATTATAGAAGCATTATTATGATTCCTGGAAGGGCTGGTGTATGAGTAGTAGTCATAGCTCCTACAAACAACTAACAATGATGTGGAGGATTAGTAAACATTAATAATAATGTAATCTAAAAATAAACACACATTTTTATGTTTTTAAACTCCCAG
>TTN-207,,0,851,1589555,1590405,GTAAATAAAGATAAATTATTTTTATTCTGTTTATTCCTGAGATTTGCACTTCTGCTAACTATTCTTATTTTAAATATTAGGCTTCCAACTTATTGAAAGTTGTGGAGTCTCCTCTGCTGTGTTAAATTTAGCATTAGAAATGATGGCTATTTCATATTGCCCCTTTCCCAGGAAAACAAACCCAGGCAGATGTTTATGCTGCCTCTGTGCAATGGTCTCAGAGAAAGAAGAAGTGAGGGCTAGAAAGGAAGGGCCATTCCTTATTTTTTTATTGTAGTTAACACAAATGTTAAGAGTCATATAAATAATGAGAGCCCTTAAGAACTTTAAAAATCTGTTATCTAAAAGTACCTAATTAACTTGGTTACATAATTTTAAATGTTGTTTTTATGAAACTGACTAAGGGATCATATGCAATAGTCAAAAACCTAGGTTTAAAATTAGAAATGTTTTTGAAATAATAATCAGAACTTTTTAAAAAGGTTAACTGTATAAATATGAAATATAAATTCCATGAACTTATCGAATATTAAAACTATTCCACTGGAAGAAACTAGGGGTTCTGCAAACTGGAGCTCTCATGGAATAATAGAAGGTGTGTCCATTTGATAATATTTATTGAATCCATTTTTTCATACTGGAAAAATCCTCAAATCAAGAGTAGAATGCATCTTGATACTCTACTATGTTCCATAGTCAAAAATTTAAATGGAACCAATACAAAAAAAAAAAACAAATTATCAATAAAATAGATCTGAAATACTGATGTTGTTTAACTAGGTAGATTTTTGTTTAGTGAAGCAGTTGGATGGATAGAATTAATATGCTAATAGTATCTTTATCTATTTTAG
>TTN-207,,0,454,1590406,1590859,GTATGTATAAACTGAATGACTTGTTTCCCTCTTTTCTTCATTTTTGCTCAGTTCATTAAATTTTCAATGCTATGAACCTGATTTGCAGTTTATGTGAAATAGTTAAAATGATCTTAGATTTTTTTAAGGTTAGAAATCTTTTAAAAGTTATTTTCCTCAGAGTTACTTTCATGCTTTGACATTACAAGCTAAATCATTTAGTCTTATTACTAACACTAAATTCCAAGTGCTAATTTCTAATGCAGAAGTTCAAGTTTTACTTTTACTGCCTTGTTGCATCTCTGCTTGATCCTGCTTCAAATCCTAGCACTAAGAATTGTGTTGGTAATAACGATCCCAAATATAATACTTCACACGATTATATATTATCCTTACCTTATCTCATTTGCAATTAACAACCTAAGAGAACTTACCTATTTAAGCATCCCTTCTTATTCCTGTGTTTTTATTTCAG
>TTN-207,,0,441,1590860,1591300,GTAAGTAATTAGAAATATTTAAATAGACTAGAGCATCAACATCATTATCATGGCTTGTTTGGCAGCAATGTATAAATCAGCAGTTCAATCCAATAGGCACAACTTCTTCTCTAAGCTTTATTGTGAATGATTTTTTTTTCTTAAAATTTCTATCTAATTGATTTCATTAAAAAATCAAAAGATGATAAAAATTGTAATGGTAAACTTAAATATAACCAAAATATGTTAAGTACAGAAACTTGTACCCAGAGTTCAAAGTTGTGCGTAAAGGTCAAAGAAAAAAAAACCGAACTCATCTCTCTCTTTAAAAAATGATACATGTATCTGCATATACACTTATAGGTGTGTATAAACACATATACACAGAGAGAGAGAGATAGAGAGAGAGAGAATTTTAATAGGAATTCTAAAAGTACTGCAATTTCTCTAAAATGCTTGCAG
>TTN-207,,0,152,1591301,1591452,GTATTATTTAAAACATTCCTAGCACCCATGTACACAAGTAATATGTTTACTGATCTATACTCACATTAGTTATTTATATAATCAAATACTTTTAAATTTTGTGCAAAGCAATATTCTTCAAAATACAAATATATTTGTACATATTTTTAAAG
>TTN-207,,0,590,1591453,1592042,GTATACATCTTTGTGTTTCAGCTACAAGTTCAAAATTTTTTTATTTATGTGTATGGACATGTGTACATATATTGCTAAGTAACTCACAAATCTGAAACGACCAAAAACAGCACATTTTTACATAATACAAATTTTATGTTGAGTTGCACATATGTTTAATTTAAATAGTAACATTATCTACTTTGTTTCTAGTTCTGCTTAAAAATTACATTTTTTTATTATAAAGAAGGTTTGTGTTTAATTAGTAGTTTGCTAACTTCACTATGCAATGCATTCCATTGCATATAATATTCCCTGTCCTCTTATTTATAGAAATAGACCCTAACAGATTTGGAAAAGCACAACATTGTGTGTGAAGAAGTTGTGTCTATTTGATTCTCATTTAAGAATGTTTGATGAAGGCTGCATGCATTGTTTGTCCCTATAGATCAAAACATGATTTGTTTTCTTGTCAATACTGAATTTGTTCTCAAGCTACCATATTAACCCACTCATTCTGTGTCTAAATACTTGAGTATAAAATCCATGTGTTTGATCTGATGTCTTGTACTAAAAAAAAGGAATACTAATGTGAAATACTCTCTTTAAAG
>TTN-207,,0,232,1592043,1592274,GTATAAGGCAAACTGGAATGTGGGGGCTCAAATGGAAGGGTTTTAGGCAGATTTTTATCCCTCTTGTTGTCTAATTTGTGATCGTGTAGACATTTCTGTCTCCTTGTAAATTCTGTCATCTTTTTCATTTCATGTTTGTCTCTGTTTTCATTTTTATTTTAATGTTCTTTGTAAATTACAATTACCACCCACAACATGGCATATCAGTAATTAAAATGTACATTTTTTTAAG
>TTN-207,,0,1028,1592275,1593302,GTATTAGTAATTCATTCTAAGTTTAAACTCTTTTAATAAAAATTAGTACAAATACCATAGTAAAACATTTATGTTAGTATTAAATAATAGATTTAGTCACAGTGTGCATACCTATAGCCACTATGTACAAAGGATGTGATGGGGGACGGGAAGAACCATGAGGAAGGCACAGGGGGAAAAAAGTGAAAATTATGGGAGGCTCCATTCCCTGCTTCAGAGAGTTTGCAATCTCGTAACCTGTTACTTGGAAATACAGTGTCCTGGAGCCAGTTCATGCTAGCTCACCAGAGCCTATGGTTACATTTTCAGGAATTTTGCCAGTCAGTAGTTTAACACCACCATTATTAAAAATTAGATTATGTAAATTTACAGTCCAATAAAGTATATTTTTAAATATTAATAAATACTCAAAACTCCTATTTTACTGCATTTTGTTCTTATCTGTGTTTCTGAGATTGTTTCCATCTTTGTGTCTGTGTGGTGGAAATGCCATATAATGTACTACTGCACATCTCTTTCCAACTCCAGGACAATGACATCACCTTGACAGCCAGGGTGGGAGGGAGTGTTTATACCACCTTGGAAATCGGAAATCTGCAAGCACTATAGATCAAGGCTCCACCCCCTCCATCCCACCCAAATTGTTAAACATTTAAGACACAAAAAAATCTAATGCAATTGTATTTATGAAACTGCTTTATAAAAGTAAAGGTTACAAAAAAAAAAACTAACTTCATAGTTATCGATGTTCATAAAAAGCTGGTTTCTGAGGAACTGACACAGGCACCTCCGAGGGAGGATTGCTCCTACCTGTTCCTGACAAAGTAGAGGCTTCTGCAGTTAAAGGTGACAGCAGTCACATTTTCTAATTAGCCATTCAGCCATCTTCATTTACTCTCATTTCTAAAGCATAATTTTCTTGCATTCAGTTGGTATAAAAAGGGAATCTCTATTTAATTCTAAGTCTTACAACAACATATGCCTTGTCAAATGCACACTTTCTCAAAAATGGCACTTTTCTTTTAAAG
>TTN-207,,0,397,1593303,1593699,GTAGAATAATATTTGTGAAAAAAATAATTCTTAGCATCCATCTTGTATCTTTTTCTATAAGATCTGTGTATTAACAAAATAGCATCTGTAAACCATCTATAATATATTTAATTCTGTGTATATTGATTTCATTTATTTGTGGTGATGTGTTATACAAGTATTGGTAACATTTCTAAACTCCAGATCACGCTAACTGGGTCTTTGTCTGCTTGTGTAATGTATGTAATGTCTATATGGTGTTGAGGTATTTAGCTTTCATTTCTACCACAAGTAGGCATATTTAAATTACTTCCTAATTCTCACACTGTTAGTGAAGATTTATGCTTTAATGTAATCTTAGATGTCTCAGAAGGTGACTAGAATATTCCACATTATTTCAACAATTGTATCTTTAAAG
>TTN-207,,0,2119,1593700,1595818,GTACGCCAGAGCCAATGATGGGGAGACTCTTTGCTCCAAGTGCCAGCCTTTTGCTTTCTACGATCTTCATATGTACTATGCTGCCTTTGTCTTTTGTCTCTTTTACATTCTTCTTGTGTTTTTACTGTTTGTCAGCTTCCGTGCCATGCTCTTGACATACTTTATTTATTATACTGAATATTCCTAAGACATCACCAAAAAGTATTGTTAAAGGAAGTAACTATGTCAAACTGCTATCTTACATTTTTAATATCTTCCCTCTTTTAGAGAAAGAGGAAATGTTTGTGAAACTTGTTTTCTACTGACATGTTTCTAGGAAAAAACCTTTCATCCTTCATAAATGTAACTTTTTCTTAATAAAAGCAGTTTCATGCATTATGAAGAGGTGGAGACAGGCAATGACAACTGGAGAGTGTCTGGCAGAACTGAATGTTAATTACATAAAGACGTACATAGTACCACGCTTCTTAAAAGTCAATAGTGGCGAGTCTTCAATAGTGGGGAACATACAGATTTTTTGAAGTTTACTTTCACCATTTTCTTGAGACCTTAACTGAGCTTCAGTATTTGCCATAAATGTTTCCGTTATCTAATTAGCTAGTCAAAGTACCTTTCACAGAGGTATGTTTGAATGAAAATGTGCTGCTGTGGTATATCACAAATCCCTTGCTTTGGTTTGTTTGGGATTTTTTTGGCGATAAAAGGCACTATCTTATTGAAGCACTGAAGCTACAATTGCACGCATCCATTCAGTTATAGAGAGACTCAGCAAGAATTCAACATTATCCAATTTAGGAGAAACCAGACCTAACTAAAATAGTACATTTTGAATAGTGTTCCCTTGGCCTGACTTTGCAATGTTTCTATTTTCTTCCTGAATCAAATATGCTTCTCTCTTTCTCAAACTCTTGGCTCTTTCAAAATTCTTTTGATTATCTAACCATTAAATACAAAGGTCATGTTAGTAAAACCAATACTAATACTAAAGCTACTTGAGACAGATCGTCTTAGATAAATTAAATCCATTGTTATTATGTACTACATTTCCCCATACAAAGCATAAAGAACCTTTTCTATATACTATCTGAACATTCTTGACTGTTTGTGTAATCACTAATTCGTTTTCAGCAAAGTCATATATGTCTTCTAAAGGAGACACAGAGGCATCTCTCATTTACTCATAAAAACAAATACACATAGTATAATAGCACGTATATATATATAAATACTGCATGTATATATAGCATAACATATACATATATAAATTAACAGCTATATAATTGCACCAAAATATTACAAATGCACGTGCAGAGGTGCAGGGATTCACAAAAGCTGCCAATATTGTATTTAAAATGAGAACAATTATTGCCAATAATGCATGCTGTTAAAATTCATCTTCCAATTAAAAAGTCAACATTATCCATTCTTAGAATAGATAAATCAAATACACTGTAAACATTTTTTAGGTTGAAAACCCTGTTCAAAACTCTAGAGCCCCTTAGAAAAAAAAAGCACAAATACACATACCCACAAAATTCTGCACACAAAGCTCTGTAAAGTCATTAACACATGGGTATCAGATTGAGAGACCTACTCTAGAGTGTTTCCTGAGTTTTGAATTCACTACAGGCACACCCCCCAAAAATGAGAGGAGAAATGTGGGGAAGAGAAGTAAGTTACACATATTCAACTATTCTAAGACTTCTTAGTCTTAGTCTAAAATAGTCTTAGATAAACTAAAGCCATTGTTATTAAGTACTCCATTTCTCAATACAAAGCGTAAAGAAGTTTTCTATATACCATATCCACATTCTTGATTGTTTGTGTCATCACTAATTTGTTTTTAGCAAGGTCATACAATATATAAAGGATGAATTCTGTGCACAACTTTGTTACATAACTCATTTTTGCCTAAATGCCTCTAAAACATTATTTGTGATATTTATCACATTGTGATCCTTGGAATAGTATAGTTAGTTTAATTTTCTGGATAATTTTGCTGATGCATAGATAATCCATAACAACATTAATGTACTACATAAAGATTTGTGCATGTGCCTATGTTCTTTCATAAAAGTGATATATGTCTGAACTAACATTGTGTTTCAAAAACTTTAAG
>TTN-207,,0,217,1595819,1596035,GTACAGTGGCTTTCGACGTAAAGCCCTATCTTTTATCTTTGATACAAAATATGTTGTGTTTAATTATCTGTTCATTGAGTTAGTTTAATTCTAAATGAATGTTTTGTGGTGAGAACTGAACAAAAGTGTCTGTCCACCCGTCTGCTTTCTTAAAAAAAATAACTGTGCATAGCTACTTTAGAAAATATAAAGTCAATTCTAAAAATGTCTCTTCAAG
>TTN-207,,0,141,1596036,1596176,GTACTTAATCCCATCTCCATGAAATAACCTTGTCTTTCCTTCAAGCCTCTTTAATTGCATGTCTTCTTTAATTGCCACTTCTATGTTGCTCATTTATTTGGCCTTTTTGACAAATTTTAAAATTCAATACTATCCTTTAAG
>TTN-207,,0,153,1596177,1596329,GTATTGTTTCTCCATCTTCCCAAGAACTGTCTTTATGTTCCAGTGATTTTGTTAGTTTTGTGATATGAGTGCACTGTGGGTGTATTTCTTTGTTTTGCACTGGGCTTCAATGAGATCACATTAAATTTCTAAAAGTGCATAATGTCTCTAAAG
>TTN-207,,0,274,1596330,1596603,GTAGGATTTGCCTCAATCCTCTGACAAAAAAAAAAAAAAAAAAAAAAAATCTTCGAGTGTGTTAAATTCTTGCTTTTTCCATCTGGTCTGTGCTTATACTGATCCATTGTCTCACTTGCAGTGAAACTTTTGTGTTTATGTCCTTGTGATATGTAACTTGTTTTCCCATTTTGCTAGTCAAAGTGGTGTACTGTGCAACTCTTCCCCAAATTCTAGAAAGTGAGAATTGTTAAAATTCTTGATTTTAAACTTCAACTTTAACACTTTCTTAAAG
>TTN-207,,0,452,1596604,1597055,GTATATAATCGGAAGTCAGGGGATAAATGAGTTTGTGTGTGTTTCCTCAAAGTCTCTTCTTCTTCCACATGTGATTGTTTACTTTAGAACATGTCCTCATCAGTTATTTCTCCTTATGTTGGTATTAGAATGTGTCTACCTTTTGTAGCCTTCTGGGACTGAGTCTTTTGTGTCTATGTTGGCCTTGAATCATTCGAAGGAAGTGGATGAGTCCCGAAAATGTTATAATTTTGAAAGTGGCCACACTTGGACATAACTCAAGTATCATTCTCAGTCTTGGGCTGTACTTGCCCTCATCTTAAATTAGCTTCCTCCTTCTTATAGTGAGGAAGTACCATGAAGCTATGTCCTAAGCAGATAGAAGAACAGTTATCCATCTGTAGTGACCACATGGCTGTATATACATCTGTATCTCAGCAGGCTGAATTTAAATGAAACCTTATCTTTTAAAG
>TTN-207,,0,2512,1597056,1599567,GTAAACAATGCAAATAAGCTAGAGATGATCTGGGGTTTTGATGAGGTGTTTTCTTTCACAAATTGTCTACAGACCAATGAAAAGAGACAGAAAAAAGTGACACAAATTCAGTGAACATCTACCAGTCTCATTAAATGAATATTTTGATCAAAACACAAGATTCAGGAGGATTATACTAGATTAGAGAAATCCAGTGTATTTCTTCTGCATCCCTTCTTACTTGCCTACATAGAATAAAAGAGGCTTCATATTTATATATAATTAATCAGGGCAGGTATCTCCATATACATATATCCTTTCATTAAACAGGACTTGGCTTCAGCATGGTGGGCTGGCATAAGCTTTACCTTAGTAGCCTAATGCCTAATTGGTGTTTCTCAAACATTGCTTGTACCACAATCCACAGACAGAAATATATTTTATATTATAATCCTTTAATTTTTTTATTCTAGGCATTTAAAAAATACAAGTTATAATCCATTAAGTCAATTGCAGAAGTCACTATAATGTCTTAAAATGTTTTAAAATGAGCAAGAAAATATATTACCTCATTACATTCCAGGAGTCAATGCCATATTTGTGAGTCTGAAGCCCTGAACACATAAGGCTTTCCTGTATTTTACATATGGAGAAAACCATTGTGTTATATATGGGATCAGACTGACTTGTTACTCAGATCTTTTCATACCTATAATGCTAATTATCTATAGTTTCTTAAGGACAGAACCAACAAACTATTCCATTGGGATATTTTTTCAATGAATTAAGGCAGCACCAGGTTTCCAACTAAAATCCAGCATTCTGGCTAGAGCCATGTGGCCAAAAGAACTTTCCTAAGAAAGTTCCTAAGGTCTGCTTTTAAAGAGAAATCAATAAGCTCCTTAACCAAACTAACTCTCTCCCCAGTGAGAAGATGAGTAGAATTGAAGTACATTTAGATGTCCCAAGTATCTGTTTTTATCTGTCTAATAAAAGATGGCACACCATGCCCCTTTTTTCACTTGGAACAAAAGCCCATGTAAAAATCCAAGGTGCCATAGTCTTAGTGGAATGCCTTGGAATAGGCCAAGATGGGACATGACTCCCAGGAGGAAATCCATTAACTCTGTTGTGCTTCCTGGAAGAGGCCATGATGGTGGACATAAGTCAGGAAGCTGGTAGATTTGAAGACGACTCCATCTTTTCTAAAAGTGTTTGTAAAACCAAACATAGTCTGATTTCAACTTTTGACACTATAAACTTCCTGTAGTACTCCAGACTCTAGTTAAAAGGAGAAACACTGTGATTATTTTTATGTTCTCATTATGCCCCAAAGATGGGTGGCTTGTTAGGTTTACTTTCAGCGTAAGGAGCAGATATGTTTTTAACCAGACACTTCTATTCCTTATTTAACTTTGACCAGGCATGGTGGCTCATGCCTATAATCCCAGTGCTTTGGGAGGCTGAGAAGGGAGGATTGCTTGAGCACAGGAGTTCAAGACCAGCCTATGCAACATAGCAAGCCCCATTCTACAAAAATTAAAAAAACAGCTAGGCATGGTGGCATGCACCTCTAGTCCCAGCTACTCAGGAGGCTGATGCAGGAGGATCATTTGAACCCAGGAGTTCGAGGTTACAGTGAGCTGTGATTACACCACTGCATTTTAGCCTGGGCAACAAAGCAAGACATTGTCTTAAAAAAAATTAAAACTGGCCGGGCGCGGTGGCTCACGCCTGTAATCCCAGCACTTTGGGAGGCCGAGGCGGGTGGATCACGAGGTCAGGAGATCGAGACCATCCCGGCTAAAACGGTGAAACCCCGTCTCTACTAAAAATACAAAAAATTAGCCGGGCGTAGTGGCGGGCGCCTGTAGTCCCAGCTACTTGGGAGGCTGAGGCAGGAGAATGGCGTGAACCCGGGAGGCGGAGCTTGCAGTGAGCCGAGATCCCGCCACTGCACTCCAGCCTGGGCGACAGAGCGAGACTCCGTCTCAAAAAAAAAAAAAAAAAAAAAAAAATTAAAACTGTATACACTTAGGCTCAAAAATCATGTGAAGCCTCCTGCCTCTTCTACCATACCTGCCCCACAAAACTGGCGGGGAAAACAATATGGAATATTATCTTACAATTCACTTAAATCCTCAAGTATGTTTCTGCCCTGTGGCCTTCAAATCTACAGTGCTCTGCTATTTGTGAAACTCATCTTCAAATTCTTCTGTTCTTATTAACTCAGCTATTATAATCGTTTCTTGTCCCGTACTTGTCCTGTCGTTGCTGTGGATATAAGCATTATTATCTGTATGACACATTTGAAAATTAAGTTAATGAAACCTATTTCCCATTTCCCATACTCTTCATTAACGCATGTGCTTTGATTAAAATGCTCTTTGAGTATTTTAAATAGGAACAAGCAGGGGTTTGGCAAGGGTTAAACTTTTGCTATTTTGATTACTCTTTGAAGTGATAAATTAAAGCTAAAAATAAACATGAAAAACACTGTAATTTATCTTCTTTAAAACTGCTGTCTTTAAAG
>TTN-207,,0,187,1599568,1599754,GTATGCTGACTCTTTAATTAGTTTTATCCCTATGTTAGCTTGTCTCCTTCTTTATGTTTCCTTATAGCTAATTTGTCATCCATATTGCAAATATTGATAAATATCATGTCTAATAAAAAGATCCCTTACACTTTTATCGAAAAGAAATCTAGACATTTCTACAAACATATTTTATAATCTTTTCAAG
>TTN-207,,0,263,1599755,1600017,GTATGATTTCTTTCAAAGAAATGCAACACTATTTATTTTAATGTATATAATAATACCTTCACATTTGCATAACTGTCTTATGCATAACAATTTGCATAACTGTCTACGTTTTGTCAGAACACATGTATGAACGTATTTACTGAGTATAGTCATTAACGTTTGTATATATGTGCAATCTTTTCAAAAAGTGAATGCTAAGCCCCACAACTGTGTCACTTCATATGTAAGGCAAACTCATATTCTTAAACCTAATCTTTCTAAAG
>TTN-207,,0,156,1600018,1600173,GTATATTGGATTTTATTTTATTCTCAAGACTGTCTTTTTTTAATCTTAAATTGATACATTCTTCAGATTTTTTAAACATTAACCAGAAAATAAGTGTGCCTGTGTTTAGTGTTTTCCATATCGTATGTTTGATGGTATTGCCTGGTATCTTTTAAG
>TTN-207,,0,252,1600174,1600425,GTAAACAAACCTCCCCAGCAGAAAAACTAGGAACATATGGCTTGTCTTTCTTTCTCTCTGCTGCTGTTCTTTGGGTCATACTGTTTATATGTTGGTGGGTGACAATGGTGTCTTTGGGTAGAGTATTACTTGTGATGTTTTTGTGTGTGTGCCTTGTAAATTCTTCTATTCTAAAATCACAGTACTTTCTGGCTAGTATATTTTTTACGTCCACTTTGATATAACTCCCTAATCCTAAAATTATCTTTTAAG
>TTN-207,,0,247,1600426,1600672,GTACATCCGCCCTTCCATTATGCACAATATTGTACTTGCCCTACTCTCTTTACCAAATACACTGGTTATGGGGGCTGGTTTTTGTTGTTGTTGTTGTTGTTGATGTTGTTGTTGTTGTTACAGTTGTTGTTTTATGTTTGAAATAATGAAAATGTCAAGTGTTTATGTTTGGGCTACTACTTTATGGCTGCCTTTTTGTGGTTTGAAAGAGGGAAACAATACTTTAAAGTGAAATCTCTCTTTAAAG
>TTN-207,,0,707,1600673,1601379,GTATACTGACTCTTAAAAAAAAAAAAAAAATCAAAATAAGCATCCAGACACTAAAACTAATCTAGTGGAATAGGTTCCATTAGAAAAAAAAAGACATAGTATAAAGTAAGCAATATAAGTTTGTTAATGCATATCACTTCAAAACTAAACATTTTTGATAACAGAAAGTACTTTTTTCTTAAAAAAAAGTGAGGCTTCTTCTAAACGTATGTGAATAATTTTCCTTAATCTGTATTTGTCTTCTAATGTCTTTTCCATATACTAAACTCATCTGCCTAGATGCTTGCTTTATGTGGCAATCTCTGATGAAATTTTTAATTTTTTCAATTCTGAATTTTCTACATTGTACCAATAGAGCTAAGGAAAATGTCTTAGAAGTGAGGTGAAGAAACTATTCATGTAACATAGGTTTCTGTCTAATGCTTCTACTTAGTTTGATAGTCATTATTTATGCTGTTTAGTTGTCTTTTTAAACTTTTATAAATACTACTTGATTTTCCTAAAATTATTCAATGTCTTTGACGTACTTCATATGTATATTAGAGTAAGTTTATTTCCAAGTCTATTGATTTTCTTGCTTTTTAAATGAAAGTTTAATCAGGCACTGTTATGGTTGTCTTTGTCCTTGAATTGTTTGAACAAAATTTCTCTTCACACACACATTTTCAGAATCTTGCAATTCACTTTTAATAATTACTCCTTTAAAG
>TTN-207,,0,307,1601380,1601686,GTATATTGAACTTTGATTAAGTAATGTGAGGCATGAAACTATCTGGCTCTTTGCCTTCTAGTTCCCAATCTGACTCCTATACTTTATTAGCTTATTGTTGATTAAGGGCAGGGTATATAACATTTGAAATCACAATTGCTAAATATACTCTATGATACCTTGACTGGCCAAAAAAGAACAGTCAGGGTCTCCCATAATCAGTGCATGAAACAAACGCAAAAGAATAAAATCAAAGCACATTGTTACTATCAGTCATCCTTAAAAGTGCTTTAAAGTAAAGTGCTGCCTGTTGTTAATATTGTTTCAG
>TTN-207,,0,958,1601687,1602644,GTATGAGCAAAACTGCAAACTCAAAACCACACTAAATATGTGCACACTCAAACAAGATAAAACAAGATAAATCATAACAAGATAAAAATTTGGATACCCAAAGAAATTTGGAAAGAACTTTGTTTCATTTCGCAAATGCGGAATTTTCTTCTTTGATAACTTCTAGAAAAAATTTTAAAAACCCTCTATAAATCTTAAGGTTATTGTTAGACTTTTGTTCCGGGAATAATCTAATACCCCCCTCATTTTTGCTCGTATGCAAAATAGCAAATGTCCCTAAGTTTCTTTTTCAAAAAGGTTACAAGTTTATCTTCAAGTGCCCGTGATCATTCTAGTACATGGTTAAAAATTTCTGAACATCCTTTATTCTAAAACTTGCTATTACGGAGTATGATAGGCTATTGAGAAAATGTATTTACCCACAGGGTTCCCATTATCAAAACTTGACAATGACTGCTTCAAAAGTTAAGATAGAGATGTAAGCTAACACAAGCTGTTGTGTTTTACCTAATGAAGGTCAAATTTGTTGGCATATAGTTTGGGCTTCAAATTGTTTATTTTACTCAAAGAATAAATCTCTATTGAAATTTTGAAATGAATCAATCTTATTTCACTTATTCAGTCTCTGATGTTTCATAGCCCAACTTTGAGAACATTCTACATAGTCTTACTGATAGCTTTAAAAAAACCATATTATAGGGGAGTTTCAGCCAGGAATTTATCTACCTGAAATGAAATGAGAATTTTAATATGTAAGAATTACCTAATTAAAGAAAATAGCAAGAAGGAAAGGGCAATATGAGCTTGTTCTGCTTGGATCTCTGATTCTTGCCTACTTCAATAGGCTATGGCTATACTGTAGATAAAAGATATTATTTCAATTATTTGATTCCTTTTAAGAAATGTTTAAACTTATATTCTAAGTCTAACATGAAATACCTTGTATGTACTTTTAAAG
>TTN-207,,0,210,1602645,1602854,GTAGAGTGAAAAAAACATTATTACCTGTAAGAGATCTTTGTTTCCTCCATGTCTGTCCTACTATAAAAATATATGTAAAAGTGGCAGTGTACAAATTATGTGTGTGTTTGGGAATATTATGTTGTATTTGTCTTTCTTAACTTTTTGTTCTTGCTAGCCTTGAGAAACCTGTTTCAATTTTTAAAATCTCTTAATATTGATATTTTGAAG
>TTN-207,,0,204,1602855,1603058,GTACATTACTGAGTAATAATCACCAAAAACAACTTTGTTATGTATGTTCTAAAATCATGTCTTCCTAGCCCGTCTGATGGTCTGTGTTTTTGCTGAGTAGGATGTTCTTGTCCTGATTCTTACATTTCAGTTTTTTATGTGTATTTATTACATAGTATTCAAGGAGTTGGTTTTAATGCTCTTTAATAATTAATATCTTTAAAG
>TTN-207,,0,747,1603059,1603805,GTATAATGATTTCCTTCCTCGATTGTGATCTTTTCTGATGCCTCTTTTGAAATTAATGTAACTATGATTCATTTCATTTTGTTGTTTCATGTCTTTTAAATTAGTTGTCAGCAGAATGTTGGATGTAAAAATGTGTAAATACAGGATAAGAAGATAATGCCTTTAAAAGGAAAAATTATTTCTAAATACATCCATAGCCTGTTAGCCAGTGGCTGTGTCCTGCCACATGGCTACAATACATATAAAATAGAATGTTTGGGTTTAAAATCAGTGACCGTTTGGCATATTCCTGATTTACCTAAATGATGTAATGATACCATAATATTCACCAAGCTTTGGTAACTGTTTATTCATTCTAAATTCATTTTGAAGATTTTTTTTAAAGCTAACCAGTTTCCAGTCATTTTCCCCCTGATTCATACTAAGTATGAAGTATACTAATTGAGAAGTAAATTTCACTTTTCAGGAAGGATATTTCTTTCAAGCAGAGATATTTGAACACTAAACCTCATTTCACATTTGGGCTCTGCTACTTCATGTTTACTTGGGTACTTCTGTGTACTTGTATTTATATGAAGCTCAGAATCCTTTCCACAGAGAGTATATAGTTTCTTAAAGATGAACAATCGCATATGTATCTCATTAAAGGAAGATACATTATTCTATCTGCTTAAAGTACAGCAAAACAAGCATTGGCTGGGTGGCCTTTTACTGACAATAAAATTTCCTTATACTTCATATTTCAAG
>TTN-207,,0,198,1603806,1604003,GTACCTAATGGCACTCATTTTAATGTTTTGTTCGTCTTTTGCTGTTGAATTCCTCTTCAGTTCTGTGTGTGAAAACTTCTTTTGTGGGAAAAGTAAATCTTGTCCTTTCTTCTGTTATAAATGGGCCTGTGTTTCTAAGGTGTCTTAATTTTGTTGAGTCATTGGCAAATGTCCAACTTAAAGATAATATCTTTAAAG
>TTN-207,,0,211,1604004,1604214,GTAGATGATGCCTCCTGCAAAGGGCTGTGCAACAGCATCTTTGGAGTTTGGGGGTCTGATTTGGTCAGATTCTGGGGGTTATTGGCAGCACCAATGATTGCTTACTTTAAAGCAGATATTTTTAGATGCTGAAATATGATTTCTACAGGTGCTTTTCACATTTTATTTCTTTCCTGCAAAATTTCCAACATTCTTAATAATATCTTTAAAG
>TTN-207,,0,182,1604215,1604396,GTACACCACCATTCATTGACGGGTATCTAAGAGACTTCATCTGCCTAGAAATAGTTAACTTTCTTCTGAGTTCAAAACCTTGTGTGTGTGTCACTGTCCGTTGTTAAAAAACATTAGCTGTGTTTTATATGGATGTGTTGTTACTAGTAGTTAGAACTTAACAATAAACAATATCTTTAAAG
>TTN-207,,0,508,1604397,1604904,GTACATCCTTATAATCCATCAGTGGAATAGCATGATAATTCACCCATGCAGCATAACTTGGTGAGCCATAGCAGATCTTTCCCCATGACAATATTAACAACATTAATGCCATGACAAGCGCCTCTCAACTGGCCACAGGAGCAGTTTACCCGGTATTCATCTCTGAATTTTACCATCAAATTATGCTTATGCTCAATGGTTGGCTCCTCCTCTTTAGTGGAAAGTTCTTCAAGTAAAATACATTCCTTTTGCATATCAAAATGGACAAAACCATCATTTACCAGGCATTGTGTCTTGTCTTTATCACCAGTCCACGTTTTTTTCGGTGTTTTTTATTTTAATTTTTGTGTATTTTCTGGCCTTTGTTTTGTGGCTATTATAATTTTCAGTCTTAAAGTGAAATTGATAGAATATCTATGCTGCTTCAGTTAAGGCCTTACATTGCCAGCCTTAAAATCTTAGCTATGGGTAAAAAATGTGACACTAACTCTATTTGATATCTTTGAAG
>TTN-207,,0,249,1604905,1605153,GTACATGAACTTGCAATGTTGCAATATTTTTATTTCACATTTGCATATGGGTAAAAATTAATTGGTTTAATTCTGTACTCTTTGGGATGCAACTCTTTAGAGAAAATTAAATATTTTATTTTAAAAATAAAATGCTTCTTGGAATACCTTTGTCATACTTTTATTACCTTATCTTAATCTTTTGAAACTATGCTTGGAATCAGTATTTTTATGTCGTATAAAATTTTTCTCTAAATCATTTCGTTAAAG
>TTN-207,,0,205,1605154,1605358,GTACATAATTTCATCACTTAGAGTACTTGGGGGAAAAAACTCACATCTATGTATACTCACATACAAATTTCCCCATTACATTGTACATTTTTAAAGTGTCTATCTGGTTAGAAATATGTCAGATATTTTGTGATTCTTTTTCATATCTATTGCTCTAAGACATTTTAAAAGAACATATTCCTAAATATAAATAATATCTTTAAAG
>TTN-207,,0,207,1605359,1605565,GTACATTAATCTGTAACAGAGCCATGGTAAAAGACAAAACTAACTGGTGTTATACAGCCTTACTAATTATAATTAATGCTTAGTATTTATGTTGATAATAATTGATGCTTTGTGATCACAGAATATTTGCCTTTCATAAGCTTCTTCATTGTTGTGAATATTTTACATAAAAGTGATGTTTGTACCCTTGAATAAATATCTTTAAAG
>TTN-207,,0,333,1605566,1605898,GTATAGCAGCTCTTCTTGGAATCATCAAGGCCTCTTTTGTGTTGAATTCTGCTTTCCCATCCTTTTGTTCATCTCCAGTTTTATCTATAATCCTTTACCCTCTGTGATTGACCACCTAAATCTTAGAAAACATTCCAGACATGTGTGTTCTTATTGTGTATCTGCCTTGTGTATCTGTCTATTGTAAATTATCTAAATGTCTTTTCAAATCACATATTATGTTTACATGTTTGTGGTCTTATCCTCACGTGTCTCTTTCATATATATATATATATATATATATATGACCATGTATATGTGGTTTTTAATGCCTTCAAATGAAATGTTTTTAAG
>TTN-207,,0,1205,1605899,1607103,GTACACCTCCCCAAAGTGAATACACATTGTTCACCCATAGCTTGGTCACATAAATTATGATGAAACTGGGTTTTAGGAAAATTATATTTACAAAATGGATAATCACACAGTTACATATTTACTTCTAACGATGTTCAGGAACACTGATATCTACTTTTTTCACTGATACAAAGCAGTATTCAAGAACAAAGATGAAAGGAAGCATTGTCCCAGAACTGATACAAAAGTTCTGATTTCATATCATTTGATTAAACATCATAGTTTTCATGGAGATATATTTAAATATATATGAATAAGTATACTATATATTTAAATGTATTGAAAACTATTATGAATAAATATTCTTAAATTTCTTCCTTCAACCATTTATATTAAATGCCTTTTTAACACCAGGCTAAAAAGAAAAAAAGATGAATGTATTTATCAAAACACAGAATAATAGTTATGTCTTCTAATACATATATATAAAGGGCAGCCCAACAGGTTTTGATTTTAGCGTTGACTTTACACCTTGTTGTATTACTCTCAGCGAGTCCTTTAACCAACCTGAGCCTGAAGTTATTTTCCTGTAAATTGGGGATGCTAATATCAGTCTTAATGGGCTCAGCTATTATGGTGAGAATTAAATAAAGTAAGGTATTAAAGTAGTCTATCATTGAATGAATAGTATCCAGATTTAACATATTCAATCAGCTCATAGTACAGGACAGAATTAATATATTTGTGCTTTAAAGCTCAATAATATTTTCTACAAAAGATGCTGGCATGGCTGCTTAAAATCAGCATAACCCTCGCATCAGGCCATATAGTTATATAATCAAATGAAATAGTAAAGCTGATCTTTTATTGGATATCAACGATTCAGAAATACTTTCTAGACAATAAATTACTAGTGAAATTTAAATGTATGAAATGATATTAGGTTGGTGCAAAAGTAATTGCGGTTTTTAGCATTAAAAGTAATGTCAAAACCGCAATTATTTTTGCACCACCCTAATAGCATCTGTCCTCTGATAATGACATATGCTGCTGGTCCCTTGCTTTACAAATCCCAATTACATTATAATATCTGGGCTCCCAACTAACATGACAGACCTGTCTTGAGCGACTGTTAACACATTGGTCTTTCTGGGTGTGGGGTCTTCTTGGTTTCTCTTTTTTTGTCCTTCAAAATAAATCCTTATCATGAAATGATGTCTTTAAAG
>TTN-207,,0,166,1607104,1607269,GTATTGCTATTCCGAAGTAAATTAGACTATGCCATTTCCTTCCTTCTCCTATAAAAGTCAAAATGTCCTGTTTCCGTATTTGTTAATACAACTTATATTACTGCTGTGTCTACTTGTCTTTGTGTGTGTGAAACTGAACTTATAAAATAAAATAATATTTTTAAAG
>TTN-207,,0,557,1607270,1607826,GTACATCATCCCATAACAGGGATATGTTTGCTGCACCGATGTTGAACTGTGGTTCTATCCACACAGGACACTCAACATAAATGTGTGCATTGTATGGTCTGTCATTCACATTCGTCATTTCTGACTCTTTTGCACCCAAGTTTGTGTTGTGTCCATTTTTTCACTTGGTGTTGGTGTGCTTTACATCGTTTCTCTATGTATGTTGTTTCTAAAAAATAAAAATATATCTTTAAAGAGCCAAAAATAACTAAGGAACTAGTCCCTGAAATACCCATTTCTTCATACCCATTTCTTCCTACAAAAAAAAAAAAGACAAAAGAAAAAAGAAATAGAGGCTCCAGCAGTAAAAAGTAGAATTTCTCTTTAATAAACCCTAAATCTTAAACCACAAACCTTTTTATTCTTTTCTCATTAACCGATTCTGTGAAATGTCAATGTTTCATCTTGTGTATGTGCCTTGTGATATTTACTCTCTTATGTTGGAAACTGGAAACGTGGTCTTTATTCTTCTTTGGTTCTTGCATTTTAAGTGTCTAAAATAATCAATGTCTCTCAAG
>TTN-207,,0,629,1607827,1608455,GTAGATAACTTTCTAAGAAAATAACATTTCAAAGTCATCCTTGTCTTATTATTGTCTAATATTTGAAGTAGGTAAATGTAAAATTTACCCCAGGAAATCAACATATTCAGATTCTAAAATAAATTATTATTAACCTAATAGAAATTGGGCAGGCAAATTAATATTATTTGAATCTCTTTGCATGTTCAGCCTGTTTGTCTGTTTGCTATTTGTTTTATTTTAATTAGAATTCATGAAGGGAAACTGTATTTGCTGTGGGAAATTTTTCATCAAATGACTTAGTAGGCAACTGTAAAATAAGCTTATCCAAGAGAAATTCCAGTTAAGCCTGAGTAACTGGTGCAGAAAATCTGATTTCTACCCCAAGTGGCTGTTTGACTTCAAACAAGTCTTTCATTAAAAAAAAAACAATAATAATTTTTTTATTATTATAAATTATCTGAAGTCCTTTCCAGTTCACAAATGCTGGGATATGCCTAACATATTTTGAAGACCCAGTAGAGATTTTTTAAGGACTAGTGAGTTTACACAAGCGTTTCGAAGGCTGAGCAGTTTTCAGATATTATCACTGTAGTCTAATATTCAAAATAATTATAAAAATAATTTACAAAATAATAATCTTTTTAAAG
>TTN-207,,0,603,1608456,1609058,GTATAACCGCTTTTAAGGATTGAACATTTAAAATTCCTGGTGTTCCAAATCTTTCTCAGTAGCTAAATCTAAGATTCACCAGTATGCTTTTCTTATATCGTATCCATGATAAAGTGAAGATTAATTATTCCTGGCACCTGAATCTATGTGTCCTTTTTTTACCCTAAATTTTTCTACAACATCTGCAATACAACTAAGAATGAGAGATTACTATTTTGTTATTGGCGATTGAATTTTTTTCTGACCAGGCCCTACTATAATAGTTTCTCCTAGATTTCAATCCTTAATTTTGTTTTTAATATTAATATGGGGGGAATCTATTTCTCTGGTGAAAGTGTTCATTTTTTAAGAAAAATCTTTAATTTACTATTCCTGAAGAGTGTGATAATATTTTGCATAATTGGTATTACATTTGCTTATAGGATTTCTAAGTAATATCCTTTACACCTCTAGGGTTCCTACTCCACATTTATTATTACCATTTAGGTTGCTAATATCTTTTAAAAATAAGTCAATGTTTTGTGATATTTATTTATTGGTATATGGGTGGTGTTCTGCTCATCACATGCCACTTTTCAAAATGTTCATAAAATTTCTTTTAAG
>TTN-207,,0,929,1609059,1609987,GTATATCAAATCCTCATTATTAATATCTTTAACTTCCCATTAATTTTCTTTCTTAAAAGCAACATTTTCTTTTTTGACTGCCTTCTTATAATCATTTAGATAGTGAACTGATTAAGGACCAGTAAAAATATAACTCATTCCATTTCTTTAATCTTTTCTAGGATGTTAACGAATAATTGTGTGCATGTGTTTACGTATGAATTATTCTAGAAGCTTCTTAACTGAGAATTTTAATATATTAGTATGTCTCTATATACTTATACACATAGCAATGGATCCCTCTTCCCCACATTTTAGATTTTATTCCATAAGTGGAACGGAGTTTTCTTCTGTGTTATAATAATTATTTTACTATATTTATTATTTTATGGAACAAACCTAATGCTTGGATAATAACTATTTTAAAGAGCCTCACGTCCCTTTTGTAATGTTTAGCCCAAGCATTCAAGGTTATTACAAAATGTCTACTTTTCCCTGCTTCCTAATTCACTTAATGCTTCAGACAGTGCTCTTAAGCAGTTAGATTATGCTGTCCCTGTCATAGTAGACTCCTCAGCTAATAGAAGAGTGCACAGCAGAAAGTGAGGCCAGTGTCAGGGCTTAAATACTCTACAATGGTAATCACTTCAAAAAAGTCTTCATCAAGTTAAAAATAGTAAAAGTGAGTCCATATTGGTAATCCCTGTTATTAAAAGAAAAAAAAAAGAATGGCACAGGTACTTTGTGGACATTTCTTCTTCTATAGGAATGTTAGAACAAATGAGTGATTTGAGAAAGTATCTTTATTGCCTCTAAAATGGATGTCCCACAGTACAGAGTGACTTCTGAAAAACTTTAATTATTGTAATGTTGGCGTTGTCTCTGGTGTTTTTATTTCATGTGTGTTATTGAACATTCTCAGCTAACTAAAACACCTAATATCTTTAAAG
>TTN-207,,0,153,1609988,1610140,GTACATCTTCTCTTTTAAACCTGACTTCCTCTTCTGTCTTTTTTCGTTAAGACTTTTATGTTTCATGTCTCTGTGTCTTGATTGTTTTTGATGATTTTTGTCTATGAAAGCTTGCTCTCGACAGTCCTAAATATTAAAACTGTATCTTTAAAG
>TTN-207,,0,139,1610141,1610279,GTATTTTTGGAAAGATCCTGGATTTTCGTGTATTGTTGCATGCAATCCTTTATTCAGTTTTAAAAATATATATTTTGAATGTACATCTTTATTTCTTCAGTGTTTAAAAAAATAAGTCTTAAAATAGATGCTCTTTCAG
>TTN-207,,0,800,1610280,1611079,GTATAGGGAATTCTTCAAATACTACAAATTCTTATATCTTGCTCTAACTTTCCTTTGAAAGTAAATTTTGTGTTCAGTTTGGAAGATTAGAAACCCCATGAAATACTTTAAACATGAGTTTAAACTAGTTGACACAAAGATTAATATCTCTTAACCACACGGAGTATAATTTTAGTAGATGATAGTAATATTTGATATCTACTTATCTAAGGAGGTCACTGTATGAATTTGGGGATTATTTTTTAAATCTGACTAAGAATGTTACACAATTGTTACAGGTACCAAAATAACTGACCAGTGTCATTGGTTAAGTGAAAAAGAAACTCCTCAGTTCACTGAGGAATTTACATGTTCAGGCAAAATAATCACTGCTTTAACATTTTAGTCAACTGTTCACAAACTGAGAAATACTTACCAAAAGCTTTTGCCAGTTTATGATACTTTCATTAGAGAAACAACATTAAGGAAGTGAAGTATTGTTAATGGCACCTGTATTCTAGCATACTGTGAAGACAAGCCATAGCACAAATAAGTTATCTGCAATACCACTCTAGATCTTGCACAAATTAACAATATATGTGTAATATGAAGGAATGTGTGTGTGTGTGTGTTTAGCATATATAGCAAATTACAATATACATGATATTTAGCAAATCAAATCTCTTTTGGAAATAAGTGTGTTATAAATTAAAAAAATATAGATAAAGAATTTTGTGACCCCTCATTGTACTAACGTTAGTAGTAGTGCTCCAAAATACTTCAAGAGTTCATTCTAAACCAAAATACTAATATCTTTGAAG
>TTN-207,,0,794,1611080,1611873,GTATCTTCTTTGTGAAAAATTACTACTTAACTTTACATACAATAGCACCTTGGTTGCTTTATAAGCACAAGTTTGCATTCCACTTGATGTCTTTCTTCTGTATTTCTTGTTTCTGACATGTCTAAAACAAACTAATATCTTTAAAGCAGCTGAGGGTCCAAGGGAAGTTCTACCAAAAAAAGACAGTCACTGTTGTTATACCTAAAACAACCAAAGCAAATATCTCTAGTAACCAAATAGTGAGCCCAAATTTCCTCCTTTGGTGCTATTTGGTTATATATTCACTAACATGCTTACTGATAAACACATGTTTTTCTATTTATTATTAATTATATTAACCTGGCAAATATAAATACATAGTGAATATGTGTTTAATGTTCTTGCTTTGTTCATTTTTGCAAATCTCTTAAATTTCACAATAGAAATAAAAACAGTATCTAATAAATAATATAAACTTATTTCTTTAAAGTCTCTGAAGCATGTGCGTAAGTTATCACTGAAGAGAAGGTAGCAACTCTTCCACAAAAACAAACAGTAATAGCACCAGCTGAAGGTGTACTGTTAATTTTTCTTCTCAAGTTCTTACCATTCTAACATGGGAAATTTCCCTGGATTTTTGTTATTATATATTTTTTAAATTCAATGCATTTGAAATACTGTAATGTATTTGATAAAGTGTTGTCTGCATTTTATATTGTTGCTGTGTTCTGTTCTGTGTTTATATCTCTCATGCTCTGCTTGTTAAAAAATTGTATATTTAAAAATAAAAGAAATTATTACTATTATCTTTAAAG
>TTN-207,,0,542,1611874,1612415,GTAACTGGCTTTTCTCATTCATCATTAATATAAAATCCTTTTTTATTCACTTACTATGTAAGAGAGACCTTTCTCTTCTCAATGCCACAAGATGGCTATGAATGACATAAACTTCAATTTATGTTCTATAACATAATCCTGCCTTTTGAGGCAATGTTTTAGGCGTAAAGACATAAGCCCAAAGTTATCATTTGTATTGATCCTCTTATTTAATAACTAAATAATATTGATCCCTCAACTTCTCTTTCAAAAATAATTCATTTTGGAAGCTCTTCTGAAGTAGCTCTGGAAAAAAAAAAGTGTGCTCTAAATGGCAATAGAAAATGATACTATCTCCAAAGAGCAAAGTGTTTCTGATATAATGAATCAAGAACTCATCGACAAAGCAATTCAGAGAAATGCAATGACTACATTTGACTTATAGTTGACTTATAATTGAGGGGTTTTTGGCGTTCATCTTGTTAGATGCCCCTTCTAGGCTTGCTATGTTTACACCCAACTATAATGTTCTGAAAAAATAAGATAAATAAATATCTTTAAAG
>TTN-207,,0,144,1612416,1612559,GTATACAGTGATGCTAATCAGAACATGAAATAATTCTTGGTTTAGTTTTTCATGGTTTAAAGTGAATGTGTGTGACATTAAATCCTTGTATTTCGTATCTTATATTTGTTATCTGTAACAATTAATATACTAATATCTTTAAAG
>TTN-207,,0,1651,1612560,1614210,GTGAGTGTAGAAAAATTAGTGGTTCTTTTTCGTTTCATTTATGTCCTTAAATTCACTATGTTTGTCTTTTTAGCTTTGAAAAGTAAATATACTAAACTCTTATAAAAGCCTAACATGCCACAAATATATGACTCAAATAATCTTAGTGTCTATTATCCTCAGACAAGTTATATTTCCTCACCAATTTAAAAAAGAAATACTCTACTTATCAGAGTGTATGATTTCAGAAAAGTCAGTTGTCTTGTTAAATTTTCCTAACCTATTCTGTATACAAGTGTCTTTTGCTTTGAAGCAATTTATTTTCTCAGATCATGAAGTAACTTAACTCCATAATATTTTAATTGGATTTTATAAAATCAAAATGTTTCACCATTATTTTTTTTTTTACTCTTGATAACCATAATTGGAAACATTTTGGCAAAACTGCTCAAAGGACCCTAGGTTTACAAGGCCACTCAAACCTCAAAAGAATTCTCACGACCTTTTTTTTTGGGGGGGGGTTTCATACAAAATTAGGTTTAAATAATTTGAATTATGAAATAATCCAAATAGTAAAATATTGTGAATAGAATACTGTTCAACAACCTGAATAGTAAAAGTGACAGTAGTCAAAATATTCTTCCTTTTTTTTTTTTTTTTGAGATGGAATCTCACTCTGCTGCACCCAGGCTGCAGTGCAGTGGCACGATCTTGGCTCACTGCAACCTCCGTCTCCTGGGTTCAAGCTATTCTCCTGCCCCAGCCTCCCGAGTGGCTGGGATTACAGGTGCCTACCACCAGGCCCGGCTAATTTTGTGTATTTTTAGTAGAGACAGGGTTTTACCATGTTGGTCAGGCTGGTCTCAAACTCCTGACCTCAGGTGACCCGCCCACCTCAGCCTCCCAAAGTGCTGGGATTACAGGCATGAGCCACTACACCAGACCCGCTTCCATTTTTTTTAATCTAAAAAATTTCCTGTTGAAACTCAACTTTCTTGTTGTTCATCCTGTTATACTAAGTTGGGATAAAATAATATAATCACTTCCTCCTTTGAATATCCTTTCTATTCTTGACTTTAGTTATTGTTTTCAGACAGTTTTTCTTTCTAAAGGCTGGAGAAATTTTTGTTGTCTTTATTTGCCTTATTTTCTAAGTATTTAATTTTTTTAATTTTCTGCCTCCAAACCCTAAATGGCTTTTACATTCATATTAAACTGTGAAACCATATATTAGATGTGATTTGAAAATATAGATAATGAGGCTTCTAGAAAGGGAAAAGACTTACATGAATTTCTAGTAGGTCAAATATCGGAGAATTCTCAATGTGCAATTCAGCATCTTCCCTGTTCTTTATAGACAAATCCATTAAAAATAAGACCAATAGGACAATTTTACCAATAACTTTCTTAAGGCAAAATGAAGAATTATATAGTCCTTGCCTGAACAATTCCTCCATTTTATTATCATCATCATAGAGAAATGCTTAGAGTCTTACATCATGAAACTGGGAGTGAGGCTATCCCCAGCCAATGCATTCTAGCCACTAATTTGCCTCTATGTGCTACTATTAATTTTGGTGATGAATGTGGTATTATATATTATATTTTTCTTAATACACTTCTTTATCCACCTTGAAACATCCTAATTATTTAAATACTAATATCTTTAAAG
>TTN-207,,0,112,1614211,1614322,GTATATAACACCAATGATCCACTCTGAAGAAAAATTATTTTTTGGCCCCTTTTAAAAAGCTCAATATTTTTCTTCACCATTTATAAATATAACTATACTCATATCTTTTAAG
>TTN-207,,0,122,1614323,1614444,GTATATTTCAAATACATCAAACCCAGATGAGTATCTTTAGCTTTATGACTCAAACATTGCATGCTTTTTATAATTTACTGTTTTTACAACTTTTAAATGTAAACCTACTAATATCTTTAAAG
>TTN-207,,0,334,1614445,1614778,GTATAATTCTCTAGTTAGGAAAATCTAAAGAAGAAAATATACTGTCTTCAGTCTGCAAAATATTTAATGTTTAATATACATTCTCACAACCTCTAATGTTAAAATACTGTGTTTAAAGGATCTGATATACCCACAACAAAGAATGACCTATGACTTGCCCCCAAGAAAGTCAAGTCCCACACATATAATATACAAAGATAAAATATTAGAACAAAAATAACATTTCTAACATAAAGATATCTGAAATGATATTAACATATCTAACTTTCTTAGTATGTCATGTCTTTATGCCTTTGCCTTTTCTCAATTAAAAAAAATACTAATATCTTTAAAG
>TTN-207,,0,1032,1614779,1615810,GTACAAGTTGGAAGAAAGTCACCTTTTTAATCTCATGTTTGCAGTTGTACTTAACACATGTAAAAATACTAATATCTTTTAAGCCAAAGTGGCTACAGTGGAAATCATTTCAGAGATGGATCCCCCAAGTAGAAGCTCAACCAAATGTATTCATGTCCCAGTGAGTCACTCAAGAGACAACAGAGGGAAAAAATACCTTTAGCTTATACACATGAAAGATAGTTGAGTCAGTGTATTTTTATGAGGACTCCAAAGAAAATATATATACACATATTATGATCAAAACATGTCTTAAAGAAAATATTAATTCAGTGTGAAGCTGATCTGTAATATCTCTACAAGATTAGAGCACCTGAGACCCTCCCAGAATATCCTCCAACCTAGGGAAAAATAATTCCAGTTAAAGCTGGAAATCTCCCCTCCATGTTCATTTGCTCCTCTCATAGCCTATCTTTTATTTTTCAAGCATCATTTTTTTTCATTTTGAATATCTTTAGATAAGTCAAAACATGAAAAAGCTTTAAAACCTCCAGAACAATAATTTCATCATAACACCCATGGTATTCTGTAATTTGAAGAATATCTGAATATTTTGATATTTTTTCTCAGTCTGGAATCTTTTGGTTGTTCTCCTCTCTCCTAAACTTGAAAAACACTCACCTTTTTAAGGTGCCTGAGGTGTGAATACAAAAAAATGCCGACCTAGATTTTTCGAAGTGGCTGTAATTTGTTTTTCTCAACATAATAGCTAGAGGTATAGCATTAATTATAATCAATGTTTCCACTTTCCATGATCTAGTTTTCTATGCATCTACCATTCCAAGAAATAAAATTACTAATACTGATAGTGCCTGAGGTGACCAAGAAAACAGCCGCTTATAACCAAATACTCACACTGCTACAAAAGATCCGATTCTGGGGGCGGGGAGTGGGAGAAGGTTCCCATCTGGAATGTTCTGTATGTGCAGTTAAGATGGGAACTCTTTACTCCTCTTCATAACTCCAAAGTACAATGCATTCATATCTTTAAAG
>TTN-207,,0,247,1615811,1616057,GTATCGTTCATCCTGCCATTCCTTCCTTCATTTATTAGAGTGCTTAGCATGTACAGGGTGCTAGGGAACTGGAGAATAATAAACAAAGACAATTAATATGTGGTTCCTCTCCTCAAGATTGTATACCTCCTCAGATTCTTTAAAGGAATCATCTTTTTAGCCATAAATATCACTTTGGTTCAGCTCATTTAATTAATGTCTCCACTGATCCTTTTAACCTCTAACCATAATACTAATATCTTCAAAG
>TTN-207,,0,450,1616058,1616507,GTACGTTACCTCTGAACAAATGTGGAAGAAGAAATTATCTGTCCTCTGCTCTTAAAACTATGGTTTCTTCCTAATACTCTTCATAAATTCTAAATATAAACATACTAATATCTTTTAAGTGTCTGAGGTTCCACAGGAAGTTTCCTCTAAAAAGAAATTATTTATGGCTGTTTCTGCCAAAACAGAAAACACTCCTGCTGGAAGTATTCATTCAACAAATCCTTTATAATGAGAGTGTAGAGTGTCGCGAGAGCTCTGTGAGGTTCTGGAGGAGGGGGAGCACCTCCTCTCAAGGATCCACTAACCCCTTAAAAGACTTAGCCTATTGGTGGAACAAAGGGAGGATGGAGGAAAGAGAAGAAAATGTGGTTATATTTCCTAACTTATTGTGGTTACTGTTTTCCATTAATCATTTTAACTCTTAAATGTGAATTGCTAATATCTTTCAAG
>TTN-207,,0,114,1616508,1616621,GTACAAGTCACCATGCTCTCAGGGTCAAGAACTAGCTCTTGTAGTTTTGAGAATATTTTTGCTATTCCTAGTTATCTGCATAACACTAAACATAAAACTACTAATTTCTTAAAG
>TTN-207,,0,116,1616622,1616737,GTATATCTTGCTGGAAGCTTAGAGGGGTGGGAACATGTCTTTTCTTGTATAAATGTTTTTCCTGATTGTGTTGATTCTTGTAACTTCTAAATGTAAAATTATTAATATCTTCAAAG
>TTN-207,,0,361,1616738,1617098,GTACATTCTTAACTGTCTTTTTATGGTGGGATAGTGGGTGGGGCGATAGAAAGGACCACCTTTCTAGTTTTGAAAATTATTTTGATGTGTACATGTGAATCATGTCTGTGTTGACTCTTGCAACTCAAGTGTAAATGTATTAATATCTTCAAACTGCCTGAAGCTCCCAAAGAAATGGCTACCAAAAAGAAAATACCGGAAGTTCCTCCTCTAAAACCTGAAACACCACCTATTATGGGAACTTGTTACCACTGATCTCAGCTCAGGAGAAAAAAATAGCTCTTTTGTTCTTGAAAATGTCTTTGTATCTATCTAGTAATCTCTGTATTTTCTGAGTGTAAAAATACTAATATCTTTCAAG
>TTN-207,,0,112,1617099,1617210,GTATTTGTCACTGACTTTAGGCTTCAGAAGACCTAATTCTTCTGCTCTTGACAATATTTTTTTCTAGCGGTCTTCATAACACCTAAATGTAATTTCACTAATATCTTTCAAG
>TTN-207,,0,108,1617211,1617318,GTAGTTGCCACTGACCTTAGGCTTCAGATCTCATTCTTTTGCTCTTGAAGATATTTTTTCCAGTGGTCTTCATAACTTCTGAATGTAATTTTGCTAATATCTTTTAAG
>TTN-207,,0,110,1617319,1617428,GTATTTGTCACTGATTTTAGGCTTCAGATGATGTATCTCTTCTGCTCTGGAAAATATTTTTCTAGTGGTCTTCATAATGCCTAAATGTAATTTCACTAATATCTTTCAAG
>TTN-207,,0,83,1617429,1617511,GTAGACACCCTCTTGTTGCTGTGTTTGATATTGTTTGTTTGTCTTTACTTTGTCTAATAATGAAAATACTAATATCTTTAAAG
>TTN-207,,0,210,1617512,1617721,GTAATGCCAAAGCTATACAAACTATAGGAGAAAAATAACTGTTATTTTAACTAGGAAATTACATGTTAAAAATCCTACTACATAAAGATGATATAATTCTAAAGAAAACAAATGTCAATCGCTATCCAAAATATCTTGGTGGGTGTTTATATGCAAAAGGCATCCATCATTTTCACCTTTTCTAAACACAAATTACAAATATCTTTGAAG
>TTN-207,,0,153,1617722,1617874,GTAGGTATCATTACACATTGTCAGTCGGGGGGCCCTGGGGAAAGACTGCATAGAAGTGTCCGCCGATCTCACAAGTTGTATTTGCTTGGGTAAATGTGGAGTCGATATTCCCCCTTTATAGCTTCTAACTAAAAGATACTAATATCTTCAAAG
>TTN-207,,0,112,1617875,1617986,GTATTTATTCCCTCTCCTCTGCTAAGAAAAACTTATCGTCTGTACCCCTCACAATCACTGTAATATATACCTTCACCATTCATAAATTATAAAAATACTAATATCTTTCAAG
>TTN-207,,0,114,1617987,1618100,GTACATGTCAGCTCAACCTTATCCTGCAGAAGAAATCTCTCTTCCATTCCTGAAAACAATTTTAGTCCATTCCTCTTCATTAACCTAAGTATAAAACTACTAATATCTTTCAAG
>TTN-207,,0,115,1618101,1618215,GTACACTTTAGCCCTGACTTCATTCTGCAGAAGAGATATCTCCTCTCCTACTGTAAACAATTTTAGCCCATTTCTCTTCATTAACTTAAGTCTAAAACTACTAATATCTTTCAAG
>TTN-207,,0,113,1618216,1618328,GTATTTTTTACCCCTGTCCTTTTTCTGCAGAAGAAATATCTCTTCTGATCTTAGAAATATTTTACTCCATTTGTCTCATTAACCTAAGTGAAAAACTACTAATATCTTTCAAG
>TTN-207,,0,105,1618329,1618433,GTACTTGTCATTTGACCTTAAGCTTCAGAAGATCCAATTCCTCTGCTGTATATTTTGCTAGTAGTCTCCATAGCTCCACATGTAACTTTACTAATATCTTTTAAG
>TTN-207,,0,2503,1618434,1620936,GTATTTGTCACTGATTTTAGGCTTCAGATGATCTATCTCTTGTGCTCTGGAAAATATTTTTCTTTTTATATATATATATATTTTTATTATACTTTAAGTTCTAGGGTACATGTGCACAACGTGCAGGTTGTTACGTATGTATACATGTGCCATGTTGGTGTGCTGCACCCACTAACTCGTCATTTACATTAGGTATGTCTCCTAATGCTATCCCTCCCCCATCCCCCCACCTCACAACACACTCCGGTGTGTGGTGTCCCCCTTCCTGTATCCATGTGTTCTCATTGTTCAATTCCCACCTATGAATGAGAACATGCAATGTTTGGTTTTTTATCCTTGTGATAGTTTGCCAAGAATGATGGTTTCCAGTTTCATCCATGTCCCTACAAAGGACATGAACTCATCATTTTTTATGGCTGCATAGTATTCCATGGAGTATATGTGGAACATTTTCTTAATCCAGTCTATCATTGATGGACATTTGGGTTGGTTCCAAGTCTTTGCTAATATGAATAGTGCCGCAATAAACATACGTGTGCACGTGTCTTTATAGCAGCATGATTTATAATCCTTTGGGTATATACCCAGTAATGGGATGGCTGGGTCAAATGGTATTTCTAGTTCTAGATCCCTGAGGAATCGCCACACTGACTTCCACAATGGTTGAACTAGTTTACAGTCCCAGCAACATTGTAAAAGTGTTCCTATTGCTCCACATCCTCTCCAGCGCCTGTCGTTTCCTGACTTTTTAATGATCACCATTCTAACTGGTGTGAGATGGTATCTCATTGTGGTTTTGATTTGCATTTCTCTGATGGCCAGTGATGATGAGCATTTTTTCTTGTGTATTTTGGCTGCATAAATGTCTTTTTTTGAGAAGTGTCTGTTTGTATCCTTCGCCCACTTGTTGATGGGGTTGTTTTTTTCTTACACGTTTGTTTGAGTTCATTGTAGATTCTGGATATTAGCCCTTCGTCAGATGAGTAGATTGCAAAAATTTTCTCCCATTCTGTGGGTTGCCTGTTCATTCTGATGGTAGTTTCCTTTGCTGTGCAGAAGCTCTTTAGTTTAATTCGATCCTATCTGTCAATTTTGGCTTTTGTTACCATTGCTTTTGGTATTTTAGACATGAAGTCCTTGCCCATGCCTATGTCCTGAATGGTATTGCCTAGGTTTTCTTCTAGGGTTTTTATGGTTTTAGGTCTAACATTTAAGTCTTTACTCCATCTTGAATTAATTTTTGTGTAAGGTGTAAGGAAGGGATCCAATTTCAGCTTTCTACATATGGCTAGCCAGTTTTCCCAGCACCATTTGCTAAATAGGGAACCCTTTCCCCATTTCTTGTTTTTGTCAGGTTTGTCAAAGATCAGATGGTTGCAGATGTGTGGTATTATTCTGAGGGCTCTGTTCTGTTCCATTGGTCTATATCTCTGTTTTGGTACCAGTACCATGCTGTTTTGGTTACTGTAGCCTTGTAATACAGTAGCGTGACGCCTCCAGCTTTGTTCTTTTGGCTTAGGATTGACTTGGCAATGTGGGCTCTTTTTTGGTTCCATATGAACTTTAAAGTAGTTTTTTCCAATTCTGTGAAGAGAGTCATTGATAGCTTGACGGAGATGGCATTGAATCTATAAATTACCTTGGGCAGTATGGCCATTTTCACGGTATTAGTTCTTCCTATCCATGAGCATGGAATGTTCTTCCATTTGTGTCCTCTTTTATTTCGTTGAGCAGTGGTTTGTAGTTCTCCTTGAAGAGGTCCTTCACATCCCTTGTAAGTTGGATTCCTAGGTATTTTATTCTCTTTGAAGCAACTGTGAATGGGAGGTCACTCACGATTTGGCTCTCTGTTTGTCTGTTATTGGTGCATAAGAATGCTTGTGATCTTTGCACATTGATTTTGTATCCTGAGACTTTGCTGAAGTTGCTTATCAGCTTAAGGAGATTTTGGGCTGAGACGATGGGGTTTTCTAGATATACAATCATGCCATCTGCAAACAGGGACAATTTGACTTCCTCTTTTCCTTATTGAATACCCTTTATTTCTTTCTCCTGCCTGATTGCCCTGGCCAGAACTTCCAACACTATGTTGAATAGGAGTGGTGAGAGAGGGCATCCCTGTCTTGTGCCAGTTTTCAAAGGGAATGCTTCCAGTTTTTGCCCATTCAGTATGATACTGGCTGTGGGTTTGTCATAAATAGCTCTTATTATTTTGAGATACGTCCCATCAATACCTAATTTATTGAGAGTCTTTAGCATGAAGGGCTGTTGAATTTTGTCAAAGGCCCTTTCTGCATCTATTGAGATAATCATGTGGTTTTTGTCGTTGGTTCTGTTTATATGATGGATTACGTTTATTGATTTTTGTATGTTGAATCAGCCTTCCATCCCAGGGATGAAGCCCACTTGATCATGGTGGATAAGCTTTTTGATGTGCTGCTGGAAAATATTTTTCTAGTGGTCTTCATAATGCCTAAATGTAATTTCACTAATATCTTTCAAG
>TTN-207,,0,83,1620937,1621019,GTAGACACCCTCTTGTTGCTGTGTTTGATATTGTTTGTTTGTCTTTACTTTGTCTAATAATGAAAATACTAATATCTTTAAAG
>TTN-207,,0,210,1621020,1621229,GTAATGCCAAAGCTATACAAACTATAGGAGAAAAATAACTGTTATTTTAACTAGGAAATTACATGTTAAAAATCCTACTACATAAAGATGATATAATTCTAAAGAAAACAAATGTCAATCACTATCCAAAATATCTTGGTGGGTGTTTATATGCAAAAGGCATCCATCGTTTTCACCTTTTCTAAACACAAATTACAAATATCTTTGAAG
>TTN-207,,0,153,1621230,1621382,GTAGGTATCATTACACATTGTCAGTCGGGGGGCCCTGGGGAAAGACTGTATAGAAGTGTCCGCCGATCTCACAAGTTGTATTTGCTTGGGTAAATGTGGAGTCGATATTCCCCCTTTATAGCTTCTAACTAAAAGATACTAATATCTTCAAAG
>TTN-207,,0,112,1621383,1621494,GTATTTATTCCCTCTCCTCTGCTAAGAAAAACTTATCGTCTGTACCCCTCACAATCACTGTAATATATACCTTCACCATTCATAAATTATAAAAATACTAATATCTTTCAAG
>TTN-207,,0,114,1621495,1621608,GTACATGTCAGCTCAACCTTATCCTGCAGAAGAAATCTCTCTTCCATTCCTGAAAACAATTTTAGTCCATTCCTCTTCATTAACCTAAGTATAAAACTACTAATATCTTTCAAG
>TTN-207,,0,115,1621609,1621723,GTACACTTTAGCCCTGACTTCATTCTGCAGAAGAGATATCTCCTCTCCTACTGTAAACAATTTTAGCCCATTTCTCTTCATTAACTTAAGTCTAAAACTACTAATATCTTTCAAG
>TTN-207,,0,113,1621724,1621836,GTATTTTTTACCCCTGTCCTTTTTCTGCAGAAGAAATATCTCTTCTGATCTTAGAAATATTTTACTCCATTTGTCTCATTAACCTAAGTGAAAAACTACTAATATCTTTCAAG
>TTN-207,,0,105,1621837,1621941,GTACTTGTCATTTGACCTTAAGCTTCAGAAGATCCAATTCCTCTGCTGTATATTTTGCTAGTAGTCTCCATAGCTCCACATGTAACTTTACTAATATCTTTTAAG
>TTN-207,,0,2502,1621942,1624443,GTATTTGTCACTGATTTTAGGCTTCAGATGATCTATCTCTTGTGCTCTGGAAAATATTTTTCTTTTTATATATATATATATTTTTATTATACTTTAAGTTCTAGGGTACATGTGCACAACGTGCAGGTTGTTACGTATGTATACATGTGCCATGTTGGTGTGCTGCACCCACTAACTCGTCATTTACATTAGGTATGTCTCCTAATGCTATCCCTCCCCCATCCCCCCACCTCACAACACACTCCGGTGTGTGGTGTCCCCCTTCCTGTATCCATGTGTTCTCATTGTTCAATTCCCACCTATGAATGAGAACATGCAATGTTTGGTTTTTTATCCTTGTGATAGTTTGCCAAGAATGATGGTTTCCAGTTTCATCCATGTCCCTACAAAGGACATGAACTCATCATTTTTTATGGCTGCATAGTATTCCATGGAGTATATGTGGAACATTTTCTTAATCCAGTCTATCATTGATGGACATTTGGGTTGGTTCCAAGTCTTTGCTAATATGAATAGTGCCGCAATAAACATACGTGTGCACGTGTCTTTATAGCAGCATGATTTATAATCCTTTGGGTATATACCCAGTAATGGGATGGCTGGGTCAAATGGTATTTCTAGTTCTAGATCCCTGAGGAATCGCCACACTGACTTCCACAATGGTTGAACTAGTTTACAGTCCCAGCAACATTGTAAAAGTGTTCCTATTGCTCCACATCCTCTCCAGCGCCTGTCGTTTCCTGACTTTTTAATGATCACCATTCTAACTGGTGTGAGATGGTATCTCATTGTGGTTTTGATTTGCATTTCTCTGATGGCCAGTGATGATGAGCATTTTTTCTTGTGTATTTTGGCTGCATAAATGTCTTTTTTTGAGAAGTGTCTGTTTGTATCCTTCGCCCACTTGTTGATGGGGTTGTTTTTTTCTTACACGTTTGTTTGAGTTCATTGTAGATTCTGGATATTAGCCCTTCGTCAGATGAGTAGATTGCAAAAATTTTCTCCCATTCTGTGGGTTGCCTGTTCATTCTGATGGTAGTACCTTTGCTGTGCAGAAGCTCTTTAGTTTAATTCGATCCTATCTGTCAATTTTGGCTTTTGTTACCATTGCTTTTGGTATTTTAGACATGAAGTCCTTGCCCATGCCTATGTCCTGAATGGTATTGCCTAGGTTTTCTTCTAGGGTTTTTATGGTTTTAGGTCTAACATTTAAGTCTTTACTCCATCTTGAATTAATTTTTGTGTAAGGTGTAAGGAAGGGATCCAATTTCAGCTTTCTACATATGGCTAGCCAGTTTTCCCAGCACCATTTGCTAAATAGGGAACCCTTTCCCCATTTCTTGTTTTTGTCAGGTTTGTCAAAGATCAGATGGTTGCAGATGTGTGGTATTATTCTGAGGGCTCTGTTCTGTTCCATTGGTCTATATCTCTGTTTTGGTACCAGTACCATGCTGTTTTGGTTACTGTAGCCTTGTAATACAGTAGCGTGACGCCTCCAGCTTTGTTCTTTTGGCTTAGGATTGACTTGGCAATGTGGGCTCTTTTTTGGTTCCATATGAACTTTAAAGTAGTTTTTTCCAATTCTGTGAAGAGAGTCATTGATAGCTTGACGGAGATGGCATTGAATCTATAAATTACCTTGGGCAGTATGGCCATTTTCACGGTATTAGTTCTTCCTATCCATGAGCATGGAATGTTCTTCCATTTGTGTCCTCTTTTATTTCGTTGAGCAGTGGTTTGTAGTTCTCCTTGAAGAGGTCCTTCACATCCCTTGTAAGTTGGATTCCTAGGTATTTTATTCTCTTTGAAGCAACTGTGAATGGGAGGTCACTCACGATTTGGCTCTCTGTTTGTCTGTTATTGGTGCATAAGAATGCTTGTGATCTTTGCACATTGATTTTGTATCCTGAGACTTTGCTGAAGTTGCTTATCAGCTTAAGGAGATTTTGGGCTGAGACGATGGGGTTTTCTAGATATACAATCATGCCATCTGCAAACAGGGACAATTTGACTTCCTCTTTTCCTTATTGAATACCCTTTATTTCTTTCTCCTGCCTGATTGCCCTGGCCAGAACTTCCAACACTATGTTGAATAGGAGTGGTGAGAGAGGGCATCCCTGTCTTGTGCCAGTTTTCAAAGGGAATGCTTCCAGTTTTTGCCCATTCAGTATGATACTGGCTGTGGGTTTGTCATAAATAGCTCTTATTATTTTGAGATATGTCCCATCAATACCTAATTTATTGAGAGTCTTTAGCATGAAGGGCTGTTGAATTTTGTCAAAGGCCCTTTCTGCATCTATTGAGATAATCACGTGGTTTTTGTCGTTGGTTCTGTTTATATGATGGATTACGTTTATTGATTTTTGTATGTTGAATCAGCCTTCCATCCCAGGGATGAAGCCCACTTGATCATGGTGGATAAGCTTTTTGATGTGCTGCTGGAAAATATTTTTCTAGTGGTCTTCATAATGCCTAAATGTAATTTCACTAATATCTTTCAAG
>TTN-207,,0,83,1624444,1624526,GTAGACACCCTCTTGTTGCTGTGTTTGATATTGTTTGTTTGTCTTTACTTTGTCTAATAATGAAAATACTAATATCTTTAAAG
>TTN-207,,0,210,1624527,1624736,GTAATGCCAAAGCTATACAAACTATAGGAGAAAAATAACTGTTATTTTAACTAGGAAATTACATGTTAAAAATCCTACTACATAAAGATGATATAATTCTAAAGAAAACAAATGTCAATCACTATCCAAAATATCTTGGTGGGTGTTTATATGCAAAAGGCATCCATCATTTTCACCTTTTCTAAACACAAATTACAAATATCTTTGAAG
>TTN-207,,0,153,1624737,1624889,GTAGGTATCATTACACATTGTCAGTCGGGGGGCCCTGGGGAAAGACTGTATAGAAGTGTCCGCCGATCTCACAAGTTGTATTTGCTTGGGTAAATGTGGAGTCGATATTCCCCCTTTATAGCTTCTAACTAAAAGATACTAATATCTTCAAAG
>TTN-207,,0,112,1624890,1625001,GTATTTATTCCCTCTCCTCTGCTAAGAATAACTTACTGTCTGTACCCCTCACAATCACTGTAATATATACCTTCGCCATTCATAAATTATAAAAATACTAATATCTTTCAAG
>TTN-207,,0,114,1625002,1625115,GTACATGTCAGCTCAACCTTATCCTGCAGAAGAAATCTCTCTTCCATTCCTGAAAACAATTTTAGTCCATTCCTCTTCATTAACCTAAGTATAAAACTACTAATATCTTTCAAG
>TTN-207,,0,115,1625116,1625230,GTACACTTTAGCCCTGACTTCATTCTGCAGAAGAGATATCTCCTCTCCTACTGTAAACAATTTTAGCCCATTTCTCTTCATTAACTTAAGTCTAAAACTACTAATATCTTTCAAG
>TTN-207,,0,113,1625231,1625343,GTATTTTTTACCCCTGTCCTTTTTCTGCAGAAGAAATATCTCTTCTGATCTTAGAAATATTTTACTCCATTTGTCTCATTAACCTAAGTGAAAAACTACTAATATCTTTCAAG
>TTN-207,,0,105,1625344,1625448,GTACTTGTCATTTGACCTTAAGCTTCAGAAGATCCAATTCCTCTGCTGTATATTTTGCTAGTAGTCTCCATAGCTCTACATGTAACTTTACTAATATCTTTTAAG
>TTN-207,,0,113,1625449,1625561,GTATTTGTCACTGACCTTAGGCTTCAGATGATCTAATTCTTTTGCAGTTGAAGACATTTTGTTCCAGTGGTCTTCATAACCCCTAAATGTAATTTTACCTAATATCTTTTAAG
>TTN-207,,0,109,1625562,1625670,GTATTTGTCACTGGCTTTAGGCTTCAGAAGACTGAACTCTTCATTTCTTGAAAATACTTTTCTAGTGGTCTTCAAACTTCTAAATGTAATTTCACTAATATCTTTTAAG
>TTN-207,,0,111,1625671,1625781,GTATTTGTCACTGGCTTTAGGCTTCAGAAGATCAAACTCCTCTATTCTTGAAAATATTTTTTCTAGTGGTCTTCATAACCCCTAAATGTAATTTCACTAATATCTTTTAAG
>TTN-207,,0,111,1625782,1625892,GTATTTGTCATTGAGTTTAAGCGTCAGAAGATCTATCTCTTCTACTCTTGAAAATATTTTTCCTAATGGTCTTCATAACTTCTAAATGTAATTTCACTAATATCTTTTAAG
>TTN-207,,0,110,1625893,1626002,GTATTTGTCACTGATTTTAGGCTTCAGATGATCAAACTCTTCTGCTCTGGAAAGTATTTTTCTAGTGGTCTTCATAATGCCTAAATGTAATTTCACTATTATCTTTCAAG
>TTN-207,,0,84,1626003,1626086,GTAGACACCCTCATGGTGCTGTGTTTGATATTGTTTGTTTGTCTTTACTTTGTCTAACAATGAAAATAATAATATCTTTTAAAG
>TTN-207,,0,128,1626087,1626214,GTAATAATGAAACTATTCAAATTAGTGTTTTTTAAAAAAATCTTTCCTTAGTGTTGTAAAAACATTTTTTTGCAAACTATCTCAGTTTTAGTCAATTCTGGCATTAAAATGAGCTCATGTCTTTAAAG
>TTN-207,,0,134,1626215,1626348,GTACATGGCAAGAAAGCTGCTAGGACACCTCGGCCACTCTTTCCCCTTCCTGCCCTGATAATTCTGGGTGCTCTGAGCTTTTGTCTTGTTTCTCAATCTTCGTTCTTTCTAAAACATACCTTCTAATTCTTTAG
>TTN-207,,0,129,1626349,1626477,GTATTCCTCACTGCCACTAACTCCCTAACAAAAAACTTTCTTTGAAGTGTCATATTCTACTGTTCTGCTTCATGATTTTCACATTTCATTGAAACCATGAGCTTAAACAACTACTAATATCTTTTATAG
>TTN-207,,0,132,1626478,1626609,GTATATGTGGCTGTCCACTGTTTGATGGGGGCGGATGGAGCCCCCAGCTTCTAAAAGGGTTTTGTTCTGTGTAAATGTGATGAATGTTTACTGGTGATTGTTTCTAATGTTAAAATACTAATATATTTGAAG
>TTN-207,,0,408,1626610,1627017,GTACATGTCACTAATGAGATTCTGCAGAAAAGCACTCACCCTTGTCTAATAAGTCACCTATTATCAAACCTTTTGTTTGCGAGTCCTCTTAAATTTGCAACTACAAAACTGTCATTCTGGATTTTTAGGGTCTGAATACTTTTTAATAATTTTTTCATTGACTTTAAAAAGTGATATATTTACTTATTACAAGCATTGGAAAAGTTTACTAACTTGGTTCTTTTATTCTTAATAGGCCATATTTTCCTCCCCACTATATGAGGGTCCAAAGACAGATCACTGACCTTATTGTGAAATTTGTTCTTGGATCTGTCCCTGGGTTATTTGAGCAAAATGTGAAGTCGATGTGGTATAAATTTAATATACTTCTCAACTACTCATAAGAAAAATGAATTAATATCTTTAAAG
>TTN-207,,0,479,1627018,1627496,GTACACGTGAGACCGGTGATTAATGACCTTGCCACTTGCGACTATTTCTAATTTAAGCTTTGTTCTTCTTCCTTCCTAACTCATTATTTCTTGGTCATTTTCTAACCTTTAATTATTTGTCTTAATTCATCATTCTAAATTAGCTCCAATCTCAAATCTATTTTGGGTTATTGGTCCACAGTATCTACATAAGTCATAGTAAGCTATATTAAACAAAGCTTCTCCAATGTACATAGAAAGTAAGGCAGGAGAACTAATGATTATAAATGACATTAAACACTAAAAGGGCTTTGCAAGCATTTGAATCAATAGACAAAGAAGTCAGTGCAAATGAGATAGATTTTATCTAAACAAAAATAAGAGAAGGTATCAATTGAAACAAAGGAAGAAATCAAGATTACTATTTATCGTGTTTAGTGTTTGTCCATCTTAGAATATTGTTCCATACATTGAAATAAAATTAACTAATATCTTTAAAG
>TTN-207,,0,269,1627497,1627765,GTACAAAGCAGAATCCACTGTATGGGAAAATACAGTCATTTCATTTTTCATGTCTATATATCTTCCTTAAGGCAAAATATCAGTCTTGTATCTTGTTGCCTGAAATCTGACTACATTAAGAACAAAAGTTATTTCTACACATAAAACTTTGGACCCACAGAATTTGGTCCCACATATACCAAGAAATATGTGTGGTTTTTAATTCATTCATTAGCATTAAATTTTTCATTGTAATCACCTAATTCTAAAAGAAATTCCTATTATTCAAG
>TTN-207,,0,3786,1627766,1631551,GTACTCATGTTAAAATGAATACTTCATTTTTGTGGTGTCTACAATTTTACACTCTTCTTATTGTGTGTTGTGTTGTATTATATGTTTGTTAACTCTTACCTATATGTTACAGTGTTGAATAAACTTGTATGTATATCTTACATCTCACAACTTTGTATTATTAAATGCTACTGATATCTTTAAAGAACCTGAGATGCCAAAGAAAGTTGTTCCAGTGAAGAAGGTCCCAACTGTTAAGAAGCCAGAAACACCAGCAGCTAAAGGTATTCACTTCATCGTTGGCATCATAAAAAAGAAAGTATTCTGATATCTTAAAGTGGAATCCAATAAGTTGTCCTCATTGTTGTTGCATAACTAAGGACAAAAATTTCCTTATTTTGCTTTCATTAATTTTAATGCTGCTCCAATAAATACAGGTTTTTTATTCTTAATATTTTAAAATGTTTTTAAATACTATTTTTAAAACAAAACTAATATCTTCAAAGTGCCTGAGGTGCCCAAGAAACTTGTTCCAGTAAAGAAAGAACCTGTGCCTGTTACCAAAAAACCAGAAGTTCTTCCAGAAAAAGGTACCTACCATGAAGAAAAAATAGATTTCTCTAACTGCTATTTAAGCATGTTAATAATAGGTCTTAGAGAAAAACATACTGAATGTGAATTTATGTTAAAACCATATTGCACAGAAAAAAGGGAAATAATGAAGGGAAAAAAATGAAACAGACAAGCAGGAGTGAAAAAATGAGTGGGATTCAGTTGTGCTGTGATATATCACATGGCTACAACTAGTAGAAAAGAACCTTCTCTCATTCAATGTGTAAAACAGCTCAATTCAACATATTTTGTTGAATGTTGACCATTAACAAGACATCATATTAGAAAAATTAAGGCCTGATTCTGTCTTCAAATAAGTTAAATCTGGTGAGAGGATAGAAAGATAACAGGACTCTAATACAGACAGGAAGTGATTACACATAGCAAGTGAATACAAAAGGGCTGCAGAAACACACGGCAAGAAAAGATTAAGTTCAGGCAGAGGCATCATGGGAAGCTGTGTTAAACTGAATTTAAATTTTGATGGACTTTTACATGTAGAAATTGAGGAAATAAGGCCGGATGTGGTGGCTCACGCCTGTCATCCCAACACTTGGGGAGGCCAAGGTGGGTGGATCACTTGAGGTCAGGAGTTCAAGACCAGCCTGGCCAACATGGTGAAACCCCGTCTCTACTAAAAATACAAAAATTAGCTGGGGGTGGTGATATGTGCCTGTAATCCCAGCTACTTGGGAGGCTGAGGCAGGAGAATTGCTTGAACCCAGGAGGCAGAGGTTGCAGTGAGCTGAGATAATGCCACTGCACTCCAGCTTGGGTGACAGAGTGAGCCTCTGTCTCAAAAAAATTAAAAAAAAGAAATTGAGGACATGATATCCCATGGAAAGGGAAGAGCATATTGAAAGGCACAGAGATAGAAGGGTCTAGAATGTTCAAGGATTGTCAAGTAAACTTATGTCAAGTAAACTCAATTTGAGTATGGATTGGCTGTGGAATGTCTTGAAAGATAATACCAGATATAAAGATGGGGTCATATTTTGGAGTACTTCAAATGCCAGTAAAAGGCTTGTACTTTTTTCTGTAGGCAATAGGAAGCTTCAAAGATTTTGAAGCAGGCTTACATATTAATAGGATTTGGGCTTTAGAAAGATAACTGGCAGCAATTTCAGCTACTAAATAGTAAAGACCCATTGCAATTATTTAAGGTCTTTAAGAGTTGGACAAGATCCGTGGCGGCAGAAATGGAAAGGGGGACTGGGTTTGAAAGAGATGGAGACTTAGTGGCCTCTGACCATTATCAAAACCATTAGGGAAATTGAGGAGCCCAAGATCATTGTAAGGTTTAAAGCTAGATGGCCAAAAGAATGGTTCATTGGGTCTCTGAACTAACGTTAGAGGAAAATGGTAGATGTGCTTTTCACCTTTAAAGCATAAAAGTTGGGAGTGTGTATCAGGAGCTTAAGAAAGAGATCAGGCCTAGAGATGTAGATCTTAAAGTCATTCACATGTAAATAAGAATTGAGTGTGCAGGAACAATTACTCAGAAAATGTAGAGCAAATTTTTTTAAGTGTCAAAGTTAGACCACCTTCATTTAAGTGTACACAGAGGACTAGAAGCAAATGAAGAAAGCTGAGAAGATTCATATATAAAATTAGGATGTCCAAAATGGTGCCATGTCTCAGAAGCCATTTTCCCCATGAAATCTAAGATGAAGCTCTTGCCCCTGCATTCTTTGCCTGCTCTTTAGACAATCTTGCATGTCTTCTAAATTCTTAATAGTAAACAAAATCATATCTTTAAAGTGCCCAAAGTGCCTGAGAAAATCATCCCAGAAAAGGAAGTGTCTGTGCCTATCCCTGCAGAGCCAGAAGTTCCACCTGCTGAAGGTACACGGCTTCTCCATAAATCTTGGAAAGATGACAATTGTCTTCATCCTCTTGCTTTGATTGTAGATGAATCTTACGTATTTGTCTGTCTGTATTGAAGTTATTGATATTTGGGGGGTCATCTGAATAATCTGTTATAGAGTGTTACTTAATGTAACTAGGTTGATATGTTAGAATAGTAGTTGCAGTATTCTGTTCTAAATATAGTCTAAAATAAAATACTATGTTTTTTAAAGTTGAAGAGACTCCTGAGGAAATAATATATGAAGAAAAAGCATCTATAACCATTGGTAGAAAAGAGACTCCCCCTGTTGAAGGTATATATATATATATATATATACATTTTTTTAATCTCCTGAAGATTCCTGTTAGAATTACAAAAGCATTTACAGGACAATATTCCTTCTTGAAATTATATACAAGAGCAGTCTAGCATGTTTGACTGCTTTATTTTTGAAATAGTTACACTTCTTTTAAGTTAGAATCTTTAATTTAGTTACTGTTGTTGGTAATTACAATTTCCAAAAGGTACAGTTTACTGAAGCAAAATGGAATAATTGCCTTGGATCCTCAAATGATAACACGGTATCAAATTTTAAAAGTCATCTCATTTGCCATCAATATACATTGAATAATCTAATTAATAGGCAGTTCAAGTAAAAGAACTTTTTCTTATACGTGAATTTTTCTATACATGAATTTGTATGAATTGTATATTTTTATTTTGTGACTGTAATCTTTGCATCAATGTGAAATTTGTATGAGTCTTTTTGAAGAACTTTACATTGCAACCTCATCTCCTTTGTCAACATTCTTTAAAGAACGTGAAATTGAAAAGTATATTAAACCTGAAGAGCCCGAACCTGAACCACAGCCTGAAGAAATACCAGTAAAAGGTATTCAATCCAGTGGACTTAAATCTTCTTTATCATATTCTTTCTCTTGAAATGTATATGGTTTATGTTGTTGTACATATGTAGTATGTCTGTTCCCATTTGTATGTAAAGTATTCTTTGTTGTAAATGTGAGCCTCATTCTTAGGTTTCCATGTAACTTGTACTGTTTCTCTCATGTCAACTGTGGCTTGTCTGGATGCTTTGTTTGTTGTTGTTATTGGTGCCTTTGCTGTATTTCTCATCATCTTTGTAAAGGGTTGATATTTTTATGTTTTATGTTCTGTGTTTTATGTTGGATACTGGTATTACGTACCTTAAAAAGTAAACTTTGTACTTCATATATATATATATATATATATATATATATATATATATATATAATTTCTATTAAATATACTACATATCCACATGCTAACATATACATATACTAACACCTCTGAAATACTCTTTCAAG
>TTN-207,,0,1303,1631552,1632854,GTAAAAAATGCCACTTCCAAAGTTTTATTAGCCTGCTTCAAACTTCTATCCAGCCATCTGAAATGATGCTTGCAAGAAATGTATGACTTTTAGAAGTGTGTACTTTCAGACATGATTGTACTGTGAGATTGCATAGAGCTGTCTCTTCTGCTGCCCCATGGTTCCTGGGTTGCTTGTCATGCCATGCCTGCTGCTGCAAAAGTCAGAAAGTACATTGATAGCGTCATCCGGGATATCTGAATGCAGGCACTGTCCAATTAACTTTCTTTTGTGGAGTGGGGAGAAAGAGTTTTCTGATTTCAAAGCCTGATTGCTATACATATCATTGCGATCTTATGCTTAAGGAATGTATAAGAAATCCTTGCAAGATATTTTTAATATTGCAGTAACACATTTACATAAAAGCCAAAACTTTGTTCTTAAAGAATTGCATGTGCTTTTAAATATATTACAAGTAATATAGTTATGATTTCCAGTAGCTGATATGTGCCTATATATCATGAAAGGAAAGCATATGAATGACTTGTTACAGTTCCCCCATCTCTTTTTTTTTCTTGCAACTTAAAGAAGTGTTCTGTGTGGTTCTCAGGGGAGCTGGAAAGAGTGGTTATGAAGACATTTGGTATCCAGCATTTATTATTAAACTTCCCTTCCCCCTTCTTATATTTTGATTTTTCTATGAATTGACACAATGTTACTTAATTTTAAAAATATCAGTTTCTTTAAAAGCTGAAATAAACTGGCAGAAACATATTATTCTTATTTTAATAAAAAGTTGTCTTGTGACGTCATATGATTCCCCAATCTAAAATTATCTAGATATAATCTTAGATATGCACTTTCCCTATACAGACCTATGTATCTTCAAACCACAGTCTTCCAGCATAAGACATTGCTGCTGGTGATTCTTGCCCTCTACAACCCTCATAGCCATTAGGGGGACCTTCTGGCACCTCTTGAAAGGCCACCCATCTGTTAATTGACACTCCATGAAGACACACACATAAATACATTTCCCTTAATGTAAAATATATGCTTAAAGGAAAATTTCTTCCTCCTGCCAATAACAAAAATTGTCTTCTTTTTCTGCTGGTCTTTAATTAACTACTGAACTTTGGAGTAAAACTGCAGTCTGTTTTCATGGTTCGAATGCTGCTTGTATGTTCTTTGAAGGCTGTTCTTGGCTGTTATTAATGCTTTCTGGTTATAAGCAAAGCTTGGTTTTGATTCTTGGAGTAGAAAGTTAATCACTTGCTTCAGATTAAATATACAAATAACAAAAGTAAAATCATATTCTTTAAAG
>TTN-207,,0,3917,1632855,1636771,GTATTTCACAGGCTGAAAAATACATACTTATGTAGTACCCCTTTACCTGACTCCTTGCTCTTTCTGCCTCCATCGAATGTTCTGTCTCTCTTTTTCAATGATCAGAGAGTAGTCCCATTCATTTCTTATATTTCTGTGGCTTTTATGGTCCTGGCTCATGAGTGTTGCTTCCTTTGTCTCCCATCCATTTCATACATGTATAGACATGGTCTATCTTTGTCTCATCTACATATGTCTTCTTGCATTTTCCTAAACTTAAAAATAACAAATTTTACTGGTTAGCCAAAATTGATATCAAGAGACATATGAGATTAAAATGCTGAGAGCTAGTAGTAAACTGTTTTGACATTTCACCTGACATAAAAATTTTAGCCAATGTAATAAGCACTAAAAATAAGTCCTATCTTCCTTTTATATTATTAAGGTTATTTGTAGGGATTTCCTTAGGACTTTCATGTCACTCTCTTCTCACTGGCTCTAAGTCATTCTCTGAGGGGTACGGAACTCACATTTCAGAAAAATTTCCTTATTACTGTAGGTAATTTTTCAAAATGTATTTTTCTGTAAACAATATTTTCCCTAATAAGGTCTCATCTAAAATTAGACCCTAAAGAAAACTAAATGAATTATAAGAGTCTAGAAAACATCTATCAAAAATAAACATAATTTTTCTAATGGGTAGTAGTGTTCTGTTCAAGTAATCAACACATTCAGACCTAGAAATTAAGACTGTTTCTGGTCACTCTGAAATTTTGGGGAAAAAAGTCACCCATATAAATATACATTTCCTGATTTCATAAAGAGGCAATTACAAAATAATGTTATCATGGATATTGATCATAAACATTAAAATAGCATATAATCACATATAATGACTTTAAAAATAATAGCTACAATGTTGGGTTCTCAAACATCAATAAGATTTTTAAAATCAAATAATAATATAAAAAATGCACAGATATATTTTCACTATGTTCATTATATCAGTAAAGAAAATCTATATTATGCCTCCTCACTTTACATTAATTAGATGCATGTGCTTCCTTCTGGGTTTGAGCAATAAAAATAGTTATTAAGAAGATTGGTACCTCTAAAATAGTATTGAAGGCCAACACAATTTATCCTGGATAAAATACGTAATGTTTAACTTTAAAATTTTTACTTAAAATATTTGACATTAAAAAAATGATTATTCAAAACGAAATACATATTTGCCTATTGTAGGTTTAAATTTTTGAAATAAGAGTTAAGCAGTTATCTTTATCACATAAAAAACCATTTAATGAATTGCAAATATCTTGTTTAAAGCCCTAAATAGGAAGTTTTATAGAAATATCTAAAAATTCAGATTCCTAATAGCAAATAGTTACACAATACAAATAAATACTGTTTTAAATTAGATTTTAATTGACATTAGTAGAGAGGAAAATGGTTTAATAATCACCACGTGTTCCTTTCTTTCACCATTCAAATCTATGAGGGCCATAATAGCAAAAGAGGCTGCTCTATAAAATAGCATCATCCACCATGCTCAGTATTCACTGTAGACGCAACAGGAAATTTTGAATTCCTTGCGTTCCTTAATTTGAATGAATTTAAGAACATTTTCTTATTCATGAAAAACGAGCTTCCAACACCAGCTTTGAAATTTTATAATTCTATAATTTTAAATATTTTATCCAGCATTATTTCAAAAAGGAAATCTTAAGAAAGGCTACTCTTCTTCTGTTCAGAAAGTGAGATATGGCCCTTCCCCAGCATCAAAGTCACAAACCGGAACTCTTGGCCACCTTCTTCCCTCAGTGGAGAAGACTGAATGATGGCACTAACACTTGCCAGTATCATTTTCATACATTTAGTGGTTGGGTAGATAACATCGTAGATTTGGACAATCTACAATTGCAGTTTGGGACAAAGATGCTGTCAAGAACCCTGTAATTTGATGAAAGATTCATAAAGTCAGTATGGAGCAACATCCTCTACATGCATTTAAAATGAATACATTTGCCTGCAGTTAATGGAGTTGAATTTCATCACAAGGCTGTATAGATATTTGCAGAGGAGATAACTTGAAATGTATCATTTAAACTTAAATTCTGTGGTATTTATATGCAGCGAAAATTGTTACTTAATGCACTACAGTTAACTAGTTTTAGGAGAGACATTTTTCTTGTTGAAATTCCGTTTTTATATAAATTCACTTCAAAATTTGAAATCATATTCTTTTAAGTGCCTGGAGGTGAAAAGAAAGTTCGCAAATTACTTCCGGAACGTAAACCTGAACCAAAGGAAGAAGTTGTTCTGAAAAGCGGTATAGTATTTTTCAACCATTCTGTCAGCGTTAAGTATATTTTAAAAATGAACTTGAAAGCTTACAAAATGTTTCTGTCCTTTGGTTTTCTTTGAATTGGTTCGCTATTTATCAAAATTTGTTTGTAGTTTCATTGAAAATTAAGAAAAATGTCATTTCCAGATCTTTTTTTTTAAAAAAAAAAGACAGAAATTTTGTGAGCATTCACAGTATTTTGAAATTTAAAATGTTAATAGACATAACTAAGTTGATAATATTCTAAACTAACAACAACTATGACTGCCATTTTCATAACCAAATTATGTAGTAAAGTACACTAAACCTATTAAATACCTTACATGAAACTACTTTAGCTTAAATTCAATATTCAGTTTTAAAGTGTGACACAGGATCACCACAACTAATAAATAACATTTTTAAAAAACTGAACATTTCTTTCTGACTAATAAAATATTAAAGAATGAGAAACAAGATAGTCAAATGAAGAATTAAGTTCTAACATTGTCTTCACATAGAATTACTGATTTTTAGGCTACATTTCTTCAGATATCTCTGCTTAAGTAAACTTTCTACTTATTTACATACTCATTAAATCATTAACATTTAATTATTATTATAATTCGTTGCTATTCAAATTATTCATTTTGTGTTGGAGCTGTTTCTCCCACAGACTTGTCTCAGAATAGACCCTCTATCTAGATAGAAACAAAGTAACTTTGAGTGCTATTATAATTGACAACCTTTGATTTTAAAAAAAACAAAACAAAAAACACTTTCGGTGTAAATGCTTACTTTCCAGAGTGCTAGGTAGCATGCTTTTTTTCATTTTCCTTGCTTTGTACATTATTTGCATTTGTCAAGCTTATTCAACATCTTCATTAGTTTGTCTTGGTTTACATATAAACCTTTTTGTCTTTAAAGTTCTAAGAAAAAGACCTGAAGAAGAAGAACCTAAAGTAGAACCTAAAAAACTAGAAAAAGTTAAAAAACCTGCAGGTAGGAATCTCAGTGACAATTTGTAAGATTATCTTTTAACAAAATGGACATTTAACAAAAGGTTTATCTTGTAAACATAAATGAAGTTAGATGTAAACATGGCTTCATATTTCATCTGTGATGTAGTCTCTGTTTTCCATTGTCTGCTTTCTGTTTAAATATTTTTATAGTAATTCCCAAATCCATTCATGTATTTCCCTGCACTTCATTCTTATCATTACTTTGCAACTTAAGTTCTTCCAGTAGAAATGACTGAAATAATCAAGTGGCTATTCATGGGAGGGTGTCAGCAAAGGTTTCATAATCTGGGGGCTTTTAAATGGGTTGGTTTTTATCATTAGCCTATTCTCAAAGGGCAAAATTATTGGGAACTATTATAGAAGTGATTTAGAAGGAGAGAGCTAAGGGGAGTGGAAGATAAGTGGATGGAATAAAAGGAAGAAAAATAAATGGAAGCAGAGTCAAGAAAATAAAATAGAAATTACTTGATAAACTATAAGGTTTTTTAAAAAACCATCCATAGAGTTTTTGAAAAATAAATTGATATTTCAGATGAGGTGCTTCCTAAATATTCAAATATTAACACTGAAAAAATAATCTTATCTTAAAG
>TTN-207,,0,430,1636772,1637201,GTACAAATCTACTGTCATTCTTAGTTGTCTCTAAAAATGCAAATATGTATCATTTAAAATATCATTACACTGACATCAAGATTTGAACACATGACCTTAATCTGTTAATCACATATGGCTTAATTTTCTTTACCATCTCACTCTCCTATGCAATTGGCTAATGATTACTCAGTTGCTAAATAAGTTACCTGAAAAAAAATTGTATTTATGGGCAATGAGATAAATAACAACATTAAAACCAAGAACATTGCCTTACTATATTTTCCAAATATTTTGTTTAAAATGAAAACTAATCAAATACTTGATTTGATAATTATATGTATATAAATTCTAATATCTTCCAAGATACGTGGGCTTAATTTTAGTTTTGACTTTGTGAAAAACTTCAAAAATCCTGTAATAATCTGCCCTCTACTCTAAATTATTTCAG
>TTN-207,,0,259,1637202,1637460,GTGAGCAAGCTTATCCTCAATGTCAACAGCATATTCTTTCTGTATTCACACACATAACATGTACTTAATAAAAGATAGTAGGTGAAAGTCAGTATGTATCAAATGATTTCTAACGTCTCAAAATGCTTAATATACTATTCTCTTAAAAACTAGTTATTTGAAGATTTCAAAATTATATCAGAAGAGGCAAATAAGCTACCAAATAAGTTTTTAGGAAGTGACAAATTGATACACTAATGCAATGGACTTCTCTCTACAG
>TTN-207,,0,2279,1637461,1639739,GTATTTATCCTGTAGCTTTCTTTTTGCTAGTTTGTTTTGGTGACTTAATAAAAGTATTCACACTTGATTAAAATTCAAGCCCTGTTTATGCTGCAACATAGGTATCATTTCAACTTCGGAGGTTTATGGTAAGTTTCTACCTTTTCTTCATGTGATATCCTTTATCCACCTTGTCTCTTGCCCAGTGGGTGAATATTGTGCCTTAACTGGAATGTACGTTCCTGGGTTGCACCATTTCTTTCATATGCTTTGGAGATTAAGTAATGAATATGTTTGGGGCTGATAAAAACTAAGGAGACAGGCAGAGACCCTGTAAGGGTATACATATAAGAATCCCATGAAGCTTCAAATTTCCCTTATACCCTATTGGAACAATTTCTCTTTTTTAAAAAAGTGTGTATATTGGGATAATGTAAAAGTTCTGGAAATGGATAGTGTTGATGGTTGTACAATATTGTGAATGTATTTCATGCAACTGAATTGAATACTTAAAAATGGCTAAAATGGTAAATTTTATGTTAGGTATATTTTACCACAATAAGAAAGAAAAAGAAAAAAGAGACTCCATATTTCAGTCTTTTAATCTGTATAAGGAATTAGATCAATAATAATTTTCTTAAATGTTCTAACTTAATGATATAGGTATCTCAAGTCCAAACTTAAAGCACCTATTAATTGTATATGAACTATTTAGTATAGTTCATCATTTAAGTGATAATTTGAGATATAATTGATCAAAACTGATTTGATGTGTAATTGATAGTCATTGATAAACATACACATCCTGACTATTTGCCCTTTGGCTCACTATCTGGGTGATGAGATCACTCATATCCCAGACCTCAGCATCATGAAATATATCCACATAACAAAACTGCACATGCATCCCATGAGTTTAAAATAAAAGTTGAAATTATTTTTTTAAAAAAGAAACAACAAAACCAAAAATAAAACAAAGTAAATTTAAAGCGGGGGCGGTGGTGGTGGGGTGGGGAGAAGGCATGTATTGATAATTTTCTAAGATGTGAAGAATCTAAGATATTCAATATAATGCCTTGACAATTTGTTCCTATGGAAAAATGATCATCTCCACTGATAAAGCACAAAATAAAAAATTCAGGGTGAATTTAAAAAAAAAAAAAGAGAACTATTTGTTACATTCCACAGTGAGATGTGCATAGGCCCCGGGAATAACATTTAGAAATGTCCATAATAGTTTGACAGAGAAATTTTTTAATTTAATTTTCTGAACCTAATAATAAAAATTGGCTTATATCTTTAATAAATCAATAAATAAAACTATTTGGAAAAATTATATTATTTTAGATTATTAATTCAATAATTAGTCATTTTATATTTGTTTATATATTTTTATATAAATTATTTAGAAATTTTTTTATTTAAAATTATCTCAAAATATTTGGACATTACCATGTTTAATGACATAAAAAAATACACTATATTCTTTTGACTGTAGTTTAATTTTTAATATTTGTGTTATATTTTGTTGCTGATGTTTATGATTTGGGCATATTCTTTTAAACTTTTATAATGTCAACGTAGTACTTTTATTATTCAGAAAAAGGTGATGAACTGCTCTTGTCTAATTAAGTATGTATAAAAATAAAGCTATTCTCAGTTATCCTGGGGGCTGAAGCTAGAGAACTCATTCCACAGTTTATACTGTCCCTGTATTAATAATGGAATCAAACTCTAAATGTCAGAACTCTCTTGCTTCTGCCTTACTTCATTGTCTAAAGGAAATCTTCAAAGAAACTCATGCATGTGTGGTACATGGACTCTTTTTCCTTAGTCTTCCCTGGATTTGTTTGTCTGCCCAATTTAGACATAAAAAGAAAGGCTTTTGGTAACCTCTCAGCCATTTCCCTTTTCCCTACACTGATTTATTGACAAAACCTTATTTCCTTGGTTCACATAATCAGGACTTACATAAACATATAAAATATTTTGCACAGCTAGGCAGGAGCAAAACTTTTCCTCACAAGGCAACAGTAAGCCTTCCAAAAATGGGAAGATAATAAGGCACTTGCTGAAAGAAGTTGTTAATCCTAAATATGTTGGCAGTTTAGCTTGAGCTCTTCAGTCTCAGAATATGCCTTCCTGGAAATGTGATTATCCATAGAAGTCATATAAATGAAACCAATTTCTCTTTATGCGTTAATATTTATAATGGAGCATGACTCACCCTCCATGGTTTACTATTAAACATGAAATAAGTCCGAAAAGTGTTTAAATGCTGAGTTTTATTTTTATTTCAG
>TTN-207,,0,569,1639740,1640308,GTGAAATTCATTTTTCTAGTACTTGCATTGTAACCTTCCACTCTGAATTTCCAAAGTTCATATTCAAGGGGAAAAAAATTTCAAAATTCATAACAATTTTTATTTTTTCTAATTGATTCTACTAAAACTAGCATGTTTTCTGATATTTCAAATAATACTTTTAGTATTATGCAAGGAGATATATATATATATATATATATATATATATATATATATATATATCCAACTATATTTTAGCATAGTGAATCCCATAAGTTCTTAGCTTCATTTTTCATATGCATGGTATTTATACATGGCAGATAAAATAATTAGACATTAATCTGGCTATTTTATACTTCAGATTAAAACTTGAGAAAAGGGACATTTATTATTCATGGATTCCTTATACCATCTCATTTTCCTGCCTGAAACAAGGCAGTATAAACTCAATTGGCCTTTCAATTGCCTGGTCTTTAGTTTTCTCGTCTTCTAATTGCTTTACGGCTGGTTTTATCCAGCAGGCAGCCAAGTATGAACTTTCTGACTCCTAAGGAGATGCCAAATCAACTTTTTATTTTACTTTGAATTAG
>TTN-207,,0,156,1640309,1640464,GTAATTTCTAGTCTTCTGAACATAATCTATATTAAACTTTAATGTAACAAACCTTAGTAGCAACTTGCATTGTAGTTTTACAAAACCTCTTATTTCCAAGTTTTATTTCATTGAAAATATTGTATTTATTGAAATATATACTGAAATTCTCCATAG
>TTN-207,,0,247,1640465,1640711,GTTAGTACTTTCCTGGGAGATTTCGTTCTGCTTATTGTTACACTAAGAAAATGGAAGAAAGGACCTCGTTTCCCAGTATTACAATATCAGAAATCTTGTACCTAAGAGGGGAATAACAATATATCCTACAGTGGATTAATTATGCCCAGTATTGTGAAATTTTTCCTATTCCTGAAATTTACTAAGGAAGCTATGTATATTACTTGTTCAGACCTTAATCATTTTTTCTGATCTTATTTTCATATAG
>TTN-207,,0,135,1640712,1640846,GTATAAAATCTTACCTTTTATTCAAATTATAAGTTTTGCGTATGTGTAAAGCCAAATAACACACCAAAACACATAAAAGCAAAGCATCGTTGGGTTGTCTAAAGCATTATGTTACTTCATCCCTGACCAATACAG
>TTN-207,,0,315,1640847,1641161,GTGAGTAATTTCACATTTTAAATTGTTAGTCATATAAAATAACCACATCCAATATTCAGGATCTATATCCTAGATTCGGGTTGCTTTAATAATAATGGAGTTAATGGAGTCTTCTAAAGTCTCCAAGAAGGAAAGAAATTTTACGTATCATTTGGGGACAACTTGAACAATTTGTGTAAAATGTTATGACAGGGAATTCTCTGCTTACTTTTATTAGTAGTAATTTTTAAAACTCTATAGAAATTTGTATCTGAAACACTTCTCCTATAGGGAATTTATCTCTTTCAAATGGTTACTAAAACTATTGTTTTTCAG
>TTN-207,,0,93,1641162,1641254,GTATGGGGCTTTTAGAATTTGGGGAGGGGTCTCAACTTTATTTCACTTCCCTGTGCATTCTGAAAAGCCTCATTCTTAATGTCTGATTTTCAG
>TTN-207,,0,282,1641255,1641536,GTAAGCGAGCTAATGAGATCTGTGACATCCCATAAAGGCATGCAAATATATGACTTTAAAGATAGGACGCCAAGTTCTAAAAGCTGTGATAATGCATCACTAATTAACTTTCACAGTGTTACCAAAACAACCCCCCTTAATTTGTTTTTAGTGGAGCTCTATTTGGAAAGATGAATAAATAAGTGCCATGTGAAATGGGTCCCTTTTACTCAGGCAGATTAGAATGGAATCTTTCTGAAGGTGAATTGTGTTTCTGAGGCATTATCTATGCTTGCATTTCAG
>TTN-207,,0,140,1641537,1641676,GTAAATGTAACCAAGTATAACCAGATAGCCAGTTTCTGAATCATGGGAGTGGGGAGTAATAAAATATTTTGCAACCTTTTACTCTTTAATAAACTTTAATTTTCACATTCTTCTAATTTTATGCTAAATGTCTTTTACAG
>TTN-207,,0,86,1641677,1641762,GTGAGTTGCTCAACAATGTAAAATTTACCCTATCTGAATCTGCAGTTTATTAGTTCAGTCATGCTAACAAAACTGTATCATTTCAG
>TTN-207,,0,142,1641763,1641904,GTAAGTCAAGATTAGCTAATTATATAGGAGAGGGGTTGCTTGGTTGTGTAGGGTGAAAAAAGGCATAAAATATCTTGATGATTTGTAGGAATAACTATATAAATGATGTTCTTTCTTTCCTTCTAACCCTCACTCCAAACAG
>TTN-207,,0,125,1641905,1642029,GTATGCTCTACTTGTCAGCCACGTTTTTGTATTTTCTCTGCAAGACTTCCTGATACACCCCTGCATTGATCAAGGGTCATCAATGGAAACGTATTCTGACTTCATCCACTGTCCACTTCTTTCAG
>TTN-207,,0,112,1642030,1642141,GTAAATAGTTTTATCAAATAGTCCACCCCAAAATCATTTTTTTTGCCTTTAGTTTTATATTTCTTCTTTAAAGTGCTTCAATTAATAAGTTCTTTCTTTTTTTTCTTGATAG
>TTN-207,,0,846,1642142,1642987,GTAAGTGCTTTTTAAATTTTAATTTTACTGCATTAAATTCAACAGAAATTTGTGGAGTATCTATTCTATAAAATAGTCTTCTAAGTGTTATATTGCATGAAAGCAGCCCAACTCCTTAAGAAGCTATCACATATGTAATCAGGCTTATTTCTAAAACACTTTACCTTCATTACTATAAGTTAATGAAGATTCTAGCTTACACCCACAAAATAGCCAATTAAAAGCCAACTTAAAATTCTTCATTAATTATTGAGCCCTGTCATGTTTAAAATAGGAGTATATAAATACTTTCTATCTCTTCATTTTATCAAAATTATTTCAGAGGAATGTTTTTCAAGTTTCCCATAAGAGAAGATATTACATAATTTACATTAATAAGCCTCATTGTTTTTCTTGGCCACCTAATATCAACAAGATTAAACATGAAGGCTAACATATATAGACATGATTAAAGGCAAACTATTAATTGATTAAGAAAAACTAACAATGTGAACCTGAAAGCTTAAAAGTAAACTAGACATAATAGAGTTGCTAAGAATTAGAAATTTACCCAAATAATGGAGGAACACAAAATTGTATTTGAAGCTAAATTTCAGTCTTTTTAGCTACTGTTAATAAAATGTTTCAAAATTCAATATGAATGGATTAGATCTTGATAAATCCCACACACTGATTCCCTTCCTAATATTTAGAGAACTTTTGAACATAAACAGGTTAAATGATTGAACACTTGACACAATTTTAAAAGATACTCAGAACTCTGTGAGTTGTGTCTTAAACTTTCCAAGAGATTGTCATTTCCCTAAGGTGATTAATAAAAGCTTTTCACTTATACTTTACTTGCAG
>TTN-207,,0,90,1642988,1643077,GTAAGGAAATTTCCATGAGTTTCACTCTTGAAGCATTGGGGTTATTTGTGCCAGAGGCTAATGACCCATGCTGGCCCTTCACTTTTCTAG
>TTN-207,,0,436,1643078,1643513,GTAAGGCTATTTCTGAACTTGTCAACACCTAAAGGAGCTGTGTGAATTAGAAAAGAACAGGTGAAAGTCAGAGTGGATGCAGGACATTTAAAACATGATAGCAGTTTCTCTATCAGACCCTAAGCCAAAGAGAGATGTCAGGGTCTATGAATGGGCTCAGACTGGCACACTTGCATTACTTTTGATCCAGCAGAGTGAGTATAAGGTTGTAGATACTCTGTGATGCTGCTAGTTGGCTCAGAATTATACAGCTAAAATAAATGTGGCTTTCCTCTTAGTACTTGTAAGCTTTACTTCCTAAAAAAAGAGCTCAAAGTTATATAAAGTTTCATCACCATTTATTTGTTGCATTCCTTTAATTAAGATAATCTATCCTTAGAACAAAATTTCAAAGAAAATTATTTTCTATGAAAGTTTTTCTGTTTTGTTGGTACAG
>TTN-207,,0,797,1643514,1644310,GTAAGTATTGTATATTTTTCAGGGAAATTAAATAAACACTTTTTCAGAAAATGAATGTGAGTGAAATTAATTGGACCTATTTTATTAGTTAGAAAATATTATTAAAACACAAAAACTGGCTCTCTTGTATTTGCCACTTTGACATTCCAATACAGAAGTGGTTCAAATCGTAAAGTTTTGGAAATTTTGTTGACCTTGCCATTTGAACAAAAGAAAATTTAGCAAATCAGATTTTCCTGCTCTGTAGTCCTCTCATTGAAAGTAGATACACATACAATGAGAATCTAACTCAGAACCCTTAAAGACCACTTCCCTCAAGTGGCTGTGCAACTAGAGCACCAGAAAGACAAGCTTTGCTGTGTGGGCATTTTAGATTCAAGAAAGAAGGTGGGAAGCATTAGGCTAACGTTTCTGGAAGGTGCAAAGTGTTTGATGGATAGGGACAGCCTCTGATTGAGGGCCCCTTGTCCTCTCCCAATCAGAGTCTTAGTTATTTTGGAAGTCACATACCTTATGTAGCAAGAAGAACTTGACGCCTGGCAGAGAGACAGATGCAGCACAGATTTCTCGCTGACCTTGTACGTCAGAACGAAAGGGCCCCTACATATACTCGCTCTCTGGCTACCAGCTCTCCCCTTCTCAGCGCCGTGGGGCCACGTTCACGTGGGAGTTAAAATAGTGGCCAGTCCTGTGGCTTCTTGAAGAAAGCAACCATGAAGATTCATATCTAAGTCTCTATTTATTCTTTTGGGATTACAAAATGAGTAACGCAAAGCTGTTTCTTCCCTCTCGAAAAG
>TTN-207,,0,3904,1644311,1648214,GTAAAAAGCAGGCATGCCTTGTCTTTCCCGTTCTTTTTCTGGAGTTCTTCCACCTTCACTTGTATGTTCCTTATTCTTTGCTCTTTCTAATGTCTCTTCCTCTGTCTTTGCCTTTCTCTTTCCGCCTTTAGCCTGATTTCTGCTGAAACTGTAAAGCCAATTTTTTGCATTTTTTCTTAGGTTTAACCTGATGATTTTTTTATTGAAATTGAAATAAATTTAAAGTATGATCATGTTTTAGTTTTTTGAAGAAAAGACAAGACTCATTGACTATGAATGATAGTTTGATTAACCAGAAGGCAGGAAGGATCAAAAAGGCTTTCTGATTGCACGCTCTGCAGCCATGGTGCACATTAAGTTTTAAGACTAACGCTCTCCATCCTATTTAGTGTTCTGCATATAAGGGGATTAAGAGGAGAAGACTGAAATTCCATTTCGGGCAGTTGATCAAGTAGTTGAGATAACTTCTGGGCAGATTTGCTCTTCAAGCATTTCTCCAAAGCTATTTTTAACCTTCAAGTGCTCTGGGCTGTGCGATATCTGGAATGCAAGTGGACTATTTAAAGTGCAACTGATGGTACTGACAAGAAAGAAGGGCTCTGTGGTTATCCACATATGTGGATGAAATATTTTTTTTAAGCTTTGGTAAATAACTAGCTCCTGCTTTTAGCTTTTACTAACATTCTTTATGCCCAAGATTTTACCCATAAGTAAAAACTAAGGGATTATTCAGATAGGCCCACAATACAATTTGCCTAAATTGATCTATATGTTTTGTCCCCAGAAACAACATATGTCTTTAAATTATCTTGACAATCCATCATTAATTTTGAATTCTTAAAATAAAATATATGGAATATGTCCAGCCTGGGTTGGAAATAAAGCACAGGACAGTACATTGTTCTGTGACATATTCCCCCAATATTTCAGAAATACTATTAAATGTGCTATAAAGATCTCAACAAAAATCAAACTTTGAAGACTTAAAGGAATATAATTAAAAAGTGATTCAGTTTAACAAAAAGCCACAGCATTGACTGAAGTATTTGAAAGCAATGCCTTCAAGTAACTGCTTTGAAACAAACAAACAAACAACAACAACAACAACAAAACTAGTATTCCACTAAAGTGATTACAGGGTAATTCACCAGCAGTCATCTGATAGGTAACGCCTGCCTGTTATACAGATAATAAGATCTTCTTGGTCTCCTTTTCCAGTGACCAGAAAAAGCAGCAGTACATTCCATTTGTAGCATGGGAATTAAGTTACATATCACAAAACCTTCCTTACAATGAGGTCTTCTAAATATTGAACTGAGGGAGGCACCTCTACCTTCAAGCTTATTGTTTGAAAAAATATATTTTGCCTATCATGCATGATTTAATTAACTTCATGTCTAAAGGCAGAGAATTGGTTGCTTTTTCAAGATTCTTTCTAGATCTGCAAATTCATGATTTATATATAGGAACACTGCTTAAAGACAAATGATATTATTTTTTCATTACCAAATATCTTTTTGTCATAGTAAGAGCTTCTTATTAAAAGATCAGTCTCAGTTCTAATACAAAAACTGCACTATTTTAATTCAAATGTAGACTCCTAAAAATCTTATTCACATTTTATTTTTAAAAAATTCTCATTGTAACTAAAATTTTTTCTAGGGTTAGAAAGGATCAGTTTACTATAATTCTATAGGGCCCCTTTACATCTCTTTTGGCATAGGAATTTTAATCCTTTACTCTAGGCACCCGAAATACCTTAGCCTTTTGTGAACTTGCTCTTGCATTACTTAAATGTCTCTTTTCAAAAAGAACTTAAATATAAACTTTGAAGTAATAAAATCATTTTGTTACATGTGGCAGATTTTGTTTAAATTAAGTCTGTCAGAACAAACTTGCTCTTGTCAATGTAATTCCGAACTTTAATACTCATTTTATGTAAAAATTTTCGCCTTCAAAACTACAATAACCAAACAAGCAAAAACAAGCTGTAGGAATAGGAAATATGAAGAGAAACTTGTAGACATGAGTTGTTTGCATTTTTTCTTTGTTGTTGTAGTTGTTTTTGGCTGTCAGTTTAAGAAAGGACTGCCAAGTTCCAAATGGCATTTGATAATTTTAAAGTTAAATTTTAAATTTGATAAAATTAAAGTTTAAATACAAAACTTTAATAGTTTTGTCATGGTCATAAGCCTACCGTATTATATTAATATGCTTCCACTATAAATAAATATTTTTAAAATCTCTAACATTATTCTTACAATCTACTGCAAAATCTTCAACATTCATTTCATTGGTTTATTTTTATAAGGCACCTACCAGTTTTCCTTTTTTTTCTTTTAACATAGTGGAGGTAGATTGTATACAAGCTGTTTATTGAGACATACTGCATTCTGAGCAGTGTCCTAGAGTAGCTACAGAGGAACTCAGATGATAAAGCAACATAATATTAATAGATAAAATATATCTGTGGGTGGGTTAGAAACTGAGACACCTTTTCAAATAGCCAAAAGTTGCATGCCAAAATTTATACTGAAATGTTATTAAAAAAACAAATTTTTCCCATTTCAGCACCATGCCCTCGGATAAGTAGCTCTGTTCCAAGGGCATATTTAACTACCCCCTCCTAGCTGTTATTTTTCCTTATTATGTTTTTTGGCCACTCTCAATTATTAAGATAATTATGTGACTAACCATGCCCAGTTCTTAATTAAAGAAAACACTTTTAGATGAAACCTTATTTCTGATTCTTTTCTTTACACTAGCATAACAAATAGTTCCACTGGTGAAAAACTTTACATTATTTTTAACGCTAAGTAAACTCTTAAGCAGTGCAAAATCAGTCTGGATGACAGGGCACAGCTTCTTAGGAATTTTATATCATAGAACTGGAAGAACCCCCAAGTCTCTTATCTTTGCTGTCAGAATGACCCCTATCTGTCGCACCATTGACATCTGATTTTCCCATTCCTGATGCTTAGACACATGAAAAAGGAAGAAGAGTCCAACTTTCATTTGCAGTTTTGAACAAAATTAATAGGTTGTACAAATTATTTAATCACAGGTTTAATTGGTTTGCAAAATAAGTTTAATTGCTAAAATAAATGGGAAGAAGAGTTATAGCTTGTTGTTGCATGGCAAACACCTTACATACAGAACATAAGGTTTACTTTTAGCTTGCCATAGCTGATATTTTCTTTCATCCTTTCATGAATTCGCTTTTCTAAGTTCTTCCTTTATATGTATATAAGCCCAGGGGCAGAATGGGGGCACACATATATATACACATATACGTATATACTATATGTGCTGTATATCTACGCATATGCAAAAAAGACCACAAATGTAAACAGAAACTGGCCTGGGCAATTTCAATGTGAAAGGCCACCTAGTAATTATATAAAGGTAACTATGAAACCCTAAAATTTTCTTGAAAGATCCCAAACTGCATAGTATTCCATGGTGTATATGTGCCACATTTTCTTAATCCGGTCTATCATTGTTGGACATTTGGGTTGGTTCCAAGTCTTTGCTATTGTGAATAATGCCACAATAAACATACGTGTGCATGTGTCTTTACAGCAGCATGATTTATAGTCCTTATACCCAATGCTAGATGATGAGTTAGTGGGTGCAGGGCACCAGCATGGCACATGTATACATATGTAACTAACCTGCACATTGTGCACATGTACCCTAAAACTTAAAGTATAATAATAATAAATAAATTTAAAAAAAAGATCCCAAACTATTGGTTGAAATGATTTTTGAATGCATACGTGCTAAATAGATGATTATAAAACAACTTGGAAAGCTCTATTTCCATTTATTTTTATCTAAATGAATTAAATGCACCCATATACTAGATTGCTGTTTCATGTATTCTTTTTTTAAAAACAACTAG
>TTN-207,,0,541,1648215,1648755,GTAATTACAAGGCTTATTTTAAAAACATGTATAAGGCAGAGGCTCATGAACAATGCCAACTCTCAATTATCTTTATATGATGAGTACTATAGATGTTTAAAATCAACCAAATAATCAAAAGTCTGATTTTACTTTTTAGCATAACAAAATAATTCACAGACTATCTTTTTAAAGAGCCAAAATTGACTAGCATAGGTTTTACTTCCTCCTTCCATCTCTATTGTTTTTATTGCACATCCTAGATTTTCAAAAGCCAGCTGGAGGAAGAATTATTATCAAGCTAGGTATCCATCACTTTATTAACCAAGAGTTGGCTGTTATTTCCTTAATGTTTCCTAGTTTTTAAAAATGATTTTCCTCTTGTCTGTACAAATAATGATAAAATATCATTTTTAGAGGAAAATGTCTGAGTGTAATCAAAACTTGAAAATAAAACTTAGGACAGAACAAAGCCCTGGAGATGGCAGGGGAAAGTTGAGAAGGTACCAAAACTCTTGGAGAAGGAAAGGAGTACCTTGGCTAATGAGTATGATTCTTTCAG
>TTN-207,,0,1697,1648756,1650452,GTAAGTATTCTTCTTACAAAGGACTTTTCATTTGCAATTCTTTAATAACTACAACAACAAAACAACACAACACTTTTTGCATGCCCTTCTTGGCCTAACTGCATTTCTTGGCAACTTCTAGTATTGACACTGACCTAACCTGATCCTTTATGTGTTTAAAGAAAAAAAGAAAAGAAAAGTCTTATTCTATGTCTGGTCTGATTAATGATGGAGCAATCACTTTTCCCTATGCTTCTTTTCTCTCACTGAGTAGTGAGTAGATGTGCTCTTTGTCTACATGGGGTCAGCCTACTGTATGGATATCCTGATATGGATGAGGAGAAACTGAATTTTAAAGATAAGTAGGGAGTCCTAATTTTAAAAACAAAGTAAAAGTGATTTCCATGTGGAAGGAAAATGAATTTTCAGGTGTGGGGAACAACTAGAAAATGAGCATGAAATTTCAGTCTGAATAGGAGCATACTAGAGATCTGCTGTAATATGACAAAGCACATTCACATGATTCAATCTCTGAGAATAAGAATGGATAAGAAGATGGAGTGAGGCCCTGGATCTTTTGAGTCCTGGACTCTTTGAATGAAGAGAACTCTAATGGTTTTTAACATTACTTCTTCCTCTGGTGAAAAATGTAATGTCTTTTTTCAAAATGCCACATACTAGCTTATTTGTTTCATTCATTCCTTTGTCCAGTGATGACATTTTTCTGCAAATTTTTTGTGCAATATTTGTTTGTTTGGTTTGGTTGCTTCCCATCTGTCAACAGCTACAACCTAGTGACTCTGTGCTTCATGCATCTTGTACCATGTTTTTCTTACCACTTTGTGGTTGCTCTGCTCAAGCTTATGTCAAAGTAGCTTCTTGGGTCTCCTTCTTCACCTTGACATCTACCTTCACTCCAAGAAGGCTCAGCTGCAAGGAGCATATTTTCAAACCTATTAGACAGCATTTGTCTCAGAATCTTATTGCTCAAGAATGGTCATCTTGGGAAGGACTCACAGGGAGCTCTGAAAGAAGGAAGGGCAAGGGGGCAGCTCCCTAATCCTATACACCAGCTGAATTAATTCTACAGATGAATGAAATAACAGATGTAAAATCCTAATCACCCTCCCATACAAAACACATTGCTTTATTGCACTAATAGATGTTATGCCTGACTTATATGTGACGTCTTCAAAGCTGATTTTTTTAAAAAGCTAAATGTATGTTTCAATTACAGCCTCATGCCTCTTAGCCATACACAAGGCTGGCCATAGTGCTTCACGTGTTCTATCTTTGAATTCTGCTAATTTCTCAAAGATTGTGCTAAGTGCCTTAAATAAGACAATGTTTCTTTGCCACTGGTGTCTGAAGTTTCCTTTGACATTATCTTTCAAGTCTGGTGCAGTGCAAATGAAGATTTTTCCTCCAGCTATTATTCAAAAGAACTGAGATGGCTCCCTAGTATATATACTGTACACACACACATGCACACTAGTTGAACATATAGAATGCCACATAATTTTATGTAAACTAAAGAGATATCTAAAAAGCAAAGCATCATACCTGATGGGCAGCTTCAAGTGATTTCAAAGTCAGTTGTAGTCTATTAAGATGGAAAATCCCTAAAAAAGAGTCACTTTTTCTTAATGTATACTATGGTAATGTCAGAGTAAATTTCCAGAAACCTCATTTTGAATTCTGATGACATTCTCTTACAG
>TTN-207,,0,661,1650453,1651113,GTCTGTGACTGTATACCTGTCATCTTGTACTGTCAAATAACTTTATATTTACTTTTGGTCTAGCCAAAATGGAAAAAAAAAAGTTAGTCACAACTTCTCTGGTCACCACTTTACTTTTAAAGATAATTGTAGTATAAAATGTATTCTTGACTTTAATTGCTCTCTTTTTAGTATTATTAATTTACTATTACTTGAAAAACACTGGACTCACAATCAGGAGATTTAGATATTAGTTTGAACCATATGAAAGTGCTGTTTTCTTAGATCAGAAAGTCAAATATCAGCAATTATATTTCTTTCAACTAAGTACCTCCTGTTGCTATTAACTACCATTGGCAAGTTTCTTCAAGTCTGAGCCTTAGTTTACACATCCAAGAAGTTAGTCTGCATAATGTCTAAGGCTCACTATAGCTCTAAACTTATATGATCCCATTGTTTTTAATAACTGATAATAGTATCACAGCAGCTAACTTAACAGTAATTGGTAAGATTGTTCTTGCTTTTGGGGTTTGTTTATATTTGTGTCTGCCACCTTGGTTCTTCTTCACACTATGAAGTCTTGTTGGTTGCTTTCAGAAAAACTCAGGATCATAGTTTTTCTTAAGGACACCTGTGTGAAGGAACAACAAGAAAACTGATAATCTATTTATCTTAAATATAG
>TTN-207,,0,98,1651114,1651211,GTAAGAGTAAAGTCATTCTTTGTGAAGTATATGTGTTGGGAAAAAATAATAATTTCCAGCTTAACTCAATGTGGTTTTTGTTTTTTCAATGCTTGCAG
>TTN-207,,0,106,1651212,1651317,GTATGAAAACTACAGTGAATAATCTTTTATTTCTAACAATTCACACTTGCTAGATTTAAAGTACAAAGACATATGTTTCTAATATCTTGTAACTTTTTCTTCCCAG
>TTN-207,,0,108,1651318,1651425,GTAAGTTTGTTCTTGCTTTTAGGGTTTTTTGTTTGTTTGTTTGTTTTGTATTTGTATTTACCACTTTGATCATTATTCATACTATAAAGTCTTGTCGGTTGCTTTCAG
>TTN-207,,0,89,1651426,1651514,GTAAGTAATTTATATACCACTAGAGATTTTTTCATCAGTTTCTGTTATAAAAATAATTAAAATCAACATATTTTTCTCCTTTACAACAG
>TTN-207,,0,104,1651515,1651618,GTAAGCAAGATCTTTTTATTCTCTATTTCTGTAGCTATATATACACTTTTGACAATTTAGTGGCCATCATTGCAAGCTAACTGATAATCCAATGTCTCCTTTAG
>TTN-207,,0,100,1651619,1651718,GTACATATTAAGTGAAAAAACAATTCTAATGTTACCAATTTTTTAAAATTGTTAATCAAAATGTAAACATATTTGTATTTATTTCACATTTTCTTTCCAG
>TTN-207,,0,767,1651719,1652485,GTCAGTCCCTTTATTTTAAAATATCCTTCCAATATCACAGAGTTTAGATTTCAGATTTCACAGTTATTTAATGAGGTAATCCTTGTGAGGGTCTTTCATTTCTAGCAAGCCCTACCCACATGTTAACAACTCTAATTTTGCTCACTACAAAGTAAGTGTCTTGAGTAAGAGGAAATTAATAGCAATAATCTTTACATGCCAGAGCCTTGGACAGTTGCTAGTACATGATGACTATTTATGAACTTAGGCTACAACTAAGCTATCACCCTGAGAGTCTTGGCAAATCTAAAGACGGTCTTATACTCTCCTACTTTACAAACCCCTGTGTGCCTTTTAGGTATGTTCTCATCCTGACCCAGGACATCCTTATACACTGTCCTTATGAAAAAGCCATTAGTGTACCTCTCATTCATAAGAAAAAAGTTTCTCTGATTTATTGAACTAAGTATGCAGTGCCTACTCTATCAAAAAACAAAACAAAACATGTTTTGCACTACACTGAGTCCTATGTTACTATTTTTGGCAAGGAATGCATGTCTTATGATTTTATGCCATTCTCAATCCTCTACTCTCCAATCTAATTTGCACGCACAACAACAACAAAAAGCTATGAGAACTCTAAGCCACTTAGTTTTCTCTGCTATAAAGTTACTGTAGCTTACTTCCAAGGTTATGTAACCAATATTTTCTAATAAATGCATAATAACATGATGTAGCTTGGCTACGTTTAATAGTCGAAAGCGTTCACATGTTATCTTTCTCACTAG
>TTN-207,,0,92,1652486,1652577,GTAAGCCCTTGGGTCTCTCAGACTTAATTGGCAAAGCACAATTTAAAAGCAAGACAGCACACTAAAAAAATTCCTCTATATGTGAATTTCAG
>TTN-207,,0,107,1652578,1652684,GTAAGAAGTTTTAAGTAAATTCAAGTTAGCTTTTAAGTAAATTGCAGTCTTTGCCTTCATCATCGTTACCCCAAACTCATATTTTCTTCTTCTGTGGTGAAATCCAG
>TTN-207,,0,266,1652685,1652950,GTAAGCCCATCAAAAAAGGGAAATAATTACTGCATGAAATCCAGATATTAGGCCTATCAATTAAAATAAATCAAGTTAAATGAAAGTTAATAAAAAGGTAGAATATCATAAAAATTTGGATAAAGTTTTAGAAACCCAGACTGTGCCTACTTTACTTAGTGAATTTGATAAACCTGTTAATGAGGATGATATAATTGATTACAACACTGTTTTCATAAATTGTCACTAACGTAAATGGTATGCTCCAACTCCTTCTTTTATTCCAG
>TTN-207,,0,90,1652951,1653040,GTAGGTCATTTGCATATAAAAAAGAATATTCAATGTGGATCATGGACATAACTGTATGTGTTTTTTACAAATATTAATTCATAATCGTAG
>TTN-207,,0,106,1653041,1653146,GTAAATAGATATTTTATTTTTAGATCGGGGAATAGCACATAGCTACTTTGGGGCAACAGGGACTTAAATATGGCACTGCAAACTCATTAACTTTTCTTCTTTGTAG
>TTN-207,,0,98,1653147,1653244,GTAAGGAACAAAACATTTATCATCTAAGGTGATTTGGCAGTATTAACAAATATTAGTTCAGACTATTAACAGTGACTCGTGAGTGCATTTTTTTTCAG
>TTN-207,,0,690,1653245,1653934,GTGAGTTTTGAGCAGCACTGCATCAATGCCAAAAATGAGAGTAGGGGAAATCCCAGAAGGTTGGGATGCCATACAAAAGTCTTATGTGCTACAACTTCTTACCTTTACCTCACTGAAAATGTACAAAAACTTTTTAAGAATGCATCGGTGCTAATGCTTCCTGAGGTAGCTCAACCAAGGATTGTATAATTGTAATTGTCTTGTCTTGTGAGCCTTACCAAATTTGTAATAAAAAAAAAAATTCCCTACTGACTTGGTACCTGCTAAGTACCCAATATGTACCCATTAAGCTAGAAGTGGAAAGTAAATATTTATTTCCCTGGTGGTCACACTTCTTATTCCACTAGAATACCTTAGTTGACCTAATCAGCCATTATTTCCTTGTGTTTATATTAGTTACTATTCTTTACCCTGAATTAAAATCATATTTCTGATAAGCAAACTGGTAGAATCAACACCTCATTTGCCATCTTTTTTCATGTGTACAAACTATGAAGCAGTTTTTCTTATATTGAGTCAAATATTATCATGTATCCTACTTTGCAATTTTCCCTAATATGAAATTAATGTAAGAATAATCCCTAGCATTCAAAACAACTGCAGTTTGTATCCCTGGTCATGGTAAAAATCTTTTGGGTTGGCGAAAGGGTTTTTTGGAAATAACTGATTAACTGTATTTCTTTGTCCCAG
>TTN-207,,0,156,1653935,1654090,GTGAGTACATTCTTGATGATTTCTTACCTAATCTTGTTGCCTGTTTTTGCTTTTAGACCTAGAGTTGAAGTTATGGGGCAAGGCAGGGGTTGGCAATGTGAAGAGAACTGCATAGGTGGCCTGTGTAAGACTGACTCTCTCTTCCAAATGTTGTAG
>TTN-207,,0,338,1654091,1654428,GTAGGTTTTTAATTTGGCATGAGAGTAAATGTGTACTCCTAGTCACTAAAATGGGCTTTGTTGGGGAAAATTTAAATGTTTGTCTTTTTTCATTGAGAATCCTATGCTGCCGGTGTATCTGTCTGATTTTTAAAGGTGCTGCTGAATGTACTGCCTGCTCAGGGTTTTCATGACAGTATTGAAATGAAAATGTATTCAGTTATAGTGTTGAAGTAATCCAGGTTTAATTTAAAGACTAGTATTATACCAGGGGTTTGAATTTTTGAAAGATTATGAGTACTACACAATGAAACGATTATCGACATCACAGTAAAACATCCTATTCTGTTTTCTGACAG
>TTN-207,,0,93,1654429,1654521,GTATCTATTTTTGATTTTTGTCTTATCAAATAGGCCTCTGACCTTAAATCTGCTTGAACTTGATAACATCATAAATAATCTTTTCCAATTCAG
>TTN-207,,0,117,1654522,1654638,GTAAGGAAGGTTCTCATTTTAAAAGGGGATAAACTCTTTGCAGTTACTTTCTTGAAAGAAAAAAATAAAAAAAATGGTGAACAATTTTTTTTTCTGCATCTGTAATGCCATACACAG
>TTN-207,,0,114,1654639,1654752,GTAAGTTTCTCAATCAGCTGATAAAAAAAAAAGGATGCTTATGTCAAACTTGCATTTTGGTGTCATATTTATATACAGGACATATAACATTTTACACCATTATCCTGTCTATAG
>TTN-207,,0,474,1654753,1655226,GTATGCTCAGAATCCCCATCAAGATGTTAAGACAGCAGTATATTCAAATGTTTACTCTTTAGTATTCCTTGGGATTACAGATGATTATATATTACTAAAAAAATTTTAAACTACTTTTACTCATATTTTCTATTACCTCATAATTTGAAAAATTATATAAATTCCATTCAAGGGCACATTTCTTAGTTTACTCTAAAATATTAACCTTCAGGAAGTTTCAAAGTGTTTGATCCCCCAGTATATTATGATAATGACCACTGTCATAGATATTATAATTAGATTGGTATGTTTGGCCCAGTCTAAAGTGTGTGGCAGTTAAAAAGCAATTTTTAATTTATATTGAAGTGCTTTTCAGTTAAATTTCCAAATCACCTTTTCACAATTTAAATAAATTAGTCTCTTCTGTGTAAAATAAACATAGGCTTCTTCTGCTTCTTACCATGATGATACACATGCACTTTGTTCCTAATTCAG
>TTN-207,,0,88,1655227,1655314,GTATTATTTATATAATTTTTGTGGTTATTTCGAAGTTCATATGAACTCCTTTTTGACAAACCTAAACAATGATTTCATTGGCTTGCAG
>TTN-207,,0,196,1655315,1655510,GTAAGTCACTCTTGATGTCTGGGATATATAAATTCTTCTAATATCTGCCTGTGAGCTACGATATGAGAAAATATGAAAAATTCATTACTATTATTTCCTCCTGGCTACATTACTTCTTAATGACTGCCTGCACTTTCAGACTGACTATTGGGTAATAAAAAAAAAAATGAATTTGTTTTCCTTCCTTCTTTTTCAG
>TTN-207,,0,114,1655511,1655624,GTATGCTCTTGCACTTAATCTTTGTGACAATAAGTGCTCTCGCACTTAATTTTTGTGACAGGAGATTATCACCTTTCCTCTGGTTTTCCTAATCATTGTTTATTTTATTTTCAG
>TTN-207,,0,102,1655625,1655726,GTAGAATTTGAATTAATTCATAAAGAATAACTTACACTTGGCTGCAAATTCTTAACTGTGTTTTTTCATTAATGCTAATGAAATGCTTTGTTGTTTCAATAG
>TTN-207,,0,80,1655727,1655806,GTAAGTAGTGCTGATTATACACAAGATATTGTCTAGAACTTGATGAGACTGTGGATATGAATATTTCACTCTTTTCTCAG
>TTN-207,,0,100,1655807,1655906,GTAAGAGCACAAGGTCTTTTATAGTTAATAAAATACCCTTTATTCATGCATTGCATTTTGACATACTCTGTTTTTTGCTCTTTTGAATGATATCTTACAG
>TTN-207,,0,603,1655907,1656509,GTAATCATTCTTTGAAGAAAAACCAGACATTCTTCACATGTAGAGGAAATTAGTTAACTTTGCAGTGCTATTAATAATATAATTGGCTTCATGAACTGGCCACTTGTAAACTAAATGTCACTTCTGATTATGTCTTTCCATAGGAGAAGTAAAACAATTCTAAAGAGATGAAATCGCTAAACGCTTATTAGACTAATTTATACTAGTTTTAGTTAATTGCATGTGAAATACTAATTTAAATAACAGATATTAGCATACCCAAAGAGCATTGAAATGACCACAATTTTTTAATTGCACAGCTTCACATTTTCCCATAGTGTTCTTAACCAGGGATAGTAACATTTTCTGCATTCCCCCCAGCCCTGCAAATAATGTCTGGAAATTTGTGGGGCCATTTTTGCTTGGCACACAGACTTGAGGTAGATACCACTGACATTTAGTAGTTGGGAGCCAAGGATGCTAAATGCTCTGCAGTGTGAATGACACTCCAGCACATCAAAGATTATCCTACCCAAAATACAGATAGCCCCACTTAGAGACAAGTGCATTATTAAAATGCTGATTTTTCAGGATTACTAGAATAATTATCCATTTTTGTAATAG
>TTN-207,,0,103,1656510,1656612,GTAAGTTTGGACATGGATGCACTATGGCTAAGAACTAATAAACCATAGTTTTGTTTTAAGAAGGTGGTTTTCCTGATACTAACATTTTTTTCTTGTTCTTCAG
>TTN-207,,0,113,1656613,1656725,GTAAGTTTTGTTTCATGGAGTTGCCACTTTCCCATTTTGAAATAAATGAAAATAATGTTTTGTCAGTTATTTTCATCAGAATTGAAAACATTTATTGGTTATGATCACTATAG
>TTN-207,,0,299,1656726,1657024,GTGAGTCATTAAAACTACACTTTCCAATGGAAAAAGGTTTTAGTAAAACATAAAAATAAAAAGTTTGGGAGAGAGTTAAAAGAAATGGGACATAGCTTCAGCAAGTTATCCTCAATCATATTTTATCTGCTGGCCATGTAAAAGAAATCACCTGATCTTGTTATTTATTAGCTAATGGAATACAAAGATAGATGTGGGAAAACCACAAATCATGTCAGAGGAGCATGCTCACATTTATATTTTCCATAGCAACCCTTCCCACACAAATTTTTGATTACTGTTCTCTTCTGAAATATTAG
>TTN-207,,0,128,1657025,1657152,GTAAGTTTCCTTTGGCATCTAAAGTTTGCCTTTTTACCATGTACTTTGGTATATAATTACTACAGCTTTTAAAATTGCATTTTTATGTCATACTGGGAAATTTACTTCAAATGTTATTTTTTTATCAG
>TTN-207,,0,96,1657153,1657248,GTAAGTAGTTCCTTAAGAAGAAGGTGGAGTAGAACAAGCTATTGTACATTTTAAAACCATCAGGGAGTTTGATTTGTCTATCTTCATTCATTCTAG
>TTN-207,,0,99,1657249,1657347,GTACTTAACGTTATTGGAATAAAATTATGGATATTTTCTCTATATGGGACTATTTTTTAATCTTTCATGGGCTAATGCATGACTGTTCTCTTTCAACAG
>TTN-207,,0,86,1657348,1657433,GTAAGGAATGTTGCACTGATTTTCACAGGATTTTCCCAAGTGATACTATCTTATTACATTGATTTTTGGCTTTGTTTTGTTTTCAG
>TTN-207,,0,1307,1657434,1658740,GTAAAAGAGAAGGTTTCATTGTGTTTATAGAGTAATGTTTTGCTTCTAGTTATATTATTTACTGAGCTTTATGGCTTCAAACTCCCAACAGTCTCAAAATCTATAGCTAAAGAGTAATAAGAAAAGTAAATCAAAAAACTATTAGCAACATTAAAGATATCATATTTCCTATAATTTCAATGTAATTTGTGGCTGTAAGTATATTAATCATGCATGGTTTCTTGTACTGAAAAACTTGGATCTACAGGGGCTTAATAATAACCTAGAAGTAGTTTAGACATATTATATCTCTCCAGTAGAACACATTGGAAGTCGGGTTTTTAAAACTTACTAGCGTAGTAGTTAAAGAGAATTCAATGTTCTTCTAAAAGATTAGACAATTCCTGAGAATAAATGCCTTAGTCTTCCTCTATATTCAAAAAGTCCCCATACTGGAAGGATAGAGAGGCCCAAAACCAGAAACAGCCTCCAAAGAATAGAAAACCAACCAGAGGGAATCTCCCAGAAATCAATACGAAACACTAAAATTGCACACACAGTAATGCACACTGACATCCCATCTAAGAAAGCAAAGGCTTTGAGGAAGACCCATTCCTCAAGAGACAGAAGAACTTATTCCTTCACCATCACCCCCTGAAAAAAAAAAATACATCCTATATCACTGCTGCAGCTCATCTATGAACGTCCAATATACCACAGGCTGTGCCAGAGGCACCAGAACAGAGCTGAGCTTCCACTCCTTCTGGTTGCAATAACAGTCAACAAGTATGGATTGGGTCTAGTTTTACCACTGAAAGCTTAACTCTTAGTTTGGTCCTTCAGGAAAGAAAACTTCAGCAGCATTACATACATCCTCTTTCCACCATATTTTGAACCCACATGTGAGGCAACATGACTCAAAGTATGTTCATAGACATATCCACTATCTGTTAATAAAAGAAAAAACACTTTGCTCTCAGCTGGTCATTCAAAGCAAAGCTTCACAGACTTACTTTCCTAGTTCAGTAGAATTAGAAGCATCCCCAGTTACAAAGGTAAACAATCTAAAATGTTAAATTAAAAAAGCATACGTGCCCTTGATTTATTTTTCACTGATAATCTTGATGAAAAGTTTGCTAAGAAAAATTCTGTCTACATGAATGTCTATAATTTTGGCAACTGACAAGTTTTAGGAATGATTTTAAATAAGGATGTAAGGTTATGCCAAACAGAAGGCTATTTTTTACATAATTAAGTTGAAGTGAAATATTATTTCTTACATGAATATTTATCTCATGCTAATCATTTTCACTTGCCTCTGGCTAAAG
>TTN-207,,0,118,1658741,1658858,GTGCGGAATCTGAATATAATAATAATTTTAATGCATTTTACAGTGTGCCTTTATCCCATAAGTTGAAAAAAACATCCTTATGACTTTGTTACTGTTTTTCTTTCTCTTCTCTTTGCAG
>TTN-207,,0,88,1658859,1658946,GTAAGTGACTTGCTTTCTTACATCAAAAAGGCATCCAGTGTCTGTTTAAGAATTGCCTTCTCAATATTCTCTGTTGATTCCTTTCCAG
>TTN-207,,0,402,1658947,1659348,GTAAACTCTTCTGAATATTTTCTTATACACATTAAAAGTACATGACTCTGGTTTGATGCCATTTTAATATAACCTTGGAATTTGATAATTAAACTCAAAACCACACACGATAAGCTGTTATTTTGTTATTGTAGTGTTTAGCCCCACACACATAAGGCTCCTTAGTACATAGCGTTTGATACACAGATACTCTTTTAATTGAGATCCACTATCAGGTACAATACATCTACATATTTTTATTTTAAAAAAAGCTTTCTCCTTTTCTCTGTCTTCCCATGTTTTGAGTCTATATATTTATTTCTTCTTACAGTCATCCCTCCCAAAATAAGTTGAATTTTTAAATGAGTGAAAACCAACATAAGTATATTCTCTTCAATAAATTTCTGTTTTTCTAATTTCTAG
>TTN-207,,0,1285,1659349,1660633,GTAAGTATGCTTCCGTTTCTGGGGACTAATTTCTAAAGCACAAAGTCACTAAATGGATAATTCTGCCTTAAATTTCTTATATTTTTCTATGCCAAATTATTTTATTTATTAAAATAAAAAAGGTTCATGTTCACATAGACTATCGGAAGTATATATTTATGTGTGTATACATACATGCACAGATATATACATACACACATACATAAAATCATACAGTTTGTAAACTCTTGGATTAAACCAAATATTTTATGAGGAATCACAATAATAAAGACCTGGACTATAAACTCCTATGTCTTCTGATACTTTAAATAAATTTCTATCTCATTAGATACTGGGGAAATCATCTCTCCCACTAAACAGTCAGACCTTCCAGTAGGAATTCAACAAAAAACAGAATGTTGTTAGCTTTTCTATAATATTATTGAACAAAGATTTAGGATTCTCAGGCATAGTCTGTGAGGTCAAATAAGAGAGAAAAATTCTTCTAAAAGATCTGTGAGCAGATTCGTTCAAAAATTAAAAAATACTGTGGCCATAATAATTCATCCTATTTGCTACATATCTGATTAGATTCTCTATAGAAGAAAAATTCAATTATTTGTTAAAAAGAAAATTTTAAATACTCAAGTGCTATGTGGAGCATATATACCTATATAATGAGGTAGTTATTCATTCATTTGCAAACTAGTATTGAACATGTGCTTTGTGCAAGGATCTATATTAACCACTGGAGGGGGAAAAGTTAAGATTAAAAAGACAAGTACAGTAAAAGAATTTCTGTAATTGTAAAGCACTTTCAGAAAGGTAAAGGATTGTTATGGGATTATTGTAGACACTGATCCTGTCCCTAAAGGGCATTAAGATTAGTTTGTGTTCAAAGGTTTACTAGCTATTGATGGAATCCTTTTTAAATTTTCATATTGTGGCAAATTAAATTTAAATCATGTTTTCAGTAAAGGCTATTGTAGAATTTCTTCAAAGGGATCTCAAAAGTAAAGTAGTTTTTTACCAATCATGTATAAATAGAATGTAAATCTAACAAGATAGGAAGTAGTCTTTCTATTCCCAGTTAGTTGTTTGCTTTCTCTGTTTTTGCATTAATGCTAAAGGAAAATAGACCATTTCCTTTATTTCTCTTCTCTAGAAGGCAACTGTATTTCCTTTTAGCATTTCTATTTTAATATTTTAATAGATTAAAATAATATATGATCATGTGTAGTAAAAGACTCCAGCACTTCATCAGCTTCAAAATCTGATGAAGCTTTTTTTTTTCTTTTGTTATTAG
>TTN-207,,0,131,1660634,1660764,GTACTAGTACTTACTCAGTTTATGTATTCCTCTTTTGATCTTATTATGAAATTGATTAATTTACTGAAGATATTTCAATTACTTTTGACAAATATGAGCTAAATCCTGTTAAATTGTATGTGGTATTACAG
>TTN-207,,0,87,1660765,1660851,GTAGGAAAATAACCATTCTCCTCTTTTTTCCACTGAATCACTATAAGGAGTATTTATACTACAACTGACTGTCTCCTTTTCTAATAG
>TTN-207,,0,94,1660852,1660945,GTAAAAAAATAATAATTAAAATAATTCAGAATATGGTTGACTTCAATATTGCTATGATTTCATTCAATGTATGACTACTATTTTCTTTGTACAG
>TTN-207,,0,93,1660946,1661038,GTAAGAAAGACTTTGAAAGTTGCTACAGAATAAAAACAAATTATTTTTAAGCATTTAAGGAACGTTGCTTATATTGTGATTTACATCCAACAG
>TTN-207,,0,93,1661039,1661131,GTAAGCTTTAAAATCTAAATTTAAAATATCTTCTCAAAATTGAAGTATATTATTATAAACAACGCTTAATACTTCCTTTAATTATTTTTACAG
>TTN-207,,0,1003,1661132,1662134,GTAAGTACCAATGTACTGACAAAGAATGTCCTCCTTACAGCTGCCTTCCTAGGTGTTCAATAATAGTTCACAATTAAAAGAGCTATATCTGTACCTTAGGAAGCTACTATGGCTTGAATGTAGACATGGGCACATTACTTAATTACTCATTCCTTCAATTTCCACAGAATTTTCACATTCCCTTACCTGTTACCTTTTCCCTGTTCAAAGGAGATGATGTCTGTAATTTCCTCGCTGTAATTTTCCTCGCAGTCTGTTTTATTTATCAGAGGCTAAAGCAATTTCTCTGCATGCTCCTCAAAAGGGACAGAAAGTAACCAGTCATTTTCTTAGCAACTGCTGAGACCCATTTATCTTCACAATCAAGTTTTTATTTCTCTATATGAGAAAAGATATATCCATTTTAATGAAGTATATATATATATATATATATATATATATATGGTAATAATTCTTCCTCTGATAATTACCATCACTACTGTTGTGTATTTGTTTATTCTCTCATCTAAGTGTGAAGAAACTGTAGTCACTACCCTCTTTGAATATTTCTGTCCTAAATTTGTGCAAAATGGAAAATTGCTTTCCTTTTATTAACAGTTATATTTCTTAAAAGGGGAATTCACCTTCTTGTGTATCCCTTCATAATTCTGTGTAAATATTAAAGAGAGTATCCCATGATACTCTCCTACTACAATCTCCTCTCTTCCCTTTTGTCAGGATATGAGAATATAATAATACACATCATTACATGCATAATGATGCCAAATAAAGTGAGGCAAGCACAGATACATAGCCACATGTAGATCCAATAAAAGATGCTGACCCCGTGTACCTGCTCCCCAAACTAGCGTAATAGTGTTAAAGACAGAACCATTCTTTATATTGGGCTGAGCTACAAAGTCTGCCTACAGTGGATCCAAACAACTTTATAGTAACTGTGAATTCTACTTTCTATCCCTCAATGCTTTTTGCTCCTAATGACAACTTTTTTTAAATAATCTAG
>TTN-207,,0,108,1662135,1662242,GTAAAGACTGCATGGTTTGGTTAAAATTACTTGTTTTTCTGTTCATAAATAACATTTGGCTTTAAAATCATCTGAGTGATAAAGGGTTCCTTCTTTAAACCATTTTAG
>TTN-207,,0,83,1662243,1662325,GTAAGTAGGAGAACATTTTCACATACAAAGCCATTTTTACTTTTTTTTTAAATTTCTTATAATCAATATGATCTTTTTCACAG
>TTN-207,,0,93,1662326,1662418,GTAAGCCTGGAAACCATTCCTTTTTTTTAAATCTTATTTTCCAAAAGTGCCTTGGAAAAGTCAAGAATACTAACGTATACTGGCTCTTTGCAG
>TTN-207,,0,447,1662419,1662865,GTAGGAAAACTTGGCACTAAGGAAATGCACTATGAATAAACTAAAAAATGTCATAGTTATTCTCAATCCCATTAACTTCTGTCTATACTTTTTGGATTAAGAAATCAGGAAAATAGCATAATTTTAACTCACATTCCAAACATCTGTTAATGTCAGAAATCGAATCAAAAGTTAAGTCATGTTATTACTAATCTTTTGGTTATAAACCCTGGAATGTGGAATAAATAAATCAAGGTTTAATCATTTGACAATAATTTTAAAGCATAACTCCTGCCAAGTTATTCCATTCAGTGTTGCCTGTAATATCTGATCCCTAAAACCTAAACCAGCAACAATTTTCCCAGAGTAAACAGTTAAATAGGCTGCTGGTGATGCTTTAGGAAGCCATTAAAGCAAGAAGCTACAAAGAACTATTCTAATTATAAAATGTCTATGATTTCTCCCCAG
>TTN-207,,0,88,1662866,1662953,GTAATTATCAATCCTTCCTTATGCCATCAGTATTTATGTTTCAGATTGAAGGGGAAAAATCACATTTGTAATTTTCAATTGCTTCCAG
>TTN-207,,0,1728,1662954,1664681,GTAAATACTTTCAATTTGTCTGTGCAACTTTTTAAACCAACATTCTTATTATATTTACACAAAGCTATGCTGTATGCTGTGTAACAAACATTTTGGAAAATAAGAAAAATCACCCATAATCATGTTGAACATTATTAGAATTTTTAAAAATTTCCTCCTTACTTTTTTATTCTATGTGTATTCTGTATGGTGGGTGTAAGTTTACAAATTATATAATTGAGAAAACAGATGCTAACAAGAAGACATGCATCCATGTTTCCAGTGAACCTAAAGAGTGCATGTACACAATTCTCAAATTGCTAGAAGGCCATGAATATGTATTCTGAATCATGGCCCAGAATAAATATGGCTTTTTTATAGAACTTGCCCCCATAGTGTCTATTATGTTGTTATATAGTTTTCATAGAAGCAACTTTCCTTAAACTGTACATGAATGTTTAACAATCTGCAACTTTCCTTAAACTGTACATGAATGTTTAACAATTTGCCAGTGCTGACCATTTCACATCATGAGACTCTACCCCTATCGCTAAATTATCATAATAATGCAAAAACCTGTTTGAAGGGTTTCAGTATTCTAATTGAAGAGAAGCATCATAGTTGGTTATCAATATTGCATTTCTAGTCACTGAATATAGAGTTGAACTCTATGAGGCTTTTTCATGGCTCTCACTGGAGGCTTTAGTCCAGTGATTTGCTCAGAACACGAAGCCTTTCCACTCAGGGCTCTTTCTAAGCATGTCTCTAGGCACAACAATACTCCAGCCACAGTTTTTATGTGAAAATTGCCAGTTCTATGTTGAATATAATTAATATAAGAATGGCATAAGGAAAAATATTTCATTAAGCAGTAGCCCCACAAACTTTCAGGTTAGTTTCAAGCACCTAAAGCTCTTTTGCCTAATGGTTATTACTTTAATTTGAGAACTGGTACATTTCCACGTTAATTATTTGCAACCTCCTCAAAGTCATTCTGAAATTTGGGGCCTCCTATGCTGCTTGTTGATCCACTGGTCATCCAGAAATAAACCATCTCTCTCTCCGTTTCCCCTGCAGAGGAAACTGGACATAGAAACTGACTATGCCACTCTTACCCATCTCTTGTATCCCTCTGCATGCTTGCCTCCCAGCTCCCTCCTGTCCAACTCACAAATTGCTTTTAAAAAGCATTTTTATTTTCCCTTCAGCCTCTACTAAAACCATGGTAACCAATAACTGTTGCAAACCTACTTCATTAACAAATATGGGGCTTGATGCTATGGCTCACACCTGTAATCCCCTGACTTTGGGAGGCCAAGGCAGGTGGATCACTTGAGGTCAGGAGTTCGAGACCAGCCTGACCAACATGGTGAAACCCTGTCTCTACTAAAAATGCAAAAATTAGCCTGGTATGGTGGCACATGCCTGTAGTCCCAGCTACTTGGGAGGCTGAGGCAGGAGAATTGCTTGAACCTGGGAAGCGGAGGTTGCAGTGAGCTGAGATTGTGCCACTGAACTCCAGCCTGGGTGACAGAGCGAGACTCCCATCTCAAAAAAAAAAAAAAAAAAAAAAAGTGGTTGACTGTTTTTGTATTGACTAGATAGCAGAAGGAAAAACTAACTCAATTAGTAGACACAAAACCTTACTTTCTTCAAAACAACATTTTTGTCTCCTTTTAAAAAAACAAGTGTTGAGCATTATCTTTCATTGAAGGCAAACAGCTTGAATTATTTTCTTCTTATTTCCAG
>TTN-207,,0,860,1664682,1665541,GTAAGTAAAAAAAAAAAAATGTATACTTAATCACTTCTTTACTCATTTAGTACAAGACTATGGTGAAAAAATATGTGTATAAATGCCGTACATTTCATTCACTTGACAAGCAGTTATCACACAACTACTCAGTATCTGATTTGGTAGTATTTGGACAGTGATTGTGAAAGAGATTTTACAAATATGTATAATTCATTGAATTTCTTTTTGTTTTTTTTTTTCTTTTTGGTTTTGTTTTGACACATAGTCTTACTGTTACCGAGGCTGGAGTATAGTGTCATGATCTTGGCTCACTGCAACCTCCACCTCTGAGGTTCAAGTGATTCTTGTGTCTCAGTCTCCCGAGTAGCTGGGATTACAGACATGCACCACCATGCCCAGCTAATTTTTCTATTTCTAGTAGAGGCAGGGTTTTGCCATGTTGGCCAGGCTGGTCTCAAACTCCTGGCCTCAAGTGATCCACCTGCCTCGGCCTCCGAAAGTGCTGGCATTACCACTCCTAGTTCATTTATCAAATTTCTTCCATCTATACCTCACAGATTTTTTTTTAATTTCCCACTTAATGGCATTAATAGAAACTGAATTATTTTCCTACTTCTAAAACTACCAATTCTGAAGACCTTTCCTAAATTATTTTGCCTCAACAAACCTCTATTTCCTCATCTGTCAAGTGAAGAAATTCAATTGTATTGGGTCCTTTTTAACTCTAATAGTTTTATGATGAGATCTCTTTTGCTATTTATGGGAGCAGAGAGTTTAATGTTTAAATGCAATCTTCAGAAAAGGAATATTCACTACATCCTACTACATTCTTAATGTGACATTTTTTTCTACCACAATTCCTATACTTATATTCGCAG
>TTN-207,,0,101,1665542,1665642,GTATGTGTCTACTACAATTTATACTTCTGAAACTTGCACATTTGTAGATTTGTAATAAGACATCAATAAAAATGACTTGCCTTTATAATTACAAATTTTAG
>TTN-207,,0,93,1665643,1665735,GTAAGTCTTATTTAGTGGAAAGAATAGATCTTCTGTTCTTTCAAAAGCAGAAATGGCAATAACATTTTGTGCCATGATTTTTTTTTTCTGCAG
>TTN-207,,0,92,1665736,1665827,GTATGCATTATGTTTCTTTTTAGTGATTCAATGCTTGATAAAACTAATATAAAGAAATAAATTTCTAACGCATTTTCCAACATTTGTTACAG
>TTN-207,,0,89,1665828,1665916,GTATAGTATTAATGGATTTATTCAGTTTTCATGTTATCTAACTTTGTTTTCAGCTATATGCTAATTCGTTTTTTACTTTTATTTTTTAG
>TTN-207,,0,114,1665917,1666030,GTGAGTAAAATGCTCTCACTTGTGTTTGCAAGGAAAATAGATGTCTGATTGTATGTGTTTAATTGTAATCTGCATTATGGATCAAATCTGAGTGTTCTGTTCTCTTTATTCTAG
>TTN-207,,0,101,1666031,1666131,GTAAGAATTTTACTACTTAGGCCATTAAAAATAAATTTTGATAATTTTGAGCTCTTATATGGATAAAATTACTTATCAAACTGTTATTTAACACTTTTTAG
>TTN-207,,0,85,1666132,1666216,GTAAGTTGCTTTCTCTGAATACAAAACTATTGTTTGACTGTCTTTAAGAATATTACTTTTTCATCATAACTTCTTCTTTGAAAAG
>TTN-207,,0,94,1666217,1666310,GTAATTTTTGGACTAGCAGTATTACCTTATTTCTTTTTAAAATTATTCATATAGGTGAAAATCAAAATCTAATTTTTTCATGTTTACTTTTCAG
>TTN-207,,0,318,1666311,1666628,GTAGGATGTCCTTGTTTTTTCTGATATTACAGCAACTCTTAATCTCAAGCACAGAAGTATTCGATAAATAAGTTAATGTAACATCTAAATCTGTAACATCCAAACTGTATTTAGCAAATATTTTTCCAAATAGACCTTTTACCAAAATACCTAAAAGGTACAAACAATAGTAGATTCTCATTTTTATGAAGGAAAATAAAGAGGACACTAATTGAAAAATTGGATGACCTATATTTGATTAACTGAGAATAGGCTATATAAAATTACACATTGAAGTATCACTAGTAGTAGTTAACTATATGTATATTTTACTTTCAG
>TTN-207,,0,98,1666629,1666726,GTAAGTCCTTCCCTTAGCATGTGATTCATTCACACTTAATTTCTTATGATTTCCCCACATTCTGAAAAATCAATTAATGACCTTAATGTCATTTGCAG
>TTN-207,,0,98,1666727,1666824,GTGGGTTACTAAAATGCTTCTCCCTCCCACTTCAAAAATGAATTTGTTAATAGGGATGCTGAGGAGACATGTATATCTGATTTTATGATTCTTTACAG
>TTN-207,,0,310,1666825,1667134,GTAAGTATTATGCTTTCTTCCTCCTTTTAACCCCAGTCTCCTATTTTAGCAAGGTCAAGATACTAATACCATTTTAATCCACTTCTGAAAGAGATTTCATTTGTAGAGACCGAAATAGTGTAATAAATATCTATCTCACTCATGAAACACTTTTTTGATCTGTCTCATCTTATATGTTTTGCTTTTAATGTACTGAACTACAGGTTCTATGTACATTGGAGCAAATCCATACTAAAACTCTTATGTACATTAACAAAGGGGATTTGATTAGGTTACCTAGGTAATCTTCTAAATTATGTTTTTCTTCTAG
>TTN-207,,0,1157,1667135,1668291,GTAAGTAGTCTTTGCTTCATTTATGTCATGTGGTAAGTTTATTAGAATTTCTTCTTTTATATGTAGACATTTCTCCCTGAGGAATCTAGCTCTAGAAATTCTTGAAAAACAGTAGAGAACAGTGGCTTTCAAACACATGAGTGGGCCAAAAACACACAGTAAATAAACTTATACAAACACATATATAACTAAAAAACATTTCCTGAAACAATACCCATTTATTATCATGTGCATTCTTATGTTTTCTACCCTATTCTGTGTTTTTAAAAATATTGGCTGTACAACAAACATATGAAGAAAAGCTCATCACCACTGGTCACTAGAGAAATGCAAATCAAAACCACAATGAGATACCATCTCACACCAGTTAGAATGGTGATCACTAAAAAGTCAGGAAACAACAGGTGCTAGAGAGGATGTGGAGAAATAGGAAAGCTTTTACACTGTTGGTGGGAGTGTAAATTAGTTCAACCATTATGGAAGACAGTGTGGCGATTCCTCAAGGATCTAGAACCAGAAATACCATTTGACCCAGCAATCTCATTACTGGGTATATACCCAAAGGATTATAAATCATTCTACTATAAAGACACATGCACATGTATGTTTATTGTGGCACTGTTCACAATAGCAAAGACTTGGAACCAACCCAAATGCCCATCAATGACAGACTGGATAAAGAAAATGTGGCACCACATTTACACCACAGGATACTACGCAGCCATAAAAAAGGATGAGTTCATGTCCTTTGCAGGGACATGGATGAAGCTGGAAACCATCATTCTCAGCAAACACAAGAACAGAAAACCAAACACCACATGTTCTCACTCATAAGTGGGAGCTGAACAATGAAAACACATGGACACAGGGAGGGGAGCATCACACACTGGGGCCTGTCAGGGGTTGGGAGGCTAGGGGAAGGATAGCATTAGGAGAATACCTAATGTAGACGATGTGTTGATGGGTGCAGCAAATCACCATGGCACATGTATACCTATGTAACAAGCCTGCACATTCTGCATATGTATCCCAGAACTTAAAGTATATATTAAAAAAAATTGGTGGTAATACAAGCATTAATTTGCACCAGTATAGCTCTCCACCAGAAGAAACTTATCCACCTTCCCAAAATTAATATCTTTTCATTTTACTTTCAG
>TTN-207,,0,103,1668292,1668394,GTAAGTTAAGTATTAGACAAATGGCCATCTAAATATGAAGCTCAGAAATATTTTTACGTATCAAATCCTTGTTCTTACATTTCTTTCCTCTTGGTTCATGTAG
>TTN-207,,0,90,1668395,1668484,GTATGTTTTTGTGAAGGAGAAAAAAAGTTGTTTTCTTTCTAGTTTGTTACTTAATGTAGAAACTGACATCTTCCTTGTCTTCATCTCCAG
>TTN-207,,0,369,1668485,1668853,GTAAGTTTTGGGGTTTTTTTATTGTTGTTGTTGTTTTAGTATTATGGAGGCACATTTAAATCTCGGAGTCTAAGATTTGGACTCCAAGACACAGAGAGTAGTAGAGATCTGAAGATTACAACTCCCATTTAAGAATATGTTCTATCTCTTACAATGAAGATGACATATTAAAAAAAGAAAAGGACATATAATTTCCTTTAAAGCATACAGCAAGGACTCAAAAGTGCATACTAGTTGGACGGTTATTAAAATGGGATAATTGTCTTCCTGTTGAGCTTGTTACTTAGCAGCAGGGATGATAATGTGAAATATGGAAGTTTAAACTTCTGCTGGTAAGATAAATGGTGAGTGTACCTCTTTTTGTTTTAG
>TTN-207,,0,379,1668854,1669232,GTAAGATTCTGCTGAGTATTATAGGCAAAGATGTAACAGCATTCATGATGGTCATTTTTCCTAATAAAAAACTAAATATACACCTAAGGAAAAAAGGAAAATTAAAATGATGTTTTGTATATAGACACAAACATTATGATTATGGAGAATCATAATAACATGCTAAATTAAAAAGCAAGATACACAACTGTGGCAACTATATAATTTCAATAGTTATTCAATAGTGCAGTTATTATTTGTCTATTAAAAATAAACAAAATGAAATAACACTAAAATTCCATTCTTGAAAGAAGCAGCATATGAATTTCCCACTATTATTAATAAGGATTACATAATATAGCTTTGCATACATTAAGTCCTTTATCTTATTTCTTTCCAG
>TTN-207,,0,347,1669233,1669579,GTAACTAATAAACTTCATTGGAATCCCATATTTTACTTTGGATAATGGGATGTAAATAGGATTTACAGAATAATGTGGGAGAAGACATTCATATTCTAATGTGTATTTCCTATGCACAGAATTATTCTTATGACAGAACCACGTTTTAGAGTTAAAAAGAGCTTTAGAAATCACATATTTCAATTACCTAATTTTACAAGTGAAGAAACTAAGATTCTAAAAAATTAACTAACCTCCTAGGTCATATAGGAAATTGACAATAGAAAGACTGCAGCCCAGGTCTCCAGACCTCTACTCTATACTCATTCCCCATTCCACATATTCACTCTTCTTCCTTATTCCTTCAG
>TTN-207,,0,87,1669580,1669666,GTAGGAACATTTCCCGGTGGTTTTTCATTTTATTTTTTAAAATTATCTTTTAGCCTGGGAAATTAACTTTTCAATCAATTTCTGCAG
>TTN-207,,0,101,1669667,1669767,GTAAGTGTTCATGAACGAGTTCCATATCCTGTGTTAAAAGCAGCATTAAACACCCAGGAAGGAAGTTTTCATGAAAATTTCCTATCATTATTTATTCTCAG
>TTN-207,,0,889,1669768,1670656,GTAAGTATTACCAGGGGGAGTACATAAGGCTTTTCCTATTAATCATATTCTAAGAGGGAGACTAGAACTCCCTTAGGTAGATTAATTTATTAACAAGGTGTAGAGCTGGTAACTCCAAGAGTACTTTTTAGGAGAGCTGGGTGGGTACTTTACGGTATTGTGGAACAGGCAAATCAAATGCACATGATTTGTGGTTTTGAAAAGCTTTTCATATATATAAGAATTTCCTGTCTTCAAAAGACATGAAATGAGAGAATTTTATTGGAATGTAAGAATTTTATTTTAGGAATAAAGAGGCCTTTTAACTAAGTAGTGAGCTATTTACTATTCTTAGGGTTTCTGTTTTCCAATCCACCATCTCCCTAAGTATGTGACTGGTGGGCTCTCCATCTTAATTTCCCTTCTTCTTATTTCTTCTATTTGCTTATCCTCCATGATAATTTCCCCTTTATTTGAATTACTTGATATTATATGTCACCCTCCAGGTACTTTTCTTCCTACTATGAAATAATAAAGAGAGCTAGAATATGTGGCAGAATACCTTCATGGAATATAGAAAGGAAAAAACAAGAATGAAAGGGAGCCAAAAATCAATCGTCTACTTTCCTTTTAATATATGTAGCATTTCAGAGTACATAAGGCTCATGAAAGAGGAGGTACAGATCCTCCGGGGGGAAAACCTGGTTAAGCCTAAAGCATAGTGGAAAATGGAAAGATCAACAATTAGTACAGAACAGAAAAATGATTTTGAGGATTGTATTAAGGAAGTTTTAAAGAACAAGAAATCAGCTCTAGAAAATAAATGTATTTTAGGAGTGACAAGGCCAGTCCCTGGAAATACATTTGACTATTAAATTTTTATTTAACTTCTTCACCCAAAATTAAACAG
>TTN-207,,0,92,1670657,1670748,GTAAGTCTATTTCAAAAAAGAATCATATATATTTTAAAATAGCTTATGTATTTTTTACACATTCATTTCTTATTTACCTACTATTTATCCAG
>TTN-207,,0,90,1670749,1670838,GTAAGCAAATGAACCATCATCCCATCATTTTGAGTTATATCCTTCCTTTGTTATATGGGGCTTACACTTATCATTTCTCCTTTGCTTTAG
>TTN-207,,0,167,1670839,1671005,GTAAGGCTCTATGCACACATCTTCATTTTTCCTTTATTGTCATCGAAAGTGCACTCTTGTGTCCCACTCACTAGCTTATCTAAAAATCCGTTAAAAGCTAGAACTATTTGAAAAAGTTAATCGCCTGGCCTTAAAAATAACAGTAATTTATCTCTGCTATTTTACAG
>TTN-207,,0,90,1671006,1671095,GTAAGTGTCTTAAATTCAGAAGACGTAAAGCAAAACACGGTTTTGAGGAGGCTTCTTATTATAAATCTTGCATTATCTACTTTTTTCTAG
>TTN-207,,0,425,1671096,1671520,GTATTTTGTTTGTTCTTATCCTACAGCTTTTACATCAAGATTCCTCACAAATATTTCCCTGAGAACAGTTGAACATGTGCTTATCGATAACATTATCTGCTTATACAGAAATGTGTTTTTATTTCAGTACATATGGTTAATGTTTAATTTTATTGAAAATATCCTAATGTAATAGTTAATAAAGTATTTCTTAATTATAATATCTATTTTTGTAAGTTAAAATTGTTCACCAAAAAAGACAACAACTATGCATATTCCAAGAGGAAAAAAAAAATGGCACTATGCTTGGGTAATAAAAGTATAGATACTAGCAAGAATGACTACTTGTTCAATATATATGGATATGTATAAATAATTTGGGCAACACATATATATTGTAAAATCAAGCTGCATTTATACTTGATACATCCCTGGGTCTTTTGTAG
>TTN-207,,0,89,1671521,1671609,GTAAGTCATTATATGAAGAAAAACCCAGGTGCATGTTTTACATGAAGAAAACTGGTATTTGTTTGACTGGTTTTGCTTTTATGTTTTAG
>TTN-207,,0,91,1671610,1671700,GTAGGTCCATTTTACTTTTTATGTACTTTTTTTTTTAAAGCAAATTAAGCCTCCTTCCTTTTCTGATTAAAATGTATTTTTTTCTTTGCAG
>TTN-207,,0,91,1671701,1671791,GTATGTAGAGCATGTGAGGGAATTGACATGGAAACATTTATAGCAGAGTTTAGGAAATCATGGATTTCTAATAAATTTGCTTCCTTTTCAG
>TTN-207,,0,112,1671792,1671903,GTTAGTATTTGTCTTTTTCAACACCGTTCATTCCAGAGTGCCAATATTTTATCTAAATTACCCAAAAGCCAAACTCTGAATATATACTTTTGTGTCTTTGTTTCTTTCTCAG
>TTN-207,,0,673,1671904,1672576,GTATGTTTTAAGAATAAGGAAATTCTACATATCCACGTTAATTTTGCTAGAATAGTGTGAGTCATTCTAATTAGTCGTTATTTCATCTTAAATGCTTTTGGGTTCACACCCTTCACACCCCAAACTATTCATACTATGGCACAAAATGGAATCTCTAGTGAAGAGTCTTTCATTGATTAAAAAAACAGAAATTTACGTAGCTAAAATTGGATAATATATGTTGAATTTAAGTATTATTGAATCTAACTGTATATATATGTAGGTATACATGTTTATATATATATATACACAGATTATATATATATAGTATGTGTGTATGACATATATCATATGTGTGTATGTGCGTGTGTACAGAAATTGTATATAAAGTTTTTTAAAAGATTGTTCATCTTGTTCCTCTTTTTTATCCCCATGGTGAATTTGGAGTAAATTTTATCATTTAATCTGGTCATTTTACCCTTAATTTGGATTTGAATGCTATAGCATGTAATGACATAGCTTGTGGGAGCCTTGGTTGGTTCAGAAGCAAAATGGGTTATGTAAAAAGGAAGACTAAAATCAACATAAAAATATGGCCTTCATTTAAAAGTTTTCTTTTGACAATACATGAAGAGTGCACATTTAAAAGTGCTGTAATAATTATTCACTTTCTTTTGATGCTTTGTTTTCTTAG
>TTN-207,,0,105,1672577,1672681,GTATGTCTAATTTTGTGTAGAAGCAAAATTTGAAATTATTTGCATTGATTTATGTTAATTTTCAGAAACACTTTTTCACTTTCACTTTCTATACTCATTTTTCAG
>TTN-207,,0,92,1672682,1672773,GTAAGTTGTCCAACTTTTCAAAGATCCAGGTTTTCTTTTACCATAAATGTGTTATTGTCTGTACTAATCTATAGGATTTCTCTCTTTTGTAG
>TTN-207,,0,108,1672774,1672881,GTACGTATTTGTCATGGGAAGGGCAGTTCTGATAACAAAAATGCAAATCTTACTTCTGCGAAGCAAAATATTATAAGTGCCGCTAATCTGCTTCTCTTATTACCACAG
>TTN-207,,0,1695,1672882,1674576,GTAAGCATGCTTAGCACTTTGAATCAAAATTGCTATTTAACTCAGTATTTCCGCATACCTTTTCCTGGTTCTAATCCTATAGAATAACTTTTACTCTGTGCCTTAATGGGGTTTTTGGAAGAAATTATGGACTAGCTGGGAGTCTGAGGAAAATTCCTTAAATACCTTTCCAGCCCTCTTGACTTGACTGTAAAGTGAGAGATTTAGACCTCAGGATATCTATGGGCCTTTCCAACTTCAACCTTTTATGATTGATTGTATGAGTTGGTGCTTTCATTCTGTTTTAAATTATCAGAGTCAATAATTAAACCATGGTTGAGTTCCTAGAGAATATTGCTCTTAAATAAGCCACAGACTAAACAGAGACTTCATTTTTTGGTTTTTTTTTTTTTGTTTGTTTGTTTGTTTGTTTGTTTTGAGACAGAGTCTCACTCTGTCGCCCAGGCTGTAGTGCAGTGGCACGGTCTTGGTTCACTGCAACTTCCGCCTCCTGGGCTCAAACGATTCTCGTGCCTCAGTCACCTGAGTAGCTGGGATTACAGGCATGCCCCACCACACCCAGCTAATTTTTTGTATTTTTAGTAGGGACGGAGTTTCACCATGTTGGCCAGGCAGGTCTCAACCTCCTGACCTCAGGTGATCCACCCACCTCGGCCTCCCAAAGTGTTGGGATTACAGGTGTGAGCCACCATGCCTGGTCTAAACACAGACTTTGATGATGATAGTATTAGCAGCAGCTAACATTTATTGAGGAATTTTCATGAATTCTTTCCCTTAGTTCTCACAGCCCTCATATTAGCCATCTTATAGAAGGGAAACTGAGGCTGAGAGTGCTTTTGTAACTTCCCCGTTAGGGATGGAGTGGGAATTCAGACAGACAGACTTCAGAGCCCTCTCTATCATGGTTAGTCCAAAATGCGTATTCTTCACCATTCTGGAAAATAAGTGGCACATTCAACTCAACAATGTTTTGAAAATTAAAACGTCATGAGAGTCAGGTATCCTGTGACACTTTACCTAAAAGATCTCCATTTGCTAAGAGAAAATTGAGCCACTGTAGTGTCTGGGCAAAAGTATCCACTTCCATCTTCATGCTGAGAATCTCAGGGCTGTTCATTATTTATGAATCAGGCTTTGTGGATACTGAATCAGTGTTTATGAGAGTATAAAGCAAGTCGAATTTAGTTATCTTTCTTGATAATTCCAAACAGCATGGCAGAAAATCTGTCCAGTAATTATGTAGCTCTGTGGGTAGAGAATTCAGACTTTAAGTGTCTGACATGAACCATCCACACTTGGATATCAGTGAACTGGGATGGGAAAAGAAAAAGAATAGGAGGTGCGTAGAAGAAAAGGAAAGAAAAGCTAAAGTGAAAGGAAATGTTTTAACAGCTTCTTCCATGATGTTCTCACTACCATATCCCATTTCTTCACTGGAATAAAGCAACTAATGGACTTTAAAACACATGTAAAAGGTGCTTAAGTCCCTGCACAACTCACAGTCTTTCTACCCCATCTGAGATAGAAGAGTGGCCTATAAATTTTTAATTTTTAAATAATAATTGCATAGAATTATAATGATGGTGTGTGTGTATAATTTAATAATGGCCAATGACCTTACTTTAAGGTTGGTGCAACTATTTTTTTTTCCATCCTTATAATATTTTAAATATTTCTCATCTGTTTTTCTTGCAG
>TTN-207,,0,112,1674577,1674688,GTAGGTGCTGAATACAGACCACTGTCATATTACATTTGCCTAAAGCTTAGTAATTTTGAACAAGTAGGCTTTAAAGAAGTACTAACATCGTGTTTTGTCCTTTCACTGATAG
>TTN-207,,0,236,1674689,1674924,GTGAGACATGATTTCATTAGAAAACTGAAACGTGAAAAATTTAAAAATAAACTACGCTAACCTGTGCATATGCTTTAATTTTCTTTTATATAACACCTGTCTCATTACCATCCTTTTCACAAGGTGAAAAATATAAAAAATAAAACCAATGTTCTTGGAAAGAATGCGAACATCAAAGGTATAATTTATCAGTAATGTGGATTCTTGTACCTTGTTTTCCCTTCCTTTCTAAATAG
>TTN-207,,0,106,1674925,1675030,GTAAGTGCTCATACCTGCAGCATCTTCACCTGTGTCTTCTATATTCACCTGTGTGACTAAATTGTACATGATTGTGTAATTATTTTATTGTGAATGGCCATTCCAG
>TTN-207,,0,105,1675031,1675135,GTATGTACCTACTGGTTTGATTATGTTTTTTAATAAGCATACTTCCAGGAAATCACTCTTTTTTGCTTTTAAAATTCACTGTATGTATCCATTTTATGTCTACAG
>TTN-207,,0,369,1675136,1675504,GTAAGTGATTATTATTCAAATACATTTAGTTTAGCAATTGAACATATTAGAAACAAATATATCAAGGAATGCTTTTCTTCTCTGCATCACCTTCTTACATATCTTCTTGTCACTAGAGAACTGGTCATGTAAAGCAAGAGGAATTATTTTAAGTCAGTCTAATAAACTAATTTGAAGTTCATTTTAAAGACTATGAAATGGAAAGTTGAAATTAATGACCAATATGAGTTTGGGAGATTGAATAAATTACTTATTATAAAAATTTTACTTATTTATTAAAATTATAGAATAATTGTATTGTTCTTCCATGGATGATTAAGACCTGGTTACAAATGTAATGATGCATTTACCTTCCTTATAATTTTTTAG
>TTN-207,,0,693,1675505,1676197,GTAAGCATTTACAACTTATTTCCAATGAGACTAAGAGCATTCACATTTTTAAAAAACACATTTGGCCCCTGGCCTGTAAAATGGTAACAGAAACAAATTACCCAAGGTTGCTAAGTGGATGAATTATGTCTTTCTACCTTTCAGATGAAAAGAAGAAAAAAATAATTGGCATCAATTATTTTTTCTATTATTTCACTCCATTCCCATATAAAGAGCATGCAGCAAGTGGGAATGAGTTTTTAGCTTTGTAATTTTCGCCACTTAACAGTACATAAAGAAAAGGTTCTCGAGAATAAGTGTCCATCTTTACTGAAGTTATTAAAATACAACATACATCCAACAACACAATCATCCCCTTGCTTGAATGCAGCTGATGGCCTCTTAAAAGAACTTGTGTGACTGTGCAGCAGTATTAGGAAGTACATGATCTGTAAATGTTTCACTTTCCTTTTTACAAAGAGCAATGCAAAATTAAAAACATGACAGGCATTACAAAGGGAATAATAATAGGCAAATATTTAACCCCATAGTCCAAATTCTCAATTATCAATCCTACTTTCAAAATAGGCTTTGGTAGCACAGTAGAAGTCACTACTCTTCCTGGCCTTGTGATATGGCACTACTGAAAAATATATATTTATGTATGTCTTTATTAAGCCAAACTAATACATAGTATTTCTCTTTCTTTTATAG
>TTN-207,,0,116,1676198,1676313,GTACTTTTAAAATAGCTTCTTAATGCTACAATTTATGAACTTGGATTAGAGACATGCCTAGTTGTATTTTAATGGACAAGGAAAAAGAAACTAACTCTAGAAACTTTTTCTTATAG
>TTN-207,,0,96,1676314,1676409,GTAAGTTTGCGTTTTTACTAAGCGGTACTATGTCAAAAGTTTAACCTTCCAAGCAAATGCATCTAATTGATTTGGGGTTTTGTTTTTGTTTTACAG
>TTN-207,,0,101,1676410,1676510,GTAAGAAAAATAAAAATCCTATTTCAAAGTCTCTATTATTAAATGTTTCCCCTGAATTTTATAAAATTGTATTCATACTTAATACCTTTGTTTATATTTAG
>TTN-207,,0,97,1676511,1676607,GTATGTATCACAATTTAAGGGCATATTTGTTTATTATTACTGATTCTAGTAGAACTCAGAGTGGTATATTTTAACCTTATTTTTGCATCCCTTCCAG
>TTN-207,,0,97,1676608,1676704,GTAGGAAATAGTCAACATTCTCCTTTTTAAAATTATCTCAATTTATGTGAAAATAAACTCTCAGATATTCATTCATATCTGTTTTGCCTACTGACAG
>TTN-207,,0,95,1676705,1676799,GTAAGCATGTCAAATGTTCTCACATTTATATAGCATTTTCCAGTGTGGGCAGAAAGAATGATCTTCATCATGGCTTGTCATTACACCTGTTTCAG
>TTN-207,,0,126,1676800,1676925,GTAAGTATTAACACTTTTAAATAATTTGACAGTTGAAATGTAATAGAATCAGGGGGAGAAGGGAGAAGGGCAGTCTTATCAATAGTAATTTTGTGCAATTCTCATCATCCTTATTTTCATAAACAG
>TTN-207,,0,881,1676926,1677806,GTGAGCTCCAAGAATCATACATAAATACAATGCTCCTCAAAACTATATGACAGATAATTTTCCAACACACAATCTCTAAGAATTTTTAGAATTTATGAATGGTCTAGAAAAGCACATGCTTATTTGCATGATCATAAATATAGCTTAAGTCAGAGAACATTTTAACTATTACATCTGTTAAGTTAGCAATTAGAATTGCTAAAAGTTGTACAGCATTTTCCAATTAATGAAAAAATATTCTATCAATATGAAAAGAATCTATTTTATAAATTTTCCTTAGAGAAAAATGCATTGTACTGTAATAACTGAAAAGAAAAATGGCAAAACTCCTTTTAAGAAGAGGTTTAGCAGGAACATACAGTTTCTAGTGGTTTCATAAGTTACTGACAAAGTAATTGTGACAAGAGCTTCAAAAATAAGTGGCAAATCCTTTTACAGAGTCTGAGCCCAAGAACTATAAAGGAATAGTCACTGGGACTGAATTGGGGAAGCTAAGGAAACCAATTCTTGTATTCATTAGAAATGTATTGGTGGCAAGTGATACTAACCCAGTGAAAGATAAGCAACTAAAGAAAAGTCCCTAAGAATGGGTACTTTAAGTAATGAGCTTAGCTAATAGAGAACACACAGTAAAGCTGGCCAAAGAAGTAGGGAAGAAATATCTACTTTCCTAAAGCAATTTAATTCTTAAGATAATAATATTAAATTATAATGTGGCACTCTGTGCTGTCCTATAATATCAGGAGCCCAGTTAATAAAGATTATCTTGGTGAGTGTGGACAAGAGCAATAATGCCTTTGTGAGTCTTGAAAACAAAAAATACAAATCTCAACATTTCCTTATTTGCCTAATATCTGCATCTCACTTTTTAAATTCCACAG
>TTN-207,,0,85,1677807,1677891,GTATTTATCACAGAAGCTTTTAGGTGAATTATTTTCTTCTCACACCTGTCCATGAATTAATTAAATTTTGTCATTAACTTTCCAG
>TTN-207,,0,171,1677892,1678062,GTAAGCATTTTACTTAAAATTGGCTATACAATGAGTAGATCCTCTAAAACAATATAGCTTGACCTATGATTGATCACCTCTCTAGAAAGGAACTATGTTGATTATATTTCCCCAAGAAAAAAAAAGCTATCAGGCAAATAGGAAATATGAATCTTTCATTCTGTTTTTCAG
>TTN-207,,0,119,1678063,1678181,GTATGTACCAAATAGCCAAAAAAAAAAAAAAAGTAAAGTAAAATGAAAACATTCAGAATTCGTAACAATTTACCATAAAAATAATGCTTAAGAATAAATGCCTGATTTCTTTCCCATAG
>TTN-207,,0,98,1678182,1678279,GTAAGGATGTGTGACAAAGATACAAGCAAGTTGATGTTCAGTCACCCAATTTTGATTTGAAGTAAAAATTAATTTCCTGTATTTCTTCTCTTTCATAG
>TTN-207,,0,679,1678280,1678958,GTAAGTCCACAGGCCCTTCCACCACTCTCCCCACCTCTGATTCTGAATGTTAACAAAAAAGAATTTGTTTTTAATATGCCCTAATGTAAATAAAAATAGGTCACAAAATTAACCCTGTGGTCTTTCTAAGGTTTCTAAACCTCCTTTTCTCAGGTTTCTAAACCTCCTTTTCTCAGAGGTTTTCAACACACTTAGGCTTGATTTTTTTTTTAATATCTTCACTCTTATGAAAGAGAAGAGGAGGGAGTTAGGAAGAAAGGAATGGAAGGAAGAAAAGAGAGAAGGGAAGGAGGAAGAGAGGAAAGGAAGGAGGACTGGCAATGTTATAGTGAGAAAAAAATACAGAGTGCATGCTTAATAAATGTAGAATTGAAGAAAATGAGGAACAGCAAGGAAAGTACAAAATTAAACCTCAGCATCATGCAATATACCCATGTAACAAACTGCACATGTACCCCTGAAGCTAAAAGTCAAAAATTTTTAATAAAAATAATTAAATAATTAAATGATTTAAATTAAAATTTACAAATAGTACAAAAGTGAAACTATTGGAAAAATAGTCATGTGCCTTATGTACCTTTTAAAATACCAACCAAAACCTAAGGAAAACACAAATATATGAGTCATTGTTTTAACGTATTCATATTGCCATATCGTGTTAACCTCTGTCTTGCTGCAG
>TTN-207,,0,911,1678959,1679869,GTAAGGACATTTTGTATCAGTCAAATTGATTGAGTTACAATTTATATGTGGGAAAATTCACCTTTTTGAAATATATAGTTCTATGACTTTTGAAAAATGTACTGTTTTGTAATCACCACCACAATCAAAATGTGGAATATTTTTATTACCCCGTAAAGTTCCCTTGTGTCCGTTTGTAATCAGTCCCTTCCCCACCCCAGCTGCTAGCGATTTCTGGCAAATAATTTTTAATATTCTTCTCTGGAGTCAATTTCCACTTCTTTAAGATGAGATTCATAATATATGCTTTCTATCACACTTAAAATTTTAAAACAAGTTAATATTTCTGGAAGCACTTTAAAAACTGCTGATAAATGTAAGATAATAATAGTGATTACAAATGAAGCACATTTAAGAGAAAGGAAAGTGAAAAAATGTTAAGTATTTTTAGCTGATAAAATGAATAAAATTTTCTTTTTTCTTTCTTTTGTTTTTTTGTGTTTTTTTGAGACAGAGTCTCACTCTGTCACCCAGGCTGGAGTGCAGTGGCATGATCTTGGCTCACTGCAACCTCTGTCTCCCAGGTTCAAGCAATTCTTCTGCCTCAGCCTCCTGAGTAGCTGGGATTACAGGTGCCTGCCACCACGCATGGCTAATTTTTATGTTTTTAGTAGAGACGCGGTTTCACCATGTTGGCCAGGCTGGTCTTGAACTAACTCCTGACCTCAAGTATCTGCCCACCTTGGCCTCCCAACTTGCTGTGATTACAGGCATGAGCCACCACACCCAGCCATGAATAAAATTTTCACAAGACAAAAAAACAGGCTAATGTTAACAGTCCGTTTCAACAACTCATTGAATTTGTTAGGTGGCACAGCTAATTTTCAACTTTGCAGCAACTTTAACCAGTATATTCTTATTCTTATTCTCAG
>TTN-207,,0,101,1679870,1679970,GTGAGACATATGATCATTTGCTTTCTGCAATAATTGCCATAGACTTATTTCTTAGTCCCCCTACCCCAAATGCTAAATTGAAACCCTACCTTTTTTTCCAG
>TTN-207,,0,130,1679971,1680100,GTAAGTGCCCTTTCAACCACAAAATTATAAACATTATTTCAGCACTTTTCTGTTTTTAAATGAAAGTCATTGGCTTATAATACTTGGGACTGTATTCTAATACATGTGTGCTTTCCACTTATATTTACAG
>TTN-207,,0,106,1680101,1680206,GTAAGGAATTCAGAAGAAGGGGTTAAATTAAAGAAGCAAGCCATGTTTGGTCCTTTTATTTCACCAGTAAAGCTGACTCCCTTTTCATTATTTTAAAATATTTCAG
>TTN-207,,0,622,1680207,1680828,GTAAGTAGCCTTTGGTTCTCTACTTATGATTTACAAACTAAACAAGTTAAGGCTAATTCCCCCTCTATACTAAGTAGAACCCTGGAAAGCTTTATTGGAGAGCAAGTGTTAAGAAAGAAAAGCAAGTACACACACAGGAAATATGACAAGTTCTACAGGAAACCATTCCAAGCACACAACCTCAGCAGATGTTAGATGGAGTGAACTGAGCACTTTCCTTGAGTAATTCCCTCTAATGCAATGGTTTCTTTTTAAAAATATTTCCCAACAAGATTTGAAAGGTCAACAATTGTATGCCACTTCAATGAACCTAAGTAAGGGCAAGAATACTACAGAATTATAGAGAGAATTTACAGTCCCTTAAAAGCCTATACATTATTAATCCCCTTCCAATCATAAAGAGAAAAAAACACTCTACATAAAATGTGACGATGTGCTCATTGAATCCCTATTTACCATATGATCCTAGGAAAATCACTTCAAAGAGTTTTTAAGAATTAGGCTAATATGTAAATCATGGTATGTGTCAGTAAATAAGGTAAATTCATTCCTGATATACAAGGACAAAGGATTACAGATTGAGTATTAACAGTCACTTAATATTATCTTTCATATTGTTCAG
>TTN-207,,0,98,1680829,1680926,GTATTTTATTTTTATTTTCAGTGCTTTTTATTTTTAAAGAAAAAAAAATCTCAAAAACACACTATGAAAACCACCACAATTGTATTTTCCCCCAACAG
>TTN-207,,0,362,1680927,1681288,GTGAGTACAACTTGATTTCTGTATCTTCCTATGGTAAAGTTCCATCTTTGCATAAAATTCTTTTAAACAGAAAGAAATTTTGAAAGGAAATAGCAAAGATTCAGATAAAGTACAAGTGCCTTTTCTTTCACTTTAATTGAATGTTTGCATATCTAAAAGGAGAAATATATATCCTAACCCCATTGTAAAAATAGAACTTTGGTTTTTGATATGTCTTAGTATAAAGTAACCAATTTCATCTTTCTGGAATAGCTATTTTTTAACAAAATTTTGGACTCATATAACATTCTTTTTTAAAAAAATAAGCTTTAATAAAGCTGCCTGTTTCATCTCATGACTCAAATCTTTTTTTTGTTTAATAG
>TTN-207,,0,132,1681289,1681420,GTAAAAATAAATAAATTATCATCAAGTTGAGGCTAAATGAGTTATTAACTTGGGGGTGGAGGCTATTGCACTTAAACACATACTGTTAGATGTTGCTAAATTATATTCTTTTTTTTTTTTTTTCTGATACAG
>TTN-207,,0,124,1681421,1681544,GTAACCAGTTCTTAAATGTCTCTTTCTTTTATCTTCTAAAATATTTTATCTTCTAAATTCAGCTTCCCAAAAAAAGCTTAAAATGAAATCACTTTTTAAAACACAAATCATTTGCATTCTACAG
>TTN-207,,0,740,1681545,1682284,GTAGGTTGGCTTTTGTTTTTACCCACATTTCTTCAGAAGATAATATTAGGGAAATATTTTCAAACATCCCCCCTTATATACACATACAAGAAAGTATTAAAATAAAATTATTTTCCTAATTCCAGAATACAATTTGTACACCAAAGCAGAAACACACATTTGAAGTTAGCATATGCTTTTCTATGAGCATAAAAAGCAGTTATTAAGTACCTAGTTATATGTGGTATTATATAAGATTCCATAGTGTCAGCCCCTGCTCCCAGGAATATTTAAGAATAAAGTCAGTGAATATACAAAATGGCACTACTTGCCTAAACCTTCACAGTTGCTAATTTTCCAAAGCAGTGCAAAGTTAATTAAAGAACTATTTCTATTTTACCAATTAAAATTAGTTTGCTTTCATTTCAATCTTCTGAAAGATAATTTAATGTTTTGGTTACTCAAAATCTCCCAAATCCACTTATCTCCTAAATCCGTTGACTATTCTTTTCAAGACTTTTTTCCTTAAGTCATATGAATCATCTTTGGCTCAGTTTAGTTTAAGGAATCATTACAGTGATCTCAAAAGTCACACATGATAATTTTCCAAAAGTGGAACTGAGAAAGTATTAGGTATTACCTACATTGCATGAAGAAGTTGACTTTTTTTCTTTTTATGTTTTTCACACGCAGAATCTAGAAGAGTAAAAGGTGGGGGTCTCTTTCTAATTAAGTTTGCCTTACAGAGGTTTCTTTTTTAG
>TTN-207,,0,100,1682285,1682384,GTAAGTTTAATTATGAATATATTATTGAAGAAAAACTAAAATACCATGTCTTCCACATCTGAAGAACTTCAACATTTCTTTTCTTTTTCCTTTGTCTTAG
>TTN-207,,0,525,1682385,1682909,GTAAGTATCTCCTCACCCTTCTTCCTTACATGTTTAAGGCCTTTAGATCGTTTTTTTGCCTCTCTTTCAAGCACAGAAAACTCTAAGAAGCCTTATTAAATTCCATGTGAAAGAGGGACAGCCAACTGATGTGAATTCATTCTTGTAGTCAAACTTTCTTTATAGCTACACAGAAACTTGGATAGATTACATTTCAAAGTAAAGCTACCAACTGCCGTGTAACATTTATTTGCAGGATGCACAATATGTCAATTACTTTCTATATGACTAATCATTTTTCTCCTAGTGATTCCTAGCACCTGCATGTAATGTAATGATAGAAATATAAGGATTCATGTTTTGGAGACATTGAGCTAGCTCTTGACAAATGTATGTATATATGTATTTGCTTATGCTTCAACAGCAAATTGTTTGGGTTATGCTGCTGTGTGTGTGTTGAAGTTTCCATTTCTGTAAGTCAGCGTCATATGTCATCAATTAACCAGATGTCATTGATGTTCACTGTGTATCTGCTATGCTCCACAG
>TTN-207,,0,138,1682910,1683047,GTGAGCAATAAAATTACTGGTAGAGGTAGACAAGCCAAGTAACATGGTGTAGTCTTTAGTACACACAATTCAGTAGAAAGCAAATCTTTATTTTTTTCAGTGATTCTAAGACCTTTTTTTTGTCATTGTTCCATAAAG
>TTN-208,ENSE00001465556,1,212,1683048,1683259,GAGCAGTCGTGCATTCCCAGCCTCGCCTCGGGTGTAGGGATTGCATAGAAAAGCAAAACTACACAGTCTTGACTGTGTAGTTTTGTTTTTAGGATTAGAGGCTCACCGATTCATGTCGGAGATGGTCAGAAAAACCAACTCTCCATAGGACGTCGTTTCAGAAGCAACCTTGGGCTTAGTCCCACCCTTTTTAGGCACTCTTGAGAAATCAG
>TTN-208,ENSE00003502146,1,104,1683260,1683363,AGTGCCTAGAAAGATGACAACTCAAGCACCGACGTTTACGCAGCCGTTACAAAGCGTTGTGGTACTGGAGGGTAGTACCGCAACCTTTGAGGCTCACATTAGTG
>TTN-208,ENSE00003807606,1,204,1683364,1683567,GTTTTCCAGTTCCTGAGGTGAGCTGGTTTAGGGATGGCCAGGTGATTTCCACTTCCACTCTGCCCGGCGTGCAGATCTCCTTTAGCGATGGCCGCGCTAAACTGACGATCCCCGCCGTGACTAAAGCCAACAGTGGACGATATTCCCTGAAAGCCACCAATGGATCTGGACAAGCGACTAGTACTGCTGAGCTTCTCGTGAAAG
>TTN-208,ENSE00003810976,1,288,1683568,1683855,CTGAGACAGCACCACCCAACTTCGTTCAACGACTGCAGAGCATGACCGTGAGACAAGGAAGCCAAGTGAGACTCCAAGTGAGAGTGACTGGAATCCCTACACCTGTGGTGAAGTTCTACCGGGATGGAGCCGAAATCCAGAGCTCCCTTGATTTCCAAATTTCACAAGAAGGCGACCTCTACAGCTTACTGATTGCAGAAGCATACCCTGAGGACTCAGGGACCTATTCAGTAAATGCCACCAATAGCGTTGGAAGAGCTACTTCGACTGCTGAATTACTGGTTCAAG
>TTN-208,ENSE00003809662,1,86,1683856,1683941,GTGAAGAAGAAGTACCTGCTAAAAAGACAAAGACAATTGTTTCGACTGCTCAGATCTCAGAATCAAGACAAACCCGAATTGAAAAG
>TTN-208,ENSE00003809782,1,245,1683942,1684186,AAGATTGAAGCCCACTTTGATGCCAGATCAATTGCAACAGTTGAGATGGTCATAGATGGTGCCGCTGGGCAACAGCTGCCACATAAAACACCTCCCAGGATTCCTCCGAAGCCAAAGTCAAGATCCCCAACACCACCGTCTATTGCTGCCAAAGCACAGCTGGCTCGGCAGCAGTCCCCATCGCCCATAAGACACTCCCCTTCCCCGGTCAGACACGTGCGGGCACCGACCCCATCTCCGGTCAG
>TTN-208,ENSE00003805863,1,331,1684187,1684517,GTCCGTGTCTCCAGCAGCAAGAATCTCCACATCCCCCATCAGGTCTGTTAGGTCTCCATTGCTCATGCGTAAGACTCAGGCATCCACCGTGGCCACAGGTCCTGAAGTGCCTCCCCCTTGGAAGCAAGAGGGCTACGTGGCCTCCTCATCTGAGGCTGAGATGAGAGAGACAACGCTGACAACCTCTACTCAGATCAGGACAGAAGAGAGATGGGAAGGGAGATACGGTGTCCAGGAGCAAGTGACCATCAGTGGTGCTGCGGGTGCTGCCGCCAGTGTGTCGGCCAGTGCTAGCTACGCAGCAGAGGCTGTTGCCACTGGTGCTAAAGAG
>TTN-208,ENSE00003803639,1,153,1684518,1684670,GTGAAACAAGATGCTGACAAAAGTGCAGCTGTTGCGACTGTTGTTGCTGCCGTTGATATGGCCAGAGTGAGAGAACCAGTGATCAGCGCTGTAGAGCAGACTGCTCAGAGGACAACCACGACTGCTGTGCACATCCAACCTGCTCAAGAACAG
>TTN-208,ENSE00003810843,1,138,1684671,1684808,GTAAGAAAGGAAGCGGAGAAGACTGCTGTAACTAAGGTAGTAGTGGCCGCCGATAAAGCCAAGGAACAAGAATTAAAATCAAGAACCAAAGAAGTAATTACCACAAAGCAAGAGCAGATGCACGTAACTCATGAGCAG
>TTN-208,ENSE00003803899,1,126,1684809,1684934,ATAAGAAAAGAAACTGAAAAAACATTTGTACCAAAGGTAGTAATTTCCGCAGCTAAAGCCAAAGAACAAGAAACTAGAATTTCTGAAGAAATTACTAAGAAACAGAAACAAGTAACTCAAGAAGCA
>TTN-208,ENSE00003805623,1,138,1684935,1685072,ATGAGAAAGGAAGCCGAGAAAACTGCCTTGTCTACAATAGCAGTTGCTACTGCTAAAGCCAAAGAACAAGAAACAATACTGAGAACTAGAGAAACTATGGCTACTAGACAAGAACAAATCCAAGTTACCCATGGAAAG
>TTN-208,ENSE00003801659,1,294,1685073,1685366,GTGGACGTTGGAAAAAAGGCTGAAGCTGTAGCAACAGTTGTTGCTGCAGTAGACCAGGCCCGAGTCAGAGAGCCCAGAGAGCCTGGGCATCTTGAAGAATCCTATGCTCAGCAGACCACTTTGGAGTACGGATATAAGGAACGCATTTCCGCCGCAAAGGTAGCTGAGCCTCCCCAACGTCCAGCCTCAGAACCCCACGTTGTCCCTAAAGCAGTCAAGCCTAGAGTAATCCAGGCTCCTTCTGAGACTCATATCAAAACTACTGATCAAAAGGGAATGCACATATCATCACAG
>TTN-208,ENSE00003804455,1,123,1685367,1685489,ATCAAGAAAACTACAGATCTAACAACGGAAAGATTAGTCCATGTGGATAAACGCCCCCGCACAGCTAGCCCTCACTTTACTGTTTCAAAAATTTCTGTTCCTAAGACAGAACATGGATATGAG
>TTN-208,ENSE00003810306,1,282,1685490,1685771,GCATCAATAGCCGGTAGTGCTATTGCCACATTACAAAAAGAGTTGTCAGCCACATCTTCTGCTCAGAAGATCACCAAATCGGTGAAGGCTCCTACTGTGAAGCCCAGTGAGACTAGAGTAAGGGCAGAGCCCACACCCTTGCCACAGTTCCCCTTCGCTGACACACCAGATACTTACAAGAGTGAAGCTGGCGTTGAGGTGAAAAAGGAAGTAGGGGTGAGCATCACTGGCACCACCGTCCGTGAAGAGCGCTTTGAAGTACTGCACGGACGCGAAGCCAAG
>TTN-208,ENSE00003805296,1,66,1685772,1685837,GTAACAGAAACAGCAAGAGTACCAGCACCTGTTGAAATTCCTGTTACTCCACCAACTTTGGTCTCG
>TTN-208,ENSE00003806123,1,259,1685838,1686096,GGCTTAAAAAATGTGACTGTCATAGAAGGTGAATCTGTCACCTTGGAGTGCCACATCTCTGGATACCCATCCCCGACAGTGACATGGTACAGGGAAGACTACCAAATCGAAAGTTCCATTGACTTCCAGATAACCTTCCAGAGTGGAATTGCTCGTCTTATGATTCGCGAAGCATTTGCGGAAGACAGCGGGCGATTTACTTGCAGTGCTGTAAATGAGGCTGGAACCGTCAGCACATCCTGCTATCTGGCTGTGCAGG
>TTN-208,ENSE00003808554,1,64,1686097,1686160,TGTCAGAAGAATTTGAAAAGGAAACCACAGCCGTGACTGAGAAATTTACTACAGAAGAGAAACG
>TTN-208,ENSE00003804962,1,216,1686161,1686376,CTTTGTTGAGTCAAGAGATGTGGTTATGACTGATACTAGCCTCACAGAGGAACAAGCAGGGCCTGGAGAACCTGCCGCGCCTTACTTTATTACAAAACCAGTGGTCCAGAAACTGGTGGAAGGTGGGAGCGTGGTGTTTGGATGCCAAGTTGGCGGCAACCCAAAGCCCCATGTATACTGGAAAAAATCTGGTGTTCCTCTAACCACTGGATACAG
>TTN-208,ENSE00003804165,1,143,1686377,1686519,ATACAAAGTGAGTTACAACAAACAAACCGGTGAATGCAAGCTGGTGATTTCTATGACTTTTGCTGATGATGCTGGAGAATACACTATTGTTGTTCGCAATAAGCATGGAGAAACTTCTGCATCTGCTTCCTTGCTTGAAGAAG
>TTN-208,ENSE00003802603,1,206,1686520,1686725,CTGATTATGAGTTACTGATGAAGTCCCAGCAAGAAATGCTTTATCAGACACAAGTGACTGCATTTGTTCAAGAACCTAAAGTTGGAGAAACAGCACCTGGATTTGTATACTCTGAGTATGAAAAAGAGTATGAAAAAGAACAAGCCTTAATTAGGAAGAAAATGGCCAAAGATACTGTAGTGGTCAGAACTTATGTAGAAGATCAG
>TTN-208,ENSE00003807963,1,234,1686726,1686959,GAATTCCATATTTCTTCCTTTGAAGAGAGACTTATTAAAGAAATTGAATATAGAATAATAAAGACTACATTAGAAGAACTTCTTGAAGAAGATGGAGAAGAAAAGATGGCAGTTGACATTTCTGAATCTGAAGCTGTTGAATCAGGATTTGATTCAAGAATCAAGAATTATAGAATTCTTGAGGGGATGGGTGTCACTTTTCATTGCAAGATGTCTGGATATCCATTACCAAAG
>TTN-208,ENSE00003808968,1,245,1686960,1687204,ATTGCTTGGTACAAAGATGGCAAGCGCATCAAACATGGAGAAAGATACCAAATGGACTTTCTACAAGATGGCAGAGCTAGTCTGCGTATACCTGTTGTTCTTCCAGAAGATGAAGGAATCTACACTGCATTTGCCAGCAATATTAAAGGAAATGCAATTTGCTCAGGGAAATTGTATGTGGAGCCTGCTGCACCACTTGGAGCTCCGACTTACATTCCCACACTAGAGCCAGTGAGCAGAATCAG
>TTN-208,ENSE00003802614,1,272,1687205,1687476,ATCTCTCTCTCCACGTTCAGTGAGCAGGTCTCCTATACGCATGTCTCCTGCACGGATGTCACCTGCAAGGATGTCTCCTGCACGGATGTCCCCTGCAAGAATGTCCCCTGGACGTAGGCTGGAGGAGACAGATGAGTCACAACTTGAGAGACTATATAAACCAGTCTTTGTGTTAAAACCTGTTTCTTTCAAATGTTTAGAAGGGCAAACTGCCAGATTTGACTTAAAGGTTGTTGGTAGACCTATGCCAGAGACGTTCTGGTTTCATGATG
>TTN-208,ENSE00003811446,1,165,1687477,1687641,GCCAGCAAATTGTCAATGACTATACCCATAAAGTAGTCATTAAAGAAGATGGTACTCAATCACTAATTATTGTCCCTGCCACACCCAGTGATTCTGGGGAATGGACTGTGGTTGCCCAAAACAGGGCAGGCAGATCTTCAATTTCAGTGATTTTAACTGTGGAAG
>TTN-208,ENSE00003805710,1,169,1687642,1687810,CTGTGGAACATCAGGTAAAACCGATGTTTGTAGAAAAACTGAAAAATGTCAATATAAAGGAAGGTTCCCGACTTGAAATGAAAGTCAGAGCTACGGGTAACCCCAACCCTGACATTGTATGGTTGAAAAACAGTGACATCATTGTGCCTCATAAATATCCCAAAATCAG
>TTN-208,ENSE00003809358,1,1694,1687811,1689504,AATTGAAGGAACCAAGGGAGAAGCTGCCCTTAAAATCGATTCCACTGTCAGCCAAGATTCTGCCTGGTATACTGCGACTGCTATTAATAAAGCTGGCAGAGACACTACAAGATGCAAAGTAAATGTTGAAGTTGAGTTTGCAGAGCCTGAGCCAGAGAGAAAGTTAATCATCCCACGGGGGACATATAGAGCAAAGGAGATTGCAGCCCCAGAACTGGAGCCCCTCCATTTGCGATATGGCCAAGAGCAATGGGAAGAAGGTGATCTCTATGACAAAGAGAAACAACAGAAACCATTTTTCAAGAAAAAACTCACTTCCTTAAGACTTAAGCGCTTTGGGCCTGCCCACTTTGAATGCAGGCTAACACCCATTGGTGACCCAACGATGGTGGTGGAGTGGCTCCATGATGGAAAGCCACTTGAAGCAGCCAACAGGCTCCGTATGATCAATGAATTTGGGTACTGCAGCCTTGATTATGGCGTTGCATATTCTAGAGACAGTGGTATCATTACTTGCAGAGCCACTAACAAATATGGAACAGATCACACATCTGCTACCCTTATTGTTAAAGATGAGAAAAGTCTTGTGGAAGAATCCCAATTGCCTGAGGGGAGGAAAGGCTTACAGAGAATTGAAGAATTAGAGAGAATGGCTCATGAAGGTGCACTTACAGGTGTAACAACAGATCAGAAAGAAAAGCAAAAGCCAGACATTGTCTTGTACCCAGAGCCAGTTAGAGTACTTGAAGGGGAGACTGCAAGGTTCCGCTGCAGGGTAACAGGCTACCCTCAGCCCAAAGTCAACTGGTACCTCAATGGACAGCTCATCCGCAAAAGCAAAAGGTTCAGAGTTCGCTATGATGGTATCCATTACCTGGACATCGTGGACTGCAAATCATATGACACAGGTGAAGTGAAGGTCACCGCGGAAAATCCTGAAGGTGTGATAGAGCATAAAGTGAAGCTTGAGATTCAACAGAGGGAAGATTTTAGGTCTGTCCTTAGGAGAGCTCCTGAACCAAGGCCTGAGTTTCACGTACATGAACCAGGAAAGCTTCAGTTTGAAGTACAAAAAGTGGATAGACCTGTTGACACCACTGAAACCAAAGAAGTTGTGAAGTTGAAAAGGGCTGAAAGAATTACCCATGAAAAAGTGCCTGAAGAGTCGGAAGAGCTGCGCAGTAAATTCAAGCGCAGAACAGAAGAGGGCTATTATGAAGCCATTACCGCTGTGGAGCTCAAGTCTCGAAAGAAGGATGAATCCTATGAGGAACTCCTCAGGAAGACAAAAGATGAACTTCTCCACTGGACCAAAGAGTTAACTGAAGAGGAAAAGAAAGCTCTTGCCGAAGAAGGCAAAATCACGATTCCAACTTTTAAACCTGACAAGATTGAACTAAGTCCTAGTATGGAGGCTCCAAAAATCTTCGAAAGAATCCAGAGCCAAACAGTGGGCCAAGGATCTGATGCACACTTCCGGGTCAGAGTCGTGGGGAAACCAGACCCCGAATGTGAATGGTACAAAAATGGTGTCAAAATTGAACGGTCTGACCGGATCTACTGGTACTGGCCCGAAGACAATGTTTGTGAATTGGTCATAAGAGATGTGACTGCTGAGGACTCTGCCAGCATCATGGTAAAAGCCATCAACATAGCTGGAGAAACCTCCAGTCACGCATTCTTACTTGTCCAAG
>TTN-208,ENSE00003809440,1,282,1689505,1689786,CCAAGCAATTGATCACTTTCACACAGGAATTACAAGATGTTGTTGCTAAGGAAAAAGACACTATGGCAACCTTTGAATGTGAAACTTCAGAACCATTTGTCAAAGTGAAATGGTATAAAGATGGTATGGAGGTTCATGAGGGAGATAAATACAGGATGCACTCTGACAGAAAGGTTCACTTCCTCTCCATACTGACCATTGATACGTCTGATGCTGAAGATTACAGCTGTGTACTTGTGGAAGATGAAAATGTCAAAACGACTGCTAAACTTATTGTTGAAG
>TTN-208,ENSE00003802960,1,267,1689787,1690053,GTGCAGTTGTTGAGTTTGTGAAAGAACTTCAGGACATAGAAGTTCCAGAATCATATTCAGGAGAATTAGAGTGCATTGTATCCCCAGAAAATATAGAAGGAAAATGGTATCATAATGATGTGGAGCTTAAATCCAATGGCAAATATACAATTACATCTCGTCGTGGACGTCAGAACCTCACGGTCAAGGATGTAACCAAGGAGGACCAGGGAGAATACAGCTTTGTCATCGACGGGAAAAAGACAACCTGTAAATTAAAGATGAAAC
>TTN-208,ENSE00003804241,1,273,1690054,1690326,CCCGCCCCATTGCTATCCTACAAGGACTTAGTGACCAAAAAGTCTGTGAGGGTGACATTGTTCAGCTTGAAGTTAAAGTCTCCTTGGAAAGTGTGGAAGGCGTCTGGATGAAAGACGGCCAAGAAGTGCAGCCCAGTGACAGGGTTCACATTGTGATAGACAAACAATCTCATATGCTGCTCATTGAAGACATGACTAAGGAAGATGCTGGAAATTACTCTTTCACCATTCCAGCCCTTGGCCTCTCCACCAGTGGGCGTGTCTCTGTCTATA
>TTN-208,ENSE00003806988,1,264,1690327,1690590,GTGTGGACGTGATAACACCTCTAAAAGATGTTAATGTGATTGAAGGCACCAAGGCTGTGCTTGAATGTAAGGTGTCAGTCCCTGATGTGACTTCTGTTAAGTGGTACTTAAATGATGAACAAATCAAGCCTGATGACCGTGTACAGGCCATTGTGAAAGGTACTAAACAGCGACTAGTCATTAACCGAACTCATGCTTCAGACGAAGGACCTTACAAGCTGATAGTTGGCAGAGTTGAAACCAACTGTAATCTCTCTGTAGAAA
>TTN-208,ENSE00003804968,1,261,1690591,1690851,AAATTAAAATTATCAGAGGTCTTCGTGACCTTACCTGTACAGAAACTCAAAATGTGGTGTTTGAGGTTGAGCTGTCCCACTCTGGAATTGATGTCCTGTGGAATTTTAAGGACAAGGAAATCAAGCCCAGTTCTAAATATAAAATTGAAGCACATGGAAAAATATATAAATTGACAGTTCTAAATATGATGAAAGATGATGAAGGAAAATACACATTTTACGCGGGAGAAAATATGACATCTGGAAAACTTACTGTGGCAG
>TTN-208,ENSE00003809850,1,261,1690852,1691112,GTGGGGCCATCTCCAAGCCACTCACAGATCAGACCGTAGCTGAATCCCAGGAAGCTGTGTTTGAATGTGAAGTTGCCAACCCAGATTCCAAAGGCGAATGGTTGAGGGATGGCAAACACCTACCACTGACTAACAACATCAGAAGTGAGTCTGATGGCCACAAAAGGAGACTTATCATTGCTGCCACCAAATTAGATGACATTGGAGAATATACCTACAAGGTGGCCACCTCCAAAACATCTGCCAAACTCAAAGTTGAAG
>TTN-208,ENSE00003806479,1,264,1691113,1691376,CTGTCAAAATTAAGAAGACTCTGAAGAACCTCACAGTGACAGAAACACAGGATGCTGTTTTCACTGTCGAGCTTACACACCCTAATGTCAAAGGTGTCCAGTGGATCAAAAATGGAGTTGTGCTGGAATCCAATGAAAAGTATGCTATCTCTGTCAAAGGAACAATTTACTCTCTGAGGATTAAAAACTGTGCCATCGTGGATGAGTCTGTTTATGGCTTCAGGCTTGGAAGGCTTGGAGCCAGTGCCAGACTGCACGTGGAGA
>TTN-208,ENSE00003804523,1,261,1691377,1691637,CTGTCAAGATCATTAAAAAGCCAAAGGATGTGACAGCCTTGGAAAATGCCACTGTTGCCTTTGAAGTTAGTGTTTCCCATGACACTGTTCCAGTAAAATGGTTCCATAAGAGTGTGGAAATTAAGCCAAGTGACAAACACAGACTGGTCTCAGAAAGGAAAGTCCACAAGCTGATGCTGCAGAACATCTCCCCCTCAGATGCTGGGGAATACACAGCTGTGGTCGGGCAATTGGAATGCAAAGCAAAACTGTTTGTGGAGA
>TTN-208,ENSE00003807378,1,261,1691638,1691898,CATTACATATTACAAAAACCATGAAAAATATCGAGGTGCCTGAGACCAAAACTGCCTCTTTTGAGTGTGAGGTGTCCCACTTCAATGTCCCTTCCATGTGGCTGAAGAATGGTGTGGAAATTGAGATGAGTGAAAAGTTCAAGATAGTTGTGCAGGGAAAACTCCATCAGCTGATCATCATGAACACCAGCACAGAGGACTCGGCAGAATACACATTTGTCTGTGGCAATGACCAAGTCAGTGCCACCCTGACAGTCACCC
>TTN-208,ENSE00003807271,1,261,1691899,1692159,CAATCATGATTACTTCCATGCTGAAAGACATCAACGCTGAAGAAAAAGACACTATTACTTTTGAGGTGACAGTGAACTATGAAGGCATCTCTTACAAATGGTTAAAGAATGGTGTGGAAATCAAATCAACTGACAAGTGCCAGATGAGAACCAAAAAGCTCACACACTCACTGAACATCAGGAATGTTCACTTTGGGGATGCTGCTGACTACACCTTTGTGGCTGGAAAAGCAACATCAACAGCCACACTTTATGTGGAAG
>TTN-208,ENSE00003808172,1,142,1692160,1692301,CTCGTCATATAGAATTTAGGAAACACATTAAGGACATTAAGGTACTGGAGAAGAAGCGAGCCATGTTTGAATGTGAAGTTTCTGAACCTGACATCACTGTACAGTGGATGAAAGATGACCAGGAACTGCAGATCACAGACAG
>TTN-208,ENSE00003808223,1,166,1692302,1692467,AATAAAGATTCAGAAGGAGAAATATGTCCACCGCCTTCTGATCCCATCCACCCGGATGTCTGATGCTGGGAAGTACACAGTGGTGGCAGGAGGCAACGTGTCAACTGCAAAACTCTTTGTAGAAGGCAGAGATGTTCGCATCCGAAGTATTAAAAAGGAGGTTCAG
>TTN-208,ENSE00003810851,1,232,1692468,1692699,GTCATTGAGAAACAGCGTGCTGTTGTTGAATTTGAGGTCAATGAAGACGATGTTGATGCCCACTGGTATAAAGATGGCATTGAAATCAATTTCCAAGTTCAAGAACGACACAAATATGTAGTGGAAAGAAGAATCCACCGAATGTTTATCTCTGAGACCAGACAGAGCGATGCAGGAGAATACACCTTTGTGGCAGGAAGGAACAGGAGTTCTGTCACTCTCTATGTCAATG
>TTN-208,ENSE00003802092,1,285,1692700,1692984,CTCCTGAACCGCCCCAAGTTCTGCAGGAGCTCCAGCCTGTCACTGTGCAGTCTGGCAAGCCTGCCCGCTTCTGTGCCGTGATATCCGGAAGACCACAGCCCAAAATTTCCTGGTACAAGGAAGAGCAGCTGCTTTCCACTGGCTTCAAGTGCAAATTTCTTCATGATGGGCAAGAATACACGCTTTTGCTAATTGAAGCCTTCCCAGAGGATGCGGCAGTCTATACCTGTGAAGCCAAGAATGACTATGGTGTTGCCACAACATCAGCTTCACTCTCAGTGGAAG
>TTN-208,ENSE00003807103,1,126,1692985,1693110,TTCCAGAAGTTGTGTCTCCTGATCAGGAAATGCCTGTTTATCCACCTGCCATCATCACCCCGCTTCAGGACACTGTCACTTCTGAAGGGCAGCCAGCCCGTTTTCAATGCCGGGTTTCTGGAACAG
>TTN-208,ENSE00003801355,1,189,1693111,1693299,ATCTAAAAGTGTCGTGGTACAGCAAAGACAAGAAAATCAAGCCATCTCGGTTCTTTAGAATGACTCAATTTGAAGACACTTATCAACTGGAAATTGCCGAAGCTTATCCAGAAGATGAAGGAACTTACACGTTTGTTGCTAGTAATGCTGTAGGCCAAGTATCAAGCACAGCCAACCTGAGTCTGGAAG
>TTN-208,ENSE00004024281,1,375,1693300,1693674,GATTTAGCAAATTTGAAGAAAATACATCAAACTCCCAATGGCATGTCTCTTTATCAGTTTCATTTAAGAAGGAGCCCCTTGGCCAAAAGCCCAGCTTCATCCAGCCTCTGTCAAGCCTCAGGGTGCACAACGGGGAGACAGTCAGATTTCATGCGAGGGTTTCTGGCATTCCCAAGCCAGAAATCCAATGGTTTCATAACCAGCAGCTAATTCTACCAACAAAAGATGTAGTTTTCCATTTTGAGGAGTCCACAGGCATGGCTTTAATGCTTATAGTTGATGCTTACTCAGAGCATGCTGGGCAGTACTCTTGCAAAGCAGCCAATAGTGCTGGGGAAGCCACTTGTGCAGCTACACTCACAGTGACTCCAAAAG
>TTN-208,ENSE00004024285,1,576,1693675,1694250,TGCAAGCCCTAGATAGGCAAAGTTCTGGGAAAGATGTAAGAGAGTCCACCAAGTCCCAGGCAGTGGCAGATTCCTCTTTCACAAAGGAGGAGAGCAAAATATCTCAAAAGGAAATTAAGTCATTTCAAGGATCATCATATGAATATGAAGTGCAGGTTTTTGAAAGTGTATCTCAAAGTTCCATCCACACAGCTGCATCTGTTCAAGATACACAGTTGTGCCATACTGCATCCCTTTCACAAATTGCAGAAAGCACTGAGCTATCTAAGGAATGTGCTAAAGAGTCCACGGGTGAGGCGCCCAAGATTTTCCTGCATCTTCAGGACGTCACTGTAAAGTGCGGTGACACGGCTCAATTCCTCTGTGTTTTAAAAGATGATTCTTTCATTGATGTAACCTGGACTCACGAAGGTGCAAAGATAGAGGAATCCGAGAGACTGAAACAATCACAAAATGGAAATATTCAGTTTCTTACCATATGTAATGTTCAGCTGGTAGACCAAGGACTATACAGCTGCATTGTACACAATGACTGTGGAGAGAGGACAACGTCAGCAGTACTAAGTGTAGAAGGTG
>TTN-208,ENSE00003810791,1,57,1694251,1694307,CTCCTGAATCAATTTTGCATGAGAGGATTGAACAAGAGATTGAGATGGAAATGAAAG
>TTN-208,ENSE00004024265,1,2781,1694308,1697088,AGTTTTCTAGTTCTTTTCTGTCTGCCGAGGAAGAAGGACTTCATAGCGCCGAACTTCAATTATCTAAAATAAATGAAACACTTGAACTTTTGTCTGAATCTCCAGTTTACCCAACTAAATTTGATTCCGAAAAGGAAGGCACTGGCCCAATTTTCATCAAAGAAGTGTCAAATGCTGATATAAGCATGGGGGATGTGGCTACACTGTCTGTAACTGTCATTGGCATCCCCAAACCTAAAATTCAGTGGTTCTTTAATGGAGTGCTATTAACCCCTTCTGCTGACTACAAATTTGTTTTTGACGGTGATGATCATAGCCTGATCATTCTGTTCACCAAATTGGAGGATGAGGGAGAGTATACATGTATGGCCAGTAATGACTATGGAAAGACAATATGTAGTGCCTATCTAAAAATTAATTCCAAAGGAGAGGGTCACAAAGACACTGAAACAGAATCAGCAGTGGCAAAATCTCTGGAAAAGCTGGGAGGTCCTTGTCCTCCTCACTTCCTTAAGGAGTTAAAACCAATTCGCTGTGCTCAAGGGCTTCCTGCCATCTTTGAGTACACAGTGGTTGGAGAGCCTGCCCCTACTGTTACATGGTTCAAAGAAAACAAGCAGCTTTGCACCAGTGTTTATTACACTATCATTCATAACCCTAATGGCTCTGGAACTTTCATTGTCAATGACCCTCAGAGGGAAGACAGTGGCCTCTATATCTGTAAAGCAGAGAATATGTTGGGTGAGTCCACCTGTGCAGCAGAGCTGCTTGTGCTTCTGGAAGACACAGACATGACTGATACCCCCTGCAAAGCAAAGTCCACACCAGAGGCTCCTGAGGATTTTCCACAGACACCCTTAAAGGGTCCCGCAGTTGAAGCACTTGACTCAGAGCAGGAAATTGCAACGTTTGTAAAAGACACCATTTTGAAAGCTGCTTTAATTACAGAAGAAAACCAGCAACTATCTTATGAGCATATTGCTAAAGCCAATGAATTGAGCAGTCAGCTTCCTTTGGGAGCTCAGGAATTGCAATCCATTTTGGAGCAAGACAAGCTCACTCCTGAAAGCACCAGGGAATTTCTTTGCATCAATGGCAGTATTCACTTTCAGCCTCTCAAGGAACCATCTCCCAACCTACAGCTGCAGATTGTACAGTCCCAGAAAACCTTCTCCAAAGAAGGTATTCTAATGCCTGAAGAGCCTGAGACACAGGCAGTTCTATCAGATACCGAGAAAATCTTCCCAAGTGCCATGTCCATAGAACAAATTAATTCATTAACAGTTGAGCCTCTGAAAACTTTATTAGCTGAACCTGAAGGGAATTATCCACAGTCTTCAATAGAACCTCCAATGCATTCTTATCTAACCTCTGTGGCTGAGGAAGTACTTTCACCAAAAGAAAAGACAGTATCTGACACCAACAGAGAGCAAAGAGTGACTCTTCAAAAGCAAGAGGCACAAAGTGCGCTCATCTTGAGTCAGAGCTTAGCTGAGGGACACGTGGAGAGTCTCCAGAGTCCTGATGTCATGATCTCTCAGGTAAACTATGAGCCCCTAGTCCCTTCAGAACACTCATGCACAGAAGGAGGTAAAATTTTGATAGAAAGTGCAAATCCACTGGAAAATGCAGGGCAAGATTCTGCGGTCAGAATTGAGGAAGGCAAGTCCTTAAGATTTCCACTAGCACTTGAAGAAAAGCAGGTACTGCTCAAAGAAGAGCATTCTGACAACGTGGTGATGCCCCCAGACCAAATCATTGAGTCTAAAAGAGAGCCCGTGGCAATAAAGAAAGTGCAGGAGGTACAGGGAAGGGACCTTCTTTCTAAGGAAAGCTTGCTTTCTGGTATTCCAGAAGAGCAGAGATTAAACCTGAAAATTCAAATCTGCCGGGCTTTGCAAGCAGCCGTGGCCAGCGAGCAGCCAGGTCTTTTCTCTGAGTGGCTAAGAAATATTGAAAAGGTGGAGGTCGAGGCTGTAAACATCACCCAAGAGCCCAGACACATCATGTGCATGTACCTTGTTACTTCGGCAAAGTCTGTAACAGAAGAAGTAACCATCATTATTGAAGATGTTGATCCTCAAATGGCTAACCTGAAAATGGAACTTAGGGATGCTTTGTGTGCTATTATATATGAGGAAATAGACATCCTAACAGCTGAGGGTCCTAGAATTCAGCAAGGAGCCAAAACAAGTTTGCAAGAAGAAATGGATTCTTTTTCAGGTTCACAGAAGGTTGAACCCATTACTGAACCAGAAGTTGAATCTAAATATCTGATCTCAACTGAAGAGGTCAGTTATTTTAACGTGCAAAGTAGGGTTAAATATTTGGATGCCACACCTGTCACTAAAGGGGTTGCTTCAGCTGTTGTCTCTGACGAAAAACAAGATGAGAGTCTGAAACCATCAGAGGAAAAAGAGGAGTCTTCCTCTGAAAGTGGTACTGAGGAGGTTGCTACAGTAAAGATACAGGAAGCTGAGGGTGGCTTAATCAAAGAGGATGGCCCCATGATACATACACCTTTAGTGGACACTGTTTCTGAGGAAGGTGATATTGTACACCTCACAACATCCATAACAAATGCTAAAGAGGTGAATTGGTATTTTGAGAATAAACTGGTGCCTTCAGATGAAAAGTTCAAGTGTTTACAAGATCAAAATACATATACGCTAGTCATCGACAAAGTAAATACCGAAGACCATCAAGGAGAGTATGTCTGTGAGGCCTTGAATGACAGCGGAAAAACAGCAACTTCAGCCAAACTCACTGTAGTAAAAAGAG
>TTN-208,ENSE00003805227,1,279,1697089,1697367,CTGCCCCAGTGATCAAGAGGAAAATCGAACCCCTGGAAGTAGCACTGGGCCACCTAGCCAAATTCACCTGTGAGATCCAAAGTGCTCCCAATGTCCGGTTCCAGTGGTTTAAAGCTGGCCGAGAAATTTATGAGAGTGACAAGTGTTCTATTCGATCTTCAAAGTATATCTCCAGCCTTGAAATCCTGAGAACCCAGGTGGTTGACTGCGGCGAGTATACATGCAAAGCTTCCAATGAGTATGGCAGTGTCAGCTGTACAGCCACACTAACTGTGACAG
>TTN-208,ENSE00003808619,1,564,1697368,1697931,AGGCATATCCACCAACCTTTCTCTCCAGACCTAAGTCCCTTACAACTTTTGTGGGTAAGGCAGCCAAGTTCATCTGCACAGTGACAGGGACTCCTGTGATAGAAACCATTTGGCAGAAAGATGGTGCTGCACTCTCACCTTCACCTAACTGGAGGATTTCCGACGCAGAAAACAAACACATTTTAGAACTCTCAAACCTTACCATTCAAGATAGAGGAGTTTATTCTTGTAAGGCTTCCAACAAGTTTGGAGCAGACATCTGCCAAGCAGAGTTGATCATCATTGATAAGCCACATTTCATTAAAGAATTAGAGCCTGTGCAGTCCGCTATCAATAAGAAGGTCCACCTTGAGTGCCAAGTAGATGAAGACAGAAAAGTCACAGTTACGTGGAGCAAAGATGGGCAAAAACTCCCCCCAGGGAAAGATTATAAGATCTGTTTTGAAGATAAAATAGCAACACTTGAGATTCCTTTGGCCAAACTGAAAGATTCAGGAACCTATGTCTGTACAGCTTCAAATGAGGCTGGAAGCAGCTCCTGCTCAGCCACAGTCACTGTCAGAG
>TTN-208,ENSE00003811334,1,282,1697932,1698213,AGCCACCATCCTTCGTGAAGAAGGTGGATCCCTCTTATTTAATGCTCCCAGGTGAATCAGCACGCCTCCATTGCAAGCTGAAAGGCTCACCTGTGATCCAGGTTACTTGGTTTAAAAATAACAAAGAACTCAGTGAAAGTAACACAGTCCGAATGTATTTTGTCAATTCTGAGGCTATACTTGATATTACGGATGTAAAAGTTGAAGACAGTGGGAGTTACTCATGTGAAGCAGTGAATGACGTCGGCAGTGATAGCTGCAGTACTGAAATAGTTATCAAAG
>TTN-208,ENSE00003807496,1,279,1698214,1698492,AACCTCCTTCTTTCATCAAAACTCTTGAGCCTGCAGACATAGTGAGAGGAACAAATGCTCTACTTCAGTGTGAAGTCTCAGGCACTGGACCATTTGAAATTAGCTGGTTCAAAGACAAGAAACAAATTCGAAGTAGTAAAAAATACAGATTGTTTTCTCAGAAGTCTCTTGTGTGTCTGGAGATCTTTTCGTTTAATAGTGCAGATGTTGGTGAATATGAATGTGTTGTTGCTAATGAAGTCGGCAAGTGTGGCTGCATGGCAACCCACTTACTCAAAG
>TTN-208,ENSE00003806831,1,279,1698493,1698771,AACCTCCAACCTTTGTAAAGAAAGTAGATGATTTGATTGCACTAGGAGGACAAACCGTTACCCTGCAAGCTGCTGTGAGAGGGTCAGAGCCCATTTCTGTCACATGGATGAAAGGTCAAGAGGTCATCAGAGAAGACGGAAAAATCAAAATGAGCTTTTCCAATGGTGTTGCAGTCTTGATAATCCCTGATGTTCAGATTAGTTTTGGAGGCAAATACACGTGCCTGGCTGAAAATGAAGCTGGAAGCCAAACATCTGTTGGGGAATTAATAGTTAAAG
>TTN-208,ENSE00003801788,1,279,1698772,1699050,AACCTGCCAAAATCATTGAGCGAGCAGAACTGATCCAGGTGACAGCAGGAGATCCCGCCACACTGGAGTACACAGTGGCAGGCACGCCAGAACTGAAGCCCAAATGGTACAAAGATGGGAGACCCTTGGTCGCCAGTAAAAAATACCGAATAAGTTTTAAAAACAATGTTGCCCAGCTCAAATTTTATTCAGCTGAGCTGCACGACAGTGGCCAATACACATTTGAGATTTCCAATGAAGTGGGCAGCAGCTCCTGTGAGACTACATTCACTGTATTAG
>TTN-208,ENSE00003804186,1,288,1699051,1699338,ATCGAGACATTGCTCCATTTTTTACCAAACCCTTGCGCAACGTGGATAGTGTTGTTAATGGTACCTGCAGACTGGACTGCAAAATTGCAGGCTCCCTCCCCATGAGGGTGTCCTGGTTTAAGGATGGCAAAGAAATAGCTGCTTCTGACAGATACAGGATAGCATTTGTGGAAGGCACAGCCTCTTTGGAGATCATCAGAGTAGACATGAATGATGCAGGGAATTTCACTTGTCGAGCCACAAATTCCGTGGGAAGCAAAGACAGCAGTGGAGCCCTGATTGTGCAAG
>TTN-208,ENSE00003805178,1,279,1699339,1699617,AACCACCCAGTTTTGTAACTAAACCCGGCTCAAAGGATGTTCTGCCTGGCTCAGCAGTCTGCCTGAAGAGCACTTTCCAAGGATCTACTCCTCTCACAATCAGATGGTTTAAGGGCAACAAAGAGCTGGTTTCTGGTGGAAGCTGCTATATTACCAAAGAAGCTTTAGAGAGTTCCCTGGAACTCTATTTAGTAAAAACCTCTGATTCGGGCACGTACACATGTAAAGTCAGCAATGTCGCTGGAGGGGTGGAATGCAGTGCAAACTTGTTTGTAAAAG
>TTN-208,ENSE00003806856,1,282,1699618,1699899,AACCTGCCACATTTGTTGAAAAGTTAGAGCCATCACAGCTGTTAAAGAAGGGAGATGCCACCCAGCTAGCCTGCAAAGTAACTGGTACCCCTCCAATTAAAATAACATGGTTTGCAAATGATAGAGAAATTAAGGAGAGCAGCAAACACAGAATGTCTTTTGTGGAGTCTACTGCAGTTCTAAGACTGACAGATGTTGGCATCGAAGACAGTGGTGAATATATGTGTGAGGCCCAAAATGAGGCTGGCAGTGACCACTGCAGTAGCATTGTAATAGTCAAAG
>TTN-208,ENSE00003804074,1,279,1699900,1700178,AGTCACCTTATTTTACCAAGGAATTTAAGCCAATTGAAGTCTTAAAGGAGTACGATGTCATGTTGCTGGCTGAGGTGGCAGGCACTCCTCCCTTTGAGATCACTTGGTTCAAAGATAACACAATCCTGCGAAGTGGTAGAAAGTATAAGACTTTCATTCAGGATCATCTGGTTAGCCTGCAGATCCTCAAGTTTGTAGCTGCAGATGCTGGCGAATACCAGTGTCGGGTGACCAATGAGGTGGGCAGCAGCATCTGCAGTGCCAGGGTGACTTTAAGAG
>TTN-208,ENSE00003807057,1,279,1700179,1700457,AACCCCCATCCTTCATAAAGAAGATCGAGAGTACCAGCTCCCTCCGGGGAGGCACAGCTGCCTTCCAGGCCACTCTGAAGGGCTCCTTGCCAATTACGGTGACTTGGCTAAAAGACAGCGATGAAATCACTGAAGACGATAATATAAGAATGACCTTTGAGAACAATGTGGCCAGTTTGTACCTCAGTGGCATTGAAGTCAAGCATGATGGGAAATATGTCTGTCAGGCCAAAAATGATGCAGGAATACAAAGATGTTCTGCATTACTCTCAGTAAAAG
>TTN-208,ENSE00003807032,1,279,1700458,1700736,AACCTGCAACAATCACCGAGGAAGCTGTGTCTATAGATGTCACCCAAGGAGACCCAGCCACTTTGCAGGTTAAATTTTCAGGGACTAAGGAGATTACAGCCAAATGGTTTAAAGATGGCCAAGAACTGACCCTGGGCTCAAAATATAAAATCAGTGTCACTGATACAGTCTCAATACTGAAGATTATTTCTACAGAAAAGAAAGATAGTGGAGAATATACTTTCGAGGTCCAAAATGATGTTGGGAGGAGCAGCTGCAAGGCTAGAATTAATGTATTAG
>TTN-208,ENSE00003810010,1,288,1700737,1701024,ATCTTATCATACCTCCTTCATTCACCAAAAAGCTGAAGAAAATGGACAGCATTAAAGGTTCTTTCATTGATTTAGAATGTATAGTGGCTGGGTCACATCCCATAAGCATCCAGTGGTTCAAAGATGACCAAGAAATATCAGCTAGTGAAAAGTACAAATTCTCTTTTCATGACAATACTGCCTTCTTGGAAATCAGCCAGCTGGAAGGTACAGACAGTGGGACATACACTTGTTCTGCCACAAATAAGGCAGGGCACAACCAATGCAGTGGGCATCTGACAGTCAAAG
>TTN-208,ENSE00003805733,1,279,1701025,1701303,AACCCCCTTACTTTGTGGAAAAGCCACAGTCACAAGATGTCAATCCCAACACAAGGGTACAGTTAAAGGCTCTTGTGGGTGGCACTGCACCCATGACAATAAAGTGGTTTAAAGATAACAAAGAGTTACACTCAGGAGCAGCCCGCTCAGTTTGGAAGGATGACACCTCTACCAGTCTAGAGCTCTTTGCAGCCAAAGCTACCGATTCTGGAACCTACATTTGCCAACTAAGCAATGATGTTGGCACAGCAACCAGCAAAGCCACTCTCTTTGTAAAAG
>TTN-208,ENSE00003805836,1,282,1701304,1701585,AACCTCCTCAATTCATTAAGAAGCCCAGTCCAGTCTTAGTGCTGAGGAATGGACAGTCAACAACATTTGAATGCCAAATAACAGGCACTCCTAAAATCCGAGTGTCTTGGTATCTAGACGGGAATGAAATAACAGCCATTCAGAAACATGGCATTTCCTTCATTGATGGTTTAGCCACTTTCCAGATTTCTGGTGCCAGGGTAGAAAATAGTGGGACTTATGTGTGTGAAGCTCGAAATGACGCAGGCACGGCGAGCTGCAGCATTGAACTCAAAGTGAAAG
>TTN-208,ENSE00003802637,1,279,1701586,1701864,AACCCCCCACCTTTATCAGAGAGCTGAAGCCTGTGGAGGTAGTAAAATATAGTGACGTGGAGCTGGAGTGTGAAGTTACGGGAACACCTCCGTTTGAAGTCACTTGGCTGAAGAATAACAGGGAAATTCGAAGCAGCAAAAAATACACATTGACCGACAGAGTGTCTGTGTTTAACCTCCATATAACCAAGTGTGACCCTTCAGACACTGGGGAATACCAGTGCATTGTATCCAATGAAGGCGGCAGCTGCTCATGCAGTACTAGAGTTGCCCTGAAAG
>TTN-208,ENSE00003809504,1,279,1701865,1702143,AACCACCATCATTCATTAAGAAGATAGAAAATACCACTACTGTTTTGAAAAGTTCTGCCACCTTTCAGAGTACCGTGGCAGGTTCTCCTCCTATTTCTATAACCTGGCTAAAGGATGATCAGATTCTTGATGAAGATGATAATGTCTATATTTCATTTGTGGACAGTGTGGCCACACTTCAAATCAGAAGTGTGGATAATGGACACAGTGGGAGATATACCTGTCAAGCCAAGAATGAGTCAGGAGTTGAGAGGTGTTATGCTTTCCTTTTAGTACAAG
>TTN-208,ENSE00003802968,1,279,1702144,1702422,AACCAGCTCAAATCGTAGAGAAAGCTAAATCAGTTGATGTTACGGAGAAAGATCCCATGACCTTGGAATGTGTTGTGGCTGGAACACCAGAACTCAAAGTGAAATGGCTTAAAGACGGGAAACAAATAGTTCCCAGTAGATACTTTTCAATGAGTTTTGAAAATAACGTGGCCAGTTTTAGAATTCAGTCAGTAATGAAGCAGGACAGCGGTCAGTACACTTTCAAGGTGGAAAATGACTTCGGAAGCAGTAGCTGTGATGCCTACTTAAGAGTGCTAG
>TTN-208,ENSE00003810612,1,288,1702423,1702710,ATCAAAATATTCCTCCATCATTCACCAAAAAATTAACCAAAATGGATAAAGTTCTGGGCTCTTCTATTCATATGGAGTGCAAGGTGTCTGGTTCACTTCCCATTAGTGCTCAGTGGTTTAAGGATGGAAAAGAAATATCTACAAGTGCAAAATACAGACTTGTGTGCCATGAGAGATCTGTGTCTCTGGAAGTTAATAATCTGGAATTAGAAGATACTGCAAATTACACATGCAAAGTGTCAAATGTAGCAGGAGATGATGCATGCAGTGGCATCTTAACTGTGAAAG
>TTN-208,ENSE00003806423,1,279,1702711,1702989,AACCACCAAGCTTCCTAGTGAAACCTGGGCGACAGCAAGCCATACCTGATTCTACAGTGGAATTTAAGGCAATACTAAAAGGAACACCACCATTTAAAATAAAATGGTTTAAGGATGATGTGGAACTTGTCTCAGGTCCTAAATGTTTCATTGGCTTGGAAGGGTCGACTAGCTTCTTAAATCTCTACTCAGTGGATGCTTCTAAGACTGGACAGTATACTTGCCATGTTACCAATGATGTTGGTAGCGACTCTTGTACTACGATGTTGCTTGTGACAG
>TTN-208,ENSE00003805536,1,282,1702990,1703271,AACCACCAAAGTTTGTAAAGAAATTAGAAGCCTCCAAAATTGTGAAAGCAGGTGACTCTTCACGACTTGAATGCAAGATAGCTGGATCCCCAGAAATCAGAGTTGTGTGGTTCCGAAATGAACATGAACTTCCAGCCAGTGATAAGTACAGAATGACTTTCATTGACTCAGTGGCCGTCATACAGATGAACAATCTCAGTACTGAGGACAGTGGAGATTTCATTTGTGAGGCTCAGAATCCCGCTGGCAGCACAAGCTGCAGTACCAAGGTTATAGTAAAAG
>TTN-208,ENSE00003807762,1,279,1703272,1703550,AGCCACCTGTTTTTAGCAGCTTCCCTCCTATAGTAGAAACCCTTAAAAATGCTGAAGTCAGTCTTGAATGTGAACTTTCGGGAACACCACCGTTTGAGGTGGTATGGTACAAAGACAAGCGGCAACTCAGAAGCAGCAAGAAATACAAGATTGCATCCAAAAACTTCCACACAAGTATTCACATTCTCAATGTGGACACTTCAGACATCGGTGAATACCACTGCAAAGCACAGAATGAAGTGGGAAGTGATACTTGTGTTTGTACTGTAAAATTGAAAG
>TTN-208,ENSE00003809887,1,282,1703551,1703832,AACCACCAAGATTTGTCTCCAAACTGAACAGCCTCACTGTTGTAGCCGGAGAGCCTGCTGAATTACAAGCATCCATAGAAGGCGCCCAGCCTATTTTTGTCCAGTGGCTTAAAGAGAAGGAAGAAGTGATTAGAGAAAGTGAAAACATCAGGATTACATTTGTGGAAAATGTTGCAACTCTACAGTTTGCAAAAGCAGAGCCAGCTAATGCTGGAAAGTATATCTGCCAAATCAAGAATGATGGTGGAATGAGGGAGAACATGGCCACACTGATGGTCTTAG
>TTN-208,ENSE00003811356,1,279,1703833,1704111,AGCCCGCAGTCATTGTTGAGAAGGCAGGACCGATGACGGTGACTGTAGGAGAAACGTGCACTCTGGAGTGTAAGGTGGCTGGCACTCCGGAACTCTCTGTTGAATGGTACAAGGATGGAAAGCTGTTGACCAGCAGCCAAAAACACAAATTTAGCTTCTACAACAAAATCTCTTCCTTAAGGATTCTCTCAGTTGAAAGGCAAGATGCAGGCACATACACTTTCCAGGTTCAAAATAATGTTGGGAAAAGCAGCTGCACAGCTGTGGTTGATGTTTCAG
>TTN-208,ENSE00003804298,1,288,1704112,1704399,ACCGAGCAGTTCCTCCCTCTTTCACACGAAGACTGAAAAATACTGGTGGGGTGTTAGGTGCTTCTTGCATCTTGGAATGCAAAGTAGCTGGATCATCACCTATTTCAGTTGCCTGGTTTCATGAGAAAACCAAGATTGTCAGTGGAGCAAAGTACCAAACCACATTTTCAGATAATGTCTGCACATTGCAGTTGAATTCTCTGGATTCCTCAGATATGGGCAATTACACATGCGTGGCTGCTAATGTCGCTGGGTCTGATGAATGTCGTGCAGTGCTAACTGTACAAG
>TTN-208,ENSE00003807700,1,279,1704400,1704678,AACCACCCTCTTTTGTGAAAGAACCTGAACCTTTGGAAGTACTACCAGGCAAAAATGTAACCTTCACAAGCGTTATTAGAGGAACCCCTCCATTCAAAGTCAACTGGTTCAGAGGTGCCAGAGAACTAGTGAAAGGAGACCGGTGCAACATCTATTTTGAAGACACTGTGGCAGAACTGGAATTATTTAATATTGACATATCTCAGAGTGGGGAATACACCTGTGTGGTTTCTAACAACGCTGGCCAAGCATCTTGCACTACCCGTCTCTTTGTGAAAG
>TTN-208,ENSE00003803086,1,279,1704679,1704957,AACCAGCTGCATTTTTGAAGAGATTAAGTGATCATTCTGTAGAACCAGGGAAGTCCATAATTCTGGAGAGCACCTACACTGGAACACTTCCAATTTCTGTCACTTGGAAAAAGGATGGTTTTAACATAACTACCTCTGAAAAATGTAACATAGTCACAACAGAGAAAACTTGTATCCTGGAAATTCTGAATAGCACAAAAAGAGATGCAGGGCAGTATTCCTGCGAGATTGAAAATGAGGCAGGAAGGGATGTTTGTGGAGCTCTGGTATCTACATTAG
>TTN-208,ENSE00003806655,1,279,1704958,1705236,AACCGCCTTATTTTGTTACGGAACTGGAACCTCTGGAGGCAGCAGTTGGAGATTCGGTTTCTTTACAATGCCAAGTTGCTGGGACACCAGAAATTACAGTGTCTTGGTACAAAGGAGATACCAAATTACGGCCAACTCCTGAATACAGGACCTACTTTACAAACAATGTGGCCACACTTGTTTTTAATAAAGTGAACATCAATGACAGTGGAGAGTACACATGCAAAGCAGAAAATAGTATAGGAACTGCTTCTTCTAAGACTGTGTTCAGAATTCAAG
>TTN-208,ENSE00003805355,1,288,1705237,1705524,AGCGCCAACTCCCACCTTCTTTTGCAAGACAATTAAAGGACATTGAACAAACTGTGGGGTTACCTGTTACACTCACTTGTCGATTAAATGGCTCTGCACCCATCCAAGTGTGCTGGTATAGAGATGGAGTACTTTTAAGAGACGATGAAAATCTACAGACTTCATTTGTAGATAATGTGGCAACTTTAAAAATTTTGCAAACTGACTTGAGTCACTCTGGCCAGTACTCTTGCTCAGCTTCCAACCCACTTGGAACAGCATCTTCTAGTGCTAGACTCACAGCAAGAG
>TTN-208,ENSE00003804884,1,288,1705525,1705812,AACCCAAGAAATCTCCCTTCTTTGACATCAAGCCTGTATCTATAGATGTTATTGCTGGAGAAAGTGCTGATTTTGAGTGTCATGTTACTGGTGCTCAACCGATGCGAATCACTTGGTCAAAAGATAACAAGGAGATCCGTCCTGGAGGAAACTATACAATCACATGTGTGGGAAACACTCCTCATTTGAGAATTCTTAAAGTAGGCAAAGGAGACTCTGGTCAATATACTTGCCAAGCAACCAATGATGTTGGCAAAGACATGTGCTCAGCTCAGCTCAGTGTAAAAG
>TTN-208,ENSE00003805805,1,282,1705813,1706094,AACCTCCAAAGTTTGTTAAGAAATTAGAAGCTTCAAAAGTTGCAAAGCAGGGAGAATCCATTCAACTGGAATGTAAAATAAGTGGCTCCCCAGAAATCAAAGTTTCATGGTTCCGAAATGACAGCGAACTTCATGAAAGTTGGAAATACAACATGTCATTCATTAATTCTGTGGCATTGCTTACGATCAATGAAGCTAGTGCTGAAGACAGCGGGGACTACATTTGTGAGGCTCATAATGGTGTTGGTGACGCCAGCTGCAGCACAGCGTTGACAGTGAAAG
>TTN-208,ENSE00003803146,1,279,1706095,1706373,CACCTCCTGTTTTCACCCAGAAGCCTTCTCCAGTAGGAGCTCTTAAAGGTTCTGATGTGATTCTCCAATGTGAAATTTCGGGAACTCCCCCATTTGAAGTAGTATGGGTTAAAGATCGAAAGCAGGTTAGAAACAGCAAGAAATTTAAAATCACTTCAAAACATTTTGATACAAGTCTTCATATCCTTAATCTTGAAGCCTCCGATGTCGGGGAATATCACTGCAAAGCTACTAATGAGGTGGGAAGTGACACGTGTTCTTGCTCTGTCAAGTTCAAAG
>TTN-208,ENSE00003806016,1,282,1706374,1706655,AACCTCCACGATTCGTGAAAAAGCTAAGTGACACCTCAACCCTTATTGGGGATGCTGTTGAGTTACGGGCCATAGTGGAGGGCTTCCAGCCAATTTCTGTTGTCTGGCTGAAAGATAGAGGTGAAGTCATCAGAGAGAGTGAAAATACCAGGATTTCATTCATTGATAACATTGCAACCCTCCAGCTGGGGAGTCCAGAAGCATCTAATTCTGGAAAATATATATGCCAAATCAAAAACGATGCTGGAATGAGAGAATGCTCTGCAGTCTTGACTGTACTAG
>TTN-208,ENSE00003808302,1,279,1706656,1706934,AACCAGCAAGAATCATAGAGAAGCCCGAACCCATGACTGTCACTACTGGAAATCCTTTTGCATTAGAGTGTGTAGTGACTGGAACACCAGAACTCTCAGCCAAGTGGTTCAAAGATGGAAGAGAATTGTCTGCAGACAGCAAACATCACATTACATTCATCAATAAAGTGGCTTCCCTTAAAATCCCCTGTGCCGAAATGAGTGACAAAGGATTATATAGCTTTGAAGTGAAAAACAGTGTTGGCAAAAGTAACTGCACTGTATCCGTCCATGTTTCTG
>TTN-208,ENSE00003802442,1,288,1706935,1707222,ATCGGATTGTGCCTCCTTCCTTCATCCGCAAGCTGAAAGACGTGAATGCCATCCTGGGGGCCTCAGTTGTTTTGGAGTGCCGAGTCTCTGGCTCAGCCCCGATTTCAGTTGGCTGGTTTCAGGATGGAAATGAGATTGTTAGTGGGCCCAAATGTCAGTCCAGCTTTTCGGAAAACGTCTGTACTTTGAATCTGAGCTTGTTGGAGCCCTCCGACACAGGCATATACACGTGTGTGGCTGCCAATGTAGCTGGTTCCGATGAGTGCTCAGCAGTCCTGACTGTGCAAG
>TTN-208,ENSE00003809965,1,279,1707223,1707501,AACCACCATCTTTTGAACAAACCCCTGATTCTGTGGAAGTTTTGCCTGGAATGAGCCTCACATTCACCAGTGTCATCAGAGGCACCCCTCCTTTCAAGGTCAAGTGGTTTAAAGGCAGCAGGGAACTGGTGCCTGGGGAGTCATGCAACATCTCTCTGGAAGATTTTGTCACAGAACTGGAGTTGTTTGAGGTGCAGCCATTAGAAAGTGGAGACTATTCTTGCCTCGTTACAAATGATGCTGGCAGTGCTTCCTGTACCACACATCTTTTTGTGAAAG
>TTN-208,ENSE00003809650,1,279,1707502,1707780,AACCAGCCACCTTTGTGAAAAGATTGGCTGATTTCAGTGTTGAGACAGGAAGCCCCATAGTTCTCGAGGCCACATACACTGGCACACCTCCAATCTCAGTGAGCTGGATAAAGGACGAGTATCTTATTTCACAATCTGAGAGATGCAGTATTACTATGACAGAAAAATCTACCATACTGGAAATTCTTGAGAGCACAATAGAGGATTATGCACAGTACAGCTGCCTGATAGAAAATGAGGCTGGTCAAGATATCTGTGAAGCTCTGGTGTCTGTCTTAG
>TTN-208,ENSE00003810498,1,279,1707781,1708059,AACCACCGTACTTTATTGAACCTCTGGAACATGTGGAAGCAGTCATTGGAGAACCTGCAACTTTACAGTGTAAAGTGGATGGAACTCCAGAAATTAGAATTTCTTGGTATAAAGAACACACAAAGCTACGATCAGCTCCTGCATATAAAATGCAATTCAAAAATAACGTTGCTTCCTTAGTAATCAACAAAGTGGATCACAGTGATGTGGGAGAGTATTCATGCAAGGCAGACAACAGTGTGGGGGCAGTCGCTTCTTCAGCTGTGCTTGTTATCAAAG
>TTN-208,ENSE00003807178,1,288,1708060,1708347,CGCGCAAACTTCCACCTTTCTTTGCAAGAAAACTGAAAGACGTTCATGAGACTCTAGGCTTCCCAGTTGCATTTGAATGCCGCATCAATGGCTCAGAACCTCTTCAAGTGTCTTGGTACAAGGATGGGGTTCTTTTGAAAGATGATGCTAATTTGCAGACATCTTTTGTTCATAATGTAGCAACTCTTCAGATTTTACAAACTGACCAGAGCCACATAGGGCAGTATAATTGCTCTGCTTCTAATCCTCTTGGGACTGCTTCATCCAGTGCCAAGCTCATTCTCTCAG
>TTN-208,ENSE00003808579,1,288,1708348,1708635,AGCATGAAGTGCCTCCTTTCTTTGATCTAAAGCCTGTATCAGTAGATCTTGCTCTTGGAGAAAGTGGTACTTTTAAATGTCATGTAACTGGGACTGCACCAATCAAAATCACTTGGGCCAAAGATAACCGAGAGATTCGCCCTGGAGGCAACTACAAGATGACTTTGGTAGAAAATACTGCCACTCTGACAGTTCTCAAAGTAGGCAAAGGCGATGCCGGGCAGTACACCTGCTATGCAAGCAACATCGCTGGAAAAGACTCTTGTTCTGCTCAGCTGGGTGTACAAG
>TTN-208,ENSE00003801249,1,282,1708636,1708917,AACCACCCAGGTTCATTAAGAAGCTAGAACCTTCAAGAATTGTGAAACAGGATGAATTCACAAGGTATGAATGCAAAATCGGTGGGTCTCCAGAAATCAAAGTTTTATGGTATAAGGACGAGACTGAAATTCAAGAGAGCAGTAAATTCAGAATGTCATTCGTTGACTCGGTGGCTGTGCTGGAAATGCACAATCTCAGTGTTGAAGACAGTGGAGACTACACCTGTGAGGCCCACAATGCAGCAGGCAGTGCCAGCAGCAGCACATCCTTAAAAGTTAAAG
>TTN-208,ENSE00003810208,1,279,1708918,1709196,AACCACCCATTTTCCGCAAAAAGCCTCATCCTATAGAGACACTGAAAGGAGCTGATGTTCACCTTGAATGTGAGCTTCAGGGCACTCCCCCATTTCACGTTTCTTGGTATAAAGACAAGAGAGAACTTAGGAGCGGCAAGAAGTACAAGATAATGTCTGAGAACTTCCTAACCAGTATCCACATCCTGAATGTCGATGCTGCAGACATTGGGGAATATCAGTGTAAAGCCACAAATGATGTGGGAAGCGACACTTGCGTTGGTTCCATCGCTCTCAAAG
>TTN-208,ENSE00003802440,1,282,1709197,1709478,CACCACCAAGATTTGTGAAGAAGCTCAGTGACATATCTACTGTCGTTGGTAAAGAAGTTCAGCTGCAGACTACCATTGAAGGCGCTGAACCCATTTCAGTGGTGTGGTTCAAAGATAAGGGAGAAATCGTTAGAGAAAGTGACAACATATGGATTTCTTATTCAGAAAACATTGCAACCTTACAGTTTTCAAGAGTGGAACCAGCCAATGCTGGAAAATACACTTGTCAGATCAAAAACGATGCTGGGATGCAAGAGTGCTTCGCCACGCTATCCGTTCTCG
>TTN-208,ENSE00003802351,1,279,1709479,1709757,AGCCTGCAACAATTGTAGAAAAGCCAGAATCCATAAAAGTTACCACGGGAGACACCTGTACCTTGGAGTGTACAGTAGCTGGCACCCCTGAACTCAGTACTAAGTGGTTTAAGGATGGAAAAGAGCTAACAAGTGACAACAAATACAAAATAAGCTTCTTCAACAAAGTATCCGGCCTTAAGATCATCAATGTAGCACCGAGTGACAGTGGGGTATACAGTTTTGAGGTGCAGAACCCTGTTGGCAAAGACAGCTGCACAGCTTCATTGCAGGTTTCAG
>TTN-208,ENSE00003807933,1,288,1709758,1710045,ACCGAACCGTTCCTCCTTCATTCACAAGAAAATTGAAAGAGACAAATGGTCTATCCGGCTCCTCAGTTGTAATGGAGTGTAAAGTCTATGGGTCACCTCCAATCTCTGTCTCCTGGTTCCATGAAGGAAATGAGATCAGTAGTGGAAGGAAATACCAGACCACCCTGACAGATAATACTTGTGCTTTAACTGTGAACATGCTGGAAGAATCAGACAGTGGTGACTACACATGTATAGCTACTAATATGGCTGGTTCTGATGAATGTAGTGCTCCTTTGACTGTGAGAG
>TTN-208,ENSE00003804939,1,279,1710046,1710324,AACCACCATCTTTTGTTCAGAAACCTGATCCCATGGATGTTTTAACTGGGACCAATGTAACTTTCACAAGTATCGTAAAAGGAACACCTCCTTTCAGTGTTAGCTGGTTCAAAGGTAGCAGTGAACTAGTACCAGGTGACAGATGCAACGTGTCTTTGGAGGATTCAGTTGCTGAACTGGAGTTGTTCGATGTAGATACATCACAAAGTGGAGAATATACTTGCATAGTTAGCAATGAAGCTGGCAAGGCTTCTTGTACAACACATCTCTACATAAAAG
>TTN-208,ENSE00003810094,1,279,1710325,1710603,CCCCAGCCAAATTTGTGAAGAGGCTGAATGATTACAGCATAGAGAAAGGAAAACCCCTGATCCTAGAGGGTACATTCACTGGAACTCCTCCCATTTCGGTTACCTGGAAGAAAAATGGCATAAATGTAACTCCTTCTCAGAGGTGTAATATAACTACGACTGAAAAATCGGCAATCCTGGAAATTCCAAGTAGCACAGTAGAGGATGCAGGACAATACAACTGCTACATTGAAAATGCCTCTGGAAAAGATTCCTGTTCAGCACAAATACTCATACTAG
>TTN-208,ENSE00003811103,1,279,1710604,1710882,AACCACCGTATTTTGTCAAGCAGTTGGAGCCGGTTAAGGTGTCTGTTGGAGATTCTGCCTCTCTACAATGCCAGCTTGCTGGAACCCCTGAAATTGGGGTATCCTGGTATAAAGGAGATACAAAATTGAGACCCACTACGACTTACAAAATGCATTTTAGGAATAATGTTGCTACACTGGTTTTCAACCAGGTTGATATTAATGATAGTGGAGAATATATCTGCAAAGCTGAAAACAGCGTGGGAGAAGTTTCTGCATCAACTTTCCTTACCGTTCAAG
>TTN-208,ENSE00003801476,1,288,1710883,1711170,AGCAAAAACTTCCACCATCATTTTCTCGACAATTGAGAGATGTTCAAGAAACAGTTGGACTGCCAGTTGTTTTTGATTGTGCCATAAGTGGATCAGAACCTATCTCCGTGTCTTGGTATAAAGACGGCAAGCCATTGAAAGACAGCCCAAATGTACAAACATCATTTTTAGACAATACAGCCACACTCAATATTTTTAAAACTGACCGGAGCCTTGCAGGCCAGTATTCCTGCACAGCTACAAACCCTATAGGCTCTGCTTCTTCCAGTGCCAGGCTCATTCTCACAG
>TTN-208,ENSE00003808430,1,288,1711171,1711458,AGGGGAAGAACCCACCCTTCTTTGACATCCGTCTTGCCCCTGTGGATGCTGTGGTGGGAGAAAGTGCTGACTTTGAGTGCCACGTCACGGGCACACAACCGATAAAGGTCAGCTGGGCCAAAGACAGCAGAGAAATACGAAGTGGCGGAAAGTACCAGATTAGTTATCTGGAAAACAGCGCCCACCTGACAGTCCTCAAAGTAGACAAAGGAGATTCTGGACAATATACCTGCTATGCTGTGAATGAAGTGGGAAAAGACTCTTGCACAGCTCAGCTGAATATAAAAG
>TTN-208,ENSE00003809007,1,291,1711459,1711749,AGCGGCTCATCCCACCAAGTTTCACTAAAAGACTCTCAGAGACAGTAGAAGAAACAGAAGGGAATTCTTTCAAACTTGAGGGACGTGTGGCTGGTTCCCAACCTATAACTGTTGCCTGGTACAAAAATAATATAGAGATACAACCAACTTCTAACTGTGAAATAACATTCAAGAACAACACGTTAGTGCTGCAAGTCAGGAAAGCAGGCATGAACGACGCTGGTTTGTACACATGCAAAGTGTCCAATGATGCAGGCTCTGCTCTGTGCACGTCTTCAATCGTCATCAAAG
>TTN-208,ENSE00003803910,1,288,1711750,1712037,AACCTAAGAAGCCACCTGTATTTGATCAGCACCTTACTCCAGTAACAGTGAGTGAAGGAGAATACGTGCAGCTCAGCTGCCATGTCCAGGGATCTGAGCCAATTAGGATCCAGTGGTTGAAGGCTGGCAGGGAAATAAAGCCTTCAGACAGATGCAGCTTCAGCTTTGCTAGTGGGACAGCTGTACTGGAACTCAGAGATGTGGCTAAAGCAGATTCGGGAGATTATGTGTGTAAAGCTTCAAATGTGGCTGGAAGTGACACTACCAAATCAAAAGTGACCATTAAAG
>TTN-208,ENSE00003804245,1,93,1712038,1712130,ACAAACCAGCTGTGGCCCCAGCAACCAAGAAAGCTGCGGTAGATGGAAGACTCTTTTTTGTGTCAGAACCTCAGAGTATCAGAGTCGTAGAAA
>TTN-208,ENSE00003801649,1,286,1712131,1712416,AAACCACTGCGACCTTCATTGCAAAAGTTGGAGGTGACCCAATCCCAAATGTTAAATGGACAAAAGGGAAGTGGAGACAGCTGAACCAAGGAGGTCGTGTTTTCATCCACCAAAAAGGCGATGAAGCAAAACTGGAGATTAGGGACACCACAAAAACTGATTCTGGGTTATACCGATGCGTGGCATTTAACGAACATGGTGAAATTGAAAGTAATGTTAACTTACAGGTGGATGAAAGGAAGAAACAAGAGAAAATTGAAGGCGATCTTAGAGCAATGCTGAAAAA
>TTN-208,ENSE00003805371,1,184,1712417,1712600,GACTCCAATCTTAAAGAAAGGAGCTGGAGAAGAAGAGGAAATTGATATCATGGAACTTCTCAAAAATGTTGATCCTAAAGAATATGAAAAATATGCCCGCATGTATGGAATCACTGACTTCCGAGGTCTTCTTCAAGCATTTGAACTGCTCAAGCAAAGCCAAGAAGAAGAGACACATAGACTG
>TTN-208,ENSE00003802112,1,90,1712601,1712690,GAAATTGAGGAAATAGAGAGGTCAGAGAGGGACGAAAAGGAATTTGAGGAACTTGTATCATTTATTCAGCAAAGACTGTCACAGACAGAG
>TTN-208,ENSE00003810323,1,268,1712691,1712958,CCTGTCACTCTGATCAAGGACATTGAAAATCAGACAGTTTTGAAAGATAATGATGCTGTCTTTGAAATTGACATTAAAATTAATTATCCAGAAATCAAGCTTTCGTGGTACAAAGGAACTGAAAAACTGGAACCCAGTGATAAATTTGAAATAAGCATTGATGGTGACCGACATACACTCAGAGTCAAAAACTGTCAACTTAAAGACCAGGGCAATTATCGATTGGTTTGTGGTCCACACATCGCTAGCGCTAAACTAACTGTAATTG
>TTN-208,ENSE00003810781,1,261,1712959,1713219,AGCCTGCATGGGAACGGCATCTTCAGGATGTGACTCTGAAAGAAGGCCAGACTTGCACCATGACATGCCAATTTTCTGTACCAAATGTAAAATCTGAATGGTTCAGAAATGGCAGAATCCTTAAACCCCAAGGTAGACATAAAACAGAAGTGGAACACAAAGTCCATAAATTGACCATTGCAGATGTTCGAGCAGAAGACCAGGGTCAGTACACCTGCAAATATGAAGACCTTGAAACTTCAGCAGAACTCAGAATCGAAG
>TTN-208,ENSE00003805599,1,210,1713220,1713429,CTGAACCAATTCAGTTTACAAAGCGCATACAGAACATCGTGGTGAGTGAGCATCAGTCTGCCACCTTTGAGTGTGAAGTGTCCTTTGATGATGCCATTGTAACATGGTACAAAGGACCAACAGAACTGACAGAGAGCCAGAAATACAACTTCAGGAATGATGGCCGCTGCCATTATATGACCATCCACAATGTGACCCCAGACGATGAAG
>TTN-208,ENSE00003809461,1,78,1713430,1713507,GTGTCTACTCGGTCATCGCTCGGCTGGAGCCAAGAGGTGAAGCAAGAAGCACGGCAGAGCTGTACCTAACGACGAAAG
>TTN-208,ENSE00003805821,1,27,1713508,1713534,AAATCAAACTTGAGCTGAAGCCTCCTG
>TTN-208,ENSE00003803485,1,60,1713535,1713594,ATATTCCTGACTCCAGAGTTCCAATCCCAACCATGCCTATCAGAGCAGTGCCACCAGAAG
>TTN-208,ENSE00003803812,1,84,1713595,1713678,AAATCCCTCCTGTGGTTGCTCCTCCTATCCCCCTTTTGCTACCAACACCCGAAGAAAAGAAACCACCACCAAAACGTATTGAAG
>TTN-208,ENSE00003804844,1,72,1713679,1713750,TTACCAAAAAGGCTGTGAAGAAAGATGCCAAAAAAGTTGTTGCAAAGCCCAAAGAGATGACACCACGTGAAG
>TTN-208,ENSE00003810688,1,48,1713751,1713798,AGATTGTCAAGAAGCCTCCACCTCCTACTACCTTAATTCCAGCAAAAG
>TTN-208,ENSE00003806388,1,405,1713799,1714203,CTCCTGAAATCATTGATGTATCCTCTAAAGCTGAAGAAGTAAAAATAATGACTATAACCAGAAAGAAAGAGGTTCAGAAAGAAAAAGAAGCTGTGTATGAGAAAAAGCAAGCAGTCCACAAGGAGAAGAGAGTCTTCATTGAATCTTTCGAAGAACCTTATGACGAACTGGAGGTAGAACCATACACAGAGCCATTTGAACAACCTTATTATGAAGAACCAGATGAAGACTATGAAGAGATTAAGGTAGAAGCTAAAAAAGAAGTTCACGAGGAATGGGAAGAAGATTTTGAAGAAGGGCAAGAATACTATGAAAGGGAAGAAGGCTATGACGAAGGGGAGGAAGAGTGGGAAGAGGCTTACCAAGAAAGGGAAGTAATTCAAGTTCAAAAGGAGGTCTATGAAG
>TTN-208,ENSE00003803093,1,63,1714204,1714266,AATCACATGAGAGAAAAGTTCCAGCCAAAGTACCTGAAAAGAAAGCACCACCACCTCCTAAAG
>TTN-208,ENSE00003802009,1,78,1714267,1714344,TTATAAAGAAGCCAGTAATTGAAAAAATTGAAAAGACTTCTCGAAGAATGGAGGAAGAAAAAGTTCAAGTCACCAAAG
>TTN-208,ENSE00003806356,1,78,1714345,1714422,TACCTGAAGTTTCAAAGAAGATTGTTCCACAAAAACCTTCCCGGACTCCAGTACAGGAAGAAGTTATTGAAGTGAAAG
>TTN-208,ENSE00003803112,1,87,1714423,1714509,TACCAGCTGTGCATACAAAGAAGATGGTTATTTCAGAAGAAAAGATGTTCTTTGCTTCTCACACAGAGGAGGAGGTGTCAGTCACAG
>TTN-208,ENSE00003811115,1,81,1714510,1714590,TCCCCGAGGTACAAAAGGAAATTGTTACTGAAGAGAAAATTCACGTTGCCATTTCCAAAAGGGTTGAACCACCACCTAAAG
>TTN-208,ENSE00003810048,1,84,1714591,1714674,TCCCTGAGCTACCTGAGAAACCAGCTCCAGAAGAAGTGGCCCCTGTTCCTATCCCTAAAAAAGTGGAGCCCCCAGCACCAAAAG
>TTN-208,ENSE00003809302,1,84,1714675,1714758,TTCCTGAGGTTCCCAAGAAACCCGTGCCAGAGGAGAAAAAGCCAGTTCCTGTGCCTAAGAAGGAACCTGCTGCTCCCCCAAAAG
>TTN-208,ENSE00003811271,1,84,1714759,1714842,TCCCAGAGGTGCCAAAGAAACCTGTCCCTGAAGAAAAGATTCCCGTTCCTGTTGCAAAGAAAAAGGAAGCTCCCCCAGCTAAAG
>TTN-208,ENSE00003811169,1,81,1714843,1714923,TTCCTGAAGTACAGAAGGGAGTTGTGACAGAAGAAAAAATAACCATTGTAACTCAAAGAGAGGAATCTCCACCACCAGCAG
>TTN-208,ENSE00003802187,1,84,1714924,1715007,TGCCAGAAATACCAAAGAAGAAAGTTCCTGAAGAAAGGAAACCTGTTCCTCGGAAGGAGGAAGAAGTTCCACCACCACCAAAAG
>TTN-208,ENSE00003810484,1,84,1715008,1715091,TGCCAGCTCTGCCTAAGAAACCCGTCCCAGAGGAGAAAGTTGCAGTGCCAGTTCCTGTCGCTAAGAAAGCTCCTCCTCCCCGAG
>TTN-208,ENSE00003810121,1,102,1715092,1715193,CTGAAGTCTCTAAGAAAACTGTTGTAGAAGAAAAGAGATTTGTTGCTGAAGAAAAACTATCCTTCGCAGTTCCTCAAAGAGTGGAAGTCACGCGGCACGAAG
>TTN-208,ENSE00003805410,1,114,1715194,1715307,TATCTGCAGAGGAGGAATGGAGTTACTCAGAAGAGGAGGAAGGTGTGTCCATTTCAGTTTATAGAGAAGAAGAAAGAGAGGAGGAGGAAGAAGCAGAGGTTACAGAATATGAAG
>TTN-208,ENSE00003801264,1,81,1715308,1715388,TGATGGAAGAGCCTGAGGAATATGTTGTGGAAGAAAAGCTGCACATTATTTCTAAGAGAGTGGAAGCTGAGCCAGCTGAAG
>TTN-208,ENSE00003805756,1,78,1715389,1715466,TGACAGAGAGGCAGGAGAAGAAAATTGTACTGAAACCAAAAATTCCTGCTAAAATAGAGGAGCCTCCACCGGCTAAAG
>TTN-208,ENSE00003808334,1,84,1715467,1715550,TTCCTGAAGCACCTAAGAAAATTGTGCCAGAAAAGAAAGTTCCTGCTCCAGTTCCTAAAAAGGAAAAGGTGCCCCCACCTAAAG
>TTN-208,ENSE00003808052,1,84,1715551,1715634,TGCCAGAAGAGCCAAAGAAACCAGTTCCAGAAAAAAAGGTTCCTCCAAAAGTCATTAAGATGGAAGAACCTCTCCCAGCCAAAG
>TTN-208,ENSE00003803067,1,84,1715635,1715718,TGACTGAGAGGCACATGCAAATTACCCAGGAAGAAAAAGTTCTTGTTGCTGTAACTAAAAAAGAGGCGCCTCCAAAAGCAAGAG
>TTN-208,ENSE00003808806,1,84,1715719,1715802,TGCCAGAGGAACCGAAGAGAGCTGTCCCAGAAGAAAAAGTTCTGAAACTCAAACCTAAAAGAGAGGAGGAACCACCAGCTAAAG
>TTN-208,ENSE00003805330,1,81,1715803,1715883,TGACTGAATTCAGAAAAAGAGTGGTTAAAGAAGAAAAAGTATCAATTGAAGCTCCAAAAAGAGAACCTCAACCCATCAAAG
>TTN-208,ENSE00003807878,1,207,1715884,1716090,AAGTAACTATAATGGAAGAGAAAGAAAGGGCTTATACCCTAGAAGAAGAAGCTGTTTCAGTACAACGGGAAGAAGAATATGAGGAATATGAAGAATATGATTATAAAGAATTTGAGGAGTATGAACCAACAGAAGAATATGACCAATATGAAGAATACGAGGAGCGGGAGTATGAACGATATGAAGAGCATGAAGAATACATCACAG
>TTN-208,ENSE00003806244,1,78,1716091,1716168,AACCAGAGAAGCCTATCCCTGTAAAGCCTGTCCCAGAAGAACCAGTTCCCACAAAACCAAAGGCCCCACCGGCTAAAG
>TTN-208,ENSE00003810594,1,75,1716169,1716243,TGCTGAAGAAAGCTGTCCCTGAAGAAAAAGTACCAGTGCCCATTCCTAAGAAACTCAAACCTCCACCACCCAAAG
>TTN-208,ENSE00003809388,1,93,1716244,1716336,TGCCTGAAGAACCAAAGAAAGTTTTTGAGGAAAAAATACGTATTTCAATTACCAAACGTGAAAAAGAGCAGGTGACTGAACCCGCTGCTAAAG
>TTN-208,ENSE00003807405,1,78,1716337,1716414,TGCCCATGAAGCCCAAGAGGGTTGTCGCAGAAGAAAAAGTACCTGTCCCTAGAAAAGAAGTAGCACCACCTGTTAGAG
>TTN-208,ENSE00003810081,1,162,1716415,1716576,TGCCAGAAGTGCCTAAAGAACTTGAACCAGAAGAGGTTGCCTTTGAAGAGGAAGTTGTAACCCATGTAGAAGAATATCTTGTAGAAGAAGAAGAAGAGTACATTCATGAAGAAGAGGAGTTCATAACTGAGGAAGAAGTGGTGCCAGTGATACCAGTCAAAG
>TTN-208,ENSE00003806496,1,84,1716577,1716660,TGCCTGAGGTACCCAGGAAACCTGTTCCAGAAGAGAAGAAACCTGTTCCTGTTCCCAAGAAGAAGGAAGCTCCACCGGCAAAAG
>TTN-208,ENSE00003802498,1,78,1716661,1716738,TGCCTGAGGTTCCTAAGAAGCCAGAGGAGAAAGTTCCTGTGCTTATTCCTAAAAAGGAGAAGCCTCCGCCAGCAAAAG
>TTN-208,ENSE00003809653,1,84,1716739,1716822,TTCCTGAAGTGCCCAAGAAACCTGTGCCAGAGGAGAAAGTACCAGTACCAGTTCCTAAAAAGGTGGAAGCTCCACCTGCCAAAG
>TTN-208,ENSE00003810862,1,84,1716823,1716906,TGCCAGAGGTACCCAAGAAGCCTGTGCCTGAGAAGAAGGTGCCAGTTCCTGCTCCTAAGAAAGTGGAGGCTCCACCTGCAAAAG
>TTN-208,ENSE00003805059,1,84,1716907,1716990,TGCCAGAGGTGCCCAAGAAGCTCATCCCAGAAGAAAAGAAACCAACACCTGTTCCGAAAAAAGTGGAAGCACCACCACCCAAAG
>TTN-208,ENSE00003801382,1,297,1716991,1717287,TGCCAAAGAAACGTGAACCAGTTCCAGTTCCTGTAGCTCTACCTCAGGAAGAGGAAGTTCTATTTGAAGAAGAAATTGTTCCTGAAGAGGAAGTTCTACCTGAGGAAGAGGAAGTTCTACCTGAGGAAGAGGAAGTTCTACCTGAAGAAGAGGAAGTTCTACCTGAAGAAGAGGAAATTCCACCTGAGGAAGAGGAAGTTCCTCCCGAAGAAGAATATGTACCTGAGGAAGAAGAATTTGTACCTGAAGAAGAAGTCCTTCCAGAAGTTAAACCTAAGGTGCCAGTACCTGCACCAG
>TTN-208,ENSE00004025982,1,87,1717288,1717374,TGCCTGAAGTGCCAAAGAAACCTGTACCAGAGAAGAAAGTCCCTGTTCCCGCCCCTAAAAAAGTGGAACCTCCACCACCACCCAAAG
>TTN-208,ENSE00003805240,1,75,1717375,1717449,TGCCTGAAATTAAGAAGAAAGTGACAGAGAAGAAAGTGGTCATTCCCAAGAAAGAGGAGGCTCCCCCTGCCAAAG
>TTN-208,ENSE00004025997,1,84,1717450,1717533,TGTCTGTGGTACCTAAGAAACCTGAGCCAGAAAAGAAGGTCCCTCCTCCTGGTCTTAAGAAAGCAGTGGCCCCTCCTGCCAAAG
>TTN-208,ENSE00003804875,1,75,1717534,1717608,TTCCTGAGGTGCCTAAGAAGGTGGAAGAAAAACGAATCATTCTCCCTAAAGAAGAGGAAGTTCTACCAGTTGAAG
>TTN-208,ENSE00003801552,1,96,1717609,1717704,TGACTGAGGAGCCTGAAGAAGAGCCTATTTCAGAAGAAGAAATCCCAGAAGAACCACCTAGCATAGAGGAAGTTGAAGAGGTGGCACCACCTAGAG
>TTN-208,ENSE00003804385,1,78,1717705,1717782,TGCCTGAAGTGATTAAGAAAGCAGTACCTGAAGCACCTACTCCTGTTCCTAAAAAAGTGGAGGCACCACCAGCTAAAG
>TTN-208,ENSE00003805135,1,69,1717783,1717851,TGTCAAAGAAAATTCCTGAGGAAAAAGTACCTGTTCCTGTTCAGAAAAAAGAGGCACCCCCAGCCAAAG
>TTN-208,ENSE00003808243,1,75,1717852,1717926,TGCCTGAAGTACCAAAGAAAGTCCCAGAAAAGAAAGTCCTTGTGCCTAAAAAGGAAGCTGTTCCCCCAGCTAAAG
>TTN-208,ENSE00003808353,1,297,1717927,1718223,GGAGAACTGTCCTTGAAGAAAAAGTATCAGTTGCCTTCCGCCAAGAAGTAGTAGTAAAAGAAAGACTAGAATTAGAAGTAGTAGAAGCAGAAGTGGAAGAAATTCCGGAAGAAGAAGAGTTCCATGAAGTTGAAGAATATTTTGAAGAAGGCGAGTTTCATGAAGTAGAAGAATTCATCAAATTAGAACAACATAGAGTTGAAGAAGAACACAGAGTTGAAAAAGTTCATAGGGTAATAGAAGTTTTTGAGGCTGAAGAAGTGGAAGTATTTGAAAAACCAAAAGCTCCACCTAAAG
>TTN-208,ENSE00003807571,1,81,1718224,1718304,GGCCTGAGATATCTGAGAAAATCATCCCTCCAAAAAAACCGCCCACTAAAGTTGTTCCTCGAAAAGAGCCACCAGCTAAAG
>TTN-208,ENSE00003808118,1,78,1718305,1718382,TACCGGAGGTGCCTAAGAAAATTGTGGTAGAAGAAAAAGTACGTGTTCCTGAAGAGCCCAGAGTTCCACCAACTAAAG
>TTN-208,ENSE00004025978,1,84,1718383,1718466,CACCCGAAGTACCCAAGAAAATTGTCCCAGAAGAAAAAGTTCGTGAAGCTGTTCTGAAAAAGCCTGAAGTTCCACCAGCTAAAG
>TTN-208,ENSE00004026002,1,75,1718467,1718541,TTCCTGGGATGCCTAAGAAAAGTGTTCAAGAAGAAAAATCACCTATTGTTATTTCTGAAGACACAGAGATGTACA
>TTN-208,ENSE00004025998,1,84,1718542,1718625,TTTATGAAGCATCTGAAGAAGCAGTCCTAGAAGAAAAAGTACTTGTGACTCAACCTCAAAAGACAAAACCCAAACTAGCAAAAG
>TTN-208,ENSE00004025971,1,84,1718626,1718709,TGCCTGAGCCACCCAAGAAAGTTGTTCCAGAAGACAAAATATATGTGACTATTCCTAAAAAGAGAGAAACACCAGCAACTAAAG
>TTN-208,ENSE00001725280,1,84,1718710,1718793,AACCTGATACAACCAGAGGCATTTTTCCAGAGGTGGAGCCACCTGAGGCTATTCCTGAAATTCCAGAACATCCTCCAACTGAAG
>TTN-208,ENSE00004024308,1,78,1718794,1718871,AGTTTGAAGTCTTCAAGGAAGTCATTCCAGAGGGAGAAACTCCTATTGTTAAAAGAAGAAAAACACCATCACCAACAG
>TTN-208,ENSE00004025995,1,84,1718872,1718955,TGCCTGAATCACCTCGAGAAATTGTCCCTGTAAAGGAAACACCCATGGCTGCTCCCCTTGAAATTGAAATACCTCCCACTAAAG
>TTN-208,ENSE00004024272,1,84,1718956,1719039,CACCAGAAGCTATGAAAGAAGTTGTCCCTGAAATGAAAATATTTGAGGATGTACCTGAAGAGCCAGAAACTCCACGTATGAAAA
>TTN-208,ENSE00004024280,1,75,1719040,1719114,CGCCCGAAGCTCCTCAAGAAATTATTCCTGCCAAGACAGTTCCTTCCAAAAAAAGAGAACCCCCATCAGTTAAAG
>TTN-208,ENSE00004024279,1,84,1719115,1719198,TGCCTGAAGCTCTCCAAGAAATTGTCCCTGAAAAGAAAACGCTTGTGGTTCCTCTCAGAAAGCCTGAAGTCCTTCCTGATGAAG
>TTN-208,ENSE00004024286,1,78,1719199,1719276,TGCCGGAGGCTCTCAGAGAAGTTGTCCCGGAAAAGAAAGTGCATCCTCCCCAAAGGGCTGAAGTTGTACCTGTCAAAG
>TTN-208,ENSE00004024310,1,84,1719277,1719360,TGCACGAAGCTCCCAAAGAGATTATCCCTGAAAAGAAAGTGTCGGTGGTGCCTCCTAAAAAGCCTGAAGTCCCACCTGTTAAAG
>TTN-208,ENSE00004024305,1,84,1719361,1719444,TGCCAGAAGCTTCCAAAGAGGTTATCCGCGAAGAGAAAGTGCCCTTGGCTCCTCCTAAAGAGCCTGAAGTCCCACCTGTTAAAG
>TTN-208,ENSE00004024294,1,84,1719445,1719528,TACCAGAGCCTCCCAAAGAAGTAGTTCCTGAAAAGAAAGCGCCAGTGGCTCCTCCTAAAGAGCCTGAAGTCCCACCTGTTAAAG
>TTN-208,ENSE00004025974,1,84,1719529,1719612,TGCCTGAGGCTCCCAAAGAAGTTGTTCCTGAAAAGAAAGTGCCAGTGCCTCCTCCTAAAAAGCCTGAAGTGCCACCCACAAAAG
>TTN-208,ENSE00004025967,1,84,1719613,1719696,TCCCAGAGGTGCCAAAGGCAGCTGTCCCAGAAAAGAAGTTGCCTGAAGCTATTCCTCCCAAACCGGAAAGTCCTCCCCCTGAAG
>TTN-208,ENSE00003807304,1,90,1719697,1719786,TGCCTGAAGTGCTGCCACCGAAGGAAGTGGTCCCAGAAAAGAAAGTACCGGTGCCTCCTGCCAAAAAGCCAGAAGCTCCACCTCCTAAAG
>TTN-208,ENSE00004026001,1,84,1719787,1719870,TTCCTGAAGCTCCTAAAGAAGTTGTACTTGAAAAGAAAGCATCTGTGGCTGTGCCCAAAAAACCGGAAGCCCCACGTGCAAAAG
>TTN-208,ENSE00004025988,1,84,1719871,1719954,TGCCTGAAGCTGCTCAAGAAGTTGTCCCAGAAAAGAAAATTCCCAAGGCACCAATCAAAAAACCAGAAGCCCCCGCAGTTACAG
>TTN-208,ENSE00004025983,1,81,1719955,1720035,TGCCAGAAGTTCCTCAAGAAGCCACAGAAAAAGAAATTCCCGTGGCTCCACCCAAAAAACCAGAAGCTCCAATTGTCCCAG
>TTN-208,ENSE00004025976,1,81,1720036,1720116,TGCCTGAAGCTCAAGAAGTTGTCCCAGAAAAGAAAGTTCCTAAGGCTCCTCCCACAAAACCAGAAGCCCCACCTGCCACAG
>TTN-208,ENSE00004025986,1,81,1720117,1720197,TGCCTGAAGTCCCACAAGAAATTGTGCCAGAAAAGAAAACACTGGTGCTTCCTAAAAAGCCAGAAGTTCCACCTGTTACAG
>TTN-208,ENSE00004025969,1,84,1720198,1720281,TGCCAGAGGCTCCCAAAGAAGTTGTCCTTGAAAAGAAAGTGCCCTCGGCTCCTCCTAAAAAGCCTGAAGTCCCACCTGTTAAAG
>TTN-208,ENSE00003802745,1,84,1720282,1720365,TGCCTGAGGCTCCCAAAGAAGTTGTTCCTGAAAAGAAAGTGCCAGTGCCTCCTCCTAAAAAGCCTGAAGTGCCACCCACAAAAG
>TTN-208,ENSE00003809569,1,84,1720366,1720449,TCCCAGAGGTGCCAAAGGCAGCTGTCCCAGAAAAGAAGGTGCCTGAAGCTATTCCTCCCAAACCGGAAAGTCCTCCCCCTGAAG
>TTN-208,ENSE00004025984,1,90,1720450,1720539,TGCCTGAAGTGCTGCCACCGAAGGAAGTGGTCCCAGAAAAGAAAGTACCGGTGCCTCCTGCCAAAAAGCCAGAAGCTCCACCTCCTAAAG
>TTN-208,ENSE00004026000,1,84,1720540,1720623,TTCCTGAAGCTCCTAAAGAAGTTGTACTTGAAAAGAAAGCATCTGTGGCTGTGCCCAAAAAACCGGAAGCCCCACGTGCAAAAG
>TTN-208,ENSE00004025966,1,84,1720624,1720707,TGCCTGAAGCTGCTCAAGAAGTTGTCCCAGAAAAGAAAATTCCCAAGGCACCAATCAAAAAACCAGAAGCCCCCGCAGTTACAG
>TTN-208,ENSE00004025973,1,81,1720708,1720788,TGCCAGAAGTTCCTCAAGAAGCCGCAGAAAAAGAAATTCCCGTGGCTCCACCCAAAAAACCAGAAGCTCCGATTGTCCCAG
>TTN-208,ENSE00004025979,1,81,1720789,1720869,TGCCTGAAGCTCAAGAAGTTGTCCCAGAAAAGAAAGTTCCTAAGGCTCCTCCCACAAAACCAGAAGCCCCACCTGCCACAG
>TTN-208,ENSE00004025981,1,81,1720870,1720950,TGCCTGAAGTCCCACAAGAAATTGTGCCAGAAAAGAAAACACTGGTGCTTCCTAAAAAGCCAGAAGTTCCACCTGTTACAG
>TTN-208,ENSE00004025970,1,84,1720951,1721034,TGCCAGAGGCTCCCAAAGAAGTTGTCCTTGAAAAGAAAGTGCCCTCGACTCCTCCTAAAAAGCCTGAAGTCCCACCTGTTAAAG
>TTN-208,ENSE00004025993,1,84,1721035,1721118,TGCCTGAGGCTCCCAAAGAAGTTGTTCCTGAAAAGAAAGTGCCAGTGCCTCCTCCTAAAAAGCCTGAAGTGCCACCCACAAAAG
>TTN-208,ENSE00004025989,1,84,1721119,1721202,TCCCAGAGGTGCCAAAGGCAGCTGTCCCAGAAAAGAAGGTGCCTGAAGCTATTCCTCCCAAACCGGAAAGTCCTCCCCCTGAAG
>TTN-208,ENSE00004025987,1,90,1721203,1721292,TGCCTGAAGTGCTGCCACCGAAGGAAGTGGTCCCAGAAAAGAAAGTACCGGTGCCTCCTGCCAAAAAGCCAGAAGCTCCACCTCCTAAAG
>TTN-208,ENSE00004025975,1,84,1721293,1721376,TTCCTGAAGCTCCTAAAGAAGTTGTACTTGAAAAGAAAGTATCTGTGGCTGTGCCCAAAAAACCGGAAGCCCCACGTGCAAAAG
>TTN-208,ENSE00004026003,1,84,1721377,1721460,TGCCTGAAGCTGCTCAAGAAGTTGTCCCAGAAAAGAAAATTCCCAAGGCACCAATCAAAAAACCAGAAGCCCCCGCAGTTACAG
>TTN-208,ENSE00004025980,1,81,1721461,1721541,TGCCAGAAGTTCCTCAAGAAGCCGCAGAAAAAGAAATTCCCGTGGCTCCACCCAAAAAACCAGAAGCTCCAATTGTCCCAG
>TTN-208,ENSE00004025994,1,81,1721542,1721622,TGCCTGAAGCTCAAGAAGTTGTCCCAGAAAAGAAAGTTCCTAAGGCTCCTCCCACAAAACCAGAAGCCCCACCTGCCACAG
>TTN-208,ENSE00004025996,1,81,1721623,1721703,TGCCTGAAGTCCCACAAGAAATTGTGCCAGAAAAGAAAACACTGGTGCTTCCTAAAAAGCCAGAAGTTCCACCTGTTACAG
>TTN-208,ENSE00004025990,1,84,1721704,1721787,TGCCAGAGGCTCCCAAAGAAGTTGTCCTTGAAAAGAAAGTGCCCTTGGCTCCTCCTAAAAAGCCTGAAGTCCCACCTGTTAAAG
>TTN-208,ENSE00004026004,1,84,1721788,1721871,TGCCAGAGGCTCCCAAAGAAGTTGTTCCTGAAAAGAAAGTGCCAGTGACTCCTCCTAAAAAACCTGAAGTCCCACCTGTTAAAG
>TTN-208,ENSE00004025977,1,84,1721872,1721955,TGCCAGAGGCTCCCATAGAGGTTGTTCCTGAAAAGAAAATGCCCTTGGCTCCTCCTAAAAAGCCTGAAGTCCCTCCTGTTAAAG
>TTN-208,ENSE00004025991,1,84,1721956,1722039,TACCAGAGGCTCCCAAAGAGGTTGTTCCTGAAAAGAAAGTGCCCTCGGCTCCTCCTAAAAAGCCTGAAGTCCCACCTGTTAAAG
>TTN-208,ENSE00003806373,1,84,1722040,1722123,TGCCAGAGGCTCCGAAAGAAGTTGTTCCTGAAAAGAAAGTGCCAGCGGCTCCTCCTAAAAAGCCTGAAGTCACACCTGTTAAAG
>TTN-208,ENSE00003807489,1,84,1722124,1722207,TGCCTGAGGCTCCCAAAGAAGTTGTTCCTGAAAAGAAAGTGCCAGTGCCTCCTCCTAAAAAGCCTGAAGTGCCACCCACAAAAG
>TTN-208,ENSE00003805050,1,84,1722208,1722291,TCCCAGAGGTGCCAAAGGTAGCTGTCCCAGAAAAGAAGGTGCCTGAAGCTATTCCTCCCAAACCGGAAAGTCCTCCCCCTGAAG
>TTN-208,ENSE00003808824,1,84,1722292,1722375,TGTTCGAGGAGCCTGAGGAAGTTGCCCTAGAAGAGCCTCCTGCTGAAGTTGTGGAAGAGCCAGAGCCAGCGGCGCCTCCACAAG
>TTN-208,ENSE00003807203,1,84,1722376,1722459,TGACCGTACCACCTAAGAAACCTGTCCCAGAAAAGAAAGCACCTGCTGTCGTTGCCAAAAAACCTGAACTACCACCAGTGAAAG
>TTN-208,ENSE00003811260,1,84,1722460,1722543,TGCCCGAGGTGCCCAAGGAGGTTGTTCCTGAAAAGAAGGTGCCTCTGGTGGTTCCCAAAAAGCCAGAAGCCCCACCTGCTAAAG
>TTN-208,ENSE00003806229,1,78,1722544,1722621,TGCCTGAAGTTCCAAAAGAAGTTGTTCCAGAAAAGAAAGTAGCTGTTCCCAAAAAGCCAGAAGTCCCACCAGCAAAAG
>TTN-208,ENSE00003807893,1,84,1722622,1722705,TGCCAGAAGTGCCAAAGAAACCTGTCTTGGAAGAGAAACCAGCTGTTCCTGTTCCAGAAAGAGCGGAGTCTCCTCCCCCAGAAG
>TTN-208,ENSE00003809515,1,108,1722706,1722813,TATATGAAGAACCTGAGGAAATTGCTCCTGAAGAGGAAATTGCTCCTGAAGAGGAAAAGCCAGTTCCTGTTGCAGAAGAGGAGGAACCAGAGGTTCCACCTCCAGCAG
>TTN-208,ENSE00003804845,1,78,1722814,1722891,TGCCTGAAGAGCCCAAGAAGATCATCCCAGAGAAGAAAGTTCCTGTCATCAAAAAACCAGAAGCACCGCCTCCTAAAG
>TTN-208,ENSE00004025992,1,78,1722892,1722969,AACCTGAGATGCCAAAGAAAGTTGTTCCAGTGAAGAAGGTCCCAACTGTTAAGAAGCCAGAAACACCAGCAGCTAAAG
>TTN-208,ENSE00004025972,1,84,1722970,1723053,TGCCTGAGGTGCCCAAGAAACTTGTTCCAGTAAAGAAAGAACCTGTGCCTGTTACCAAAAAACCAGAAGTTCTTCCAGAAAAAG
>TTN-208,ENSE00004025968,1,84,1723054,1723137,TGCCCAAAGTGCCTGAGAAAATCATCCCAGAAAAGGAAGTGTCTGTGCCTATCCCTGCAGAGCCAGAAGTTCCACCTGCTGAAG
>TTN-208,ENSE00004025985,1,81,1723138,1723218,TTGAAGAGACTCCTGAGGAAATAATATATGAAGAAAAAGCATCTATAACCATTGGTAGAAAAGAGACTCCCCCTGTTGAAG
>TTN-208,ENSE00004025999,1,75,1723219,1723293,AACGTGAAATTGAAAAGTATATTAAACCTGAAGAGCCCGAACCTGAACCACAGCCTGAAGAAATACCAGTAAAAG
>TTN-208,ENSE00003806702,1,111,1723294,1723404,AACCTGAACCTGAAAAGGTTATTGAGAAGCCAAAACTCAAACCAAGACCCCCACCTCCTCCACCTGCTCCACCTAAGGAAGATGTGAAGGAGAAAATATTCCAACTTAAAG
>TTN-208,ENSE00003809179,1,69,1723405,1723473,CTATTCCAAAGAAGAAAGTTCCTGAAAAACCTCAGGTTCCAGAAAAAGTGGAGCTTACACCTCTGAAAG
>TTN-208,ENSE00003804802,1,81,1723474,1723554,TGCCTGGAGGTGAAAAGAAAGTTCGCAAATTACTTCCGGAACGTAAACCTGAACCAAAGGAAGAAGTTGTTCTGAAAAGCG
>TTN-208,ENSE00003811452,1,75,1723555,1723629,TTCTAAGAAAAAGACCTGAAGAAGAAGAACCTAAAGTAGAACCTAAAAAACTAGAAAAAGTTAAAAAACCTGCAG
>TTN-208,ENSE00003807205,1,90,1723630,1723719,TACCAGAACCACCACCTCCAAAACCTGTTGAAGAGGTTGAAGTACCTACTGTTACAAAAAGGGAAAGGAAGATTCCTGAACCAACAAAAG
>TTN-208,ENSE00003806747,1,63,1723720,1723782,TGCCTGAAATCAAGCCAGCAATACCTCTCCCTGCACCTGAACCGAAACCAAAGCCCGAAGCAG
>TTN-208,ENSE00003810755,1,90,1723783,1723872,AAGTGAAAACAATCAAACCACCTCCTGTGGAACCTGAACCAACCCCCATCGCTGCCCCAGTAACAGTGCCAGTGGTTGGAAAGAAAGCAG
>TTN-208,ENSE00003806122,1,51,1723873,1723923,AAGCCAAAGCACCTAAGGAAGAGGCTGCCAAGCCAAAAGGTCCTATCAAAG
>TTN-208,ENSE00003804858,1,402,1723924,1724325,GTGTACCCAAAAAGACTCCTTCACCAATAGAAGCCGAAAGGAGAAAGTTAAGGCCAGGAAGTGGTGGAGAGAAACCTCCTGATGAAGCCCCGTTCACCTACCAGCTAAAGGCTGTGCCACTGAAGTTTGTGAAAGAAATCAAAGACATCATCTTGACAGAATCAGAGTTCGTTGGCTCTTCAGCAATCTTTGAATGTTTGGTCTCCCCTTCCACTGCAATTACAACCTGGATGAAAGACGGTAGCAATATCCGTGAGAGTCCCAAGCACAGGTTTATTGCAGATGGTAAAGACAGAAAGCTGCACATCATTGATGTTCAACTTTCCGATGCTGGTGAATACACCTGTGTTTTACGTTTGGGAAACAAAGAAAAGACCTCCACGGCTAAACTTGTTGTAGAAG
>TTN-208,ENSE00003803996,1,279,1724326,1724604,AACTTCCTGTGCGTTTTGTAAAAACACTGGAAGAGGAAGTCACAGTGGTCAAAGGACAGCCATTGTACTTGAGCTGCGAGTTAAACAAAGAGCGTGACGTGGTCTGGAGGAAGGATGGCAAGATTGTGGTGGAGAAACCTGGCCGAATTGTGCCAGGCGTCATTGGCTTGATGCGGGCTCTGACCATCAACGATGCAGATGACACAGATGCTGGAACATACACAGTTACTGTGGAAAACGCCAACAACCTGGAGTGTTCATCTTGCGTAAAAGTAGTAG
>TTN-208,ENSE00003807976,1,276,1724605,1724880,AAGTCATTAGAGATTGGCTGGTGAAACCTATACGAGACCAGCATGTGAAACCCAAGGGGACAGCTATTTTTGCCTGTGATATAGCAAAAGATACTCCAAACATTAAGTGGTTCAAAGGATATGATGAAATCCCTGCGGAACCAAATGATAAGACTGAAATACTGAGAGATGGAAATCATCTGTACCTCAAAATTAAGAATGCTATGCCAGAAGATATTGCTGAGTATGCAGTGGAAATTGAAGGAAAAAGATACCCTGCAAAGCTGACACTTGGAG
>TTN-208,ENSE00003804328,1,140,1724881,1725020,AGCGTGAAGTTGAACTGCTTAAACCAATAGAGGACGTTACCATTTATGAGAAAGAAAGTGCAAGCTTTGATGCAGAAATCTCAGAGGCAGACATTCCTGGACAATGGAAACTGAAAGGAGAACTTCTAAGGCCCTCACCT
>TTN-208,ENSE00003802254,1,127,1725021,1725147,ACTTGTGAAATCAAAGCAGAAGGTGGAAAACGCTTCTTAACTTTGCACAAAGTCAAACTGGACCAAGCTGGTGAAGTCCTCTACCAGGCCCTTAATGCAATTACAACTGCCATTTTGACAGTAAAAG
>TTN-208,ENSE00003811410,1,264,1725148,1725411,AAATCGAACTTGACTTTGCTGTGCCCCTGAAGGATGTCACTGTTCCAGAAAGGCGACAGGCTCGATTCGAATGTGTCCTCACCCGAGAGGCAAATGTTATATGGTCCAAAGGACCTGATATAATTAAGTCATCTGACAAATTTGATATCATCGCTGATGGAAAGAAACATATTCTTGTTATTAATGATTCTCAATTTGATGATGAAGGGGTCTATACTGCTGAGGTGGAGGGCAAGAAGACCTCAGCTCGGTTGTTTGTCACAG
>TTN-208,ENSE00003805150,1,267,1725412,1725678,GTATAAGACTGAAATTCATGTCACCTCTTGAAGATCAAACAGTAAAAGAAGGTGAAACAGCAACTTTTGTTTGTGAACTTTCTCATGAAAAAATGCATGTAGTCTGGTTCAAAAATGATGCCAAACTCCATACAAGCAGAACAGTACTCATCTCTTCTGAGGGCAAGACTCACAAATTGGAAATGAAAGAAGTGACATTGGATGATATATCTCAGATAAAAGCTCAAGTCAAGGAGCTGAGCTCCACAGCACAGCTGAAGGTCTTAG
>TTN-208,ENSE00003801907,1,264,1725679,1725942,AGGCCGATCCCTACTTCACTGTGAAATTACATGACAAAACTGCAGTGGAGAAGGATGAGATTACTTTGAAGTGTGAAGTGAGCAAAGATGTACCAGTGAAATGGTTCAAAGATGGTGAAGAGATTGTCCCTTCACCCAAATATTCTATCAAGGCAGATGGCCTGCGCCGCATCTTAAAAATCAAAAAGGCGGACCTTAAAGATAAAGGCGAATATGTGTGTGACTGTGGCACAGACAAGACCAAGGCAAATGTTACTGTTGAGG
>TTN-208,ENSE00003802031,1,140,1725943,1726082,CTCGACTAATAAAAGTGGAAAAGCCTCTGTACGGAGTAGAGGTGTTTGTTGGTGAAACAGCCCACTTTGAAATTGAACTTTCTGAACCTGATGTTCACGGCCAGTGGAAGCTGAAAGGACAGCCTTTGACAGCTTCCCCT
>TTN-208,ENSE00003811443,1,127,1726083,1726209,GACTGTGAAATCATTGAGGATGGAAAGAAGCATATTCTGATCCTTCATAACTGTCAGCTGGGTATGACAGGAGAGGTTTCCTTCCAGGCTGCTAATGCCAAATCTGCAGCCAATCTGAAAGTGAAAG
>TTN-208,ENSE00003811384,1,267,1726210,1726476,AATTGCCTCTTATCTTCATCACACCTCTCAGTGATGTTAAAGTCTTCGAGAAAGATGAGGCTAAGTTTGAGTGTGAAGTATCCAGGGAGCCCAAAACATTCCGTTGGCTAAAAGGAACCCAGGAAATCACAGGTGATGACAGATTTGAGCTTATAAAGGATGGCACTAAGCATTCAATGGTGATCAAGTCAGCTGCTTTTGAAGATGAAGCAAAATACATGTTTGAAGCTGAAGATAAGCACACAAGTGGCAAACTGATCATTGAAG
>TTN-208,ENSE00003801954,1,267,1726477,1726743,GAATCCGGCTCAAATTCCTCACCCCTCTCAAAGATGTAACTGCCAAAGAGAAGGAAAGTGCTGTATTTACTGTGGAGTTATCTCATGATAACATCCGAGTTAAATGGTTCAAGAATGACCAGCGCCTACACACCACCAGGTCGGTCTCAATGCAAGACGAAGGGAAAACTCATTCGATCACATTCAAAGACCTGTCTATTGATGACACCTCCCAAATTAGAGTAGAAGCTATGGGGATGAGTTCAGAAGCTAAACTCACTGTGCTTG
>TTN-208,ENSE00003809996,1,267,1726744,1727010,AGGGAGACCCATATTTTACAGGAAAACTTCAAGATTATACTGGTGTAGAGAAAGATGAAGTTATTCTACAGTGTGAAATTAGCAAAGCAGATGCACCAGTGAAATGGTTTAAGGATGGGAAGGAAATAAAGCCATCCAAAAATGCTGTTATTAAGGCAGATGGCAAGAAACGCATGCTAATCCTAAAGAAAGCCTTGAAATCAGATATTGGACAGTACACCTGTGACTGTGGGACAGATAAGACCTCAGGAAAACTTGACATTGAGG
>TTN-208,ENSE00003804589,1,140,1727011,1727150,ATCGGGAAATTAAACTGGTGCGACCCCTGCACAGTGTGGAGGTGATGGAGACTGAGACAGCACGCTTTGAAACCGAAATCTCTGAAGATGATATCCACGCCAACTGGAAACTCAAGGGAGAGGCCCTACTCCAAACACCT
>TTN-208,ENSE00003805931,1,127,1727151,1727277,GATTGTGAAATTAAGGAAGAAGGCAAAATACACTCCCTTGTTTTGCACAACTGTCGCCTGGACCAGACGGGTGGGGTGGATTTCCAAGCTGCCAATGTTAAATCTAGTGCCCACCTCCGAGTTAAGC
>TTN-208,ENSE00003811344,1,143,1727278,1727420,CACGAGTAATTGGTCTTCTGAGGCCTTTAAAGGATGTCACCGTGACTGCAGGGGAAACAGCCACCTTCGACTGCGAGCTCTCCTACGAAGATATCCCAGTGGAATGGTATCTCAAAGGGAAGAAACTAGAGCCCAGCGATAAG
>TTN-208,ENSE00003802375,1,124,1727421,1727544,GTGGTCCCACGTTCAGAAGGAAAAGTTCATACACTTACTCTGAGGGATGTAAAGTTAGAAGATGCTGGGGAAGTCCAACTAACAGCAAAAGATTTCAAAACTCACGCCAACCTCTTTGTGAAAG
>TTN-208,ENSE00003806733,1,267,1727545,1727811,AACCCCCAGTTGAATTCACTAAGCCTCTTGAGGACCAGACGGTCGAAGAGGGAGCCACTGCAGTGCTGGAGTGTGAAGTCTCCAGAGAAAATGCTAAGGTGAAATGGTTCAAAAATGGGACAGAAATCCTCAAAAGCAAGAAGTATGAAATTGTTGCTGATGGCAGGGTCAGAAAACTTGTTATACATGACTGTACCCCAGAGGATATTAAAACATACACTTGTGATGCTAAGGATTTTAAGACTTCCTGTAACCTGAATGTCGTGC
>TTN-208,ENSE00003807497,1,98,1727812,1727909,CTCCTCATGTGGAATTCTTAAGACCACTCACCGACCTTCAAGTTAGAGAAAAAGAAATGGCTCGATTTGAGTGTGAACTTTCCCGAGAAAATGCTAAG
>TTN-208,ENSE00003802530,1,169,1727910,1728078,GTTAAGTGGTTTAAAGATGGTGCTGAAATTAAAAAGGGCAAAAAATATGACATCATATCCAAGGGAGCAGTGCGCATTCTTGTCATCAACAAATGTCTACTGGATGATGAAGCTGAATATTCCTGTGAAGTAAGGACAGCGAGAACTTCTGGCATGCTGACAGTTCTGG
>TTN-208,ENSE00003811387,1,267,1728079,1728345,AAGAAGAAGCTGTCTTTACCAAAAATCTTGCCAACATTGAAGTTAGTGAAACAGACACTATAAAACTGGTTTGTGAAGTCTCCAAACCTGGCGCAGAAGTGATTTGGTATAAAGGGGATGAGGAGATCATTGAAACAGGAAGATATGAAATACTGACTGAAGGACGGAAGAGAATCCTGGTCATTCAGAACGCTCACCTTGAGGATGCTGGCAACTACAACTGTCGACTCCCAAGCTCTCGAACCGATGGCAAAGTCAAAGTACATG
>TTN-208,ENSE00003802653,1,267,1728346,1728612,AACTGGCTGCTGAATTTATCTCAAAGCCTCAAAACCTTGAAATACTTGAAGGAGAAAAGGCTGAATTTGTCTGCTCTATATCAAAAGAAAGCTTTCCAGTCCAGTGGAAGAGGGATGATAAGACACTTGAATCTGGAGATAAATATGACGTTATTGCTGATGGTAAAAAGAGGGTCCTAGTTGTGAAAGATGCCACATTACAAGATATGGGCACTTACGTTGTCATGGTAGGGGCCGCCAGAGCAGCAGCTCACTTGACAGTCATTG
>TTN-208,ENSE00003802540,1,279,1728613,1728891,AAAAACTCAGGATCGTAGTTCCTCTTAAGGACACCCGGGTGAAGGAACAACAGGAAGTTGTCTTCAACTGTGAAGTCAATACTGAAGGTGCCAAAGCCAAATGGTTCAGAAATGAAGAAGCTATATTTGATAGTTCAAAATACATCATTCTCCAAAAAGACCTAGTCTACACCCTCAGAATTAGAGATGCACACTTAGATGACCAAGCCAACTATAATGTGTCTTTGACCAATCACAGAGGTGAAAATGTTAAAAGTGCAGCCAATCTAATAGTAGAAG
>TTN-208,ENSE00003802874,1,409,1728892,1729300,AGGAAGACCTTAGGATTGTTGAGCCTCTTAAAGATATTGAAACAATGGAGAAGAAATCTGTCACATTCTGGTGCAAGGTGAATCGTCTCAATGTAACACTGAAGTGGACCAAAAATGGTGAAGAAGTGCCTTTTGACAACCGTGTCTCATACAGAGTTGATAAGTACAAGCACATGTTAACCATTAAAGACTGTGGCTTCCCAGATGAAGGTGAATACATTGTCACTGCTGGACAAGATAAATCTGTTGCTGAGCTTCTCATCATAGAAGCCCCGACAGAATTTGTGGAACACTTGGAAGATCAGACAGTCACTGAGTTCGATGACGCTGTCTTCTCCTGCCAGCTCTCCAGAGAGAAAGCCAATGTAAAATGGTACAGAAATGGGAGAGAAATCAAAGAAGGCAAAAA
>TTN-208,ENSE00003804130,1,125,1729301,1729425,ATACAAATTTGAAAAAGATGGAAGTATACACAGACTCATTATAAAAGATTGCAGGCTGGATGATGAGTGTGAATATGCTTGCGGGGTAGAAGACAGGAAGTCTCGTGCTAGACTTTTTGTGGAAG
>TTN-208,ENSE00003807647,1,267,1729426,1729692,AAATTCCTGTTGAGATCATCAGGCCTCCACAAGATATTCTTGAAGCCCCTGGTGCTGATGTTGTCTTTTTAGCAGAACTCAATAAAGATAAGGTGGAAGTCCAATGGCTAAGAAATAACATGGTTGTTGTCCAGGGTGATAAACACCAGATGATGAGTGAAGGAAAGATACATCGACTACAGATTTGTGATATTAAGCCCCGTGACCAGGGTGAATACAGATTTATTGCCAAAGACAAAGAAGCCAGAGCTAAGCTTGAACTGGCAG
>TTN-208,ENSE00003802353,1,270,1729693,1729962,CTGCACCAAAAATCAAGACAGCTGACCAAGACCTTGTGGTTGATGTTGGCAAGCCTCTGACAATGGTGGTGCCATATGATGCCTACCCCAAAGCAGAAGCTGAATGGTTTAAAGAAAATGAACCTTTATCTACAAAAACCATTGATACTACGGCTGAACAAACTTCTTTCAGAATTTTAGAAGCCAAGAAAGGAGACAAAGGGAGGTATAAAATTGTGCTTCAGAACAAACATGGAAAAGCAGAAGGATTCATCAATTTAAAAGTTATTG
>TTN-208,ENSE00003809195,1,303,1729963,1730265,ATGTTCCTGGGCCAGTACGTAACTTAGAAGTGACAGAAACATTTGATGGTGAAGTGAGCCTTGCTTGGGAAGAACCTTTAACTGATGGTGGAAGCAAAATCATAGGTTACGTTGTTGAAAGACGTGACATTAAGAGAAAGACCTGGGTTCTGGCCACAGACCGTGCAGAGAGTTGTGAGTTTACTGTCACTGGTCTACAGAAAGGAGGAGTTGAGTACCTATTCCGTGTGAGTGCAAGAAACAGAGTTGGCACTGGTGAGCCAGTAGAAACTGACAATCCTGTAGAAGCAAGGAGTAAATATG
>TTN-208,ENSE00003803170,1,303,1730266,1730568,ATGTTCCAGGCCCTCCTTTGAATGTAACCATCACTGATGTGAATCGATTTGGTGTCTCACTGACATGGGAACCACCAGAGTATGATGGAGGTGCTGAGATCACAAACTACGTCATTGAATTAAGAGACAAGACTTCTATCAGGTGGGATACTGCCATGACTGTGAGAGCTGAAGACCTGTCTGCAACTGTTACTGATGTGGTAGAAGGACAGGAGTACAGTTTCCGAGTGAGAGCCCAAAATCGAATTGGAGTTGGAAAACCAAGTGCAGCCACACCCTTCGTCAAAGTTGCTGATCCAATTG
>TTN-208,ENSE00003806295,1,188,1730569,1730756,AGAGACCAAGTCCTCCTGTAAACCTAACTTCCTCAGATCAGACTCAGTCATCAGTTCAGCTCAAATGGGAACCTCCTCTGAAAGATGGAGGAAGCCCAATATTAGGCTATATAATTGAGCGATGCGAAGAAGGAAAAGATAATTGGATTCGTTGCAATATGAAACTTGTCCCTGAACTGACTTACAAG
>TTN-208,ENSE00003810732,1,115,1730757,1730871,GTTACCGGATTGGAAAAAGGAAATAAATATTTATATAGAGTATCTGCAGAAAATAAAGCTGGTGTTTCAGATCCATCTGAAATTCTTGGTCCTCTCACCGCTGACGATGCATTTG
>TTN-208,ENSE00003809985,1,285,1730872,1731156,TTGAACCAACAATGGATTTAAGTGCATTTAAAGATGGTCTGGAAGTTATTGTCCCAAATCCTATCACGATCCTGGTTCCAAGTACAGGCTATCCAAGGCCAACTGCAACCTGGTGTTTTGGAGATAAAGTACTAGAAACAGGGGACCGGGTGAAAATGAAGACCTTGTCTGCCTATGCCGAACTTGTCATTTCTCCAAGTGAACGTTCAGACAAGGGCATTTATACACTGAAATTAGAAAACCGTGTGAAAACAATTTCTGGGGAAATTGATGTCAATGTAATTG
>TTN-208,ENSE00003808828,1,152,1731157,1731308,CTCGCCCAAGTGCACCCAAAGAATTGAAATTTGGTGATATAACCAAGGACTCAGTACATTTGACTTGGGAACCACCTGATGATGATGGAGGAAGTCCGTTAACTGGATACGTTGTTGAAAAACGAGAAGTCAGCCGGAAAACATGGACTAAA
>TTN-208,ENSE00003803811,1,148,1731309,1731456,GTTATGGACTTTGTGACTGATCTAGAATTCACAGTTCCTGATCTTGTTCAAGGAAAAGAGTACTTATTTAAAGTTTGTGCTCGTAACAAATGTGGCCCTGGAGAACCTGCATATGTTGATGAACCTGTAAATATGTCAACTCCTGCAA
>TTN-208,ENSE00003803944,1,178,1731457,1731634,CGGTACCTGACCCACCAGAGAATGTTAAATGGAGAGATCGAACAGCCAATAGCATCTTCTTAACATGGGATCCACCTAAAAATGATGGTGGTTCACGCATCAAAGGATATATAGTTGAAAGATGTCCACGTGGTTCTGATAAATGGGTTGCCTGTGGAGAACCTGTTGCAGAAACAAA
>TTN-208,ENSE00003802090,1,122,1731635,1731756,AATGGAAGTGACAGGTCTTGAGGAAGGCAAATGGTATGCCTACCGCGTGAAGGCCTTAAACAGGCAGGGTGCTAGCAAACCAAGCAGACCCACAGAGGAAATCCAGGCTGTGGACACACAAG
>TTN-208,ENSE00003809522,1,288,1731757,1732044,AGGCCCCAGAAATCTTCCTCGATGTGAAGCTCCTTGCTGGTCTCACTGTAAAAGCTGGGACCAAGATTGAACTTCCTGCCACCGTAACCGGAAAACCTGAACCTAAAATAACTTGGACAAAGGCTGATATGATTCTGAAGCAGGACAAAAGAATTACCATTGAAAATGTCCCTAAGAAATCCACAGTGACTATTGTTGATAGTAAGAGAAGTGACACTGGCACATATATCATTGAGGCTGTGAATGTGTGTGGCCGGGCCACTGCTGTGGTGGAAGTGAACGTCTTAG
>TTN-208,ENSE00003804879,1,297,1732045,1732341,ATAAACCCGGACCACCAGCTGCCTTTGACATCACAGATGTAACCAATGAGTCATGTCTTCTAACATGGAACCCACCACGCGATGATGGTGGATCTAAGATCACAAACTATGTTGTGGAGAGACGAGCAACTGATAGTGAAGTGTGGCACAAGCTCTCATCCACCGTCAAGGATACAAACTTCAAGGCCACCAAATTAATCCCCAATAAAGAGTACATCTTCAGAGTTGCTGCAGAAAACATGTATGGTGTTGGTGAACCAGTTCAGGCCTCTCCAATAACAGCCAAATATCAGTTTG
>TTN-208,ENSE00003809410,1,187,1732342,1732528,ATCCACCTGGTCCTCCAACTCGCCTAGAACCTTCTGATATCACTAAAGACGCAGTGACTCTCACATGGTGTGAGCCAGATGATGATGGTGGCAGCCCAATCACAGGATACTGGGTTGAAAGACTGGATCCTGATACAGATAAATGGGTTAGATGCAATAAGATGCCAGTAAAGGACACAACATACAG
>TTN-208,ENSE00003808827,1,116,1732529,1732644,AGTGAAAGGTCTCACTAATAAGAAAAAATACAGATTCCGTGTGTTGGCTGAAAATCTTGCTGGACCTGGAAAACCAAGCAAATCAACTGAACCAATCTTAATAAAGGATCCCATAG
>TTN-208,ENSE00003806136,1,300,1732645,1732944,ATCCTCCATGGCCCCCTGGAAAACCAACTGTAAAAGATGTAGGCAAAACATCAGTAAGGTTGAATTGGACAAAACCAGAACATGATGGAGGTGCAAAGATTGAGTCTTATGTCATTGAAATGCTGAAGACTGGAACAGATGAGTGGGTCAGAGTGGCGGAAGGGGTTCCCACCACTCAGCACTTGCTCCCAGGGCTCATGGAAGGACAGGAATACTCATTCCGAGTTAGAGCTGTGAATAAGGCTGGGGAAAGTGAACCCAGTGAACCCAGTGACCCTGTGCTTTGCCGGGAGAAGCTAT
>TTN-208,ENSE00003804290,1,300,1732945,1733244,ATCCTCCATCACCACCACGCTGGCTTGAAGTTATTAATATCACAAAAAATACAGCAGACCTAAAATGGACAGTTCCTGAGAAAGATGGAGGGTCCCCCATCACCAACTACATTGTGGAAAAGAGAGACGTCAGGCGAAAAGGCTGGCAAACAGTGGATACCACTGTCAAGGACACCAAGTGCACAGTCACCCCACTGACTGAGGGCTCTTTATATGTGTTCCGAGTTGCTGCAGAAAATGCTATAGGACAAAGCGACTACACCGAAATTGAGGACTCTGTGCTGGCCAAAGACACCTTTA
>TTN-208,ENSE00003803723,1,106,1733245,1733350,CCACTCCTGGACCACCCTACGCCCTGGCAGTGGTTGATGTGACAAAACGACATGTTGACCTAAAGTGGGAGCCACCTAAAAATGATGGTGGAAGACCAATACAGAG
>TTN-208,ENSE00003805819,1,197,1733351,1733547,ATATGTCATTGAGAAGAAAGAAAGGTTAGGTACCCGTTGGGTGAAAGCTGGAAAGACTGCAGGACCTGACTGTAACTTCAGAGTAACTGATGTCATCGAAGGAACAGAGGTCCAGTTTCAGGTTCGGGCTGAAAATGAAGCTGGAGTTGGCCACCCAAGTGAACCCACAGAAATCCTATCCATTGAAGATCCAACAA
>TTN-208,ENSE00003806467,1,306,1733548,1733853,GTCCTCCCTCACCACCCCTTGACCTACATGTGACTGATGCTGGGAGAAAACACATTGCCATTGCTTGGAAGCCTCCAGAGAAAAATGGTGGAAGTCCTATCATAGGATACCATGTTGAAATGTGTCCAGTAGGCACTGAGAAATGGATGAGAGTTAATTCTCGCCCAATAAAGGACTTGAAATTCAAGGTTGAAGAAGGTGTTGTTCCTGACAAAGAATATGTCCTGAGAGTGAGAGCAGTCAATGCTATTGGTGTCAGCGAGCCATCTGAAATCTCTGAAAATGTGGTTGCCAAAGACCCAGACT
>TTN-208,ENSE00003808061,1,279,1733854,1734132,GCAAGCCAACAATTGACCTGGAGACTCATGACATTATTGTTATTGAAGGTGAAAAGTTAAGCATTCCTGTTCCCTTCAGAGCTGTCCCAGTTCCAACTGTTAGTTGGCATAAAGATGGCAAAGAAGTTAAAGCAAGTGATAGATTAACAATGAAGAATGATCACATCTCTGCACACCTTGAAGTTCCCAAGAGTGTCCGTGCAGATGCCGGAATTTATACCATTACACTGGAGAATAAGCTCGGCTCAGCAACAGCCTCAATCAATGTCAAAGTCATAG
>TTN-208,ENSE00003811164,1,300,1734133,1734432,GCCTACCTGGACCATGCAAAGATATTAAAGCAAGTGACATTACCAAGAGTTCTTGTAAGTTAACTTGGGAACCTCCAGAATTTGATGGTGGAACCCCAATTCTTCATTATGTCCTGGAGCGCAGAGAAGCTGGGAGGAGAACATATATACCAGTCATGTCTGGTGAGAACAAACTGTCATGGACTGTGAAGGATCTCATACCAAATGGTGAATACTTCTTCCGTGTTAAAGCAGTCAACAAGGTTGGTGGAGGAGAATATATTGAACTGAAAAATCCAGTCATTGCTCAAGATCCAAAGC
>TTN-208,ENSE00003805132,1,303,1734433,1734735,AACCCCCTGATCCACCTGTAGATGTAGAGGTTCATAATCCTACAGCGGAGGCAATGACTATTACATGGAAGCCACCTTTGTATGATGGAGGGAGCAAGATAATGGGCTACATCATAGAGAAGATTGCTAAGGGTGAAGAAAGGTGGAAGAGATGCAATGAACACCTGGTACCAATCCTGACCTATACAGCAAAAGGACTTGAAGAGGGGAAAGAGTACCAATTCCGTGTGCGAGCAGAGAACGCCGCGGGTATTAGTGAACCTTCTCGGGCTACTCCTCCAACCAAAGCTGTAGATCCCATTG
>TTN-208,ENSE00003805056,1,363,1734736,1735098,ATGCCCCCAAAGTCATTCTGAGAACAAGCCTAGAAGTGAAACGAGGTGATGAAATAGCACTTGATGCAAGTATTTCTGGATCACCTTACCCAACTATTACATGGATAAAGGATGAAAATGTTATTGTACCAGAGGAAATTAAGAAGCGTGCAGCACCCTTGGTTAGGAGAAGGAAGGGTGAAGTTCAAGAAGAAGAACCATTTGTCCTGCCTCTGACACAGCGTTTGAGTATTGACAACAGCAAAAAGGGAGAATCTCAGCTACGCGTCCGAGATTCTCTCCGACCTGACCATGGTCTGTATATGATCAAAGTTGAAAATGACCACGGTATTGCAAAAGCTCCTTGTACTGTCAGTGTGTTAG
>TTN-208,ENSE00003811138,1,303,1735099,1735401,ATACACCGGGACCACCAATCAACTTTGTATTTGAAGATATCAGAAAGACCTCAGTCCTTTGTAAATGGGAACCACCCCTTGATGATGGTGGCAGTGAAATCATAAACTACACTTTGGAAAAGAAAGACAAGACAAAACCCGACTCAGAATGGATTGTTGTCACTTCAACACTTAGACATTGCAAATATTCAGTAACAAAACTGATTGAAGGAAAAGAGTACCTCTTCCGTGTAAGAGCTGAAAACAGATTTGGGCCAGGTCCACCATGTGTTTCAAAGCCACTTGTGGCTAAAGATCCATTTG
>TTN-208,ENSE00003809346,1,300,1735402,1735701,GACCACCTGATGCACCAGATAAGCCCATTGTGGAAGATGTTACCAGCAACAGTATGCTAGTGAAATGGAATGAACCAAAAGATAATGGAAGCCCCATTTTGGGTTACTGGCTTGAAAAACGTGAAGTTAACAGTACACATTGGTCTCGTGTCAACAAAAGCCTTCTGAATGCCTTGAAAGCCAATGTAGATGGCTTATTAGAAGGACTCACCTATGTCTTCAGAGTATGTGCTGAAAATGCAGCTGGACCTGGAAAGTTCAGTCCACCTTCAGATCCCAAAACAGCACATGATCCAATCT
>TTN-208,ENSE00003806782,1,297,1735702,1735998,CTCCTCCTGGGCCACCTATCCCAAGAGTCACTGACACAAGCTCTACAACTATTGAACTAGAATGGGAACCCCCAGCTTTCAATGGTGGTGGGGAAATTGTTGGCTATTTTGTTGATAAGCAGTTGGTTGGCACAAATGAATGGTCACGCTGCACAGAGAAGATGATCAAGGTCCGTCAGTACACCGTCAAAGAAATCCGAGAGGGTGCTGATTACAAACTTCGGGTGAGTGCTGTCAATGCCGCAGGGGAAGGACCGCCTGGAGAAACACAACCTGTTACTGTGGCTGAACCACAAG
>TTN-208,ENSE00003804121,1,285,1735999,1736283,AGCCTCCAGCTGTGGAACTGGATGTTTCTGTCAAGGGTGGAATACAAATAATGGCTGGGAAGACTCTTAGAATTCCAGCTGTGGTGACTGGTCGCCCTGTACCTACAAAAGTATGGACCAAAGAAGAAGGGGAGCTGGATAAAGACCGTGTTGTAATAGACAACGTTGGAACCAAATCTGAACTAATTATCAAGGATGCACTGCGAAAAGACCATGGCAGATATGTGATTACAGCTACAAATAGCTGTGGTTCCAAATTTGCAGCAGCCAGGGTAGAAGTTTTTG
>TTN-208,ENSE00003804454,1,294,1736284,1736577,ATGTCCCTGGTCCAGTTCTTGACTTAAAACCTGTTGTAACAAACAGAAAAATGTGTCTACTTAACTGGTCTGATCCAGAAGATGATGGAGGAAGTGAAATAACAGGCTTTATCATTGAAAGAAAAGATGCCAAGATGCATACTTGGAGACAACCAATAGAGACTGAGAGATCTAAATGTGACATCACAGGTCTGCTTGAGGGACAAGAATATAAGTTCCGTGTTATTGCCAAGAACAAGTTTGGCTGTGGCCCTCCTGTTGAAATAGGACCAATTCTTGCAGTTGATCCACTAG
>TTN-208,ENSE00003803420,1,300,1736578,1736877,GTCCTCCAACATCTCCAGAGAGGCTCACATACACTGAAAGGACAAAGTCCACTATCACACTTGACTGGAAAGAGCCCCGCAGTAATGGTGGCAGTCCCATCCAAGGATATATCATTGAAAAACGGCGTCATGACAAACCTGACTTTGAAAGAGTTAACAAGCGACTCTGCCCAACCACATCTTTTCTGGTTGAAAATCTTGATGAACACCAAATGTATGAGTTCCGTGTCAAAGCTGTCAATGAAATTGGTGAAAGTGAACCATCCCTACCTCTTAATGTAGTCATACAAGATGATGAAG
>TTN-208,ENSE00003809028,1,309,1736878,1737186,TGCCTCCAACTATTAAGTTGCGTCTGAGTGTTCGAGGAGACACTATCAAAGTTAAGGCAGGAGAGCCTGTCCACATCCCTGCAGATGTGACAGGCCTTCCAATGCCTAAGATTGAATGGTCCAAAAATGAAACTGTAATTGAAAAACCCACTGATGCACTTCAGATAACCAAGGAAGAGGTATCCCGAAGTGAGGCAAAAACTGAGCTTAGCATTCCCAAAGCGGTCCGGGAGGACAAAGGCACTTACACAGTTACTGCTTCCAATCGCCTTGGCTCAGTGTTCCGAAATGTTCACGTTGAAGTATATG
>TTN-208,ENSE00003801894,1,191,1737187,1737377,ACCGCCCATCCCCACCAAGAAATCTTGCTGTTACTGACATTAAAGCTGAATCTTGCTACTTGACATGGGATGCCCCTCTTGATAATGGTGGCAGTGAAATCACCCATTATGTTATTGACAAACGTGATGCAAGTAGGAAGAAAGCAGAATGGGAGGAAGTCACCAACACTGCTGTAGAGAAAAGATATGGG
>TTN-208,ENSE00003809851,1,430,1737378,1737807,ATCTGGAAACTTATCCCCAATGGTCAGTATGAGTTCCGAGTCAGGGCAGTGAATAAATATGGAATCAGTGATGAGTGCAAATCAGATAAAGTAGTCATTCAAGATCCTTATCGCCTTCCTGGACCTCCAGGAAAACCAAAAGTTTTGGCACGCACCAAAGGATCAATGCTAGTGAGCTGGACTCCTCCTTTGGACAATGGTGGCTCTCCAATTACTGGCTACTGGCTGGAGAAAAGAGAAGAGGGAAGTCCTTATTGGTCACGTGTTAGCCGAGCACCAATAACCAAAGTGGGATTGAAAGGCGTGGAATTTAATGTTCCTCGTTTGCTTGAAGGCGTTAAATACCAGTTCAGAGCCATGGCAATAAATGCTGCAGGAATTGGTCCTCCCAGTGAACCATCAGATCCAGAGGTTGCAGGAGATCCCATAT
>TTN-208,ENSE00003808594,1,309,1737808,1738116,TTCCACCGGGGCCACCTTCTTGCCCAGAAGTTAAAGATAAAACGAAGTCAAGCATCTCACTAGGATGGAAACCTCCAGCCAAAGATGGTGGCAGCCCAATCAAAGGATACATTGTAGAAATGCAAGAAGAAGGTACTACTGACTGGAAAAGAGTAAATGAACCAGACAAACTTATAACTACCTGTGAATGTGTGGTGCCTAATCTGAAAGAGCTCAGGAAGTACAGATTCAGAGTGAAAGCTGTCAATGAAGCTGGTGAATCTGAACCAAGTGATACAACTGGGGAGATCCCTGCCACTGATATTCAAG
>TTN-208,ENSE00003810473,1,149,1738117,1738265,AGGAACCAGAAGTTTTCATTGACATTGGAGCACAGGACTGTCTGGTTTGTAAAGCTGGCTCACAGATTAGGATTCCTGCTGTCATCAAGGGACGCCCAACACCAAAATCATCTTGGGAATTTGATGGAAAGGCAAAGAAAGCAATGAAG
>TTN-208,ENSE00003801625,1,33,1738266,1738298,GATGGAGTTCATGACATACCCGAAGATGCACAG
>TTN-208,ENSE00003802643,1,130,1738299,1738428,CTGGAGACTGCTGAAAACTCCTCAGTAATTATTATTCCGGAGTGTAAACGATCTCATACAGGCAAATACAGCATCACAGCCAAGAATAAAGCAGGACAAAAGACTGCAAATTGCAGAGTTAAAGTCATGG
>TTN-208,ENSE00003804239,1,300,1738429,1738728,ATGTACCAGGCCCACCCAAAGATCTGAAAGTCAGTGATATCACAAGGGGTAGTTGCAGACTTTCATGGAAGATGCCAGACGACGATGGAGGAGACAGGATCAAAGGCTATGTTATTGAGAAGAGGACTATTGATGGAAAAGCCTGGACCAAAGTCAATCCAGACTGTGGAAGCACCACATTTGTAGTGCCTGATCTCCTCTCTGAACAGCAATATTTCTTCCGTGTGCGAGCAGAAAACCGTTTTGGTATTGGCCCACCTGTGGAAACCATTCAGAGGACCACTGCCAGAGATCCGATAT
>TTN-208,ENSE00003806278,1,318,1738729,1739046,ATCCTCCTGATCCTCCTATTAAACTCAAGATTGGCCTCATCACAAAGAACACAGTGCATCTGTCATGGAAACCCCCGAAGAATGATGGGGGCTCCCCTGTTACCCACTATATTGTTGAGTGCCTTGCATGGGACCCTACTGGGACAAAGAAAGAAGCCTGGAGGCAGTGCAATAAGCGTGATGTGGAAGAACTGCAATTTACTGTTGAAGACCTAGTAGAGGGTGGGGAATATGAATTCCGAGTCAAAGCTGTCAATGCTGCAGGAGTCAGCAAGCCTTCAGCCACTGTTGGCCCTGTGACTGTCAAAGACCAGACAT
>TTN-208,ENSE00003801391,1,297,1739047,1739343,GCCCACCATCAATTGATCTAAAAGAATTCATGGAGGTTGAAGAAGGAACCAATGTTAACATTGTGGCCAAAATTAAAGGTGTGCCATTCCCGACACTAACCTGGTTTAAAGCTCCTCCAAAGAAGCCTGATAACAAAGAACCTGTTCTCTATGACACCCATGTCAACAAACTGGTGGTAGATGATACTTGCACTTTAGTTATTCCGCAGTCTCGCAGGAGTGACACTGGCTTATATACCATCACAGCTGTAAATAATCTGGGAACAGCATCAAAGGAGATGAGACTGAATGTCCTGG
>TTN-208,ENSE00003806021,1,300,1739344,1739643,GTCGTCCTGGCCCTCCAGTGGGACCCATAAAATTTGAATCTGTTTCAGCAGATCAAATGACACTATCTTGGTTTCCACCTAAAGATGATGGTGGGTCTAAGATTACAAACTATGTAATTGAGAAAAGAGAAGCTAACAGGAAGACATGGGTCCATGTCTCCAGTGAACCTAAGGAGTGCACGTACACGATTCCCAAATTGCTAGAAGGCCATGAATATGTATTCCGAATCATGGCCCAGAATAAATATGGCATTGGAGAACCTCTTGACAGTGAACCTGAAACAGCAAGAAACCTCTTCT
>TTN-208,ENSE00003803442,1,315,1739644,1739958,CTGTCCCTGGAGCACCAGATAAACCAACAGTTAGCAGCGTGACTCGTAACTCCATGACTGTCAACTGGGAAGAGCCAGAATATGATGGAGGCTCTCCTGTGACAGGGTACTGGCTGGAAATGAAAGACACCACTTCAAAGAGATGGAAGAGAGTTAACCGAGATCCTATCAAAGCCATGACTTTGGGTGTTTCTTATAAAGTGACTGGTCTTATTGAAGGTTCCGACTATCAATTCCGGGTATATGCAATCAATGCTGCTGGCGTGGGTCCAGCAAGTCTGCCATCAGACCCAGCGACTGCTAGAGATCCAATTG
>TTN-208,ENSE00003801787,1,149,1739959,1740107,CCCCTCCTGGTCCTCCATTTCCCAAAGTGACAGATTGGACTAAATCATCTGCAGATCTGGAGTGGTCTCCCCCACTAAAAGATGGTGGATCCAAAGTAACTGGATACATCGTTGAATATAAAGAAGAAGGAAAAGAAGAATGGGAAAAG
>TTN-208,ENSE00003802004,1,151,1740108,1740258,GGTAAAGATAAAGAAGTGAGAGGAACAAAGCTTGTTGTGACAGGATTAAAGGAAGGAGCATTCTACAAATTTAGAGTTAGAGCAGTCAACATTGCTGGCATTGGAGAACCTGGAGAGGTCACAGATGTCATTGAAATGAAGGACAGACTTG
>TTN-208,ENSE00003808790,1,282,1740259,1740540,TTTCACCTGACCTTCAGCTAGATGCCAGTGTCAGAGATAGAATTGTTGTCCATGCTGGAGGGGTGATCCGAATCATTGCCTATGTGTCTGGAAAGCCTCCTCCAACCGTCACCTGGAACATGAATGAAAGAACCTTACCTCAAGAAGCCACCATTGAGACCACAGCCATTAGCTCATCCATGGTCATCAAGAACTGCCAGAGGAGCCATCAAGGCGTCTATTCTCTTCTTGCCAAAAATGAAGCCGGAGAAAGAAAGAAGACAATTATTGTTGATGTATTAG
>TTN-208,ENSE00003807896,1,303,1740541,1740843,ATGTTCCAGGTCCCGTTGGAACACCATTCCTAGCTCACAACCTAACCAATGAGTCCTGCAAACTGACATGGTTTTCTCCAGAAGATGATGGAGGCTCTCCAATCACCAATTATGTCATTGAAAAGCGTGAATCTGACCGCAGAGCATGGACCCCAGTGACATATACAGTTACCCGACAAAATGCTACTGTCCAGGGTCTCATTCAAGGAAAAGCCTACTTTTTCCGAATTGCGGCTGAAAATAGTATTGGCATGGGTCCATTTGTTGAGACATCAGAGGCACTTGTTATCAGAGAGCCAATAA
>TTN-208,ENSE00003801753,1,303,1740844,1741146,CTGTACCAGAGCGTCCTGAAGACCTGGAAGTCAAAGAAGTTACTAAAAATACTGTAACTTTGACTTGGAATCCTCCTAAGTATGATGGTGGGTCAGAAATTATTAACTATGTCCTAGAAAGTCGGCTCATTGGGACTGAGAAGTTCCACAAAGTTACAAATGACAACTTGCTTAGCAGAAAATACACTGTTAAAGGCTTAAAAGAAGGTGATACCTATGAGTACCGTGTCAGTGCTGTCAACATTGTTGGACAAGGCAAACCATCATTTTGCACCAAACCAATTACTTGCAAGGATGAGCTGG
>TTN-208,ENSE00003807039,1,282,1741147,1741428,CACCCCCAACGCTTCACCTCGACTTCAGAGATAAGCTCACGATTCGAGTTGGTGAAGCTTTTGCCCTCACTGGCCGTTACTCAGGCAAACCAAAGCCTAAGGTTTCCTGGTTCAAAGATGAAGCTGATGTGCTGGAAGATGATCGCACTCATATAAAGACTACACCAGCAACACTTGCTTTAGAGAAGATCAAGGCCAAACGTTCAGATTCCGGCAAATACTGTGTGGTTGTGGAGAACAGTACAGGCTCTAGGAAAGGTTTCTGTCAAGTTAATGTTGTTG
>TTN-208,ENSE00003804106,1,300,1741429,1741728,ACCGTCCTGGACCACCAGTAGGACCAGTTAGTTTTGATGAGGTGACCAAAGATTACATGGTTATCTCTTGGAAGCCTCCTTTAGATGATGGAGGCAGTAAAATCACCAATTATATTATTGAGAAGAAGGAAGTGGGTAAAGACGTCTGGATGCCAGTGACATCTGCAAGTGCTAAAACAACATGCAAAGTTTCTAAACTACTTGAAGGAAAAGATTATATTTTCCGGATACATGCTGAAAATCTGTATGGAATAAGTGATCCTCTGGTGTCTGATTCAATGAAAGCCAAAGATCGTTTCA
>TTN-208,ENSE00003801817,1,303,1741729,1742031,GGGTTCCTGATGCACCTGATCAGCCAATTGTTACAGAAGTTACCAAAGACTCTGCATTAGTAACCTGGAATAAGCCACATGATGGAGGAAAACCCATCACAAACTACATCCTGGAAAAGAGAGAAACTATGTCTAAACGATGGGCTAGAGTTACCAAAGATCCTATTCATCCATACACTAAATTTAGGGTTCCTGATCTTCTAGAAGGATGTCAGTATGAATTCCGGGTTTCTGCAGAAAATGAAATTGGTATTGGAGATCCAAGCCCACCATCCAAACCAGTCTTTGCTAAAGATCCAATTG
>TTN-208,ENSE00003810564,1,309,1742032,1742340,CTAAACCAAGTCCACCTGTTAATCCTGAAGCAATAGATACAACATGCAATTCAGTCGATCTAACTTGGCAGCCACCACGTCATGATGGTGGGAGCAAGATTCTGGGTTATATTGTTGAGTACCAGAAAGTTGGAGATGAAGAGTGGAGAAGAGCCAATCACACCCCTGAGTCATGTCCTGAAACTAAATATAAAGTCACCGGTCTTCGGGACGGTCAAACCTATAAGTTTAGAGTGTTAGCAGTCAATGCAGCTGGTGAATCAGATCCAGCTCATGTTCCGGAGCCAGTCCTAGTAAAAGACAGGCTTG
>TTN-208,ENSE00003807476,1,282,1742341,1742622,AACCCCCTGAGTTGATTCTTGATGCCAACATGGCAAGAGAACAACACATTAAAGTTGGTGATACTCTAAGACTTAGTGCCATCATCAAAGGAGTGCCATTCCCAAAAGTAACTTGGAAAAAAGAAGACAGAGATGCTCCAACTAAAGCAAGAATTGATGTGACTCCAGTTGGTAGCAAGCTTGAAATTCGTAATGCTGCCCATGAAGATGGTGGAATTTATTCTTTAACAGTGGAGAATCCAGCTGGTTCAAAAACTGTCTCAGTAAAAGTACTTGTATTAG
>TTN-208,ENSE00003807363,1,300,1742623,1742922,ATAAACCTGGGCCACCTAGAGATCTGGAAGTCAGTGAAATTAGGAAAGATTCATGTTACCTTACTTGGAAAGAACCACTGGATGATGGTGGTTCTGTTATTACCAATTATGTGGTTGAGAGGAGAGATGTTGCCAGCGCCCAGTGGTCACCTCTCTCAGCTACATCAAAGAAAAAGAGTCACTTCGCTAAGCATCTGAATGAAGGCAACCAGTACCTCTTCCGAGTAGCTGCGGAGAACCAGTATGGACGTGGTCCTTTTGTTGAAACACCAAAACCAATCAAGGCTTTGGATCCTCTCC
>TTN-208,ENSE00003808994,1,294,1742923,1743216,ATCCCCCAGGGCCACCCAAGGACCTGCACCATGTAGATGTTGACAAGACTGAAGTCTCCCTAGTCTGGAATAAGCCGGATCGTGATGGTGGTTCTCCAATCACTGGATATTTGGTAGAATATCAAGAAGAAGGCACCCAGGACTGGATTAAATTTAAGACTGTGACAAACTTAGAGTGTGTGGTTACTGGACTACAACAAGGAAAGACCTATAGATTCCGTGTAAAAGCTGAAAACATTGTGGGTCTTGGTCTCCCTGACACAACTATCCCGATAGAATGTCAAGAAAAACTAG
>TTN-208,ENSE00003810188,1,2967,1743217,1746183,TGCCTCCATCCGTGGAGCTAGATGTGAAATTAATTGAAGGTCTTGTGGTAAAGGCTGGAACCACAGTCAGATTCCCTGCTATTATAAGAGGTGTGCCTGTTCCTACTGCAAAGTGGACAACCGATGGGAGTGAGATTAAAACCGATGAGCACTACACAGTTGAAACAGACAACTTCTCATCAGTACTTACCATTAAGAACTGCTTAAGGAGAGACACTGGGGAATATCAAATCACAGTTTCCAATGCAGCCGGTAGCAAAACAGTAGCCGTACATCTTACTGTTCTTGATGTTCCTGGGCCACCAACAGGTCCTATTAATATTCTGGATGTTACTCCTGAACACATGACTATCTCATGGCAGCCACCTAAGGATGATGGAGGAAGCCCTGTGATAAATTATATTGTTGAGAAACAAGATACAAGGAAAGACACGTGGGGTGTTGTCTCTTCCGGAAGCAGTAAGACAAAGCTGAAAATCCCACATCTGCAGAAGGGCTGTGAATATGTTTTCCGAGTTAGAGCAGAGAATAAGATAGGTGTTGGTCCTCCCCTTGACTCCACACCTACTGTTGCTAAGCATAAATTTAGTCCTCCGTCTCCTCCTGGTAAACCAGTGGTTACTGACATTACTGAAAATGCAGCAACAGTGTCTTGGACCCTGCCAAAATCTGATGGTGGCAGTCCAATAACTGGCTACTATATGGAACGTCGAGAAGTAACTGGCAAATGGGTGAGGGTCAACAAAACACCTATCGCTGACCTGAAGTTCAGAGTGACTGGACTCTATGAAGGAAATACATATGAGTTTAGAGTTTTTGCTGAAAATCTTGCAGGACTAAGCAAACCATCCCCAAGTTCTGATCCAATAAAAGCTTGCCGGCCCATCAAACCACCTGGACCACCTATTAATCCTAAACTGAAAGACAAGAGCAGAGAAACAGCTGATTTGGTGTGGACAAAGCCTCTCAGTGATGGTGGTAGCCCCATTCTAGGATATGTAGTGGAATGTCAGAAACCTGGCACAGCACAATGGAACAGGATTAATAAAGATGAACTCATTAGGCAATGTGCCTTTAGGGTACCTGGACTAATTGAAGGAAATGAGTACAGATTCCGTATAAAGGCAGCTAATATTGTAGGAGAGGGTGAGCCAAGAGAACTAGCAGAATCTGTGATTGCAAAAGATATCCTTCATCCTCCAGAAGTAGAACTTGATGTTACTTGTCGTGATGTTATTACCGTGAGAGTAGGCCAAACTATCCGCATTCTAGCTCGAGTCAAAGGCAGACCTGAACCAGACATAACTTGGACTAAGGAAGGCAAAGTATTGGTCCGAGAAAAGAGGGTGGACCTTATTCAGGATCTACCTCGTGTTGAGTTACAAATTAAAGAAGCTGTTAGAGCTGATCATGGCAAGTATATCATCTCAGCTAAGAACAGCAGTGGACATGCCCAAGGTTCAGCCATCGTTAACGTCCTTGACAGACCTGGGCCTTGCCAGAATTTGAAGGTTACCAATGTAACCAAAGAGAACTGTACAATTTCTTGGGAAAACCCACTAGATAATGGTGGCTCAGAAATAACAAACTTCATAGTAGAATATCGCAAACCAAACCAGAAAGGCTGGTCAATTGTTGCATCAGATGTCACTAAACGATTAATCAAGGCCAACCTTTTAGCCAACAATGAATACTATTTCCGAGTTTGTGCAGAGAATAAAGTAGGTGTTGGGCCAACCATCGAAACAAAAACTCCCATTCTGGCTATTAACCCTATTGACAGACCAGGTGAGCCTGAAAACCTTCACATTGCAGATAAAGGAAAGACATTTGTCTATCTAAAGTGGCGGAGGCCTGACTATGATGGTGGCAGTCCAAATCTGTCATATCATGTTGAGAGAAGGCTTAAGGGCTCCGATGACTGGGAAAGAGTGCATAAAGGAAGCATTAAAGAAACTCACTACATGGTTGACAGATGTGTTGAAAACCAGATTTATGAGTTCAGAGTGCAAACAAAGAATGAAGGTGGGGAAAGTGACTGGGTGAAGACAGAGGAAGTTGTTGTGAAAGAAGACTTACAAAAACCAGTACTTGATCTGAAATTAAGTGGGGTCCTAACTGTCAAAGCAGGGGACACCATTAGGCTTGAGGCAGGGGTTAGAGGCAAACCATTCCCAGAAGTTGCATGGACCAAGGACAAAGACGCTACAGACTTAACAAGATCACCAAGGGTCAAGATTGATACCCGTGCTGATTCATCTAAATTTTCTCTTACTAAAGCAAAGCGAAGTGATGGGGGTAAATATGTAGTTACGGCAACTAACACGGCTGGCAGTTTTGTGGCCTATGCCACTGTCAATGTTTTAGATAAGCCTGGTCCTGTGAGAAATCTGAAAATTGTTGATGTGTCCAGTGATAGGTGTACTGTTTGCTGGGATCCACCAGAAGATGATGGTGGCTGTGAAATCCAAAATTATATTCTAGAAAAATGTGAGACAAAGCGAATGGTTTGGTCTACCTATTCTGCTACTGTCTTGACACCTGGTACTACAGTAACACGTCTCATAGAAGGAAATGAATATATTTTCAGAGTCCGTGCAGAAAATAAAATAGGCACAGGGCCTCCAACAGAAAGTAAACCAGTCATAGCCAAAACCAAGTATGATAAACCTGGTCGCCCTGATCCCCCAGAAGTCACTAAAGTAAGCAAAGAAGAGATGACTGTGGTTTGGAATCCACCTGAATATGATGGTGGAAAGTCTATAACTGGATACTTTTTGGAGAAAAAGGAAAAGCATTCAACACGATGGGTCCCTGTCAACAAGAGTGCAATCCCTGAGAGACGTATGAAAGTACAGAATCTCCTCCCAGACCATGAATATCAGTTCCGTGTCAAGGCAGAAAATGAAATTGGAATTGGAGAACCAAGCTTGCCTTCAAGACCGGTGGTGGCAAAAGACCCCATAG
>TTN-208,ENSE00003811401,1,321,1746184,1746504,AGCCACCTGGTCCACCAACCAATTTCAGAGTGGTTGATACAACCAAACATTCCATAACTCTTGGGTGGGGAAAACCAGTCTATGATGGTGGTGCACCGATCATTGGATATGTTGTGGAAATGAGACCAAAAATAGCAGATGCGTCTCCTGATGAAGGCTGGAAACGGTGTAATGCTGCAGCACAGCTTGTACGCAAGGAATTCACTGTTACCAGCTTGGATGAAAACCAGGAATATGAGTTCAGGGTGTGTGCCCAAAACCAAGTTGGTATTGGGCGCCCTGCAGAGCTAAAGGAAGCTATCAAACCTAAAGAAATACTAG
>TTN-208,ENSE00003805661,1,285,1746505,1746789,AACCTCCGGAGATTGATTTGGATGCCAGCATGAGGAAACTGGTCATAGTGAGAGCAGGATGCCCTATTCGTCTCTTTGCTATAGTGAGAGGACGACCAGCCCCTAAAGTCACTTGGCGAAAAGTTGGCATTGATAATGTGGTCAGAAAAGGACAAGTTGATCTGGTTGACACTATGGCCTTCCTTGTCATCCCCAATTCTACCCGTGATGACTCAGGAAAATATTCCTTAACACTTGTGAACCCAGCAGGAGAAAAGGCTGTATTCGTAAATGTCAGAGTATTAG
>TTN-208,ENSE00003804742,1,300,1746790,1747089,ACACTCCTGGGCCTGTGTCTGATTTAAAAGTTTCAGATGTCACTAAAACATCATGCCATGTGTCCTGGGCCCCTCCTGAAAACGACGGTGGGAGCCAAGTGACACATTATATCGTGGAGAAACGTGAGGCAGACAGAAAGACATGGTCGACCGTTACCCCAGAAGTTAAGAAAACAAGCTTCCATGTAACCAATCTTGTCCCTGGGAATGAGTATTACTTCAGAGTAACTGCTGTCAACGAATATGGCCCTGGCGTCCCAACAGATGTCCCAAAACCAGTGCTTGCATCAGATCCTCTAA
>TTN-208,ENSE00003810357,1,303,1747090,1747392,GTGAGCCGGATCCCCCAAGGAAATTAGAAGTGACTGAAATGACCAAGAACAGTGCCACCTTAGCCTGGTTACCTCCCCTACGTGATGGAGGTGCTAAAATCGATGGCTACATCACTAGTTACAGAGAAGAAGAGCAGCCTGCAGATCGCTGGACAGAGTACTCAGTGGTAAAAGATCTGAGCCTTGTTGTCACTGGCCTAAAGGAAGGAAAGAAATACAAATTTAGAGTAGCGGCCAGAAATGCTGTTGGAGTCAGTTTGCCAAGAGAAGCTGAAGGAGTGTATGAAGCCAAAGAACAACTGT
>TTN-208,ENSE00003801707,1,276,1747393,1747668,TGCCACCAAAGATCCTTATGCCAGAGCAAATAACTATCAAAGCTGGGAAAAAACTCCGAATTGAAGCCCATGTGTATGGAAAGCCTCATCCCACCTGTAAATGGAAAAAAGGAGAAGATGAAGTTGTCACATCCAGCCACCTGGCAGTGCATAAAGCAGACAGCTCTTCAATTCTGATCATAAAAGATGTGACTAGGAAAGACAGTGGTTACTACAGCCTCACAGCAGAGAACAGTTCTGGGACAGACACTCAGAAAATCAAAGTTGTAGTCATGG
>TTN-208,ENSE00003810399,1,300,1747669,1747968,ATGCCCCCGGCCCCCCTCAGCCTCCATTTGACATTTCTGATATAGACGCTGATGCTTGCTCCCTGTCATGGCACATCCCTCTGGAGGACGGAGGCAGTAACATCACCAATTATATAGTGGAGAAGTGTGATGTAAGCCGAGGTGACTGGGTCACGGCTCTAGCTTCAGTCACAAAAACTTCCTGCAGGGTTGGAAAGCTGATCCCAGGCCAGGAGTACATCTTCCGGGTCCGTGCTGAAAACCGATTTGGCATTTCAGAGCCTCTCACATCTCCAAAGATGGTTGCGCAGTTCCCATTTG
>TTN-208,ENSE00003810448,1,303,1747969,1748271,GTGTTCCTAGTGAACCAAAGAATGCACGAGTCACCAAAGTCAACAAGGACTGTATTTTTGTTGCTTGGGACAGACCAGATAGTGATGGAGGGAGCCCCATTATTGGTTATCTGATTGAACGCAAGGAAAGAAACAGTTTGCTGTGGGTGAAAGCCAATGATACTCTTGTCCGGTCAACTGAATATCCTTGTGCTGGCCTTGTAGAAGGTCTTGAGTATTCATTCAGAATCTATGCCCTAAACAAAGCTGGATCCAGCCCACCCAGCAAACCCACAGAATATGTAACTGCAAGAATGCCAGTTG
>TTN-208,ENSE00003802505,1,300,1748272,1748571,ATCCTCCTGGGAAACCTGAGGTTATTGATGTCACCAAGAGTACTGTATCTCTGATCTGGGCTCGTCCAAAGCATGATGGAGGCAGTAAAATTATTGGCTATTTCGTAGAAGCTTGCAAACTTCCTGGTGATAAATGGGTACGGTGCAATACTGCACCTCACCAGATTCCCCAGGAAGAGTACACAGCTACTGGCCTAGAAGAGAAAGCTCAGTATCAATTTAGAGCTATTGCCAGGACCGCGGTAAACATTAGCCCACCTTCTGAACCTTCTGATCCAGTGACTATCCTCGCAGAAAATG
>TTN-208,ENSE00003806397,1,288,1748572,1748859,TCCCTCCCAGGATAGACCTGAGTGTGGCTATGAAATCTTTGCTTACTGTGAAAGCTGGAACTAATGTCTGCTTGGATGCTACTGTTTTTGGTAAACCGATGCCAACAGTTTCTTGGAAAAAAGATGGCACACTGCTAAAACCAGCAGAAGGCATAAAGATGGCCATGCAGCGGAATCTGTGCACCTTGGAGCTATTCAGCGTGAACCGGAAGGACTCAGGAGACTATACCATTACTGCTGAAAATTCAAGTGGTTCTAAATCAGCCACCATTAAGCTTAAAGTGTTAG
>TTN-208,ENSE00003807889,1,297,1748860,1749156,ATAAACCGGGTCCTCCAGCATCTGTTAAAATCAACAAAATGTATTCAGATCGTGCTATGCTTTCTTGGGAACCGCCTCTTGAAGATGGAGGCTCAGAAATCACCAACTATATTGTTGACAAACGTGAAACAAGCAGGCCCAACTGGGCTCAAGTCTCTGCAACTGTGCCTATCACCAGCTGCAGCGTGGAGAAACTTATAGAGGGCCATGAGTATCAGTTCCGTATTTGTGCTGAAAATAAATATGGAGTAGGCGATCCAGTCTTCACTGAACCAGCAATTGCCAAAAACCCATATG
>TTN-208,ENSE00003811290,1,303,1749157,1749459,ACCCACCAGGACGCTGTGATCCTCCTGTTATTAGCAACATAACCAAAGATCACATGACAGTCAGCTGGAAGCCACCAGCAGATGATGGGGGCTCACCCATCACTGGCTATTTGCTTGAAAAGCGGGAAACCCAGGCTGTTAACTGGACTAAGGTCAACAGAAAACCTATTATAGAAAGAACATTAAAAGCAACAGGTCTTCAAGAAGGTACCGAATATGAGTTCCGTGTTACAGCTATAAATAAAGCTGGACCAGGCAAACCCAGTGACGCATCCAAGGCCGCTTATGCTCGGGACCCTCAGT
>TTN-208,ENSE00003808853,1,306,1749460,1749765,ATCCTCCTGGCCCACCGGCTTTCCCTAAAGTATATGATACAACTCGCAGCTCTGTGAGTCTATCTTGGGGCAAGCCAGCCTATGACGGCGGCAGCCCTATCATTGGTTATCTCGTTGAAGTAAAACGGGCTGACTCCGATAACTGGGTGAGGTGCAACTTACCACAGAATCTACAGAAAACCCGCTTTGAGGTTACTGGCCTGATGGAAGACACACAATATCAATTCCGTGTGTATGCCGTTAATAAGATTGGATACAGTGACCCCAGTGATGTGCCAGATAAACACTATCCCAAGGACATCTTAA
>TTN-208,ENSE00003807542,1,288,1749766,1750053,TTCCACCTGAGGGAGAACTTGATGCGGACTTAAGGAAGACACTCATATTACGTGCTGGAGTTACTATGAGACTATATGTACCAGTAAAAGGACGCCCACCTCCAAAGATTACTTGGTCTAAACCAAATGTCAATCTAAGAGACAGGATTGGACTGGACATAAAGTCAACTGACTTTGACACTTTCTTGCGCTGTGAAAATGTGAACAAATATGATGCAGGAAAATATATCTTAACCCTGGAGAACAGCTGTGGTAAAAAGGAATATACCATTGTTGTGAAAGTGCTTG
>TTN-208,ENSE00003810775,1,291,1750054,1750344,ATACTCCTGGGCCACCTGTCAATGTGACTGTTAAGGAAATATCCAAAGACTCTGCTTATGTTACCTGGGAGCCTCCCATTATTGATGGCGGAAGCCCCATCATAAACTATGTGGTACAAAAACGTGATGCAGAGAGGAAATCCTGGTCTACAGTGACAACTGAGTGCTCCAAAACAAGCTTCAGAGTAGCTAATTTGGAGGAGGGAAAATCCTACTTCTTCCGAGTGTTTGCTGAAAATGAGTATGGCATTGGTGATCCCGGTGAAACTCGTGATGCTGTCAAAGCTTCCC
>TTN-208,ENSE00003811210,1,288,1750345,1750632,AAACTCCTGGACCAGTTGTGGACCTGAAAGTGAGGTCTGTATCTAAGTCATCCTGTAGCATTGGCTGGAAAAAGCCTCACAGTGATGGTGGAAGTCGGATTATTGGATATGTAGTTGATTTCCTGACTGAAGAAAATAAGTGGCAACGAGTTATGAAATCCTTAAGCCTACAGTACTCTGCAAAAGATTTGACTGAAGGGAAGGAATATACCTTCAGAGTGAGTGCTGAGAATGAAAATGGAGAAGGAACCCCAAGCGAAATCACTGTTGTGGCAAGGGATGATGTTG
>TTN-208,ENSE00003805436,1,588,1750633,1751220,TGGCTCCTGATCTTGACTTAAAGGGTCTACCTGATTTGTGCTACTTGGCTAAAGAAAACAGCAACTTCCGGCTTAAGATCCCCATAAAAGGCAAGCCAGCTCCATCAGTCTCCTGGAAGAAAGGGGAAGATCCTCTAGCAACTGACACTAGAGTCAGTGTTGAGTCATCTGCGGTTAACACAACTCTTATAGTGTACGATTGCCAAAAATCTGATGCTGGAAAATACACAATCACACTTAAGAATGTTGCTGGCACCAAGGAAGGAACTATCTCCATAAAGGTTGTTGGCAAGCCTGGCATCCCCACTGGACCAATCAAATTTGATGAAGTCACAGCAGAAGCCATGACCTTAAAGTGGGCTCCTCCAAAGGATGATGGAGGTTCTGAAATCACCAACTATATCCTAGAGAAGAGGGATTCTGTGAACAACAAGTGGGTGACGTGCGCCTCAGCTGTCCAGAAAACCACCTTTAGAGTAACCAGACTTCATGAGGGCATGGAATATACCTTCAGGGTCAGTGCCGAAAATAAATATGGTGTAGGGGAAGGCCTGAAATCGGAGCCAATTGTTGCGAGACATCCATTTG
>TTN-208,ENSE00003808777,1,105,1751221,1751325,ATGTGCCTGATGCTCCCCCACCTCCCAATATTGTGGATGTCAGACACGATTCAGTATCTCTAACTTGGACTGACCCCAAGAAAACTGGTGGTTCTCCAATTACAG
>TTN-208,ENSE00003806939,1,198,1751326,1751523,GGTATCATCTCGAGTTCAAGGAAAGAAACAGCCTTTTGTGGAAGAGAGCTAACAAGACTCCGATAAGGATGAGAGACTTTAAAGTGACAGGATTAACTGAAGGTCTTGAATATGAATTCCGAGTTATGGCAATCAATTTAGCAGGTGTGGGCAAGCCAAGCCTACCATCAGAGCCTGTTGTGGCACTGGACCCAATTG
>TTN-208,ENSE00003811024,1,297,1751524,1751820,ATCCTCCTGGAAAACCTGAGGTTATTAACATAACAAGGAATTCAGTGACTCTCATTTGGACTGAACCTAAATATGACGGTGGTCATAAGTTAACTGGATATATAGTGGAGAAGCGAGATCTACCTTCGAAGTCTTGGATGAAAGCCAACCATGTTAATGTCCCAGAATGTGCCTTTACTGTAACTGACCTTGTTGAGGGTGGAAAATATGAATTCAGAATTAGAGCAAAGAATACAGCAGGTGCTATCAGTGCTCCATCAGAAAGTACAGAAACCATTATTTGCAAGGATGAATACG
>TTN-208,ENSE00003803896,1,588,1751821,1752408,AGGCACCAACAATTGTCCTTGATCCCACAATAAAAGATGGGCTAACAATTAAAGCAGGGGATACCATTGTTTTGAATGCCATTAGCATTCTTGGCAAACCCCTTCCAAAATCAAGTTGGTCCAAGGCAGGAAAAGACATTAGACCATCAGATATCACTCAGATAACTTCAACCCCAACATCTTCCATGCTTACTATCAAGTATGCCACTAGAAAAGATGCGGGTGAATATACCATCACTGCTACCAATCCTTTTGGCACGAAGGTGGAACATGTGAAGGTAACAGTCCTTGATGTACCTGGTCCCCCAGGTCCTGTTGAAATCAGTAATGTTTCTGCTGAAAAAGCAACACTTACATGGACACCTCCCTTGGAAGATGGCGGCTCACCAATTAAGTCCTATATACTTGAAAAGAGAGAAACCAGCCGACTTTTGTGGACAGTGGTTTCTGAAGATATTCAGTCTTGCAGGCATGTGGCAACCAAACTTATCCAAGGAAATGAGTACATCTTCCGGGTCTCAGCTGTAAACCACTATGGCAAAGGAGAACCTGTACAGTCTGAACCTGTCAAAATGGTAGACAGATTTG
>TTN-208,ENSE00003807419,1,303,1752409,1752711,GTCCCCCTGGCCCTCCTGAAAAACCAGAGGTATCAAATGTCACTAAGAACACTGCCACTGTCAGCTGGAAAAGGCCAGTGGATGATGGTGGCAGCGAAATTACAGGATATCATGTAGAAAGGAGAGAAAAGAAAAGCCTGCGATGGGTGAGAGCAATAAAAACACCAGTTTCCGATCTCAGGTGCAAAGTAACAGGACTGCAAGAAGGAAGCACCTACGAATTCCGTGTCAGTGCAGAAAACAGAGCAGGAATTGGTCCACCCAGTGAGGCTTCAGATTCTGTTCTGATGAAAGATGCAGCAT
>TTN-208,ENSE00003811193,1,17106,1752712,1769817,ATCCTCCAGGACCACCTTCAAATCCGCATGTCACTGATACTACCAAGAAATCTGCTTCTTTGGCATGGGGCAAGCCTCATTATGATGGTGGACTTGAAATCACTGGCTATGTCGTGGAGCATCAAAAAGTAGGAGACGAGGCCTGGATAAAAGATACCACAGGAACCGCCCTCAGAATCACTCAGTTCGTTGTTCCTGATCTTCAGACTAAAGAAAAATACAACTTCAGAATCAGTGCCATCAACGATGCAGGTGTTGGGGAGCCAGCGGTGATTCCAGATGTTGAAATCGTAGAACGGGAGATGGCTCCTGATTTTGAACTAGATGCCGAGCTTCGAAGAACACTTGTTGTTAGAGCAGGACTCAGTATTAGGATATTTGTGCCAATTAAAGGTCGTCCTGCTCCTGAAGTGACATGGACCAAAGATAACATCAACCTGAAAAACCGAGCCAACATTGAAAATACGGAATCATTTACTCTTCTGATTATCCCAGAATGTAACAGATATGATACCGGTAAATTTGTCATGACCATTGAAAACCCGGCTGGGAAGAAAAGTGGCTTTGTGAACGTCAGAGTCTTGGACACGCCAGGCCCAGTCCTCAACCTGCGGCCTACAGACATCACAAAGGACAGTGTCACCCTGCACTGGGACCTCCCTCTGATAGATGGAGGCTCACGTATAACAAACTACATTGTAGAGAAACGTGAAGCAACACGGAAATCTTATTCCACAGCCACCACTAAGTGCCATAAATGCACATATAAAGTTACCGGCTTGTCTGAAGGGTGTGAATATTTCTTCAGAGTGATGGCAGAGAATGAATATGGAATTGGTGAGCCAACAGAAACTACAGAGCCCGTAAAAGCCTCTGAAGCACCATCTCCACCAGACAGCCTTAACATCATGGACATAACTAAGAGCACCGTCAGCCTGGCATGGCCTAAGCCCAAACACGATGGTGGCAGCAAGATCACTGGCTATGTGATTGAAGCCCAAAGAAAAGGCTCTGACCAGTGGACCCACATCACAACCGTGAAAGGGTTAGAATGTGTTGTGAGGAATCTAACTGAAGGAGAGGAATATACCTTCCAAGTGATGGCAGTGAACAGCGCGGGGAGAAGTGCCCCTAGAGAAAGCAGACCCGTCATTGTCAAGGAGCAGACAATGCTTCCAGAGCTGGATCTCCGTGGCATCTATCAGAAACTGGTCATTGCCAAAGCTGGTGACAACATCAAAGTTGAAATTCCAGTGCTCGGTCGACCGAAGCCCACAGTGACATGGAAAAAAGGAGACCAAATTCTTAAACAGACACAGAGAGTTAATTTTGAAACCACAGCGACTTCAACCATTTTAAATATCAATGAGTGTGTCAGAAGTGATAGTGGGCCCTATCCATTAACAGCAAGGAACATTGTAGGAGAGGTTGGTGATGTCATCACCATTCAAGTCCATGATATCCCAGGGCCACCTACTGGACCAATCAAATTTGATGAAGTTTCATCTGATTTTGTAACCTTCTCTTGGGACCCACCTGAGAACGATGGTGGTGTACCAATAAGCAACTATGTAGTGGAAATGCGGCAGACTGACAGTACTACCTGGGTTGAGTTAGCAACCACCGTTATACGTACTACCTATAAAGCCACCCGCCTTACTACTGGATTAGAGTATCAGTTCCGTGTAAAAGCTCAGAATAGATATGGAGTTGGACCAGGCATCACATCAGCATGCATAGTTGCCAACTATCCATTTAAGGTTCCTGGACCTCCTGGTACCCCTCAGGTAACTGCAGTTACCAAGGATTCAATGACAATTAGCTGGCATGAGCCACTTTCTGATGGTGGAAGCCCCATTTTAGGATATCATGTTGAAAGAAAAGAACGAAATGGTATTCTCTGGCAGACTGTGAGCAAAGCTTTAGTACCAGGCAACATTTTCAAATCAAGTGGACTTACAGATGGTATTGCTTATGAGTTCCGGGTGATTGCAGAAAACATGGCAGGCAAAAGTAAGCCAAGCAAGCCATCAGAACCTATGTTGGCTCTGGATCCCATTGACCCACCTGGAAAACCAGTACCTCTAAATATTACAAGACACACAGTAACACTTAAATGGGCTAAGCCTGAATATACTGGGGGCTTTAAAATTACCAGTTATATCGTTGAAAAGAGAGACCTTCCTAATGGACGGTGGCTGAAGGCCAACTTCAGCAACATTTTGGAGAATGAATTTACAGTCAGTGGCCTAACAGAAGATGCTGCATATGAATTCCGTGTGATCGCCAAAAATGCTGCAGGTGCCATCAGTCCACCATCTGAGCCATCTGATGCTATCACTTGCAGGGATGATGTTGAGGCACCAAAGATAAAGGTGGATGTTAAATTTAAGGACACGGTTATATTAAAAGCAGGTGAAGCATTCAGACTGGAAGCTGATGTTTCAGGCCGCCCACCTCCAACAATGGAATGGAGCAAAGATGGAAAAGAGCTGGAAGGCACAGCAAAGTTAGAAATAAAAATTGCAGATTTCTCTACTAATCTGGTAAACAAAGATTCAACAAGAAGGGATAGTGGTGCCTATACCCTTACAGCGACTAATCCTGGTGGCTTTGCTAAACACATTTTCAATGTCAAAGTTCTTGACAGACCAGGCCCACCTGAAGGACCTTTGGCTGTAACTGAAGTGACATCAGAAAAGTGTGTACTATCATGGTTCCCTCCACTGGATGATGGAGGTGCCAAAATTGATCATTACATAGTACAGAAACGTGAAACCAGCAGATTGGCATGGACAAATGTAGCCTCAGAAGTCCAAGTAACAAAGCTAAAGGTCACTAAACTCTTGAAAGGCAATGAATACATATTCCGTGTCATGGCTGTAAATAAATATGGAGTGGGAGAGCCACTGGAATCAGAGCCTGTGCTTGCAGTGAATCCTTATGGACCCCCTGATCCGCCCAAAAACCCTGAAGTGACAACTATTACTAAAGATTCGATGGTTGTCTGCTGGGGACATCCTGATTCTGATGGTGGAAGTGAAATCATCAATTATATTGTGGAACGGCGTGATAAAGCTGGCCAACGCTGGATTAAATGCAACAAAAAAACTCTTACTGATTTAAGATATAAAGTGTCTGGACTGACAGAAGGACATGAATATGAGTTCAGGATTATGGCTGAAAATGCTGCTGGAATTAGTGCACCAAGTCCTACCAGTCCATTTTACAAGGCTTGTGACACTGTGTTTAAACCTGGACCACCAGGTAACCCACGTGTTCTGGATACAAGCAGATCATCCATTTCAATCGCTTGGAATAAACCTATCTATGATGGTGGTTCAGAAATCACTGGGTATATGGTTGAGATTGCCCTGCCAGAGGAAGATGAATGGCAGATTGTCACTCCACCAGCAGGACTCAAGGCAACTTCGTATACTATCACTGGCCTCACAGAGAATCAGGAATATAAGATCCGCATCTATGCCATGAATTCCGAAGGACTTGGGGAACCTGCCCTTGTTCCTGGAACTCCAAAGGCTGAAGACAGAATGCTGCCTCCAGAAATTGAACTGGATGCTGACCTGCGCAAAGTTGTTACTATAAGGGCCTGCTGCACCCTGAGACTTTTTGTTCCCATCAAAGGAAGGCCTGCACCTGAGGTGAAGTGGGCCCGGGACCATGGAGAATCTTTAGATAAAGCTAGCATCGAATCCACAAGCTCTTACACCCTGCTTATTGTTGGAAATGTAAACAGATTTGACAGTGGCAAATATATACTAACTGTAGAAAATAGTTCAGGCAGCAAGTCTGCATTTGTCAATGTTAGAGTTCTCGATACACCAGGCCCCCCACAGGATCTGAAGGTAAAAGAGGTCACTAAGACATCTGTCACACTCACATGGGACCCACCTCTCCTTGATGGAGGTTCAAAAATCAAGAACTATATTGTTGAAAAGCGGGAATCAACAAGAAAAGCATATTCAACTGTTGCAACAAACTGCCACAAGACTTCCTGGAAGGTAGACCAGCTTCAAGAAGGCTGTAGCTACTATTTCAGGGTTCTCGCAGAAAATGAATATGGCATTGGGCTGCCTGCTGAAACCGCAGAATCTGTGAAAGCATCAGAACGACCTCTTCCTCCAGGAAAAATAACTTTGATGGATGTCACAAGAAATAGTGTGTCACTCTCTTGGGAGAAACCAGAGCATGATGGAGGCAGCCGAATTCTAGGCTACATTGTGGAGATGCAGACCAAAGGCAGTGACAAATGGGCCACGTGTGCCACAGTCAAGGTCACTGAAGCCACTATCACTGGATTAATTCAGGGTGAAGAATACTCTTTCCGTGTTTCAGCTCAGAATGAAAAGGGCATCAGTGATCCTAGACAACTGAGTGTGCCAGTGATCGCCAAAGATCTTGTCATTCCACCAGCCTTCAAACTCCTGTTCAATACTTTCACTGTACTGGCAGGTGAAGACCTAAAAGTTGATGTTCCATTCATTGGCCGCCCTACCCCAGCTGTAACCTGGCATAAAGATAATGTACCACTGAAGCAGACAACTAGAGTAAATGCAGAGAGCACAGAAAATAATTCACTACTGACAATAAAGGACGCCTGCCGAGAAGATGTTGGCCATTATGTGGTTAAACTGACTAACTCAGCTGGTGAAGCTATTGAAACCCTTAATGTTATCGTTCTTGACAAACCAGGGCCTCCAACTGGACCAGTTAAAATGGATGAAGTGACAGCTGATAGTATTACTCTTTCCTGGGGCCCACCCAAGTATGATGGTGGAAGTTCTATCAATAATTACATTGTTGAGAAACGGGACACTTCCACAACCACCTGGCAAATTGTATCAGCTACAGTTGCAAGGACAACAATAAAGGCTTGCAGACTGAAGACTGGATGTGAATATCAGTTTAGAATTGCAGCTGAAAACAGATATGGGAAGAGTACCTACCTCAATTCAGAGCCTACTGTAGCCCAATATCCATTCAAAGTTCCTGGTCCTCCTGGCACTCCAGTTGTCACACTGTCCTCCAGGGACAGCATGGAAGTACAATGGAATGAGCCAATCAGTGATGGAGGAAGTAGAGTCATTGGCTATCATCTAGAACGCAAGGAAAGAAATAGCATCCTCTGGGTTAAGTTGAATAAAACACCTATTCCTCAAACCAAGTTTAAGACAACTGGCCTTGAAGAAGGTGTTGAATATGAATTTAGAGTCTCTGCAGAGAACATCGTGGGCATTGGCAAGCCGAGTAAAGTATCAGAATGTTATGTGGCTCGTGACCCATGTGATCCACCAGGACGGCCAGAGGCAATCATTGTCACAAGGAATTCTGTGACTCTTCAGTGGAAGAAACCCACCTATGACGGTGGAAGCAAGATCACTGGTTATATTGTTGAGAAGAAAGAATTACCTGAGGGCCGTTGGATGAAAGCCAGTTTTACAAATATTATTGACACTCATTTTGAAGTAACTGGCCTAGTTGAAGATCACAGATATGAGTTCCGGGTTATAGCCCGAAATGCCGCAGGAGTGTTTAGTGAGCCTTCAGAAAGCACAGGAGCAATAACAGCTAGAGATGAGGTAGATCCACCACGAATAAGTATGGATCCAAAATACAAAGACACAATCGTGGTTCATGCTGGTGAATCATTCAAGGTTGATGCAGATATTTATGGCAAACCAATACCAACCATTCAGTGGATAAAAGGTGATCAGGAGCTTTCAAACACAGCTCGATTAGAAATAAAGAGCACCGACTTTGCCACCAGTCTCAGTGTAAAAGATGCAGTACGTGTCGACAGTGGAAATTACATACTGAAGGCCAAAAATGTTGCAGGAGAAAGATCAGTTACTGTGAATGTCAAGGTTCTTGACAGACCAGGGCCACCTGAAGGACCTGTTGTTATCTCAGGAGTTACAGCAGAAAAATGCACACTAGCTTGGAAACCCCCACTTCAGGATGGTGGGAGTGACATCATAAATTATATTGTGGAAAGGAGAGAAACCAGCCGCTTAGTTTGGACTGTGGTTGATGCCAATGTGCAGACTCTCAGCTGCAAGGTTACTAAGCTTCTTGAAGGCAATGAATATACTTTCCGTATAATGGCAGTAAACAAATATGGTGTTGGTGAACCTCTTGAATCTGAGCCAGTAGTTGCCAAGAATCCATTTGTAGTACCAGATGCACCAAAAGCTCCAGAAGTCACAACAGTGACCAAGGACTCAATGATTGTTGTATGGGAAAGACCAGCATCTGATGGTGGTAGTGAAATTCTTGGATATGTTCTTGAGAAACGGGATAAAGAAGGCATTAGATGGACAAGATGCCATAAGCGTCTGATTGGAGAGTTGCGCCTGAGAGTAACTGGACTCATAGAAAATCACGATTATGAGTTCAGAGTTTCTGCTGAGAATGCTGCTGGACTTAGTGAACCAAGCCCTCCTTCTGCTTACCAAAAGGCTTGTGATCCTATTTATAAACCAGGACCCCCAAACAACCCCAAAGTCATAGACATAACCAGATCTTCAGTATTCCTTTCTTGGAGCAAACCAATATATGATGGTGGCTGTGAAATTCAAGGATACATTGTTGAAAAATGTGATGTGAGTGTTGGTGAATGGACAATGTGCACTCCACCAACAGGAATTAATAAAACAAACATAGAAGTAGAGAAGCTGTTGGAAAAGCATGAATACAACTTCCGTATCTGTGCTATTAATAAAGCTGGAGTTGGAGAACATGCTGACGTCCCTGGACCTATTATAGTTGAAGAAAAATTAGAAGCACCAGACATTGATCTTGACCTAGAACTAAGGAAAATCATAAATATAAGGGCAGGTGGCTCCTTAAGGTTATTTGTTCCTATAAAAGGTCGTCCTACACCAGAAGTTAAATGGGGAAAGGTGGATGGTGAAATCCGAGATGCAGCTATAATTGATGTCACTAGCAGTTTCACCTCTCTTGTTCTTGACAATGTCAACCGATATGATAGTGGAAAATATACGCTTACATTAGAAAACAGCAGTGGAACAAAGTCTGCCTTTGTTACTGTGAGAGTTCTGGACACGCCAAGTCCACCTGTTAACCTGAAAGTCACAGAAATCACCAAAGACTCAGTATCAATTACATGGGAACCTCCTTTGTTGGATGGGGGATCCAAAATAAAAAATTACATTGTTGAGAAACGTGAAGCCACAAGAAAATCATATGCTGCTGTTGTAACTAACTGCCATAAGAATTCTTGGAAAATCGATCAGCTCCAAGAAGGTTGCAGTTATTACTTTAGAGTCACAGCTGAGAATGAGTATGGTATTGGCCTTCCTGCCCAGACTGCTGATCCAATTAAGGTTGCAGAAGTGCCACAACCTCCTGGAAAAATAACTGTGGATGATGTCACCAGAAACAGTGTCTCTCTGAGTTGGACAAAACCTGAACATGATGGTGGCAGTAAAATCATTCAGTATATTGTGGAAATGCAAGCTAAACACAGTGAGAAATGGTCAGAGTGTGCTCGAGTAAAGTCTCTTCAGGCAGTAATTACCAACCTAACTCAAGGGGAAGAATATCTTTTTAGAGTTGTTGCTGTAAATGAAAAGGGGAGAAGTGATCCTCGGTCCCTTGCAGTTCCAATAGTTGCCAAAGATCTGGTAATTGAGCCAGATGTAAAACCTGCATTCAGTAGTTACAGTGTACAGGTTGGCCAAGATTTGAAAATAGAAGTGCCAATTTCTGGACGTCCTAAGCCAACCATTACCTGGACTAAAGATGGTCTCCCACTGAAGCAGACCACAAGAATCAATGTTACCGATTCACTGGATCTCACCACACTCAGTATTAAAGAAACTCATAAGGATGATGGTGGACAATATGGAATCACAGTTGCCAATGTTGTTGGTCAGAAGACAGCATCCATCGAAATTGTAACTCTAGATAAACCTGATCCTCCAAAAGGACCTGTTAAATTTGATGACGTCAGTGCTGAAAGTATTACATTATCTTGGAACCCTCCATTATATACAGGGGGCTGCCAAATCACCAACTACATTGTTCAGAAAAGAGATACAACCACCACAGTATGGGATGTTGTTTCTGCTACTGTTGCTAGAACTACACTCAAAGTGACCAAACTGAAAACTGGTACAGAATACCAATTTAGAATATTTGCCGAAAACAGATATGGACAAAGCTTTGCCTTAGAGTCTGATCCAATTGTAGCTCAATATCCCTACAAAGAACCAGGCCCTCCAGGTACACCATTTGCCACAGCCATTTCCAAAGACTCCATGGTCATACAGTGGCATGAACCAGTCAACAATGGTGGAAGCCCCGTCATAGGTTACCACCTGGAGAGAAAAGAAAGAAACAGTATTTTGTGGACAAAGGTCAACAAAACTATTATTCATGACACCCAATTCAAAGCACAGAATCTTGAAGAAGGCATTGAATATGAATTCAGAGTGTATGCTGAAAATATTGTTGGTGTAGGCAAAGCAAGCAAGAATTCTGAATGCTATGTAGCCAGAGATCCCTGTGACCCACCAGGAACCCCAGAACCAATAATGGTTAAAAGAAATGAAATCACTTTACAGTGGACCAAACCTGTGTATGATGGTGGAAGTATGATTACAGGCTACATTGTAGAGAAACGTGATTTGCCTGATGGTCGTTGGATGAAAGCTAGCTTTACAAATGTCATTGAAACTCAATTTACTGTGTCAGGTCTTACTGAAGATCAAAGATATGAATTCAGAGTCATTGCAAAGAATGCAGCTGGTGCAATAAGTAAACCCTCTGACAGTACTGGACCAATAACTGCCAAGGATGAGGTTGAACTCCCAAGAATTTCAATGGATCCAAAATTCAGAGACACAATTGTGGTAAATGCTGGAGAAACATTCAGACTTGAGGCTGATGTCCATGGAAAGCCCCTACCTACCATTGAGTGGTTAAGAGGAGATAAGGAAATTGAAGAATCTGCTAGATGTGAAATAAAGAACACAGATTTCAAGGCTTTACTTATTGTAAAAGATGCAATTAGAATTGATGGTGGGCAGTATATTTTAAGAGCTTCCAATGTTGCAGGTTCTAAGTCATTCCCAGTAAATGTAAAAGTATTAGATAGACCAGGACCTCCAGAAGGGCCAGTCCAGGTTACTGGAGTCACTTCTGAAAAATGCTCTTTAACATGGTCTCCACCACTTCAAGATGGTGGCAGTGACATTTCTCACTATGTTGTTGAAAAGCGAGAAACCAGTCGACTTGCCTGGACTGTTGTTGCTTCAGAAGTTGTGACCAATTCTCTGAAAGTTACCAAACTCTTAGAAGGTAATGAATATGTTTTCCGTATAATGGCTGTCAACAAATATGGTGTTGGAGAGCCTTTGGAATCTGCACCAGTACTAATGAAAAATCCATTTGTGCTTCCTGGACCACCAAAAAGCTTGGAAGTCACAAATATTGCCAAAGACTCCATGACCGTCTGTTGGAACCGTCCAGATAGTGATGGTGGAAGTGAGATTATTGGTTACATTGTAGAGAAAAGAGACAGAAGTGGCATTCGATGGATAAAATGTAATAAACGCCGCATTACAGATTTGCGTCTAAGAGTGACAGGATTAACAGAAGATCATGAGTATGAATTCAGGGTCTCTGCAGAAAATGCTGCTGGAGTTGGGGAACCAAGTCCAGCTACAGTTTATTATAAAGCCTGTGATCCTGTGTTCAAACCTGGCCCACCTACCAATGCACACATTGTAGACACCACTAAAAATTCAATCACACTTGCCTGGGGTAAACCCATCTATGATGGCGGCAGTGAGATCTTGGGATATGTAGTAGAAATCTGTAAAGCAGATGAAGAAGAATGGCAAATAGTTACTCCACAGACTGGCCTGAGAGTCACTCGATTTGAAATTTCAAAACTCACTGAACACCAAGAGTATAAAATACGAGTCTGTGCCCTCAACAAAGTTGGTTTAGGTGAGGCTACATCAGTTCCTGGTACTGTGAAACCAGAAGATAAACTTGAAGCACCTGAACTTGACCTTGACTCCGAATTAAGAAAAGGAATTGTTGTAAGAGCTGGTGGATCTGCCAGAATTCACATTCCATTCAAAGGTCGTCCAACGCCTGAGATCACTTGGTCTCGAGAGGAAGGTGAATTCACAGATAAGGTCCAAATTGAAAAGGGAGTAAACTATACCCAACTATCAATAGATAACTGTGATAGAAATGATGCTGGAAAATACATTCTTAAGTTGGAAAACAGCAGTGGATCAAAGTCTGCTTTTGTAACTGTGAAAGTTCTTGACACTCCAGGACCACCACAGAATTTGGCAGTCAAAGAAGTGAGAAAAGATTCTGCCTTCCTGGTATGGGAGCCACCCATCATTGATGGAGGGGCAAAGGTCAAGAACTATGTGATTGACAAACGTGAGTCAACCAGAAAAGCGTATGCTAATGTGAGTAGTAAATGCAGCAAAACAAGTTTTAAAGTGGAAAACCTTACAGAAGGAGCCATTTATTACTTCAGAGTCATGGCTGAAAATGAATTTGGAGTTGGTGTTCCAGTGGAAACTGTTGATGCCGTGAAAGCTGCTGAACCTCCTTCCCCACCAGGAAAGGTTACACTCACTGATGTGTCCCAGACCAGTGCATCACTTATGTGGGAGAAACCTGAACATGATGGCGGTAGCAGAGTCCTGGGGTACGTTGTTGAAATGCAGCCCAAAGGAACTGAAAAATGGAGCATTGTGGCTGAATCCAAAGTCTGTAATGCAGTTGTTACTGGTTTGAGTTCTGGACAAGAATATCAGTTCCGTGTCAAGGCTTATAATGAGAAAGGAAAAAGCGATCCAAGAGTGTTGGGTGTTCCTGTCATAGCCAAGGACTTGACTATACAGCCTAGTTTAAAGTTACCATTTAACACATATAGTATCCAAGCTGGAGAAGATCTTAAAATAGAAATTCCAGTTATAGGCCGACCAAGACCTAACATTTCTTGGGTCAAAGATGGTGAGCCTCTTAAACAGACAACAAGAGTAAACGTTGAAGAAACAGCTACCTCAACTGTTTTGCACATTAAAGAAGGTAACAAAGATGACTTTGGAAAATACACCGTAACGGCAACAAATAGTGCAGGCACAGCAACAGAAAATCTCAGTGTTATCGTTTTAGAAAAGCCTGGACCTCCAGTTGGCCCAGTTCGGTTTGATGAAGTTAGTGCAGACTTTGTAGTCATATCTTGGGAACCTCCAGCCTATACTGGTGGCTGCCAAATAAGCAACTACATTGTAGAGAAGCGAGATACAACCACCACCACTTGGCACATGGTATCAGCAACAGTTGCAAGAACAACAATTAAAATAACCAAACTGAAAACAGGCACGGAGTACCAGTTTAGAATTTTTGCTGAAAACAGGTATGGAAAAAGTGCCCCACTGGATTCTAAGGCAGTTATTGTACAATATCCATTTAAAGAACCTGGACCACCTGGAACTCCTTTTGTGACATCAATCTCAAAAGATCAGATGCTTGTGCAATGGCATGAGCCAGTGAATGATGGAGGCACCAAAATTATTGGCTACCATCTTGAACAGAAAGAAAAGAACAGTATTTTATGGGTCAAGTTAAATAAGACCCCCATTCAGGACACCAAATTCAAAACAACTGGGCTTGATGAGGGCCTTGAGTATGAGTTCAAAGTTTCTGCTGAAAATATTGTTGGCATTGGCAAGCCTAGCAAAGTGTCAGAATGCTTTGTTGCTCGTGATCCATGTGACCCACCTGGTCGCCCTGAAGCCATTGTTATTACAAGAAACAATGTCACACTGAAATGGAAGAAACCTGCCTATGATGGTGGTAGCAAAATAACAGGTTATATTGTAGAAAAGAAAGATCTACCTGATGGCCGCTGGATGAAAGCCAGCTTTACCAACGTATTAGAAACTGAATTTACAGTGAGTGGACTTGTAGAAGACCAAAGATATGAATTTAGAGTAATTGCAAGAAATGCAGCTGGAAACTTTAGTGAACCATCTGATAGTAGTGGTGCCATTACTGCAAGAGATGAAATTGATGCACCAAATGCCTCTCTGGATCCAAAATATAAAGATGTCATCGTTGTTCATGCAGGAGAGACTTTTGTTCTTGAAGCCGACATCCGTGGCAAACCTATACCTGATGTTGTTTGGTCAAAAGATGGAAAAGAACTTGAAGAAACAGCTGCTAGAATGGAAATTAAATCTACTATTCAGAAAACAACTCTTGTTGTCAAAGACTGTATACGGACTGATGGAGGACAATATATTCTGAAACTCAGCAATGTTGGTGGTACAAAGTCTATACCCATCACTGTAAAGGTACTTGACAGGCCAGGGCCTCCTGAAGGGCCTCTGAAAGTTACTGGAGTTACTGCGGAAAAATGTTACCTGGCATGGAACCCACCTTTGCAAGATGGTGGTGCTAATATTTCACATTACATCATTGAAAAGAGGGAGACAAGCCGACTCTCTTGGACCCAGGTTTCAACTGAGGTACAGGCCCTTAACTACAAAGTTACTAAACTTCTTCCTGGTAATGAGTACATTTTCCGTGTCATGGCTGTGAATAAATATGGAATTGGAGAGCCCTTGGAATCTGGGCCTGTTACGGCCTGTAATCCTTATAAGCCACCAGGTCCTCCCTCAACACCTGAAGTCTCAGCAATCACCAAAGATTCTATGGTAGTAACATGGGCACGCCCAGTAGACGACGGAGGTACCGAAATTGAGGGCTACATTCTTGAAAAACGAGATAAGGAAGGCGTTAGATGGACCAAGTGCAACAAGAAAACATTAACGGATCTGCGGCTCAGGGTAACTGGTCTTACCGAAGGCCATTCCTATGAATTCAGAGTTGCTGCTGAAAATGCAGCTGGTGTGGGAGAACCTAGTGAGCCATCTGTTTTCTACCGTGCGTGTGATGCCTTGTATCCACCAGGTCCCCCAAGCAATCCAAAAGTGACGGACACTTCCAGATCTTCTGTCTCCCTGGCATGGAGTAAGCCAATTTATGATGGTGGCGCACCTGTTAAAGGCTATGTTGTAGAGGTCAAAGAAGCTGCTGCGGATGAATGGACAACCTGCACTCCACCAACAGGATTACAAGGAAAGCAGTTCACAGTGACCAAGCTTAAAGAAAACACTGAATATAACTTCCGTATTTGTGCCATCAATTCTGAAGGTGTAGGTGAACCTGCAACTCTACCTGGCTCAGTGGTTGCTCAGGAGAGGATAGAGCCACCAGAAATAGAACTCGATGCTGATCTCAGAAAGGTGGTCGTTCTGCGTGCAAGTGCTACTTTACGCTTATTTGTCACTATCAAAGGTCGACCAGAACCCGAAGTTAAATGGGAAAAGGCAGAAGGCATTCTCACTGACAGGGCTCAGATAGAGGTGACCAGCTCATTTACAATGTTGGTGATTGATAATGTTACCAGATTTGACAGTGGTCGGTATAATCTGACATTAGAAAATAATAGTGGCTCCAAAACAGCTTTTGTTAACGTCAGAGTTCTTGACTCACCAAGTGCCCCTGTGAATTTGACCATAAGAGAAGTGAAGAAAGACTCAGTGACGTTGTCCTGGGAACCACCACTTATTGATGGTGGAGCTAAGATTACAAACTACATTGTCGAAAAACGAGAAACTACAAGAAAAGCCTATGCTACCATTACAAATAATTGCACTAAAACTACTTTCAGAATTGAAAATCTACAAGAAGGATGTTCTTACTACTTCCGAGTCTTGGCTTCCAATGAATATGGGATTGGTTTGCCAGCTGAAACAACAGAACCCGTTAAAGTGTCTGAACCACCCCTCCCACCTGGAAGAGTAACTCTTGTTGATGTGACCCGTAATACAGCTACAATTAAGTGGGAGAAACCAGAAAGTGATGGTGGCAGCAAAATTACTGGTTATGTGGTTGAAATGCAGACTAAAGGGAGTGAAAAGTGGAGCACCTGCACACAAGTTAAGACTCTAGAAGCAACTATATCTGGCTTAACTGCAGGAGAAGAGTATGTCTTCAGGGTAGCTGCAGTTAACGAAAAGGGAAGAAGTGATCCAAGACAACTTGGAGTGCCAGTAATTGCAAGGGATATTGAAATAAAGCCTTCAGTTGAGCTTCCTTTCCATACTTTCAATGTAAAGGCTAGAGAACAACTTAAGATTGATGTGCCATTCAAAGGAAGACCTCAAGCTACTGTGAACTGGAGAAAAGATGGTCAGACTCTTAAAGAGACAACTAGAGTCAATGTTTCTTCTTCAAAGACTGTAACATCACTATCTATTAAGGAAGCTTCAAAGGAAGATGTTGGAACTTATGAATTATGTGTTTCAAACAGTGCTGGATCCATAACAGTTCCTATTACTATAATTGTCCTTGACAGACCAGGACCTCCAGGTCCTATACGTATTGATGAGGTTAGTTGTGACAGCATAACCATTTCTTGGAATCCTCCAGAATATGATGGTGGCTGCCAAATTAGCAATTACATTGTTGAAAAGAAAGAAACCACCTCTACAACATGGCACATAGTTTCACAAGCAGTTGCAAGAACATCCATTAAAATAGTTCGCCTGACAACAGGAAGTGAGTATCAGTTCCGTGTTTGTGCAGAAAACCGCTATGGAAAGAGCTCCTACAGTGAATCTTCAGCTGTTGTTGCAGAGTATCCATTCAGTCCCCCAGGTCCTCCTGGTACTCCTAAAGTTGTGCATGCCACAAAATCTACCATGCTTGTAACCTGGCAAGTGCCAGTTAATGATGGAGGAAGTCGAGTAATTGGCTATCATCTTGAGTATAAAGAAAGAAGCAGCATTCTTTGGTCAAAAGCAAATAAAATCCTCATTGCTGATACTCAAATGAAAGTCTCCGGCCTTGATGAAGGACTGATGTATGAGTATCGTGTATATGCTGAAAATATTGCTGGAATTGGTAAATGCAGTAAATCTTGTGAACCAGTCCCTGCAAGAGATCCTTGTGACCCTCCTGGACAACCTGAAGTCACAAATATCACAAGAAAATCAGTGTCACTTAAATGGTCTAAACCACATTATGATGGTGGAGCTAAGATCACAGGATACATTGTTGAACGCAGAGAACTACCAGATGGCCGGTGGCTGAAGTGCAATTATACTAATATACAAGAAACATACTTTGAAGTAACTGAACTTACTGAAGATCAGCGTTATGAATTCCGGGTTTTTGCAAGGAATGCTGCTGACTCAGTTAGTGAGCCATCTGAATCCACTGGGCCTATTATAGTTAAAGATGATGTTGAGCCTCCAAGAGTTATGATGGATGTCAAGTTCCGAGACGTTATTGTTGTCAAAGCTGGAGAGGTCCTTAAGATAAATGCAGACATTGCAGGGCGACCTCTGCCAGTAATTTCCTGGGCCAAGGATGGTATAGAAATTGAAGAAAGAGCAAGAACAGAAATCATCTCAACAGACAATCATACTTTGTTAACAGTTAAAGACTGTATAAGACGAGACACTGGGCAATATGTACTAACACTGAAGAATGTTGCCGGCACTCGGTCTGTGGCCGTTAATTGCAAAGTACTTGATAAGCCTGGTCCACCAGCAGGACCACTTGAAATAAATGGCCTCACTGCTGAGAAATGCTCTCTTTCCTGGGGACGTCCCCAAGAAGATGGTGGTGCAGATATCGACTATTACATCGTAGAAAAACGTGAAACAAGCCACCTTGCATGGACAATATGTGAAGGAGAGTTACAGATGACATCCTGTAAAGTAACCAAGTTACTCAAAGGCAATGAATATATATTTAGAGTAACTGGTGTTAATAAATATGGTGTTGGTGAGCCCCTAGAGAGTGTAGCTATAAAGGCACTAGATCCATTTACAGTTCCAAGTCCACCCACGTCTTTGGAAATTACTTCTGTGACCAAAGAATCTATGACACTTTGCTGGTCAAGACCCGAGAGTGATGGAGGTAGTGAAATATCTGGATATATAATTGAAAGGCGAGAGAAAAATAGCCTAAGATGGGTGCGTGTAAACAAAAAACCAGTTTATGATCTAAGAGTGAAATCAACAGGACTTCGGGAAGGATGTGAATATGAATATCGTGTTTATGCAGAAAATGCTGCTGGCCTAAGTCTTCCAAGTGAAACCTCTCCCTTAATTAGGGCAGAAGATCCAGTGTTCCTACCATCTCCTCCATCCAAACCCAAAATTGTGGACTCAGGCAAGACAACTATAACTATTGCCTGGGTTAAGCCGCTGTTTGATGGTGGGGCCCCGATAACTGGATATACTGTAGAATACAAAAAATCTGATGACACTGACTGGAAAACTTCCATTCAGAGCTTACGAGGGACAGAATATACAATAAGCGGACTAACAACAGGAGCTGAATATGTTTTCAGAGTAAAATCTGTCAATAAGGTTGGTGCTAGTGACCCCAGTGATAGCTCTGACCCTCAGATAGCAAAGGAAAGAGAAGAAGAACCTTTATTTGATATTGACAGTGAAATGAGGAAGACCTTGATTGTCAAGGCTGGTGCCTCATTTACCATGACTGTGCCTTTCCGAGGAAGACCAGTACCCAATGTCTTGTGGAGTAAGCCAGACACTGACCTCCGTACTAGAGCTTATGTTGATACCACAGACTCTCGTACATCACTGACCATTGAAAATGCCAACAGAAATGACTCTGGAAAGTACACATTAACAATTCAGAATGTTTTGAGTGCTGCTTCACTGACCTTAGTTGTCAAAGTTTTAGATACCCCAGGTCCTCCAACCAACATTACTGTGCAAGATGTAACCAAAGAGTCTGCAGTGTTATCCTGGGATGTTCCTGAAAACGATGGTGGAGCACCAGTGAAGAATTACCACATAGAAAAACGTGAGGCCAGCAAGAAAGCATGGGTCTCTGTGACCAACAACTGTAACCGCCTCTCCTACAAAGTTACCAATTTACAAGAAGGAGCTATCTATTACTTCAGAGTCTCTGGAGAAAATGAGTTTGGTGTTGGTATACCAGCTGAAACAAAGGAAGGAGTAAAAATAACAG
>TTN-208,ENSE00003802597,1,297,1769818,1770114,AAAAACCAAGCCCACCTGAAAAACTTGGAGTAACAAGTATATCCAAAGACAGTGTTTCCCTGACCTGGCTGAAGCCTGAACATGATGGCGGAAGCAGAATTGTACACTATGTCGTTGAAGCACTAGAAAAAGGACAGAAAAACTGGGTTAAATGTGCAGTGGCAAAGTCAACCCATCACGTTGTTTCCGGTCTGAGAGAGAATTCTGAATACTTTTTCCGAGTGTTTGCTGAAAATCAAGCTGGCCTGAGTGACCCGAGAGAGCTTCTGCTTCCTGTTCTTATTAAGGAGCAACTAG
>TTN-208,ENSE00003802941,1,588,1770115,1770702,AACCACCTGAAATTGATATGAAGAATTTCCCAAGTCACACTGTATATGTTAGAGCTGGTTCAAACCTTAAAGTTGACATTCCAATCTCTGGAAAACCACTTCCCAAAGTGACCTTATCAAGAGATGGTGTCCCCCTTAAGGCAACCATGAGATTTAATACCGAAATTACTGCTGAGAACCTGACCATCAATCTCAAAGAAAGTGTTACAGCTGACGCTGGGAGATATGAAATCACTGCTGCCAACTCCAGTGGTACAACCAAAGCTTTCATTAACATTGTTGTGCTAGACAGGCCTGGTCCTCCAACTGGCCCTGTTGTTATTAGTGATATAACTGAAGAAAGTGTGACTCTCAAATGGGAGCCACCTAAGTATGACGGTGGAAGTCAAGTTACCAACTACATTCTACTCAAAAGAGAAACAAGTACTGCAGTGTGGACTGAAGTGTCTGCAACAGTTGCAAGAACCATGATGAAAGTCATGAAACTGACCACAGGAGAAGAATACCAATTCCGCATCAAGGCAGAAAACCGCTTTGGCATCAGTGATCATATAGATTCAGCTTGTGTGACTGTCAAACTACCATACA
>TTN-208,ENSE00003808789,1,303,1770703,1771005,CAACACCTGGACCACCATCTACACCATGGGTCACTAATGTTACTCGAGAAAGCATCACTGTGGGCTGGCATGAACCAGTGTCAAATGGAGGCAGTGCAGTCGTAGGCTATCACCTGGAAATGAAAGACAGAAACAGTATTTTATGGCAAAAAGCCAACAAACTGGTCATCCGCACAACTCACTTCAAAGTCACAACAATCAGTGCTGGACTTATTTATGAATTCAGGGTGTATGCAGAAAATGCTGCTGGAGTTGGAAAACCTAGCCATCCTTCTGAACCAGTCTTGGCAATTGATGCTTGTG
>TTN-208,ENSE00003806587,1,297,1771006,1771302,AACCCCCAAGAAATGTTCGTATCACTGATATTTCAAAGAACTCTGTCAGCCTTTCATGGCAACAACCAGCTTTCGATGGAGGTAGCAAGATTACAGGCTACATTGTTGAGAGACGTGACCTTCCAGATGGCAGATGGACCAAGGCCAGCTTCACCAATGTTACTGAAACTCAATTCATCATCTCTGGCTTGACTCAGAATTCCCAGTATGAATTCCGTGTCTTTGCTAGGAATGCTGTTGGTTCCATTAGCAATCCATCTGAGGTTGTAGGGCCCATTACTTGCATCGATTCTTATG
>TTN-208,ENSE00003807681,1,288,1771303,1771590,GTGGTCCTGTAATTGATTTGCCTCTAGAATATACAGAAGTTGTCAAATACAGAGCAGGTACATCTGTGAAGCTCAGAGCTGGCATTTCTGGCAAACCTGCGCCTACTATTGAGTGGTATAAAGATGATAAAGAATTACAAACCAATGCACTGGTGTGTGTTGAAAATACCACGGACCTCGCATCTATACTCATCAAAGATGCCGATCGCCTTAATAGTGGATGCTATGAATTAAAACTAAGGAATGCCATGGGCTCAGCCTCAGCCACCATCAGAGTACAGATCCTTG
>TTN-208,ENSE00003811102,1,300,1771591,1771890,ACAAACCAGGCCCACCTGGTGGACCAATTGAATTTAAGACTGTAACTGCTGAGAAGATCACCCTTCTCTGGCGGCCTCCAGCTGATGATGGTGGTGCAAAAATCACTCACTACATTGTGGAAAAGCGTGAGACAAGCCGCGTTGTGTGGTCTATGGTGTCTGAACATTTGGAAGAGTGCATCATTACAACCACCAAAATTATCAAAGGAAATGAATACATCTTCCGGGTCCGAGCCGTGAACAAATATGGAATTGGCGAGCCACTGGAATCTGATTCCGTTGTAGCCAAGAACGCATTTG
>TTN-208,ENSE00003802386,1,303,1771891,1772193,TTACACCTGGGCCACCAGGCATACCAGAAGTGACAAAGATTACCAAGAATTCGATGACTGTTGTATGGAGCAGGCCAATTGCAGATGGCGGTAGTGATATAAGTGGCTATTTCCTTGAAAAACGAGACAAGAAGAGCCTAGGATGGTTTAAAGTACTAAAAGAGACTATCCGTGACACCAGACAAAAAGTAACAGGACTCACAGAAAACAGTGACTATCAATACAGAGTTTGTGCTGTAAACGCTGCTGGACAGGGTCCATTTTCTGAACCATCTGAATTCTACAAAGCTGCTGATCCTATTG
>TTN-208,ENSE00003809908,1,306,1772194,1772499,ATCCTCCAGGTCCACCTGCTAAGATAAGAATCGCAGATTCAACCAAGTCATCCATCACCCTTGGCTGGAGTAAGCCTGTCTATGATGGGGGCAGTGCTGTTACTGGGTATGTTGTCGAGATAAGACAAGGAGAGGAAGAGGAATGGACTACTGTCTCTACCAAAGGAGAGGTCAGAACTACAGAATATGTGGTATCCAACCTGAAACCTGGAGTCAATTACTACTTCCGGGTATCTGCTGTAAACTGTGCTGGACAAGGAGAACCTATAGAAATGAATGAACCTGTACAAGCTAAAGATATACTTG
>TTN-208,ENSE00003808993,1,1767,1772500,1774266,AGGCACCAGAGATTGACCTGGATGTGGCTCTCAGAACTTCTGTTATTGCCAAAGCTGGTGAAGATGTACAAGTGTTGATTCCCTTTAAAGGCAGACCTCCACCTACTGTCACATGGAGAAAAGATGAGAAGAATCTTGGCAGTGATGCCAGATACAGCATTGAAAACACTGATTCATCCTCATTACTCACCATTCCTCAAGTTACTCGCAATGATACAGGAAAATATATTCTCACAATAGAAAATGGAGTTGGTGAACCTAAGTCTTCAACTGTGAGTGTTAAAGTGCTTGACACACCAGCTGCCTGCCAGAAACTACAGGTTAAACATGTTTCTCGAGGCACAGTCACTTTGCTCTGGGATCCTCCTCTCATTGATGGAGGATCTCCAATAATTAATTATGTCATTGAAAAGAGAGATGCCACCAAGAGAACATGGTCTGTCGTGTCACACAAATGTTCTAGCACATCCTTCAAGCTAATAGATTTGTCGGAGAAGACTCCATTCTTCTTCAGAGTTCTTGCAGAAAATGAAATTGGAATTGGGGAACCCTGTGAAACTACAGAGCCAGTGAAGGCTGCTGAAGTACCAGCTCCTATACGTGATCTCTCAATGAAAGACTCAACAAAGACATCTGTCATCCTCAGCTGGACCAAACCTGACTTTGATGGTGGTAGCGTCATCACAGAATATGTTGTAGAAAGGAAAGGTAAAGGTGAACAGACGTGGTCCCACGCTGGCATAAGTAAGACATGTGAAATTGAGGTTAGCCAACTTAAGGAGCAGTCAGTCCTGGAGTTCAGAGTGTTTGCCAAAAATGAGAAAGGACTGAGTGATCCTGTCACTATTGGGCCAATTACAGTGAAAGAACTTATTATTACACCTGAAGTTGACCTGTCAGATATCCCTGGGGCACAAGTCACTGTGAGAATTGGGCACAATGTGCACCTTGAATTACCTTATAAGGGAAAACCCAAACCATCCATCAGTTGGCTGAAAGATGGCTTGCCACTGAAAGAAAGTGAATTTGTTCGCTTCAGTAAAACTGAAAACAAAATTACTTTGAGTATTAAGAATGCCAAGAAGGAGCATGGAGGAAAATACACTGTTATTCTTGATAATGCAGTGTGTAGAATTGCAGTCCCCATTACAGTCATCACCCTTGGCCCACCATCAAAGCCCAAAGGACCCATTCGATTTGATGAAATCAAGGCTGATAGTGTCATCCTGTCATGGGATGTACCTGAAGATAATGGAGGAGGAGAAATTACTTGTTACAGCATCGAGAAGCGGGAAACTTCACAAACTAACTGGAAGATGGTGTGTTCAAGTGTTGCCAGAACGACTTTCAAAGTTCCTAATCTAGTCAAAGATGCTGAGTACCAGTTTAGAGTGAGAGCAGAAAACAGATACGGAGTCAGCCAACCACTTGTCTCAAGCATTATTGTGGCAAAACACCAGTTCAGGATTCCTGGTCCCCCAGGAAAGCCAGTTATATACAATGTGACTTCTGATGGCATGTCACTAACTTGGGATGCTCCAGTTTATGATGGTGGTTCAGAAGTTACTGGATTCCATGTTGAAAAGAAAGAAAGAAATAGCATCCTCTGGCAAAAAGTTAATACATCACCAATCTCTGGAAGAGAATATAGAGCCACTGGACTGGTAGAAGGTCTGGATTACCAATTCCGTGTATATGCTGAAAATTCTGCTGGCCTAAGCTCACCTAGTGACCCAAGCAAATTTACCTTAGCTGTTTCTCCAGTAG
>TTN-208,ENSE00003811205,1,294,1774267,1774560,ACCCACCTGGCACTCCTGACTACATTGATGTCACCCGGGAAACCATCACACTTAAATGGAACCCACCATTGCGTGATGGAGGCAGTAAGATTGTGGGCTATAGCATTGAGAAACGGCAAGGAAATGAACGCTGGGTGAGATGCAACTTTACTGACGTCAGTGAATGTCAGTACACAGTTACAGGACTCAGTCCTGGGGATCGCTATGAGTTCAGAATAATTGCAAGAAATGCTGTTGGAACTATAAGCCCGCCCTCACAGTCTTCTGGCATTATTATGACAAGAGATGAAAATG
>TTN-208,ENSE00003808021,1,288,1774561,1774848,TTCCACCAATAGTAGAGTTTGGCCCTGAATACTTTGATGGTCTCATTATTAAGTCCGGAGAGAGCCTTAGAATTAAAGCTTTGGTACAAGGAAGACCAGTGCCTCGAGTAACTTGGTTCAAAGATGGAGTGGAAATCGAAAAGAGGATGAATATGGAAATAACCGACGTACTTGGATCCACCAGCCTATTTGTTAGAGATGCTACTCGGGACCATCGTGGTGTATACACAGTGGAAGCCAAAAATGCATCTGGTTCTGCAAAAGCAGAAATTAAAGTGAAAGTACAAG
>TTN-208,ENSE00003804355,1,300,1774849,1775148,ATACACCAGGAAAAGTAGTTGGGCCAATAAGATTCACCAATATTACTGGGGAGAAGATGACTCTGTGGTGGGATGCCCCACTCAATGACGGTTGTGCTCCCATAACCCACTACATCATTGAAAAACGGGAAACCAGCAGACTTGCCTGGGCACTAATTGAGGATAAATGTGAAGCCCAAAGTTACACTGCCATTAAACTAATAAACGGCAATGAATACCAATTCCGTGTTTCTGCAGTTAACAAGTTTGGTGTTGGCAGGCCACTTGATTCTGATCCAGTGGTTGCTCAAATACAATATA
>TTN-208,ENSE00003807046,1,2067,1775149,1777215,CTGTTCCTGATGCCCCTGGCATTCCAGAACCTAGCAACATAACAGGCAACAGCATTACCCTGACATGGGCAAGGCCAGAATCAGATGGTGGCAGTGAAATTCAACAGTATATCCTTGAAAGAAGAGAAAAGAAAAGCACAAGATGGGTAAAAGTGATCAGCAAACGACCAATCTCTGAAACAAGATTCAAAGTCACTGGTCTGACAGAAGGCAATGAGTATGAATTCCATGTCATGGCTGAAAATGCTGCAGGAGTTGGACCTGCAAGTGGCATCTCAAGACTCATTAAATGTAGAGAGCCCGTCAACCCACCAGGTCCTCCCACAGTGGTCAAAGTAACAGACACATCAAAGACAACTGTGAGCTTAGAATGGTCCAAACCAGTGTTTGATGGTGGCATGGAAATAATTGGGTATATTATTGAAATGTGTAAGGCCGACTTAGGAGACTGGCACAAGGTGAATGCAGAGGCATGTGTGAAAACAAGATATACAGTCACTGATCTACAAGCAGGTGAAGAATACAAATTCCGAGTTAGTGCTATCAATGGTGCTGGAAAAGGCGACAGCTGTGAAGTGACTGGCACAATTAAAGCAGTTGACCGGTTAACAGCTCCTGAGTTAGACATAGATGCAAACTTCAAACAGACTCATGTTGTTAGAGCTGGGGCCAGTATTCGCCTCTTCATTGCCTACCAAGGTAGACCTACTCCTACAGCTGTGTGGAGCAAACCAGACTCTAACCTTAGCCTTCGGGCTGATATCCATACAACAGATTCCTTCAGCACCCTCACTGTGGAAAACTGCAACAGAAATGATGCAGGGAAATATACCCTTACTGTGGAAAACAACAGTGGTAGTAAGTCAATCACATTCACCGTGAAAGTGCTAGACACTCCAGGCCCACCTGGCCCAATTACCTTCAAAGATGTGACCCGGGGATCTGCTACATTGATGTGGGATGCCCCTCTTCTTGACGGTGGTGCCCGAATCCATCATTATGTGGTAGAGAAACGAGAGGCAAGTCGCCGTAGTTGGCAGGTTATCAGTGAAAAATGCACTCGTCAGATCTTCAAGGTCAATGACCTGGCCGAAGGTGTTCCGTACTATTTCCGTGTTTCTGCAGTAAATGAGTATGGTGTTGGTGAGCCCTATGAAATGCCAGAACCAATTGTAGCCACAGAACAGCCTGCTCCACCTAGGAGACTTGATGTTGTTGATACTAGCAAATCCTCCGCAGTCTTAGCTTGGCTTAAACCTGACCACGATGGAGGCAGCCGGATCACTGGCTACCTGCTTGAAATGAGACAAAAGGGATCTGACTTCTGGGTTGAAGCTGGTCACACCAAACAGCTAACTTTCACAGTAGAGCGTCTTGTTGAGAAAACTGAATATGAATTCCGTGTGAAGGCCAAGAATGATGCTGGCTATAGTGAACCCAGAGAAGCCTTCTCTTCTGTCATCATTAAGGAGCCTCAAATCGAGCCCACTGCTGACCTCACTGGAATTACCAATCAGCTTATAACTTGCAAAGCAGGAAGCCCATTTACCATTGACGTACCAATCAGTGGTCGTCCTGCCCCCAAAGTAACATGGAAACTGGAAGAAATGAGACTTAAAGAGACAGATCGAGTGAGCATTACAACAACAAAAGACAGAACCACACTGACTGTAAAGGACAGCATGAGAGGTGACTCTGGAAGATACTTCTTGACCCTGGAAAATACAGCTGGTGTTAAAACATTTAGCGTCACAGTTGTGGTCATTGGAAGGCCAGGTCCAGTAACCGGCCCCATTGAGGTCTCATCTGTCTCAGCTGAATCGTGTGTCCTGTCATGGGGAGAACCTAAAGATGGAGGAGGCACTGAAATTACTAATTACATAGTTGAAAAGCGTGAATCGGGTACAACAGCTTGGCAGCTTGTCAATTCCAGTGTCAAGCGCACTCAAATTAAAGTCACTCATCTCACAAAATACATGGAATATTCTTTCCGTGTCAGTTCAGAGAACAGATTTGGTGTCAGCAAACCTCTAGAATCAGCACCAATAATTGCTGAACATCCATTTG
>TTN-208,ENSE00003810611,1,303,1777216,1777518,TCCCACCAAGCGCTCCTACCAGACCTGAGGTCTACCATGTGTCTGCCAATGCCATGTCTATTCGTTGGGAAGAACCCTACCACGATGGTGGCAGTAAAATCATTGGCTACTGGGTTGAGAAGAAAGAACGTAATACAATTCTTTGGGTGAAAGAAAACAAAGTGCCATGCTTAGAGTGCAACTACAAAGTAACTGGTTTAGTAGAAGGACTGGAATATCAGTTCAGAACTTATGCACTCAATGCTGCAGGTGTTAGCAAGGCCAGCGAAGCTTCAAGACCTATAATGGCTCAAAATCCAGTTG
>TTN-208,ENSE00003803222,1,306,1777519,1777824,ATGCACCAGGCAGACCAGAGGTGACAGATGTCACAAGATCAACAGTATCACTGATTTGGTCTGCCCCAGCGTATGATGGAGGCAGCAAGGTTGTGGGCTACATCATAGAGCGTAAGCCAGTCAGTGAGGTAGGAGATGGTCGCTGGCTGAAGTGCAACTACACCATTGTATCTGACAATTTCTTCACCGTGACTGCTCTCAGTGAAGGAGACACTTATGAGTTCCGTGTGTTAGCCAAGAATGCAGCAGGCGTAATTAGCAAAGGGTCTGAATCTACAGGCCCTGTCACTTGCCGAGATGAATACG
>TTN-208,ENSE00003801213,1,291,1777825,1778115,CTCCACCCAAAGCCGAACTGGATGCCCGATTACACGGTGATCTGGTTACCATCAGAGCAGGTTCTGATCTTGTTCTGGATGCTGCAGTTGGTGGCAAACCTGAACCCAAAATTATCTGGACCAAAGGAGACAAGGAGCTAGATCTCTGTGAAAAAGTCTCTTTGCAGTATACTGGCAAACGAGCAACTGCTGTGATCAAGTTCTGTGACAGAAGTGACAGTGGAAAATACACTTTAACAGTGAAAAATGCCAGCGGGACCAAGGCCGTGTCTGTCATGGTCAAAGTGCTTG
>TTN-208,ENSE00003809128,1,297,1778116,1778412,ATTCCCCTGGCCCATGTGGAAAGCTCACCGTCAGCAGAGTAACACAGGAGAAGTGCACTTTAGCCTGGAGCCTTCCGCAGGAAGACGGAGGAGCAGAAATCACTCACTACATCGTGGAAAGACGCGAGACTAGCAGGCTCAACTGGGTGATTGTTGAAGGCGAATGCCCAACCCTATCCTATGTCGTTACCAGGCTCATCAAGAACAATGAGTACATATTCCGAGTGAGGGCAGTAAACAAATATGGCCCTGGTGTGCCTGTTGAATCAGAGCCAATTGTAGCCAGAAACTCATTCA
>TTN-208,ENSE00003803385,1,306,1778413,1778718,CTATTCCATCACCACCCGGCATACCTGAAGAAGTTGGGACTGGCAAAGAGCATATCATCATTCAGTGGACAAAACCTGAATCTGATGGTGGCAATGAAATCAGCAACTACCTAGTAGACAAACGTGAGAAGAAGAGCCTGCGCTGGACACGTGTCAACAAAGACTATGTGGTGTATGATACCAGGCTGAAGGTGACCAGCCTGATGGAGGGTTGTGATTACCAGTTCCGGGTGACCGCAGTGAATGCAGCTGGTAACAGTGAGCCCAGCGAAGCTTCCAACTTCATCTCATGCAGAGAACCATCAT
>TTN-208,ENSE00003807140,1,306,1778719,1779024,ATACCCCTGGACCACCTTCTGCTCCAAGAGTTGTGGATACCACCAAACACAGCATTAGTTTGGCATGGACCAAACCCATGTACGATGGTGGTACTGACATTGTAGGATATGTTCTGGAAATGCAAGAGAAGGACACTGATCAGTGGTACCGAGTGCATACCAATGCCACAATAAGAAATACTGAATTCACTGTGCCAGACCTTAAAATGGGCCAGAAATATTCCTTCAGAGTTGCTGCCGTGAACGTGAAGGGTATGAGCGAATACAGCGAATCAATTGCTGAAATTGAGCCCGTGGAAAGAATAG
>TTN-208,ENSE00003809946,1,282,1779025,1779306,AAATACCAGATCTTGAGCTTGCAGATGATCTAAAGAAGACTGTGACCATCAGGGCTGGGGCCTCCTTGCGCTTGATGGTGTCTGTATCTGGAAGACCACCTCCTGTCATAACGTGGAGCAAGCAGGGCATTGACCTTGCAAGCCGGGCAATTATTGACACCACTGAGAGCTACTCATTGCTAATAGTGGACAAAGTTAATCGGTACGATGCTGGAAAATACACAATTGAAGCTGAAAACCAATCTGGCAAGAAATCAGCAACAGTCCTTGTTAAAGTCTATG
>TTN-208,ENSE00003810384,1,594,1779307,1779900,ATACTCCTGGTCCCTGTCCTTCAGTGAAAGTTAAGGAAGTATCAAGAGATTCTGTGACTATAACTTGGGAAATTCCCACGATTGATGGTGGAGCTCCAGTCAACAATTACATCGTTGAGAAGCGTGAAGCTGCTATGAGAGCATTCAAAACAGTAACTACCAAATGCAGCAAGACACTTTACAGAATTTCTGGACTTGTAGAAGGAACCATGTACTATTTCAGAGTGCTGCCAGAAAATATTTATGGCATTGGAGAACCTTGTGAAACATCTGATGCAGTACTGGTCTCAGAAGTGCCTTTGGTGCCTGCAAAGCTAGAAGTGGTCGATGTCACCAAATCCACTGTTACCCTTGCCTGGGAAAAACCACTCTACGATGGTGGTAGCCGACTCACTGGATATGTTCTCGAGGCCTGCAAAGCTGGCACAGAGAGATGGATGAAGGTTGTCACCTTAAAACCCACAGTCCTAGAGCACACTGTTACTTCCTTAAATGAAGGTGAACAATACTTATTTAGAATAAGGGCACAAAATGAGAAAGGTGTGTCAGAACCAAGAGAGACTGTCACAGCCGTGACTGTACAAGACCTCAGAG
>TTN-208,ENSE00003802641,1,288,1779901,1780188,TGTTGCCAACAATCGATCTTTCTACAATGCCTCAGAAGACCATCCATGTCCCAGCTGGCAGACCAGTAGAGCTGGTGATACCTATTGCTGGCCGTCCACCTCCTGCTGCTTCCTGGTTCTTTGCTGGTTCTAAACTGAGAGAATCAGAGCGTGTCACAGTTGAAACTCACACTAAAGTAGCTAAATTAACCATCCGTGAAACCACTATCAGAGATACTGGAGAATACACACTTGAATTGAAGAATGTTACCGGAACTACTTCAGAAACCATTAAAGTTATCATTCTTG
>TTN-208,ENSE00003806194,1,300,1780189,1780488,ACAAGCCTGGTCCACCAACAGGACCTATTAAGATTGATGAAATTGATGCTACATCAATTACCATTTCCTGGGAACCACCTGAATTGGACGGTGGTGCTCCACTGAGTGGTTATGTGGTAGAACAACGTGACGCTCATCGTCCAGGATGGCTGCCCGTTTCTGAATCAGTGACTAGGTCCACGTTTAAGTTTACCAGACTCACCGAAGGAAATGAGTATGTGTTCCGTGTGGCTGCAACAAACCGCTTCGGGATTGGCTCTTACTTGCAGTCTGAGGTCATAGAGTGTCGCAGCAGCATCC
>TTN-208,ENSE00003805894,1,303,1780489,1780791,GTATTCCTGGACCCCCAGAAACATTACAGATATTTGATGTTTCCCGTGATGGCATGACACTTACTTGGTACCCACCAGAGGATGACGGTGGCTCCCAAGTGACTGGATATATTGTGGAGCGCAAAGAAGTGAGAGCAGATCGATGGGTCCGTGTAAATAAAGTACCTGTGACAATGACACGGTACCGCTCCACTGGCCTTACTGAAGGCTTAGAATATGAACACCGTGTCACAGCCATTAATGCAAGAGGGTCTGGGAAACCAAGTCGTCCTTCCAAACCCATCGTTGCCATGGATCCAATTG
>TTN-208,ENSE00003808643,1,303,1780792,1781094,CTCCTCCAGGAAAGCCACAAAACCCAAGAGTTACTGATACAACAAGGACATCAGTCTCCCTGGCCTGGAGTGTTCCAGAAGATGAAGGAGGATCTAAAGTCACAGGCTACTTGATTGAAATGCAAAAAGTAGATCAACATGAATGGACCAAGTGTAACACCACTCCAACCAAGATTCGAGAGTATACTCTAACACACCTACCTCAGGGTGCAGAATACAGGTTCCGCGTCCTAGCTTGTAATGCTGGTGGACCTGGTGAGCCTGCTGAGGTACCAGGAACAGTCAAAGTCACTGAAATGCTTG
>TTN-208,ENSE00003805779,1,585,1781095,1781679,AATATCCTGATTATGAACTTGATGAAAGATACCAAGAAGGTATCTTTGTAAGGCAAGGTGGCGTCATCAGACTTACCATACCAATCAAAGGAAAACCATTCCCAATATGTAAATGGACCAAGGAAGGCCAGGATATTAGTAAGCGTGCCATGATTGCAACATCTGAAACACACACTGAGCTTGTGATCAAAGAAGCAGACAGGGGTGATTCTGGCACTTATGACCTGGTTCTGGAAAATAAATGTGGCAAGAAGGCTGTCTACATCAAGGTCAGGGTGATAGGAAGTCCCAACAGTCCAGAAGGGCCACTGGAATATGATGACATCCAAGTCCGCTCTGTGAGGGTCAGCTGGAGACCTCCTGCTGATGATGGTGGTGCTGACATCTTAGGCTACATCCTCGAGAGACGAGAAGTGCCTAAAGCCGCCTGGTATACCATTGATTCCAGAGTCCGAGGTACATCTCTGGTGGTAAAAGGCCTCAAAGAGAATGTAGAATACCATTTCCGTGTTTCAGCAGAAAACCAGTTTGGCATAAGCAAACCCTTGAAATCTGAGGAACCAGTCACACCAAAAACACCATTGA
>TTN-208,ENSE00003806836,1,306,1781680,1781985,ATCCTCCAGAACCTCCAAGCAATCCTCCAGAAGTACTCGATGTAACCAAGAGTTCTGTTAGCTTGTCCTGGTCCCGGCCCAAAGATGATGGTGGTTCTAGAGTCACAGGCTACTACATCGAACGCAAAGAGACATCCACTGACAAGTGGGTCAGACACAACAAGACTCAGATCACCACCACAATGTACACTGTCACAGGGCTTGTTCCCGATGCTGAGTATCAGTTCCGCATCATCGCACAGAATGATGTTGGCCTGAGTGAGACCAGCCCTGCTTCTGAACCAGTTGTTTGCAAAGATCCATTTG
>TTN-208,ENSE00003810204,1,300,1781986,1782285,ATAAACCAAGCCAACCAGGAGAACTTGAGATTCTTTCAATATCCAAAGATAGTGTCACTCTACAGTGGGAGAAACCTGAATGTGATGGTGGTAAAGAAATTCTTGGATACTGGGTTGAATATAGACAGTCTGGAGACAGTGCCTGGAAGAAGAGCAATAAGGAACGTATTAAGGACAAGCAATTCACAATAGGAGGTTTGCTGGAAGCTACTGAGTATGAATTCAGGGTTTTTGCTGAGAATGAGACTGGGCTGAGCAGACCTCGCAGAACTGCTATGTCTATAAAGACTAAACTCACAT
>TTN-208,ENSE00003805486,1,576,1782286,1782861,CTGGAGAGGCCCCAGGAATACGCAAAGAAATGAAGGATGTTACCACAAAATTGGGTGAAGCTGCTCAACTCTCATGCCAGATTGTTGGAAGGCCTCTTCCTGACATTAAATGGTACAGATTTGGTAAAGAGCTCATACAAAGCCGGAAATACAAAATGTCTTCAGATGGACGCACACACACTCTTACAGTAATGACAGAGGAACAGGAAGATGAAGGTGTTTATACCTGCATAGCCACCAATGAGGTTGGAGAAGTAGAAACCAGTAGTAAGCTTCTCCTGCAAGCAACACCGCAGTTCCATCCTGGTTACCCACTGAAAGAGAAATATTATGGAGCTGTGGGTTCCACACTTCGGCTTCATGTTATGTACATTGGTCGTCCAGTACCTGCCATGACTTGGTTCCATGGTCAGAAACTTTTGCAAAACTCAGAAAACATTACTATTGAAAACACTGAGCACTATACTCATCTTGTCATGAAGAATGTCCAACGTAAGACTCATGCTGGGAAATACAAAGTCCAGCTCAGCAATGTTTTTGGAACAGTTGATGCCATCCTTGATGTGGAAATACAAG
>TTN-208,ENSE00003801306,1,306,1782862,1783167,ATAAACCAGACAAACCTACAGGACCAATTGTGATCGAAGCTCTATTGAAGAACTCCGCAGTGATCAGCTGGAAACCACCCGCAGATGACGGAGGCTCCTGGATCACCAACTATGTGGTGGAAAAATGTGAGGCCAAGGAGGGGGCTGAATGGCAATTGGTGTCTTCAGCCATCTCAGTGACAACCTGTAGAATTGTGAACCTCACAGAAAATGCTGGCTATTACTTCCGGGTTTCAGCTCAGAACACTTTCGGCATCAGTGACCCTCTAGAAGTGTCCTCAGTTGTGATCATTAAGAGTCCATTTG
>TTN-208,ENSE00003808123,1,594,1783168,1783761,AAAAGCCAGGTGCTCCTGGCAAACCAACTATTACTGCTGTCACAAAAGATTCTTGTGTTGTGGCCTGGAAGCCACCTGCCAGTGATGGAGGTGCAAAGATTAGAAATTACTACCTTGAGAAGCGTGAGAAGAAGCAGAATAAATGGATTTCTGTGACAACAGAAGAAATTCGAGAAACTGTCTTTTCAGTGAAAAACCTTATTGAAGGTCTTGAATACGAGTTTCGTGTGAAATGTGAAAATCTAGGTGGGGAAAGTGAATGGAGTGAAATATCAGAACCCATCACTCCCAAATCTGATGTCCCAATTCAGGCACCACACTTTAAAGAGGAACTGAGAAATCTAAATGTCAGATATCAGAGCAATGCTACCTTGGTCTGCAAAGTGACTGGTCATCCAAAACCTATCGTCAAATGGTACAGACAAGGCAAAGAAATCATTGCAGATGGATTAAAATATAGGATTCAAGAATTTAAGGGTGGCTACCACCAGCTCATCATTGCAAGTGTCACAGATGATGATGCCACAGTTTACCAAGTCAGAGCTACCAACCAAGGGGGATCTGTGTCTGGCACTGCCTCCTTGGAAGTGGAAG
>TTN-208,ENSE00003808212,1,5609,1783762,1789370,TTCCAGCTAAGATACACTTACCTAAAACTCTTGAAGGCATGGGAGCAGTTCATGCTCTCCGAGGTGAAGTGGTCAGCATCAAGATTCCTTTCAGTGGCAAACCAGATCCTGTGATCACCTGGCAGAAAGGACAAGATCTCATTGACAATAATGGCCACTACCAAGTTATTGTCACAAGATCCTTCACATCACTTGTTTTCCCCAATGGGGTAGAGAGAAAAGATGCTGGTTTCTATGTGGTCTGTGCTAAAAACAGATTTGGAATTGATCAGAAGACAGTTGAACTGGATGTGGCTGATGTTCCTGACCCACCCAGAGGAGTCAAAGTTAGTGATGTCTCACGAGATTCTGTCAACTTAACATGGACTGAGCCAGCCTCTGATGGTGGCAGCAAAATCACCAACTACATTGTTGAAAAATGTGCAACTACTGCAGAAAGATGGCTCCGTGTAGGACAGGCCCGAGAAACACGTTATACCGTGATCAACTTATTTGGAAAAACAAGTTACCAGTTCCGGGTAATAGCTGAAAATAAATTTGGTCTGAGCAAGCCTTCAGAGCCTTCAGAACCAACCATAACCAAAGAAGATAAGACCAGAGCTATGAACTATGATGAAGAGGTAGATGAAACCAGGGAAGTCTCCATGACTAAAGCATCTCACTCTTCAACCAAGGAACTCTATGAGAAATATATGATTGCTGAAGATCTTGGGCGTGGTGAGTTTGGAATTGTCCATCGTTGTGTTGAAACATCCTCAAAGAAGACATACATGGCCAAATTTGTTAAAGTCAAAGGGACTGATCAGGTTTTGGTAAAGAAGGAAATTTCCATTCTGAATATTGCTAGGCATAGAAACATCTTACACCTCCATGAATCATTTGAAAGCATGGAAGAATTAGTTATGATCTTTGAGTTTATATCAGGACTTGACATATTTGAGCGCATTAACACAAGTGCTTTTGAACTTAATGAAAGAGAAATTGTAAGTTATGTTCACCAGGTCTGTGAAGCACTTCAGTTTTTACACAGTCATAATATTGGACACTTTGACATTAGACCAGAAAATATCATTTACCAAACCAGAAGAAGCTCTACCATTAAAATCATAGAATTTGGTCAAGCCCGTCAGCTGAAACCAGGGGACAACTTCAGGCTTCTATTCACTGCCCCAGAATACTATGCACCTGAAGTCCACCAGCATGATGTTGTCAGCACAGCCACAGACATGTGGTCACTTGGAACACTGGTATATGTGCTATTGAGTGGTATCAACCCATTCCTGGCTGAAACTAACCAACAGATCATTGAGAATATCATGAATGCTGAATATACTTTCGATGAGGAAGCATTCAAAGAGATTAGCATTGAAGCCATGGATTTTGTTGACCGGTTGTTAGTGAAAGAGAGGAAATCTCGCATGACAGCATCGGAGGCTCTCCAGCACCCATGGTTGAAGCAGAAGATAGAAAGAGTCAGTACTAAAGTTATCAGAACATTAAAACACCGGCGTTATTACCACACCCTGATCAAGAAAGACCTCAACATGGTTGTGTCAGCAGCCCGGATCTCCTGTGGTGGTGCAATTCGATCTCAGAAGGGAGTGAGTGTTGCTAAAGTTAAAGTGGCATCCATTGAAATTGGCCCAGTTTCTGGGCAGATAATGCATGCAGTTGGTGAAGAAGGAGGACATGTCAAATATGTATGCAAAATTGAAAATTATGATCAGTCTACCCAAGTGACTTGGTACTTTGGCGTCCGACAGCTGGAGAACAGTGAGAAATACGAAATCACCTACGAAGATGGAGTGGCCATCCTCTATGTCAAAGACATTACCAAATTAGATGATGGTACCTACAGATGCAAAGTAGTCAATGACTATGGTGAAGACAGTTCTTATGCAGAGCTATTTGTTAAAGGTGTGAGAGAAGTCTATGACTATTACTGCCGTAGAACCATGAAGAAAATTAAGCGCAGAACAGACACAATGAGACTCCTGGAAAGGCCACCAGAATTTACCCTGCCTCTCTATAATAAGACAGCTTATGTAGGTGAAAATGTCCGGTTTGGAGTAACTATAACTGTCCACCCAGAGCCTCATGTAACATGGTATAAATCAGGTCAGAAAATCAAACCAGGTGACAATGACAAGAAGTACACATTTGAGTCAGACAAGGGTCTTTACCAATTAACAATCAACAGTGTCACTACAGATGATGACGCTGAATATACTGTTGTGGCAAGGAACAAATATGGTGAAGACAGCTGTAAAGCAAAGCTGACAGTAACCCTACACCCACCTCCAACAGATAGTACCTTAAGACCCATGTTCAAAAGGTTACTGGCAAATGCAGAATGCCAAGAAGGCCAAAGTGTCTGCTTTGAGATCAGAGTGTCTGGCATCCCCCCACCAACATTAAAATGGGAGAAAGATGGTCAGCCACTGTCCCTCGGGCCTAACATTGAAATTATCCATGAAGGCTTGGATTATTATGCTCTGCACATCAGGGACACTTTGCCTGAAGACACGGGTTATTATAGAGTCACAGCCACTAACACAGCTGGGTCCACCAGCTGCCAGGCTCACCTACAAGTGGAACGCCTGAGGTACAAGAAACAGGAATTCAAGAGTAAGGAGGAGCATGAGCGACACGTACAAAAACAAATTGACAAAACCCTCAGAATGGCTGAAATTCTTTCTGGAACTGAAAGTGTACCACTGACACAGGTAGCTAAAGAGGCTCTGAGAGAAGCTGCTGTCCTTTATAAACCGGCTGTAAGCACCAAGACTGTAAAAGGGGAATTCAGACTTGAGATAGAAGAAAAGAAGGAGGAGAGAAAACTCCGGATGCCTTATGATGTACCAGAGCCACGCAAGTATAAGCAGACTACCATAGAAGAAGACCAACGCATCAAGCAGTTCGTGCCCATGTCTGACATGAAGTGGTATAAAAAGATACGTGATCAGTATGAAATGCCTGGGAAACTTGACAGAGTTGTACAGAAACGACCCAAGCGCATCCGCCTTTCAAGATGGGAACAGTTCTATGTGATGCCTCTTCCACGCATTACAGATCAATACAGACCTAAATGGCGTATTCCTAAACTGTCCCAAGATGATCTTGAGATAGTGAGACCAGCCCGCCGGCGTACACCTTCTCCTGATTATGACTTTTACTACCGACCTAGAAGACGTTCTCTTGGGGACATCTCTGATGAAGAATTACTCCTCCCCATTGATGACTACTTAGCAATGAAAAGAACAGAGGAAGAGAGGCTGCGTCTTGAAGAAGAGCTTGAGTTAGGTTTTTCAGCTTCACCCCCAAGTCGAAGCCCTCCACACTTTGAGCTTTCTAGCCTACGTTACTCTTCACCACAAGCTCATGTCAAGGTGGAGGAAACAAGAAAAGACTTCAGGTATTCAACCTATCACATCCCAACGAAGGCTGAAGCTAGTACAAGTTATGCAGAACTGAGGGAACGGCATGCCCAGGCTGCGTACAGACAGCCAAAGCAACGGCAAAGAATCATGGCTGAGAGGGAGGATGAAGAGTTGCTTCGCCCAGTTACGACCACCCAGCATCTCTCAGAATACAAAAGCGAACTTGACTTCATGTCAAAGGAGGAAAAGTCTAGAAAGAAATCAAGGCGACAAAGAGAAGTGACAGAAATAACAGAAATTGAGGAAGAATACGAAATCTCAAAACATGCTCAAAGAGAATCATCCTCATCTGCGTCTAGACTACTGAGACGACGGCGCTCCCTGTCTCCAACTTATATTGAGTTAATGAGGCCAGTGTCTGAGCTGATCCGGTCACGTCCACAACCGGCTGAGGAATACGAAGATGACACAGAAAGAAGGTCACCTACTCCAGAGAGAACTCGCCCACGATCCCCCAGCCCTGTGTCTAGTGAGAGATCACTCTCGAGATTTGAGAGGTCTGCAAGATTTGATATCTTTTCCAGGTATGAGTCCATGAAAGCTGCTTTAAAAACTCAGAAGACATCAGAAAGGAAGTATGAAGTTTTGAGTCAGCAGCCTTTCACACTGGACCATGCCCCTCGAATCACACTGAGAATGCGCTCGCACAGGGTACCATGTGGCCAAAATACACGTTTTATTTTAAATGTTCAGTCTAAGCCAACTGCCGAGGTTAAATGGTACCACAATGGTGTGGAACTCCAAGAAAGCAGTAAGATTCATTACACCAACACGAGTGGAGTCCTCACCCTGGAAATTCTGGACTGTCATACTGATGACAGTGGAACCTACCGTGCTGTGTGCACCAACTACAAGGGCGAAGCTTCTGACTATGCAACGTTGGACGTGACAGGAGGGGATTATACCACCTATGCTTCCCAACGCAGAGATGAAGAGGTCCCCAGATCTGTTTTCCCTGAGCTGACAAGAACAGAGGCGTATGCTGTTTCATCATTTAAGAAAACATCTGAGATGGAAGCTTCGTCTTCTGTCAGGGAAGTGAAATCACAGATGACGGAGACAAGGGAAAGTCTCTCCTCATATGAACACTCTGCATCTGCAGAAATGAAAAGTGCTGCATTAGAAGAAAAGTCACTGGAAGAAAAATCCACAACCAGAAAGATCAAGACGACTTTGGCAGCAAGAATTCTAACAAAGCCACGGTCCATGACCGTCTACGAGGGCGAGTCTGCAAGGTTTTCTTGTGACACCGATGGTGAGCCGGTACCAACTGTGACCTGGCTGCGTAAAGGACAAGTGCTAAGTACTTCTGCCCGCCACCAAGTGACCACCACAAAGTACAAATCAACCTTTGAGATCTCTTCAGTCCAGGCTTCCGATGAGGGCAATTACAGCGTGGTGGTAGAAAACAGTGAAGGGAAACAAGAAGCAGAGTTCACTCTGACTATTCAAAAGGCCAGGGTAACTGAAAAGGCTGTGACATCACCACCAAGAGTCAAATCCCCAGAGCCTCGGGTGAAATCCCCAGAAGCAGTTAAGTCTCCAAAACGAGTGAAATCTCCAGAACCTTCTCACCCGAAAGCCGTATCACCCACAGAGACAAAACCAACACCAACAGAGAAAGTTCAGCACCTCCCAGTCTCTGCCCCACCAAAGATTACTCAGTTCCTGAAAGCAGAAGCTTCTAAAGAGATTGCAAAACTGACCTGTGTGGTTGAAAGCAGTGTATTAAGGGCAAAAGAGGTCACCTGGTATAAAGATGGCAAGAAACTGAAGGAAAATGGGCATTTCCAGTTTCATTATTCAGCAGATGGTACCTATGAGCTCAAAATCAATAACCTCACTGAATCTGATCAAGGAGAATATGTTTGTGAGATTTCTGGTGAAGGTGGAACGTCTAAAACCAACTTACAATTTATGGGGCAAGCCTTTAAGAGTATCCATGAGAAGGTATCAAAAATATCAGAAACTAAGAAATCAGATCAGAAAACCACTGAGTCAACAGTAACCAGAAAAACTGAACCAAAAGCTCCTGAACCAATTTCCTCAAAACCAGTAATTGTTACTGGGTTGCAGGATACAACTGTTTCTTCAGACAGTGTTGCTAAATTTGCAGTTAAGGCTACTGGAGAACCCCGGCCAACTGCCATCTGGACAAAAGATGGAAAG
>TTN-208,ENSE00003811220,1,157,1789371,1789527,GCCATTACACAAGGAGGTAAATATAAACTCTCTGAAGACAAGGGAGGGTTCTTCTTAGAAATTCATAAGACTGATACTTCTGACAGTGGACTTTATACTTGTACAGTAAAAAATTCAGCTGGATCTGTGTCCTCTAGCTGCAAATTAACAATAAAAG
>TTN-208,ENSE00003801641,1,692,1789528,1790219,CTATAAAAGATACTGAGGCACAGAAAGTCTCTACACAAAAGACTTCTGAAATTACACCTCAGAAGAAAGCTGTTGTCCAAGAGGAAATTTCCCAAAAAGCCCTAAGGTCTGAAGAAATTAAGATGTCAGAGGCAAAATCTCAAGAAAAGTTAGCCCTCAAAGAGGAAGCTTCAAAGGTTCTGATTTCTGAAGAAGTCAAGAAATCAGCAGCAACCTCCCTGGAAAAATCCATTGTCCATGAGGAAATCACTAAAACATCACAGGCATCAGAAGAAGTCAGAACTCATGCTGAGATTAAAGCATTTTCTACTCAGATGAGCATAAACGAAGGTCAAAGACTGGTTTTAAAAGCCAACATTGCTGGTGCCACTGATGTGAAATGGGTACTGAATGGCGTAGAGCTTACCAACTCTGAGGAGTACCGATATGGTGTCTCAGGCAGCGATCAGACCCTAACCATCAAGCAAGCCAGTCACAGAGATGAAGGAATCCTCACCTGCATAAGCAAAACCAAGGAAGGAATCGTCAAGTGTCAGTATGATTTGACACTGAGCAAAGAACTCTCAGATGCTCCAGCCTTCATCTCACAGCCTAGATCTCAAAATATTAATGAAGGACAAAATGTTCTCTTTACTTGTGAAATCAGTGGCGAGCCATCCCCTGAAATCGAATGGTTTAAAAACAACCTGCCA
>TTN-208,ENSE00003801638,1,154,1790220,1790373,ATTTCTATTTCTTCAAATGTCAGCATAAGCCGCTCCAGAAATGTATACTCCCTTGAAATCCGAAATGCATCAGTCAGCGACAGTGGAAAGTACACAATTAAGGCCAAAAATTTCCGTGGCCAGTGTTCAGCTACAGCTTCCTTAATGGTCCTTC
>TTN-208,ENSE00003805382,1,303,1790374,1790676,CTCTAGTTGAAGAACCTTCCAGAGAGGTAGTATTGAGAACAAGTGGTGACACAAGCTTGCAAGGAAGCTTCTCGTCTCAGTCAGTCCAAATGTCTGCCTCCAAGCAGGAGGCCTCCTTCAGCAGTTTCAGCAGCAGCAGTGCTAGCAGCATGACTGAGATGAAATTTGCAAGCATGTCTGCCCAAAGCATGTCCTCCATGCAAGAGTCCTTTGTAGAAATGAGTTCCAGCAGCTTTATGGGAATATCTAATATGACACAACTGGAAAGCTCAACTAGTAAAATGCTTAAAGCAGGCATAAGAG
>TTN-208,ENSE00003809884,1,1319,1790677,1791995,GAATTCCGCCTAAAATTGAAGCTCTTCCATCTGATATCAGCATTGATGAAGGCAAAGTTCTAACAGTAGCCTGTGCTTTCACGGGTGAGCCTACCCCAGAAGTAACATGGTCCTGTGGTGGAAGAAAAATCCACAGTCAAGAACAGGGGAGGTTCCACATTGAAAACACAGATGACCTGACAACCCTGATCATCATGGACGTACAGAAACAAGATGGTGGACTTTATACCCTGAGTTTAGGGAATGAATTTGGATCTGACTCTGCCACTGTGAATATACATATTCGATCCATTTAAGAGGGCCTGTGCCCTTATACTCTACACTCATTCTTAACTTTTCGCAAACGTTTCACACGGACTAATCTTTCTGAACTGTAAATATTTAAAGAAAAAAAAGTAGTTTTGTATCAACCTAAATGAGTCAAAGTTCAAAAATATTCATTTCAATCTTTTCATAATTGTTGACCTAAGAATATAATACATTTGCTAGTGACATGTACATACTGTATATAGCCGGATTAACGGTTATAAAGTTTTGTACCATTTATTTTATGACATTTTACAATGTAAGTTTTGAAACTAACTGTTGGTAGGAGAAAGTTTCTTATGGAACGAATACCCTGCTCAACATTTAATCAATCTTTGTGCCTCAACATACTGTTGATGTCTAAGTATGCCTCAGTGGGTTGAGAAAATCCCCATTGAAGATGTCCTGTCCACCTAAAAGAGAATGATGCTGTGCATATCACTTGATATGTGCACCAATACCTACTGAATCAGAAATGTAAGGCATTGGTGATGTTTGCATTTACCCTCCTGTAAGCAACACTTTAACGTCTTACATTTTCTCTGATGATGTCACACAAAATTATCATGACAAATATTACCAGAGCAAAGTGTAACGGCCAACACTTTGTTCGCTCATTTTACGCTGTCTCTGACATAAGGAGTGCCTGAATAGCTTGGAAAAGTAACATCTCCTGGCCATCCCTTCATTTAACCAAGCTATTCAAGTATTCCTATGCCAGAGCAGTGCCAACTCTTGGAGGTCCCAGAGTGCAGCCAATGCCTTTGTGTGGTAGTTCTAAATTTTAATTGCACCTGAAAAACCTGGGCACCTAAGCAATGAGCCACAGCAAAAAGTAAAGAACAACAACAAAATAAAGCTGTTGTTAAATTTTAAACAATATTACTAATTGCCCAAAATGTCAATTTGATGTAGTTCTTTTCATGCAAGTATAAATTCAATTGTTAGTTATAATTGTTGGACCTCCTTGAGATAGTAACAACAAAATAAAGCAAGCTATCTGCACCTCAAAA
>TTN-208,,0,2556,1791996,1794551,GTGAGCAGCAACTTTTCTTATTTTAATAGTAGAGTCACTTTCTTATTGATCTCTGGCTCTGGATTATTTGTGTGTGCTAAATGCCTATGTACAAGTGTTTGTATGACTATTTCTTGCCAGTGCTGACCCATTATTTAAATCTGCTTGTTAAATTCTATTTTAAAATGTCTGAACATTTTTCCTTAAAAAGTTGAAAGCTTTATTATATCAGCTAAATGATTCCATGATTCAAATTGTTTAAGTTCACTTAATATTCTAAAAGTTGAGGTCTGAAATGTTGAGAGAAATGTTTACTTCTTTTCTAGACTCTCTTTGCCTGTTGAGAATGTTCAAGGTTATATTACTCAATGATAAAGTTAAGCACACCAAGAATAGCTCTGATAAAATGCATGTGGTATCAGCTACACCCTGATGACTTTTTAAGGGAATCAACTGCTGAGGTATCAGTTGCAGGACAGTGACAGAACACTTGCCTGCTGTCAGTCAACCTTGGAGAGTTTAGGAGAGTTTATTTTAAGAGCATGACATTTTAGACGCATACCTTCAGCCCCAGTTAGACAAAGGCCTGTGAAGAGCAAGTGCTAAGGCAATAAAATTTACCTAGACAATAGGAATGTAAGATCAATTTAAGCTGGTTAATTGCAACATAGTTGGAGATTTGGAATAAAATGATATAATTGTTTTCTAAAATATTCAGAATCTCTTCATGCATTTTAACTCAGCACACAGTCCAATTATATATTTTGAGATAAATGTTGACACTAAGAAGGGTAAGAAATAATGTTTAAAGGAAAGGTTTCTTACTTCTAAATACACTTTGATTTCTCATCTTCCTAGAATTTGATTACTAATTGTCAATGCCTGTAAATACATAGATATATAATTAGGTATTCTATGTCTAAGAGGACAGCTATTTTTAGATATACTAACTTATAAACAGACAAAGTTAGACACAGAAAGTTGTTCATCCCAAAGATAATATGCTACAAAAAGGAGTTTCTGACAAAAAAAATTTATGAAAGCTTTTGGATATTATCTGATTTTTCCAAATATAAATTTTATTGTCTCAGAGAATGCTGGTTTCATTTTTTTAACTAAGTAGAAGGTTACAGTAAGGAACAGAATTATCACTAAGAAGATTATTGCTCCATGAAGTTTTAGTAAACAAAGAATTTAATGAAAAATAGTAATGAAGTGATTGACAATTCAGAAATGTTCTATTTCAGAACAGAATAGTCATGTTGAATAATTAGGTATTTATGCATCAGAAAATTCTTCACATAATGTCTCTGAAACTGATAGGCAAAGTACTTTCTTGCACTTAACAAAATGACTTAACTGCAAATTTTATATTCGTTTCTTTGATGTTGAATATTTTACTTTATGAAAGCATAGGCCTTTTCACTTCATCTACATTTTACACCAGCCTTCCATTATTCAAAGTTTGCAAATTGTTCCATATTAAGAACTCAAGCCAGCATTTTTCTTTCAGAACTATAATAAACTTTGGCCTGTTCACTAAAATTTAAATTTTTCTGAATATTTACTTCAGCAGTAACAACATTTACTGCACAGTTACAGTATGAAGAAATGTTAAGAAATAGAAAGCACCGTATGCCGTCTACAAAAAGCTTGCATATTTGATAAGGCTTGCCAAAGCTTCTCCAGTCAGGAAAGAGATTACAAAGTTCAGATTTTTACTTCTGGCAACTATTTTAAGTAATCAGATAATGTCTGAATCAATGTCAACTTTATAAATATAGAGTGAACGAAAAATATTGGGGAGAAGGAAAATTTTTAAAATAATTTTCACTTACTAAGCTGATGCAGAGGTTTATTTATTTTAATTTTTTTTTTTTTTTTTTTTTGAGACAGAGTCTCATTCTGTCACCCAGGCTGGAGTGTGGTGGCACCATCTTTGCTCACTGCAACCTCCACCTCCTGGGTTTAAGCAATTCTCATGCCTCAGCCTCCCAAGTAGCTGGGACTACAGACATGGGCCACCACGCCTGGCTAATTTTTGTATTTGTAGTAGAGACAGGGGTTTCACCATGTTAGCCAAACTGGTCTCAAACTCCTGACCTCAAGTAATCCTCCCGCCTCGGCCTCCTAAAGTGCTGGGATTACCAGCATGAGCCACCACGCCAGGCCCAGAGGTTTATTTTACATTTATCACATGTCTTGTCTCTCTAATTACACTTCACTAACCCTGCATTGCTGTGGTTTTCTTCTTCAACTCTGAACCTGGTTTTCCACCATTGGTAAGACTGTATATTCCCTCTTTGACCACTAGGGTTCATTCCTTGTTCTGTTTGGCTAATACTTTTTTCCATTTCCCCTTACACTTGCTACTTTGGGTTAGGCTTTAAGTCAACTCAATGATGAACTATGCAAAACTGTTCAAGCCACAAAAGAGAAGACCTGCCCATCACTCTAGGCCCACAGATGACCTATGGAGCAATCCATTTGGAGAAACGTGTGTCTCTGCTATCTGCAAAGCAGCTCCAGAGTGACCCTTAGCTGGGACACCCTAATTTATTTTCTCTTCTTTTTCAG
>TTN-208,,0,2210,1794552,1796761,GTAAGCTCACACATTCACACTTTTGTTTTTTTTTCCTTTGCCTCCTCTCCAGTAAGTTAACGTTGCTGCAGGACTTGACGCCAAGTTTAAGCCCTGCTTTCACTTCGGAAAATTAGTCCAACACTATGGAAAGGTCATTTTAAGGGTATACCATTCACAGAGTACTGACAAAATCTGACAATATAATGGCTTGAAATGTTTTATTCATATTTATTATTCCACAAAGCAAAAATAATTAGTGTTGGATTAAAATTGCCGTTAGAATCCAGCAACTAAATAGGACCAAATTTAGTCATTCTATATTTGGGCTCAGCTGCAGAGCCAGACTGGAAGCCAAGAACTCAAGCCCAATAGAAGCCAGCCACAGAGCCATGGGGTAGGCAGTCTGGGCTGCCTGCTCTGGACACCTGAACTTCAGTTGGTTCACACGCAAAATAACAGTGCATCTAATTTTCCTCAGAGGCAGAGCTGTTCAGTAATTAACCAACTCCTCATTATTTTATTATTTTATTTTCAATCTTTATTGAGTGATTCTAATGAATTAAAAGACTTTCCAATCGTTTTGAAATGACAGAAAATAATATGCTTCTCGGGTGTCTCTATTTAAAAGGAAGCAAACACTAACCCTAGAATTTTATCTGAAAGGAAGTTCATCTCTTTTTTGCCTTCTTTTTCTTCCTCATAACTCAGTTTATGGATGGTTCAAAAAAATGCATGGTATCATCTTATGAAAAAATGGAGAGTAGTGTATGAACTATATTGTAAATAATTTTAAAATTAATCAATATTTTCTCTTTCTGTAGTATTGTAACGAGCCATGTAAGATGGATACGGATTAAAAAAAATCATGCTTAATTCTTAATTTAGTGCACTTCCATGGTTCATTGCCCACTTCTTTTTTAAAATTTTATGGCTTATAATAAAGATATAAAATAAAATTTCTTTTTTTCTCTTTTTTTCTATTATATGCACCAATCTTATTCATAACTGGATAATACTTTCTTTTACATTGTACAAATATCATATAATCATTGCTTATTTTCTATTGTACATATATAGACCAATGAAATTCCCTTTTCATTGGTCTATATATGTACAATAGAAAATAAGTCTTACCGACTTCCAAATAATTTACCTATTTATCTGGTAACACTCAGTAACTTCTGAACTGAGCAGAACACATATGACTTCAGTGGGAATTTGCCTCCTTGAGAAGTAGTGGAATCTGGCTACTTCATATCTTCTTGTTCCTTCAAACTATATGCAAATAAATTATTACAAAGACACTACTGAAAATATCCAATACCCATAAATCAGTCCAATAAACTATTTAATTGGCCATAGTGGGAGATGGGCTAATGTATAAACAACAAAATAGACTTTCTCTAGATTATCTTTACCTACCAGCGTAAGTAGATAGAGCATCAACCTTTATGCCAAGTGTGAAATAAATCATGCCCTGAATGTGCCTCGTACATTCTCAATGTACAGAGTTTTAATATATTTAAAACATCAAACCATGGACATGTAGTTCTTGGCTCTACAATTTATGGCAGATAAAGAGAATTTGGCTTTCTACCTGCAATTCCAATGATCCATGTTGTTCTGGAAGACTAGGTTTGGATTAGTCTCTTATGAGAAATTGCTTGTCCATGTTACAATGTTTTTACTGATTGCACTTGTGAAAGCAGAAGAGTCCAAGAAGACAGTGTCCCTGTAACCACAGAGGAGGGAGGAGGGCATGCCTCCTGGGCTTGTCAGGCAGAAACTGGAGATCAGTTTGCTGCTTTTGTTCTTCACTTGCTCTCAAAGAGGACAACAATCACTCTTTATTTCAAATTTTCCTTGGTTCTTCATTTTTATAAGTCCCTTTCATGATTTTAATGTTGTCTATTAAATTGCATCAGATAGAGCCCTAGGCAGGCAGGCAGGAGATGGAAATTCTAGTCCCCTCTGTGTCACTGCTAGCTGAAGGACCTTGGAAAAATCATTAGGCCTCTTTTGGTCTCAGTTTCCTCCCTTCCTGCCTTCCTAATGGTCTGCAGGTTTACACACTGATCATGCAACTGTAGGGTTTTCCCTATCATTAAGTGGCATTCCATGCTGGAAAGCTTTTACAGATTCGGACAAGGCAGTGAACATGATGGGACAGAGCAGAGGACTTTGTGGTGCCCATTCAAACATAAAGGTGAATTGTTCTTGCTCTTCAG
>TTN-208,,0,1455,1796762,1798216,GTAGGCTGCTGGGGACCTGCCAATCCTCTGCTCCCCCAGAGGACATCTCCAGCAAATTGGGAAAGGAGTCCAGAAAAAGCTATGGGCAGAGGTAGATGCAGCTCTTAAACTACAGAAGGGTCTACTGGAGGCTGAATTATTTATAACCAAGTTGTTTGCCTTTTGGAATTTAATTTTCCTCTAGAGTACATCGTAAAAGTGACTGAGAATCAGTTTCTCAATACACATATTAAACACTCAAAAGTATGTTAAGGAAATATTAAAAATCATGTTTCTCAGCAAGTAGAAAAGCTTGGAGCCTTGTTTATAAGTCCTTTAAGGAATAAGACATATTCTCCAGGGAAGTGTGAATCTCCAGGAATTCACACTTTAACAAGCATCCAGATAATTCTGATGCCGGTAGTCTACAGACCACCCATTTAAGAGGCATGTAAACATACCCAGAAGAAAATAAATGCTTGTTTATTATTCAAATGCATGACACTGTTTCCCCAGAAAACTTATCACCAATCTTAGTGGCCTCTGTTGTTTTTCTCTATCCTTTACTACCTAGTGAGACATTAGTATACAGAATATTGCATGCCTTTACATGTTTTATAACAATATCTTACATGAGCTACGTAAAGTTACATATGCTTATCCAATAAACTTTACCTTCAATGATGTTCAATTATAGGGCTATAATTGACCTAAGCAGAAACCACATCAAGTAACATCAGGTAGAACTTTAGCATGCACCCAGAAAATTCACAAATGGAAAATGCACAGGGTTGGCAGCACCTGCTGTTGTTTATTACTCAAAATCATGTCAAAGTTAATTCCACTCACTCCTCACACTTATAAAAAATTTCCTTCAACATAACCAAAAAAATCCCCTTTCTGTAACACAATTAAAATGAAGTAATGTTATTATTGGGATTAACGTTTTAAATGCAAGTAAATATTTGGGTTATTTGAATACCTATCAAGTTGGAGAAGGTTTAGAATTTTAAAAATTAAATTAAAAATGTAATGATTCTTTAAGTAACAGGTACACCCATCGTAGCAACCACTGGAATTCATTTTAATGCAACTTACTGGAATATGCAACATGGCTTTCACATATTAATAGAGCGCTAGATGTGAGGTAGAGGGGGAAGTACCAGAAAGATTCTCAAGAAATGTTATAACAAAATCTAGAGCTTTTATTTAAAACAAAGAAACAAAAGGTGGTGGCCTAAACTGCTCAGCAAAACAAAGCAAATAAAATAAAATATGGTGGTGAGAAAGCCTTCTGTAATCTCCTGGCTCCCATTCTTGCTGTCATTGCTGGGTGAGCTGGGTTCAAGGACATTCAAGGATGTTTAGATTGGCGAGTCATCACCTGGTTTTGGAATTGGAGCTGTGATTATTTAAAAATACCTTGTAGGGAGCACCCTGGCTCTCACTCTTGACTTTGTTCTCTTGTCCCCGCAG
>TTN-208,,0,484,1798217,1798700,GTACGTGCTGGAGGTTGAGGAACAGAGAGAAGGGGAGAGAGCTGGTTTGTGTCTAAATGGGGCCAAGCGTCCACTTGCCACCTCTCACAGCCCTGGGAAGAATGCTGTGAGCTGATATAAAAGCTGGCTTTTCGACACCCATGAAAAGTCCCTGAGATTCTAGTCAGGAGCGCAGAATAGAAGCAATCTGTGCTTATGAATCTCATTATAAACTGGAAAGGGTTTCAATTAAGTGATCTACATTTCCAAATTATTGGCAAATAATGAAATTTTAAAAAATCATTCTAAGTAAATTTTTATCTTGTAATGAACATTTTCTATTTTTAAACCTAATTTATATTCATGCAAAATCCAAAACTTTCTGCAATTTTCTCCATTGGGATATCCAGAAAATCTTTTTGACTTTGTAGTCAGAATTAACAGAATCTCTTTTAAAATGGGTCATTGTGCCCCCTCCCAAACATTCATCTTTCCCTTCCCACAG
>TTN-208,,0,93,1798701,1798793,GTATTTTTCTATACTGTTGGTTTTCAAGCCTTTCAGGCTGTTGCGTCCCCAGCTATTCCTCCTCAACGTGGGCTTTGTTTTAATCTTTTACAG
>TTN-208,,0,4234,1798794,1803027,GTAAAGCTGCCATAGAGAGAGCAGATTATTGCACATTTTGGAACTAGGTTTTGAAACGAGAAAGATTCCCTTGTCCCCCTCGCAGGGCATGCGACGCGGAGAGTGGTTCGCTTCTTCAGTGTCCCGCTGCTCAAACCTCTAGGGGAGCATACAAACGGGCAGGTTGTGGGGCTCCGTGTTCCTCTGGACATCCAGCCGCTTGTGTGTCTGCCTACTAGGGTCTCAGGGGTTTTTATAGGCATAGGGTGTGGGCGTGGCAGGTCAGGGTGATCTTGGGAAATGCAACATTTGGGCGGGAAGGCAGGAGTGTTTGTCCTCACCTAGGTCCATGGGCACAGGCCTCGCTAGGGACCACGCACTTCTCTTCCCAGCACTTCCCTGCCCTCCTCCCGTGTAAGTTTCATGCACTCAAAAATGTAGCAGGTGACAAAGGAGGTAAACCAAGAAGTTACTGAATATGATTTTCACAAATCCTCACTGTCCACAGGTAAATTGAAGACCCTTATAAACTTCTGAATTCTTATTTATATTTCATGTAATAAATATCTACTTTAGGGGCCAAAATATGGCACAGTGAAAGGAGAAGAGCACAGAAGTTAGAGTTCAAAGCCCTAAGGACAAATCAGCCTGATCACTTAACAGTTTGATTTAGGGCAATAAGTATAAATAATAAAATAATTGTTATTATATATGGATCACTTCCTCTATCAGATTGGAACTATACATACATTATCTCATTAAATGTTCACAACCTGTAAGAATTATTATCCTCAATGTTATTGATAGGTAACTGGAATTAAAGAAGTTAAGCAGTTTATTTAAGGTTTCAGTTGTGTCATCTGTAAATTAAAGAGAGTCACAATAAGAATGATCTCAAGCTGCATTTTGGGGCTTCAATGAGATAATTAGTTGAAAGTGCCTTGTAAATAGAAAATAATTATGCCAATATTCTTATATTCAGATGGTAAGTAAAACCTTTTAAATATTTTGCATATGCTTGTGTTATTTTATCTAGAAAATAAAATGGACTTCTATGCTTACTTAATATGGAAGTATTTTAGAAGGTGATCATGTATCATGATCAGGGCTCAGAAATTATATAATCAAGTGTAAATTGTCCACAACAGTTTTGAAAGTTTGGGATTTAGTTTATCATGATGAAACTTTTAATATGATGAAATGAAAAATGTACAAAATTTGAGCAAAGAAGTGTTTATTGATCAATTTAAATGAAATAAAAAACACATGGATGTTCCCTGCCAAGAAAATTTTTTATAAAAGAATAATAAGGAGATAGTTGACCTAAATAATATTCAAACATACTGTAAAGTTACTATAATCAGAACAGTATGGTATTGGTAAATGAATAGAAAAATACACCAGGGGAACAAAACAGAGAGTCCAGAAAGAGATCCAAGTATAATAGATCCAAGTATATAGGGAATTCAAAAAGCAAAGTGGCCTTTCAATTCAGGGGAGGGAGAGGTATTTTAATAAAGAATGCTGGTCCAATTAGCTATCCATCTGGAAGCAAACAAACATAAACCTCTGCCTCTCACTATTTACAGAATAAATTTCAGCTTGATTAAATAGTTAAAAAATGAAAAAAAAAGAGAAGACAATCTGCAAAAGCATTTATGGGTGAAAGCTTTTAAAAAGACAGTTACAGATTCAACTACATAAAAATCAACATGTATGTATGGCAAAAGCAAAAAGTCATTTCTAAACCAAACAGCACTTGTGAAAAAATTTTAAGACCTTTCTCCTCCTCAAGGTACTTCATTGCCTCTGCCATAAAAGTATCACAATAAACATAAAATGGCTACAAGGTAGACAACACCAGCCTAGAAACAGTATATAACATACAAAATTACGTAAGCTTATGCTGGATAAGACCCATAAACAAGCAAAATATTGAAATGGATTAAAAGAAATGGATCTGGGGGAATGTTTGCAACACTTACGACAAATAACCAATAAATGCACTAAATGCATTAAAAATCATCCACAAATTAATTTTTAAAGGAAAAAAATGCAACACAAAAAAAGACAAAAGATACAAAAAAGTATTTAACATAAGAGGCAATGTAAAAGTCCAATAAACATGTGAAAAAAAATGCTAGATGTTTTCCAATTTTTATTGTTTTAGCCACAAAAATGTAAAGATATTGGCAAACACTAACATGAAACCTTGAACAAAAAGCTTACTTTAAAAAACATGTCTAGCAGTCGAATAAAAAAAAATGTTCAGTCTCAGGCTAAATCCAAGTTTGCACACCATGAAATCACAACACAAGCCAAATGCAATTTCTTGAGGAGATAACAACCTAACTATATTTTAAAACCCAAGCCTAAGGGTCATTTAGAATCATGGAGTGTCCCTGATCCCATGGAGCATTTTGACCATCTTAGCAGTTTTGAAAGTTCATTAATAACCATCCAAATTGCCCCAAAATTTTGCTTTCCAATAATTAAGAAATAAAATGCCAATTTGCAGAGAAAATAATGGTTATCAAAGATAGACTGCTTCCTAAATATCTCATAGTTTAATCTTGATTTTTGTTGTAGAGTAAGGCAAACATATTTCATTGAATAAGGTGCATTGTATCTCGCTGTGACCAGGTGATTATTTTTTGTTGTAAGTACAGAAATAAGCACTCTCCTATAATGACCAAAATTACAATGATTTTCACAGTTATGGGCTTACCTGTGTCCTGCTGTTAATCAGTCATGTCATGCTAATCATGTCTTTAACTCTTTTTGAATTAAACCCATTTACTAAGTACAGCAAGAACAAGGCACAGGGTGAAACTTAAAAGCACATGTCTCTTTGCTTTTCTTCAGTTAGTGGAAACCACACATTATTCTAACTTGGTTTTTGTTATATTTCAAAGGCAGTCATGTTCAGAAAAGAGGCTTATTCCCTAGATTTCCCTTTAGTTTGATTACAACTTCATTTACAAAATGTAAATGGATTTTCACACAAAAAAAGCCATTCTTCGAGAAAATAAACATTTCTTCGTGAAACTGGTTAATGTTGTAATGTACTGTTAGGGTACTCTGTAAGTTAGAGAAAATATCAACTGTACCTTGAGCTTAATTAGAATAATCATTTCATGTATGATCAGTGTAAGCTAAATATCCTAGATAGTGACAAGATGCATTTATAAACATTTTCTTATATGCAGAATTAATAAAATGCAATGATAGGGCAATACTGCCACCTAGAGAGGAAAATGTAATAAGCCTTATTAAGAATTAAATCAGTTCTGAAAAAAATTTTACCTTACAATAGTTGGCCAATCCCCAGAATTATTGCTATAGATCAGAAATAGTCTTTTTTGGCCATCAGTGCTGGGATTTAGCACCCAAATTCTTCAACTGATGCTACTTGCACTTTGGATACACCTAAAAAGCAAACAATGAAAACTATTCTGGAAGAAGCAACTTTATCAATTTACCCAAAAATCACAGAATCATTAGTTTTTAAGTTAGTCAATTCCCACAATAACTCTAAAGATATTTAAAATAAGTCCAGAGTGCAATACAAGGGGGGCGAGTGTAAACAAATATGGAGGAAATTAAAAGTAGCTGTCCACAAACACTTCGGCTAAAGCAGCAATTTGCAAAGTGCACTGCACAACCTGTACCCAGCAACATGCTGCAGAAAGCTTCCTGAGGATGTGTCCCCCTGTCCTGGAAATTCACAAGGCATACTGACATAGTAAAGGCTGTGGGAAGTCCTGCAGGGGAAAAAAAAAAATGGCTTAAGCTGCTTAGTCAAGAGTGGCACAAGCATTTTGATTACAGAAACCTTTCTTCTTATAACACCTATTTGACATCCTCTAACCCCCCCAGAATTGGAATACAGAGATGAATTTGGAATACAGAGGTTGCTGGATTTGACATGTCTTTCCTTTGGCTGCATATTAAAGAAGTAGCTTTTTCTGTTGTGATTTTTTTTTTTTTTTAATGTGAGAAGGTGCAAGGCACAAAATCTCCAGCTTATTTGGAATTAAAGCTGATTCTCTTACAGGGTTACAGCAGATAAGAATAGGTTTATTGAGATTTAAAACAAATTACTTCCAAGTACATTATTTACCCTCTGAATGGGTTATGGAGGCACACATTTTAAAACTCTGCCTTAAAGCACTTCCAGCTTTTCATCTCATGATTCACATCCAGTTACCCCTCCTTGCTTTGACATTCTTGACCTCTGCCTTTTGGTTTTCAG
>TTN-208,,0,370,1803028,1803397,GTACTGTCAGAATGGTTTTGTTTTTCCTTATTTCACATTCTAGTTTCTCCAACTGGATTTCTGCCATGAAACTCAGTCTGTATAAATTGGAGGAAAAATGCATATGAACATAAAAATATAGCAGCAACTGAAGACCAAATTCAGTAGTCATGCTTTGTAAAACCATTTTTAATTAGGACAAAAGCTCCAATCTGTGAAGTTTCCATAATATACAGGTTTTAATGATACAGTCTCTGTATTTCTTGGCAATAATAAATGCTTATGTATGAGTGTATTTTGCTCTAGGTGGCTCAGTTTTCCAGTATGCTTTTTTATTTTCTACTGGGCATGTCATTTAAAAAAGTAATCTACTTGGTCATTTCTAATCTAG
>TTN-208,,0,857,1803398,1804254,GTACGTGCGAGGCTGCCATGGGGCACCCGCAGAGCCACGTCCTTCAGTGCACATTAACTCAACCACCATCCACTGAGCTTGGCATGCAGCTGTGCTCAATTCATTCTGAAGACAGCCTTGAGCCCAGCAGGGCCCAGACTTTTAGAACTTTCTGAGCAAAAGGTGGTCGGAGATGTCAAAGGTGTTGACAATGTGAGTATCACAAGAGCAGAGTAGGCCAGAAATACCTGGGCTATATGAGCAGGCAAAAGTCAACTATGGTATTCAAGGTAGGAAGGCAAAGAGTGGCCAGAGAAACAGAGACCAGTCAATTCCAGAGCTCAGTCACTGCACACACTGGATGTGGAAACTACTATTTCAGGGAAGGCATTACATTTCTCTAAGTTTCCCCAAAGGACTTTTGTTTTTACTTTTCTCAAAACAAACATGACACTTGATTCATAGCTGGAACAGTGTCATAAATCCAGGATAATGTCCCACCTCGCATTTGAATAGATTTTCTGTTACAGTTTAAAATCATTCCAGCTTTCCTCCTTATCCTCTTGTGTGACATTTATGTCTAAATCCTGACAGATTATTGTAACTTTTTTTTCTTTTCTGAGACAGAGTCTCGCTCTGTCACCCAGGCTAGAGTGCAGTGGCATGACCTCCGCTCACTGCAGCCTCCGCCTCCTGGGTTTAAGTGATTCTTGTGCCTCAGTCTCGTGAGTAGCTGGGATTACAGGTGTGCGCCACCACACCCAGCTAATTTTTGTATTTTTTAGTAGAGGATTTCACCATGTTGGCGAGGCTGGTCTTGAACTAATTTTTATGTAAGATGCATTAAGGTGTTTTCTTCCTTTCTCTATGAAAAGCAG
>TTN-208,,0,1206,1804255,1805460,GTGAAAATGGGTTTGTATTTTAAATTCACTGAGGTTCTTACAGGGGTCAACACAGATAATCACCTTTACCATGAAGAGTGTTGTTCCTTGGGCCACATGGTTGTTAGCATACTAATAAGATCCCCTTGTTGTATGTGTAAATTTCTGGGTACTGGATACCAAAGTTTGGTAGTGTCCCTGAATGCTCCCCTTGTGAGTATGAAAAAGAACTCTGTGAACATACACCAGGAGTAGAAACAGGGGTCTCATCACATTGATCTGGGGATGCACTAAGTATAAGACTATAGGGAGAGGACAGATGGCTAAAACCAGGAGGAAGAAATAGATGCTGAGGCAGGAATGGGGAAAAGTGGAGGAGACACTGAACTCACTTTGCTTTAGAAATCTTAGCAACTGCTTCCTGGCTCCTTCGGAAGACATTTGCACATGAGTTTGAAGTGGAATGGACAGCATGGCTTTAACAAGCCAAATGACCAGAAAAGGTGAAAAGGACAGCCCCATGGTTGGCGGCATTTGGGGACAGATTGGAAAATGCCAGTTAGTAGAGCTCTTGGCCAGTGGAACCAGTTGGCAGTTGGGTGGTTTGAGAAGATGAATTTCAAGTCCCTTTCAGCCTTGAGATCCTGTGTTTCAGTGATGAGATATTTGAGAATGGCAAAGAGGCAAATAGAGAAAACTGTCCCCCTACATACGCATATACCTTAGGTGCCCAGATGGAAACAGCATTCTTCACAGTATTTAGGAAAACTGACAAAACAAAAATATTGTATAAATGCAGATTATAAATTATCCATGCTTGATTTCTCACATGTAAAATAAAAAGATCAGACAAAATTACTTCTAAAGTCTTCCATTCTGATATATATTCTAAGATTACCTTTAGATGACAGAATTAGTACAGAATAATATTGCCATAGATCTATTTGTAAACATTGGAAGTCATTTTAAAGAAGACTACAATTCTGCTGTTCAAAACAAAGTGTTGAATTCAACTTTGTTTTCTCTAAGCAGCCTACATAATTTACAGTTTAAGGAGAGAAAGAGCATGATCTTATTTATGAACATGGGATTATTTATTTTATTTAGTGACATCTGCAGAAAAGGGATTTTACATCTTCAAATTCCTATGTTGTTATATTTAATAAACACCATATTATTTCATTGGGCATCAGGAAATAAAGTTTTTTCTTAAATCATTCTTTGCAG
>TTN-208,,0,2574,1805461,1808034,GTAAGTCTGATTTTCTAAATATTTTGTAGTTTGTTGACAATATCACATTACAGCCAGCTGCAGGTAGCTTATAGTCAAAACCCTTAAATGGAGAAGTCTTTGGTTGTATATTTTTTGTTATTGTTCCTCTATGTCTAGTATTGAAACTCAGGATGGAAATTATGTTCACATTGCACTATTTTCCACTCACTTGATCAGTTTTCAGGAGATTGTCTACAGAACAGTTTAGGGCACATCTATGAACTTTCTAGAACATACATAAATGGATGATAGATATCATGCCAGTCCAGTTACCCACCGGGACAGTTGGTTTCTTCGTGCATAGCCTAAGCCCTCAGTCACTTAGATTGTAATGCACAAACTTTACATGCACACACACATGCACACACACACACACACACACACACATATACACATACATCAGCCATAAACACCCCGAATAAATAGCAAGGGAAAGTGAGGATATGCCAGACATCGGAGAAAGCAAATACTTCCTCAAAAAAAAAAATTCCTTCAATTCACGGTTGATAAACAGTGACCTAGAAGCATTTGCTGCTGTTGTGCCGTAGAGCTGTGTGAGGACAATCTCAGTGTCACTAAAATCCACATCTCTCCCGTATGTGAAATCAAACCTTTAAGTGTCAGGAGAGAGGCATTTATCTTGAATTCTTCCATGTCAAAGAGGGCGCCTGTGCTCATCCTCCTTGAACTCAAGCTCTTTGCTGATCTTAGAGCTACTTTCTTTAAAGGTCCAGTTGAGAACCTTGTACACTTAAAAGGCTGACCAGAGGCTGCTGACTGAATTTCCCTCTCCTTACTGTGAGTGAGACATTTTGAAAGCAGCAAGAACCCTACTTAGGATAATCAAAGGCATAGAAATCCCCATTGCCATTGCAATGCTGGTGACTGGCAAGTTCAGCTGGCCTATGGTTTTCCAGCCACTTGTCAGCAGCCACCCACCGGGTTCCCTAACACGTTGACATGTCTCAAGATGAGATATGTTCAGTTCTAGGACAATTTGCTAAGGCGCATGTGGGCAGAAAAGAAGCCCATTCCTCAGGAAAGCAGTCTATGTATTAAGCACAAGTGTAGGCCCCTGAAATGGAAATCTGACATTTTATCGTTCACCACTAAGCATCCTGTATTTTCCTGAGTGTTTCAAGGATGTCTTCCCATTGCTTTTGTATCTTTTGAAACTCAAATCTTTATTTTACTCTAAACATCAGATAAGACAGGAAACTGAGATAACTGCTGCATCCATGGTGGTAGTTGCCACTGCAAAGTCCACAAAACTAGAAACAGTCCCGGGAGCTCAAGAAGAAACTACCACACAACAAGATCAAATGCACCTAAGTTATGAAAAGGTGATGACTTCCTGCCAATGTGAAAGTCACTCTTGCACCATTTCATTTGCAAATCACCTACATTTTCATCATGGATCTTAATCATCACTTCTTCACTTCCACCTCTTCTTATAATGCAAATAGAAAATTTCTTTTCCCACACAGCTACCTTTCACTGTCAATTCATTCCTAACTTTCAGACTTTCTTTGGCTTGTTACTAATATAATATAATAATTCACTTTAATATCTTCCTATTGAAGCAGATGTCCGTAAACAAGTCAATTCATAATACAAAAAATTATGTGCTATTTACAGTGCTACTGAAATGTCTCAGAGATTGCAGTTTTAAAAAATGTGAAAAGTACAAAATAGCACTCATTAGTCTTTTATTGCTAATCACATTTTTTTCTTTTAAACTGGACTTATTGTTTTGATATTTTTGCCAGTGAAACAGTATGGATGATCAAAGTAACTCAAATGATATATTTTAGTGCAATTAAAATTTCCTTGAATAGGAAGAAATTTTGCCTCCTTTCTTTTTGACTTACGTTTCTTTTATTAAAGATTTATGGAATTTAATGACTATTTTCTTACTTTCTTTTGTATGATCAGATAATGAAGGAAACTAGGAAAACAGTTGTACCTAAAGTCATAGTTGCCACACCCAAAGTCAAAGAACAAGATTTAGTATCAAGAGGTAGAGAAGGCATTACTACCAAAAGAGAACAAGTGCAAATAACTCAGGAGAAGGTGAATACAGATATTTGAGCTGTGAAAAGTTCATCTTTAAACTAATTTCTAGTAAACTATTAACTACAATATGGTATGAATTATTAATCTGTATTTGCCTTTTAAAATCCCTAACTAAAAACAAAATGGTAAATATGAGACTGATTATCATTAATTTTATCTGCACATTTGATTTTCATCCATCTGTAACATTTATAATTCATTTTATTCACCATTATTCTTTGCATGAAGATTAGCATTTTTTAGCTTAATTTTTAAAAAGTGACACAGGGACTCATCTAGAGGTTTTTTAATAGCTAACATTTCTAAGTTTTGTGATTCTCAGTCAGTATATGTAGACATTGCCGGTGAAAGTTTATTTCTCTTGTGTATTTAACCCTGAATAACCATCTTGCATCCCCATGAGGAAGGGGGAAGGGTCATACTATGTGTGTTTGAAGCCCTGTTCAACTTAAATCTTGATTTTACTGTAATAATCAG
>TTN-208,,0,3218,1808035,1811252,GTGACTATTGTTGTTCCAAGTGTGAAATCCCCTATTATAATACATTAATACCACATATCATGTGAAATTCCTTATTGTAATACATTAATATCAAGTCTCTGAATTTCTTATGTATGAGTCACTATTAACCAAATTTATTTTTTAGACAATTAAATAATTGGAAACTAAAAAAATTTATTATTGTTAATATTACTACATATCCCTTTCTCCACTTATCTCTTCACCATTATTGTCAACATTTTATTAACATCTGGGAATCTTCCAGAAGTTGATTAAAATTGCATGCAGGCTAATTTTAAGAGGCCCATGAACATTTTTTAAAAACACGGAAGATGTATAAGTAAATGATGACTCTTACTCACTGTCAAGAAGATGTGTGTTTTGAAGGGTCATAAATTCAGTATATTATGTTATGGAGTATGACTTATTTCAGTAAATTACCCATAATTTTCTTTGTATGAAACTTTATCTTTTTTCCCTCCTGTAAATATCAGAGGAGAAGATAAGCTGAAAAAATTATAATGCATGCTGTAGCAGCTCCCACTAAAGCTAAACAAGATGCATATTAAAATCTAGAGAAGGAAGTATCCAAACAGAACAATTACACATAAGCCATGAAAAGATTACCGTATCTATTTGTAGCTATGAAATATCCATGAATTAAACTGTTTCCCATGACTCTGTCATTTACTCCAAATGAGCCATTTACCTAATTGTATTCTTTATTGCTAATATACCACTTGAAAATTAGCAACTAAAGTTTTTCCATTTCATTAGCAGGATGGCCTGAATCCTATTTGTATTTCCCTCAGTGTCATTTTCTGACTCTACATCTTTTTTTTCTAAGATATGATTTAAGATAAACTTTTTAAACCTTTACTCAAATCTAACATTTAATGGCATATCAGCCTTTCAGAAGTCTCATAAATGACAGAAATTCCACTATGCAACATACTTCATGAGTGATTAACTTTTTACTTTTGTTTCCATTCAAATTTTGTCATGAATTGACTATCTTGTTTTTGTTAAAAATTAGCTAAGGATGGAAGCTGAGAAAATGTTTATACCTGAAGTAGTAGTTACCACTGCAAAATCTGCTGAACCAGCCACACCGCCAATGACTAGAGAAGGATTCACTATTAAACAAAAACAAATACATCTTTTTCGAGAAGAGATGAAAACTGATGCTATGGAGGTGAAAAGTATTGTTTCATCCCATTTCATCATCAACTCTCATAACTTTTCATCCGTCGTGAATTGTGCTTCTAGTGTTCCATCTAATTGTTTAACTGATCAATAAAACAATAGAGATGGTTAGATTCAGTCCATCCTCCAGTTGAACAGTGAGCATTTCTAGTAGTGAAAAGTCAGACCAAATAATACTCTTCTTTATGTCTCCTAAATTTATTCTCAGCATTTAACTCGTATGAATTGGAGTATTCTAGTCCAATTTGTCTTCCTGCTTCTCTAGGTTACAAACATGTGAGAGATATCAAAGTCCACTAAGAAATAAAAGCGGTTACCAGCATACTCATTTGTAGTCCACCAATAAGTGTGTGTATATAAATCTGATATACAATAATTCAAGGAAAAAACAGACAGATGCTTCCTCAATTTAAAATATTTTACCATGATTAAGATTTTTCCATATGTTTAAAATCAAGAACAAAATTTAAATATTTCAGTTGTGTGATATTTAGTCATATGACAGTTTCTTTGACAGTTTCTTTTATCATTGTTAAAATAAAATTAAGACTTAAGCTGACTACTTCATAGCAGACTGGCTAAAAGGTTCAAATGAGATATAGTGGAAATGTGATCACACTACAATCAAAATAATATTTATTTATTTAGTGTTATCTGTCGAAGATGTTAACATTTTAAAATGTCTATACAATTAAAGTCAGCTCATTGCCAATATAGTTTTTAAAAAAGAAAAAAATAAATGGACAAACTTAACTCACCTAAGCCTCATGTGTATTTTATGTTTTTTTCTGAGATGATGCAATCTAAAGTGAAGATGGTATTTGCAGTCCTTCGAGGCAGATGAAATTGTTTGTGTCTTCCTAAAAGGAAGCCCTGGATAAAGCCCATGATCACTAAAGACCCAATTCCATCTCAGAAAAATCTCATTTATATCTTGAATGGTTCAGAGAATAATTTTTAAAGATATGCAGGTAGCATAGTTGAAGAATGTTTCTGATGCATTCTAGATTCTATTCACAGGTATAGAAAACTGAATATTAATAAAATTTTCCAATCTTACTTTTAAAATGCACTTTTAAAATGTACTTTTAAAATGAACATGGCTATGTGATTTTTGAGGTATGCTGTTTCCAAGTATCACATAGAATCATAATATCTAAGCCACATCAGCTAGTTTGCCTTCTTTAAAAGAGAACCTCCTCTGCAAATTGTATTTCCATTAATGTTCATCAGACTCAGAAACGAGAAAATAATATTTGTTTCATTCTTTGCTTTAACTCTCCATAATAATGAAAGTAAATTAAACTTCAATGTGAAAGGTTGTTCTCTTGAATCCAAACATGATAACACTTTCATTTTAATCACAATATTTTTATTTGCACGGGGTTCTCTTTGTCATCTGTGTGTTTTAAGAAAGGTATTTTCTGATAGATTAAACAATCTTACCCTTAGGGAATCATAAGTAAATTCATATGCTCACTCTGTGTTTGTGAGCTTTCATGTTATGTCCGATTTGCATGCAACCATATAACTCTGTAGTCACTGATTTTTCTGGACAGGATGATGACGGTATTTGAGTGCACTTATATCATCACTGTCACTGCATTAATACCAGACTAAATGGTCAACAAGATAATAAAAATAATCAGTGAAAAGAACCAGCTCCAAAATTCTGATTTTCCAATTGCTGATTGATTGTCTGCCTGGAAAAATTCTAGAAAATTTCAAAATCTTCTTGTGATTTTATGTTCATATTGTGATTGTCCTATGTTGTGTATATGTGATTTAATGTCTAGTATAATTAAGTAGGTGTACAGAGAGTATATCTAAATAGATGTCTGTACAATATAATAATCAATGAAATAGTCCCTAAAAGTGTTTCTGAGATACATTTCTAGACACGTTAACACTGCTGTATAATGTGGACGCCATCTGCCTGTCCTGATGCCCAGGAGATATTCCAGCCTGATCTCGATATTCCTATGTATTAATTCTGGAAACCTTGTCTCCAG
>TTN-208,,0,105,1811253,1811357,GTGAGTCTATACCTGCTGATTTTTCACCTTGTTCATGGTAAAGCAAGCCTCACTGCTGTGGTCATCTGGTGATCAATGGTATCACTGAGTTTCATTTCAATGCAG
>TTN-208,,0,1268,1811358,1812625,GTAAGAAGTTACAGAGCATGATACAGAAATGTTTAAAGGAAATAAGTATCTAACCTGTGAAACAGAGCATCTCTGGGGTAGGCCAATGGAGGATTCTTTTTTGGTGATGTGTGTGTGCGTGTGTTTGCATTCACAGTGGGCCCAGACACCCTAAAGATTTGGTTTCTGAAACTCGCCCAGGGGAGTGAGCCTAGAGTCACAAGTGGTTATCTTATACCTCTGAGGAGAGACAAATCCACACAGGCTTCTCTCTAGTTCACATTTCAGGGACAGCTCAAACTCAATTGTTTTGATTACTATTGTTCTAATGATTTTGTGAAAGGTAGTGTGTTACACAGCATAGTTTTACTTATGCTGTGAGACATTTCAGAGTAACTTAACTGTGAATGTGTTTCAATAATAAAGACAGACATTGAGAAATCATATATTTATATACTCAATATAGCAAGATGGAGAGGTGGTACTGTATGGTGGTCGGGTTGGATTGTGGAATCAAATAGCTCTGGATTAGTGCCCTATCTTCTCCCTTATAATCTCTGTCATCAGGAGAAAGTAAGCATACATGTAAAATGCAAGTAAAAAGGACATAAAAACCTGCAGTTGTCAGCATGTAATAAATCCTTGATATTAGTCACTATTGTTATTATACACATCCAAGAAATAGAACCCAAACCTTCTATGCCTTCAAAGAACTGTAAGTTACATATAATGCCTATATTTGATTTAGTCCCAAATTACAAAACAAATAACCATAGACCACAACAGAATAAAAGCAGTAAGGAAACCTTTAAAATATTTTTTCTGAATGTCTTCATGTTTACCTTTCACATAGATTTGTGGCTAAAACCCAAATGTACTATTGCAAAGTAGTTCTTAGGCATTTACCAACAATTTCAATAATTTCTTAATTTTGAATCTCCCACTGTGGTATTTTCAAAAGTGGCATTCATCGGAATGGTTAAGTGAAAATTCGTGACTAAGCTTTAGAAGATCCTGTCCTTTTATGATAAAAGCTGTAAAATAAGGAGTTCTGAATACAACTCTTTAAAAAAGATATTTTAAAATTTGTTTTACAAACTAACAGGCATGACAAGGAGCTTTATAATTGGCTTATCTCTAAATGACTTTTCATTAACTGTGTGATAATGAGTGCTAATGAGAACATTAAAGAACAGACCTTATAGAAAATAGGCTCAGACTCAGTCCAAGAGGGCTAGCCATCGGAGGATGGTTAAATGACTTTATTTTCTGACTCTGTTTCCATGTAG
>TTN-208,,0,284,1812626,1812909,GTTGGTCACTGGTTACCCGCTGTTACATGGTCCACTCCCATTGAGCAGGGCCAGGTGGTTGGCTAGTTTGTACTGAAAAGTAGCCAGTGGAGTCTTGCCTTTCTCCTTTGCCATACTAAGACTTGATTTTTATGGAGCATAGTATGGGTCAGAGATCATTTTCTCAAATTATTTTTATAATTATTTTTATATTTTTATAATTATATAATGTTGCATGAGCTAAGAGTTTATGAGATTTCCCTTAATTTCATGAGCATTTTGTAATATAATTTGTAAAAATCTAG
>TTN-208,,0,655,1812910,1813564,GTGAGTAAAGAAGTTGATAATGCTGGACCCTATTCATATCTCCTCAAATCATTTTAATACACGTTTGCAAAGATCAGTTTCTCAAATTAATACAAAAATGACATTAGTGAGCTTACAGATGCTCATTTTAAGACCGTATTTGGTCTGGAAGACCATATTTGACCATATTTGGCAAGGAAGAAGGGAATTCTATGTGGTACATCATTCATGGATTCAAAAGATTTAATGAGCTTCTAATATGCAGAAGGCATTATTGCAGGAGCTGTGCAGACATAAAGACCAATCCATCCCTCTTTGAAATATTTTCTTTGCCATCAGAGAAAATGTACACAAACAAGCATAATAAAATATATAAGGTGATAAACATCACAACAGAAGGAGAATCCATGGGAGGCATAGATTCATTCCAGTTGGTGATACCATGGCAAAGCTTTGTTGAATAGGTAGCATTTGCTATTGAGCCTTACAGCTCTTTACTAATATATTAGTATATTATATAAATATTAGTTTCTCTACTACTATTTCTGGAGTCCTGATTAAAAGGCCATTTTGTGGCAGTTGAAATGCATAAGTTCAAACTCTACATTTGTTACAAAACAGAAGTGATTAATGAATATGCACACGTATCATTATTTATTTTTTCTCCTCTCTTCAG
>TTN-208,,0,203,1813565,1813767,GTTAGTGGCCACCCTCCCACAGTCCTAATGCACATGCCATCACTTTCATCTGACACTCTTTTCCACAATATGGTTTCTGTGCACCTTGAAATGATGTCCCTTTTTGGAACTTGGGGGGAGATTATATGGTCAATTTAACTGTCAGTGCTAAGCAGGGGTCACTAAACATCTCATCTCAATGAGAAACTTTTGTCTTCTTTTAG
>TTN-208,,0,111,1813768,1813878,GTAAAATATTTTGCTAATTAGTAGCTGTTCTAGTACCATTTTGACTTTCAGCCCCACCAGTATTGGCAAATTGCAACCCGGAAGCTAATATGAGGGGAATTCTCTTTCCAG
>TTN-208,,0,948,1813879,1814826,GTATTTTGATGGCTGAATATAGAGTTCTCTGTGACTTGTATAATACGTGCATGAAGCCTAGAGTAGAATTTACTCACCCCACCGACCCTGAGCATAGGCTCTTTCATTGTGGAGCCTTCTTAGTTTGTTTTGAGGTATTTTTACATTTTTTTTGTGCAAAGTCTTCCTAAGAAATAAAGCTATGTGACAAAAGTGGATGGAAGATATATTTCTTTACATTATAGTTTAATTCATTGAGTTTGTGAAAGTAGAGAAAATATGGATTTTCACACAAACACACCCACACACACACACACACACACACACTTCCAGAAAAGATTTGAGACAATTTTCAATAAAAACATGTAATAACTAAGTGACTAAAAGATAGAAGAATAGCCATGTAATGAAGAAGAAAGCTAGTTATGCACAAAAATCTATGCTAGTAATTTTTCTTCAATTCAATATAAAATTTAGCTCTGAATATTTTGCAATTTAAGATAAAAAGAGCAACCTGGTAATCTAAAAATGTAGGTGCCGTACCTTCATAATAATAAATATAATGTACCAGAGAGTTAATACTGAAATATTTGAAGGAATTTATTGTTTTAATTATTCATTTGATCTCTGAATGAAATAATGAGAAAAATAACGAACAAAGAGAAAATACCTGTTGTTTAAGTGACCTGATCATTTGCTAACATAAACACTGAAAACCACTTAATTTCATGACTGATTCTAGCAATAAATATTCTTTAAAATGAATATTTTAACTTATTTGGCCCTAATTACTCATGTTCTTGCATTTTTCTCAATTTTCAGCAATCTTATAATCTATTGTGGAGCTTAGTCATATGTTTAGGGTCATTGAATTTTATACCACAGATCCACTCACAGATAAGTCCAATTATTTTACCCACAGAAGAGTTGTTGATAACTGATTTTTAAATTTTGTACATTTACATAAAG
>TTN-208,,0,915,1814827,1815741,GTAAGTGCAACTCCAGTTTCTATGTGCATGATAAGAACTGAAATACAAGGAGATAGCAGTGCTGTCCGTTTGCTGAAAAACCTGTTGCCACTTACTGGTTCTGATACTTTGCCCCAGTGTCTTTGCCTCAGTTGTATGGAAAATGTTTTAGACCACATGGCCTCAAAAACTATACTGTCATTAAACTTCTGAGGTTCTAGCAATAGTTTCTTTTTGTTGTATTTGTTTCTAGGCATATCATGCCTCTGAAAATGCAGAGATTCTAAATCCGGTTGCCTTCCAGGCCCAGGCAGGTAACAGTGAGCTCAATGAAAACAGTAGCAAACTGGAGAGTAGGTGCCCTGCCTCAAAGAGACAGTAGCTGTGTTGTTGCCAGGCATGCACCAGGCTGTTACCAGGCTCAGTGTTGCTAGAGCTCCTGATATCTTAAAGAAAACCTGGAAGTCAGGATTTTCAATGTTTATAACTTGAAAACAAATGTAACAGCTTTCATGCTAGACTGTTCACATTTACAGTGAACTGGCTCACACTCTGTTTCACTTGACCTACACAGTATCCCTTAGAGGAAATTACAATATTATCTTCATTTAGCAGATAAAGCACTCAATATTCAGGAAGGTAAATGAATTGTTAAAAGACACACAGCAAATTAGGAAGTCCTCCGTGGTAGATCCCCCCAAAACTGACTGCTAATATAAAATTCTTTCTACAATTGTAATGGCTGGTTGGATTTGTTAGTGTTAGTTTGGTTTCCAAATTCCATCTAGAAAATATTGAGCACTTCAATAGTAGATATTTGGAAAATTTGGTTTTTGGTTATCAACTTTCCCCAGTGTAGAGTTTACCTGAATGCATAGTGGTATGACTGTTTTCTAATAAGAGCATTAAAAATTAACTGATGTTCTTAACTCTTAG
>TTN-208,,0,537,1815742,1816278,GTGAGTATAAAAGTAATGACCAACCAAACAATTTCATAAATTATACTTTCCTTTTTTTATTTGATATTTTCATTTTCAAGTGATGAGCTCGGGGTTAGACAGCTATTAGAAGGTCCAAGTTCACTGTTGCTAAGTTTCCTTAATCTTCATGGTATGTTGCACCTGTGAGTTTAGAAATAGAGATTACATATAGGCCATAAATGTGACTTTAAAAATAGGGCTTATAATATATTAAGGAAAACACCAATATTAGCACAGCTGAGTTCATTCATGCCAAGATCTCTTCATCTGTGTGATAAGCTAATGTAACCTCTAACCCAAATCTAACTCCTGCTTTTGGAATACCTTTCTACCCAAGATGCCACAACATTCACTGGGAAAGATGACCATAATGCAGATTAAAACAAACAAACCAAAAAGTCCTCTAGATTCTTCTCCCAGCTAAAAACTTCAACAGTCTAGCTCAGATACATCTCCTTAAATAATTTATATCAGTAAGGATATGTATTTTTAACAGACCATAATCTTTTTGCATAG
>TTN-208,,0,110,1816279,1816388,GTAAAATATAAACATTTATCATAGCTCCTTGCCACAGTAAAGATACAAATTGGTTAAAATATAACTATTTGATGTAAATTTTATTCATACATGCATGGTATTCTTTGCAG
>TTN-208,,0,898,1816389,1817286,GTAAGACTTGTAATAATTTGGGTTATTTAGTATGTAAATTGTTTTCAAAACATCAAATAGTAGCAAATTGCTATTGTGTAAGAAGAAAATCGAGGGCTAAAATGGCACAGAAACTTACCATTGGCAACACCAACAATTGCCAGAAGTTTTTATTTCTTGCCCCTGTGTAAGATGAGCAAAGAATTTTCATCAGTGTAACATACTGTTTATTTTCCTAGTGCTATAGCTAATATCACAATAGCTCTTATTTGACACCTGATTTTTACATATGTAAATTTATACAACAGCCCTGCAATAAAAAGATGACTATTATTGGTTTGGAAATAGGAACACTGAGGCCCTGGGAATCTATGAAAATTGTCTTAATTCATCCAGCCTGTAAGCGGTGGTGCCAGCATTCAAACTCCAAGTCAGTCTGGCTGCAATGTGTAGATGGAGTCTTGTTTTGCTTTGTTTTGTTTCCAAATTCATTTCTATGTTTTCCTCCTCTGAGATAAAGAATGTGTATTTTTTATTTTTCCATAAATGTATTCATTGGTTTACTTATCCAACCAACATTTATTAGGATGTTTTAGTAGTTAAATCAAAAAAGTCTAGTGACTGATTAAATCCAAGTGGTAAGGAAAAGAGAGTATTGAGGATTATTCCAAGATTTTTGAGCCTGGGTACCTGGATATACTGAATGACTACCAGCTAAAATTGAGAATATAGGAAAAACATAGTTGTGGGGGCAACAATAATATATTCTATTTTAGATCTGAATGAGTTTGAGGTGCCTTCTAATACGTGCAAGAAGTAAATTCTAAAATAACATGAATAATGAATAAGACAAAATGAAGTTTGTTTTGCTGAGTTTTCTTTATGCCTCACGAAAGTATTGTGTGTCTTTGTTTTGCAG
>TTN-208,,0,119,1817287,1817405,GTAAGCGTGATAAGTTTTTGCTCATGAATCATAAAAACACAAAAACAAGCTTATGTATGCATCTAACAATTTTTAAAAACTATTTTAAAATCTACTTTCTTTTAAACATATTTTCACAG
>TTN-208,,0,102,1817406,1817507,GTAAAATGAGATAAAATAAAAATAAATGAATTTTCTTATCACTTGGGTTATAAACAGGTATTTCAGCCTTACTCCCTCTAAATCATGACCTTTCTCTTTCAG
>TTN-208,,0,99,1817508,1817606,GTAAGTATGGAAATAATAAAGCTAAGCTCATTATACAAATCCAATAACCAGGGAAGCTATACCACTATATTGATTATTCCCTCCCCCAACTTTTTATAG
>TTN-208,,0,153,1817607,1817759,GTAATTTGCATGTCTTTCCTTTGATGGACCTGTCTTTGTATTCAAGAATATCCATGAGTGTGTTTACTTTTATTTTCTTTCCCCATTCCTCAGGTTGAGAATTTAATTTAATATAATGTGCTCTCCCCTTTTTCCCCCACCTTTTTCTTGTAG
>TTN-208,,0,447,1817760,1818206,GTATTCAACAACGAAGGATTTCATTGTTTACCTAAGCTCTAAAGTCACCCTTAGCATGTGGTAAAATTAGCTATGCAATTTTTCTTTCATGAAACAATTATTTGGAAATTGACTATAAGTTTCATAGCCAGAATCATAAATTTATGTTCGTAATTAAGAATGTTAACAATTTGACCATTTGGATTTTTTAAAGTAGTATTATCTTGATTTTTAGCTTTTAAGTTTTTTATTGAAGCATAATTCTTTACTTTCAAAAATATTTAAAAATTAAAATAAAATAACTGCTTCTTATTGAAAATTTATCTCTCAGCCCATCAGCGGGTAGATATTAAGAATACACCTGATAGTATGGGGGAGATAAAAGACATACAAGACATCATCTCTATCCTAAGTCTAGATGCATACCTCTCCAAAAAAATTGATTTATCTTTCTGTTATACACTTCAG
>TTN-208,,0,96,1818207,1818302,GTAAGTCCTCCCATTCCTGTCAGCCTGCAGTGAGCATCATTATGGTTTATTGATAAAAAATGATCATAACATTCTTTTTCTCCCCATATTTCACAG
>TTN-208,,0,112,1818303,1818414,GTGAGTCCTAATTATAAAATTTTATGTTTACACTATTAAGCAACATAAAGAACTTCAAGGAGCAGACAATTTCAACAAAATTCATTCATCTTGTGTGTGTATGATTTTGCAG
>TTN-208,,0,92,1818415,1818506,GTAAGGATTATTCTACCTATCTAATAATTACTTTAAGCATTCTACTTTCCCAGTGTAACAATAACCAAGAGATTATTTTATTTTTTCCCCAG
>TTN-208,,0,1637,1818507,1820143,GTTGGTATATTTATTAACCTAAATTCTTACGAGGAGTGATTGTTATTTTAAGAAATTATTATTCATTTCCCCCAAAATTCCTTTCAGTTTCCCACTTCCATGCCTCTGCTTATGCTGTTCCCAAAGCCAATAGTACTTGCAACACCATTCCCACCAGCCTAAATTACAAATGTTCTTCTAGGCCTACCTCAAACGTCACCTTCTCCATTAAACCTTCCTTAATCTCTCCATTTGTATATGATCTCTTCCTCATCCAACCCCAGGATCACTTTATATGTGCCTCTTTCCTAGTGTTTATTATGCACTTGTCTTATTCCCCATTTCCTCTTTCAATATCAGTGTATAAACTCCTGAAATCTGGAATTCTATTTGTATATTCCAATATATTGCAAATGACAGATAATCAATTGGTGTTTGCTGTATTGAGCTTTATTTAAACTTCCTTACTCTAAAGAATTATTTCCTTTTTTAGCCATTCTTGCTTCTTTAGCCTTTGTGCCTTTTATTTTCTTCCTACTTTTTAATGAAATCAATAAATATTTTCAAAATACAGCTTAATGTAACTGTATTTCTTATGATATCATGTAGAAATAAGACCATCATTCAGTAGAATTTCTTAGCTTTACAATGAAGAATAAAAAATGTAAATCAATTGCCAGAAAAAACTAGAAGTCATCATTAATTTGTTTGGTTCATTACAGTTTAAATTTTGAGGAGTTGAGATGTTACATTCAGATCGTGTTGTCCATTACATCTAGTATTGAAGCAAGTCATATGGTAATGATTTGTCTTATTTGGTATGAAAGTTTCATGGTTTATACTTACTTACGTTATAAGATTTCTTCAGAGATCGGACCATGAAAAGACTTGTAAAACAAAATTTCAGATTCAGCATTTTTATACATTTAATATAAATTACATGTTTTAAATGTGTGGAAACAGGAATAAACTATGAACTCCTCTGTGATTTCACCCAGTGTTTTTAAAGTACCTACCATTGGTCAGACACTTGTAGAAACTCAGGACACAAAACTAAATAAGAAATGATTTTTTTCTTGAGAAATTCATAATTTAGAGAGGACAGATACATAAGCAACTAGCTTGTTAAAGCAGTAATTATTTCTGCTAATGGATGATAAGAGTGGAGGCAATGGGGTGAAACTTCATAGAATGGGCGACATTTGCCAACACAGTGATTTTTAATATATAGAAATCCTCAATGTAGTAGAAACATTGATGACTCGTACATTTTGTTTAGCAAATTTTTATGTAGTCAAAATATCAGATTCCCAGGAAATAATCATTAAAAGACCAAGTAAAATGCTTTTGAAGAAGAAGGAATTGGGTTAGAGACTATCCTGGTGGTATACTGTTCTAAGAATTTCCTATTAATTCAACAGTTATTTTTTCTTCACAAAACTTTTCTGATTCCAGTATTTCTCCTAATTATCAGTTATGCATACTTAGAATAAGGGATTTCTTTGGTACCTTCTCAATATGGGTAAAAACAATCATAGACATTTCATGATTTCAAAATCATGTTCTTAAATTTGATATTTTATATTTACTTCTGCAAAGATTTTCCCATTGTGTGAATATGTTTAAAGGACTCATACTGTACATCTCTTGTTCCAAAG
>TTN-208,,0,535,1820144,1820678,GCAAGTAACATAGGATTTGTCCTTTTCAAATCATATTACAATCTTGATCGTTATCGTTTTAAAAGACAAACGATATGGCCATTTTGGATACCATAAATTTTCATTTCATAAAGTCATTCTAGATCCTCTAAACCTTCCTGAGACACATTCCACAAGGTACAAAATTGCTTATCAAATGCGTTTATGCAAAAAAGCCATTTCTTAGGTTAAAGCTCTGTGAAACAGCTAAATCAGACACTGATTCTCCATTCGTCTTTCACCCTTCTCCAATCAGTCTATTATGCTGCTAATACATAGCTATGCAAACTTCATACTACTAAAGCATAGAAAAATCATTTCACGATGTACATGTCCAGTTGGATCCCAGGTTCCCCTAAATAATCTCAGGTGTTTTTTAAAACAGAGGTGCTGCATAACTGTAAAATGTTTGGTAGCCATTCTTTTGCAGGGTGAGTAAGCAATGATCTTGTTCAGGACTTCTTTTCCTTGATGATGTCATCTATATTTTCTAACCCAATCATAAATTTGTCTTTAG
>TTN-208,,0,91,1820679,1820769,GTAAGTTGATTTAGAAACACTTTTCAAGCAGTCAGCCCATGGTTACCATTAAGTTAACCCTATCACTGAATTGCTCCAATTTTCCTCTTAG
>TTN-208,,0,120,1820770,1820889,GTAAGTATCAGGCAGCCCCCTACAGCCCTTTCCTTAATGAACCCCATGTATCTATTTGTTTGGTTTCATCTACTTTTTAAACAAATTGTATTAACTGAAGTGCTCTTTGATTTTACCAAG
>TTN-208,,0,745,1820890,1821634,GTAAGTTAAAAAATATATATATATATATACACATATATATAAAATATCAAATATTCAGTAGATTCATTGATATTCTATATCCTACACTTTGCTGACCACTCAAAAATCCTTGATTGGGTGGGCAGGGTGGCTCAAGCCTGTAATCCCAGCACTTTGGGAGGCCAAGGCAGGAGAATCACTTGAGATCAAGATTTTGAGACCAGGCTGGGAAATACAATGAGATCCTGCCTCTAGCAAAGACAAAAGGAAAAAAAAAAATTAGCTGGGCATGGTGGCACACACTTGTAGTCCCAGCTACTCAGGAGGCTGAGGTGGGAAGATCGCTTGGGCCCAGAAGGCCAAGGCTGCAGTGAGCCACAATCACGGCACTGCACTGCAGCCTGGGCGACAAAGTGAGAACCTGCCTCAAAAAATAAAGAAAAAAAATTGTTAATTGAAACATCTAGTATGTGGTTACACTGAGTAAAGCACTAGTATCTCCACCTGGATAAAATGTTCCAGTTAGAGTAGCATTGAAAGGCTACCTGGAAAGATGCCTCAGTGTCTATCACTTGATCTTTCTGTTCCTCTGTGAGTTGGCACTGTCCTGTATAGTACATGGAAGGTATCAAAGCTTATATCTCTAAACTGTAATCTCCTCAACAGACGCACTAAAAACATTCCAAATTTTTATTCTGCACCTGTTATAACCCACATCATATTTACGTAAAGTCTCCTTGGGTGTTTTTTCTTTTCTCCTTTGCAG
>TTN-208,,0,517,1821635,1822151,GTATGGTTTCATACATATTAGATCCATAGAAAAAATGTCATACATGCTTTATAAAATTTAGTGTATCAATTAATGAATGGATAAATAAAATGTGGGATAGCCATACGATGGGATATCATTCAGCAATAAAAAGGAAGCACTACGATATGCTACAACATGGATGAACCTTTAAAACTTTATGCTAAGTGAAAGAAGCCAGAGACCATACAAAGACCACATATTGTATGATTCCATTTATATGAAATGTCCAAGATACACAAATCTATAGAGATGTAGATTGGTGGTTGCTTAGGTCTACAGGGGAGACAATAGAAAAGTCCTTGGGGTGATGGCTAAGGGTTACATGATTTCTTCTTGGGGAATGAGAATGTTCTAAAATTATGGTGATGGCTACACAATGATGAATACATGGAAATTCATTGAATTGTATACTTTAAATTGGTGGATTGTACAGTATGTGAATTATATCTCAATAAAGCTGTTAAAAATGTTAATTTTTCTACATGCTATTTTCCAG
>TTN-208,,0,89,1822152,1822240,GTCAGTTGTTTTGTCTTGCTACATTCCAGTAATTCCCAGTTTCCTCTGAATCACCATACGGTAAACTCGAATTTCCATTTCATCCATAG
>TTN-208,,0,1146,1822241,1823386,GTATTGTCTACATACTAAATGTTTTGAAAAATCATCAGTAGTCCATAATCTATCATTTTATATTTTAATGTTTCCCTTTTACATTTTCTAACCACCATCCTTTAAAGAATTAAATCAGCTCATTCTTACTTGGCTTAGACTCTCTTATGCTGACCTCAATTTAGTCACAGTTTCCACTCAGGGAATAAGGGTGTCCCTAGCAGCTGTCTAAATACGTTAATTAAAGCAGCTGTAGAAATTTCACTGTCTAATAAATGGCTGCTTGCCAAGCAGCACCAACCAGAAAAGAATTAAAATGTAAATCGTGAGGTTCACACATCAATTAGAATTAAGGAAATTTAGAACAAGGTGATATTTTCTCAGAAGGTTTCTATCTGTGGAGAGGCAAGTGTCAAGGAACTTAGTGGCTAGAAATACTTTCTGTGAAGTCTAAGAGAAAGCCCTGTCCAAGCCGTGCTGGGTTCCTGGCAAGGATGCTGGGCACTCTTGCTGTCGGCTGCATTTACAGAGCTTGTCCTCATAAGTGTCCACCATCCCAAATGATATAATGGAGGAAACATGTCTAGAGAAATACCAGTTGAGTTCAGCTTTATCATATTGCTCATCCAAAGAAAACCAGGCTTTACAGACTGTGGACTATAATGAAAAAGGCTTCAATGAGGACTCAGATAACCTGGAGATGTCTTCCATCATTTATTTGCCAATTCTGAACCTCAGTGTTCTCACTCTTAAAATGAGGATAATAATTCCTACCTAGCCCACAAAGTTATTATTCATATAAAATGAAATCAAATTAAGTAATAACTTTTTAGACAATAAAAAGCCCCCAAAGGTAAAGCATCATTATATCCCTTATTAGTAAATAAGAAGCAAACATTTAAGGATGAAATAATTGTCTCTTTGGGGCAGCTCCTTTCCTCCATGCAGCTGTAAACACAATTCTCTACAAGAGAAGTTTATGTACCATTTGTCCAATACTAGGCAGGAAAAATTAGAGAGTGCTATAATCAGCCAACTTATTACATTATAATATATTGGTTTCACATGCCATTCATTGACCAGTTTTAGAAATTGATTAACTGGGAGGAAACCAGAGCTTCAAGTTTTTGTTGTTGTTGTTGTTTTTTTATGTTGTTCCATCAACAG
>TTN-208,,0,1569,1823387,1824955,GTATGTAGGGACAGATTTCAGCATATTTTGTGGATCCATCAGAAATAATCCTCCTGTTTAAGTCACTAAATTCTTGTAACTTGAAGGAAATTTCTAAAGAACCTATGGTATTCATGTGGTTCCAGCTACATTTTTTTTCACATTATATCTATGGAAAAGGGAGGGCAGCTGTTAAAAGACCTATTGAGAAGTTATTTTCAGAAAGCACCTGATGGCCAGATCCTCATCTGGTTGCTCAAAACTATTGAACACCCATTGGGTGTCCATTTTCATATACCCCAGATGAGCTTCTAGATTCGCTGTTAAACTATTTTAGTTCTCTGCCCTCTGCCTGAACTGCTCAAGTCCTAGCAGCACTACCAAGTGAAAGGGGTGTTTCCAGCCTCTGATATGGAGTGCCTGGGAGAACTCAAAAGTCCTCTTTGAGACCCTGGAAGGCCTAGAGAGCCTCAGGCAATGTGGAACTCGATCCTCTCTACCCCAAGCTCTAAGAACAGGGGCTCTTACTTTGGACAGGGAATTCCACATGCTACCAAGCACTCCTGAGGAGCCTCTGAGCAGTCCCCAGGGAAGTGCTGTTAAACCTCTGCTCTCCTCATTAGAAATCTTAAGGCTGAATCTCAAGCTGACCTTGTTTTGAGTCTAACCTAGATGCAAGAGAAAAATGGAACCTCCCTTCCTATTCTCATCCTAGGCCATATCTCTTTGAATAAAATACCCCTGAGGCAGATGCAGGAACTCCAGGGGTAATCTCAAGATTCACAAAGATGAACCATATCGCCAGCATTCCCTAGGTTCCTAGAAGACCAAATGGTCATGGCATCCAGTTCTTATTATCTCTGTATTAGTAGTGGAGAAACTGAGGCACAGAAAAGTAAAGATCTTTTCTATGATAGTGTCAGAAACCAGCCTCACAGAAGTCATTTCTTCTAATTTCTGGGTTCCATGAACTAACCAGGTCCCCTCACTCATCACAGCACTGAGAATATGCTTTAGTTAGCAAAACAGGAAAGCTGAATTTGTTAAGTCTACCTAATGGCATTTAACTAGATCTGAAATAGTGTTAATTCAGTCATTCATTCAATACTTACTGATTGCATTTTACTGGCACTGGTACATAACAAAATGACTATGACATAAACACAAATACTTGCAAAACAAACAAACTGGAATGATATGAGCCTCTTCACCACATGATTTGTCCAAATGAATTTTAAAAATAGGTAGCACACGGAAGTTATTGTATAATTCATTCAGGTGTCCATCGCTAAGCCCCCACCACAAACAGAAACTGGGATAATCAGGTTAACTCGGCACTCTCAGCATGCCCCCCAAATATCAAAAATATCTTTCTGAAGCTATTCCCTCTGCATGTGGACAAATTCCAAGTGCTTTCTTCATTCTTAGCACAAAGAATGTTCTAATATTCTGAGGCAAGTAAAAATACCACAATTCCAAAATTTTGTCTCTGGATGTATAACTAGCCAGCAACAAATTAATGTAGAGTTTTGCATGCTCTCTTGTGTTTTTACACTTTTTCATGGGCTATTTGTCAACATTTACTCCTAG
>TTN-208,,0,224,1824956,1825179,GTAGGAATGCCTCGCTACTTCCAGCTGAAAATAAAACCTAAGAAGCAGGCTTTTGTCCTTTCCCAGTGCATTTAAAAATACAATTTGGAGCTCATAAAAGTAGATTGCTACCCAACTTTGAAAGCACTCTGCAGTGAAATAAATTAAGATAAACCTACATGCTCCCTTCTGTGAGGTCTCTATGGTGACTTAATCATGACAAATCTTGTGGTTTCTTTCTTTAG
>TTN-208,,0,5004,1825180,1830183,GTAGGTTTAAGAACAAAAGGTGTCATTGCCAATACTTACAAATAATTACATGGGAAAAACATTCTGTCAGCTTCTCCTCCATCACAAACATCTCTCATGCATAATTTGAAGCTTAATGGAAATCTAACAGAAAACTTATTTCAATTATTAAATTAAGAATTAGATAAGTGTTTTTCACTATTTTGTGCCCTTAATAATGGTTGTTTATGTTATGTTATGTGTTCTTTATCACAATAAAAAAATTAGTGTTTTTCACTAATATTAAAAAAGGTCATGTTCCCTTTATGATTGTAGCTGCACTTTAATTTCTTCATTGATAAAATACAATGACAAAACTAAAATTATTAGATTATAATAGCATCTACATATAATTCAAAAGAATAATACATTTATATAAGACATTATTCAGTCTATGGACAATGCTTGTGTGAAAGGTATCCTTTGGAAGACAATATCCTATAGTGGTCAAAAGTCGGGGCTTCATTGTCAAAGATGCTGAATTTGAATCTTGCCTTCAATATATATCATGTCTCTCGTTCTCCTTCTGTCATGAATACATTGAGTATATGATTGCATTCAATCCTAGAAAATATATTTTATGAGGCTAGGAATTCCGTTTTAGTGCCTAGAATTTGGCATCTGAAAAATAGTACCTGCTAGAAGGTAAGCTCTATGAAAACAAGAGTGGATGGTTGCCCCAGAATATCACCTGATACATAGTAGATACTCCATAAGTAATTGTTGACTGGACTAATTAATGATGGTTAAATGACTGTTACCAAACACTTAAGATTATTATCAAGATTAAGTTAGGTAACTCAAGTCAGCACATAGCACAGTGCTCATCATACAGTAATCAATCAGAGTTAGCTGCTACCATTTTTAATTGGGGCATGCTTCTCAAGTACCACCAGCCAATTTCCTCATCCCAGGAATCTGATCTTGGTAGAATGAGACAATATATGTGGAACCACTTCAAGTCATAACTGATTGTCTATAATCACAATTATTTGAGAGTTTCCCAGCCAAAGGGAAACTCTCAAAGCTTGGGCATCTCCCAGCCCTCTTATTAGGCTGATGCAAAAGTAATTGCAAAGTTGTATTGTTTTGTTTATTATGCTTCTCCCATTAGTTTATAATCCAATCTCTACCTTGTCAAGATTTATTTTTCTCAACAGGTTAGTACTTCAGTTGGTCTTCTGACCCAATTATTTCCTCCTCAGGAATGGAGATGGTGATCTAGAAATCTAATAGACCTATTTGATTTTATGAGCATAATTAAAAGATATAATGTATGTAAAGCACCTATAGGCATGGCTGCCAGGTAACTGGGGCTCAATACATTCATTTTATTATAGCCATAGAGAGGAATTATATAAACATCAATGTTTAGTATTGTATGGCCAGTATGGACAAATACCATAGACTGTATATTTGAGGGATAGTGTTCAAGAAATGCTAAATATTAATAAATGAGGACTGATTTGATAATATCCTACTAACACAATAATACAAAATATATTTTAAAAGCAAGTTCATTAAAGCTACACTAAATAATTTATCCATTTATTTAATTTTTAGAGGAATTTTTTAATATAAACATATATGTACATCATTCAAAGTAGTAATATTTGTCTTAACTATATTGGTATAGTGCTTTTAAGTCTATAACATATTAACATATGGTAGTATTGCCTTTAAAGTGTTGTAGAAATACACCTGAAGCACTCTACAAGACACCAATTGGGGTAGAAAGAGAAAAATTTCACTATCTTTTCTGCATAACCAATGTCTTTAAAAAGGTTTGAATAGGCTTTGTAAACTGAGAAGATCATTAACTTCCTATGTGTGGTAATATCTGTACACATATAGTGGTTTTAGCATCCTCTTATAAATTTGTTTTCTATATGAAAGAAATTAAATTCATTAAATAGAATGACCCTTCAAAAACTTGCCAACTCACATAGTTTCATACCACTGGGACTAAAAATATTTACAGAACTTCCTCTGGCCAGGTATTGCCTTAAGTAAGTGTAGCCCTGCTTTCCACAAATTGGAAAGAAATTGGGAGTCTTCAGAAGCTCCCATGTTCTTGGGGGTTGTAATACTTTCTGAAGCATGAAACGTGGCCCTGAGCAACCAGGTGCTGTTTCTAACAGCGAAAATGTTACCTATTGAAGGTCTCCAGTGCCACCTACTGGTAGAGGAGTAATTTGGAAAAGCAGAATCTTAAAATGTAAAAAAGCTATTTTTTTGCTGTTTATTCTACAGATGATGAGTCAGTGTCATTTGGAGGCTTACAGAGTGACAGCTAGCTAAACAGAAATGATGAATAATTAGTTTAACAATGATATTGTCTGTTATTCATTTAAGCATCTGTGCAATTTTAATTCTACCATTTATTGTTTCCCTGCTATTGAGATATTACCCTAGGTGCTGGGGTGCAGATCTTGCTCTTGCCTTTAAGGAGCTTGACATGTAGGTGAGGAGATGCATGCACACAACTATATCCCAAGGTTGTAAGTGCTATTAACAGGCCCACGTACTCATCATTCTCTGTCTGGGAGAGAGCCAGAGAAAGATGTGTGAACTGAGCATTGAAAAATATGTAGGATCATTGAACACAGTGGCATCCTATGATGAGAAAACAACATCTCCAAGTCATCAAAACTTGCAATAATGCTTCATGTGCTAGAAGCAAGTGGTTTAAGTACAGTTGGAAAGTGATATCATGAGTGGGTAAGAAGGCTGGATAATACAGCAAAGGCCGTGCTAAAGTTTTTGGTATTCTATGCTGAAGATTTTGGAATTGATCTTGTTTACATTTAGGAGACACTGCAGGATTTTTAAGCCCCTGGGTACCATGATCAGGTTTACTTTTTAGAAGTGATACTGTGATAGGGAAAGAAGGGATGGACAGATGTGGGAGGCAAGACTGGCAGTCAGGAACTGGAGAGAGATTATTACAATAGGCCTGGAGAGCGTGGATGAGGCCCTCAGCCAGGGCAGTCAGGAGAGACAAGTGGGGTATTGCAGAAGTAGTAATATGGGAGAAGAATGGCCTCAAAGAAGACACGAGAGGCTAATGAGTAACGCAGATCATGGCATCACAGCCACAAGCACCAAGTCCACTACCAAGAAAAGTTTTACCTGTTAACTCACTTATTGTGTGCAGTTCATGTCCAGTGGCAGTTCATGTGTATCCTGGTGCCTCATTCAGTTCACCAAAGGAAGAAGCTGTCAGTAGAAATAAGCAGAGAACCTTGTAAGAGGATGTACCATTGATGATCTCACACACACACACACACACACACACACACACACACACCCCTTCACACAAACTAAATAGGGGTGGTGTTTCATGTTATATCACATGGCACTGTCTTTTGGCGTGTTATTGAAGACAACGTTGCTTCCATCTGTGATGTTAGATATTCTTGCTATAATGACTGACTTGTGCCAGTGGCTTATAAAGCCCTTCCATGTGTGTTATATCATTTAATTCTCACAGCAATTATATGCAACGAATAGCCCATAAATTATTACGCATGCCATTTTACAAATGAAAAGACTAATCCAGAAAGCTTAAATGACATTTCCAAGGCCACACAGCTGACAAGTTGTAGTGTCAAGATTTCATTTTCTTTATATGTATATATTTTGATGGAGTCTTGCTCTGTCACCAGGCTGGAGATCTCGGCTCACTGCAACCTCCCCCTCCCGGGTTCAAGCTATTCTCCTGCCTGAGCCTCCTGAATAGCTGGGATTATAGGTGTGTGCCACCACACCTGGCTAATTTTTGTATTTTCAGGAGAGACTAGGTTTCACCACGTTCGTCAGGCTGTTCTCGAACTCCTGACCTCGTGATCTGCCCGCCTCAGCCTCCCAAAGTGCTGGGATTACAGGTGTGAAGCACCGCGCCTGGCCAGGATTTCATCTTCTACTTTACCTTACTATCTAAGGAACTGAACAGATTTGTTACTCTAAGAGGAGAACCTGCCATTTATACACATCTACCATCATGGGCAGGAGAGTAACTTTTATAGACAAGTATTGGCATTAAAATGCAGACAAATGCTAGATGATTGGACTATTAGAAGATCATCTTGGATGGTTTTGAGACCAAGAAGTGGTATAGTGACTGTGCTCCAAAAACAAGATGGCTTTGATTTTGGCTATTCAAACAGTTAACTAAAATTAAAGTGCATATCACCTACAATTATTACAACACAATAACCTGCTACTTTACTGTAATTTGGGTTTTTACTTTCTATTATTTTAAGATGGTTCAAATCCTTATATAGAAATAGCTAGCTTTATTATAATGTCTTATAACTGCCACTCTGAAAAGAGTCAAATGTATCTAAGATGCTCAAATACCATAATAAATCACCCTCTTTATTTAAAAAATTATTTTCTCTACAATTATTTGTGCCATATATACTGCGTACTGAAACCTTTTGCTCATTAGTAACAAAGATAGAGATTTTTTTTCTACAGCCTTCAAAGGTATCTATTTTAGACTTTTCATATCTTGATCTTCTCAGCTCTCTTTTTGATTGATTTTTCTGCAAACCAAAAGTGGAGATTTTTCTCATTTCCTGTCCCAGAAGGCAACTACAAGCCCAGATCAAACCTTTCCTGATGACTCTTCTTAGGACTGTCTTTTTCTCAAAGTCACTGAATATGTCAAAATCTTGTCTCTGCTTCCACTGCATGACATGCAAATGTCTAAAGAGAATGTAACTGAAGTTCTATCATTTTAAACATTACAACCAGTTCAACCTTAGGACAAGCTATATTTTTCTATCATTACATTTCCTTCTTGAAGATGAAAGGAAATCATTTAACAATAGTAGATATGGCATGCCCAGAGAAAAGTATCATGTTATTAAGTCAAATATGAAATGTAGGCACTAGTATTATTAACATTGTGTTTGCAGGTAAATTGTAAAAATCCACTCATTTTTGTGGTTGAAGTATCTCTTTTCTTTTGTGTCGCAG
>TTN-208,,0,1067,1830184,1831250,GTAAAGTAAAACAACTTTCAGAACCCCATTTAAATATAGATCGAATCTTAACAATGTCTGTAACAATTACTCAAGAGTTCATGTAAATCATTGTTGTTCCTACCATTCTCTTCTAATTCAACTAATTATTTCCCTGTTATATGCCATGGTCTCGCCTCTCCTTTACCACTTTTCATTGTGAATCATAGACCATCACGTTTCATTTGGCCCCGCTTTTTCTCTGTAACAATTTGTAATGTATTGCTGCTGTCACCAGCTGTCATGCTTCCTAATCAGCATGAATCAGAAGGGGGCGAAATATGCTGCATAAATAGGTAGATTTGTTTTCTCAATTGGCTAAGATAAAAATTAAATTTTAAAAACATCTAAGAGTGTTATCATCCTCCTATCATGCTGACACAATTTTGATTTCACAAAAGCTAGACCGTTTCAGGTCTGTACACCAGCGAGCTATATTCATCCTCCTCTCAAGAATGTCTTAGTGTTAAGAAGTCCAGTCCTAAAGTGGTTTAACATTTCTGTTAGTTGGGGCTCTTAAATTGTAATCAGAAACACTTCCTCAGTAACATGGGGAATTTGATTCAAACAAGGATAGCATTTTTATATAGTGGTACTATTTTTCCTGAGCAAATATAGTCTATGTAGTATTAAGTACATACAAATACATAAGGATTTAGAGAAACTATTTTTTTCTTAACCTTATGCATTAACTGTAACTAGATGTTTTTTTAAATAATGAATTTAAAGTGGTTTAAAATTAAAAAGTTGACTTTACAACAAGAGGAAGAAAGAAAAGAATATCCAAAACCCTGTTGGGTACTCCACTATTGCCTTCATGAACAATGTAGTGAAGTTCCTTAGCCCATTCATGTCTCAGCTTGCTTCTCTGGGAAATGGAAGTGAACTTGTGTGACTTCGAGTCAATAGTGACATACAAGGACAAGGCAGTAGGAGTGGACTGAATTCTAGTCCATTATTGAAATTTGTGACAAATCTGTAGACAACTCCAAATGAGTTCTGGTTTCAGTGCAAGGTAAGACATTAAAAATTGGTATGCTTCTTTTCAG
>TTN-208,,0,744,1831251,1831994,GTAAAGCCCATCTTGCTTCAAGGACTTTGATTTGCTGTATACCTCTCAGTCCCACTGTTACTAATGAGAGTCTCTGCTGTTTGTTTTATTGCATACTGTGGTCAGTCCATAACTTACTAATAAAATAACATGCAATAACTCCCGCTAGGTCCTCAATTATGGGTTAACCTACATACTTTAAATTTCACTGAAGTATGTGTTCTATGCACTAGAGAACCAATAATTATTTTATTAGGCACCACCTTTGCTTGGCTTCTTTACTCTTCTAAGCAATATTGTATCATTGCATCATTAAATGATCTATTTGCTGATTATTACTTACTGTACTTAAAGTAAGTACAGTATTACTTACTGTACTTAAAGTAAGTACAGTATTACTTACTGTACTTAAAGCATACAGTGGACGGAGAGCAAATGCTAACCCAAATACAGTCAGCTAGAGGGAGAGAGAGAAAGACAGACTGGGTCACTTTGGATAGCTGAAATGACAACAGAAAGAAGGAACCAGATACTGCATGGCATCTGCATGAGTCTTCATCAACCACTCAGCACTGAATCACCAGGAATGAATTTTCTTTTGTGTGATCCTGACATCTAGATCATATTGCATCTGGCATGCTGCTTTCAAGTGACAACTACGTCTTTCATCTTCATCTTCCATGCCATTTTGTGTTACTAACATGGGCAAGTGACAAAGCTTAGATCTTAATATTCTTTTCTTTTTCTTGTCACTTGATTATACAG
>TTN-208,,0,3041,1831995,1835035,GTTAATTGATTTTTAGCTATGACTTGCTTCATTTCATCCTCATCGCTTTATGCAGCTTTTCTGCCATGCAAATTCAATCGACGAATATATTAATTAGAATATCTCTAAATTAGCACCCTATTCATAAGTGACTTCTGAAAGTCAGCCAAGTCATTGGCCATGATTATCCTGAAAATTTAACTTACCAGTCTAGATTCAGAAAGTTTAATTTTTAAACGTAGGTTCGGGAAGCAAAGGTTTATTTCCTATGTGCTGCATTTTCTAATATTTACCAACGCACTACCAAGAAAGTGTAGCAAAGTTAAAATGTTGTATTCTGAGAAGTACTTATTGGGTATTTATTATTGTGCCAGATACTGTGGTAAATTTCAGTTTAATTGTTTTAATAGCAAGAGGTTCAACAATTCTTATCTCCTCTTTATTTTCACATCTGGAGGTTCTAGTTGTTTACAAAGGGGCCATGAAAATAGAAAATTGGGACCAAGTACAGTGACTCATGCCTGTAATCCCAGCACTTTGGGAGGCCGAGGCAGCCAGATCACTTGAGGTCAGGAGTTTGAGACCAGCCTGGCTAATATGGTGAAACCCCATCTCTACTAAAAATACAAAAATTAGCCAGGCATGTTGGATGTTGGTGCATGCCTGTAATCCCAACTACTCAGGAGGCTGAGGCCAGGAGAATCGCTTGAACCCAGGAGGCAGAGGTTGCAGTGAGCCGAAATAGGGTCACTGTACTCCAGCCTGGGCAACAGAACTAGACTCCATCTCCAAAAAAGAAAAATAGAAAATTGAAAATTGGGCACTGAAAATAACAAAGCTCTCTCTGGACCAAAATTAGAAGTCTCTAGATATTTCTCCATAAATGATGCTGCTTTTACAGGCTTAAAATCCTCCTGGAATTGTATAATTTTCTCATGGCAAGATCACAATTTTTGTCGTTATTGGGCTTGATTCTCCATTATGTCTGGAAGAGCAGGAATAAACTTGTCTGGGCAAGTAATAACTTCTTCCTCTTATCCATGGACTTTCCTTTTGGATATTAATGAAATGAGAAAAATATTTTTCAGGTGCCATAAGCCTGTGTTGTGTGCCCGTAGTCAAAACAGCTTCACTGAGTCTCATGGAAGGAAGCTGGTGGAATAAATTCAGGCATCTCCAGGGGTCTGTGGAAAGCTCTGGCCTCAAGTTCCTCCCTGATCCTGGCCATAGTGGTGTTAGGGATGAAAAGGGGGCAATGCAGTGCTATGTAGGTGCACAGCCATCTCTGCACAGAATTTTGAAACAGTGGCCTTTCTTCCTACCCAGTACAGAGAATACAGTTTATTGATTCATATAATGTATCCGCAACACCTACTCACCAAAAAGAGGTCTTATTCTTTCTTAATGAGATTTTGTTCTATAGCTATCTCTCATTCTGTCACCGTAGCCTACAAAGGCAATATCTCAAGAACTGAGGTCTAGTTATGTAAATTAGATAGAAAATTCCACCAGCCAGAGAGTTGACCCTCAATTTCACTACAGCTGCTGGCTAGCACAGTAATCACACAGAGTCACTATTTATTTGGAGGTGTTGTCTACAAGTCCTGTAGGTGACAGTGTGACAATTTTTTCAGTAATGTAATTGGGAGTTGGCTGTGTTGTGAAGGTGGGAGAAATGTAGATCTCTTAACTCACTTCCTAAAGAATCTAGTGCTATAGTGCGGTGTTTGACTGTCATATTCCCAGAATTGATTTGAACTCGGCTCTTTTGCCCTAGGATCTCCAGTTCATTCAGTTCCAATTGATAATATTATTAAAGTGTTCTTGAAGCAAAAGAATTTTTTTGAACATCCAACTGCCTTACTTGTACCTAAGAAAGTTGAAAGATAAGACATTTTTAGATGTTTGAAGAGTGAAAGATCAGGCACAGTTGTCTAATTATTTGACATAGGCCAGTCTTTATATGTTCCTTTTTTATTTTGGCTTAATAAGTTCATATAGGCTACAGAGTTATCCACCAAGATCAAGTAGGAATGTCAAACCCCTGGAAGTCTTTTTGAATACAGTTATTATGTGCATAATAAACATAAACATATCATATATAAGTTTCATGACTAACATGCTGCCTTTCCTTCTCATCCTAATGACATTCCATCTTCTCCACATTCAGCATGTTTTTCATTCTTACAAACACAGCTAATTTATGCCTTTCCCTAACTTTATTCTTACCTAGCAAAAGAATCGCAAGCCAGAGCACTTACAAAAATTACTCTGGGTTCTGACACTAAAAGTATTAAAACACTCAGAGAGTCACAAATTAAAACAACCCGTGAAGTAAAAAGAGAATCGTCAAAGAAAACATCAAGTTTGTCATTAACTTCATGCCAAAAACCGTAAGAAACTGAGAACAAGGGAATAAAGTCTACTGACAGGATACCACGTGGACTGAAGACTGAGAGTGATACGAGAGCCCCAGCCTTTCCCAAGGAGCTGCCCTAGATATGACTGTGTCTAAAAGCTGTGCATATTCCTTGTGGAATAAAAACAGTTTTGATAAGTCTTTGTTTTGTTTCTTAATATGTAATTTGGACTTCATGTAGTTCAAAGTTTGAAAGGTGATTCAAATCAAAGGAGTGTTTACTAGCAGGAAAAACTGAGAATAGCCCTCTGCTAAAGTAGCAATTTAGAAAATGCATGTTCTTTCTAAATGTGATTTCATCTCTTAGCAAGTGTTTAGTCAATAGGACATTTTTTAGAAAATAATATTCCTTCGGTTTGTAGATTGCTTTCTGCATGCATGTAAAGGCATGGGGAATTATAGAACTAAAAGTGGAAATTTCATGAAGAACCTAAAATAAAAATGTTTTAAATCTTTCTGTCAACATTGTCATGTGTTTTATCAGCTCAATAGTTTGTTTGGCATGGACTTTTTGGTAAATTTGGGGAATGTAGTTTTCTGTTGTTATAATAAAAAGAAAACTTTAATCATACAAGTCATGAATTGATGCAGAAAATATATGCAATTAATCACTAAAATCTCTTTATATGTTTTTCTATTTTAG
>TTN-208,,0,11202,1835036,1846237,GTATTGTTATAATGGATGTGAGATTTAAGTAGAAATTCTAAAGGATTAATAGGATCCTTGAGTTGCCTTCTTTCTCTTAGTATTATTGAGAAAAAAATGACATAGATATACAAATATATCTCTTAGAGTATATATTACTATGTCGCATGCTTGGTTTAGAATTTTGATGGTTACATGCATTTCACAGTAATTTATTGTAAGTTAATTTAAAATTTTGTATTTAAAATTTATCAGCCAAATTCAACTTTATGTTTGCAGTCATTTCCAAAAGTGTATATTAGGAGAAGTTGTCATCTTAATGCATGAAATCATGAAGTAGAAGTTTGTTTTCAAAATCACGGTGAATTACATTGAAAATAGACAATAACCTAGCTGTCATTCTCAGAATGCAATGTCATGAATGAATTATGATTGAAATGCTACTTTACTGAGGTTGTGTGAAAACATTACATTCCCATCTGGTTTACACTTCATTCACATATATCATTTTAACATTGATATGTCTCTTACACTGGCTTGCAGATAGCTGCCTTATGTGATCCTTATTGCCTGCTTTTCTTTGCATAACATTGTGACTTTATGGCTGTATTAGTTCGAATAAACGCCTTCTCATTTTATTTTAGCTAATTATTTATGGTTATAGTTCTTGTATATACTCTTTAAATAGTTGATTCTCAAAAATATAATAATTTAATCTACAATCAAAAGAATCAGAAAGGGCGTTTATTCCACTCTCTGCAAGTCAGGTAAGATTTTCCACTTAGCCATCAAAAGAACAAAGTTTTCCTGCTCTCAAAACAAATATGCACAGGAACATGTTATTTTGAAATGCATTTTTGCTTGTTCAAGAAGAAATTTCAACAGTTTGAAGAAAAGACCAGACAACGAACGATTTTCGTGTCAGAATCTTTTAAACAGAGCATGGTGTTGCGTTTATTCGAACAAATATGGTGAGTGAATTTTTCTATGGATTTGTGAGATCTGTAGCATGCAATTTATTTCATTTCCTATTTTGCAATTTTATTTACTTTCAACTTTTTCAAGTTCTATGGAAAATAGTAAAGGTTTTTTTTTTTTTTTCCAGAATTATTCTCTGAGGGGGAATCTGAACATTCAGAAAGGGATACACGTGACGCCTTTTCAGATTCTGAAGACATAGACCACAAATCCATGGCTGCTAAAAGATATGCAAGTAGAATATCATCTACAAGCTCCTGGCCTGAATATTTTAAGCCTTCTTTTACCCAGAAACTTACATTTAAATATGTTTTAGAGGGTGAACCGGTTGTTTTTACATGTAGATTAATTGCCTGTCCAACTCCAGAAATGACTTGGTTTCATAACAATCGGCCCATCCCAACAGGTCTTCGTCGGATTATAAAAGCTGAGAGTGATTTACACCATCACTCTTCCAGCTTAGAGATTAAAAGGGTCCAAGACAGAGATTCTGGAAGTTATAGGTTACTAGCAATTAATAGTGAAGGGTCTGCAGAATCAACTGCATCATTGCTTGTTATCCAAAAAGGGCAAGATGAGAAATATTTAGAATTTCTGAAAAGAGCAGAACGGACACATGAAAATGTGGAGGCTTTAGTTGAAAGGGGAGAAGATAGGATAAAGGTTGACCTGAGGTTTACTGGCTCTCCCTTTAACAAAAAACAAGATGTGGAACAAAAGGGAATGATGAGAACTATACATTTTAAGACAATGAGTTCTGCCAAGAAAACAGATTACATGTATGATGAAGAATATTTAGAAAGTAAATCTGACATAAGAGGTTGGCTTAATGTAGGTGAAAGTTTCCTGGACAAGGAGACCAAAGTGAAGTTGCAACGTTTAAGGGAGGCTAGAAAAACATTAATGGAGAAAAAGAAATTATCTCTTTTAGATACGTCTTCTGAAATAAGCTCAAGAACTTTGAGAAGTGAAGCTAGTGATAAAGATATTCTGTTCTCTAGAGAGGACATGAAAATCAGATCTATGTCTGATCTAGCTGAAAGTTATAAGGTAGATCATTCAGCTGAGAGTATTGTGCAAAATCCACATGCCCTTTCTAATCAAATGGATCAAAATATAGAATCTGAGGAACTTCCCACAAGCTTTCAAACTATTGTTGATGAAGAAATTTTCCAGACTGAAATAAGAATGAGCCAAGAAGCACTGGTAAAGGAAAGTCTACCAAAAGACCATTTATATGGTGAAATTCTAGTAAATGAAAATACCCAAGCAAGAGGACAGCTGGAAGAAATTATGGCCAATACTACAATTGGAGAGTCATCCACATATATCACTAATGTATGTGAGAAGGAGGAAGTATATGAGACTCCTGAAAATGTGTCTCAAGCTATTACACCACATGCCAGCGAATCTTTTGGTACACTTGTAAATGTTGAAGAAAGTGAAGAAATAGCTAGTGAAAGAATAAAAAAGGATGATTTGAGAGAATTACAACTCTCTGCTTCTACACGAATTGATGAATTCAAAACCGAACAGAAGGAAGAAAACATGAGATTTTTTGAAAATTCTTTTCGAAAACGCCCACAACGTTGCCCACCTTCATTTCTTCAAGAAATTGAATCTCAAGAAGTTTATGAAGGTGACAGTTGTAATTTTGTGTGTCATTTTCAAGGATATCCTCAACCTATAGTGACGTGGTATAACAATGACATGCCAATCCCACGTAATCAAAACTTTATCATTCATTCGTTGGAAAACTATTCAATATTAACTCTTTCATCTGTTCATCATCAGAATGAAGGTTCTATTACTTGTGTGCTATTTAACCAATATGGAACAGTAAAAACAACCAGTATGCTTAAAGTGAAAGCAAAACAAAAACATGATGTCAAAGCACATAAAGTCCCAGTGTTCCATGACTACTTGGATGAGGAAGAAGAGTTAGCATTGGTGTTTGACCAAGCAAAAGGCGCCCATCCATCTATGAGTCAAGAGGGCCAAACAAATCTTCATTTGTTAAAAACTAACCCACCAGTTCCTCCCTCTGGAGACACAGAATTGCTTTCCTTTCCTGTAGAAATTCAGGTAACAGCAGCTACTCCTATCCCAGAACAGGATAAAGAGTCTAAAGAAGTGTTTCAAACTGAGGAGCTGGAACCTAAAGCAATGCCTCAAGATCAAGTTACTCAATCACCAAAACACAGATTTGTATTTTTGTCTGATATTACTAATGAACCACCAAAAATGTTACAAGAAATGCCAAAGCATGCCAGGTGTAGAGAAGGGGATTCCATCATTCTTGAATGTTTAATATCTGGTGAGCCCCAGCCAGTTGTAACATGGTTTCAAAATGGAGTCCTTTTAAAGCAGAACCAGAAGTTTCAGTTTGAAGAAGTTAATTGTAGCCACCAATTATATATTAAGGATGTTAATTCTCAAGATTCTGGAAAATATAAATGTGTTGCTGAAAACAATTCAGGGGCAGTTGAAAGTGTTTCAGATCTAACAGTGGAGCCTGTCACTTATAGAGAAAATAGTCAATTCGAAAATATTGGTGAAATTTATGGAAAATATTCCAGAGATCAGCAACTGCAAGACCAGGGAGAATCTGTAAGGGCACATTTTTATGATTATCCAGCTGGTCCCTTTACTCCCTGGACAAATGTAAAAGAATATTCAGTAAGGGACTATTTTCAAAGCCTTGAGACTATTGAGCAAATAGACCAGAAAGAGCAGGTGCGTTGCATACCTTCTAGAGAAAAAATTCCCAGATTTGTGCATGGTGCTTCAAGAACCATAAAAATCAGCAAGCCCATCAGGGCTGAATTCATACAATGTCAGGCTGAAGGGAAAGAGAGACATGTAAGTGAAAAATCAAAGCTGCACCAAGCAGAGGGTACTGTTTATCCATTTGTTGATGATTTCAGTGATGTCACTATTAAGAAAGAAATAAGAAATAATTTTGGAAAACTTGGTAGATCAGAAAAGGAAAATGTACAAGAATGTGCCCAAAGTGACTATTTACCAAATATTCACTCTGAGAGAATTTCTGACAGTTACAATACAAAAGATTCATCTGCCATTGTATATGAAGAATCCCTTGGTGAAGAGATACACTACCCGGGGAAAAAGGTGAAGCATAGAATTATCGAATTTGAAAAATTACATGTAGAAAAAGGAGTTCTAGAAAAAAGACCTACCAGAACATCAATTGTTAATCCTCCTCAAAAGAAGATTGATGACAAAGCCTTTTCATTAAAGCAAAGAGAATCAAGATCAAGCAATCTAAATGCAAATATGTATCAGGCAGAGAAAATGTCTCCAAATACTGAATCAGATTCATCTAACATTGCAATAAATTTAAAGCTGCTTTCCTCTCAAACTCATAAAGAATTTGACGCACAAGAAAGGGAACAACAGGAAAAAATAAGTCTTATAGATAAACCTGCAATTTCTAAAAGAGCTGAACATGAATCACCTATTACATTTGACTTAAAGCAGTTTCACACTCAAATAAAACACACAGATGTGAAATTCCAAGAATTAGATAGTGGTCAACCAGAAGAAGCTTATTTTAAAATCCAACATCCTGCTGACACTGAGAACATTGTATTTGATCTAAAACAAATGTATTCTCATATAGGAGATCCAGCTCTGGAGTTCCAAGGGCAAGAAACTAGGGAACAGCAGGAAATACATTATAAAGAAAAAATTCCTAGCCCTGAAACGTTACAACCTGACACACACAATATCTCTAAAAGTGTGCAAAATAATGTATTTGCCAGTCAAGAAATTTCTTCCAGTCAAGAGCTTTCAAATAGAACTATGGTGGAGAAAAGTAGTATTGATGAAAATTCCATTTCTTTAGAAAAAGAAGTCCGACATGTACAGGAACAAAACTTAGACATTTTAAAAACTGATCTTTCTCTTAAATCCTTTTCTGAAGAAATCTATAGTGAATCATGTGCCCTACTTCCAACCTCATCTGCAGATATAGAAGAAACTGATCTTTCTGAGAAAAGTTGTCCTCTAGAAAATGGAGGCAGAAGTTCCATCTCACATTTGAAAAAAGCAGCAAGTGAGGAAAAGCCTTTAGGGGTTGGTGAAATGGAAGAAGAATGCACTCTAGAACCAGAGTTGGCAGCATTTCCAAAGCAGGATGGTGGGACACAGGAATATACAGATGCCACTTTGGAAGACCACAGAGGTGATGTTCAGGAAGCTGACACACTCCATAGACAGCTCTCCCTGAGTCAGTGCTTCCCACTCTTGATGACTGAAGAACAACAGAATCCAGGTGAACAAATAAGTACAAACATTCATGCCTCTGGAGAAGAAAAATGTTATGAAGAAGTTCAAGTTCAGAATGAAGCTTCTTTCTCCACTTTAGAAGGAGAAATGATAGAAACTAGTTTTTCTCAAAATATTCCTAAATTAGATGAGGCACATACCACTGAGGCAGCAGAATCTGAGACCTCCCTAACACAATATTTACTTGCTGCTGGAAAGCGTGAGGTTCCTGAAACTAAAGACACCAGAGACCAGGCAAAGCTTGTCCAGAGTGAATCAATCACTTCAATGGAGGTGGAAGAAGTAACTTTCAACACTGTGTATGAATACTACAACCAGAAACAGGAATCACTAGGTCGTCCACTTTCTCCTGAGTCTGACATTTCCATTGGTGTGGGAAGTACAACCAGTGAAGAAATATCTGAGTTAGATCAGTTTTATACCCCACCATCATCTGTTGAATATTTTGAATCTCCAAAGTCCCCTGACTTATATTTTAATCCTTCAGATATAACTAAACAATCCTCAATACATTCAGGAGGTGAGACAGTTGAAAGATATTCCACACCTTTAGGGGAAGTTGCTGAAAGATATTCAACACCTTCCGAAGGTGAGGTAGGAGAAAGATACTCCACACCCCCAGGGGAGACACTAGAGAGATACTCCACACCTCCAGGAGAGACTCTAGAGAGATACTCCACACCCCCAGGAGAGACTCTAGAGAGATATTCCACACCCCCAGGAGAGACTCTGGAGAGATACTCCACACCCCCAGGAGAGACTCTAGAGCGATATTCCACACCCCCAGGGGAGGCACTAGAGAGATATTCTATTCCTACTGGAGGACCAAACCCCACTGGTACTTTTAAAACATATCCATCAAAAATAGAAAGGGAAGACGGTACACCAAATGAGCATTTCTACACACCTACAGAAGAGAGGGGTTCAGCTTATGAAATATGGCGTTCCGATTCATTTGGTACACCCAATGAAGCCATTGAGCCAAAAGACAATGAAATGCCTCCATCTTTTATTGAACCTCTGACCAAAAGGAAGGTATATGAAAACACAACACTAGGCTTCATTGTTGAAGTTGAAGGTCTTCCAGTTCCTGGTGTGAAATGGTATCGAAATAAATCTTTACTAGAGCCAGATGAAAGAATCAAAATGGAAAGAGTGGGTAATGTGTGTTCACTGGAAATTTCTAACATTCAAAAAGGAGAAGGGGGAGAGTACATGTGTCATGCTGTAAACATCATAGGGGAAGCAAAGAGCTTTGCAAATGTAGACATAATGCCCCAGGAAGAAAGAGTGGTGGCACTACCACCTCCAGTAACACATCAGCATGTCATGGAGTTTGATTTGGAACACACCACATCATCAAGAACACCTTCTCCTCAAGAAATTGTCCTGGAAGTTGAATTAAGTGAAAAAGACGTTAAAGAATTTGAGAAGCAGGTGAAAATAGTGACAGTTCCCGAATTTACTCCTGACCATAAAAGTATGATTGTGAGTCTAGATGTTCTTCCATTTAATTTTGTAGATCCAAATATGGATTCAAGGGAGGGAGAAGACAAAGAACTAAAAATTGATTTAGAAGTATTTGAAATGCCTCCTCGCTTTATAATGCCTATTTGTGATTTTAAAATTCCAGAAAATTCAGATGCTGTATTCAAATGTTCAGTCATAGGGATCCCGACTCCCGAAGTTAAGTGGTATAAAGAATATATGTGTATTGAGCCAGATAATATTAAATACGTGATTAGCGAGGAGAAGGGAAGTCACACTCTTAAAATTCGAAATGTCTGTCTTTCTGATAGTGCAACATACAGGTGCAGAGCTGTGAATTGTGTAGGAGAGGCTATCTGTCGGGGATTCCTCACCATGGGAGATTCTGAAATATTTGCTGTGATAGCAAAGAAAAGCAAAGTGACTTTAAGCAGTTTAATGGAAGAATTGGTCTTAAAGAGCAACTACACAGACAGTTTTTTTGAATTTCAGGTGGTGGAAGGGCCTCCCAGGTTTATCAAAGGTATTTCTGACTGTTATGCACCAATAGGTACAGCAGCATATTTTCAGTGCTTAGTTCGTGGCTCTCCAAGACCCACGGTTTACTGGTACAAAGATGGAAAATTAGTCCAAGGAAGAAGGTTCACTGTTGAGGAAAGTGGCACAGGGTTCCATAACCTGTTTATAACAAGCTTAGTAAAGAGTGATGAAGGAGAGTATAGGTGTGTAGCTACAAACAAATCAGGAATGGCTGAGAGCTTTGCAGCACTCACCTTAACTTAAAATGTAATGTTTTAGTGCCTCAGTAATTATTAGCATTGATCTGAGTGCTTTCATATTTTCCAAATTATGTGGATCTAATAAACTTCCAAACAGGTCCACCATATTTGAATTCATTACCTTGGAGACCCCTAAAGAAATAATCTCTATGTAGAAATCTCATCTTTGTAATACATGTAAATATTTTGTTATCTGAACTGTGGAATCATCACTTGTGTCAATCATGCTGTGTAATATCAAACACAATTAAATCTCTCCTTGGCTACCTAATTGTTTGTACTTCTATTTACCCTCATGCCTCCTCCACAAAGTGTTTCAGTGGAATGGACTCTCTTTTAGCAGATAAACCATATATGCAAAAGTACAATGTAAAAGTGGAGACCATATCAGATGACCACGCAGACAAATTGGTAAGGGCAAATCTCTCTGCTCCCATTCTAAGTTATTTTTGGAATTTTAACCCCTTTGCATCCAAACTCATGTTTATTTACTTTGACTTAGAATAGGCAAAACAAACAACAAAAACCAGCTTCTCCCAATTGGCAACTAACTCTATAATCTGTTTGACATTTCAATCTTAATATATTAACTTCATCTCTTTTAAAAATGTTTTCGTTATTAATATTCCTCTTCATAAGTGCTTTAATTCTCACTGGCTTCAAGGGACCAATTGTGCTCTTTGTGGGCAGGGTTCACCTAGACATTTGCAAAATAAGCAAATAGATCTTTCCACTTTTGGAGATACCTTATTTTTCTCCATTTTTGAGATGACATCAAGTGTAAAATGCAGCAATAATTTAGTATTGGCCTGGGGAAAAAAGGGAAACTATCATATTGTGTTTACATATAGATTTTAAAACTGTATTCTGATTTCAGAATCTTTAAAATTTAAAAAAAGGTGGGATATTTTTAGAATTGAGACAATATGGTAATTTGTATTTCAGATTATATATAAATAACAAGATAACAAGCTTTCCTATCAGTTTCACTGAATTTCATCTTTAAAACGAATATAGCTTAATAAGCATTCAATTTTTATTGTGATGTTTATGTTTCTAAAGTAACTCTTTAATTTTGTCTTTTAAAATTAAAATAACAGTAAATTAACATACTCCTTAATATCTTACCTATATACTAATGTGGACCCAAGTCTTCTCATATAAGACTCGACAAATATAAAAAATTCTGAAAATGAAGGGTAGGACCAAAAGACCTTAGAGGTGATCATTCAACAATACAATTCTGTGTTAAGCTAATAGTAATTATTCTTAATACAATTTAGAATAAACTTTAATTTTGTAACAAAGGACGAGAGAAATAATATTACAATGAAAGATAAATTTTATCTCCCTCCACCTCTTAAATTACTTATTGTTACTTAATGGCTACATTTGTCACCTGCATTTAGCAATATTTAAGTACCATTATCATATTTAAAATGCTAATTTTAATTAGAAATGTAAACAATTTAAATTTAATTTTCAAAAGAATTCATATCCAATTATGTTTATTATGTTTCTTTCATCTATCAGTCTTTATTCTCAACATGGGAATTCTCTAACAGCTATCCAAATTAAAGAAGCAATAGAGACAATGTACAGAAAATAGGCAGAGCAGCCAGGCCTCCCCTGCCTCCCTCACAAAAAAAATTTTGAATTATCTGTTTGAGCCACCATAACTCATCAGCATAGATACACTATTGTAGAACAATCATTCCTGTTCCAACCAGTGAGCACACAATATCTGTGATAATAATTATAGACATAATGTAATATATCACATCACAAATTCCTGAAATAAAACTAATTCTATAGATTAGGAACTTAGAGATTTATTCTGCACTTAGTCACATAATGGATGTTAAAATTAACGAGAAACTCAGATTGAGGCAAACATGACAAGCATGCTTTACTCAAACATCATACAGCACAGCAACAGTTCAAACCTTGTTTCTTAAAAAAAGAGAAAGAGAGAAATAGAAAAATGTTTTTATGTCCTACTGGATTTCAGGAAGAGCTGAAAAACACTCTTATTCATATAGTAAAGAGGGCTTTGTTTGGTTTTGCTCATTAGAATTCTGTAATTCTGTTAGTTTCAAGTATGGTGAGCTTGAGTATACGCAGAATAACAGTGACTGAATAAAGAAAAGTAAGCCTTGGCTTACTTTAATTGTCATAGATAATGAAATGGAATTTTTTATTTTCTGACTCAATGGCACGTAACATAAAACCCCAAAATATTAATTTCTCTGATTCTGGATAAAGAATTTATTGTATTGCACATAGTTGAGTTTAGACAATTAATAGCTGCTACCACAACATGTAATTTTTTAAACTATGCCTTTCAAGTTTCAGCACATTTGAATTTCATTTACTATCCTTTTTATGGCTAATAATACCATGGCTTGAAGTAAAATATTTGCAAATAGTTCAACATAGTAGTGAGTAAGGGTATTTTAACTGTATTCACATTCACTCCCTTTACAGATATTTTGTGAGTTCAAGTGAAGGGAAAGGTAACGCGAATTATGTATTGTAGATTAAATGCGAAGTTAAGTGATCACCATTAATATGTAAAATTATCAATGGTTTTATGGTTTACTTAAAATAATAAATACCTGAATATGTATTCTGCATGCTATAGATGAGTTTCTCCAGTATTTTTACAGCCAGCAGACACTTGAGTCCTGTCTTCTAATGCTTATATGCTAGAACAGAAAGGAATTAAGGTGTAAGTCTATTTCATGTGATGCAAGTGAAGTCACCAAATAAAATCATAAAACTGCCTTTTGCTAAGGCAATAAAACTACTAATAACAGGCCTGTTCTACATAGCTAAGAGGTTTAATAAAAAATCGAATTCCTTGTTTAAAATTACATGTCTTTCATCCTGTCATCCAGGATACTGTTTAAAGAGTCTCTGTTATGCACTGCTTTGTTTCTTGCTCAGTGGTTCTGTATAGGTTTTCTTATACAATAAAATACAATGAACTTTTAATATTGGAGTTGTTTTCTCTTATTTTTGATTATCTTATTTTCTTGGCTAATGCCTTATTACAAAGGCTTTGTTCAAGTAATATGGTGATTTACATAGATGAAAGAAGGCCTGCATTTCTAGAAACTGAAAACAGTGGTTCTCTTACAAATCCAAATTAAACATTTCCTGTAGCCTCTTATTTTTAATAATGACTTTAGAGGCAGTAATTAGAACATCAATGGTTTATTTTGGAAATAATCAGTCTTTAACAAAGAAGATTATTCTTAACCTCAAGAAAACTCTAAATATAAATAACAATTCTGGATCTTTTTAGAAGTTGATTTAAATAATGCTGGATTATTATAACTATTTAATTAGCAGTTTTTCAAACTTTAAAATTGGAATTATATCTCAAGAAAAACTCATGAGAGCATTTTTAAAACATGAACTCTATCACAGATGAAGTGGATCAAAAATTGCTTTTGTACAGTATCTATAATTTTGCATAATTTTATATGTTAAGCTAAGAAAAATTTAGAAATGTGCTTTTTGATACATTAATCTTGGAATAATCTAATCATTCCAGGAATAAAGCAGAAGAAGGCCATCAACTGGTGTCTAATTCTTTGATTTCTATTTTTATATTAAATAAAATTTTATAGTAAAATAATAATCATTTTTCCCCATACAG
>TTN-208,,0,780,1846238,1847017,GTTGGATTTTAAGGATAAAATAGATCAAATGCTAACATTCACTGGATTGTAATGATTTAGCTTGCATCACTTAAATTTTCACTTATCTGCCACTTCCAGAATGTAATTTATTTAGAGTAAGAATGAAATCACAGACATAATCATGGTTATGAACTCACCTTTTCCCTTACTGCCCTGTTGGGTGCTATGCTATCATATCCATGGTACTATTTATTTTAAAAATAAAACATATTTTCATATGTTTCATAATACCAATAGATAAGCTTTTAGTTAATTTTCATATGAAGATAACTTTCATAATATGTAATAAAAAGTATCAGTGAACACCTAGCCACTCTGAAATCACTGGTCTCACCCTTAGATTTAAAATAACCATGATTAGTTGTCTGTTTCTTTTTTCTGTTTATTTTTTGTTGTTGTTTCACTTCATCACTTTATTTAGTATATCATGTTTCTTCACATTATTTTCAGTGTTCCCATTCAGCATGGTATATTTAAAGAATATATCATGTTGTTATGCATATAATCCAATAGCATCACATTTTTTCACAATTCACTGCAAAGCAATGATTGAATAGGTTTTTTTTAAAAAAAGCTTATTGTCTTCTTTTGCCTTCAATGATCTTTCTCATTTTCCAGTCACTTGCCTTAAACTGCTGTAATCCATCTCACCAATTTCAACTGTTTTACTCCATTAACAGCAACAAAAGTTAGAAGAAAAACAAAAATGTCATATGCCTGATAAGGAGGCATGTTAATGGACTCTACTTCCCTTTGCAG
>TTN-208,,0,2007,1847018,1849024,GTAAATGCCATACATTGGCACAGATGTTGTCACTTCATTTCATATTGTTGTCCTTTTTGCTTTCTGTACATGTGTGGGAAATGCTTGTATTACCAACTGGAGAGACCAACAACCAAGACAGTAACATGGTAGGTAGGTACTGCAGAGCCTATATGGGATAAGAAATCATTATTTACAGTCACATTTCTACTACTGACCAAAGAAAAAATAATTTATTATTTGAGAACAAAGTTAAGTAATCAAATGAGCTCAGCTTGGCCCTTCATATAAAACATATCAGGACAGTTTGGTGCCACTAAAAAAAAATAATGTCTCAATGTATTTAAAAATTTTAAATCAAATAACCAATTAAGAACAGAATTACAAACTTAAAAAAGTCAGTGTCTAAGTCTAAAATTAAATCCTAATGTAAGACAGGGAGCTAGTATAGGACTGAAAACTAGGATTCTCTCTAGGCATTTTTACTAATTTAAAAATAAGACGGCTGGGCACGGTGGCTCACGCTTGTAATCCCAGCACTTTGGGAGGCCAAGGCAGGCGGATCACAAGGTCAGGAGATCGAGACCATCCTGGCTAACACAGTGAAACCCGATCTCTACTAAAAATATAAAAAATTAGCCAGGCGTGGTGTCACGCACCTGTAGTCCCAGCTACTTGGGAGGCTGAGGCAGGAGAATTGCTTGAAGCCAGGAGGCAGAGGTTGCAGTAAGCCAGGATTGCACCACTGCTCTCCAGCCTGGGCAACATAGCGAGACTCCACCTAAAAAAAAAAAAAGAAAGAAAGAAAATAAGACAACTACACAAATATCCTATTCCCAATTTTCTAATTGATATGTAGGGTGACTTTCAAATAGTTAACACTCATCAAATACTTGAATGCCTTCATTAACCAAAATATTAGTAGCAAGCTTTTCTTCCTTTCTTCCTACCTTCTTTCCTTCCTTCCTTCCTTCCCTCCTTCCCTCCCTCCTCTCTATCTTTCTTTCTTTCTTTTCTTTCTTTCCCTCTTCCCAAGAGAAAGTGTGAGTATGAACTGTGGTTTGAGGACAGGGGTAGAGGTACAGTCAAGCCATACTTGGACTGTTGGGGAAGGCTGTCCCTTGGTCTTCTTTGTCAATGAGAATATCAAGGGGAAGGGCAAATGCAGCACATCTCTTGAATGTGAAAACGATGAGGTTCCCTATAGCTTCCTCTTCTCTACAATCCTTTTACGTGATCCTAAGAAAAACCCAGGCCCATGATGACCCAACCAGTGCTTTTCACTCTGGTCAAAATGTCTCCATAAAACCAAGTACATGATATTATTCATACTGACGCGTTTGGAAGTTTCTTTACTCAAATTAGGTCAATTTAGGAATGCGACTAATATTGAAGCTTCAGATAATAAGAGGAAAGGATAAGGAGGATGACTTAAAAAAATTAAAAAGAGAGGTTCTGAAAGTCTGGCTTCAAGATGCAGAATGGAAAGGGGAAGTTGCTGCTATTAAATATTTTTACAAGTTTGAGTTGGCCTAGAGGATGCATTCATAGTTAAGCCATATAAGAATTTCCAGGCAGTTGACATGAGGGTTAGAAAGACATTACAAAACTACTTCAATCTTCTTATCACTTAATATCCCTACTCTTCAGAAGAGTCAAATACATTTTCTTTATCTTCCTTACATAATCTTCTAATTTGCAGAATTAAAGTATCAGCTCAATAGCTTATCAAATAATTAAACAAGCAGCCACTAAAATGGACAAATCTTTAGTAATGTTACTTAATAAAGGAACGCTTGTCTTTTCTTTGATAGAGACAAGTAAAGTGATGTCTTGCTCCCTTATAAAGAACACTCTCATCCCTTTCCTTTGACAATCTTTTGTTCTTATTAACACATTACTCCATTTTAAATTATGGCTCATGTCTATCTAAAGACTTAACTCATCTTTTCTCTGTCTTGGAATATATAATTACAGCAAGTGCTTTGGTGGGGACTAAATGTAATGCTGGAAAAATTTCTTTTGCAG
>TTN-208,,0,522,1849025,1849546,GTAAGAAACGTGTGAATGTATTTTCTAGTCCCTTCTCTGCAAGGAATCCTCAGTAGAAAAACTGTTGGCAAACAATTCAGTCAGTACACTTTGTTATTAAAATAATGTCATTCAGCAAACATTATGGTTTGGGAAAGTCCTGGCATTGTTTGATTTTATTTTTTTAATCCTCTTCAAAGTTCACTTAACTTTTGTTCTTTTAAATTGTCTGCTATTAACAAAGCTTGCTTAAAATTTCTTCTAAGAAAAAACTCCAAGTGTCTGAGCAATTCTTAACTATCTTCTTTTATAAAATTCTTCTTTGTGTAGGTAGTCTGTTTATTGTTGTTTTATTTTAAATCAAGAGACTGGGAAAGTGTCTTAGAATGATAGGAACCTATTAAATGCACCACAGCTTTTACAGAAATTTTGTGGAGATATTTTATGTGTGTTGGGTCTCTTTGTTGTATATGTCTACTTTTCTTTTGCGGAGTTTATGTTTCAGATATCTTCTCCTTTTTCTTTTTTGTAAACTTCATGTAG
>TTN-208,,0,100,1849547,1849646,GTTTGTTTACTGAGTTTCCATCCAGTATTTTTCTGAGAAAAGATTTCCCTTTTAATTACTTATTACCCATTACTTACACAATGCTTTCATGCTTTTGTAG
>TTN-208,,0,435,1849647,1850081,GTTAGTGCTTGAAAAACTAATGTCTCTTTAATAAATTGTCAAACTAGCTTTCTTACCCCATGGAAGAAAAACTGGTACTTTCTTCTCTTGTCCTATCCTTTAAATTTGTTTTGTCTTGGTTTGACCTGGGACCTTGGGAACAAAGTCAGTAACTTTCACCTGGTCTTTTTCCCGAGACTAGTGTAAATATCTATTATCTGATAACAAAAGGGAATAATAAGCCATTTTGTCAGCTGACAAACATGTATCATCTATGCCTCTGTCTCTTGGATGGAATTATAATTATTCTTAACTTTTATTTCTTCTTCTAATTAACACTATGAAATAGTAGTATTGGGACAAGATAAATATAATCTTGAAAAAACTCTTAAATATAGATGGTGTTGAAAGTGTTTGGGAATTGATATGTTTTATATGCTCTCTTTCCTTAACTAG
>TTN-208,,0,96,1850082,1850177,GTTTGTGTAGGAACATTTAAACCTCAAATTGCTATTTAGAATTAAAGTGAAACCCTAACAAGCATTTAGGGTGCTAACTATTTCATACCATTGTAG
>TTN-208,,0,117,1850178,1850294,GTTAGTATTTTTAGAAAATGATGCTACATATGCATTTGAAACCCAACAAATGGCCTAAAGTCAATCACTGAGCACTCTTCTATATTGACCTTTTCTCCCTTCTTGTGCAACACACAG
>TTN-208,,0,115,1850295,1850409,GTTGGCTGGAGACTTTGCATTTTATCCTTATTAAAGATTATGTTCAAATTAAGTCATCTTCCCTTAGATCAACCCTCTTAACTCTTTGAAATTCTTTCTTATACCCCTTCTTCAG
>TTN-208,,0,92,1850410,1850501,GTTTGCATTGTTTTCTTGACATCTTTGTGCTAACCTTGTTATAAATTCTTTCCTCTTTCTCACATTTCTTAATAACTTCCTTCCTTCCACAG
>TTN-208,,0,94,1850502,1850595,GTTTGTGTTCACTTTGCCTCTTGTGTTGCCAAAGTTATGGCCCATGGCACAGACCCCTCCTCCCTTAATGCAAATCATTCCTTTTTTACTGTAG
>TTN-208,,0,109,1850596,1850704,GTTAGTGTTGGTTCCAGTGAGGGACTGGCTTTTCTGAAGAGTCAATTCTTTTTTTTAAGCCACTTTTGCTATAGGGATAATATTGATTGAGAATTCATTCTTCTGTTAG
>TTN-208,,0,101,1850705,1850805,GTTGGTTCAGAACGTTTGCCTTGGGTTTGAGGAAGAAATGCAGATGTAAGCCTTTCAGCAGGGTAATGCACAACCCACATCTATCCCTTTGTTTTCTACAG
>TTN-208,,0,132,1850806,1850937,GTTGGTATTGTTCTTCTACAGAGAGGATTGGGCATTTCCATGCTCCTTCTTCCCTTAAAATTTAAAAAAAAAAACAAAAACAAATTAGTAGATTGACCTTTTTTTGTTGTTGTTTGCTTTTTCATTGAATAG
>TTN-208,,0,133,1850938,1851070,GTTGGCAAATTTTATTTCCACTTATCAAGAACTTACAAAATATTTTTGTTTCATTTCTAAATTTTCACCTTTATTGCTAAGTTATAAAATAAAACTTCCTATTTTCTTTTGCTTGTTTTTTCTTTCACCTCAG
>TTN-208,,0,147,1851071,1851217,GTCTGGTCTCTACATCTCCTCACTTTCTTGCTTGTCTAGATTTTCTTGCCTGGGGTGGGCCGGGGCGGGGGACGCTTAAGACAGCAGTTTTGCCCAGTGACCTGTTTTTAAAAATATTCAACATCACAATTCTTTTTCCATCTTTAG
>TTN-208,,0,97,1851218,1851314,GTTCGTGAATGGAATCTATTCTCCATTTTGGCTGTGCTGCCTGATAAGTTTGGGGTCTTCCCTTGAGTAAGCTACTGTCTTCCTTTTGAATCTTTAG
>TTN-208,,0,118,1851315,1851432,GTCAGTTATACAAGAAGCAGCCTATCAAATAAAAATTCTGTAACGCTTTTAAATCTTATCATTATGGGTAGGAGTTACAATATGTTTCTTCTTTTCACACTCTCTTATTTAATCACAG
>TTN-208,,0,112,1851433,1851544,GTTTGTAAGCTATTCTCTTTCAAAGATAGTCTATAGCGACAGTTTCATTAGCAGACATTATTTCTAGTGGAGTTACCAATGTAACTCATCCACATTTTCATTTTTACTACAG
>TTN-208,,0,102,1851545,1851646,GTTTGTATCTTCACCCCAGTCAGCTTCCCTTATTTATAGTATGTCCTTTGTAAACAAATAGCAAGAGATTAATGGATGTGTTTTGCTGTTTGCATTGGACAG
>TTN-208,,0,246,1851647,1851892,GTTAGAATTTCTTTACCTCTTCTTGATTCTTCCTTGCGAATGCTTCTTAAATGTATCACTCTTGCCTTTGTATCCTTTAGAGCTAAAATCTCTATGATTCTGGTTCTTTAGATACATATTCATTGTGTTCAAGAAATATTCAGCCATTGCCTCTTTCCAAGAGTGTTTTCTTAAATGTCCATAAAACTGTCACAATAATTCAACTGCAAGCAATTTAATTAAATATATCTCTCTTAAAATCTATAG
>TTN-208,,0,213,1851893,1852105,GTGTGCAAATTTGATTCCTTTATGTTTCTGTCTGACTGTGTCTTTGGTTCTCTGTATTCAGTTACAATGTCTCTAAACAATCAAGAAAGTAGTATTCTTTCTAACATAGTAAACAGTATTTGCTCATGTTTTTCTCTTGCCTGTATACTATCTAATTTAACTATTGTTATTTATTTCTGTTCCCTGATACTCTCCTCTTTCCTGACTCTTTAG
>TTN-208,,0,1043,1852106,1853148,GTAGACATCTTGTTCTTGTGTTTCTCATTAAATGAAAACCACCTTCTCCCCTGGGTATTATAGCTCTTTATTCATTTACTATCATTTTAGTTTCCATTTGAGATCATAGAATATTTTTCTGAGCTAGTATTATTTCCCTTTTTAGATGGTTTCCTTCTTGAATTTTGCTTACATGTAACTAGTCATTATGAAATATTTTTGTTATTCCAGTGTCATAATTCTGATTACCTCAACACATTTGCCAAACATCAAACGTGATGTTTCAAAACTGCACAAAAAAATGAAGTAGGCATTTTAAAATTAGTCTTTTGCTTTCAATCAACTTACAGATATATCATTCTCACTATAATCTATATCATTAATAACAAGCACTTTTACTATATCTATGCAAAGTGAAAGCAATACAGGTTTTAAACTTATGTTTAAAACAGGACAATAATATTTTTTCCTTCTCTCTCAAGGATCACTTCCTATCCTTTAAAAATTATATGACTATACCTTGGTACAAATAGTATCTGTGTTTTTTTGCTGCAATTTTCCAGTGCTTTTTTTTTTTGTCACAAAGGCCAAGTTTGTCTTGTTTTAAGACAATTATTGCAGTAATCATTTGCTGAAATGGAAGACTTAGATCACGGATGTTGTGATGACTTCCAAGTGTCTGTTATAGAACATATACAAAAAAAATCATCCTTGAAATTAGAATTCCATACTTCATGCAAATCATTATTTATTGCTATACTTGCTTGTTTGCAATTTTTGTATCAATCTTTGTAGCCTAAGATACATCAGTAAGGTGTAGTAGATAGAATGTTGAACTGTTCAGTAACGACATCTAGGATCTATCTGGGTTCTCTGCCCATCTAGCTGGTTATCTTGTGAAGGCAAATGGCTTCTGAGGCTGTTATCCCATGAGAGTGTTAGTGCTGGACTCTACTTACCCATTAGAATATCTTAAACCTTTCTTCCAATTTAAAGACAAATAAAAAATTTTCATTTTGTGAAATTCAGTAGCCCAATTCATGAGAAATTCTTGTTTTTTGCAG
>TTN-208,,0,118,1853149,1853266,GTAAATATAGTTCATCCACATGGCAGAAATGTCATAAATGTGCAAAATCCTACTTTTTTCACTCTCGCATGATCTGGACAATCTTTTCAACAATTTCCATCCATCTTTTCCTGTTCAG
>TTN-208,,0,829,1853267,1854095,GTTGGTACAATAGCCCACGATAGAAACTGGTGCCAAATGCTGGAATGAATTACTAAGAGTTACTGGCAGATTCTTTTTCTGAGTTTCTTCTAGAACTATATTTATCCTCATCTATTTGAAAGGTCTAGAGGAAAGACATAGTTGATCTTTCAAACACTCTTTTCTGTTTCTGTGATTCTAACAAAAATTAGACATCTGTTTTATTGTTTAATAACTACCTGTCTATATCAATTAGCAGATACAATCATGACTCTCTTTGATTAAGCATGAAAGAATACAGAGCCCAGCATGTGCTACAAGAGTAATTGTTAAAACTAACAAGAACTCCAAAGGTTGGCATTTGATAGCAAAGCTTCCACATAAAATTAATGACAATTAAACAATTGTTTGAATAACAACTTTCAAAGAATTGTCTTTAGCACCTTAAGGTAGAGCAAAAATACCAAGTAATTCACAATAACCTGTAGACTTTGATCTACAGAGGGTCAAGTGGAAATCAATATATACTATCTAATGCACATTGTTTAAATTGTTTTGAAGTTGAGTCATGCACGAACATATATTTCTTAAGAATAATTGCTACATAAGACGACAGCAAGAGTGGTGGGAAAAACAAAAAATAAAGAAAAAACTGAAAAGAAAAAATATTAAAATAAAAAATAGCTATAATTCTATGACTGCATGTAATTATGGAATCACACTTTAAAGTCGAGAGAGAGAGCACCCTAACATAACCATCTCACTGGGAGAAACAATCTTAGTGAATGTGATAGTAGAGACAGAGTAAAGATCCCAGACTTTGACAGATGGATATCACGTTTTATTTCAG
>TTN-208,,0,116,1854096,1854211,GTTAGTTCTGCTGTTTTCTTCTGGTTGCTTATGCAAATTCCTTTTACAAGTTTCCTTCTTTCAAGTCTCTTCTATTCTTTCAAATCATGATGAGTCTCTTACCTTTCCTCACACAG
>TTN-208,,0,159,1854212,1854370,GTCAGTAGACAGTCAAACTTGTAAGGAATTTCTTACAAATTCCTCTTCAGGTGCACATCTATGTTGACAAACATTTGAAAGTGCTCTAATGTTTTATTCAAAATTGCAACTCCATCTGAAGCTTACAGGATCTTTTAATTGTTCTCCATGTCTATATAG
>TTN-208,,0,93,1854371,1854463,GTTTGCTCAAGTGGATTCACTTTTTCTGTTTTCTGTATACCGACATCCTTGTGTTTTTCTTGTGTTTAACTGCTGTGCTTTGTCACTTACTAG
>TTN-208,,0,108,1854464,1854571,GTGTGTTGTCTTATTGTCTCTTAAATCATTTGCATTCTTCTAACATGTAGCATAGTTTCTTTGATATTCATTAATTCCAGTTGCTAACTGTGAGCCTTTCTTCCTTAG
>TTN-208,,0,112,1854572,1854683,GTGATGATATTTTACAAATTAAAAAAATTCTTTTTTCCTTAACTCTTGTATCTTTATGGTGAACTTCTCATTTCATCTCCTAACACCTTAAGTATTACATGTCTCCCTACAG
>TTN-208,,0,124,1854684,1854807,GTTTGTTCACACGTCACTCTTTTTCTTTGCAAACTGTGGCTTCATATTTCATTGTCAAAGTAGAAACGACCAATGGCAAAAAAACAAACAAAAAATACACATTGCCTTTCTTCTCATCCTCCAG
>TTN-208,,0,644,1854808,1855451,GTATCATTCCATGACTTTTGACAATATTTGTTCCTTACCATATTTGCATAATTGTCTTATAAAAGTTTCTTTGGTTTTTAAATGTTTGAGAGAAACTAACTGGACATGTTAGAATTTGTGTATTAGTGTTGGAGGCAACATTAATCAAAGTTGTGTTTTCTCTTTATATTGTTCTTTACATTAGTGTAACTCTAAGTGTAATCTTATCAAAAAGTATTGTTTAATTGAAATTTGTTAAATGTTGTTTTAACTATCTAGTCCATTTTTTAATGCTTTCTTGTTATATGGCATTCTGATTTATCATTACTAAATGTTGATCAAATACATCTATAATACATTAACTTTTATGTTTTAACTTACATAGTCAAACTAAAAAAAAGAATCAACTAAATTCTCTATTAAAAATGCACATGTACCCTAAAACTTAAAGTATAATAATAATAAATTTTAAAAAACTAAAAAAAAAATGTTATGAGATTATTTAACTTAAAAGATAACTTATTTTACTGTAAAATCCTCAGAAAGTATATTCTTAATAACAAACCAGTTTAAATATAAATTTATGGGATCTTCAGCTACAAAAACAAGCTCTTTTAACATGTATAATAAATATCCCTTACTGACTGTTTTGTTTGGTTTACTAG
>TTN-208,,0,257,1855452,1855708,GTTAGACACACTAAGCTTCTTTGTTTCTTTATTCTCCTCTGATTTGGGCTCTTAGCAAAGTTATGAGTTCCAAAATAAAAGGATAATTAAGGTTATTTGGTTGCAATTCTTCAACAAGTTTTAATGAATTGTCATTTCTTGTGTCAGCATGTATTGTCATATGATCACACCAGTCACTCTTCAAGGTTCTAGATTTAATTTTTTTTTCCTTTATAGTAAGCAAGTGTTCTCATTGTTTATCTCCTTTTTTCTGGTAG
>TTN-208,,0,120,1855709,1855828,GTTTGTATACATGGACACAAAAATATATGCCCCTTCCTCCTATCTGTTCTTGCCTAACTAATAACTTGTGTGGCCATGATTCTCACATTTTTTCCTCTAACCACAAATTTCTTTCATCAG
>TTN-208,,0,150,1855829,1855978,GTTAGTAGCAAAGCACAGCCAGAGAAAAAATCAATTTACTTGATCCATGATCATTTTCCTCAAATATTCCTCTTATCCAGTAATTCAGTGATTGCACTCTTGAGTTTGAAAGGTTACTTTGTTTTCAATGCAAAATACTTCTTCTTTTAG
>TTN-208,,0,102,1855979,1856080,GTGAGTAGAATGAGATTTTTATGAATATACAATATTTCCAGGGGGTGGAGGGGCACAGAATAAAACTTCTCTTTAAACGCAAAACTACCCTTCCCCACATAG
>TTN-208,,0,190,1856081,1856270,GTCAGTGTGCAAGGATAAAGCTGCTGCTTCTCTAACACCTCTTTCATGTGGACGTGGTGCCTGCCTTCCCTGGAGTTTCTTTATTTTGTCTTCATGTTTAGTCTTAGCTCCCTTTTTTTAAGGAGCAAAAGCACTTCTCACTTGGATTTCTTTCTTCTCTTTATCTCCCCTTCCGCCTTGCAATATCTAG
>TTN-208,,0,94,1856271,1856364,GTTTGCTCTTTCCCCCAATATATACATCTTTTAAAATTTCTCTTAAGTCTTCATTAGAAGGCAAGAATTTTACCCACATGTTTTCTCCTTATAG
>TTN-208,,0,100,1856365,1856464,GTGTGTTGACAGCTACCTCTTTTTATTGCTCTCTTTCTTTTCAAACATCCTCTTTTACATGGCATGACTGACTTGCTGACTACCATCCTTTGTACCATAG
>TTN-208,,0,132,1856465,1856596,GTGATGGTGTTGTTTAACCTAGTGTGTGTGAACAGATTCATTTTCTTAAAAACGTTAAAACTTTTATGAATTGAAATATGTTGTGGATGCCTTCTCACCTGTAAATAAGGATTATCTGTAACTTCTTTACAG
>TTN-208,,0,140,1856597,1856736,GTGAGTAACTCACAGTACCCTCTTCATTGTAAAGCAGCTTCACTGCTCCAGGCCACCAAAAGGCTGGTGCCATTTAGTTTCTGCTCTGTATGTGAGAGCATGGAAATAAAAATCACCATGTTGGTCTTCATTCTTTTCAG
>TTN-208,,0,1320,1856737,1858056,GTACTTGTTAGAGTGAAGGAGCAAGATCTCTTTTACATTTTCAGTATCTTAAAATATAGGAGGGTGGGTGTGCTTGAGAGAGAGCTATGTTTAGGACCAGGGTCTAGTGATGAAAATGGATCAAGTGGATCAAGGACCTTCCAAATGGAGACAAGTATTTTTTAATTACTTTAAAAAAAAAATTTAAAACTAGGAAAACATGGACCAAAAGTCCATTTTAAGAGACTAAAAATAGAGACTAGAGAGAGATAACCGAAACTCTACAAAATTGCAAGAAAATCCTAGTTTGAAAGACGGTATCATAGGACAAAAGCGAAGTTATTGCAAATGACTTTTTTCCCACAGTACTTAGTAAATGAATGGATTTTGTCCCTCTAAGGCATAGCAAAGAGCCAAACTATCAAGCCCTTCAAGGAGAATTCAGATGAGAATGATAAGTTCAACTTACTTTCCTCCACTAGCCCCACTTAAATAATAGTGGAGGTCAGGGGCTGGGGAGTAAGTAGATCAGTATCTGCTATTATGGAAGGCAGTCATGTGTTTCTGCCACATGTTTATCGCTGCTACTGTCAGAAATTAAATAGTTCACTCAATGGACTGCTAGTCTAGTCCATTAGAGTATTTTTAAGGGTTTTTGTAGTGGTGGTTTATAAATATCTTGAAATTAAAATATAATTAGATTTAGCAGCCCATTTGCTCTATGACATATAGCTAATCACTTTTACTTCCCTATGCCTGAATTTTTTGCTTCAGTTAATGAGGAAATCATTACTCTCACACACTTCAAAGGAAAATTATGAAGGTTGAGGAAATACCCATTTAACACCTAAAAGAGGAAAATGGCATTTTAAAAATATTAAGATATCTGACCCACTTTGCCATTCCGGCTCTTCATGCTATGTAACTGATAGCATTGCAGCCTTAGGAAATAGTTCTCCACTGGTTCATATACAAGACAGTAATCAAATTCTCATTCCCCGTGGACCTCAGAGGGCTTCCACTGACAGATACATGCTATTATCTCTGATCTTGGCACTAGAGAAGGGACTCTTTTGCTGGGGAGAGGATGGCACAATAAAGAGTAATGTCTTTTTCTCCTTCTTTTAGTAATAATACTTGATGTGGATGCTTACAAAAACAAGCATATTTTATTTTAGAAATTTTCTATTTAGGTTTCATTTAACTCTTCTTCCTTGAACTGCATAAATTTGTTTTCCAGAGCTAAAGACCTCTCTAGCAAAGATTATTTTTTCCACCTCATCTTGAATTATATGCATCTGTTCCATCCCTTACCCTGTGTTTTTCCTCTTGGTTCCATAG
>TTN-208,,0,228,1858057,1858284,GTCAGCGCTCTCCCCACCTGTGTGTTTTTCACATTAGCCTCCTCTTTAATTGTCCTCTTAACTTCCTGTTTGACTCTTCAACGATGTTTTAAAATAGGGAAAGGACACAACAAAGAATTGAAAGTGTTTTTTTCACTCTCTATCTCTCTGATGGAGTGGAAGATTGATTCTTACTTTTAACTATATACTTACAGAATACATCCGTATTTTCCTTTTTTCCAATTTTAG
>TTN-208,,0,412,1858285,1858696,GTTAGATGGACTGCATTCACTTCTGCTCACTACTTCCCTTCTAATTGTAATACTCTGTTGCCCCCTCCACCCCAGCCCAGTCTTATCACTAGCAGCCTATTCCACTTTCCCTTTGTTTCCTCTCCAAGTCCTTTTCTGTTTAGTCTGCTTCCCTTTTCCAAATCCTACTGAATATCCTTTTAGATAATGTTGTAATTAGGTTTTGATTGGATTAAGAAAGCTGGAGTAGATGAGATATTCAACTTTCCTACTGAATACAAACTTTAATGTGTCCCTGCTCGCATCCACCAAAAATGCCTCTTAAATGGAAATAACACATTATCACTAGTTTGATTCCCGGCATTCACGATTTGAGCAAAATGCTGTCAGTCTCACAAATTTTAAAACCCAGGCTTTCCTCCTTTTTCATCAG
>TTN-208,,0,116,1858697,1858812,GTTAGTAAAAAGATGATGTTATCACAGATACAAGGCACACACTCACCAGGATCTGTATTTTCTTTAGTTTTTCAATTTGAGTTTAAAATATGGATATCTTTTACATTTCATTCCAG
>TTN-208,,0,524,1858813,1859336,GTTGGTTGATTTCTTGGGCTTTTCCTTCATCATTATAATAATGTAGTTCCTGATTTTCATAAATGTATATGGGTTGTTACATCTTCTATAGGATAACATGAGTCCGACATCTTCTGAATCAGCAAATTCAGAGGCAATACCATCTGTAGAATTAGAAGAAAACCATGTTCAAAAGTTATATCCCTTTCTTTTTGAGGAATTTCCAAAATGATGATAGGAATGAAAAATAGTCCCTGGATAAGGTTAAAGCAGTCTTCATTTATGCTGAAATAATTCACCACATAATTCTTCACGGCAAAGAGAGAACAAAATCCCTAGCAAGTCAACCATCACATTCTGCCCACTGATTCTCCAAGCTTTTGATAGTGTGAACCCATAGAGGAGTTTTTAATACCGTCACAAAAGAGCCAAATGGATCTAGGGATAGTCCATCAAAAAGACAGTTCTCTCTTCAAGTCATTTTATAATTGTTGTCCTTTGTTTTTTTTGTTTTGTTTTGTTTTGTTTTGTTTTGTATCATTCAG
>TTN-208,,0,109,1859337,1859445,GTCAGTTTACAAAACAGTAAAATGAATTGCATTTCATAGTTTATTAAGCATGTTTGTCATAACAATTCACAAATACTAAACCTTTTCTGATATGTGCTTTTGTGTTTAG
>TTN-208,,0,103,1859446,1859548,GTTTGTCAGACTGCTCTTCTAGATTTATACGATTAGTAATTAGATGTGTCTTTGTCTGTATGTATATGTGTTTGATTTTATATTTTCAATTTGGTCACTTTAG
>TTN-208,,0,92,1859549,1859640,GTTTGTCATGATTGCACATTTTTATCTTTGTATACAATCGATGATCTGGCATGTCTCCTTCATGACTGATTGATTATCTCTCTTGGCTGCAG
>TTN-208,,0,594,1859641,1860234,GTGATTGCAATATTTTTAAAGTGAACGAATTTGTGTTTCTTTTGAACAAGATTTAAAATGTCTGGGGAGGCCTATTTTTTAGGAAAATCTTTCCAAAGGCTTAAAATTCTGCTTAAGTAATCCTATTTACAGTTAGTGGCTTATCTTTTTCTATGGATTCTACAGAGAGATAATATGACTAAATCTTTAATTGGAAGGATTATGCAATCATTTGCTTCTATAATTAAATCTTTTTTAAAAAGTGACCATATATTTTTAAATTCCACCCCGTAAGTATCTCATGCAAATTGCTAGAAGGCAGTCTTTAAAATTACAGGAATCTGCTGCTTGCCCAGAGACATGCCTTCAGCCAACCAATTGCTTTATTGGTTTTCATACTGTTTTGCACCTACTGTGCATTAGGGTTGGTCTCAGAGTGATACTTTTGCTCCAGAAATCTATATGCTTTTCTTTATCTCCAAGTTAATTCAAGAGACATTAATAATTCCTGATTTTTAATAGAAATTGCATATATACGTGCGTTTGTATATATATAATTGTGAGAAGAGCATTTAGTAAATTAAAGTATTTGTTACTTTTATTCTGTTCCTACAG
>TTN-208,,0,139,1860235,1860373,GTTTGTGGATTCTTAAACTTTCATTTCTAGAATTAAAGTATTATAATCAAATATGAACTTAGGGAGAAATTTCTATTTCAGTAAACTGACATGGTCCAGATATTGAGCCTGAAACCTTGTCTTTCTGCTCTACTATTAG
>TTN-208,,0,778,1860374,1861151,GTATCGTTTATTTTGCAAGTGGTCCAACAAAAGTGTAATCATTTTGTAGTATAGCCTGAAGGTGTCGTTTTTATGATGATGAATGCAATTTAGGACATTTTTAAACAAATGAAAAGAAAATGTTTAAGAGGAAATAAGTTTATCTAGAGAAGAAGTCATTTTTTAAATCTGTATTTCTTTCTTTCCTCGAGACAGGATCTCATTCTGTCGCACAGGCTGGAGTACAGTGGCGTGATCTCAGTTCACTGCAACCTCTGCCTCCTGGGTTCAAGTGATTCTTGTGCCTCAGCCTCCTGAGTAGCTGGGATTACAGGCGCCTGCCACCATGACCAACTAATTTTTGTATTTTTTGGTAGAAACGGGGTTTCACCATGTTGGCCAGGTTGGTCTGGAGCTCCTGACCTCAAGTGATCCACCCGCCTTGGCCTCCCAAAGTGCTGGGATTACAGGCATGAGCCACCACACCCAGCTTATAATCTATATTTCTAAAACTTTATATATTCCCTATGATACTGAGACTACCCCTTCTTTTTACAAATTTGTGATTCTCTAAATGGCCATGAGTTACTTCTTATCATCCACCTTGTAAGTCAAAGAACAGTTTAGAATAAGCTCGTAGAAGGAGGCTGAAATGTTTAGGAACATATTCTGATATAGTGTATTTAGTTGGTTAGCCTTGATTTTTAACTAAAAATATGAGGGTTTTTTTTCTTGAAAAGCTTCATATTAGTAATCTGCTTCTAGCTTCTACTTCATATATCCTTGCAATTTCTTATAG
>TTN-208,,0,1752,1861152,1862903,GTGAGTTATCCTCACAGCCCCAACCTGTTGTGTTTTTCTTCACTGCCTGTTATATATCCATGAGCATTTCTTATGATATCTTGACCAAGTAAGTTATAACAAATATAAATACACATTATTTAACTGTGTATTTATCACTCCATATGTTTACTAAAAATATAAATTATTGTAATTTAATTATGTGGCTTCCCGAAGGAGGTGTCATTTAACGGACTAATATCTTAGGTTTCTAAATCATATCCTAAAATTCCTTTAGGTAGTTAGAAGTTTCAGCGTACTCTGAAATGTGTGCATATGTGACATATATTTTTATGAAGCACATTTGTTTTGAAATTTTTTTAATGTTCATCACCAAATATCACATTAACTTGACTATTATTGAGTTATATATTATATCACAGTCTGAAACTTTCTCCTTTCCAAGTGTATTTCTAAAGGATTATTGTTTAATGTATATTGCCCAAAGCGTTTGACCTGCAAACAAATATTAATCCCAGACAAAAGGGTAACATTTGCCCAAAAAGAAAAATAATGGGTAGAAAACATTGCATATCATTATGGAAGACATATTTAAATACACAATCATCGCTTGAGAAAATGAAATAGACCATGTTGTTTAAGGATATCTTTATCTGTTTCTCTTCACTGTAATGGCTTCCAGTAATTACAACATAGCTTCATCAAAATCACATTAAAAACTAACCTCCTAGAGCAGCCTGGAATTAATTACCAACTCTTATGATCTGGTTAGTTATCTCACAGTGCACAGGTAGTAAGTTATTATTAATAGGCTGATATCACTAATAAGTAAATATCACTGAGTTGTCTTAAAATTCCAGTTTCACCACTCATTTTGTGGAATTTAGATGCATTTAGTTTTAAAACACATTTTATAAAATGAAAAATATATACTTAGCAGTGGCTTATCTTCATGATTTACACTCATGATGGTTTTACCATGGGCAGATAAATGCTTTCTATAGAATTCTGAAGCTATTTATAAAATGTTTTTAAAGGATAGACATCAGAAGTTTTAATCTTTGCAATAACAAAAAAAATGGCCTTATTCTTTCTAGGTACAGGTCTCAGAACCATTGAACAAAATCATTACATAATACTGAGTTGTACATTGCCTTCCTATCATGTTACTCATCAATGTCTTCATCATTGGTCTTCAGTTAAACACTGAGCCTCAACTCCTAATTCCCTTGGGCTAAGATTGGATTTTAAATGCTACTGTGGCTGCATTTAATAGCTAAAGATGAACATCAGAGAAAATCACATATAAATATGTGGGCTCATGTATTACTCAAATGCTAGCTTTCTTTCCTAGAGGGTAGCAATCATTGCCGCTGGAGATAAGCAGAATTCCCAAATAAGCCCTTCATTTTCAGGGTTCAGCAAAAACACCGCTGTACACAGGTTTGAGAGAATTAATAGTGTGCTATATGGCAAAGAAGTTCATAGTAACTGCCAATGTCTGCAGTGCTTAGTAAGGACACAGAGGCTGGGGCAATTTGTGGGCAGCATGTGATGTGTTCTTTGCTTGTTTTTAAACCTTTATCTTTTTAAAAAATCCAACAAATTTAAACTATTGTCTTTAGAGAGGAATAAACCAGGCACATAATTCTGTCCTACTACAGCAACAGTGTTACCTGTTAGAGGCCAGTTTTTCTCTTTATTTGTTTCTCTTGTGGAATTTAATACTTTTTTGCCTTTATGTTCCTCATGAAAATACCTTTTCAATTCCAG
>TTN-208,,0,571,1862904,1863474,GTACAGACACCTCAAAAGTATTATGCAGCTCAAGCCAGCAACCACTCATGTTTATTTGCTTATTATGATTTCCCTAGAAATGGAATTAGATTTTTAGAAATATCAGTTGTTGCTCATCTGCAATTTGTAGGCTCCTTATTATAATTGAAATATTAGGTAATTTAACAGAAATAATGTCAATACAAAGTATCTGAAATTACTACAAGTTTACCACCCTATTTCTTGAACTTCTTTTCACCATATCCATTAAGATGTAATTAACGCAGTTCCAAAAATGATGCTATAATAATGCGATAGAAAGTAGGCTGTTGTGATACACCTGGAAAAAATAAAACCAAGTCTAAAAATATTGACACTACTAATATGATTATAGTTCAACCTTTGATAGCTATCATTAGCATAAATGTCTGAGAAGCTGCTTTATCTTCTGTAACCCACCCTTACATAGAAAGAGAATTCTGCAGTACTTACTTATCAAACTGCCAACCTCCTAAGGCTTATTTTACAAAGGGGGATATGTATTGTAATTCTGAGGTGATTGTAGTAACAAAACATGTAAATGTTTTTTCAG
>TTN-208,,0,122,1863475,1863596,GTAAGTGCACTTCATGAGAAGTACATCTTCATCTATCTTATACCTTTTACTTATGATTTAATTTTGGAAGAACTGATTTTAGAAAATTAAATTTTTATTCACTTGTTTTCATTATTCCTTAG
>TTN-208,,0,1096,1863597,1864692,GTGAGTTCAATAAAAACCACAAATCGTACAATCAGCCCTCCATATAAGTGGGTTCCGCATCCACAGTCAACCAGCCCCAGTGGAAAGTATTAAAGAACAAAAAATTTAAAAATACAAATAAACAATACAGCATAACAACCATTTACACAGCACTTACATTGTATTAGATATTATAAGTAATCTAGAGATGAAGCATATGGGAGGATGTGCATAGGTTACATGCAAATACTATGCCATTTTGCATCAGGGACTTGAGCATCTGGCCACAGGCCTCCTGAAGCCAATCTCCCAGGCATAGAGAGGGATGACTGTAATGTCCCATTCACAAAAAGAATCTCTCAAGAGTCATGGGCCATCCATCTCAAGATTCAGATTGTTAAAGAACATAGGCATATAGACATTTTCACAGAAGCAGATAAGCAAATACACAACATCTGGGTGTTCTTGTTTCATTAGAATCAATTTCCGAATTTAAGAGAAAGTTTTAAGAATGAGGTGAATGTCTATTAAGATTTTTAAACAAAAAGAAATGGCCTATAAAGAAACCCCAGTATTGTCTGTGCCTAGGTATGAAACTTTTTTTCTATATATGATTTCTTATGTTATGAATGGTTCTCTAAAACAACTGTTTTAAACATTTTCCATAATTATCATTCATTTCAATATGGTTCATTTTTCAACATAATTATTAAATTAAATCCACACTCAATTTCCACACATCGTTTCCGTGATATGTATACTATTCTATTATTAAAGTTTTCCATTGCTATTATTATTTTTTCTGATATTATAATTCATTAGCTAGGCTCTTTGGTTATAAAGTTTACAGAAATACTTCTATTATCCTTTCCCTTCTTAAAATTTTCATTCCTACATCTATATTTTATTACAATGGTCCTAATCCATCTGATCTTAATCGACTCCATCTCCAAACCCACATTTTTAAATTGTTTCACAGCTAACATGGTAAAATTAATATTTATTGAATAAAGAACATAGAAAACCTTAATGAAGTATATAATCTTTGAATGATGATAGACAATTAAAAATAAGTAGAAGACAGGTGTTTTATCCTTACTTTTTAAATTTTATTTAG
>TTN-208,,0,207,1864693,1864899,GTATGCTCCTTCATATATAGCATCATGCTAAAAAAGTCACATTTAAAACATCTCACATATTCCCTTTGAATTACCAGAATCCTATAGTTATATGACGTCATTTAATATGACCTAACCAGCATCCAGAATGGAAGCTGAATATAGTCATGCGTCCTCTAAATCAAATTTTGTTTCATCTGTAATGCCTATCATTTTTGTTCTTCTCAG
>TTN-208,,0,99,1864900,1864998,GTAAAAAGAATTATGTTGATAATAAAATGAACAAGTTATTATTGAGTATTATTATAAGGGAAGGAGTAACAAATGTGTTTTAATTCTTTATTCTCCTAG
>TTN-208,,0,102,1864999,1865100,GTAAGTTAGAAAAGGCTTATGAAATACTTGTGAGATTTAAATTACTGTTGAGCACATCTGCGTGTGATATTGAACAAAATGCGTGTTGTATCACATGAACAG
>TTN-208,,0,1483,1865101,1866583,GTGCGTGAAACACTATGGAGTCCTTGTGGGTACAGCATAGGTCAATGGCAAATGTTGTGCAGGACCCCTGCAACCCTACCTGTAGACACACACCAAAGTGGTCATGTGTTCTTATTTCCCAACACACGTTCTCATAGTATTCATCTCAAAGTTCATACAAAAGCACAAGGGAAATATTCAAATGAGTGTCAGTTCTTTTGCATCGTTCTTTTAGATTTTAATCTAGTCTAAGACATAATCTTTAACAGTTATTTCTGTCTAAAGTCTAAATTTCATGATTCTCATATCTAGGATTGTAGAAAGAAAGCTAGGAAAGGACAAGATCTCATAGATGTAAATCTGGAGGATCTTGGCTAGGAATTGATATTTTGTTTATAGGACTTAGTCTGACTTTCTCTGTACAAAATTATATAGATAACATAAACATGTCATGTGCAATTAGCAACTATTTTTCAAAAATATTTATTTCATTTTCAGATCATGTTTCAACCTTCTGAATCTCTGAAATTAAGTGAAATCTCAGAATTTAGGAGTAACAACATTCATTTCCTAATTGATTATACACATTTTCCAAAGACACCCTCAAACTGTATTGAGAAAAATTTTGGCTATGATAATAGCATCTGCTTTCAGCTATTGGTGCCCATTCGTAGTTGCTGAAACACAAATATATGACATTGGATTTACATAAGCATGTCAACTTTTCTGACTTACCTTACAATGAATATCAGTGACTGGTTGTATTTTAAATGGTTTTCAAATTAAAGGGCCAGCTGCAAGTACTAATTATTTTTTAAATAATTGATATTTTTAATATAATTCTTTAGTAAATAGAGCTCACCAGAGTACTGTGATTTCTAAGACTTTATGGTACTGTTATACATATAAGACCCTCCCCTCCAGCCTCTTCTAGAAAGCACTCCTGCCATCCACACACATACTTTGTTTGTGCCCATATGTACTTAGCAGATTTCTGAACTCTAAAATTTTTCTTTTTGAAATTTAGAAGTGCAGATTTCCGATTGCGTTTGAAATTATTTTACAGGAAAAGTTATACATATTAGATAAACAATTATAGATCCTGAATAGCAAAAATTATTTTACTGAGGCAAGAAAGAATTTCACAGAGGAATAAGTTGTAGAGTACAATCAAGTTTGTGTTCCCTAACACTTTTAAAATTTAATTTGACTTTGGGTCATTAGCTCTCTTTAGTATGTTCTTTATATAAATATTTTAAGAACTCACAATAATTTCTTTACACTTTGCTACATTCGACCAGCATGAATACACTTAAGAATTGGGATACTTTTTTGTTAGTGATGCAAAGAAGAGTGCATTTCTTCTCATTTTGGATTTTTGAACTTTTCTTGCTATTTTATAACTGGGTACAAAGATGGAGATTTTAAGTATCTGAGGTAAAAGCAAGTAAAAGAAATTCCTCTCTATATAATCTAACTTTGAACCCTCTTTGTACTTAAACAG
>TTN-208,,0,208,1866584,1866791,GTGATTTCATTGACAGTTTTCCAGTGAATGTATAATTTAAGCCTCGTCTGTTTTCTGTATTTCTACCCTGTATGCGCTCATGCTCTCATTCTATCTAGAATGCTTTTTTAGAAAAGACAAGTGTAAATAAACACATACGTATATTGAAGTAAAGAAGTGTTATTTGCAACATATCAGAAAACAAAAGTTGGATGATTTTTCACCCTAG
>TTN-208,,0,101,1866792,1866892,GTGAGGTAGCGCCATCAGAAAGCCACCCTGCCATCTTCGAAACACGTAGCCTACCTATACCATTCTGAACACAAAAATATCATTTTTTTTTTATTTTGCAG
>TTN-208,,0,452,1866893,1867344,GTAAGTTGTTTTGTAAAAATCAATCCTTGCTTACAATAAATTTGGCATAATTTTGTAAATCACAGAAGCCAAACTAAAATGTATAAGATATCTTTCTCTTTTGGGTAAAATATTTTTCAATAAAACTGTTATGCAGTAGAATTACTTTCAGTCAAATAATAAAATGTTAAACCTTGTGAGTCTGGCAAATTAGAGATAATAAGGTCTCACTCAGCTGATGCTAGAATCATGTTAAATAGAATAGCCACAGAATGAAACAAATTTTGACAGTGAACAAAACTTACCTGCGTGGTTGCATACAAAAGAATACTAATATTATTTTGTCTGTATATTAGATTCTGCCATTAGATATGCCTGACATATCTCAGGATCTAATAAATCAAACACACCTTAGTTTTCTAATAAATAGCTTGTTCTCAGTCTCTCTATGCTTATTACATGTCCCTTTCCAG
>TTN-208,,0,324,1867345,1867668,GTAAGACCCAGAACCTCAACATCTGAGCTTGGAGCAGCAATATTCTAGCACTAGGAATCTGTACGAAATTTTATACCAGCGACCAAACTGCAGCAGAGTCAGAACAAAACCTTCCATGTCATATTCTTCAGTGAGCAATTAGAAATTAAAGTAAAAAAAAAAAGTAGTTCCAGTTATAAATAAATGCTACTTTTATTTGTTCCGACTGATGAATTCGTACTATAATACCTATGAAGTACTGAAAGAAATGCATGAGACTTTTCATTATATTTTACGCAAAATAAGAAACTAAAACATGTTACTAACGGCATTTATTTTCTTCAG
>TTN-208,,0,2205,1867669,1869873,GTATTATACCTCATCTACCTAGATGTCGAAATAAGAATTTCACTCTGCTGACCCGAAAAATGTTGCTTAATACAACGCATTGGCCCTCTAGTGGTCAAGAGGTGGAATTGCCTTTCAAAATGTAAATTACTTTCTCAAAGTATTAGCTAACTAAATGTGTAAGTTATGTGCTTAAAACTCTGAAAATCATCAAACAAAATACTATTTTGGTATTAAAATATTTTATTTTAATGAAATTACTGAAACATTAATAGAGAACTAATTTAATGTTTCATATTTTCCTAACTACTATGTATAACAAAAAGAATAATGGAACCAATTTCTAGTGCAGCTTATAGAAATAAACCATAGTAGTTTACAGCCAAATTGCAAATTATAGCTTGTGGCTTTTCTCAATTTATAGTATTAACTACTCTTAAAAATTTACTATTTTGTCACATAAAATATGATTTAGAATACTTATGAAATATTTGACTTCTTTTGTACCTAAGGCATGATCTCACCAATAAAGAGATCTTAAGTGTTCCAAGGAATTGCTCCTCTCAAATACTCAGTAGAGAAGTTGTAGTATTTGTGTCCCAAAGCTTCTCAACTAAATTAGACAACAGATTTCCTGGGACTTTCTGGAGTTATAGGGAGTTCAGAAATGCTGTCAGAATTCTCCCAGCATGGTCAGAAAAAATTCTGTATGTCAAAATCACATTTTTCTATAGCTAAGTCACTACTACTGTATTAGATTCAAGGGGTGGAAATGGTAGGCCCTTAACACCCGCTATAATTGGCATTAAACGCTTGACCTATTTTTCAGCCAGCCTTAGAGGAAATTCAATTAGAAACTTCCAATTTTGTGACTAATGCAACCTCATTAACAAAGAGAAGCATTTTTATGATTCATACGAACATAAGCATTTTATCTAGCTGTGAGAACAGAGAGGAACAAGAATCAACAATCATAAATTGGATTTCCATTTCTATTTCTGTTGTCAAAAATAATAACTTATGTTAATGAATGATTTGTTCTTTGACTGGTAGTATCAACATGGCTAAGTTTGGTACTCACTGTGAAACTTGAGAAGTTAAATAATGTTTTAAAAATTAAAAAAGAGGCCTGGCGCGGTGGCTCACGCTTGTAATCCCAGCACTTTGGGAGGCCGAGGTGGGCGGATCACGAGGTCAGGAGATCGAGACCACGATGAAACCGCGTCTCTACTAAAAATACAAAAAATTAGCCGGGCGTGGTGGTGGGCACCTGTAGTCCCAGCTACTCAGAGAGGCTGAGGCAGGAGAATGGCGTGAACCCGGGAGGCGGAGCTTGCAATGAGCCGAGATCGAGCCACTGCACTCCAGCCTGGGTGACAGAGTGAGACTCCGTCTCAAAAAAAAAAAAAAAAAAAAATTAAAAAAGAGTGGGCTGGGCGCGGTGGCTCACGCCTGTAATCCCAGCACTTTGGGAGGCCGAGGCGGGCGGATCACAAGGTCAGGAGATCGAGACCATCTTGGCTAACACGGTGAAACCCCGTCTCTACTAAAAATACAAAAAATTAGCCGGGCGCGGTGGCGGGCGCCTGTAGTCCCAGCTACTCGGGAGGCTGAGGCAGGAGAATGGTGTGGACCTGGGAGGCGGAGCTTGCAGTGAGCCGAGATTGCGCCACTGCAATCCGGCCTGGGCTAAACAGCGGGACTCCGTCTCAAAAAAAAAAAAAAAAAAAAAAAAAAAAAAAAAAAAAAAAAAAAAAGAGTGTTATTTATTCATGAATACAAAAGGCCATAATCAAGTATGATTAGGAACCGTGGTTAAGGTATAACAGCTGCACAACAAAGGACTTTAAACCCACTTGTTACTCTTCCTCCTAACATATTTGTGTTCGTCCCTAAGGATGAAGCAAAGATGAAAATGTGTACTTTACTATTTATGATATCACTTAGATTCACACTCCATGTTCTGAAAACTTTAACTCTCAGCAGACATAAAATCAGTGAAGATGTAAGATCACAGTACATTTTCTATATCCCTCCAAAACAATTTTTTTGCATCTAGTCCTAGATCTTTCCAAAACAAATATCTTGTAGTAATATGCAGAATCTCGCTACTATCAACATATGGAAAAATAAAATATTTCAATAAAATTCCTAGTTTCCTGAAAGCATTTTAGTTACTTACACCAGAAATATTTTTTCTTTTTTTTTCTTTTTTTTTTTTTTTAG
>TTN-208,,0,1674,1869874,1871547,GTATTATAATTAATCAAAAAGCAGTCTTAACACTTTTTTCTTGGCCAAAACTTTTAAATTCTAAACAGTGGAGGGTGAAGGAAGGGTAAGAGTTTGCAATCACAAAATGGTACCTCTCCCTTCACTCACTTTCGCCCTCGTCTTTGACTCAGTCCTCACTCTCTCAACTCCTTTTTTCCCCCTTTTCTCTTTCCTGTCCTCCTGAGCCCCTGGGAACCAATGACAACACCAGTGTATTCTGGTTATTTCTGGATGAAAATTTAAAGAAGGTCTTGCCCAGAAATCCAACAGCTATTCTTTTTTTTTCTTTTTTATTTTATTGTAAATTGACTATTTACTATTGTGTATATATTTATGGGGTACAAAGTGATGTTATGATCTGTGAATACAATATGGAATAATTAAATCAAGCCAATTAACATATCCATCACCTCAAATACTTAACATTTTTGTGGTGAGAATATTTGAAATTTACTCTTAGCGATTTTGAAATGTACAGTACACTATTATTAACTATATTCACCACTCTGTGCAACAGATCTCAAGAAAAGCCATGTTTCTTCTGTCTAAGATTTTGTACCCTTTGACCAACATTTCCCCATTCCCTCAAATCCCCAGCCTCTGTAACCATCATTCTACTCTTTATGAATTCAACTTTTTTAGTTCCACATCTAAGTGAGAACTTACAGTCTTTGTCTTTCTGTGCCTGGCTTATTTCACTTAGCATAATCTCCAGTTCTATCCATGTTGTCACAAATGACAAAATTCCCTTTTTTTATAAGGCTGAATAGTATTCCATTGTGTATTTATATACCACCTTTTCCTTATGTATTCATCCATTGATGGACACTTAGGGTGTTTCCATAACTTGGTCTTTGTGAATAATGCTGCAATGAACATGGAAGTACCCAACAGCTGGTCTTGATAAAGTCACATCAATGTAAGATCAAGGGTTGCTGCTAATTTTAAGAGGTTGCTGCAACCCACCTCAGTATCTTTCCTGATTTAGGTGATCTAAATATCAATATTTGAAGAAAAAATACTTTATGAAGGAGGATCAATTCAAATCACTTTAACTTTCAATATATCCTCGAAGATTTTTAGGAAAACAGTTGGATAACTAAATTTAAACAAATAGTTTTAACTCATTTGACTAAGATTAGAGTACAGCAACCTCCATAAAGAAGGAAAATATGGAAACACAAGGCATCATTCATCATTCAGACTTTTCTGAGTGGTCATTTGTGAAACATCATGGAATAAGAGGACACTCAAAAAGCATGGATATTTCATGAACTTCATAGTTAATAATTGAAAAAGTCTAATGTGTTATTTTTAGCATTGGACATATTAAACATTCTCTTCATGCTTAATGTTAACTTATTAGAAATCAATCTAAACTAGAACCAATTTAAATGATCTTAAATCAATCTAAACTAGAATCAAACTTTGGCCTTTTGCATGTTTGATTTTTGTTAATATGGCCTTGCATAGCATTTCTAATGAGCTAGATTTGGAAATTATAGAAGCATTATTATGATTCCTGGAAGGGCTGGTGTATGAGTAGTAGTCATAGCTCCTACAAACAACTAACAATGATGTGGAGGATTAGTAAACATTAATAATAATGTAATCTAAAAATAAACACACATTTTTATGTTTTTAAACTCCCAG
>TTN-208,,0,851,1871548,1872398,GTAAATAAAGATAAATTATTTTTATTCTGTTTATTCCTGAGATTTGCACTTCTGCTAACTATTCTTATTTTAAATATTAGGCTTCCAACTTATTGAAAGTTGTGGAGTCTCCTCTGCTGTGTTAAATTTAGCATTAGAAATGATGGCTATTTCATATTGCCCCTTTCCCAGGAAAACAAACCCAGGCAGATGTTTATGCTGCCTCTGTGCAATGGTCTCAGAGAAAGAAGAAGTGAGGGCTAGAAAGGAAGGGCCATTCCTTATTTTTTTATTGTAGTTAACACAAATGTTAAGAGTCATATAAATAATGAGAGCCCTTAAGAACTTTAAAAATCTGTTATCTAAAAGTACCTAATTAACTTGGTTACATAATTTTAAATGTTGTTTTTATGAAACTGACTAAGGGATCATATGCAATAGTCAAAAACCTAGGTTTAAAATTAGAAATGTTTTTGAAATAATAATCAGAACTTTTTAAAAAGGTTAACTGTATAAATATGAAATATAAATTCCATGAACTTATCGAATATTAAAACTATTCCACTGGAAGAAACTAGGGGTTCTGCAAACTGGAGCTCTCATGGAATAATAGAAGGTGTGTCCATTTGATAATATTTATTGAATCCATTTTTTCATACTGGAAAAATCCTCAAATCAAGAGTAGAATGCATCTTGATACTCTACTATGTTCCATAGTCAAAAATTTAAATGGAACCAATACAAAAAAAAAAAACAAATTATCAATAAAATAGATCTGAAATACTGATGTTGTTTAACTAGGTAGATTTTTGTTTAGTGAAGCAGTTGGATGGATAGAATTAATATGCTAATAGTATCTTTATCTATTTTAG
>TTN-208,,0,454,1872399,1872852,GTATGTATAAACTGAATGACTTGTTTCCCTCTTTTCTTCATTTTTGCTCAGTTCATTAAATTTTCAATGCTATGAACCTGATTTGCAGTTTATGTGAAATAGTTAAAATGATCTTAGATTTTTTTAAGGTTAGAAATCTTTTAAAAGTTATTTTCCTCAGAGTTACTTTCATGCTTTGACATTACAAGCTAAATCATTTAGTCTTATTACTAACACTAAATTCCAAGTGCTAATTTCTAATGCAGAAGTTCAAGTTTTACTTTTACTGCCTTGTTGCATCTCTGCTTGATCCTGCTTCAAATCCTAGCACTAAGAATTGTGTTGGTAATAACGATCCCAAATATAATACTTCACACGATTATATATTATCCTTACCTTATCTCATTTGCAATTAACAACCTAAGAGAACTTACCTATTTAAGCATCCCTTCTTATTCCTGTGTTTTTATTTCAG
>TTN-208,,0,441,1872853,1873293,GTAAGTAATTAGAAATATTTAAATAGACTAGAGCATCAACATCATTATCATGGCTTGTTTGGCAGCAATGTATAAATCAGCAGTTCAATCCAATAGGCACAACTTCTTCTCTAAGCTTTATTGTGAATGATTTTTTTTTCTTAAAATTTCTATCTAATTGATTTCATTAAAAAATCAAAAGATGATAAAAATTGTAATGGTAAACTTAAATATAACCAAAATATGTTAAGTACAGAAACTTGTACCCAGAGTTCAAAGTTGTGCGTAAAGGTCAAAGAAAAAAAAACCGAACTCATCTCTCTCTTTAAAAAATGATACATGTATCTGCATATACACTTATAGGTGTGTATAAACACATATACACAGAGAGAGAGAGATAGAGAGAGAGAGAATTTTAATAGGAATTCTAAAAGTACTGCAATTTCTCTAAAATGCTTGCAG
>TTN-208,,0,152,1873294,1873445,GTATTATTTAAAACATTCCTAGCACCCATGTACACAAGTAATATGTTTACTGATCTATACTCACATTAGTTATTTATATAATCAAATACTTTTAAATTTTGTGCAAAGCAATATTCTTCAAAATACAAATATATTTGTACATATTTTTAAAG
>TTN-208,,0,590,1873446,1874035,GTATACATCTTTGTGTTTCAGCTACAAGTTCAAAATTTTTTTATTTATGTGTATGGACATGTGTACATATATTGCTAAGTAACTCACAAATCTGAAACGACCAAAAACAGCACATTTTTACATAATACAAATTTTATGTTGAGTTGCACATATGTTTAATTTAAATAGTAACATTATCTACTTTGTTTCTAGTTCTGCTTAAAAATTACATTTTTTTATTATAAAGAAGGTTTGTGTTTAATTAGTAGTTTGCTAACTTCACTATGCAATGCATTCCATTGCATATAATATTCCCTGTCCTCTTATTTATAGAAATAGACCCTAACAGATTTGGAAAAGCACAACATTGTGTGTGAAGAAGTTGTGTCTATTTGATTCTCATTTAAGAATGTTTGATGAAGGCTGCATGCATTGTTTGTCCCTATAGATCAAAACATGATTTGTTTTCTTGTCAATACTGAATTTGTTCTCAAGCTACCATATTAACCCACTCATTCTGTGTCTAAATACTTGAGTATAAAATCCATGTGTTTGATCTGATGTCTTGTACTAAAAAAAAGGAATACTAATGTGAAATACTCTCTTTAAAG
>TTN-208,,0,232,1874036,1874267,GTATAAGGCAAACTGGAATGTGGGGGCTCAAATGGAAGGGTTTTAGGCAGATTTTTATCCCTCTTGTTGTCTAATTTGTGATCGTGTAGACATTTCTGTCTCCTTGTAAATTCTGTCATCTTTTTCATTTCATGTTTGTCTCTGTTTTCATTTTTATTTTAATGTTCTTTGTAAATTACAATTACCACCCACAACATGGCATATCAGTAATTAAAATGTACATTTTTTTAAG
>TTN-208,,0,1028,1874268,1875295,GTATTAGTAATTCATTCTAAGTTTAAACTCTTTTAATAAAAATTAGTACAAATACCATAGTAAAACATTTATGTTAGTATTAAATAATAGATTTAGTCACAGTGTGCATACCTATAGCCACTATGTACAAAGGATGTGATGGGGGACGGGAAGAACCATGAGGAAGGCACAGGGGGAAAAAAGTGAAAATTATGGGAGGCTCCATTCCCTGCTTCAGAGAGTTTGCAATCTCGTAACCTGTTACTTGGAAATACAGTGTCCTGGAGCCAGTTCATGCTAGCTCACCAGAGCCTATGGTTACATTTTCAGGAATTTTGCCAGTCAGTAGTTTAACACCACCATTATTAAAAATTAGATTATGTAAATTTACAGTCCAATAAAGTATATTTTTAAATATTAATAAATACTCAAAACTCCTATTTTACTGCATTTTGTTCTTATCTGTGTTTCTGAGATTGTTTCCATCTTTGTGTCTGTGTGGTGGAAATGCCATATAATGTACTACTGCACATCTCTTTCCAACTCCAGGACAATGACATCACCTTGACAGCCAGGGTGGGAGGGAGTGTTTATACCACCTTGGAAATCGGAAATCTGCAAGCACTATAGATCAAGGCTCCACCCCCTCCATCCCACCCAAATTGTTAAACATTTAAGACACAAAAAAATCTAATGCAATTGTATTTATGAAACTGCTTTATAAAAGTAAAGGTTACAAAAAAAAAAACTAACTTCATAGTTATCGATGTTCATAAAAAGCTGGTTTCTGAGGAACTGACACAGGCACCTCCGAGGGAGGATTGCTCCTACCTGTTCCTGACAAAGTAGAGGCTTCTGCAGTTAAAGGTGACAGCAGTCACATTTTCTAATTAGCCATTCAGCCATCTTCATTTACTCTCATTTCTAAAGCATAATTTTCTTGCATTCAGTTGGTATAAAAAGGGAATCTCTATTTAATTCTAAGTCTTACAACAACATATGCCTTGTCAAATGCACACTTTCTCAAAAATGGCACTTTTCTTTTAAAG
>TTN-208,,0,397,1875296,1875692,GTAGAATAATATTTGTGAAAAAAATAATTCTTAGCATCCATCTTGTATCTTTTTCTATAAGATCTGTGTATTAACAAAATAGCATCTGTAAACCATCTATAATATATTTAATTCTGTGTATATTGATTTCATTTATTTGTGGTGATGTGTTATACAAGTATTGGTAACATTTCTAAACTCCAGATCACGCTAACTGGGTCTTTGTCTGCTTGTGTAATGTATGTAATGTCTATATGGTGTTGAGGTATTTAGCTTTCATTTCTACCACAAGTAGGCATATTTAAATTACTTCCTAATTCTCACACTGTTAGTGAAGATTTATGCTTTAATGTAATCTTAGATGTCTCAGAAGGTGACTAGAATATTCCACATTATTTCAACAATTGTATCTTTAAAG
>TTN-208,,0,2119,1875693,1877811,GTACGCCAGAGCCAATGATGGGGAGACTCTTTGCTCCAAGTGCCAGCCTTTTGCTTTCTACGATCTTCATATGTACTATGCTGCCTTTGTCTTTTGTCTCTTTTACATTCTTCTTGTGTTTTTACTGTTTGTCAGCTTCCGTGCCATGCTCTTGACATACTTTATTTATTATACTGAATATTCCTAAGACATCACCAAAAAGTATTGTTAAAGGAAGTAACTATGTCAAACTGCTATCTTACATTTTTAATATCTTCCCTCTTTTAGAGAAAGAGGAAATGTTTGTGAAACTTGTTTTCTACTGACATGTTTCTAGGAAAAAACCTTTCATCCTTCATAAATGTAACTTTTTCTTAATAAAAGCAGTTTCATGCATTATGAAGAGGTGGAGACAGGCAATGACAACTGGAGAGTGTCTGGCAGAACTGAATGTTAATTACATAAAGACGTACATAGTACCACGCTTCTTAAAAGTCAATAGTGGCGAGTCTTCAATAGTGGGGAACATACAGATTTTTTGAAGTTTACTTTCACCATTTTCTTGAGACCTTAACTGAGCTTCAGTATTTGCCATAAATGTTTCCGTTATCTAATTAGCTAGTCAAAGTACCTTTCACAGAGGTATGTTTGAATGAAAATGTGCTGCTGTGGTATATCACAAATCCCTTGCTTTGGTTTGTTTGGGATTTTTTTGGCGATAAAAGGCACTATCTTATTGAAGCACTGAAGCTACAATTGCACGCATCCATTCAGTTATAGAGAGACTCAGCAAGAATTCAACATTATCCAATTTAGGAGAAACCAGACCTAACTAAAATAGTACATTTTGAATAGTGTTCCCTTGGCCTGACTTTGCAATGTTTCTATTTTCTTCCTGAATCAAATATGCTTCTCTCTTTCTCAAACTCTTGGCTCTTTCAAAATTCTTTTGATTATCTAACCATTAAATACAAAGGTCATGTTAGTAAAACCAATACTAATACTAAAGCTACTTGAGACAGATCGTCTTAGATAAATTAAATCCATTGTTATTATGTACTACATTTCCCCATACAAAGCATAAAGAACCTTTTCTATATACTATCTGAACATTCTTGACTGTTTGTGTAATCACTAATTCGTTTTCAGCAAAGTCATATATGTCTTCTAAAGGAGACACAGAGGCATCTCTCATTTACTCATAAAAACAAATACACATAGTATAATAGCACGTATATATATATAAATACTGCATGTATATATAGCATAACATATACATATATAAATTAACAGCTATATAATTGCACCAAAATATTACAAATGCACGTGCAGAGGTGCAGGGATTCACAAAAGCTGCCAATATTGTATTTAAAATGAGAACAATTATTGCCAATAATGCATGCTGTTAAAATTCATCTTCCAATTAAAAAGTCAACATTATCCATTCTTAGAATAGATAAATCAAATACACTGTAAACATTTTTTAGGTTGAAAACCCTGTTCAAAACTCTAGAGCCCCTTAGAAAAAAAAAGCACAAATACACATACCCACAAAATTCTGCACACAAAGCTCTGTAAAGTCATTAACACATGGGTATCAGATTGAGAGACCTACTCTAGAGTGTTTCCTGAGTTTTGAATTCACTACAGGCACACCCCCCAAAAATGAGAGGAGAAATGTGGGGAAGAGAAGTAAGTTACACATATTCAACTATTCTAAGACTTCTTAGTCTTAGTCTAAAATAGTCTTAGATAAACTAAAGCCATTGTTATTAAGTACTCCATTTCTCAATACAAAGCGTAAAGAAGTTTTCTATATACCATATCCACATTCTTGATTGTTTGTGTCATCACTAATTTGTTTTTAGCAAGGTCATACAATATATAAAGGATGAATTCTGTGCACAACTTTGTTACATAACTCATTTTTGCCTAAATGCCTCTAAAACATTATTTGTGATATTTATCACATTGTGATCCTTGGAATAGTATAGTTAGTTTAATTTTCTGGATAATTTTGCTGATGCATAGATAATCCATAACAACATTAATGTACTACATAAAGATTTGTGCATGTGCCTATGTTCTTTCATAAAAGTGATATATGTCTGAACTAACATTGTGTTTCAAAAACTTTAAG
>TTN-208,,0,217,1877812,1878028,GTACAGTGGCTTTCGACGTAAAGCCCTATCTTTTATCTTTGATACAAAATATGTTGTGTTTAATTATCTGTTCATTGAGTTAGTTTAATTCTAAATGAATGTTTTGTGGTGAGAACTGAACAAAAGTGTCTGTCCACCCGTCTGCTTTCTTAAAAAAAATAACTGTGCATAGCTACTTTAGAAAATATAAAGTCAATTCTAAAAATGTCTCTTCAAG
>TTN-208,,0,141,1878029,1878169,GTACTTAATCCCATCTCCATGAAATAACCTTGTCTTTCCTTCAAGCCTCTTTAATTGCATGTCTTCTTTAATTGCCACTTCTATGTTGCTCATTTATTTGGCCTTTTTGACAAATTTTAAAATTCAATACTATCCTTTAAG
>TTN-208,,0,153,1878170,1878322,GTATTGTTTCTCCATCTTCCCAAGAACTGTCTTTATGTTCCAGTGATTTTGTTAGTTTTGTGATATGAGTGCACTGTGGGTGTATTTCTTTGTTTTGCACTGGGCTTCAATGAGATCACATTAAATTTCTAAAAGTGCATAATGTCTCTAAAG
>TTN-208,,0,274,1878323,1878596,GTAGGATTTGCCTCAATCCTCTGACAAAAAAAAAAAAAAAAAAAAAAAATCTTCGAGTGTGTTAAATTCTTGCTTTTTCCATCTGGTCTGTGCTTATACTGATCCATTGTCTCACTTGCAGTGAAACTTTTGTGTTTATGTCCTTGTGATATGTAACTTGTTTTCCCATTTTGCTAGTCAAAGTGGTGTACTGTGCAACTCTTCCCCAAATTCTAGAAAGTGAGAATTGTTAAAATTCTTGATTTTAAACTTCAACTTTAACACTTTCTTAAAG
>TTN-208,,0,452,1878597,1879048,GTATATAATCGGAAGTCAGGGGATAAATGAGTTTGTGTGTGTTTCCTCAAAGTCTCTTCTTCTTCCACATGTGATTGTTTACTTTAGAACATGTCCTCATCAGTTATTTCTCCTTATGTTGGTATTAGAATGTGTCTACCTTTTGTAGCCTTCTGGGACTGAGTCTTTTGTGTCTATGTTGGCCTTGAATCATTCGAAGGAAGTGGATGAGTCCCGAAAATGTTATAATTTTGAAAGTGGCCACACTTGGACATAACTCAAGTATCATTCTCAGTCTTGGGCTGTACTTGCCCTCATCTTAAATTAGCTTCCTCCTTCTTATAGTGAGGAAGTACCATGAAGCTATGTCCTAAGCAGATAGAAGAACAGTTATCCATCTGTAGTGACCACATGGCTGTATATACATCTGTATCTCAGCAGGCTGAATTTAAATGAAACCTTATCTTTTAAAG
>TTN-208,,0,2512,1879049,1881560,GTAAACAATGCAAATAAGCTAGAGATGATCTGGGGTTTTGATGAGGTGTTTTCTTTCACAAATTGTCTACAGACCAATGAAAAGAGACAGAAAAAAGTGACACAAATTCAGTGAACATCTACCAGTCTCATTAAATGAATATTTTGATCAAAACACAAGATTCAGGAGGATTATACTAGATTAGAGAAATCCAGTGTATTTCTTCTGCATCCCTTCTTACTTGCCTACATAGAATAAAAGAGGCTTCATATTTATATATAATTAATCAGGGCAGGTATCTCCATATACATATATCCTTTCATTAAACAGGACTTGGCTTCAGCATGGTGGGCTGGCATAAGCTTTACCTTAGTAGCCTAATGCCTAATTGGTGTTTCTCAAACATTGCTTGTACCACAATCCACAGACAGAAATATATTTTATATTATAATCCTTTAATTTTTTTATTCTAGGCATTTAAAAAATACAAGTTATAATCCATTAAGTCAATTGCAGAAGTCACTATAATGTCTTAAAATGTTTTAAAATGAGCAAGAAAATATATTACCTCATTACATTCCAGGAGTCAATGCCATATTTGTGAGTCTGAAGCCCTGAACACATAAGGCTTTCCTGTATTTTACATATGGAGAAAACCATTGTGTTATATATGGGATCAGACTGACTTGTTACTCAGATCTTTTCATACCTATAATGCTAATTATCTATAGTTTCTTAAGGACAGAACCAACAAACTATTCCATTGGGATATTTTTTCAATGAATTAAGGCAGCACCAGGTTTCCAACTAAAATCCAGCATTCTGGCTAGAGCCATGTGGCCAAAAGAACTTTCCTAAGAAAGTTCCTAAGGTCTGCTTTTAAAGAGAAATCAATAAGCTCCTTAACCAAACTAACTCTCTCCCCAGTGAGAAGATGAGTAGAATTGAAGTACATTTAGATGTCCCAAGTATCTGTTTTTATCTGTCTAATAAAAGATGGCACACCATGCCCCTTTTTTCACTTGGAACAAAAGCCCATGTAAAAATCCAAGGTGCCATAGTCTTAGTGGAATGCCTTGGAATAGGCCAAGATGGGACATGACTCCCAGGAGGAAATCCATTAACTCTGTTGTGCTTCCTGGAAGAGGCCATGATGGTGGACATAAGTCAGGAAGCTGGTAGATTTGAAGACGACTCCATCTTTTCTAAAAGTGTTTGTAAAACCAAACATAGTCTGATTTCAACTTTTGACACTATAAACTTCCTGTAGTACTCCAGACTCTAGTTAAAAGGAGAAACACTGTGATTATTTTTATGTTCTCATTATGCCCCAAAGATGGGTGGCTTGTTAGGTTTACTTTCAGCGTAAGGAGCAGATATGTTTTTAACCAGACACTTCTATTCCTTATTTAACTTTGACCAGGCATGGTGGCTCATGCCTATAATCCCAGTGCTTTGGGAGGCTGAGAAGGGAGGATTGCTTGAGCACAGGAGTTCAAGACCAGCCTATGCAACATAGCAAGCCCCATTCTACAAAAATTAAAAAAACAGCTAGGCATGGTGGCATGCACCTCTAGTCCCAGCTACTCAGGAGGCTGATGCAGGAGGATCATTTGAACCCAGGAGTTCGAGGTTACAGTGAGCTGTGATTACACCACTGCATTTTAGCCTGGGCAACAAAGCAAGACATTGTCTTAAAAAAAATTAAAACTGGCCGGGCGCGGTGGCTCACGCCTGTAATCCCAGCACTTTGGGAGGCCGAGGCGGGTGGATCACGAGGTCAGGAGATCGAGACCATCCCGGCTAAAACGGTGAAACCCCGTCTCTACTAAAAATACAAAAAATTAGCCGGGCGTAGTGGCGGGCGCCTGTAGTCCCAGCTACTTGGGAGGCTGAGGCAGGAGAATGGCGTGAACCCGGGAGGCGGAGCTTGCAGTGAGCCGAGATCCCGCCACTGCACTCCAGCCTGGGCGACAGAGCGAGACTCCGTCTCAAAAAAAAAAAAAAAAAAAAAAAAATTAAAACTGTATACACTTAGGCTCAAAAATCATGTGAAGCCTCCTGCCTCTTCTACCATACCTGCCCCACAAAACTGGCGGGGAAAACAATATGGAATATTATCTTACAATTCACTTAAATCCTCAAGTATGTTTCTGCCCTGTGGCCTTCAAATCTACAGTGCTCTGCTATTTGTGAAACTCATCTTCAAATTCTTCTGTTCTTATTAACTCAGCTATTATAATCGTTTCTTGTCCCGTACTTGTCCTGTCGTTGCTGTGGATATAAGCATTATTATCTGTATGACACATTTGAAAATTAAGTTAATGAAACCTATTTCCCATTTCCCATACTCTTCATTAACGCATGTGCTTTGATTAAAATGCTCTTTGAGTATTTTAAATAGGAACAAGCAGGGGTTTGGCAAGGGTTAAACTTTTGCTATTTTGATTACTCTTTGAAGTGATAAATTAAAGCTAAAAATAAACATGAAAAACACTGTAATTTATCTTCTTTAAAACTGCTGTCTTTAAAG
>TTN-208,,0,187,1881561,1881747,GTATGCTGACTCTTTAATTAGTTTTATCCCTATGTTAGCTTGTCTCCTTCTTTATGTTTCCTTATAGCTAATTTGTCATCCATATTGCAAATATTGATAAATATCATGTCTAATAAAAAGATCCCTTACACTTTTATCGAAAAGAAATCTAGACATTTCTACAAACATATTTTATAATCTTTTCAAG
>TTN-208,,0,263,1881748,1882010,GTATGATTTCTTTCAAAGAAATGCAACACTATTTATTTTAATGTATATAATAATACCTTCACATTTGCATAACTGTCTTATGCATAACAATTTGCATAACTGTCTACGTTTTGTCAGAACACATGTATGAACGTATTTACTGAGTATAGTCATTAACGTTTGTATATATGTGCAATCTTTTCAAAAAGTGAATGCTAAGCCCCACAACTGTGTCACTTCATATGTAAGGCAAACTCATATTCTTAAACCTAATCTTTCTAAAG
>TTN-208,,0,156,1882011,1882166,GTATATTGGATTTTATTTTATTCTCAAGACTGTCTTTTTTTAATCTTAAATTGATACATTCTTCAGATTTTTTAAACATTAACCAGAAAATAAGTGTGCCTGTGTTTAGTGTTTTCCATATCGTATGTTTGATGGTATTGCCTGGTATCTTTTAAG
>TTN-208,,0,252,1882167,1882418,GTAAACAAACCTCCCCAGCAGAAAAACTAGGAACATATGGCTTGTCTTTCTTTCTCTCTGCTGCTGTTCTTTGGGTCATACTGTTTATATGTTGGTGGGTGACAATGGTGTCTTTGGGTAGAGTATTACTTGTGATGTTTTTGTGTGTGTGCCTTGTAAATTCTTCTATTCTAAAATCACAGTACTTTCTGGCTAGTATATTTTTTACGTCCACTTTGATATAACTCCCTAATCCTAAAATTATCTTTTAAG
>TTN-208,,0,247,1882419,1882665,GTACATCCGCCCTTCCATTATGCACAATATTGTACTTGCCCTACTCTCTTTACCAAATACACTGGTTATGGGGGCTGGTTTTTGTTGTTGTTGTTGTTGTTGATGTTGTTGTTGTTGTTACAGTTGTTGTTTTATGTTTGAAATAATGAAAATGTCAAGTGTTTATGTTTGGGCTACTACTTTATGGCTGCCTTTTTGTGGTTTGAAAGAGGGAAACAATACTTTAAAGTGAAATCTCTCTTTAAAG
>TTN-208,,0,707,1882666,1883372,GTATACTGACTCTTAAAAAAAAAAAAAAAATCAAAATAAGCATCCAGACACTAAAACTAATCTAGTGGAATAGGTTCCATTAGAAAAAAAAAGACATAGTATAAAGTAAGCAATATAAGTTTGTTAATGCATATCACTTCAAAACTAAACATTTTTGATAACAGAAAGTACTTTTTTCTTAAAAAAAAGTGAGGCTTCTTCTAAACGTATGTGAATAATTTTCCTTAATCTGTATTTGTCTTCTAATGTCTTTTCCATATACTAAACTCATCTGCCTAGATGCTTGCTTTATGTGGCAATCTCTGATGAAATTTTTAATTTTTTCAATTCTGAATTTTCTACATTGTACCAATAGAGCTAAGGAAAATGTCTTAGAAGTGAGGTGAAGAAACTATTCATGTAACATAGGTTTCTGTCTAATGCTTCTACTTAGTTTGATAGTCATTATTTATGCTGTTTAGTTGTCTTTTTAAACTTTTATAAATACTACTTGATTTTCCTAAAATTATTCAATGTCTTTGACGTACTTCATATGTATATTAGAGTAAGTTTATTTCCAAGTCTATTGATTTTCTTGCTTTTTAAATGAAAGTTTAATCAGGCACTGTTATGGTTGTCTTTGTCCTTGAATTGTTTGAACAAAATTTCTCTTCACACACACATTTTCAGAATCTTGCAATTCACTTTTAATAATTACTCCTTTAAAG
>TTN-208,,0,307,1883373,1883679,GTATATTGAACTTTGATTAAGTAATGTGAGGCATGAAACTATCTGGCTCTTTGCCTTCTAGTTCCCAATCTGACTCCTATACTTTATTAGCTTATTGTTGATTAAGGGCAGGGTATATAACATTTGAAATCACAATTGCTAAATATACTCTATGATACCTTGACTGGCCAAAAAAGAACAGTCAGGGTCTCCCATAATCAGTGCATGAAACAAACGCAAAAGAATAAAATCAAAGCACATTGTTACTATCAGTCATCCTTAAAAGTGCTTTAAAGTAAAGTGCTGCCTGTTGTTAATATTGTTTCAG
>TTN-208,,0,958,1883680,1884637,GTATGAGCAAAACTGCAAACTCAAAACCACACTAAATATGTGCACACTCAAACAAGATAAAACAAGATAAATCATAACAAGATAAAAATTTGGATACCCAAAGAAATTTGGAAAGAACTTTGTTTCATTTCGCAAATGCGGAATTTTCTTCTTTGATAACTTCTAGAAAAAATTTTAAAAACCCTCTATAAATCTTAAGGTTATTGTTAGACTTTTGTTCCGGGAATAATCTAATACCCCCCTCATTTTTGCTCGTATGCAAAATAGCAAATGTCCCTAAGTTTCTTTTTCAAAAAGGTTACAAGTTTATCTTCAAGTGCCCGTGATCATTCTAGTACATGGTTAAAAATTTCTGAACATCCTTTATTCTAAAACTTGCTATTACGGAGTATGATAGGCTATTGAGAAAATGTATTTACCCACAGGGTTCCCATTATCAAAACTTGACAATGACTGCTTCAAAAGTTAAGATAGAGATGTAAGCTAACACAAGCTGTTGTGTTTTACCTAATGAAGGTCAAATTTGTTGGCATATAGTTTGGGCTTCAAATTGTTTATTTTACTCAAAGAATAAATCTCTATTGAAATTTTGAAATGAATCAATCTTATTTCACTTATTCAGTCTCTGATGTTTCATAGCCCAACTTTGAGAACATTCTACATAGTCTTACTGATAGCTTTAAAAAAACCATATTATAGGGGAGTTTCAGCCAGGAATTTATCTACCTGAAATGAAATGAGAATTTTAATATGTAAGAATTACCTAATTAAAGAAAATAGCAAGAAGGAAAGGGCAATATGAGCTTGTTCTGCTTGGATCTCTGATTCTTGCCTACTTCAATAGGCTATGGCTATACTGTAGATAAAAGATATTATTTCAATTATTTGATTCCTTTTAAGAAATGTTTAAACTTATATTCTAAGTCTAACATGAAATACCTTGTATGTACTTTTAAAG
>TTN-208,,0,210,1884638,1884847,GTAGAGTGAAAAAAACATTATTACCTGTAAGAGATCTTTGTTTCCTCCATGTCTGTCCTACTATAAAAATATATGTAAAAGTGGCAGTGTACAAATTATGTGTGTGTTTGGGAATATTATGTTGTATTTGTCTTTCTTAACTTTTTGTTCTTGCTAGCCTTGAGAAACCTGTTTCAATTTTTAAAATCTCTTAATATTGATATTTTGAAG
>TTN-208,,0,204,1884848,1885051,GTACATTACTGAGTAATAATCACCAAAAACAACTTTGTTATGTATGTTCTAAAATCATGTCTTCCTAGCCCGTCTGATGGTCTGTGTTTTTGCTGAGTAGGATGTTCTTGTCCTGATTCTTACATTTCAGTTTTTTATGTGTATTTATTACATAGTATTCAAGGAGTTGGTTTTAATGCTCTTTAATAATTAATATCTTTAAAG
>TTN-208,,0,747,1885052,1885798,GTATAATGATTTCCTTCCTCGATTGTGATCTTTTCTGATGCCTCTTTTGAAATTAATGTAACTATGATTCATTTCATTTTGTTGTTTCATGTCTTTTAAATTAGTTGTCAGCAGAATGTTGGATGTAAAAATGTGTAAATACAGGATAAGAAGATAATGCCTTTAAAAGGAAAAATTATTTCTAAATACATCCATAGCCTGTTAGCCAGTGGCTGTGTCCTGCCACATGGCTACAATACATATAAAATAGAATGTTTGGGTTTAAAATCAGTGACCGTTTGGCATATTCCTGATTTACCTAAATGATGTAATGATACCATAATATTCACCAAGCTTTGGTAACTGTTTATTCATTCTAAATTCATTTTGAAGATTTTTTTTAAAGCTAACCAGTTTCCAGTCATTTTCCCCCTGATTCATACTAAGTATGAAGTATACTAATTGAGAAGTAAATTTCACTTTTCAGGAAGGATATTTCTTTCAAGCAGAGATATTTGAACACTAAACCTCATTTCACATTTGGGCTCTGCTACTTCATGTTTACTTGGGTACTTCTGTGTACTTGTATTTATATGAAGCTCAGAATCCTTTCCACAGAGAGTATATAGTTTCTTAAAGATGAACAATCGCATATGTATCTCATTAAAGGAAGATACATTATTCTATCTGCTTAAAGTACAGCAAAACAAGCATTGGCTGGGTGGCCTTTTACTGACAATAAAATTTCCTTATACTTCATATTTCAAG
>TTN-208,,0,198,1885799,1885996,GTACCTAATGGCACTCATTTTAATGTTTTGTTCGTCTTTTGCTGTTGAATTCCTCTTCAGTTCTGTGTGTGAAAACTTCTTTTGTGGGAAAAGTAAATCTTGTCCTTTCTTCTGTTATAAATGGGCCTGTGTTTCTAAGGTGTCTTAATTTTGTTGAGTCATTGGCAAATGTCCAACTTAAAGATAATATCTTTAAAG
>TTN-208,,0,211,1885997,1886207,GTAGATGATGCCTCCTGCAAAGGGCTGTGCAACAGCATCTTTGGAGTTTGGGGGTCTGATTTGGTCAGATTCTGGGGGTTATTGGCAGCACCAATGATTGCTTACTTTAAAGCAGATATTTTTAGATGCTGAAATATGATTTCTACAGGTGCTTTTCACATTTTATTTCTTTCCTGCAAAATTTCCAACATTCTTAATAATATCTTTAAAG
>TTN-208,,0,182,1886208,1886389,GTACACCACCATTCATTGACGGGTATCTAAGAGACTTCATCTGCCTAGAAATAGTTAACTTTCTTCTGAGTTCAAAACCTTGTGTGTGTGTCACTGTCCGTTGTTAAAAAACATTAGCTGTGTTTTATATGGATGTGTTGTTACTAGTAGTTAGAACTTAACAATAAACAATATCTTTAAAG
>TTN-208,,0,508,1886390,1886897,GTACATCCTTATAATCCATCAGTGGAATAGCATGATAATTCACCCATGCAGCATAACTTGGTGAGCCATAGCAGATCTTTCCCCATGACAATATTAACAACATTAATGCCATGACAAGCGCCTCTCAACTGGCCACAGGAGCAGTTTACCCGGTATTCATCTCTGAATTTTACCATCAAATTATGCTTATGCTCAATGGTTGGCTCCTCCTCTTTAGTGGAAAGTTCTTCAAGTAAAATACATTCCTTTTGCATATCAAAATGGACAAAACCATCATTTACCAGGCATTGTGTCTTGTCTTTATCACCAGTCCACGTTTTTTTCGGTGTTTTTTATTTTAATTTTTGTGTATTTTCTGGCCTTTGTTTTGTGGCTATTATAATTTTCAGTCTTAAAGTGAAATTGATAGAATATCTATGCTGCTTCAGTTAAGGCCTTACATTGCCAGCCTTAAAATCTTAGCTATGGGTAAAAAATGTGACACTAACTCTATTTGATATCTTTGAAG
>TTN-208,,0,249,1886898,1887146,GTACATGAACTTGCAATGTTGCAATATTTTTATTTCACATTTGCATATGGGTAAAAATTAATTGGTTTAATTCTGTACTCTTTGGGATGCAACTCTTTAGAGAAAATTAAATATTTTATTTTAAAAATAAAATGCTTCTTGGAATACCTTTGTCATACTTTTATTACCTTATCTTAATCTTTTGAAACTATGCTTGGAATCAGTATTTTTATGTCGTATAAAATTTTTCTCTAAATCATTTCGTTAAAG
>TTN-208,,0,205,1887147,1887351,GTACATAATTTCATCACTTAGAGTACTTGGGGGAAAAAACTCACATCTATGTATACTCACATACAAATTTCCCCATTACATTGTACATTTTTAAAGTGTCTATCTGGTTAGAAATATGTCAGATATTTTGTGATTCTTTTTCATATCTATTGCTCTAAGACATTTTAAAAGAACATATTCCTAAATATAAATAATATCTTTAAAG
>TTN-208,,0,207,1887352,1887558,GTACATTAATCTGTAACAGAGCCATGGTAAAAGACAAAACTAACTGGTGTTATACAGCCTTACTAATTATAATTAATGCTTAGTATTTATGTTGATAATAATTGATGCTTTGTGATCACAGAATATTTGCCTTTCATAAGCTTCTTCATTGTTGTGAATATTTTACATAAAAGTGATGTTTGTACCCTTGAATAAATATCTTTAAAG
>TTN-208,,0,333,1887559,1887891,GTATAGCAGCTCTTCTTGGAATCATCAAGGCCTCTTTTGTGTTGAATTCTGCTTTCCCATCCTTTTGTTCATCTCCAGTTTTATCTATAATCCTTTACCCTCTGTGATTGACCACCTAAATCTTAGAAAACATTCCAGACATGTGTGTTCTTATTGTGTATCTGCCTTGTGTATCTGTCTATTGTAAATTATCTAAATGTCTTTTCAAATCACATATTATGTTTACATGTTTGTGGTCTTATCCTCACGTGTCTCTTTCATATATATATATATATATATATATATGACCATGTATATGTGGTTTTTAATGCCTTCAAATGAAATGTTTTTAAG
>TTN-208,,0,1205,1887892,1889096,GTACACCTCCCCAAAGTGAATACACATTGTTCACCCATAGCTTGGTCACATAAATTATGATGAAACTGGGTTTTAGGAAAATTATATTTACAAAATGGATAATCACACAGTTACATATTTACTTCTAACGATGTTCAGGAACACTGATATCTACTTTTTTCACTGATACAAAGCAGTATTCAAGAACAAAGATGAAAGGAAGCATTGTCCCAGAACTGATACAAAAGTTCTGATTTCATATCATTTGATTAAACATCATAGTTTTCATGGAGATATATTTAAATATATATGAATAAGTATACTATATATTTAAATGTATTGAAAACTATTATGAATAAATATTCTTAAATTTCTTCCTTCAACCATTTATATTAAATGCCTTTTTAACACCAGGCTAAAAAGAAAAAAAGATGAATGTATTTATCAAAACACAGAATAATAGTTATGTCTTCTAATACATATATATAAAGGGCAGCCCAACAGGTTTTGATTTTAGCGTTGACTTTACACCTTGTTGTATTACTCTCAGCGAGTCCTTTAACCAACCTGAGCCTGAAGTTATTTTCCTGTAAATTGGGGATGCTAATATCAGTCTTAATGGGCTCAGCTATTATGGTGAGAATTAAATAAAGTAAGGTATTAAAGTAGTCTATCATTGAATGAATAGTATCCAGATTTAACATATTCAATCAGCTCATAGTACAGGACAGAATTAATATATTTGTGCTTTAAAGCTCAATAATATTTTCTACAAAAGATGCTGGCATGGCTGCTTAAAATCAGCATAACCCTCGCATCAGGCCATATAGTTATATAATCAAATGAAATAGTAAAGCTGATCTTTTATTGGATATCAACGATTCAGAAATACTTTCTAGACAATAAATTACTAGTGAAATTTAAATGTATGAAATGATATTAGGTTGGTGCAAAAGTAATTGCGGTTTTTAGCATTAAAAGTAATGTCAAAACCGCAATTATTTTTGCACCACCCTAATAGCATCTGTCCTCTGATAATGACATATGCTGCTGGTCCCTTGCTTTACAAATCCCAATTACATTATAATATCTGGGCTCCCAACTAACATGACAGACCTGTCTTGAGCGACTGTTAACACATTGGTCTTTCTGGGTGTGGGGTCTTCTTGGTTTCTCTTTTTTTGTCCTTCAAAATAAATCCTTATCATGAAATGATGTCTTTAAAG
>TTN-208,,0,166,1889097,1889262,GTATTGCTATTCCGAAGTAAATTAGACTATGCCATTTCCTTCCTTCTCCTATAAAAGTCAAAATGTCCTGTTTCCGTATTTGTTAATACAACTTATATTACTGCTGTGTCTACTTGTCTTTGTGTGTGTGAAACTGAACTTATAAAATAAAATAATATTTTTAAAG
>TTN-208,,0,557,1889263,1889819,GTACATCATCCCATAACAGGGATATGTTTGCTGCACCGATGTTGAACTGTGGTTCTATCCACACAGGACACTCAACATAAATGTGTGCATTGTATGGTCTGTCATTCACATTCGTCATTTCTGACTCTTTTGCACCCAAGTTTGTGTTGTGTCCATTTTTTCACTTGGTGTTGGTGTGCTTTACATCGTTTCTCTATGTATGTTGTTTCTAAAAAATAAAAATATATCTTTAAAGAGCCAAAAATAACTAAGGAACTAGTCCCTGAAATACCCATTTCTTCATACCCATTTCTTCCTACAAAAAAAAAAAAGACAAAAGAAAAAAGAAATAGAGGCTCCAGCAGTAAAAAGTAGAATTTCTCTTTAATAAACCCTAAATCTTAAACCACAAACCTTTTTATTCTTTTCTCATTAACCGATTCTGTGAAATGTCAATGTTTCATCTTGTGTATGTGCCTTGTGATATTTACTCTCTTATGTTGGAAACTGGAAACGTGGTCTTTATTCTTCTTTGGTTCTTGCATTTTAAGTGTCTAAAATAATCAATGTCTCTCAAG
>TTN-208,,0,629,1889820,1890448,GTAGATAACTTTCTAAGAAAATAACATTTCAAAGTCATCCTTGTCTTATTATTGTCTAATATTTGAAGTAGGTAAATGTAAAATTTACCCCAGGAAATCAACATATTCAGATTCTAAAATAAATTATTATTAACCTAATAGAAATTGGGCAGGCAAATTAATATTATTTGAATCTCTTTGCATGTTCAGCCTGTTTGTCTGTTTGCTATTTGTTTTATTTTAATTAGAATTCATGAAGGGAAACTGTATTTGCTGTGGGAAATTTTTCATCAAATGACTTAGTAGGCAACTGTAAAATAAGCTTATCCAAGAGAAATTCCAGTTAAGCCTGAGTAACTGGTGCAGAAAATCTGATTTCTACCCCAAGTGGCTGTTTGACTTCAAACAAGTCTTTCATTAAAAAAAAAACAATAATAATTTTTTTATTATTATAAATTATCTGAAGTCCTTTCCAGTTCACAAATGCTGGGATATGCCTAACATATTTTGAAGACCCAGTAGAGATTTTTTAAGGACTAGTGAGTTTACACAAGCGTTTCGAAGGCTGAGCAGTTTTCAGATATTATCACTGTAGTCTAATATTCAAAATAATTATAAAAATAATTTACAAAATAATAATCTTTTTAAAG
>TTN-208,,0,603,1890449,1891051,GTATAACCGCTTTTAAGGATTGAACATTTAAAATTCCTGGTGTTCCAAATCTTTCTCAGTAGCTAAATCTAAGATTCACCAGTATGCTTTTCTTATATCGTATCCATGATAAAGTGAAGATTAATTATTCCTGGCACCTGAATCTATGTGTCCTTTTTTTACCCTAAATTTTTCTACAACATCTGCAATACAACTAAGAATGAGAGATTACTATTTTGTTATTGGCGATTGAATTTTTTTCTGACCAGGCCCTACTATAATAGTTTCTCCTAGATTTCAATCCTTAATTTTGTTTTTAATATTAATATGGGGGGAATCTATTTCTCTGGTGAAAGTGTTCATTTTTTAAGAAAAATCTTTAATTTACTATTCCTGAAGAGTGTGATAATATTTTGCATAATTGGTATTACATTTGCTTATAGGATTTCTAAGTAATATCCTTTACACCTCTAGGGTTCCTACTCCACATTTATTATTACCATTTAGGTTGCTAATATCTTTTAAAAATAAGTCAATGTTTTGTGATATTTATTTATTGGTATATGGGTGGTGTTCTGCTCATCACATGCCACTTTTCAAAATGTTCATAAAATTTCTTTTAAG
>TTN-208,,0,929,1891052,1891980,GTATATCAAATCCTCATTATTAATATCTTTAACTTCCCATTAATTTTCTTTCTTAAAAGCAACATTTTCTTTTTTGACTGCCTTCTTATAATCATTTAGATAGTGAACTGATTAAGGACCAGTAAAAATATAACTCATTCCATTTCTTTAATCTTTTCTAGGATGTTAACGAATAATTGTGTGCATGTGTTTACGTATGAATTATTCTAGAAGCTTCTTAACTGAGAATTTTAATATATTAGTATGTCTCTATATACTTATACACATAGCAATGGATCCCTCTTCCCCACATTTTAGATTTTATTCCATAAGTGGAACGGAGTTTTCTTCTGTGTTATAATAATTATTTTACTATATTTATTATTTTATGGAACAAACCTAATGCTTGGATAATAACTATTTTAAAGAGCCTCACGTCCCTTTTGTAATGTTTAGCCCAAGCATTCAAGGTTATTACAAAATGTCTACTTTTCCCTGCTTCCTAATTCACTTAATGCTTCAGACAGTGCTCTTAAGCAGTTAGATTATGCTGTCCCTGTCATAGTAGACTCCTCAGCTAATAGAAGAGTGCACAGCAGAAAGTGAGGCCAGTGTCAGGGCTTAAATACTCTACAATGGTAATCACTTCAAAAAAGTCTTCATCAAGTTAAAAATAGTAAAAGTGAGTCCATATTGGTAATCCCTGTTATTAAAAGAAAAAAAAAAGAATGGCACAGGTACTTTGTGGACATTTCTTCTTCTATAGGAATGTTAGAACAAATGAGTGATTTGAGAAAGTATCTTTATTGCCTCTAAAATGGATGTCCCACAGTACAGAGTGACTTCTGAAAAACTTTAATTATTGTAATGTTGGCGTTGTCTCTGGTGTTTTTATTTCATGTGTGTTATTGAACATTCTCAGCTAACTAAAACACCTAATATCTTTAAAG
>TTN-208,,0,153,1891981,1892133,GTACATCTTCTCTTTTAAACCTGACTTCCTCTTCTGTCTTTTTTCGTTAAGACTTTTATGTTTCATGTCTCTGTGTCTTGATTGTTTTTGATGATTTTTGTCTATGAAAGCTTGCTCTCGACAGTCCTAAATATTAAAACTGTATCTTTAAAG
>TTN-208,,0,139,1892134,1892272,GTATTTTTGGAAAGATCCTGGATTTTCGTGTATTGTTGCATGCAATCCTTTATTCAGTTTTAAAAATATATATTTTGAATGTACATCTTTATTTCTTCAGTGTTTAAAAAAATAAGTCTTAAAATAGATGCTCTTTCAG
>TTN-208,,0,800,1892273,1893072,GTATAGGGAATTCTTCAAATACTACAAATTCTTATATCTTGCTCTAACTTTCCTTTGAAAGTAAATTTTGTGTTCAGTTTGGAAGATTAGAAACCCCATGAAATACTTTAAACATGAGTTTAAACTAGTTGACACAAAGATTAATATCTCTTAACCACACGGAGTATAATTTTAGTAGATGATAGTAATATTTGATATCTACTTATCTAAGGAGGTCACTGTATGAATTTGGGGATTATTTTTTAAATCTGACTAAGAATGTTACACAATTGTTACAGGTACCAAAATAACTGACCAGTGTCATTGGTTAAGTGAAAAAGAAACTCCTCAGTTCACTGAGGAATTTACATGTTCAGGCAAAATAATCACTGCTTTAACATTTTAGTCAACTGTTCACAAACTGAGAAATACTTACCAAAAGCTTTTGCCAGTTTATGATACTTTCATTAGAGAAACAACATTAAGGAAGTGAAGTATTGTTAATGGCACCTGTATTCTAGCATACTGTGAAGACAAGCCATAGCACAAATAAGTTATCTGCAATACCACTCTAGATCTTGCACAAATTAACAATATATGTGTAATATGAAGGAATGTGTGTGTGTGTGTGTTTAGCATATATAGCAAATTACAATATACATGATATTTAGCAAATCAAATCTCTTTTGGAAATAAGTGTGTTATAAATTAAAAAAATATAGATAAAGAATTTTGTGACCCCTCATTGTACTAACGTTAGTAGTAGTGCTCCAAAATACTTCAAGAGTTCATTCTAAACCAAAATACTAATATCTTTGAAG
>TTN-208,,0,794,1893073,1893866,GTATCTTCTTTGTGAAAAATTACTACTTAACTTTACATACAATAGCACCTTGGTTGCTTTATAAGCACAAGTTTGCATTCCACTTGATGTCTTTCTTCTGTATTTCTTGTTTCTGACATGTCTAAAACAAACTAATATCTTTAAAGCAGCTGAGGGTCCAAGGGAAGTTCTACCAAAAAAAGACAGTCACTGTTGTTATACCTAAAACAACCAAAGCAAATATCTCTAGTAACCAAATAGTGAGCCCAAATTTCCTCCTTTGGTGCTATTTGGTTATATATTCACTAACATGCTTACTGATAAACACATGTTTTTCTATTTATTATTAATTATATTAACCTGGCAAATATAAATACATAGTGAATATGTGTTTAATGTTCTTGCTTTGTTCATTTTTGCAAATCTCTTAAATTTCACAATAGAAATAAAAACAGTATCTAATAAATAATATAAACTTATTTCTTTAAAGTCTCTGAAGCATGTGCGTAAGTTATCACTGAAGAGAAGGTAGCAACTCTTCCACAAAAACAAACAGTAATAGCACCAGCTGAAGGTGTACTGTTAATTTTTCTTCTCAAGTTCTTACCATTCTAACATGGGAAATTTCCCTGGATTTTTGTTATTATATATTTTTTAAATTCAATGCATTTGAAATACTGTAATGTATTTGATAAAGTGTTGTCTGCATTTTATATTGTTGCTGTGTTCTGTTCTGTGTTTATATCTCTCATGCTCTGCTTGTTAAAAAATTGTATATTTAAAAATAAAAGAAATTATTACTATTATCTTTAAAG
>TTN-208,,0,542,1893867,1894408,GTAACTGGCTTTTCTCATTCATCATTAATATAAAATCCTTTTTTATTCACTTACTATGTAAGAGAGACCTTTCTCTTCTCAATGCCACAAGATGGCTATGAATGACATAAACTTCAATTTATGTTCTATAACATAATCCTGCCTTTTGAGGCAATGTTTTAGGCGTAAAGACATAAGCCCAAAGTTATCATTTGTATTGATCCTCTTATTTAATAACTAAATAATATTGATCCCTCAACTTCTCTTTCAAAAATAATTCATTTTGGAAGCTCTTCTGAAGTAGCTCTGGAAAAAAAAAAGTGTGCTCTAAATGGCAATAGAAAATGATACTATCTCCAAAGAGCAAAGTGTTTCTGATATAATGAATCAAGAACTCATCGACAAAGCAATTCAGAGAAATGCAATGACTACATTTGACTTATAGTTGACTTATAATTGAGGGGTTTTTGGCGTTCATCTTGTTAGATGCCCCTTCTAGGCTTGCTATGTTTACACCCAACTATAATGTTCTGAAAAAATAAGATAAATAAATATCTTTAAAG
>TTN-208,,0,144,1894409,1894552,GTATACAGTGATGCTAATCAGAACATGAAATAATTCTTGGTTTAGTTTTTCATGGTTTAAAGTGAATGTGTGTGACATTAAATCCTTGTATTTCGTATCTTATATTTGTTATCTGTAACAATTAATATACTAATATCTTTAAAG
>TTN-208,,0,1651,1894553,1896203,GTGAGTGTAGAAAAATTAGTGGTTCTTTTTCGTTTCATTTATGTCCTTAAATTCACTATGTTTGTCTTTTTAGCTTTGAAAAGTAAATATACTAAACTCTTATAAAAGCCTAACATGCCACAAATATATGACTCAAATAATCTTAGTGTCTATTATCCTCAGACAAGTTATATTTCCTCACCAATTTAAAAAAGAAATACTCTACTTATCAGAGTGTATGATTTCAGAAAAGTCAGTTGTCTTGTTAAATTTTCCTAACCTATTCTGTATACAAGTGTCTTTTGCTTTGAAGCAATTTATTTTCTCAGATCATGAAGTAACTTAACTCCATAATATTTTAATTGGATTTTATAAAATCAAAATGTTTCACCATTATTTTTTTTTTTACTCTTGATAACCATAATTGGAAACATTTTGGCAAAACTGCTCAAAGGACCCTAGGTTTACAAGGCCACTCAAACCTCAAAAGAATTCTCACGACCTTTTTTTTTGGGGGGGGGTTTCATACAAAATTAGGTTTAAATAATTTGAATTATGAAATAATCCAAATAGTAAAATATTGTGAATAGAATACTGTTCAACAACCTGAATAGTAAAAGTGACAGTAGTCAAAATATTCTTCCTTTTTTTTTTTTTTTTGAGATGGAATCTCACTCTGCTGCACCCAGGCTGCAGTGCAGTGGCACGATCTTGGCTCACTGCAACCTCCGTCTCCTGGGTTCAAGCTATTCTCCTGCCCCAGCCTCCCGAGTGGCTGGGATTACAGGTGCCTACCACCAGGCCCGGCTAATTTTGTGTATTTTTAGTAGAGACAGGGTTTTACCATGTTGGTCAGGCTGGTCTCAAACTCCTGACCTCAGGTGACCCGCCCACCTCAGCCTCCCAAAGTGCTGGGATTACAGGCATGAGCCACTACACCAGACCCGCTTCCATTTTTTTTAATCTAAAAAATTTCCTGTTGAAACTCAACTTTCTTGTTGTTCATCCTGTTATACTAAGTTGGGATAAAATAATATAATCACTTCCTCCTTTGAATATCCTTTCTATTCTTGACTTTAGTTATTGTTTTCAGACAGTTTTTCTTTCTAAAGGCTGGAGAAATTTTTGTTGTCTTTATTTGCCTTATTTTCTAAGTATTTAATTTTTTTAATTTTCTGCCTCCAAACCCTAAATGGCTTTTACATTCATATTAAACTGTGAAACCATATATTAGATGTGATTTGAAAATATAGATAATGAGGCTTCTAGAAAGGGAAAAGACTTACATGAATTTCTAGTAGGTCAAATATCGGAGAATTCTCAATGTGCAATTCAGCATCTTCCCTGTTCTTTATAGACAAATCCATTAAAAATAAGACCAATAGGACAATTTTACCAATAACTTTCTTAAGGCAAAATGAAGAATTATATAGTCCTTGCCTGAACAATTCCTCCATTTTATTATCATCATCATAGAGAAATGCTTAGAGTCTTACATCATGAAACTGGGAGTGAGGCTATCCCCAGCCAATGCATTCTAGCCACTAATTTGCCTCTATGTGCTACTATTAATTTTGGTGATGAATGTGGTATTATATATTATATTTTTCTTAATACACTTCTTTATCCACCTTGAAACATCCTAATTATTTAAATACTAATATCTTTAAAG
>TTN-208,,0,112,1896204,1896315,GTATATAACACCAATGATCCACTCTGAAGAAAAATTATTTTTTGGCCCCTTTTAAAAAGCTCAATATTTTTCTTCACCATTTATAAATATAACTATACTCATATCTTTTAAG
>TTN-208,,0,122,1896316,1896437,GTATATTTCAAATACATCAAACCCAGATGAGTATCTTTAGCTTTATGACTCAAACATTGCATGCTTTTTATAATTTACTGTTTTTACAACTTTTAAATGTAAACCTACTAATATCTTTAAAG
>TTN-208,,0,334,1896438,1896771,GTATAATTCTCTAGTTAGGAAAATCTAAAGAAGAAAATATACTGTCTTCAGTCTGCAAAATATTTAATGTTTAATATACATTCTCACAACCTCTAATGTTAAAATACTGTGTTTAAAGGATCTGATATACCCACAACAAAGAATGACCTATGACTTGCCCCCAAGAAAGTCAAGTCCCACACATATAATATACAAAGATAAAATATTAGAACAAAAATAACATTTCTAACATAAAGATATCTGAAATGATATTAACATATCTAACTTTCTTAGTATGTCATGTCTTTATGCCTTTGCCTTTTCTCAATTAAAAAAAATACTAATATCTTTAAAG
>TTN-208,,0,1032,1896772,1897803,GTACAAGTTGGAAGAAAGTCACCTTTTTAATCTCATGTTTGCAGTTGTACTTAACACATGTAAAAATACTAATATCTTTTAAGCCAAAGTGGCTACAGTGGAAATCATTTCAGAGATGGATCCCCCAAGTAGAAGCTCAACCAAATGTATTCATGTCCCAGTGAGTCACTCAAGAGACAACAGAGGGAAAAAATACCTTTAGCTTATACACATGAAAGATAGTTGAGTCAGTGTATTTTTATGAGGACTCCAAAGAAAATATATATACACATATTATGATCAAAACATGTCTTAAAGAAAATATTAATTCAGTGTGAAGCTGATCTGTAATATCTCTACAAGATTAGAGCACCTGAGACCCTCCCAGAATATCCTCCAACCTAGGGAAAAATAATTCCAGTTAAAGCTGGAAATCTCCCCTCCATGTTCATTTGCTCCTCTCATAGCCTATCTTTTATTTTTCAAGCATCATTTTTTTTCATTTTGAATATCTTTAGATAAGTCAAAACATGAAAAAGCTTTAAAACCTCCAGAACAATAATTTCATCATAACACCCATGGTATTCTGTAATTTGAAGAATATCTGAATATTTTGATATTTTTTCTCAGTCTGGAATCTTTTGGTTGTTCTCCTCTCTCCTAAACTTGAAAAACACTCACCTTTTTAAGGTGCCTGAGGTGTGAATACAAAAAAATGCCGACCTAGATTTTTCGAAGTGGCTGTAATTTGTTTTTCTCAACATAATAGCTAGAGGTATAGCATTAATTATAATCAATGTTTCCACTTTCCATGATCTAGTTTTCTATGCATCTACCATTCCAAGAAATAAAATTACTAATACTGATAGTGCCTGAGGTGACCAAGAAAACAGCCGCTTATAACCAAATACTCACACTGCTACAAAAGATCCGATTCTGGGGGCGGGGAGTGGGAGAAGGTTCCCATCTGGAATGTTCTGTATGTGCAGTTAAGATGGGAACTCTTTACTCCTCTTCATAACTCCAAAGTACAATGCATTCATATCTTTAAAG
>TTN-208,,0,247,1897804,1898050,GTATCGTTCATCCTGCCATTCCTTCCTTCATTTATTAGAGTGCTTAGCATGTACAGGGTGCTAGGGAACTGGAGAATAATAAACAAAGACAATTAATATGTGGTTCCTCTCCTCAAGATTGTATACCTCCTCAGATTCTTTAAAGGAATCATCTTTTTAGCCATAAATATCACTTTGGTTCAGCTCATTTAATTAATGTCTCCACTGATCCTTTTAACCTCTAACCATAATACTAATATCTTCAAAG
>TTN-208,,0,450,1898051,1898500,GTACGTTACCTCTGAACAAATGTGGAAGAAGAAATTATCTGTCCTCTGCTCTTAAAACTATGGTTTCTTCCTAATACTCTTCATAAATTCTAAATATAAACATACTAATATCTTTTAAGTGTCTGAGGTTCCACAGGAAGTTTCCTCTAAAAAGAAATTATTTATGGCTGTTTCTGCCAAAACAGAAAACACTCCTGCTGGAAGTATTCATTCAACAAATCCTTTATAATGAGAGTGTAGAGTGTCGCGAGAGCTCTGTGAGGTTCTGGAGGAGGGGGAGCACCTCCTCTCAAGGATCCACTAACCCCTTAAAAGACTTAGCCTATTGGTGGAACAAAGGGAGGATGGAGGAAAGAGAAGAAAATGTGGTTATATTTCCTAACTTATTGTGGTTACTGTTTTCCATTAATCATTTTAACTCTTAAATGTGAATTGCTAATATCTTTCAAG
>TTN-208,,0,114,1898501,1898614,GTACAAGTCACCATGCTCTCAGGGTCAAGAACTAGCTCTTGTAGTTTTGAGAATATTTTTGCTATTCCTAGTTATCTGCATAACACTAAACATAAAACTACTAATTTCTTAAAG
>TTN-208,,0,116,1898615,1898730,GTATATCTTGCTGGAAGCTTAGAGGGGTGGGAACATGTCTTTTCTTGTATAAATGTTTTTCCTGATTGTGTTGATTCTTGTAACTTCTAAATGTAAAATTATTAATATCTTCAAAG
>TTN-208,,0,361,1898731,1899091,GTACATTCTTAACTGTCTTTTTATGGTGGGATAGTGGGTGGGGCGATAGAAAGGACCACCTTTCTAGTTTTGAAAATTATTTTGATGTGTACATGTGAATCATGTCTGTGTTGACTCTTGCAACTCAAGTGTAAATGTATTAATATCTTCAAACTGCCTGAAGCTCCCAAAGAAATGGCTACCAAAAAGAAAATACCGGAAGTTCCTCCTCTAAAACCTGAAACACCACCTATTATGGGAACTTGTTACCACTGATCTCAGCTCAGGAGAAAAAAATAGCTCTTTTGTTCTTGAAAATGTCTTTGTATCTATCTAGTAATCTCTGTATTTTCTGAGTGTAAAAATACTAATATCTTTCAAG
>TTN-208,,0,112,1899092,1899203,GTATTTGTCACTGACTTTAGGCTTCAGAAGACCTAATTCTTCTGCTCTTGACAATATTTTTTTCTAGCGGTCTTCATAACACCTAAATGTAATTTCACTAATATCTTTCAAG
>TTN-208,,0,108,1899204,1899311,GTAGTTGCCACTGACCTTAGGCTTCAGATCTCATTCTTTTGCTCTTGAAGATATTTTTTCCAGTGGTCTTCATAACTTCTGAATGTAATTTTGCTAATATCTTTTAAG
>TTN-208,,0,110,1899312,1899421,GTATTTGTCACTGATTTTAGGCTTCAGATGATGTATCTCTTCTGCTCTGGAAAATATTTTTCTAGTGGTCTTCATAATGCCTAAATGTAATTTCACTAATATCTTTCAAG
>TTN-208,,0,83,1899422,1899504,GTAGACACCCTCTTGTTGCTGTGTTTGATATTGTTTGTTTGTCTTTACTTTGTCTAATAATGAAAATACTAATATCTTTAAAG
>TTN-208,,0,210,1899505,1899714,GTAATGCCAAAGCTATACAAACTATAGGAGAAAAATAACTGTTATTTTAACTAGGAAATTACATGTTAAAAATCCTACTACATAAAGATGATATAATTCTAAAGAAAACAAATGTCAATCGCTATCCAAAATATCTTGGTGGGTGTTTATATGCAAAAGGCATCCATCATTTTCACCTTTTCTAAACACAAATTACAAATATCTTTGAAG
>TTN-208,,0,153,1899715,1899867,GTAGGTATCATTACACATTGTCAGTCGGGGGGCCCTGGGGAAAGACTGCATAGAAGTGTCCGCCGATCTCACAAGTTGTATTTGCTTGGGTAAATGTGGAGTCGATATTCCCCCTTTATAGCTTCTAACTAAAAGATACTAATATCTTCAAAG
>TTN-208,,0,112,1899868,1899979,GTATTTATTCCCTCTCCTCTGCTAAGAAAAACTTATCGTCTGTACCCCTCACAATCACTGTAATATATACCTTCACCATTCATAAATTATAAAAATACTAATATCTTTCAAG
>TTN-208,,0,114,1899980,1900093,GTACATGTCAGCTCAACCTTATCCTGCAGAAGAAATCTCTCTTCCATTCCTGAAAACAATTTTAGTCCATTCCTCTTCATTAACCTAAGTATAAAACTACTAATATCTTTCAAG
>TTN-208,,0,115,1900094,1900208,GTACACTTTAGCCCTGACTTCATTCTGCAGAAGAGATATCTCCTCTCCTACTGTAAACAATTTTAGCCCATTTCTCTTCATTAACTTAAGTCTAAAACTACTAATATCTTTCAAG
>TTN-208,,0,113,1900209,1900321,GTATTTTTTACCCCTGTCCTTTTTCTGCAGAAGAAATATCTCTTCTGATCTTAGAAATATTTTACTCCATTTGTCTCATTAACCTAAGTGAAAAACTACTAATATCTTTCAAG
>TTN-208,,0,105,1900322,1900426,GTACTTGTCATTTGACCTTAAGCTTCAGAAGATCCAATTCCTCTGCTGTATATTTTGCTAGTAGTCTCCATAGCTCCACATGTAACTTTACTAATATCTTTTAAG
>TTN-208,,0,2503,1900427,1902929,GTATTTGTCACTGATTTTAGGCTTCAGATGATCTATCTCTTGTGCTCTGGAAAATATTTTTCTTTTTATATATATATATATTTTTATTATACTTTAAGTTCTAGGGTACATGTGCACAACGTGCAGGTTGTTACGTATGTATACATGTGCCATGTTGGTGTGCTGCACCCACTAACTCGTCATTTACATTAGGTATGTCTCCTAATGCTATCCCTCCCCCATCCCCCCACCTCACAACACACTCCGGTGTGTGGTGTCCCCCTTCCTGTATCCATGTGTTCTCATTGTTCAATTCCCACCTATGAATGAGAACATGCAATGTTTGGTTTTTTATCCTTGTGATAGTTTGCCAAGAATGATGGTTTCCAGTTTCATCCATGTCCCTACAAAGGACATGAACTCATCATTTTTTATGGCTGCATAGTATTCCATGGAGTATATGTGGAACATTTTCTTAATCCAGTCTATCATTGATGGACATTTGGGTTGGTTCCAAGTCTTTGCTAATATGAATAGTGCCGCAATAAACATACGTGTGCACGTGTCTTTATAGCAGCATGATTTATAATCCTTTGGGTATATACCCAGTAATGGGATGGCTGGGTCAAATGGTATTTCTAGTTCTAGATCCCTGAGGAATCGCCACACTGACTTCCACAATGGTTGAACTAGTTTACAGTCCCAGCAACATTGTAAAAGTGTTCCTATTGCTCCACATCCTCTCCAGCGCCTGTCGTTTCCTGACTTTTTAATGATCACCATTCTAACTGGTGTGAGATGGTATCTCATTGTGGTTTTGATTTGCATTTCTCTGATGGCCAGTGATGATGAGCATTTTTTCTTGTGTATTTTGGCTGCATAAATGTCTTTTTTTGAGAAGTGTCTGTTTGTATCCTTCGCCCACTTGTTGATGGGGTTGTTTTTTTCTTACACGTTTGTTTGAGTTCATTGTAGATTCTGGATATTAGCCCTTCGTCAGATGAGTAGATTGCAAAAATTTTCTCCCATTCTGTGGGTTGCCTGTTCATTCTGATGGTAGTTTCCTTTGCTGTGCAGAAGCTCTTTAGTTTAATTCGATCCTATCTGTCAATTTTGGCTTTTGTTACCATTGCTTTTGGTATTTTAGACATGAAGTCCTTGCCCATGCCTATGTCCTGAATGGTATTGCCTAGGTTTTCTTCTAGGGTTTTTATGGTTTTAGGTCTAACATTTAAGTCTTTACTCCATCTTGAATTAATTTTTGTGTAAGGTGTAAGGAAGGGATCCAATTTCAGCTTTCTACATATGGCTAGCCAGTTTTCCCAGCACCATTTGCTAAATAGGGAACCCTTTCCCCATTTCTTGTTTTTGTCAGGTTTGTCAAAGATCAGATGGTTGCAGATGTGTGGTATTATTCTGAGGGCTCTGTTCTGTTCCATTGGTCTATATCTCTGTTTTGGTACCAGTACCATGCTGTTTTGGTTACTGTAGCCTTGTAATACAGTAGCGTGACGCCTCCAGCTTTGTTCTTTTGGCTTAGGATTGACTTGGCAATGTGGGCTCTTTTTTGGTTCCATATGAACTTTAAAGTAGTTTTTTCCAATTCTGTGAAGAGAGTCATTGATAGCTTGACGGAGATGGCATTGAATCTATAAATTACCTTGGGCAGTATGGCCATTTTCACGGTATTAGTTCTTCCTATCCATGAGCATGGAATGTTCTTCCATTTGTGTCCTCTTTTATTTCGTTGAGCAGTGGTTTGTAGTTCTCCTTGAAGAGGTCCTTCACATCCCTTGTAAGTTGGATTCCTAGGTATTTTATTCTCTTTGAAGCAACTGTGAATGGGAGGTCACTCACGATTTGGCTCTCTGTTTGTCTGTTATTGGTGCATAAGAATGCTTGTGATCTTTGCACATTGATTTTGTATCCTGAGACTTTGCTGAAGTTGCTTATCAGCTTAAGGAGATTTTGGGCTGAGACGATGGGGTTTTCTAGATATACAATCATGCCATCTGCAAACAGGGACAATTTGACTTCCTCTTTTCCTTATTGAATACCCTTTATTTCTTTCTCCTGCCTGATTGCCCTGGCCAGAACTTCCAACACTATGTTGAATAGGAGTGGTGAGAGAGGGCATCCCTGTCTTGTGCCAGTTTTCAAAGGGAATGCTTCCAGTTTTTGCCCATTCAGTATGATACTGGCTGTGGGTTTGTCATAAATAGCTCTTATTATTTTGAGATACGTCCCATCAATACCTAATTTATTGAGAGTCTTTAGCATGAAGGGCTGTTGAATTTTGTCAAAGGCCCTTTCTGCATCTATTGAGATAATCATGTGGTTTTTGTCGTTGGTTCTGTTTATATGATGGATTACGTTTATTGATTTTTGTATGTTGAATCAGCCTTCCATCCCAGGGATGAAGCCCACTTGATCATGGTGGATAAGCTTTTTGATGTGCTGCTGGAAAATATTTTTCTAGTGGTCTTCATAATGCCTAAATGTAATTTCACTAATATCTTTCAAG
>TTN-208,,0,83,1902930,1903012,GTAGACACCCTCTTGTTGCTGTGTTTGATATTGTTTGTTTGTCTTTACTTTGTCTAATAATGAAAATACTAATATCTTTAAAG
>TTN-208,,0,210,1903013,1903222,GTAATGCCAAAGCTATACAAACTATAGGAGAAAAATAACTGTTATTTTAACTAGGAAATTACATGTTAAAAATCCTACTACATAAAGATGATATAATTCTAAAGAAAACAAATGTCAATCACTATCCAAAATATCTTGGTGGGTGTTTATATGCAAAAGGCATCCATCGTTTTCACCTTTTCTAAACACAAATTACAAATATCTTTGAAG
>TTN-208,,0,153,1903223,1903375,GTAGGTATCATTACACATTGTCAGTCGGGGGGCCCTGGGGAAAGACTGTATAGAAGTGTCCGCCGATCTCACAAGTTGTATTTGCTTGGGTAAATGTGGAGTCGATATTCCCCCTTTATAGCTTCTAACTAAAAGATACTAATATCTTCAAAG
>TTN-208,,0,112,1903376,1903487,GTATTTATTCCCTCTCCTCTGCTAAGAAAAACTTATCGTCTGTACCCCTCACAATCACTGTAATATATACCTTCACCATTCATAAATTATAAAAATACTAATATCTTTCAAG
>TTN-208,,0,114,1903488,1903601,GTACATGTCAGCTCAACCTTATCCTGCAGAAGAAATCTCTCTTCCATTCCTGAAAACAATTTTAGTCCATTCCTCTTCATTAACCTAAGTATAAAACTACTAATATCTTTCAAG
>TTN-208,,0,115,1903602,1903716,GTACACTTTAGCCCTGACTTCATTCTGCAGAAGAGATATCTCCTCTCCTACTGTAAACAATTTTAGCCCATTTCTCTTCATTAACTTAAGTCTAAAACTACTAATATCTTTCAAG
>TTN-208,,0,113,1903717,1903829,GTATTTTTTACCCCTGTCCTTTTTCTGCAGAAGAAATATCTCTTCTGATCTTAGAAATATTTTACTCCATTTGTCTCATTAACCTAAGTGAAAAACTACTAATATCTTTCAAG
>TTN-208,,0,105,1903830,1903934,GTACTTGTCATTTGACCTTAAGCTTCAGAAGATCCAATTCCTCTGCTGTATATTTTGCTAGTAGTCTCCATAGCTCCACATGTAACTTTACTAATATCTTTTAAG
>TTN-208,,0,2502,1903935,1906436,GTATTTGTCACTGATTTTAGGCTTCAGATGATCTATCTCTTGTGCTCTGGAAAATATTTTTCTTTTTATATATATATATATTTTTATTATACTTTAAGTTCTAGGGTACATGTGCACAACGTGCAGGTTGTTACGTATGTATACATGTGCCATGTTGGTGTGCTGCACCCACTAACTCGTCATTTACATTAGGTATGTCTCCTAATGCTATCCCTCCCCCATCCCCCCACCTCACAACACACTCCGGTGTGTGGTGTCCCCCTTCCTGTATCCATGTGTTCTCATTGTTCAATTCCCACCTATGAATGAGAACATGCAATGTTTGGTTTTTTATCCTTGTGATAGTTTGCCAAGAATGATGGTTTCCAGTTTCATCCATGTCCCTACAAAGGACATGAACTCATCATTTTTTATGGCTGCATAGTATTCCATGGAGTATATGTGGAACATTTTCTTAATCCAGTCTATCATTGATGGACATTTGGGTTGGTTCCAAGTCTTTGCTAATATGAATAGTGCCGCAATAAACATACGTGTGCACGTGTCTTTATAGCAGCATGATTTATAATCCTTTGGGTATATACCCAGTAATGGGATGGCTGGGTCAAATGGTATTTCTAGTTCTAGATCCCTGAGGAATCGCCACACTGACTTCCACAATGGTTGAACTAGTTTACAGTCCCAGCAACATTGTAAAAGTGTTCCTATTGCTCCACATCCTCTCCAGCGCCTGTCGTTTCCTGACTTTTTAATGATCACCATTCTAACTGGTGTGAGATGGTATCTCATTGTGGTTTTGATTTGCATTTCTCTGATGGCCAGTGATGATGAGCATTTTTTCTTGTGTATTTTGGCTGCATAAATGTCTTTTTTTGAGAAGTGTCTGTTTGTATCCTTCGCCCACTTGTTGATGGGGTTGTTTTTTTCTTACACGTTTGTTTGAGTTCATTGTAGATTCTGGATATTAGCCCTTCGTCAGATGAGTAGATTGCAAAAATTTTCTCCCATTCTGTGGGTTGCCTGTTCATTCTGATGGTAGTACCTTTGCTGTGCAGAAGCTCTTTAGTTTAATTCGATCCTATCTGTCAATTTTGGCTTTTGTTACCATTGCTTTTGGTATTTTAGACATGAAGTCCTTGCCCATGCCTATGTCCTGAATGGTATTGCCTAGGTTTTCTTCTAGGGTTTTTATGGTTTTAGGTCTAACATTTAAGTCTTTACTCCATCTTGAATTAATTTTTGTGTAAGGTGTAAGGAAGGGATCCAATTTCAGCTTTCTACATATGGCTAGCCAGTTTTCCCAGCACCATTTGCTAAATAGGGAACCCTTTCCCCATTTCTTGTTTTTGTCAGGTTTGTCAAAGATCAGATGGTTGCAGATGTGTGGTATTATTCTGAGGGCTCTGTTCTGTTCCATTGGTCTATATCTCTGTTTTGGTACCAGTACCATGCTGTTTTGGTTACTGTAGCCTTGTAATACAGTAGCGTGACGCCTCCAGCTTTGTTCTTTTGGCTTAGGATTGACTTGGCAATGTGGGCTCTTTTTTGGTTCCATATGAACTTTAAAGTAGTTTTTTCCAATTCTGTGAAGAGAGTCATTGATAGCTTGACGGAGATGGCATTGAATCTATAAATTACCTTGGGCAGTATGGCCATTTTCACGGTATTAGTTCTTCCTATCCATGAGCATGGAATGTTCTTCCATTTGTGTCCTCTTTTATTTCGTTGAGCAGTGGTTTGTAGTTCTCCTTGAAGAGGTCCTTCACATCCCTTGTAAGTTGGATTCCTAGGTATTTTATTCTCTTTGAAGCAACTGTGAATGGGAGGTCACTCACGATTTGGCTCTCTGTTTGTCTGTTATTGGTGCATAAGAATGCTTGTGATCTTTGCACATTGATTTTGTATCCTGAGACTTTGCTGAAGTTGCTTATCAGCTTAAGGAGATTTTGGGCTGAGACGATGGGGTTTTCTAGATATACAATCATGCCATCTGCAAACAGGGACAATTTGACTTCCTCTTTTCCTTATTGAATACCCTTTATTTCTTTCTCCTGCCTGATTGCCCTGGCCAGAACTTCCAACACTATGTTGAATAGGAGTGGTGAGAGAGGGCATCCCTGTCTTGTGCCAGTTTTCAAAGGGAATGCTTCCAGTTTTTGCCCATTCAGTATGATACTGGCTGTGGGTTTGTCATAAATAGCTCTTATTATTTTGAGATATGTCCCATCAATACCTAATTTATTGAGAGTCTTTAGCATGAAGGGCTGTTGAATTTTGTCAAAGGCCCTTTCTGCATCTATTGAGATAATCACGTGGTTTTTGTCGTTGGTTCTGTTTATATGATGGATTACGTTTATTGATTTTTGTATGTTGAATCAGCCTTCCATCCCAGGGATGAAGCCCACTTGATCATGGTGGATAAGCTTTTTGATGTGCTGCTGGAAAATATTTTTCTAGTGGTCTTCATAATGCCTAAATGTAATTTCACTAATATCTTTCAAG
>TTN-208,,0,83,1906437,1906519,GTAGACACCCTCTTGTTGCTGTGTTTGATATTGTTTGTTTGTCTTTACTTTGTCTAATAATGAAAATACTAATATCTTTAAAG
>TTN-208,,0,210,1906520,1906729,GTAATGCCAAAGCTATACAAACTATAGGAGAAAAATAACTGTTATTTTAACTAGGAAATTACATGTTAAAAATCCTACTACATAAAGATGATATAATTCTAAAGAAAACAAATGTCAATCACTATCCAAAATATCTTGGTGGGTGTTTATATGCAAAAGGCATCCATCATTTTCACCTTTTCTAAACACAAATTACAAATATCTTTGAAG
>TTN-208,,0,153,1906730,1906882,GTAGGTATCATTACACATTGTCAGTCGGGGGGCCCTGGGGAAAGACTGTATAGAAGTGTCCGCCGATCTCACAAGTTGTATTTGCTTGGGTAAATGTGGAGTCGATATTCCCCCTTTATAGCTTCTAACTAAAAGATACTAATATCTTCAAAG
>TTN-208,,0,112,1906883,1906994,GTATTTATTCCCTCTCCTCTGCTAAGAATAACTTACTGTCTGTACCCCTCACAATCACTGTAATATATACCTTCGCCATTCATAAATTATAAAAATACTAATATCTTTCAAG
>TTN-208,,0,114,1906995,1907108,GTACATGTCAGCTCAACCTTATCCTGCAGAAGAAATCTCTCTTCCATTCCTGAAAACAATTTTAGTCCATTCCTCTTCATTAACCTAAGTATAAAACTACTAATATCTTTCAAG
>TTN-208,,0,115,1907109,1907223,GTACACTTTAGCCCTGACTTCATTCTGCAGAAGAGATATCTCCTCTCCTACTGTAAACAATTTTAGCCCATTTCTCTTCATTAACTTAAGTCTAAAACTACTAATATCTTTCAAG
>TTN-208,,0,113,1907224,1907336,GTATTTTTTACCCCTGTCCTTTTTCTGCAGAAGAAATATCTCTTCTGATCTTAGAAATATTTTACTCCATTTGTCTCATTAACCTAAGTGAAAAACTACTAATATCTTTCAAG
>TTN-208,,0,105,1907337,1907441,GTACTTGTCATTTGACCTTAAGCTTCAGAAGATCCAATTCCTCTGCTGTATATTTTGCTAGTAGTCTCCATAGCTCTACATGTAACTTTACTAATATCTTTTAAG
>TTN-208,,0,113,1907442,1907554,GTATTTGTCACTGACCTTAGGCTTCAGATGATCTAATTCTTTTGCAGTTGAAGACATTTTGTTCCAGTGGTCTTCATAACCCCTAAATGTAATTTTACCTAATATCTTTTAAG
>TTN-208,,0,109,1907555,1907663,GTATTTGTCACTGGCTTTAGGCTTCAGAAGACTGAACTCTTCATTTCTTGAAAATACTTTTCTAGTGGTCTTCAAACTTCTAAATGTAATTTCACTAATATCTTTTAAG
>TTN-208,,0,111,1907664,1907774,GTATTTGTCACTGGCTTTAGGCTTCAGAAGATCAAACTCCTCTATTCTTGAAAATATTTTTTCTAGTGGTCTTCATAACCCCTAAATGTAATTTCACTAATATCTTTTAAG
>TTN-208,,0,111,1907775,1907885,GTATTTGTCATTGAGTTTAAGCGTCAGAAGATCTATCTCTTCTACTCTTGAAAATATTTTTCCTAATGGTCTTCATAACTTCTAAATGTAATTTCACTAATATCTTTTAAG
>TTN-208,,0,110,1907886,1907995,GTATTTGTCACTGATTTTAGGCTTCAGATGATCAAACTCTTCTGCTCTGGAAAGTATTTTTCTAGTGGTCTTCATAATGCCTAAATGTAATTTCACTATTATCTTTCAAG
>TTN-208,,0,84,1907996,1908079,GTAGACACCCTCATGGTGCTGTGTTTGATATTGTTTGTTTGTCTTTACTTTGTCTAACAATGAAAATAATAATATCTTTTAAAG
>TTN-208,,0,128,1908080,1908207,GTAATAATGAAACTATTCAAATTAGTGTTTTTTAAAAAAATCTTTCCTTAGTGTTGTAAAAACATTTTTTTGCAAACTATCTCAGTTTTAGTCAATTCTGGCATTAAAATGAGCTCATGTCTTTAAAG
>TTN-208,,0,134,1908208,1908341,GTACATGGCAAGAAAGCTGCTAGGACACCTCGGCCACTCTTTCCCCTTCCTGCCCTGATAATTCTGGGTGCTCTGAGCTTTTGTCTTGTTTCTCAATCTTCGTTCTTTCTAAAACATACCTTCTAATTCTTTAG
>TTN-208,,0,129,1908342,1908470,GTATTCCTCACTGCCACTAACTCCCTAACAAAAAACTTTCTTTGAAGTGTCATATTCTACTGTTCTGCTTCATGATTTTCACATTTCATTGAAACCATGAGCTTAAACAACTACTAATATCTTTTATAG
>TTN-208,,0,132,1908471,1908602,GTATATGTGGCTGTCCACTGTTTGATGGGGGCGGATGGAGCCCCCAGCTTCTAAAAGGGTTTTGTTCTGTGTAAATGTGATGAATGTTTACTGGTGATTGTTTCTAATGTTAAAATACTAATATATTTGAAG
>TTN-208,,0,408,1908603,1909010,GTACATGTCACTAATGAGATTCTGCAGAAAAGCACTCACCCTTGTCTAATAAGTCACCTATTATCAAACCTTTTGTTTGCGAGTCCTCTTAAATTTGCAACTACAAAACTGTCATTCTGGATTTTTAGGGTCTGAATACTTTTTAATAATTTTTTCATTGACTTTAAAAAGTGATATATTTACTTATTACAAGCATTGGAAAAGTTTACTAACTTGGTTCTTTTATTCTTAATAGGCCATATTTTCCTCCCCACTATATGAGGGTCCAAAGACAGATCACTGACCTTATTGTGAAATTTGTTCTTGGATCTGTCCCTGGGTTATTTGAGCAAAATGTGAAGTCGATGTGGTATAAATTTAATATACTTCTCAACTACTCATAAGAAAAATGAATTAATATCTTTAAAG
>TTN-208,,0,479,1909011,1909489,GTACACGTGAGACCGGTGATTAATGACCTTGCCACTTGCGACTATTTCTAATTTAAGCTTTGTTCTTCTTCCTTCCTAACTCATTATTTCTTGGTCATTTTCTAACCTTTAATTATTTGTCTTAATTCATCATTCTAAATTAGCTCCAATCTCAAATCTATTTTGGGTTATTGGTCCACAGTATCTACATAAGTCATAGTAAGCTATATTAAACAAAGCTTCTCCAATGTACATAGAAAGTAAGGCAGGAGAACTAATGATTATAAATGACATTAAACACTAAAAGGGCTTTGCAAGCATTTGAATCAATAGACAAAGAAGTCAGTGCAAATGAGATAGATTTTATCTAAACAAAAATAAGAGAAGGTATCAATTGAAACAAAGGAAGAAATCAAGATTACTATTTATCGTGTTTAGTGTTTGTCCATCTTAGAATATTGTTCCATACATTGAAATAAAATTAACTAATATCTTTAAAG
>TTN-208,,0,269,1909490,1909758,GTACAAAGCAGAATCCACTGTATGGGAAAATACAGTCATTTCATTTTTCATGTCTATATATCTTCCTTAAGGCAAAATATCAGTCTTGTATCTTGTTGCCTGAAATCTGACTACATTAAGAACAAAAGTTATTTCTACACATAAAACTTTGGACCCACAGAATTTGGTCCCACATATACCAAGAAATATGTGTGGTTTTTAATTCATTCATTAGCATTAAATTTTTCATTGTAATCACCTAATTCTAAAAGAAATTCCTATTATTCAAG
>TTN-208,,0,185,1909759,1909943,GTACTCATGTTAAAATGAATACTTCATTTTTGTGGTGTCTACAATTTTACACTCTTCTTATTGTGTGTTGTGTTGTATTATATGTTTGTTAACTCTTACCTATATGTTACAGTGTTGAATAAACTTGTATGTATATCTTACATCTCACAACTTTGTATTATTAAATGCTACTGATATCTTTAAAG
>TTN-208,,0,222,1909944,1910165,GTATTCACTTCATCGTTGGCATCATAAAAAAGAAAGTATTCTGATATCTTAAAGTGGAATCCAATAAGTTGTCCTCATTGTTGTTGCATAACTAAGGACAAAAATTTCCTTATTTTGCTTTCATTAATTTTAATGCTGCTCCAATAAATACAGGTTTTTTATTCTTAATATTTTAAAATGTTTTTAAATACTATTTTTAAAACAAAACTAATATCTTCAAAG
>TTN-208,,0,1783,1910166,1911948,GTACCTACCATGAAGAAAAAATAGATTTCTCTAACTGCTATTTAAGCATGTTAATAATAGGTCTTAGAGAAAAACATACTGAATGTGAATTTATGTTAAAACCATATTGCACAGAAAAAAGGGAAATAATGAAGGGAAAAAAATGAAACAGACAAGCAGGAGTGAAAAAATGAGTGGGATTCAGTTGTGCTGTGATATATCACATGGCTACAACTAGTAGAAAAGAACCTTCTCTCATTCAATGTGTAAAACAGCTCAATTCAACATATTTTGTTGAATGTTGACCATTAACAAGACATCATATTAGAAAAATTAAGGCCTGATTCTGTCTTCAAATAAGTTAAATCTGGTGAGAGGATAGAAAGATAACAGGACTCTAATACAGACAGGAAGTGATTACACATAGCAAGTGAATACAAAAGGGCTGCAGAAACACACGGCAAGAAAAGATTAAGTTCAGGCAGAGGCATCATGGGAAGCTGTGTTAAACTGAATTTAAATTTTGATGGACTTTTACATGTAGAAATTGAGGAAATAAGGCCGGATGTGGTGGCTCACGCCTGTCATCCCAACACTTGGGGAGGCCAAGGTGGGTGGATCACTTGAGGTCAGGAGTTCAAGACCAGCCTGGCCAACATGGTGAAACCCCGTCTCTACTAAAAATACAAAAATTAGCTGGGGGTGGTGATATGTGCCTGTAATCCCAGCTACTTGGGAGGCTGAGGCAGGAGAATTGCTTGAACCCAGGAGGCAGAGGTTGCAGTGAGCTGAGATAATGCCACTGCACTCCAGCTTGGGTGACAGAGTGAGCCTCTGTCTCAAAAAAATTAAAAAAAAGAAATTGAGGACATGATATCCCATGGAAAGGGAAGAGCATATTGAAAGGCACAGAGATAGAAGGGTCTAGAATGTTCAAGGATTGTCAAGTAAACTTATGTCAAGTAAACTCAATTTGAGTATGGATTGGCTGTGGAATGTCTTGAAAGATAATACCAGATATAAAGATGGGGTCATATTTTGGAGTACTTCAAATGCCAGTAAAAGGCTTGTACTTTTTTCTGTAGGCAATAGGAAGCTTCAAAGATTTTGAAGCAGGCTTACATATTAATAGGATTTGGGCTTTAGAAAGATAACTGGCAGCAATTTCAGCTACTAAATAGTAAAGACCCATTGCAATTATTTAAGGTCTTTAAGAGTTGGACAAGATCCGTGGCGGCAGAAATGGAAAGGGGGACTGGGTTTGAAAGAGATGGAGACTTAGTGGCCTCTGACCATTATCAAAACCATTAGGGAAATTGAGGAGCCCAAGATCATTGTAAGGTTTAAAGCTAGATGGCCAAAAGAATGGTTCATTGGGTCTCTGAACTAACGTTAGAGGAAAATGGTAGATGTGCTTTTCACCTTTAAAGCATAAAAGTTGGGAGTGTGTATCAGGAGCTTAAGAAAGAGATCAGGCCTAGAGATGTAGATCTTAAAGTCATTCACATGTAAATAAGAATTGAGTGTGCAGGAACAATTACTCAGAAAATGTAGAGCAAATTTTTTTAAGTGTCAAAGTTAGACCACCTTCATTTAAGTGTACACAGAGGACTAGAAGCAAATGAAGAAAGCTGAGAAGATTCATATATAAAATTAGGATGTCCAAAATGGTGCCATGTCTCAGAAGCCATTTTCCCCATGAAATCTAAGATGAAGCTCTTGCCCCTGCATTCTTTGCCTGCTCTTTAGACAATCTTGCATGTCTTCTAAATTCTTAATAGTAAACAAAATCATATCTTTAAAG
>TTN-208,,0,236,1911949,1912184,GTACACGGCTTCTCCATAAATCTTGGAAAGATGACAATTGTCTTCATCCTCTTGCTTTGATTGTAGATGAATCTTACGTATTTGTCTGTCTGTATTGAAGTTATTGATATTTGGGGGGTCATCTGAATAATCTGTTATAGAGTGTTACTTAATGTAACTAGGTTGATATGTTAGAATAGTAGTTGCAGTATTCTGTTCTAAATATAGTCTAAAATAAAATACTATGTTTTTTAAAG
>TTN-208,,0,504,1912185,1912688,GTATATATATATATATATATATACATTTTTTTAATCTCCTGAAGATTCCTGTTAGAATTACAAAAGCATTTACAGGACAATATTCCTTCTTGAAATTATATACAAGAGCAGTCTAGCATGTTTGACTGCTTTATTTTTGAAATAGTTACACTTCTTTTAAGTTAGAATCTTTAATTTAGTTACTGTTGTTGGTAATTACAATTTCCAAAAGGTACAGTTTACTGAAGCAAAATGGAATAATTGCCTTGGATCCTCAAATGATAACACGGTATCAAATTTTAAAAGTCATCTCATTTGCCATCAATATACATTGAATAATCTAATTAATAGGCAGTTCAAGTAAAAGAACTTTTTCTTATACGTGAATTTTTCTATACATGAATTTGTATGAATTGTATATTTTTATTTTGTGACTGTAATCTTTGCATCAATGTGAAATTTGTATGAGTCTTTTTGAAGAACTTTACATTGCAACCTCATCTCCTTTGTCAACATTCTTTAAAG
>TTN-208,,0,454,1912689,1913142,GTATTCAATCCAGTGGACTTAAATCTTCTTTATCATATTCTTTCTCTTGAAATGTATATGGTTTATGTTGTTGTACATATGTAGTATGTCTGTTCCCATTTGTATGTAAAGTATTCTTTGTTGTAAATGTGAGCCTCATTCTTAGGTTTCCATGTAACTTGTACTGTTTCTCTCATGTCAACTGTGGCTTGTCTGGATGCTTTGTTTGTTGTTGTTATTGGTGCCTTTGCTGTATTTCTCATCATCTTTGTAAAGGGTTGATATTTTTATGTTTTATGTTCTGTGTTTTATGTTGGATACTGGTATTACGTACCTTAAAAAGTAAACTTTGTACTTCATATATATATATATATATATATATATATATATATATATATATAATTTCTATTAAATATACTACATATCCACATGCTAACATATACATATACTAACACCTCTGAAATACTCTTTCAAG
>TTN-208,,0,1303,1913143,1914445,GTAAAAAATGCCACTTCCAAAGTTTTATTAGCCTGCTTCAAACTTCTATCCAGCCATCTGAAATGATGCTTGCAAGAAATGTATGACTTTTAGAAGTGTGTACTTTCAGACATGATTGTACTGTGAGATTGCATAGAGCTGTCTCTTCTGCTGCCCCATGGTTCCTGGGTTGCTTGTCATGCCATGCCTGCTGCTGCAAAAGTCAGAAAGTACATTGATAGCGTCATCCGGGATATCTGAATGCAGGCACTGTCCAATTAACTTTCTTTTGTGGAGTGGGGAGAAAGAGTTTTCTGATTTCAAAGCCTGATTGCTATACATATCATTGCGATCTTATGCTTAAGGAATGTATAAGAAATCCTTGCAAGATATTTTTAATATTGCAGTAACACATTTACATAAAAGCCAAAACTTTGTTCTTAAAGAATTGCATGTGCTTTTAAATATATTACAAGTAATATAGTTATGATTTCCAGTAGCTGATATGTGCCTATATATCATGAAAGGAAAGCATATGAATGACTTGTTACAGTTCCCCCATCTCTTTTTTTTTCTTGCAACTTAAAGAAGTGTTCTGTGTGGTTCTCAGGGGAGCTGGAAAGAGTGGTTATGAAGACATTTGGTATCCAGCATTTATTATTAAACTTCCCTTCCCCCTTCTTATATTTTGATTTTTCTATGAATTGACACAATGTTACTTAATTTTAAAAATATCAGTTTCTTTAAAAGCTGAAATAAACTGGCAGAAACATATTATTCTTATTTTAATAAAAAGTTGTCTTGTGACGTCATATGATTCCCCAATCTAAAATTATCTAGATATAATCTTAGATATGCACTTTCCCTATACAGACCTATGTATCTTCAAACCACAGTCTTCCAGCATAAGACATTGCTGCTGGTGATTCTTGCCCTCTACAACCCTCATAGCCATTAGGGGGACCTTCTGGCACCTCTTGAAAGGCCACCCATCTGTTAATTGACACTCCATGAAGACACACACATAAATACATTTCCCTTAATGTAAAATATATGCTTAAAGGAAAATTTCTTCCTCCTGCCAATAACAAAAATTGTCTTCTTTTTCTGCTGGTCTTTAATTAACTACTGAACTTTGGAGTAAAACTGCAGTCTGTTTTCATGGTTCGAATGCTGCTTGTATGTTCTTTGAAGGCTGTTCTTGGCTGTTATTAATGCTTTCTGGTTATAAGCAAAGCTTGGTTTTGATTCTTGGAGTAGAAAGTTAATCACTTGCTTCAGATTAAATATACAAATAACAAAAGTAAAATCATATTCTTTAAAG
>TTN-208,,0,2230,1914446,1916675,GTATTTCACAGGCTGAAAAATACATACTTATGTAGTACCCCTTTACCTGACTCCTTGCTCTTTCTGCCTCCATCGAATGTTCTGTCTCTCTTTTTCAATGATCAGAGAGTAGTCCCATTCATTTCTTATATTTCTGTGGCTTTTATGGTCCTGGCTCATGAGTGTTGCTTCCTTTGTCTCCCATCCATTTCATACATGTATAGACATGGTCTATCTTTGTCTCATCTACATATGTCTTCTTGCATTTTCCTAAACTTAAAAATAACAAATTTTACTGGTTAGCCAAAATTGATATCAAGAGACATATGAGATTAAAATGCTGAGAGCTAGTAGTAAACTGTTTTGACATTTCACCTGACATAAAAATTTTAGCCAATGTAATAAGCACTAAAAATAAGTCCTATCTTCCTTTTATATTATTAAGGTTATTTGTAGGGATTTCCTTAGGACTTTCATGTCACTCTCTTCTCACTGGCTCTAAGTCATTCTCTGAGGGGTACGGAACTCACATTTCAGAAAAATTTCCTTATTACTGTAGGTAATTTTTCAAAATGTATTTTTCTGTAAACAATATTTTCCCTAATAAGGTCTCATCTAAAATTAGACCCTAAAGAAAACTAAATGAATTATAAGAGTCTAGAAAACATCTATCAAAAATAAACATAATTTTTCTAATGGGTAGTAGTGTTCTGTTCAAGTAATCAACACATTCAGACCTAGAAATTAAGACTGTTTCTGGTCACTCTGAAATTTTGGGGAAAAAAGTCACCCATATAAATATACATTTCCTGATTTCATAAAGAGGCAATTACAAAATAATGTTATCATGGATATTGATCATAAACATTAAAATAGCATATAATCACATATAATGACTTTAAAAATAATAGCTACAATGTTGGGTTCTCAAACATCAATAAGATTTTTAAAATCAAATAATAATATAAAAAATGCACAGATATATTTTCACTATGTTCATTATATCAGTAAAGAAAATCTATATTATGCCTCCTCACTTTACATTAATTAGATGCATGTGCTTCCTTCTGGGTTTGAGCAATAAAAATAGTTATTAAGAAGATTGGTACCTCTAAAATAGTATTGAAGGCCAACACAATTTATCCTGGATAAAATACGTAATGTTTAACTTTAAAATTTTTACTTAAAATATTTGACATTAAAAAAATGATTATTCAAAACGAAATACATATTTGCCTATTGTAGGTTTAAATTTTTGAAATAAGAGTTAAGCAGTTATCTTTATCACATAAAAAACCATTTAATGAATTGCAAATATCTTGTTTAAAGCCCTAAATAGGAAGTTTTATAGAAATATCTAAAAATTCAGATTCCTAATAGCAAATAGTTACACAATACAAATAAATACTGTTTTAAATTAGATTTTAATTGACATTAGTAGAGAGGAAAATGGTTTAATAATCACCACGTGTTCCTTTCTTTCACCATTCAAATCTATGAGGGCCATAATAGCAAAAGAGGCTGCTCTATAAAATAGCATCATCCACCATGCTCAGTATTCACTGTAGACGCAACAGGAAATTTTGAATTCCTTGCGTTCCTTAATTTGAATGAATTTAAGAACATTTTCTTATTCATGAAAAACGAGCTTCCAACACCAGCTTTGAAATTTTATAATTCTATAATTTTAAATATTTTATCCAGCATTATTTCAAAAAGGAAATCTTAAGAAAGGCTACTCTTCTTCTGTTCAGAAAGTGAGATATGGCCCTTCCCCAGCATCAAAGTCACAAACCGGAACTCTTGGCCACCTTCTTCCCTCAGTGGAGAAGACTGAATGATGGCACTAACACTTGCCAGTATCATTTTCATACATTTAGTGGTTGGGTAGATAACATCGTAGATTTGGACAATCTACAATTGCAGTTTGGGACAAAGATGCTGTCAAGAACCCTGTAATTTGATGAAAGATTCATAAAGTCAGTATGGAGCAACATCCTCTACATGCATTTAAAATGAATACATTTGCCTGCAGTTAATGGAGTTGAATTTCATCACAAGGCTGTATAGATATTTGCAGAGGAGATAACTTGAAATGTATCATTTAAACTTAAATTCTGTGGTATTTATATGCAGCGAAAATTGTTACTTAATGCACTACAGTTAACTAGTTTTAGGAGAGACATTTTTCTTGTTGAAATTCCGTTTTTATATAAATTCACTTCAAAATTTGAAATCATATTCTTTTAAG
>TTN-208,,0,921,1916676,1917596,GTATAGTATTTTTCAACCATTCTGTCAGCGTTAAGTATATTTTAAAAATGAACTTGAAAGCTTACAAAATGTTTCTGTCCTTTGGTTTTCTTTGAATTGGTTCGCTATTTATCAAAATTTGTTTGTAGTTTCATTGAAAATTAAGAAAAATGTCATTTCCAGATCTTTTTTTTTAAAAAAAAAAGACAGAAATTTTGTGAGCATTCACAGTATTTTGAAATTTAAAATGTTAATAGACATAACTAAGTTGATAATATTCTAAACTAACAACAACTATGACTGCCATTTTCATAACCAAATTATGTAGTAAAGTACACTAAACCTATTAAATACCTTACATGAAACTACTTTAGCTTAAATTCAATATTCAGTTTTAAAGTGTGACACAGGATCACCACAACTAATAAATAACATTTTTAAAAAACTGAACATTTCTTTCTGACTAATAAAATATTAAAGAATGAGAAACAAGATAGTCAAATGAAGAATTAAGTTCTAACATTGTCTTCACATAGAATTACTGATTTTTAGGCTACATTTCTTCAGATATCTCTGCTTAAGTAAACTTTCTACTTATTTACATACTCATTAAATCATTAACATTTAATTATTATTATAATTCGTTGCTATTCAAATTATTCATTTTGTGTTGGAGCTGTTTCTCCCACAGACTTGTCTCAGAATAGACCCTCTATCTAGATAGAAACAAAGTAACTTTGAGTGCTATTATAATTGACAACCTTTGATTTTAAAAAAAACAAAACAAAAAACACTTTCGGTGTAAATGCTTACTTTCCAGAGTGCTAGGTAGCATGCTTTTTTTCATTTTCCTTGCTTTGTACATTATTTGCATTTGTCAAGCTTATTCAACATCTTCATTAGTTTGTCTTGGTTTACATATAAACCTTTTTGTCTTTAAAG
>TTN-208,,0,610,1917597,1918206,GTAGGAATCTCAGTGACAATTTGTAAGATTATCTTTTAACAAAATGGACATTTAACAAAAGGTTTATCTTGTAAACATAAATGAAGTTAGATGTAAACATGGCTTCATATTTCATCTGTGATGTAGTCTCTGTTTTCCATTGTCTGCTTTCTGTTTAAATATTTTTATAGTAATTCCCAAATCCATTCATGTATTTCCCTGCACTTCATTCTTATCATTACTTTGCAACTTAAGTTCTTCCAGTAGAAATGACTGAAATAATCAAGTGGCTATTCATGGGAGGGTGTCAGCAAAGGTTTCATAATCTGGGGGCTTTTAAATGGGTTGGTTTTTATCATTAGCCTATTCTCAAAGGGCAAAATTATTGGGAACTATTATAGAAGTGATTTAGAAGGAGAGAGCTAAGGGGAGTGGAAGATAAGTGGATGGAATAAAAGGAAGAAAAATAAATGGAAGCAGAGTCAAGAAAATAAAATAGAAATTACTTGATAAACTATAAGGTTTTTTAAAAAACCATCCATAGAGTTTTTGAAAAATAAATTGATATTTCAGATGAGGTGCTTCCTAAATATTCAAATATTAACACTGAAAAAATAATCTTATCTTAAAG
>TTN-208,,0,430,1918207,1918636,GTACAAATCTACTGTCATTCTTAGTTGTCTCTAAAAATGCAAATATGTATCATTTAAAATATCATTACACTGACATCAAGATTTGAACACATGACCTTAATCTGTTAATCACATATGGCTTAATTTTCTTTACCATCTCACTCTCCTATGCAATTGGCTAATGATTACTCAGTTGCTAAATAAGTTACCTGAAAAAAAATTGTATTTATGGGCAATGAGATAAATAACAACATTAAAACCAAGAACATTGCCTTACTATATTTTCCAAATATTTTGTTTAAAATGAAAACTAATCAAATACTTGATTTGATAATTATATGTATATAAATTCTAATATCTTCCAAGATACGTGGGCTTAATTTTAGTTTTGACTTTGTGAAAAACTTCAAAAATCCTGTAATAATCTGCCCTCTACTCTAAATTATTTCAG
>TTN-208,,0,259,1918637,1918895,GTGAGCAAGCTTATCCTCAATGTCAACAGCATATTCTTTCTGTATTCACACACATAACATGTACTTAATAAAAGATAGTAGGTGAAAGTCAGTATGTATCAAATGATTTCTAACGTCTCAAAATGCTTAATATACTATTCTCTTAAAAACTAGTTATTTGAAGATTTCAAAATTATATCAGAAGAGGCAAATAAGCTACCAAATAAGTTTTTAGGAAGTGACAAATTGATACACTAATGCAATGGACTTCTCTCTACAG
>TTN-208,,0,2279,1918896,1921174,GTATTTATCCTGTAGCTTTCTTTTTGCTAGTTTGTTTTGGTGACTTAATAAAAGTATTCACACTTGATTAAAATTCAAGCCCTGTTTATGCTGCAACATAGGTATCATTTCAACTTCGGAGGTTTATGGTAAGTTTCTACCTTTTCTTCATGTGATATCCTTTATCCACCTTGTCTCTTGCCCAGTGGGTGAATATTGTGCCTTAACTGGAATGTACGTTCCTGGGTTGCACCATTTCTTTCATATGCTTTGGAGATTAAGTAATGAATATGTTTGGGGCTGATAAAAACTAAGGAGACAGGCAGAGACCCTGTAAGGGTATACATATAAGAATCCCATGAAGCTTCAAATTTCCCTTATACCCTATTGGAACAATTTCTCTTTTTTAAAAAAGTGTGTATATTGGGATAATGTAAAAGTTCTGGAAATGGATAGTGTTGATGGTTGTACAATATTGTGAATGTATTTCATGCAACTGAATTGAATACTTAAAAATGGCTAAAATGGTAAATTTTATGTTAGGTATATTTTACCACAATAAGAAAGAAAAAGAAAAAAGAGACTCCATATTTCAGTCTTTTAATCTGTATAAGGAATTAGATCAATAATAATTTTCTTAAATGTTCTAACTTAATGATATAGGTATCTCAAGTCCAAACTTAAAGCACCTATTAATTGTATATGAACTATTTAGTATAGTTCATCATTTAAGTGATAATTTGAGATATAATTGATCAAAACTGATTTGATGTGTAATTGATAGTCATTGATAAACATACACATCCTGACTATTTGCCCTTTGGCTCACTATCTGGGTGATGAGATCACTCATATCCCAGACCTCAGCATCATGAAATATATCCACATAACAAAACTGCACATGCATCCCATGAGTTTAAAATAAAAGTTGAAATTATTTTTTTAAAAAAGAAACAACAAAACCAAAAATAAAACAAAGTAAATTTAAAGCGGGGGCGGTGGTGGTGGGGTGGGGAGAAGGCATGTATTGATAATTTTCTAAGATGTGAAGAATCTAAGATATTCAATATAATGCCTTGACAATTTGTTCCTATGGAAAAATGATCATCTCCACTGATAAAGCACAAAATAAAAAATTCAGGGTGAATTTAAAAAAAAAAAAAGAGAACTATTTGTTACATTCCACAGTGAGATGTGCATAGGCCCCGGGAATAACATTTAGAAATGTCCATAATAGTTTGACAGAGAAATTTTTTAATTTAATTTTCTGAACCTAATAATAAAAATTGGCTTATATCTTTAATAAATCAATAAATAAAACTATTTGGAAAAATTATATTATTTTAGATTATTAATTCAATAATTAGTCATTTTATATTTGTTTATATATTTTTATATAAATTATTTAGAAATTTTTTTATTTAAAATTATCTCAAAATATTTGGACATTACCATGTTTAATGACATAAAAAAATACACTATATTCTTTTGACTGTAGTTTAATTTTTAATATTTGTGTTATATTTTGTTGCTGATGTTTATGATTTGGGCATATTCTTTTAAACTTTTATAATGTCAACGTAGTACTTTTATTATTCAGAAAAAGGTGATGAACTGCTCTTGTCTAATTAAGTATGTATAAAAATAAAGCTATTCTCAGTTATCCTGGGGGCTGAAGCTAGAGAACTCATTCCACAGTTTATACTGTCCCTGTATTAATAATGGAATCAAACTCTAAATGTCAGAACTCTCTTGCTTCTGCCTTACTTCATTGTCTAAAGGAAATCTTCAAAGAAACTCATGCATGTGTGGTACATGGACTCTTTTTCCTTAGTCTTCCCTGGATTTGTTTGTCTGCCCAATTTAGACATAAAAAGAAAGGCTTTTGGTAACCTCTCAGCCATTTCCCTTTTCCCTACACTGATTTATTGACAAAACCTTATTTCCTTGGTTCACATAATCAGGACTTACATAAACATATAAAATATTTTGCACAGCTAGGCAGGAGCAAAACTTTTCCTCACAAGGCAACAGTAAGCCTTCCAAAAATGGGAAGATAATAAGGCACTTGCTGAAAGAAGTTGTTAATCCTAAATATGTTGGCAGTTTAGCTTGAGCTCTTCAGTCTCAGAATATGCCTTCCTGGAAATGTGATTATCCATAGAAGTCATATAAATGAAACCAATTTCTCTTTATGCGTTAATATTTATAATGGAGCATGACTCACCCTCCATGGTTTACTATTAAACATGAAATAAGTCCGAAAAGTGTTTAAATGCTGAGTTTTATTTTTATTTCAG
>TTN-208,,0,569,1921175,1921743,GTGAAATTCATTTTTCTAGTACTTGCATTGTAACCTTCCACTCTGAATTTCCAAAGTTCATATTCAAGGGGAAAAAAATTTCAAAATTCATAACAATTTTTATTTTTTCTAATTGATTCTACTAAAACTAGCATGTTTTCTGATATTTCAAATAATACTTTTAGTATTATGCAAGGAGATATATATATATATATATATATATATATATATATATATATATATCCAACTATATTTTAGCATAGTGAATCCCATAAGTTCTTAGCTTCATTTTTCATATGCATGGTATTTATACATGGCAGATAAAATAATTAGACATTAATCTGGCTATTTTATACTTCAGATTAAAACTTGAGAAAAGGGACATTTATTATTCATGGATTCCTTATACCATCTCATTTTCCTGCCTGAAACAAGGCAGTATAAACTCAATTGGCCTTTCAATTGCCTGGTCTTTAGTTTTCTCGTCTTCTAATTGCTTTACGGCTGGTTTTATCCAGCAGGCAGCCAAGTATGAACTTTCTGACTCCTAAGGAGATGCCAAATCAACTTTTTATTTTACTTTGAATTAG
>TTN-208,,0,156,1921744,1921899,GTAATTTCTAGTCTTCTGAACATAATCTATATTAAACTTTAATGTAACAAACCTTAGTAGCAACTTGCATTGTAGTTTTACAAAACCTCTTATTTCCAAGTTTTATTTCATTGAAAATATTGTATTTATTGAAATATATACTGAAATTCTCCATAG
>TTN-208,,0,247,1921900,1922146,GTTAGTACTTTCCTGGGAGATTTCGTTCTGCTTATTGTTACACTAAGAAAATGGAAGAAAGGACCTCGTTTCCCAGTATTACAATATCAGAAATCTTGTACCTAAGAGGGGAATAACAATATATCCTACAGTGGATTAATTATGCCCAGTATTGTGAAATTTTTCCTATTCCTGAAATTTACTAAGGAAGCTATGTATATTACTTGTTCAGACCTTAATCATTTTTTCTGATCTTATTTTCATATAG
>TTN-208,,0,135,1922147,1922281,GTATAAAATCTTACCTTTTATTCAAATTATAAGTTTTGCGTATGTGTAAAGCCAAATAACACACCAAAACACATAAAAGCAAAGCATCGTTGGGTTGTCTAAAGCATTATGTTACTTCATCCCTGACCAATACAG
>TTN-208,,0,315,1922282,1922596,GTGAGTAATTTCACATTTTAAATTGTTAGTCATATAAAATAACCACATCCAATATTCAGGATCTATATCCTAGATTCGGGTTGCTTTAATAATAATGGAGTTAATGGAGTCTTCTAAAGTCTCCAAGAAGGAAAGAAATTTTACGTATCATTTGGGGACAACTTGAACAATTTGTGTAAAATGTTATGACAGGGAATTCTCTGCTTACTTTTATTAGTAGTAATTTTTAAAACTCTATAGAAATTTGTATCTGAAACACTTCTCCTATAGGGAATTTATCTCTTTCAAATGGTTACTAAAACTATTGTTTTTCAG
>TTN-208,,0,93,1922597,1922689,GTATGGGGCTTTTAGAATTTGGGGAGGGGTCTCAACTTTATTTCACTTCCCTGTGCATTCTGAAAAGCCTCATTCTTAATGTCTGATTTTCAG
>TTN-208,,0,282,1922690,1922971,GTAAGCGAGCTAATGAGATCTGTGACATCCCATAAAGGCATGCAAATATATGACTTTAAAGATAGGACGCCAAGTTCTAAAAGCTGTGATAATGCATCACTAATTAACTTTCACAGTGTTACCAAAACAACCCCCCTTAATTTGTTTTTAGTGGAGCTCTATTTGGAAAGATGAATAAATAAGTGCCATGTGAAATGGGTCCCTTTTACTCAGGCAGATTAGAATGGAATCTTTCTGAAGGTGAATTGTGTTTCTGAGGCATTATCTATGCTTGCATTTCAG
>TTN-208,,0,140,1922972,1923111,GTAAATGTAACCAAGTATAACCAGATAGCCAGTTTCTGAATCATGGGAGTGGGGAGTAATAAAATATTTTGCAACCTTTTACTCTTTAATAAACTTTAATTTTCACATTCTTCTAATTTTATGCTAAATGTCTTTTACAG
>TTN-208,,0,86,1923112,1923197,GTGAGTTGCTCAACAATGTAAAATTTACCCTATCTGAATCTGCAGTTTATTAGTTCAGTCATGCTAACAAAACTGTATCATTTCAG
>TTN-208,,0,142,1923198,1923339,GTAAGTCAAGATTAGCTAATTATATAGGAGAGGGGTTGCTTGGTTGTGTAGGGTGAAAAAAGGCATAAAATATCTTGATGATTTGTAGGAATAACTATATAAATGATGTTCTTTCTTTCCTTCTAACCCTCACTCCAAACAG
>TTN-208,,0,125,1923340,1923464,GTATGCTCTACTTGTCAGCCACGTTTTTGTATTTTCTCTGCAAGACTTCCTGATACACCCCTGCATTGATCAAGGGTCATCAATGGAAACGTATTCTGACTTCATCCACTGTCCACTTCTTTCAG
>TTN-208,,0,112,1923465,1923576,GTAAATAGTTTTATCAAATAGTCCACCCCAAAATCATTTTTTTTGCCTTTAGTTTTATATTTCTTCTTTAAAGTGCTTCAATTAATAAGTTCTTTCTTTTTTTTCTTGATAG
>TTN-208,,0,846,1923577,1924422,GTAAGTGCTTTTTAAATTTTAATTTTACTGCATTAAATTCAACAGAAATTTGTGGAGTATCTATTCTATAAAATAGTCTTCTAAGTGTTATATTGCATGAAAGCAGCCCAACTCCTTAAGAAGCTATCACATATGTAATCAGGCTTATTTCTAAAACACTTTACCTTCATTACTATAAGTTAATGAAGATTCTAGCTTACACCCACAAAATAGCCAATTAAAAGCCAACTTAAAATTCTTCATTAATTATTGAGCCCTGTCATGTTTAAAATAGGAGTATATAAATACTTTCTATCTCTTCATTTTATCAAAATTATTTCAGAGGAATGTTTTTCAAGTTTCCCATAAGAGAAGATATTACATAATTTACATTAATAAGCCTCATTGTTTTTCTTGGCCACCTAATATCAACAAGATTAAACATGAAGGCTAACATATATAGACATGATTAAAGGCAAACTATTAATTGATTAAGAAAAACTAACAATGTGAACCTGAAAGCTTAAAAGTAAACTAGACATAATAGAGTTGCTAAGAATTAGAAATTTACCCAAATAATGGAGGAACACAAAATTGTATTTGAAGCTAAATTTCAGTCTTTTTAGCTACTGTTAATAAAATGTTTCAAAATTCAATATGAATGGATTAGATCTTGATAAATCCCACACACTGATTCCCTTCCTAATATTTAGAGAACTTTTGAACATAAACAGGTTAAATGATTGAACACTTGACACAATTTTAAAAGATACTCAGAACTCTGTGAGTTGTGTCTTAAACTTTCCAAGAGATTGTCATTTCCCTAAGGTGATTAATAAAAGCTTTTCACTTATACTTTACTTGCAG
>TTN-208,,0,90,1924423,1924512,GTAAGGAAATTTCCATGAGTTTCACTCTTGAAGCATTGGGGTTATTTGTGCCAGAGGCTAATGACCCATGCTGGCCCTTCACTTTTCTAG
>TTN-208,,0,436,1924513,1924948,GTAAGGCTATTTCTGAACTTGTCAACACCTAAAGGAGCTGTGTGAATTAGAAAAGAACAGGTGAAAGTCAGAGTGGATGCAGGACATTTAAAACATGATAGCAGTTTCTCTATCAGACCCTAAGCCAAAGAGAGATGTCAGGGTCTATGAATGGGCTCAGACTGGCACACTTGCATTACTTTTGATCCAGCAGAGTGAGTATAAGGTTGTAGATACTCTGTGATGCTGCTAGTTGGCTCAGAATTATACAGCTAAAATAAATGTGGCTTTCCTCTTAGTACTTGTAAGCTTTACTTCCTAAAAAAAGAGCTCAAAGTTATATAAAGTTTCATCACCATTTATTTGTTGCATTCCTTTAATTAAGATAATCTATCCTTAGAACAAAATTTCAAAGAAAATTATTTTCTATGAAAGTTTTTCTGTTTTGTTGGTACAG
>TTN-208,,0,797,1924949,1925745,GTAAGTATTGTATATTTTTCAGGGAAATTAAATAAACACTTTTTCAGAAAATGAATGTGAGTGAAATTAATTGGACCTATTTTATTAGTTAGAAAATATTATTAAAACACAAAAACTGGCTCTCTTGTATTTGCCACTTTGACATTCCAATACAGAAGTGGTTCAAATCGTAAAGTTTTGGAAATTTTGTTGACCTTGCCATTTGAACAAAAGAAAATTTAGCAAATCAGATTTTCCTGCTCTGTAGTCCTCTCATTGAAAGTAGATACACATACAATGAGAATCTAACTCAGAACCCTTAAAGACCACTTCCCTCAAGTGGCTGTGCAACTAGAGCACCAGAAAGACAAGCTTTGCTGTGTGGGCATTTTAGATTCAAGAAAGAAGGTGGGAAGCATTAGGCTAACGTTTCTGGAAGGTGCAAAGTGTTTGATGGATAGGGACAGCCTCTGATTGAGGGCCCCTTGTCCTCTCCCAATCAGAGTCTTAGTTATTTTGGAAGTCACATACCTTATGTAGCAAGAAGAACTTGACGCCTGGCAGAGAGACAGATGCAGCACAGATTTCTCGCTGACCTTGTACGTCAGAACGAAAGGGCCCCTACATATACTCGCTCTCTGGCTACCAGCTCTCCCCTTCTCAGCGCCGTGGGGCCACGTTCACGTGGGAGTTAAAATAGTGGCCAGTCCTGTGGCTTCTTGAAGAAAGCAACCATGAAGATTCATATCTAAGTCTCTATTTATTCTTTTGGGATTACAAAATGAGTAACGCAAAGCTGTTTCTTCCCTCTCGAAAAG
>TTN-208,,0,3904,1925746,1929649,GTAAAAAGCAGGCATGCCTTGTCTTTCCCGTTCTTTTTCTGGAGTTCTTCCACCTTCACTTGTATGTTCCTTATTCTTTGCTCTTTCTAATGTCTCTTCCTCTGTCTTTGCCTTTCTCTTTCCGCCTTTAGCCTGATTTCTGCTGAAACTGTAAAGCCAATTTTTTGCATTTTTTCTTAGGTTTAACCTGATGATTTTTTTATTGAAATTGAAATAAATTTAAAGTATGATCATGTTTTAGTTTTTTGAAGAAAAGACAAGACTCATTGACTATGAATGATAGTTTGATTAACCAGAAGGCAGGAAGGATCAAAAAGGCTTTCTGATTGCACGCTCTGCAGCCATGGTGCACATTAAGTTTTAAGACTAACGCTCTCCATCCTATTTAGTGTTCTGCATATAAGGGGATTAAGAGGAGAAGACTGAAATTCCATTTCGGGCAGTTGATCAAGTAGTTGAGATAACTTCTGGGCAGATTTGCTCTTCAAGCATTTCTCCAAAGCTATTTTTAACCTTCAAGTGCTCTGGGCTGTGCGATATCTGGAATGCAAGTGGACTATTTAAAGTGCAACTGATGGTACTGACAAGAAAGAAGGGCTCTGTGGTTATCCACATATGTGGATGAAATATTTTTTTTAAGCTTTGGTAAATAACTAGCTCCTGCTTTTAGCTTTTACTAACATTCTTTATGCCCAAGATTTTACCCATAAGTAAAAACTAAGGGATTATTCAGATAGGCCCACAATACAATTTGCCTAAATTGATCTATATGTTTTGTCCCCAGAAACAACATATGTCTTTAAATTATCTTGACAATCCATCATTAATTTTGAATTCTTAAAATAAAATATATGGAATATGTCCAGCCTGGGTTGGAAATAAAGCACAGGACAGTACATTGTTCTGTGACATATTCCCCCAATATTTCAGAAATACTATTAAATGTGCTATAAAGATCTCAACAAAAATCAAACTTTGAAGACTTAAAGGAATATAATTAAAAAGTGATTCAGTTTAACAAAAAGCCACAGCATTGACTGAAGTATTTGAAAGCAATGCCTTCAAGTAACTGCTTTGAAACAAACAAACAAACAACAACAACAACAACAAAACTAGTATTCCACTAAAGTGATTACAGGGTAATTCACCAGCAGTCATCTGATAGGTAACGCCTGCCTGTTATACAGATAATAAGATCTTCTTGGTCTCCTTTTCCAGTGACCAGAAAAAGCAGCAGTACATTCCATTTGTAGCATGGGAATTAAGTTACATATCACAAAACCTTCCTTACAATGAGGTCTTCTAAATATTGAACTGAGGGAGGCACCTCTACCTTCAAGCTTATTGTTTGAAAAAATATATTTTGCCTATCATGCATGATTTAATTAACTTCATGTCTAAAGGCAGAGAATTGGTTGCTTTTTCAAGATTCTTTCTAGATCTGCAAATTCATGATTTATATATAGGAACACTGCTTAAAGACAAATGATATTATTTTTTCATTACCAAATATCTTTTTGTCATAGTAAGAGCTTCTTATTAAAAGATCAGTCTCAGTTCTAATACAAAAACTGCACTATTTTAATTCAAATGTAGACTCCTAAAAATCTTATTCACATTTTATTTTTAAAAAATTCTCATTGTAACTAAAATTTTTTCTAGGGTTAGAAAGGATCAGTTTACTATAATTCTATAGGGCCCCTTTACATCTCTTTTGGCATAGGAATTTTAATCCTTTACTCTAGGCACCCGAAATACCTTAGCCTTTTGTGAACTTGCTCTTGCATTACTTAAATGTCTCTTTTCAAAAAGAACTTAAATATAAACTTTGAAGTAATAAAATCATTTTGTTACATGTGGCAGATTTTGTTTAAATTAAGTCTGTCAGAACAAACTTGCTCTTGTCAATGTAATTCCGAACTTTAATACTCATTTTATGTAAAAATTTTCGCCTTCAAAACTACAATAACCAAACAAGCAAAAACAAGCTGTAGGAATAGGAAATATGAAGAGAAACTTGTAGACATGAGTTGTTTGCATTTTTTCTTTGTTGTTGTAGTTGTTTTTGGCTGTCAGTTTAAGAAAGGACTGCCAAGTTCCAAATGGCATTTGATAATTTTAAAGTTAAATTTTAAATTTGATAAAATTAAAGTTTAAATACAAAACTTTAATAGTTTTGTCATGGTCATAAGCCTACCGTATTATATTAATATGCTTCCACTATAAATAAATATTTTTAAAATCTCTAACATTATTCTTACAATCTACTGCAAAATCTTCAACATTCATTTCATTGGTTTATTTTTATAAGGCACCTACCAGTTTTCCTTTTTTTTCTTTTAACATAGTGGAGGTAGATTGTATACAAGCTGTTTATTGAGACATACTGCATTCTGAGCAGTGTCCTAGAGTAGCTACAGAGGAACTCAGATGATAAAGCAACATAATATTAATAGATAAAATATATCTGTGGGTGGGTTAGAAACTGAGACACCTTTTCAAATAGCCAAAAGTTGCATGCCAAAATTTATACTGAAATGTTATTAAAAAAACAAATTTTTCCCATTTCAGCACCATGCCCTCGGATAAGTAGCTCTGTTCCAAGGGCATATTTAACTACCCCCTCCTAGCTGTTATTTTTCCTTATTATGTTTTTTGGCCACTCTCAATTATTAAGATAATTATGTGACTAACCATGCCCAGTTCTTAATTAAAGAAAACACTTTTAGATGAAACCTTATTTCTGATTCTTTTCTTTACACTAGCATAACAAATAGTTCCACTGGTGAAAAACTTTACATTATTTTTAACGCTAAGTAAACTCTTAAGCAGTGCAAAATCAGTCTGGATGACAGGGCACAGCTTCTTAGGAATTTTATATCATAGAACTGGAAGAACCCCCAAGTCTCTTATCTTTGCTGTCAGAATGACCCCTATCTGTCGCACCATTGACATCTGATTTTCCCATTCCTGATGCTTAGACACATGAAAAAGGAAGAAGAGTCCAACTTTCATTTGCAGTTTTGAACAAAATTAATAGGTTGTACAAATTATTTAATCACAGGTTTAATTGGTTTGCAAAATAAGTTTAATTGCTAAAATAAATGGGAAGAAGAGTTATAGCTTGTTGTTGCATGGCAAACACCTTACATACAGAACATAAGGTTTACTTTTAGCTTGCCATAGCTGATATTTTCTTTCATCCTTTCATGAATTCGCTTTTCTAAGTTCTTCCTTTATATGTATATAAGCCCAGGGGCAGAATGGGGGCACACATATATATACACATATACGTATATACTATATGTGCTGTATATCTACGCATATGCAAAAAAGACCACAAATGTAAACAGAAACTGGCCTGGGCAATTTCAATGTGAAAGGCCACCTAGTAATTATATAAAGGTAACTATGAAACCCTAAAATTTTCTTGAAAGATCCCAAACTGCATAGTATTCCATGGTGTATATGTGCCACATTTTCTTAATCCGGTCTATCATTGTTGGACATTTGGGTTGGTTCCAAGTCTTTGCTATTGTGAATAATGCCACAATAAACATACGTGTGCATGTGTCTTTACAGCAGCATGATTTATAGTCCTTATACCCAATGCTAGATGATGAGTTAGTGGGTGCAGGGCACCAGCATGGCACATGTATACATATGTAACTAACCTGCACATTGTGCACATGTACCCTAAAACTTAAAGTATAATAATAATAAATAAATTTAAAAAAAAGATCCCAAACTATTGGTTGAAATGATTTTTGAATGCATACGTGCTAAATAGATGATTATAAAACAACTTGGAAAGCTCTATTTCCATTTATTTTTATCTAAATGAATTAAATGCACCCATATACTAGATTGCTGTTTCATGTATTCTTTTTTTAAAAACAACTAG
>TTN-208,,0,541,1929650,1930190,GTAATTACAAGGCTTATTTTAAAAACATGTATAAGGCAGAGGCTCATGAACAATGCCAACTCTCAATTATCTTTATATGATGAGTACTATAGATGTTTAAAATCAACCAAATAATCAAAAGTCTGATTTTACTTTTTAGCATAACAAAATAATTCACAGACTATCTTTTTAAAGAGCCAAAATTGACTAGCATAGGTTTTACTTCCTCCTTCCATCTCTATTGTTTTTATTGCACATCCTAGATTTTCAAAAGCCAGCTGGAGGAAGAATTATTATCAAGCTAGGTATCCATCACTTTATTAACCAAGAGTTGGCTGTTATTTCCTTAATGTTTCCTAGTTTTTAAAAATGATTTTCCTCTTGTCTGTACAAATAATGATAAAATATCATTTTTAGAGGAAAATGTCTGAGTGTAATCAAAACTTGAAAATAAAACTTAGGACAGAACAAAGCCCTGGAGATGGCAGGGGAAAGTTGAGAAGGTACCAAAACTCTTGGAGAAGGAAAGGAGTACCTTGGCTAATGAGTATGATTCTTTCAG
>TTN-208,,0,1697,1930191,1931887,GTAAGTATTCTTCTTACAAAGGACTTTTCATTTGCAATTCTTTAATAACTACAACAACAAAACAACACAACACTTTTTGCATGCCCTTCTTGGCCTAACTGCATTTCTTGGCAACTTCTAGTATTGACACTGACCTAACCTGATCCTTTATGTGTTTAAAGAAAAAAAGAAAAGAAAAGTCTTATTCTATGTCTGGTCTGATTAATGATGGAGCAATCACTTTTCCCTATGCTTCTTTTCTCTCACTGAGTAGTGAGTAGATGTGCTCTTTGTCTACATGGGGTCAGCCTACTGTATGGATATCCTGATATGGATGAGGAGAAACTGAATTTTAAAGATAAGTAGGGAGTCCTAATTTTAAAAACAAAGTAAAAGTGATTTCCATGTGGAAGGAAAATGAATTTTCAGGTGTGGGGAACAACTAGAAAATGAGCATGAAATTTCAGTCTGAATAGGAGCATACTAGAGATCTGCTGTAATATGACAAAGCACATTCACATGATTCAATCTCTGAGAATAAGAATGGATAAGAAGATGGAGTGAGGCCCTGGATCTTTTGAGTCCTGGACTCTTTGAATGAAGAGAACTCTAATGGTTTTTAACATTACTTCTTCCTCTGGTGAAAAATGTAATGTCTTTTTTCAAAATGCCACATACTAGCTTATTTGTTTCATTCATTCCTTTGTCCAGTGATGACATTTTTCTGCAAATTTTTTGTGCAATATTTGTTTGTTTGGTTTGGTTGCTTCCCATCTGTCAACAGCTACAACCTAGTGACTCTGTGCTTCATGCATCTTGTACCATGTTTTTCTTACCACTTTGTGGTTGCTCTGCTCAAGCTTATGTCAAAGTAGCTTCTTGGGTCTCCTTCTTCACCTTGACATCTACCTTCACTCCAAGAAGGCTCAGCTGCAAGGAGCATATTTTCAAACCTATTAGACAGCATTTGTCTCAGAATCTTATTGCTCAAGAATGGTCATCTTGGGAAGGACTCACAGGGAGCTCTGAAAGAAGGAAGGGCAAGGGGGCAGCTCCCTAATCCTATACACCAGCTGAATTAATTCTACAGATGAATGAAATAACAGATGTAAAATCCTAATCACCCTCCCATACAAAACACATTGCTTTATTGCACTAATAGATGTTATGCCTGACTTATATGTGACGTCTTCAAAGCTGATTTTTTTAAAAAGCTAAATGTATGTTTCAATTACAGCCTCATGCCTCTTAGCCATACACAAGGCTGGCCATAGTGCTTCACGTGTTCTATCTTTGAATTCTGCTAATTTCTCAAAGATTGTGCTAAGTGCCTTAAATAAGACAATGTTTCTTTGCCACTGGTGTCTGAAGTTTCCTTTGACATTATCTTTCAAGTCTGGTGCAGTGCAAATGAAGATTTTTCCTCCAGCTATTATTCAAAAGAACTGAGATGGCTCCCTAGTATATATACTGTACACACACACATGCACACTAGTTGAACATATAGAATGCCACATAATTTTATGTAAACTAAAGAGATATCTAAAAAGCAAAGCATCATACCTGATGGGCAGCTTCAAGTGATTTCAAAGTCAGTTGTAGTCTATTAAGATGGAAAATCCCTAAAAAAGAGTCACTTTTTCTTAATGTATACTATGGTAATGTCAGAGTAAATTTCCAGAAACCTCATTTTGAATTCTGATGACATTCTCTTACAG
>TTN-208,,0,661,1931888,1932548,GTCTGTGACTGTATACCTGTCATCTTGTACTGTCAAATAACTTTATATTTACTTTTGGTCTAGCCAAAATGGAAAAAAAAAAGTTAGTCACAACTTCTCTGGTCACCACTTTACTTTTAAAGATAATTGTAGTATAAAATGTATTCTTGACTTTAATTGCTCTCTTTTTAGTATTATTAATTTACTATTACTTGAAAAACACTGGACTCACAATCAGGAGATTTAGATATTAGTTTGAACCATATGAAAGTGCTGTTTTCTTAGATCAGAAAGTCAAATATCAGCAATTATATTTCTTTCAACTAAGTACCTCCTGTTGCTATTAACTACCATTGGCAAGTTTCTTCAAGTCTGAGCCTTAGTTTACACATCCAAGAAGTTAGTCTGCATAATGTCTAAGGCTCACTATAGCTCTAAACTTATATGATCCCATTGTTTTTAATAACTGATAATAGTATCACAGCAGCTAACTTAACAGTAATTGGTAAGATTGTTCTTGCTTTTGGGGTTTGTTTATATTTGTGTCTGCCACCTTGGTTCTTCTTCACACTATGAAGTCTTGTTGGTTGCTTTCAGAAAAACTCAGGATCATAGTTTTTCTTAAGGACACCTGTGTGAAGGAACAACAAGAAAACTGATAATCTATTTATCTTAAATATAG
>TTN-208,,0,98,1932549,1932646,GTAAGAGTAAAGTCATTCTTTGTGAAGTATATGTGTTGGGAAAAAATAATAATTTCCAGCTTAACTCAATGTGGTTTTTGTTTTTTCAATGCTTGCAG
>TTN-208,,0,106,1932647,1932752,GTATGAAAACTACAGTGAATAATCTTTTATTTCTAACAATTCACACTTGCTAGATTTAAAGTACAAAGACATATGTTTCTAATATCTTGTAACTTTTTCTTCCCAG
>TTN-208,,0,108,1932753,1932860,GTAAGTTTGTTCTTGCTTTTAGGGTTTTTTGTTTGTTTGTTTGTTTTGTATTTGTATTTACCACTTTGATCATTATTCATACTATAAAGTCTTGTCGGTTGCTTTCAG
>TTN-208,,0,89,1932861,1932949,GTAAGTAATTTATATACCACTAGAGATTTTTTCATCAGTTTCTGTTATAAAAATAATTAAAATCAACATATTTTTCTCCTTTACAACAG
>TTN-208,,0,104,1932950,1933053,GTAAGCAAGATCTTTTTATTCTCTATTTCTGTAGCTATATATACACTTTTGACAATTTAGTGGCCATCATTGCAAGCTAACTGATAATCCAATGTCTCCTTTAG
>TTN-208,,0,100,1933054,1933153,GTACATATTAAGTGAAAAAACAATTCTAATGTTACCAATTTTTTAAAATTGTTAATCAAAATGTAAACATATTTGTATTTATTTCACATTTTCTTTCCAG
>TTN-208,,0,767,1933154,1933920,GTCAGTCCCTTTATTTTAAAATATCCTTCCAATATCACAGAGTTTAGATTTCAGATTTCACAGTTATTTAATGAGGTAATCCTTGTGAGGGTCTTTCATTTCTAGCAAGCCCTACCCACATGTTAACAACTCTAATTTTGCTCACTACAAAGTAAGTGTCTTGAGTAAGAGGAAATTAATAGCAATAATCTTTACATGCCAGAGCCTTGGACAGTTGCTAGTACATGATGACTATTTATGAACTTAGGCTACAACTAAGCTATCACCCTGAGAGTCTTGGCAAATCTAAAGACGGTCTTATACTCTCCTACTTTACAAACCCCTGTGTGCCTTTTAGGTATGTTCTCATCCTGACCCAGGACATCCTTATACACTGTCCTTATGAAAAAGCCATTAGTGTACCTCTCATTCATAAGAAAAAAGTTTCTCTGATTTATTGAACTAAGTATGCAGTGCCTACTCTATCAAAAAACAAAACAAAACATGTTTTGCACTACACTGAGTCCTATGTTACTATTTTTGGCAAGGAATGCATGTCTTATGATTTTATGCCATTCTCAATCCTCTACTCTCCAATCTAATTTGCACGCACAACAACAACAAAAAGCTATGAGAACTCTAAGCCACTTAGTTTTCTCTGCTATAAAGTTACTGTAGCTTACTTCCAAGGTTATGTAACCAATATTTTCTAATAAATGCATAATAACATGATGTAGCTTGGCTACGTTTAATAGTCGAAAGCGTTCACATGTTATCTTTCTCACTAG
>TTN-208,,0,92,1933921,1934012,GTAAGCCCTTGGGTCTCTCAGACTTAATTGGCAAAGCACAATTTAAAAGCAAGACAGCACACTAAAAAAATTCCTCTATATGTGAATTTCAG
>TTN-208,,0,107,1934013,1934119,GTAAGAAGTTTTAAGTAAATTCAAGTTAGCTTTTAAGTAAATTGCAGTCTTTGCCTTCATCATCGTTACCCCAAACTCATATTTTCTTCTTCTGTGGTGAAATCCAG
>TTN-208,,0,266,1934120,1934385,GTAAGCCCATCAAAAAAGGGAAATAATTACTGCATGAAATCCAGATATTAGGCCTATCAATTAAAATAAATCAAGTTAAATGAAAGTTAATAAAAAGGTAGAATATCATAAAAATTTGGATAAAGTTTTAGAAACCCAGACTGTGCCTACTTTACTTAGTGAATTTGATAAACCTGTTAATGAGGATGATATAATTGATTACAACACTGTTTTCATAAATTGTCACTAACGTAAATGGTATGCTCCAACTCCTTCTTTTATTCCAG
>TTN-208,,0,90,1934386,1934475,GTAGGTCATTTGCATATAAAAAAGAATATTCAATGTGGATCATGGACATAACTGTATGTGTTTTTTACAAATATTAATTCATAATCGTAG
>TTN-208,,0,106,1934476,1934581,GTAAATAGATATTTTATTTTTAGATCGGGGAATAGCACATAGCTACTTTGGGGCAACAGGGACTTAAATATGGCACTGCAAACTCATTAACTTTTCTTCTTTGTAG
>TTN-208,,0,98,1934582,1934679,GTAAGGAACAAAACATTTATCATCTAAGGTGATTTGGCAGTATTAACAAATATTAGTTCAGACTATTAACAGTGACTCGTGAGTGCATTTTTTTTCAG
>TTN-208,,0,690,1934680,1935369,GTGAGTTTTGAGCAGCACTGCATCAATGCCAAAAATGAGAGTAGGGGAAATCCCAGAAGGTTGGGATGCCATACAAAAGTCTTATGTGCTACAACTTCTTACCTTTACCTCACTGAAAATGTACAAAAACTTTTTAAGAATGCATCGGTGCTAATGCTTCCTGAGGTAGCTCAACCAAGGATTGTATAATTGTAATTGTCTTGTCTTGTGAGCCTTACCAAATTTGTAATAAAAAAAAAAATTCCCTACTGACTTGGTACCTGCTAAGTACCCAATATGTACCCATTAAGCTAGAAGTGGAAAGTAAATATTTATTTCCCTGGTGGTCACACTTCTTATTCCACTAGAATACCTTAGTTGACCTAATCAGCCATTATTTCCTTGTGTTTATATTAGTTACTATTCTTTACCCTGAATTAAAATCATATTTCTGATAAGCAAACTGGTAGAATCAACACCTCATTTGCCATCTTTTTTCATGTGTACAAACTATGAAGCAGTTTTTCTTATATTGAGTCAAATATTATCATGTATCCTACTTTGCAATTTTCCCTAATATGAAATTAATGTAAGAATAATCCCTAGCATTCAAAACAACTGCAGTTTGTATCCCTGGTCATGGTAAAAATCTTTTGGGTTGGCGAAAGGGTTTTTTGGAAATAACTGATTAACTGTATTTCTTTGTCCCAG
>TTN-208,,0,156,1935370,1935525,GTGAGTACATTCTTGATGATTTCTTACCTAATCTTGTTGCCTGTTTTTGCTTTTAGACCTAGAGTTGAAGTTATGGGGCAAGGCAGGGGTTGGCAATGTGAAGAGAACTGCATAGGTGGCCTGTGTAAGACTGACTCTCTCTTCCAAATGTTGTAG
>TTN-208,,0,338,1935526,1935863,GTAGGTTTTTAATTTGGCATGAGAGTAAATGTGTACTCCTAGTCACTAAAATGGGCTTTGTTGGGGAAAATTTAAATGTTTGTCTTTTTTCATTGAGAATCCTATGCTGCCGGTGTATCTGTCTGATTTTTAAAGGTGCTGCTGAATGTACTGCCTGCTCAGGGTTTTCATGACAGTATTGAAATGAAAATGTATTCAGTTATAGTGTTGAAGTAATCCAGGTTTAATTTAAAGACTAGTATTATACCAGGGGTTTGAATTTTTGAAAGATTATGAGTACTACACAATGAAACGATTATCGACATCACAGTAAAACATCCTATTCTGTTTTCTGACAG
>TTN-208,,0,93,1935864,1935956,GTATCTATTTTTGATTTTTGTCTTATCAAATAGGCCTCTGACCTTAAATCTGCTTGAACTTGATAACATCATAAATAATCTTTTCCAATTCAG
>TTN-208,,0,117,1935957,1936073,GTAAGGAAGGTTCTCATTTTAAAAGGGGATAAACTCTTTGCAGTTACTTTCTTGAAAGAAAAAAATAAAAAAAATGGTGAACAATTTTTTTTTCTGCATCTGTAATGCCATACACAG
>TTN-208,,0,114,1936074,1936187,GTAAGTTTCTCAATCAGCTGATAAAAAAAAAAGGATGCTTATGTCAAACTTGCATTTTGGTGTCATATTTATATACAGGACATATAACATTTTACACCATTATCCTGTCTATAG
>TTN-208,,0,474,1936188,1936661,GTATGCTCAGAATCCCCATCAAGATGTTAAGACAGCAGTATATTCAAATGTTTACTCTTTAGTATTCCTTGGGATTACAGATGATTATATATTACTAAAAAAATTTTAAACTACTTTTACTCATATTTTCTATTACCTCATAATTTGAAAAATTATATAAATTCCATTCAAGGGCACATTTCTTAGTTTACTCTAAAATATTAACCTTCAGGAAGTTTCAAAGTGTTTGATCCCCCAGTATATTATGATAATGACCACTGTCATAGATATTATAATTAGATTGGTATGTTTGGCCCAGTCTAAAGTGTGTGGCAGTTAAAAAGCAATTTTTAATTTATATTGAAGTGCTTTTCAGTTAAATTTCCAAATCACCTTTTCACAATTTAAATAAATTAGTCTCTTCTGTGTAAAATAAACATAGGCTTCTTCTGCTTCTTACCATGATGATACACATGCACTTTGTTCCTAATTCAG
>TTN-208,,0,88,1936662,1936749,GTATTATTTATATAATTTTTGTGGTTATTTCGAAGTTCATATGAACTCCTTTTTGACAAACCTAAACAATGATTTCATTGGCTTGCAG
>TTN-208,,0,196,1936750,1936945,GTAAGTCACTCTTGATGTCTGGGATATATAAATTCTTCTAATATCTGCCTGTGAGCTACGATATGAGAAAATATGAAAAATTCATTACTATTATTTCCTCCTGGCTACATTACTTCTTAATGACTGCCTGCACTTTCAGACTGACTATTGGGTAATAAAAAAAAAAATGAATTTGTTTTCCTTCCTTCTTTTTCAG
>TTN-208,,0,114,1936946,1937059,GTATGCTCTTGCACTTAATCTTTGTGACAATAAGTGCTCTCGCACTTAATTTTTGTGACAGGAGATTATCACCTTTCCTCTGGTTTTCCTAATCATTGTTTATTTTATTTTCAG
>TTN-208,,0,102,1937060,1937161,GTAGAATTTGAATTAATTCATAAAGAATAACTTACACTTGGCTGCAAATTCTTAACTGTGTTTTTTCATTAATGCTAATGAAATGCTTTGTTGTTTCAATAG
>TTN-208,,0,80,1937162,1937241,GTAAGTAGTGCTGATTATACACAAGATATTGTCTAGAACTTGATGAGACTGTGGATATGAATATTTCACTCTTTTCTCAG
>TTN-208,,0,100,1937242,1937341,GTAAGAGCACAAGGTCTTTTATAGTTAATAAAATACCCTTTATTCATGCATTGCATTTTGACATACTCTGTTTTTTGCTCTTTTGAATGATATCTTACAG
>TTN-208,,0,603,1937342,1937944,GTAATCATTCTTTGAAGAAAAACCAGACATTCTTCACATGTAGAGGAAATTAGTTAACTTTGCAGTGCTATTAATAATATAATTGGCTTCATGAACTGGCCACTTGTAAACTAAATGTCACTTCTGATTATGTCTTTCCATAGGAGAAGTAAAACAATTCTAAAGAGATGAAATCGCTAAACGCTTATTAGACTAATTTATACTAGTTTTAGTTAATTGCATGTGAAATACTAATTTAAATAACAGATATTAGCATACCCAAAGAGCATTGAAATGACCACAATTTTTTAATTGCACAGCTTCACATTTTCCCATAGTGTTCTTAACCAGGGATAGTAACATTTTCTGCATTCCCCCCAGCCCTGCAAATAATGTCTGGAAATTTGTGGGGCCATTTTTGCTTGGCACACAGACTTGAGGTAGATACCACTGACATTTAGTAGTTGGGAGCCAAGGATGCTAAATGCTCTGCAGTGTGAATGACACTCCAGCACATCAAAGATTATCCTACCCAAAATACAGATAGCCCCACTTAGAGACAAGTGCATTATTAAAATGCTGATTTTTCAGGATTACTAGAATAATTATCCATTTTTGTAATAG
>TTN-208,,0,103,1937945,1938047,GTAAGTTTGGACATGGATGCACTATGGCTAAGAACTAATAAACCATAGTTTTGTTTTAAGAAGGTGGTTTTCCTGATACTAACATTTTTTTCTTGTTCTTCAG
>TTN-208,,0,113,1938048,1938160,GTAAGTTTTGTTTCATGGAGTTGCCACTTTCCCATTTTGAAATAAATGAAAATAATGTTTTGTCAGTTATTTTCATCAGAATTGAAAACATTTATTGGTTATGATCACTATAG
>TTN-208,,0,299,1938161,1938459,GTGAGTCATTAAAACTACACTTTCCAATGGAAAAAGGTTTTAGTAAAACATAAAAATAAAAAGTTTGGGAGAGAGTTAAAAGAAATGGGACATAGCTTCAGCAAGTTATCCTCAATCATATTTTATCTGCTGGCCATGTAAAAGAAATCACCTGATCTTGTTATTTATTAGCTAATGGAATACAAAGATAGATGTGGGAAAACCACAAATCATGTCAGAGGAGCATGCTCACATTTATATTTTCCATAGCAACCCTTCCCACACAAATTTTTGATTACTGTTCTCTTCTGAAATATTAG
>TTN-208,,0,128,1938460,1938587,GTAAGTTTCCTTTGGCATCTAAAGTTTGCCTTTTTACCATGTACTTTGGTATATAATTACTACAGCTTTTAAAATTGCATTTTTATGTCATACTGGGAAATTTACTTCAAATGTTATTTTTTTATCAG
>TTN-208,,0,96,1938588,1938683,GTAAGTAGTTCCTTAAGAAGAAGGTGGAGTAGAACAAGCTATTGTACATTTTAAAACCATCAGGGAGTTTGATTTGTCTATCTTCATTCATTCTAG
>TTN-208,,0,99,1938684,1938782,GTACTTAACGTTATTGGAATAAAATTATGGATATTTTCTCTATATGGGACTATTTTTTAATCTTTCATGGGCTAATGCATGACTGTTCTCTTTCAACAG
>TTN-208,,0,86,1938783,1938868,GTAAGGAATGTTGCACTGATTTTCACAGGATTTTCCCAAGTGATACTATCTTATTACATTGATTTTTGGCTTTGTTTTGTTTTCAG
>TTN-208,,0,1307,1938869,1940175,GTAAAAGAGAAGGTTTCATTGTGTTTATAGAGTAATGTTTTGCTTCTAGTTATATTATTTACTGAGCTTTATGGCTTCAAACTCCCAACAGTCTCAAAATCTATAGCTAAAGAGTAATAAGAAAAGTAAATCAAAAAACTATTAGCAACATTAAAGATATCATATTTCCTATAATTTCAATGTAATTTGTGGCTGTAAGTATATTAATCATGCATGGTTTCTTGTACTGAAAAACTTGGATCTACAGGGGCTTAATAATAACCTAGAAGTAGTTTAGACATATTATATCTCTCCAGTAGAACACATTGGAAGTCGGGTTTTTAAAACTTACTAGCGTAGTAGTTAAAGAGAATTCAATGTTCTTCTAAAAGATTAGACAATTCCTGAGAATAAATGCCTTAGTCTTCCTCTATATTCAAAAAGTCCCCATACTGGAAGGATAGAGAGGCCCAAAACCAGAAACAGCCTCCAAAGAATAGAAAACCAACCAGAGGGAATCTCCCAGAAATCAATACGAAACACTAAAATTGCACACACAGTAATGCACACTGACATCCCATCTAAGAAAGCAAAGGCTTTGAGGAAGACCCATTCCTCAAGAGACAGAAGAACTTATTCCTTCACCATCACCCCCTGAAAAAAAAAAATACATCCTATATCACTGCTGCAGCTCATCTATGAACGTCCAATATACCACAGGCTGTGCCAGAGGCACCAGAACAGAGCTGAGCTTCCACTCCTTCTGGTTGCAATAACAGTCAACAAGTATGGATTGGGTCTAGTTTTACCACTGAAAGCTTAACTCTTAGTTTGGTCCTTCAGGAAAGAAAACTTCAGCAGCATTACATACATCCTCTTTCCACCATATTTTGAACCCACATGTGAGGCAACATGACTCAAAGTATGTTCATAGACATATCCACTATCTGTTAATAAAAGAAAAAACACTTTGCTCTCAGCTGGTCATTCAAAGCAAAGCTTCACAGACTTACTTTCCTAGTTCAGTAGAATTAGAAGCATCCCCAGTTACAAAGGTAAACAATCTAAAATGTTAAATTAAAAAAGCATACGTGCCCTTGATTTATTTTTCACTGATAATCTTGATGAAAAGTTTGCTAAGAAAAATTCTGTCTACATGAATGTCTATAATTTTGGCAACTGACAAGTTTTAGGAATGATTTTAAATAAGGATGTAAGGTTATGCCAAACAGAAGGCTATTTTTTACATAATTAAGTTGAAGTGAAATATTATTTCTTACATGAATATTTATCTCATGCTAATCATTTTCACTTGCCTCTGGCTAAAG
>TTN-208,,0,118,1940176,1940293,GTGCGGAATCTGAATATAATAATAATTTTAATGCATTTTACAGTGTGCCTTTATCCCATAAGTTGAAAAAAACATCCTTATGACTTTGTTACTGTTTTTCTTTCTCTTCTCTTTGCAG
>TTN-208,,0,88,1940294,1940381,GTAAGTGACTTGCTTTCTTACATCAAAAAGGCATCCAGTGTCTGTTTAAGAATTGCCTTCTCAATATTCTCTGTTGATTCCTTTCCAG
>TTN-208,,0,402,1940382,1940783,GTAAACTCTTCTGAATATTTTCTTATACACATTAAAAGTACATGACTCTGGTTTGATGCCATTTTAATATAACCTTGGAATTTGATAATTAAACTCAAAACCACACACGATAAGCTGTTATTTTGTTATTGTAGTGTTTAGCCCCACACACATAAGGCTCCTTAGTACATAGCGTTTGATACACAGATACTCTTTTAATTGAGATCCACTATCAGGTACAATACATCTACATATTTTTATTTTAAAAAAAGCTTTCTCCTTTTCTCTGTCTTCCCATGTTTTGAGTCTATATATTTATTTCTTCTTACAGTCATCCCTCCCAAAATAAGTTGAATTTTTAAATGAGTGAAAACCAACATAAGTATATTCTCTTCAATAAATTTCTGTTTTTCTAATTTCTAG
>TTN-208,,0,1285,1940784,1942068,GTAAGTATGCTTCCGTTTCTGGGGACTAATTTCTAAAGCACAAAGTCACTAAATGGATAATTCTGCCTTAAATTTCTTATATTTTTCTATGCCAAATTATTTTATTTATTAAAATAAAAAAGGTTCATGTTCACATAGACTATCGGAAGTATATATTTATGTGTGTATACATACATGCACAGATATATACATACACACATACATAAAATCATACAGTTTGTAAACTCTTGGATTAAACCAAATATTTTATGAGGAATCACAATAATAAAGACCTGGACTATAAACTCCTATGTCTTCTGATACTTTAAATAAATTTCTATCTCATTAGATACTGGGGAAATCATCTCTCCCACTAAACAGTCAGACCTTCCAGTAGGAATTCAACAAAAAACAGAATGTTGTTAGCTTTTCTATAATATTATTGAACAAAGATTTAGGATTCTCAGGCATAGTCTGTGAGGTCAAATAAGAGAGAAAAATTCTTCTAAAAGATCTGTGAGCAGATTCGTTCAAAAATTAAAAAATACTGTGGCCATAATAATTCATCCTATTTGCTACATATCTGATTAGATTCTCTATAGAAGAAAAATTCAATTATTTGTTAAAAAGAAAATTTTAAATACTCAAGTGCTATGTGGAGCATATATACCTATATAATGAGGTAGTTATTCATTCATTTGCAAACTAGTATTGAACATGTGCTTTGTGCAAGGATCTATATTAACCACTGGAGGGGGAAAAGTTAAGATTAAAAAGACAAGTACAGTAAAAGAATTTCTGTAATTGTAAAGCACTTTCAGAAAGGTAAAGGATTGTTATGGGATTATTGTAGACACTGATCCTGTCCCTAAAGGGCATTAAGATTAGTTTGTGTTCAAAGGTTTACTAGCTATTGATGGAATCCTTTTTAAATTTTCATATTGTGGCAAATTAAATTTAAATCATGTTTTCAGTAAAGGCTATTGTAGAATTTCTTCAAAGGGATCTCAAAAGTAAAGTAGTTTTTTACCAATCATGTATAAATAGAATGTAAATCTAACAAGATAGGAAGTAGTCTTTCTATTCCCAGTTAGTTGTTTGCTTTCTCTGTTTTTGCATTAATGCTAAAGGAAAATAGACCATTTCCTTTATTTCTCTTCTCTAGAAGGCAACTGTATTTCCTTTTAGCATTTCTATTTTAATATTTTAATAGATTAAAATAATATATGATCATGTGTAGTAAAAGACTCCAGCACTTCATCAGCTTCAAAATCTGATGAAGCTTTTTTTTTTCTTTTGTTATTAG
>TTN-208,,0,131,1942069,1942199,GTACTAGTACTTACTCAGTTTATGTATTCCTCTTTTGATCTTATTATGAAATTGATTAATTTACTGAAGATATTTCAATTACTTTTGACAAATATGAGCTAAATCCTGTTAAATTGTATGTGGTATTACAG
>TTN-208,,0,87,1942200,1942286,GTAGGAAAATAACCATTCTCCTCTTTTTTCCACTGAATCACTATAAGGAGTATTTATACTACAACTGACTGTCTCCTTTTCTAATAG
>TTN-208,,0,94,1942287,1942380,GTAAAAAAATAATAATTAAAATAATTCAGAATATGGTTGACTTCAATATTGCTATGATTTCATTCAATGTATGACTACTATTTTCTTTGTACAG
>TTN-208,,0,93,1942381,1942473,GTAAGAAAGACTTTGAAAGTTGCTACAGAATAAAAACAAATTATTTTTAAGCATTTAAGGAACGTTGCTTATATTGTGATTTACATCCAACAG
>TTN-208,,0,93,1942474,1942566,GTAAGCTTTAAAATCTAAATTTAAAATATCTTCTCAAAATTGAAGTATATTATTATAAACAACGCTTAATACTTCCTTTAATTATTTTTACAG
>TTN-208,,0,1003,1942567,1943569,GTAAGTACCAATGTACTGACAAAGAATGTCCTCCTTACAGCTGCCTTCCTAGGTGTTCAATAATAGTTCACAATTAAAAGAGCTATATCTGTACCTTAGGAAGCTACTATGGCTTGAATGTAGACATGGGCACATTACTTAATTACTCATTCCTTCAATTTCCACAGAATTTTCACATTCCCTTACCTGTTACCTTTTCCCTGTTCAAAGGAGATGATGTCTGTAATTTCCTCGCTGTAATTTTCCTCGCAGTCTGTTTTATTTATCAGAGGCTAAAGCAATTTCTCTGCATGCTCCTCAAAAGGGACAGAAAGTAACCAGTCATTTTCTTAGCAACTGCTGAGACCCATTTATCTTCACAATCAAGTTTTTATTTCTCTATATGAGAAAAGATATATCCATTTTAATGAAGTATATATATATATATATATATATATATATATGGTAATAATTCTTCCTCTGATAATTACCATCACTACTGTTGTGTATTTGTTTATTCTCTCATCTAAGTGTGAAGAAACTGTAGTCACTACCCTCTTTGAATATTTCTGTCCTAAATTTGTGCAAAATGGAAAATTGCTTTCCTTTTATTAACAGTTATATTTCTTAAAAGGGGAATTCACCTTCTTGTGTATCCCTTCATAATTCTGTGTAAATATTAAAGAGAGTATCCCATGATACTCTCCTACTACAATCTCCTCTCTTCCCTTTTGTCAGGATATGAGAATATAATAATACACATCATTACATGCATAATGATGCCAAATAAAGTGAGGCAAGCACAGATACATAGCCACATGTAGATCCAATAAAAGATGCTGACCCCGTGTACCTGCTCCCCAAACTAGCGTAATAGTGTTAAAGACAGAACCATTCTTTATATTGGGCTGAGCTACAAAGTCTGCCTACAGTGGATCCAAACAACTTTATAGTAACTGTGAATTCTACTTTCTATCCCTCAATGCTTTTTGCTCCTAATGACAACTTTTTTTAAATAATCTAG
>TTN-208,,0,108,1943570,1943677,GTAAAGACTGCATGGTTTGGTTAAAATTACTTGTTTTTCTGTTCATAAATAACATTTGGCTTTAAAATCATCTGAGTGATAAAGGGTTCCTTCTTTAAACCATTTTAG
>TTN-208,,0,83,1943678,1943760,GTAAGTAGGAGAACATTTTCACATACAAAGCCATTTTTACTTTTTTTTTAAATTTCTTATAATCAATATGATCTTTTTCACAG
>TTN-208,,0,93,1943761,1943853,GTAAGCCTGGAAACCATTCCTTTTTTTTAAATCTTATTTTCCAAAAGTGCCTTGGAAAAGTCAAGAATACTAACGTATACTGGCTCTTTGCAG
>TTN-208,,0,447,1943854,1944300,GTAGGAAAACTTGGCACTAAGGAAATGCACTATGAATAAACTAAAAAATGTCATAGTTATTCTCAATCCCATTAACTTCTGTCTATACTTTTTGGATTAAGAAATCAGGAAAATAGCATAATTTTAACTCACATTCCAAACATCTGTTAATGTCAGAAATCGAATCAAAAGTTAAGTCATGTTATTACTAATCTTTTGGTTATAAACCCTGGAATGTGGAATAAATAAATCAAGGTTTAATCATTTGACAATAATTTTAAAGCATAACTCCTGCCAAGTTATTCCATTCAGTGTTGCCTGTAATATCTGATCCCTAAAACCTAAACCAGCAACAATTTTCCCAGAGTAAACAGTTAAATAGGCTGCTGGTGATGCTTTAGGAAGCCATTAAAGCAAGAAGCTACAAAGAACTATTCTAATTATAAAATGTCTATGATTTCTCCCCAG
>TTN-208,,0,88,1944301,1944388,GTAATTATCAATCCTTCCTTATGCCATCAGTATTTATGTTTCAGATTGAAGGGGAAAAATCACATTTGTAATTTTCAATTGCTTCCAG
>TTN-208,,0,1728,1944389,1946116,GTAAATACTTTCAATTTGTCTGTGCAACTTTTTAAACCAACATTCTTATTATATTTACACAAAGCTATGCTGTATGCTGTGTAACAAACATTTTGGAAAATAAGAAAAATCACCCATAATCATGTTGAACATTATTAGAATTTTTAAAAATTTCCTCCTTACTTTTTTATTCTATGTGTATTCTGTATGGTGGGTGTAAGTTTACAAATTATATAATTGAGAAAACAGATGCTAACAAGAAGACATGCATCCATGTTTCCAGTGAACCTAAAGAGTGCATGTACACAATTCTCAAATTGCTAGAAGGCCATGAATATGTATTCTGAATCATGGCCCAGAATAAATATGGCTTTTTTATAGAACTTGCCCCCATAGTGTCTATTATGTTGTTATATAGTTTTCATAGAAGCAACTTTCCTTAAACTGTACATGAATGTTTAACAATCTGCAACTTTCCTTAAACTGTACATGAATGTTTAACAATTTGCCAGTGCTGACCATTTCACATCATGAGACTCTACCCCTATCGCTAAATTATCATAATAATGCAAAAACCTGTTTGAAGGGTTTCAGTATTCTAATTGAAGAGAAGCATCATAGTTGGTTATCAATATTGCATTTCTAGTCACTGAATATAGAGTTGAACTCTATGAGGCTTTTTCATGGCTCTCACTGGAGGCTTTAGTCCAGTGATTTGCTCAGAACACGAAGCCTTTCCACTCAGGGCTCTTTCTAAGCATGTCTCTAGGCACAACAATACTCCAGCCACAGTTTTTATGTGAAAATTGCCAGTTCTATGTTGAATATAATTAATATAAGAATGGCATAAGGAAAAATATTTCATTAAGCAGTAGCCCCACAAACTTTCAGGTTAGTTTCAAGCACCTAAAGCTCTTTTGCCTAATGGTTATTACTTTAATTTGAGAACTGGTACATTTCCACGTTAATTATTTGCAACCTCCTCAAAGTCATTCTGAAATTTGGGGCCTCCTATGCTGCTTGTTGATCCACTGGTCATCCAGAAATAAACCATCTCTCTCTCCGTTTCCCCTGCAGAGGAAACTGGACATAGAAACTGACTATGCCACTCTTACCCATCTCTTGTATCCCTCTGCATGCTTGCCTCCCAGCTCCCTCCTGTCCAACTCACAAATTGCTTTTAAAAAGCATTTTTATTTTCCCTTCAGCCTCTACTAAAACCATGGTAACCAATAACTGTTGCAAACCTACTTCATTAACAAATATGGGGCTTGATGCTATGGCTCACACCTGTAATCCCCTGACTTTGGGAGGCCAAGGCAGGTGGATCACTTGAGGTCAGGAGTTCGAGACCAGCCTGACCAACATGGTGAAACCCTGTCTCTACTAAAAATGCAAAAATTAGCCTGGTATGGTGGCACATGCCTGTAGTCCCAGCTACTTGGGAGGCTGAGGCAGGAGAATTGCTTGAACCTGGGAAGCGGAGGTTGCAGTGAGCTGAGATTGTGCCACTGAACTCCAGCCTGGGTGACAGAGCGAGACTCCCATCTCAAAAAAAAAAAAAAAAAAAAAAAGTGGTTGACTGTTTTTGTATTGACTAGATAGCAGAAGGAAAAACTAACTCAATTAGTAGACACAAAACCTTACTTTCTTCAAAACAACATTTTTGTCTCCTTTTAAAAAAACAAGTGTTGAGCATTATCTTTCATTGAAGGCAAACAGCTTGAATTATTTTCTTCTTATTTCCAG
>TTN-208,,0,860,1946117,1946976,GTAAGTAAAAAAAAAAAAATGTATACTTAATCACTTCTTTACTCATTTAGTACAAGACTATGGTGAAAAAATATGTGTATAAATGCCGTACATTTCATTCACTTGACAAGCAGTTATCACACAACTACTCAGTATCTGATTTGGTAGTATTTGGACAGTGATTGTGAAAGAGATTTTACAAATATGTATAATTCATTGAATTTCTTTTTGTTTTTTTTTTTCTTTTTGGTTTTGTTTTGACACATAGTCTTACTGTTACCGAGGCTGGAGTATAGTGTCATGATCTTGGCTCACTGCAACCTCCACCTCTGAGGTTCAAGTGATTCTTGTGTCTCAGTCTCCCGAGTAGCTGGGATTACAGACATGCACCACCATGCCCAGCTAATTTTTCTATTTCTAGTAGAGGCAGGGTTTTGCCATGTTGGCCAGGCTGGTCTCAAACTCCTGGCCTCAAGTGATCCACCTGCCTCGGCCTCCGAAAGTGCTGGCATTACCACTCCTAGTTCATTTATCAAATTTCTTCCATCTATACCTCACAGATTTTTTTTTAATTTCCCACTTAATGGCATTAATAGAAACTGAATTATTTTCCTACTTCTAAAACTACCAATTCTGAAGACCTTTCCTAAATTATTTTGCCTCAACAAACCTCTATTTCCTCATCTGTCAAGTGAAGAAATTCAATTGTATTGGGTCCTTTTTAACTCTAATAGTTTTATGATGAGATCTCTTTTGCTATTTATGGGAGCAGAGAGTTTAATGTTTAAATGCAATCTTCAGAAAAGGAATATTCACTACATCCTACTACATTCTTAATGTGACATTTTTTTCTACCACAATTCCTATACTTATATTCGCAG
>TTN-208,,0,101,1946977,1947077,GTATGTGTCTACTACAATTTATACTTCTGAAACTTGCACATTTGTAGATTTGTAATAAGACATCAATAAAAATGACTTGCCTTTATAATTACAAATTTTAG
>TTN-208,,0,93,1947078,1947170,GTAAGTCTTATTTAGTGGAAAGAATAGATCTTCTGTTCTTTCAAAAGCAGAAATGGCAATAACATTTTGTGCCATGATTTTTTTTTTCTGCAG
>TTN-208,,0,92,1947171,1947262,GTATGCATTATGTTTCTTTTTAGTGATTCAATGCTTGATAAAACTAATATAAAGAAATAAATTTCTAACGCATTTTCCAACATTTGTTACAG
>TTN-208,,0,89,1947263,1947351,GTATAGTATTAATGGATTTATTCAGTTTTCATGTTATCTAACTTTGTTTTCAGCTATATGCTAATTCGTTTTTTACTTTTATTTTTTAG
>TTN-208,,0,114,1947352,1947465,GTGAGTAAAATGCTCTCACTTGTGTTTGCAAGGAAAATAGATGTCTGATTGTATGTGTTTAATTGTAATCTGCATTATGGATCAAATCTGAGTGTTCTGTTCTCTTTATTCTAG
>TTN-208,,0,101,1947466,1947566,GTAAGAATTTTACTACTTAGGCCATTAAAAATAAATTTTGATAATTTTGAGCTCTTATATGGATAAAATTACTTATCAAACTGTTATTTAACACTTTTTAG
>TTN-208,,0,85,1947567,1947651,GTAAGTTGCTTTCTCTGAATACAAAACTATTGTTTGACTGTCTTTAAGAATATTACTTTTTCATCATAACTTCTTCTTTGAAAAG
>TTN-208,,0,94,1947652,1947745,GTAATTTTTGGACTAGCAGTATTACCTTATTTCTTTTTAAAATTATTCATATAGGTGAAAATCAAAATCTAATTTTTTCATGTTTACTTTTCAG
>TTN-208,,0,318,1947746,1948063,GTAGGATGTCCTTGTTTTTTCTGATATTACAGCAACTCTTAATCTCAAGCACAGAAGTATTCGATAAATAAGTTAATGTAACATCTAAATCTGTAACATCCAAACTGTATTTAGCAAATATTTTTCCAAATAGACCTTTTACCAAAATACCTAAAAGGTACAAACAATAGTAGATTCTCATTTTTATGAAGGAAAATAAAGAGGACACTAATTGAAAAATTGGATGACCTATATTTGATTAACTGAGAATAGGCTATATAAAATTACACATTGAAGTATCACTAGTAGTAGTTAACTATATGTATATTTTACTTTCAG
>TTN-208,,0,98,1948064,1948161,GTAAGTCCTTCCCTTAGCATGTGATTCATTCACACTTAATTTCTTATGATTTCCCCACATTCTGAAAAATCAATTAATGACCTTAATGTCATTTGCAG
>TTN-208,,0,98,1948162,1948259,GTGGGTTACTAAAATGCTTCTCCCTCCCACTTCAAAAATGAATTTGTTAATAGGGATGCTGAGGAGACATGTATATCTGATTTTATGATTCTTTACAG
>TTN-208,,0,310,1948260,1948569,GTAAGTATTATGCTTTCTTCCTCCTTTTAACCCCAGTCTCCTATTTTAGCAAGGTCAAGATACTAATACCATTTTAATCCACTTCTGAAAGAGATTTCATTTGTAGAGACCGAAATAGTGTAATAAATATCTATCTCACTCATGAAACACTTTTTTGATCTGTCTCATCTTATATGTTTTGCTTTTAATGTACTGAACTACAGGTTCTATGTACATTGGAGCAAATCCATACTAAAACTCTTATGTACATTAACAAAGGGGATTTGATTAGGTTACCTAGGTAATCTTCTAAATTATGTTTTTCTTCTAG
>TTN-208,,0,1157,1948570,1949726,GTAAGTAGTCTTTGCTTCATTTATGTCATGTGGTAAGTTTATTAGAATTTCTTCTTTTATATGTAGACATTTCTCCCTGAGGAATCTAGCTCTAGAAATTCTTGAAAAACAGTAGAGAACAGTGGCTTTCAAACACATGAGTGGGCCAAAAACACACAGTAAATAAACTTATACAAACACATATATAACTAAAAAACATTTCCTGAAACAATACCCATTTATTATCATGTGCATTCTTATGTTTTCTACCCTATTCTGTGTTTTTAAAAATATTGGCTGTACAACAAACATATGAAGAAAAGCTCATCACCACTGGTCACTAGAGAAATGCAAATCAAAACCACAATGAGATACCATCTCACACCAGTTAGAATGGTGATCACTAAAAAGTCAGGAAACAACAGGTGCTAGAGAGGATGTGGAGAAATAGGAAAGCTTTTACACTGTTGGTGGGAGTGTAAATTAGTTCAACCATTATGGAAGACAGTGTGGCGATTCCTCAAGGATCTAGAACCAGAAATACCATTTGACCCAGCAATCTCATTACTGGGTATATACCCAAAGGATTATAAATCATTCTACTATAAAGACACATGCACATGTATGTTTATTGTGGCACTGTTCACAATAGCAAAGACTTGGAACCAACCCAAATGCCCATCAATGACAGACTGGATAAAGAAAATGTGGCACCACATTTACACCACAGGATACTACGCAGCCATAAAAAAGGATGAGTTCATGTCCTTTGCAGGGACATGGATGAAGCTGGAAACCATCATTCTCAGCAAACACAAGAACAGAAAACCAAACACCACATGTTCTCACTCATAAGTGGGAGCTGAACAATGAAAACACATGGACACAGGGAGGGGAGCATCACACACTGGGGCCTGTCAGGGGTTGGGAGGCTAGGGGAAGGATAGCATTAGGAGAATACCTAATGTAGACGATGTGTTGATGGGTGCAGCAAATCACCATGGCACATGTATACCTATGTAACAAGCCTGCACATTCTGCATATGTATCCCAGAACTTAAAGTATATATTAAAAAAAATTGGTGGTAATACAAGCATTAATTTGCACCAGTATAGCTCTCCACCAGAAGAAACTTATCCACCTTCCCAAAATTAATATCTTTTCATTTTACTTTCAG
>TTN-208,,0,103,1949727,1949829,GTAAGTTAAGTATTAGACAAATGGCCATCTAAATATGAAGCTCAGAAATATTTTTACGTATCAAATCCTTGTTCTTACATTTCTTTCCTCTTGGTTCATGTAG
>TTN-208,,0,90,1949830,1949919,GTATGTTTTTGTGAAGGAGAAAAAAAGTTGTTTTCTTTCTAGTTTGTTACTTAATGTAGAAACTGACATCTTCCTTGTCTTCATCTCCAG
>TTN-208,,0,369,1949920,1950288,GTAAGTTTTGGGGTTTTTTTATTGTTGTTGTTGTTTTAGTATTATGGAGGCACATTTAAATCTCGGAGTCTAAGATTTGGACTCCAAGACACAGAGAGTAGTAGAGATCTGAAGATTACAACTCCCATTTAAGAATATGTTCTATCTCTTACAATGAAGATGACATATTAAAAAAAGAAAAGGACATATAATTTCCTTTAAAGCATACAGCAAGGACTCAAAAGTGCATACTAGTTGGACGGTTATTAAAATGGGATAATTGTCTTCCTGTTGAGCTTGTTACTTAGCAGCAGGGATGATAATGTGAAATATGGAAGTTTAAACTTCTGCTGGTAAGATAAATGGTGAGTGTACCTCTTTTTGTTTTAG
>TTN-208,,0,379,1950289,1950667,GTAAGATTCTGCTGAGTATTATAGGCAAAGATGTAACAGCATTCATGATGGTCATTTTTCCTAATAAAAAACTAAATATACACCTAAGGAAAAAAGGAAAATTAAAATGATGTTTTGTATATAGACACAAACATTATGATTATGGAGAATCATAATAACATGCTAAATTAAAAAGCAAGATACACAACTGTGGCAACTATATAATTTCAATAGTTATTCAATAGTGCAGTTATTATTTGTCTATTAAAAATAAACAAAATGAAATAACACTAAAATTCCATTCTTGAAAGAAGCAGCATATGAATTTCCCACTATTATTAATAAGGATTACATAATATAGCTTTGCATACATTAAGTCCTTTATCTTATTTCTTTCCAG
>TTN-208,,0,347,1950668,1951014,GTAACTAATAAACTTCATTGGAATCCCATATTTTACTTTGGATAATGGGATGTAAATAGGATTTACAGAATAATGTGGGAGAAGACATTCATATTCTAATGTGTATTTCCTATGCACAGAATTATTCTTATGACAGAACCACGTTTTAGAGTTAAAAAGAGCTTTAGAAATCACATATTTCAATTACCTAATTTTACAAGTGAAGAAACTAAGATTCTAAAAAATTAACTAACCTCCTAGGTCATATAGGAAATTGACAATAGAAAGACTGCAGCCCAGGTCTCCAGACCTCTACTCTATACTCATTCCCCATTCCACATATTCACTCTTCTTCCTTATTCCTTCAG
>TTN-208,,0,87,1951015,1951101,GTAGGAACATTTCCCGGTGGTTTTTCATTTTATTTTTTAAAATTATCTTTTAGCCTGGGAAATTAACTTTTCAATCAATTTCTGCAG
>TTN-208,,0,101,1951102,1951202,GTAAGTGTTCATGAACGAGTTCCATATCCTGTGTTAAAAGCAGCATTAAACACCCAGGAAGGAAGTTTTCATGAAAATTTCCTATCATTATTTATTCTCAG
>TTN-208,,0,889,1951203,1952091,GTAAGTATTACCAGGGGGAGTACATAAGGCTTTTCCTATTAATCATATTCTAAGAGGGAGACTAGAACTCCCTTAGGTAGATTAATTTATTAACAAGGTGTAGAGCTGGTAACTCCAAGAGTACTTTTTAGGAGAGCTGGGTGGGTACTTTACGGTATTGTGGAACAGGCAAATCAAATGCACATGATTTGTGGTTTTGAAAAGCTTTTCATATATATAAGAATTTCCTGTCTTCAAAAGACATGAAATGAGAGAATTTTATTGGAATGTAAGAATTTTATTTTAGGAATAAAGAGGCCTTTTAACTAAGTAGTGAGCTATTTACTATTCTTAGGGTTTCTGTTTTCCAATCCACCATCTCCCTAAGTATGTGACTGGTGGGCTCTCCATCTTAATTTCCCTTCTTCTTATTTCTTCTATTTGCTTATCCTCCATGATAATTTCCCCTTTATTTGAATTACTTGATATTATATGTCACCCTCCAGGTACTTTTCTTCCTACTATGAAATAATAAAGAGAGCTAGAATATGTGGCAGAATACCTTCATGGAATATAGAAAGGAAAAAACAAGAATGAAAGGGAGCCAAAAATCAATCGTCTACTTTCCTTTTAATATATGTAGCATTTCAGAGTACATAAGGCTCATGAAAGAGGAGGTACAGATCCTCCGGGGGGAAAACCTGGTTAAGCCTAAAGCATAGTGGAAAATGGAAAGATCAACAATTAGTACAGAACAGAAAAATGATTTTGAGGATTGTATTAAGGAAGTTTTAAAGAACAAGAAATCAGCTCTAGAAAATAAATGTATTTTAGGAGTGACAAGGCCAGTCCCTGGAAATACATTTGACTATTAAATTTTTATTTAACTTCTTCACCCAAAATTAAACAG
>TTN-208,,0,92,1952092,1952183,GTAAGTCTATTTCAAAAAAGAATCATATATATTTTAAAATAGCTTATGTATTTTTTACACATTCATTTCTTATTTACCTACTATTTATCCAG
>TTN-208,,0,90,1952184,1952273,GTAAGCAAATGAACCATCATCCCATCATTTTGAGTTATATCCTTCCTTTGTTATATGGGGCTTACACTTATCATTTCTCCTTTGCTTTAG
>TTN-208,,0,167,1952274,1952440,GTAAGGCTCTATGCACACATCTTCATTTTTCCTTTATTGTCATCGAAAGTGCACTCTTGTGTCCCACTCACTAGCTTATCTAAAAATCCGTTAAAAGCTAGAACTATTTGAAAAAGTTAATCGCCTGGCCTTAAAAATAACAGTAATTTATCTCTGCTATTTTACAG
>TTN-208,,0,90,1952441,1952530,GTAAGTGTCTTAAATTCAGAAGACGTAAAGCAAAACACGGTTTTGAGGAGGCTTCTTATTATAAATCTTGCATTATCTACTTTTTTCTAG
>TTN-208,,0,425,1952531,1952955,GTATTTTGTTTGTTCTTATCCTACAGCTTTTACATCAAGATTCCTCACAAATATTTCCCTGAGAACAGTTGAACATGTGCTTATCGATAACATTATCTGCTTATACAGAAATGTGTTTTTATTTCAGTACATATGGTTAATGTTTAATTTTATTGAAAATATCCTAATGTAATAGTTAATAAAGTATTTCTTAATTATAATATCTATTTTTGTAAGTTAAAATTGTTCACCAAAAAAGACAACAACTATGCATATTCCAAGAGGAAAAAAAAAATGGCACTATGCTTGGGTAATAAAAGTATAGATACTAGCAAGAATGACTACTTGTTCAATATATATGGATATGTATAAATAATTTGGGCAACACATATATATTGTAAAATCAAGCTGCATTTATACTTGATACATCCCTGGGTCTTTTGTAG
>TTN-208,,0,89,1952956,1953044,GTAAGTCATTATATGAAGAAAAACCCAGGTGCATGTTTTACATGAAGAAAACTGGTATTTGTTTGACTGGTTTTGCTTTTATGTTTTAG
>TTN-208,,0,91,1953045,1953135,GTAGGTCCATTTTACTTTTTATGTACTTTTTTTTTTAAAGCAAATTAAGCCTCCTTCCTTTTCTGATTAAAATGTATTTTTTTCTTTGCAG
>TTN-208,,0,91,1953136,1953226,GTATGTAGAGCATGTGAGGGAATTGACATGGAAACATTTATAGCAGAGTTTAGGAAATCATGGATTTCTAATAAATTTGCTTCCTTTTCAG
>TTN-208,,0,112,1953227,1953338,GTTAGTATTTGTCTTTTTCAACACCGTTCATTCCAGAGTGCCAATATTTTATCTAAATTACCCAAAAGCCAAACTCTGAATATATACTTTTGTGTCTTTGTTTCTTTCTCAG
>TTN-208,,0,673,1953339,1954011,GTATGTTTTAAGAATAAGGAAATTCTACATATCCACGTTAATTTTGCTAGAATAGTGTGAGTCATTCTAATTAGTCGTTATTTCATCTTAAATGCTTTTGGGTTCACACCCTTCACACCCCAAACTATTCATACTATGGCACAAAATGGAATCTCTAGTGAAGAGTCTTTCATTGATTAAAAAAACAGAAATTTACGTAGCTAAAATTGGATAATATATGTTGAATTTAAGTATTATTGAATCTAACTGTATATATATGTAGGTATACATGTTTATATATATATATACACAGATTATATATATATAGTATGTGTGTATGACATATATCATATGTGTGTATGTGCGTGTGTACAGAAATTGTATATAAAGTTTTTTAAAAGATTGTTCATCTTGTTCCTCTTTTTTATCCCCATGGTGAATTTGGAGTAAATTTTATCATTTAATCTGGTCATTTTACCCTTAATTTGGATTTGAATGCTATAGCATGTAATGACATAGCTTGTGGGAGCCTTGGTTGGTTCAGAAGCAAAATGGGTTATGTAAAAAGGAAGACTAAAATCAACATAAAAATATGGCCTTCATTTAAAAGTTTTCTTTTGACAATACATGAAGAGTGCACATTTAAAAGTGCTGTAATAATTATTCACTTTCTTTTGATGCTTTGTTTTCTTAG
>TTN-208,,0,105,1954012,1954116,GTATGTCTAATTTTGTGTAGAAGCAAAATTTGAAATTATTTGCATTGATTTATGTTAATTTTCAGAAACACTTTTTCACTTTCACTTTCTATACTCATTTTTCAG
>TTN-208,,0,92,1954117,1954208,GTAAGTTGTCCAACTTTTCAAAGATCCAGGTTTTCTTTTACCATAAATGTGTTATTGTCTGTACTAATCTATAGGATTTCTCTCTTTTGTAG
>TTN-208,,0,108,1954209,1954316,GTACGTATTTGTCATGGGAAGGGCAGTTCTGATAACAAAAATGCAAATCTTACTTCTGCGAAGCAAAATATTATAAGTGCCGCTAATCTGCTTCTCTTATTACCACAG
>TTN-208,,0,1695,1954317,1956011,GTAAGCATGCTTAGCACTTTGAATCAAAATTGCTATTTAACTCAGTATTTCCGCATACCTTTTCCTGGTTCTAATCCTATAGAATAACTTTTACTCTGTGCCTTAATGGGGTTTTTGGAAGAAATTATGGACTAGCTGGGAGTCTGAGGAAAATTCCTTAAATACCTTTCCAGCCCTCTTGACTTGACTGTAAAGTGAGAGATTTAGACCTCAGGATATCTATGGGCCTTTCCAACTTCAACCTTTTATGATTGATTGTATGAGTTGGTGCTTTCATTCTGTTTTAAATTATCAGAGTCAATAATTAAACCATGGTTGAGTTCCTAGAGAATATTGCTCTTAAATAAGCCACAGACTAAACAGAGACTTCATTTTTTGGTTTTTTTTTTTTTGTTTGTTTGTTTGTTTGTTTGTTTTGAGACAGAGTCTCACTCTGTCGCCCAGGCTGTAGTGCAGTGGCACGGTCTTGGTTCACTGCAACTTCCGCCTCCTGGGCTCAAACGATTCTCGTGCCTCAGTCACCTGAGTAGCTGGGATTACAGGCATGCCCCACCACACCCAGCTAATTTTTTGTATTTTTAGTAGGGACGGAGTTTCACCATGTTGGCCAGGCAGGTCTCAACCTCCTGACCTCAGGTGATCCACCCACCTCGGCCTCCCAAAGTGTTGGGATTACAGGTGTGAGCCACCATGCCTGGTCTAAACACAGACTTTGATGATGATAGTATTAGCAGCAGCTAACATTTATTGAGGAATTTTCATGAATTCTTTCCCTTAGTTCTCACAGCCCTCATATTAGCCATCTTATAGAAGGGAAACTGAGGCTGAGAGTGCTTTTGTAACTTCCCCGTTAGGGATGGAGTGGGAATTCAGACAGACAGACTTCAGAGCCCTCTCTATCATGGTTAGTCCAAAATGCGTATTCTTCACCATTCTGGAAAATAAGTGGCACATTCAACTCAACAATGTTTTGAAAATTAAAACGTCATGAGAGTCAGGTATCCTGTGACACTTTACCTAAAAGATCTCCATTTGCTAAGAGAAAATTGAGCCACTGTAGTGTCTGGGCAAAAGTATCCACTTCCATCTTCATGCTGAGAATCTCAGGGCTGTTCATTATTTATGAATCAGGCTTTGTGGATACTGAATCAGTGTTTATGAGAGTATAAAGCAAGTCGAATTTAGTTATCTTTCTTGATAATTCCAAACAGCATGGCAGAAAATCTGTCCAGTAATTATGTAGCTCTGTGGGTAGAGAATTCAGACTTTAAGTGTCTGACATGAACCATCCACACTTGGATATCAGTGAACTGGGATGGGAAAAGAAAAAGAATAGGAGGTGCGTAGAAGAAAAGGAAAGAAAAGCTAAAGTGAAAGGAAATGTTTTAACAGCTTCTTCCATGATGTTCTCACTACCATATCCCATTTCTTCACTGGAATAAAGCAACTAATGGACTTTAAAACACATGTAAAAGGTGCTTAAGTCCCTGCACAACTCACAGTCTTTCTACCCCATCTGAGATAGAAGAGTGGCCTATAAATTTTTAATTTTTAAATAATAATTGCATAGAATTATAATGATGGTGTGTGTGTATAATTTAATAATGGCCAATGACCTTACTTTAAGGTTGGTGCAACTATTTTTTTTTCCATCCTTATAATATTTTAAATATTTCTCATCTGTTTTTCTTGCAG
>TTN-208,,0,112,1956012,1956123,GTAGGTGCTGAATACAGACCACTGTCATATTACATTTGCCTAAAGCTTAGTAATTTTGAACAAGTAGGCTTTAAAGAAGTACTAACATCGTGTTTTGTCCTTTCACTGATAG
>TTN-208,,0,236,1956124,1956359,GTGAGACATGATTTCATTAGAAAACTGAAACGTGAAAAATTTAAAAATAAACTACGCTAACCTGTGCATATGCTTTAATTTTCTTTTATATAACACCTGTCTCATTACCATCCTTTTCACAAGGTGAAAAATATAAAAAATAAAACCAATGTTCTTGGAAAGAATGCGAACATCAAAGGTATAATTTATCAGTAATGTGGATTCTTGTACCTTGTTTTCCCTTCCTTTCTAAATAG
>TTN-208,,0,106,1956360,1956465,GTAAGTGCTCATACCTGCAGCATCTTCACCTGTGTCTTCTATATTCACCTGTGTGACTAAATTGTACATGATTGTGTAATTATTTTATTGTGAATGGCCATTCCAG
>TTN-208,,0,105,1956466,1956570,GTATGTACCTACTGGTTTGATTATGTTTTTTAATAAGCATACTTCCAGGAAATCACTCTTTTTTGCTTTTAAAATTCACTGTATGTATCCATTTTATGTCTACAG
>TTN-208,,0,369,1956571,1956939,GTAAGTGATTATTATTCAAATACATTTAGTTTAGCAATTGAACATATTAGAAACAAATATATCAAGGAATGCTTTTCTTCTCTGCATCACCTTCTTACATATCTTCTTGTCACTAGAGAACTGGTCATGTAAAGCAAGAGGAATTATTTTAAGTCAGTCTAATAAACTAATTTGAAGTTCATTTTAAAGACTATGAAATGGAAAGTTGAAATTAATGACCAATATGAGTTTGGGAGATTGAATAAATTACTTATTATAAAAATTTTACTTATTTATTAAAATTATAGAATAATTGTATTGTTCTTCCATGGATGATTAAGACCTGGTTACAAATGTAATGATGCATTTACCTTCCTTATAATTTTTTAG
>TTN-208,,0,693,1956940,1957632,GTAAGCATTTACAACTTATTTCCAATGAGACTAAGAGCATTCACATTTTTAAAAAACACATTTGGCCCCTGGCCTGTAAAATGGTAACAGAAACAAATTACCCAAGGTTGCTAAGTGGATGAATTATGTCTTTCTACCTTTCAGATGAAAAGAAGAAAAAAATAATTGGCATCAATTATTTTTTCTATTATTTCACTCCATTCCCATATAAAGAGCATGCAGCAAGTGGGAATGAGTTTTTAGCTTTGTAATTTTCGCCACTTAACAGTACATAAAGAAAAGGTTCTCGAGAATAAGTGTCCATCTTTACTGAAGTTATTAAAATACAACATACATCCAACAACACAATCATCCCCTTGCTTGAATGCAGCTGATGGCCTCTTAAAAGAACTTGTGTGACTGTGCAGCAGTATTAGGAAGTACATGATCTGTAAATGTTTCACTTTCCTTTTTACAAAGAGCAATGCAAAATTAAAAACATGACAGGCATTACAAAGGGAATAATAATAGGCAAATATTTAACCCCATAGTCCAAATTCTCAATTATCAATCCTACTTTCAAAATAGGCTTTGGTAGCACAGTAGAAGTCACTACTCTTCCTGGCCTTGTGATATGGCACTACTGAAAAATATATATTTATGTATGTCTTTATTAAGCCAAACTAATACATAGTATTTCTCTTTCTTTTATAG
>TTN-208,,0,116,1957633,1957748,GTACTTTTAAAATAGCTTCTTAATGCTACAATTTATGAACTTGGATTAGAGACATGCCTAGTTGTATTTTAATGGACAAGGAAAAAGAAACTAACTCTAGAAACTTTTTCTTATAG
>TTN-208,,0,96,1957749,1957844,GTAAGTTTGCGTTTTTACTAAGCGGTACTATGTCAAAAGTTTAACCTTCCAAGCAAATGCATCTAATTGATTTGGGGTTTTGTTTTTGTTTTACAG
>TTN-208,,0,101,1957845,1957945,GTAAGAAAAATAAAAATCCTATTTCAAAGTCTCTATTATTAAATGTTTCCCCTGAATTTTATAAAATTGTATTCATACTTAATACCTTTGTTTATATTTAG
>TTN-208,,0,97,1957946,1958042,GTATGTATCACAATTTAAGGGCATATTTGTTTATTATTACTGATTCTAGTAGAACTCAGAGTGGTATATTTTAACCTTATTTTTGCATCCCTTCCAG
>TTN-208,,0,97,1958043,1958139,GTAGGAAATAGTCAACATTCTCCTTTTTAAAATTATCTCAATTTATGTGAAAATAAACTCTCAGATATTCATTCATATCTGTTTTGCCTACTGACAG
>TTN-208,,0,95,1958140,1958234,GTAAGCATGTCAAATGTTCTCACATTTATATAGCATTTTCCAGTGTGGGCAGAAAGAATGATCTTCATCATGGCTTGTCATTACACCTGTTTCAG
>TTN-208,,0,126,1958235,1958360,GTAAGTATTAACACTTTTAAATAATTTGACAGTTGAAATGTAATAGAATCAGGGGGAGAAGGGAGAAGGGCAGTCTTATCAATAGTAATTTTGTGCAATTCTCATCATCCTTATTTTCATAAACAG
>TTN-208,,0,881,1958361,1959241,GTGAGCTCCAAGAATCATACATAAATACAATGCTCCTCAAAACTATATGACAGATAATTTTCCAACACACAATCTCTAAGAATTTTTAGAATTTATGAATGGTCTAGAAAAGCACATGCTTATTTGCATGATCATAAATATAGCTTAAGTCAGAGAACATTTTAACTATTACATCTGTTAAGTTAGCAATTAGAATTGCTAAAAGTTGTACAGCATTTTCCAATTAATGAAAAAATATTCTATCAATATGAAAAGAATCTATTTTATAAATTTTCCTTAGAGAAAAATGCATTGTACTGTAATAACTGAAAAGAAAAATGGCAAAACTCCTTTTAAGAAGAGGTTTAGCAGGAACATACAGTTTCTAGTGGTTTCATAAGTTACTGACAAAGTAATTGTGACAAGAGCTTCAAAAATAAGTGGCAAATCCTTTTACAGAGTCTGAGCCCAAGAACTATAAAGGAATAGTCACTGGGACTGAATTGGGGAAGCTAAGGAAACCAATTCTTGTATTCATTAGAAATGTATTGGTGGCAAGTGATACTAACCCAGTGAAAGATAAGCAACTAAAGAAAAGTCCCTAAGAATGGGTACTTTAAGTAATGAGCTTAGCTAATAGAGAACACACAGTAAAGCTGGCCAAAGAAGTAGGGAAGAAATATCTACTTTCCTAAAGCAATTTAATTCTTAAGATAATAATATTAAATTATAATGTGGCACTCTGTGCTGTCCTATAATATCAGGAGCCCAGTTAATAAAGATTATCTTGGTGAGTGTGGACAAGAGCAATAATGCCTTTGTGAGTCTTGAAAACAAAAAATACAAATCTCAACATTTCCTTATTTGCCTAATATCTGCATCTCACTTTTTAAATTCCACAG
>TTN-208,,0,85,1959242,1959326,GTATTTATCACAGAAGCTTTTAGGTGAATTATTTTCTTCTCACACCTGTCCATGAATTAATTAAATTTTGTCATTAACTTTCCAG
>TTN-208,,0,171,1959327,1959497,GTAAGCATTTTACTTAAAATTGGCTATACAATGAGTAGATCCTCTAAAACAATATAGCTTGACCTATGATTGATCACCTCTCTAGAAAGGAACTATGTTGATTATATTTCCCCAAGAAAAAAAAAGCTATCAGGCAAATAGGAAATATGAATCTTTCATTCTGTTTTTCAG
>TTN-208,,0,119,1959498,1959616,GTATGTACCAAATAGCCAAAAAAAAAAAAAAAGTAAAGTAAAATGAAAACATTCAGAATTCGTAACAATTTACCATAAAAATAATGCTTAAGAATAAATGCCTGATTTCTTTCCCATAG
>TTN-208,,0,98,1959617,1959714,GTAAGGATGTGTGACAAAGATACAAGCAAGTTGATGTTCAGTCACCCAATTTTGATTTGAAGTAAAAATTAATTTCCTGTATTTCTTCTCTTTCATAG
>TTN-208,,0,679,1959715,1960393,GTAAGTCCACAGGCCCTTCCACCACTCTCCCCACCTCTGATTCTGAATGTTAACAAAAAAGAATTTGTTTTTAATATGCCCTAATGTAAATAAAAATAGGTCACAAAATTAACCCTGTGGTCTTTCTAAGGTTTCTAAACCTCCTTTTCTCAGGTTTCTAAACCTCCTTTTCTCAGAGGTTTTCAACACACTTAGGCTTGATTTTTTTTTTAATATCTTCACTCTTATGAAAGAGAAGAGGAGGGAGTTAGGAAGAAAGGAATGGAAGGAAGAAAAGAGAGAAGGGAAGGAGGAAGAGAGGAAAGGAAGGAGGACTGGCAATGTTATAGTGAGAAAAAAATACAGAGTGCATGCTTAATAAATGTAGAATTGAAGAAAATGAGGAACAGCAAGGAAAGTACAAAATTAAACCTCAGCATCATGCAATATACCCATGTAACAAACTGCACATGTACCCCTGAAGCTAAAAGTCAAAAATTTTTAATAAAAATAATTAAATAATTAAATGATTTAAATTAAAATTTACAAATAGTACAAAAGTGAAACTATTGGAAAAATAGTCATGTGCCTTATGTACCTTTTAAAATACCAACCAAAACCTAAGGAAAACACAAATATATGAGTCATTGTTTTAACGTATTCATATTGCCATATCGTGTTAACCTCTGTCTTGCTGCAG
>TTN-208,,0,911,1960394,1961304,GTAAGGACATTTTGTATCAGTCAAATTGATTGAGTTACAATTTATATGTGGGAAAATTCACCTTTTTGAAATATATAGTTCTATGACTTTTGAAAAATGTACTGTTTTGTAATCACCACCACAATCAAAATGTGGAATATTTTTATTACCCCGTAAAGTTCCCTTGTGTCCGTTTGTAATCAGTCCCTTCCCCACCCCAGCTGCTAGCGATTTCTGGCAAATAATTTTTAATATTCTTCTCTGGAGTCAATTTCCACTTCTTTAAGATGAGATTCATAATATATGCTTTCTATCACACTTAAAATTTTAAAACAAGTTAATATTTCTGGAAGCACTTTAAAAACTGCTGATAAATGTAAGATAATAATAGTGATTACAAATGAAGCACATTTAAGAGAAAGGAAAGTGAAAAAATGTTAAGTATTTTTAGCTGATAAAATGAATAAAATTTTCTTTTTTCTTTCTTTTGTTTTTTTGTGTTTTTTTGAGACAGAGTCTCACTCTGTCACCCAGGCTGGAGTGCAGTGGCATGATCTTGGCTCACTGCAACCTCTGTCTCCCAGGTTCAAGCAATTCTTCTGCCTCAGCCTCCTGAGTAGCTGGGATTACAGGTGCCTGCCACCACGCATGGCTAATTTTTATGTTTTTAGTAGAGACGCGGTTTCACCATGTTGGCCAGGCTGGTCTTGAACTAACTCCTGACCTCAAGTATCTGCCCACCTTGGCCTCCCAACTTGCTGTGATTACAGGCATGAGCCACCACACCCAGCCATGAATAAAATTTTCACAAGACAAAAAAACAGGCTAATGTTAACAGTCCGTTTCAACAACTCATTGAATTTGTTAGGTGGCACAGCTAATTTTCAACTTTGCAGCAACTTTAACCAGTATATTCTTATTCTTATTCTCAG
>TTN-208,,0,101,1961305,1961405,GTGAGACATATGATCATTTGCTTTCTGCAATAATTGCCATAGACTTATTTCTTAGTCCCCCTACCCCAAATGCTAAATTGAAACCCTACCTTTTTTTCCAG
>TTN-208,,0,130,1961406,1961535,GTAAGTGCCCTTTCAACCACAAAATTATAAACATTATTTCAGCACTTTTCTGTTTTTAAATGAAAGTCATTGGCTTATAATACTTGGGACTGTATTCTAATACATGTGTGCTTTCCACTTATATTTACAG
>TTN-208,,0,106,1961536,1961641,GTAAGGAATTCAGAAGAAGGGGTTAAATTAAAGAAGCAAGCCATGTTTGGTCCTTTTATTTCACCAGTAAAGCTGACTCCCTTTTCATTATTTTAAAATATTTCAG
>TTN-208,,0,622,1961642,1962263,GTAAGTAGCCTTTGGTTCTCTACTTATGATTTACAAACTAAACAAGTTAAGGCTAATTCCCCCTCTATACTAAGTAGAACCCTGGAAAGCTTTATTGGAGAGCAAGTGTTAAGAAAGAAAAGCAAGTACACACACAGGAAATATGACAAGTTCTACAGGAAACCATTCCAAGCACACAACCTCAGCAGATGTTAGATGGAGTGAACTGAGCACTTTCCTTGAGTAATTCCCTCTAATGCAATGGTTTCTTTTTAAAAATATTTCCCAACAAGATTTGAAAGGTCAACAATTGTATGCCACTTCAATGAACCTAAGTAAGGGCAAGAATACTACAGAATTATAGAGAGAATTTACAGTCCCTTAAAAGCCTATACATTATTAATCCCCTTCCAATCATAAAGAGAAAAAAACACTCTACATAAAATGTGACGATGTGCTCATTGAATCCCTATTTACCATATGATCCTAGGAAAATCACTTCAAAGAGTTTTTAAGAATTAGGCTAATATGTAAATCATGGTATGTGTCAGTAAATAAGGTAAATTCATTCCTGATATACAAGGACAAAGGATTACAGATTGAGTATTAACAGTCACTTAATATTATCTTTCATATTGTTCAG
>TTN-208,,0,98,1962264,1962361,GTATTTTATTTTTATTTTCAGTGCTTTTTATTTTTAAAGAAAAAAAAATCTCAAAAACACACTATGAAAACCACCACAATTGTATTTTCCCCCAACAG
>TTN-208,,0,362,1962362,1962723,GTGAGTACAACTTGATTTCTGTATCTTCCTATGGTAAAGTTCCATCTTTGCATAAAATTCTTTTAAACAGAAAGAAATTTTGAAAGGAAATAGCAAAGATTCAGATAAAGTACAAGTGCCTTTTCTTTCACTTTAATTGAATGTTTGCATATCTAAAAGGAGAAATATATATCCTAACCCCATTGTAAAAATAGAACTTTGGTTTTTGATATGTCTTAGTATAAAGTAACCAATTTCATCTTTCTGGAATAGCTATTTTTTAACAAAATTTTGGACTCATATAACATTCTTTTTTAAAAAAATAAGCTTTAATAAAGCTGCCTGTTTCATCTCATGACTCAAATCTTTTTTTTGTTTAATAG
>TTN-208,,0,132,1962724,1962855,GTAAAAATAAATAAATTATCATCAAGTTGAGGCTAAATGAGTTATTAACTTGGGGGTGGAGGCTATTGCACTTAAACACATACTGTTAGATGTTGCTAAATTATATTCTTTTTTTTTTTTTTTCTGATACAG
>TTN-208,,0,124,1962856,1962979,GTAACCAGTTCTTAAATGTCTCTTTCTTTTATCTTCTAAAATATTTTATCTTCTAAATTCAGCTTCCCAAAAAAAGCTTAAAATGAAATCACTTTTTAAAACACAAATCATTTGCATTCTACAG
>TTN-208,,0,740,1962980,1963719,GTAGGTTGGCTTTTGTTTTTACCCACATTTCTTCAGAAGATAATATTAGGGAAATATTTTCAAACATCCCCCCTTATATACACATACAAGAAAGTATTAAAATAAAATTATTTTCCTAATTCCAGAATACAATTTGTACACCAAAGCAGAAACACACATTTGAAGTTAGCATATGCTTTTCTATGAGCATAAAAAGCAGTTATTAAGTACCTAGTTATATGTGGTATTATATAAGATTCCATAGTGTCAGCCCCTGCTCCCAGGAATATTTAAGAATAAAGTCAGTGAATATACAAAATGGCACTACTTGCCTAAACCTTCACAGTTGCTAATTTTCCAAAGCAGTGCAAAGTTAATTAAAGAACTATTTCTATTTTACCAATTAAAATTAGTTTGCTTTCATTTCAATCTTCTGAAAGATAATTTAATGTTTTGGTTACTCAAAATCTCCCAAATCCACTTATCTCCTAAATCCGTTGACTATTCTTTTCAAGACTTTTTTCCTTAAGTCATATGAATCATCTTTGGCTCAGTTTAGTTTAAGGAATCATTACAGTGATCTCAAAAGTCACACATGATAATTTTCCAAAAGTGGAACTGAGAAAGTATTAGGTATTACCTACATTGCATGAAGAAGTTGACTTTTTTTCTTTTTATGTTTTTCACACGCAGAATCTAGAAGAGTAAAAGGTGGGGGTCTCTTTCTAATTAAGTTTGCCTTACAGAGGTTTCTTTTTTAG
>TTN-208,,0,100,1963720,1963819,GTAAGTTTAATTATGAATATATTATTGAAGAAAAACTAAAATACCATGTCTTCCACATCTGAAGAACTTCAACATTTCTTTTCTTTTTCCTTTGTCTTAG
>TTN-208,,0,525,1963820,1964344,GTAAGTATCTCCTCACCCTTCTTCCTTACATGTTTAAGGCCTTTAGATCGTTTTTTTGCCTCTCTTTCAAGCACAGAAAACTCTAAGAAGCCTTATTAAATTCCATGTGAAAGAGGGACAGCCAACTGATGTGAATTCATTCTTGTAGTCAAACTTTCTTTATAGCTACACAGAAACTTGGATAGATTACATTTCAAAGTAAAGCTACCAACTGCCGTGTAACATTTATTTGCAGGATGCACAATATGTCAATTACTTTCTATATGACTAATCATTTTTCTCCTAGTGATTCCTAGCACCTGCATGTAATGTAATGATAGAAATATAAGGATTCATGTTTTGGAGACATTGAGCTAGCTCTTGACAAATGTATGTATATATGTATTTGCTTATGCTTCAACAGCAAATTGTTTGGGTTATGCTGCTGTGTGTGTGTTGAAGTTTCCATTTCTGTAAGTCAGCGTCATATGTCATCAATTAACCAGATGTCATTGATGTTCACTGTGTATCTGCTATGCTCCACAG
>TTN-208,,0,138,1964345,1964482,GTGAGCAATAAAATTACTGGTAGAGGTAGACAAGCCAAGTAACATGGTGTAGTCTTTAGTACACACAATTCAGTAGAAAGCAAATCTTTATTTTTTTCAGTGATTCTAAGACCTTTTTTTTGTCATTGTTCCATAAAG
>TTN-209,ENSE00001465556,1,212,1964483,1964694,GAGCAGTCGTGCATTCCCAGCCTCGCCTCGGGTGTAGGGATTGCATAGAAAAGCAAAACTACACAGTCTTGACTGTGTAGTTTTGTTTTTAGGATTAGAGGCTCACCGATTCATGTCGGAGATGGTCAGAAAAACCAACTCTCCATAGGACGTCGTTTCAGAAGCAACCTTGGGCTTAGTCCCACCCTTTTTAGGCACTCTTGAGAAATCAG
>TTN-209,ENSE00003502146,1,104,1964695,1964798,AGTGCCTAGAAAGATGACAACTCAAGCACCGACGTTTACGCAGCCGTTACAAAGCGTTGTGGTACTGGAGGGTAGTACCGCAACCTTTGAGGCTCACATTAGTG
>TTN-209,ENSE00003807606,1,204,1964799,1965002,GTTTTCCAGTTCCTGAGGTGAGCTGGTTTAGGGATGGCCAGGTGATTTCCACTTCCACTCTGCCCGGCGTGCAGATCTCCTTTAGCGATGGCCGCGCTAAACTGACGATCCCCGCCGTGACTAAAGCCAACAGTGGACGATATTCCCTGAAAGCCACCAATGGATCTGGACAAGCGACTAGTACTGCTGAGCTTCTCGTGAAAG
>TTN-209,ENSE00003810976,1,288,1965003,1965290,CTGAGACAGCACCACCCAACTTCGTTCAACGACTGCAGAGCATGACCGTGAGACAAGGAAGCCAAGTGAGACTCCAAGTGAGAGTGACTGGAATCCCTACACCTGTGGTGAAGTTCTACCGGGATGGAGCCGAAATCCAGAGCTCCCTTGATTTCCAAATTTCACAAGAAGGCGACCTCTACAGCTTACTGATTGCAGAAGCATACCCTGAGGACTCAGGGACCTATTCAGTAAATGCCACCAATAGCGTTGGAAGAGCTACTTCGACTGCTGAATTACTGGTTCAAG
>TTN-209,ENSE00003809662,1,86,1965291,1965376,GTGAAGAAGAAGTACCTGCTAAAAAGACAAAGACAATTGTTTCGACTGCTCAGATCTCAGAATCAAGACAAACCCGAATTGAAAAG
>TTN-209,ENSE00003809782,1,245,1965377,1965621,AAGATTGAAGCCCACTTTGATGCCAGATCAATTGCAACAGTTGAGATGGTCATAGATGGTGCCGCTGGGCAACAGCTGCCACATAAAACACCTCCCAGGATTCCTCCGAAGCCAAAGTCAAGATCCCCAACACCACCGTCTATTGCTGCCAAAGCACAGCTGGCTCGGCAGCAGTCCCCATCGCCCATAAGACACTCCCCTTCCCCGGTCAGACACGTGCGGGCACCGACCCCATCTCCGGTCAG
>TTN-209,ENSE00003805863,1,331,1965622,1965952,GTCCGTGTCTCCAGCAGCAAGAATCTCCACATCCCCCATCAGGTCTGTTAGGTCTCCATTGCTCATGCGTAAGACTCAGGCATCCACCGTGGCCACAGGTCCTGAAGTGCCTCCCCCTTGGAAGCAAGAGGGCTACGTGGCCTCCTCATCTGAGGCTGAGATGAGAGAGACAACGCTGACAACCTCTACTCAGATCAGGACAGAAGAGAGATGGGAAGGGAGATACGGTGTCCAGGAGCAAGTGACCATCAGTGGTGCTGCGGGTGCTGCCGCCAGTGTGTCGGCCAGTGCTAGCTACGCAGCAGAGGCTGTTGCCACTGGTGCTAAAGAG
>TTN-209,ENSE00003803639,1,153,1965953,1966105,GTGAAACAAGATGCTGACAAAAGTGCAGCTGTTGCGACTGTTGTTGCTGCCGTTGATATGGCCAGAGTGAGAGAACCAGTGATCAGCGCTGTAGAGCAGACTGCTCAGAGGACAACCACGACTGCTGTGCACATCCAACCTGCTCAAGAACAG
>TTN-209,ENSE00003810843,1,138,1966106,1966243,GTAAGAAAGGAAGCGGAGAAGACTGCTGTAACTAAGGTAGTAGTGGCCGCCGATAAAGCCAAGGAACAAGAATTAAAATCAAGAACCAAAGAAGTAATTACCACAAAGCAAGAGCAGATGCACGTAACTCATGAGCAG
>TTN-209,ENSE00003803899,1,126,1966244,1966369,ATAAGAAAAGAAACTGAAAAAACATTTGTACCAAAGGTAGTAATTTCCGCAGCTAAAGCCAAAGAACAAGAAACTAGAATTTCTGAAGAAATTACTAAGAAACAGAAACAAGTAACTCAAGAAGCA
>TTN-209,ENSE00003808716,1,138,1966370,1966507,ATAAGACAGGAAACTGAGATAACTGCTGCATCCATGGTGGTAGTTGCCACTGCAAAGTCCACAAAACTAGAAACAGTCCCGGGAGCTCAAGAAGAAACTACCACACAACAAGATCAAATGCACCTAAGTTATGAAAAG
>TTN-209,ENSE00003809802,1,138,1966508,1966645,ATAATGAAGGAAACTAGGAAAACAGTTGTACCTAAAGTCATAGTTGCCACACCCAAAGTCAAAGAACAAGATTTAGTATCAAGAGGTAGAGAAGGCATTACTACCAAAAGAGAACAAGTGCAAATAACTCAGGAGAAG
>TTN-209,ENSE00003805623,1,138,1966646,1966783,ATGAGAAAGGAAGCCGAGAAAACTGCCTTGTCTACAATAGCAGTTGCTACTGCTAAAGCCAAAGAACAAGAAACAATACTGAGAACTAGAGAAACTATGGCTACTAGACAAGAACAAATCCAAGTTACCCATGGAAAG
>TTN-209,ENSE00003801659,1,294,1966784,1967077,GTGGACGTTGGAAAAAAGGCTGAAGCTGTAGCAACAGTTGTTGCTGCAGTAGACCAGGCCCGAGTCAGAGAGCCCAGAGAGCCTGGGCATCTTGAAGAATCCTATGCTCAGCAGACCACTTTGGAGTACGGATATAAGGAACGCATTTCCGCCGCAAAGGTAGCTGAGCCTCCCCAACGTCCAGCCTCAGAACCCCACGTTGTCCCTAAAGCAGTCAAGCCTAGAGTAATCCAGGCTCCTTCTGAGACTCATATCAAAACTACTGATCAAAAGGGAATGCACATATCATCACAG
>TTN-209,ENSE00003804455,1,123,1967078,1967200,ATCAAGAAAACTACAGATCTAACAACGGAAAGATTAGTCCATGTGGATAAACGCCCCCGCACAGCTAGCCCTCACTTTACTGTTTCAAAAATTTCTGTTCCTAAGACAGAACATGGATATGAG
>TTN-209,ENSE00003810306,1,282,1967201,1967482,GCATCAATAGCCGGTAGTGCTATTGCCACATTACAAAAAGAGTTGTCAGCCACATCTTCTGCTCAGAAGATCACCAAATCGGTGAAGGCTCCTACTGTGAAGCCCAGTGAGACTAGAGTAAGGGCAGAGCCCACACCCTTGCCACAGTTCCCCTTCGCTGACACACCAGATACTTACAAGAGTGAAGCTGGCGTTGAGGTGAAAAAGGAAGTAGGGGTGAGCATCACTGGCACCACCGTCCGTGAAGAGCGCTTTGAAGTACTGCACGGACGCGAAGCCAAG
>TTN-209,ENSE00003805296,1,66,1967483,1967548,GTAACAGAAACAGCAAGAGTACCAGCACCTGTTGAAATTCCTGTTACTCCACCAACTTTGGTCTCG
>TTN-209,ENSE00003806123,1,259,1967549,1967807,GGCTTAAAAAATGTGACTGTCATAGAAGGTGAATCTGTCACCTTGGAGTGCCACATCTCTGGATACCCATCCCCGACAGTGACATGGTACAGGGAAGACTACCAAATCGAAAGTTCCATTGACTTCCAGATAACCTTCCAGAGTGGAATTGCTCGTCTTATGATTCGCGAAGCATTTGCGGAAGACAGCGGGCGATTTACTTGCAGTGCTGTAAATGAGGCTGGAACCGTCAGCACATCCTGCTATCTGGCTGTGCAGG
>TTN-209,ENSE00003808554,1,64,1967808,1967871,TGTCAGAAGAATTTGAAAAGGAAACCACAGCCGTGACTGAGAAATTTACTACAGAAGAGAAACG
>TTN-209,ENSE00003804962,1,216,1967872,1968087,CTTTGTTGAGTCAAGAGATGTGGTTATGACTGATACTAGCCTCACAGAGGAACAAGCAGGGCCTGGAGAACCTGCCGCGCCTTACTTTATTACAAAACCAGTGGTCCAGAAACTGGTGGAAGGTGGGAGCGTGGTGTTTGGATGCCAAGTTGGCGGCAACCCAAAGCCCCATGTATACTGGAAAAAATCTGGTGTTCCTCTAACCACTGGATACAG
>TTN-209,ENSE00003804165,1,143,1968088,1968230,ATACAAAGTGAGTTACAACAAACAAACCGGTGAATGCAAGCTGGTGATTTCTATGACTTTTGCTGATGATGCTGGAGAATACACTATTGTTGTTCGCAATAAGCATGGAGAAACTTCTGCATCTGCTTCCTTGCTTGAAGAAG
>TTN-209,ENSE00003802603,1,206,1968231,1968436,CTGATTATGAGTTACTGATGAAGTCCCAGCAAGAAATGCTTTATCAGACACAAGTGACTGCATTTGTTCAAGAACCTAAAGTTGGAGAAACAGCACCTGGATTTGTATACTCTGAGTATGAAAAAGAGTATGAAAAAGAACAAGCCTTAATTAGGAAGAAAATGGCCAAAGATACTGTAGTGGTCAGAACTTATGTAGAAGATCAG
>TTN-209,ENSE00003807963,1,234,1968437,1968670,GAATTCCATATTTCTTCCTTTGAAGAGAGACTTATTAAAGAAATTGAATATAGAATAATAAAGACTACATTAGAAGAACTTCTTGAAGAAGATGGAGAAGAAAAGATGGCAGTTGACATTTCTGAATCTGAAGCTGTTGAATCAGGATTTGATTCAAGAATCAAGAATTATAGAATTCTTGAGGGGATGGGTGTCACTTTTCATTGCAAGATGTCTGGATATCCATTACCAAAG
>TTN-209,ENSE00003808968,1,245,1968671,1968915,ATTGCTTGGTACAAAGATGGCAAGCGCATCAAACATGGAGAAAGATACCAAATGGACTTTCTACAAGATGGCAGAGCTAGTCTGCGTATACCTGTTGTTCTTCCAGAAGATGAAGGAATCTACACTGCATTTGCCAGCAATATTAAAGGAAATGCAATTTGCTCAGGGAAATTGTATGTGGAGCCTGCTGCACCACTTGGAGCTCCGACTTACATTCCCACACTAGAGCCAGTGAGCAGAATCAG
>TTN-209,ENSE00003802614,1,272,1968916,1969187,ATCTCTCTCTCCACGTTCAGTGAGCAGGTCTCCTATACGCATGTCTCCTGCACGGATGTCACCTGCAAGGATGTCTCCTGCACGGATGTCCCCTGCAAGAATGTCCCCTGGACGTAGGCTGGAGGAGACAGATGAGTCACAACTTGAGAGACTATATAAACCAGTCTTTGTGTTAAAACCTGTTTCTTTCAAATGTTTAGAAGGGCAAACTGCCAGATTTGACTTAAAGGTTGTTGGTAGACCTATGCCAGAGACGTTCTGGTTTCATGATG
>TTN-209,ENSE00003811446,1,165,1969188,1969352,GCCAGCAAATTGTCAATGACTATACCCATAAAGTAGTCATTAAAGAAGATGGTACTCAATCACTAATTATTGTCCCTGCCACACCCAGTGATTCTGGGGAATGGACTGTGGTTGCCCAAAACAGGGCAGGCAGATCTTCAATTTCAGTGATTTTAACTGTGGAAG
>TTN-209,ENSE00003805710,1,169,1969353,1969521,CTGTGGAACATCAGGTAAAACCGATGTTTGTAGAAAAACTGAAAAATGTCAATATAAAGGAAGGTTCCCGACTTGAAATGAAAGTCAGAGCTACGGGTAACCCCAACCCTGACATTGTATGGTTGAAAAACAGTGACATCATTGTGCCTCATAAATATCCCAAAATCAG
>TTN-209,ENSE00003809358,1,1694,1969522,1971215,AATTGAAGGAACCAAGGGAGAAGCTGCCCTTAAAATCGATTCCACTGTCAGCCAAGATTCTGCCTGGTATACTGCGACTGCTATTAATAAAGCTGGCAGAGACACTACAAGATGCAAAGTAAATGTTGAAGTTGAGTTTGCAGAGCCTGAGCCAGAGAGAAAGTTAATCATCCCACGGGGGACATATAGAGCAAAGGAGATTGCAGCCCCAGAACTGGAGCCCCTCCATTTGCGATATGGCCAAGAGCAATGGGAAGAAGGTGATCTCTATGACAAAGAGAAACAACAGAAACCATTTTTCAAGAAAAAACTCACTTCCTTAAGACTTAAGCGCTTTGGGCCTGCCCACTTTGAATGCAGGCTAACACCCATTGGTGACCCAACGATGGTGGTGGAGTGGCTCCATGATGGAAAGCCACTTGAAGCAGCCAACAGGCTCCGTATGATCAATGAATTTGGGTACTGCAGCCTTGATTATGGCGTTGCATATTCTAGAGACAGTGGTATCATTACTTGCAGAGCCACTAACAAATATGGAACAGATCACACATCTGCTACCCTTATTGTTAAAGATGAGAAAAGTCTTGTGGAAGAATCCCAATTGCCTGAGGGGAGGAAAGGCTTACAGAGAATTGAAGAATTAGAGAGAATGGCTCATGAAGGTGCACTTACAGGTGTAACAACAGATCAGAAAGAAAAGCAAAAGCCAGACATTGTCTTGTACCCAGAGCCAGTTAGAGTACTTGAAGGGGAGACTGCAAGGTTCCGCTGCAGGGTAACAGGCTACCCTCAGCCCAAAGTCAACTGGTACCTCAATGGACAGCTCATCCGCAAAAGCAAAAGGTTCAGAGTTCGCTATGATGGTATCCATTACCTGGACATCGTGGACTGCAAATCATATGACACAGGTGAAGTGAAGGTCACCGCGGAAAATCCTGAAGGTGTGATAGAGCATAAAGTGAAGCTTGAGATTCAACAGAGGGAAGATTTTAGGTCTGTCCTTAGGAGAGCTCCTGAACCAAGGCCTGAGTTTCACGTACATGAACCAGGAAAGCTTCAGTTTGAAGTACAAAAAGTGGATAGACCTGTTGACACCACTGAAACCAAAGAAGTTGTGAAGTTGAAAAGGGCTGAAAGAATTACCCATGAAAAAGTGCCTGAAGAGTCGGAAGAGCTGCGCAGTAAATTCAAGCGCAGAACAGAAGAGGGCTATTATGAAGCCATTACCGCTGTGGAGCTCAAGTCTCGAAAGAAGGATGAATCCTATGAGGAACTCCTCAGGAAGACAAAAGATGAACTTCTCCACTGGACCAAAGAGTTAACTGAAGAGGAAAAGAAAGCTCTTGCCGAAGAAGGCAAAATCACGATTCCAACTTTTAAACCTGACAAGATTGAACTAAGTCCTAGTATGGAGGCTCCAAAAATCTTCGAAAGAATCCAGAGCCAAACAGTGGGCCAAGGATCTGATGCACACTTCCGGGTCAGAGTCGTGGGGAAACCAGACCCCGAATGTGAATGGTACAAAAATGGTGTCAAAATTGAACGGTCTGACCGGATCTACTGGTACTGGCCCGAAGACAATGTTTGTGAATTGGTCATAAGAGATGTGACTGCTGAGGACTCTGCCAGCATCATGGTAAAAGCCATCAACATAGCTGGAGAAACCTCCAGTCACGCATTCTTACTTGTCCAAG
>TTN-209,ENSE00003809440,1,282,1971216,1971497,CCAAGCAATTGATCACTTTCACACAGGAATTACAAGATGTTGTTGCTAAGGAAAAAGACACTATGGCAACCTTTGAATGTGAAACTTCAGAACCATTTGTCAAAGTGAAATGGTATAAAGATGGTATGGAGGTTCATGAGGGAGATAAATACAGGATGCACTCTGACAGAAAGGTTCACTTCCTCTCCATACTGACCATTGATACGTCTGATGCTGAAGATTACAGCTGTGTACTTGTGGAAGATGAAAATGTCAAAACGACTGCTAAACTTATTGTTGAAG
>TTN-209,ENSE00003802960,1,267,1971498,1971764,GTGCAGTTGTTGAGTTTGTGAAAGAACTTCAGGACATAGAAGTTCCAGAATCATATTCAGGAGAATTAGAGTGCATTGTATCCCCAGAAAATATAGAAGGAAAATGGTATCATAATGATGTGGAGCTTAAATCCAATGGCAAATATACAATTACATCTCGTCGTGGACGTCAGAACCTCACGGTCAAGGATGTAACCAAGGAGGACCAGGGAGAATACAGCTTTGTCATCGACGGGAAAAAGACAACCTGTAAATTAAAGATGAAAC
>TTN-209,ENSE00003804241,1,273,1971765,1972037,CCCGCCCCATTGCTATCCTACAAGGACTTAGTGACCAAAAAGTCTGTGAGGGTGACATTGTTCAGCTTGAAGTTAAAGTCTCCTTGGAAAGTGTGGAAGGCGTCTGGATGAAAGACGGCCAAGAAGTGCAGCCCAGTGACAGGGTTCACATTGTGATAGACAAACAATCTCATATGCTGCTCATTGAAGACATGACTAAGGAAGATGCTGGAAATTACTCTTTCACCATTCCAGCCCTTGGCCTCTCCACCAGTGGGCGTGTCTCTGTCTATA
>TTN-209,ENSE00003806988,1,264,1972038,1972301,GTGTGGACGTGATAACACCTCTAAAAGATGTTAATGTGATTGAAGGCACCAAGGCTGTGCTTGAATGTAAGGTGTCAGTCCCTGATGTGACTTCTGTTAAGTGGTACTTAAATGATGAACAAATCAAGCCTGATGACCGTGTACAGGCCATTGTGAAAGGTACTAAACAGCGACTAGTCATTAACCGAACTCATGCTTCAGACGAAGGACCTTACAAGCTGATAGTTGGCAGAGTTGAAACCAACTGTAATCTCTCTGTAGAAA
>TTN-209,ENSE00003804968,1,261,1972302,1972562,AAATTAAAATTATCAGAGGTCTTCGTGACCTTACCTGTACAGAAACTCAAAATGTGGTGTTTGAGGTTGAGCTGTCCCACTCTGGAATTGATGTCCTGTGGAATTTTAAGGACAAGGAAATCAAGCCCAGTTCTAAATATAAAATTGAAGCACATGGAAAAATATATAAATTGACAGTTCTAAATATGATGAAAGATGATGAAGGAAAATACACATTTTACGCGGGAGAAAATATGACATCTGGAAAACTTACTGTGGCAG
>TTN-209,ENSE00003809850,1,261,1972563,1972823,GTGGGGCCATCTCCAAGCCACTCACAGATCAGACCGTAGCTGAATCCCAGGAAGCTGTGTTTGAATGTGAAGTTGCCAACCCAGATTCCAAAGGCGAATGGTTGAGGGATGGCAAACACCTACCACTGACTAACAACATCAGAAGTGAGTCTGATGGCCACAAAAGGAGACTTATCATTGCTGCCACCAAATTAGATGACATTGGAGAATATACCTACAAGGTGGCCACCTCCAAAACATCTGCCAAACTCAAAGTTGAAG
>TTN-209,ENSE00003806479,1,264,1972824,1973087,CTGTCAAAATTAAGAAGACTCTGAAGAACCTCACAGTGACAGAAACACAGGATGCTGTTTTCACTGTCGAGCTTACACACCCTAATGTCAAAGGTGTCCAGTGGATCAAAAATGGAGTTGTGCTGGAATCCAATGAAAAGTATGCTATCTCTGTCAAAGGAACAATTTACTCTCTGAGGATTAAAAACTGTGCCATCGTGGATGAGTCTGTTTATGGCTTCAGGCTTGGAAGGCTTGGAGCCAGTGCCAGACTGCACGTGGAGA
>TTN-209,ENSE00003804523,1,261,1973088,1973348,CTGTCAAGATCATTAAAAAGCCAAAGGATGTGACAGCCTTGGAAAATGCCACTGTTGCCTTTGAAGTTAGTGTTTCCCATGACACTGTTCCAGTAAAATGGTTCCATAAGAGTGTGGAAATTAAGCCAAGTGACAAACACAGACTGGTCTCAGAAAGGAAAGTCCACAAGCTGATGCTGCAGAACATCTCCCCCTCAGATGCTGGGGAATACACAGCTGTGGTCGGGCAATTGGAATGCAAAGCAAAACTGTTTGTGGAGA
>TTN-209,ENSE00003807378,1,261,1973349,1973609,CATTACATATTACAAAAACCATGAAAAATATCGAGGTGCCTGAGACCAAAACTGCCTCTTTTGAGTGTGAGGTGTCCCACTTCAATGTCCCTTCCATGTGGCTGAAGAATGGTGTGGAAATTGAGATGAGTGAAAAGTTCAAGATAGTTGTGCAGGGAAAACTCCATCAGCTGATCATCATGAACACCAGCACAGAGGACTCGGCAGAATACACATTTGTCTGTGGCAATGACCAAGTCAGTGCCACCCTGACAGTCACCC
>TTN-209,ENSE00003807271,1,261,1973610,1973870,CAATCATGATTACTTCCATGCTGAAAGACATCAACGCTGAAGAAAAAGACACTATTACTTTTGAGGTGACAGTGAACTATGAAGGCATCTCTTACAAATGGTTAAAGAATGGTGTGGAAATCAAATCAACTGACAAGTGCCAGATGAGAACCAAAAAGCTCACACACTCACTGAACATCAGGAATGTTCACTTTGGGGATGCTGCTGACTACACCTTTGTGGCTGGAAAAGCAACATCAACAGCCACACTTTATGTGGAAG
>TTN-209,ENSE00003808172,1,142,1973871,1974012,CTCGTCATATAGAATTTAGGAAACACATTAAGGACATTAAGGTACTGGAGAAGAAGCGAGCCATGTTTGAATGTGAAGTTTCTGAACCTGACATCACTGTACAGTGGATGAAAGATGACCAGGAACTGCAGATCACAGACAG
>TTN-209,ENSE00003808223,1,166,1974013,1974178,AATAAAGATTCAGAAGGAGAAATATGTCCACCGCCTTCTGATCCCATCCACCCGGATGTCTGATGCTGGGAAGTACACAGTGGTGGCAGGAGGCAACGTGTCAACTGCAAAACTCTTTGTAGAAGGCAGAGATGTTCGCATCCGAAGTATTAAAAAGGAGGTTCAG
>TTN-209,ENSE00003810851,1,232,1974179,1974410,GTCATTGAGAAACAGCGTGCTGTTGTTGAATTTGAGGTCAATGAAGACGATGTTGATGCCCACTGGTATAAAGATGGCATTGAAATCAATTTCCAAGTTCAAGAACGACACAAATATGTAGTGGAAAGAAGAATCCACCGAATGTTTATCTCTGAGACCAGACAGAGCGATGCAGGAGAATACACCTTTGTGGCAGGAAGGAACAGGAGTTCTGTCACTCTCTATGTCAATG
>TTN-209,ENSE00003802092,1,285,1974411,1974695,CTCCTGAACCGCCCCAAGTTCTGCAGGAGCTCCAGCCTGTCACTGTGCAGTCTGGCAAGCCTGCCCGCTTCTGTGCCGTGATATCCGGAAGACCACAGCCCAAAATTTCCTGGTACAAGGAAGAGCAGCTGCTTTCCACTGGCTTCAAGTGCAAATTTCTTCATGATGGGCAAGAATACACGCTTTTGCTAATTGAAGCCTTCCCAGAGGATGCGGCAGTCTATACCTGTGAAGCCAAGAATGACTATGGTGTTGCCACAACATCAGCTTCACTCTCAGTGGAAG
>TTN-209,ENSE00003807103,1,126,1974696,1974821,TTCCAGAAGTTGTGTCTCCTGATCAGGAAATGCCTGTTTATCCACCTGCCATCATCACCCCGCTTCAGGACACTGTCACTTCTGAAGGGCAGCCAGCCCGTTTTCAATGCCGGGTTTCTGGAACAG
>TTN-209,ENSE00003801355,1,189,1974822,1975010,ATCTAAAAGTGTCGTGGTACAGCAAAGACAAGAAAATCAAGCCATCTCGGTTCTTTAGAATGACTCAATTTGAAGACACTTATCAACTGGAAATTGCCGAAGCTTATCCAGAAGATGAAGGAACTTACACGTTTGTTGCTAGTAATGCTGTAGGCCAAGTATCAAGCACAGCCAACCTGAGTCTGGAAG
>TTN-209,ENSE00004024281,1,375,1975011,1975385,GATTTAGCAAATTTGAAGAAAATACATCAAACTCCCAATGGCATGTCTCTTTATCAGTTTCATTTAAGAAGGAGCCCCTTGGCCAAAAGCCCAGCTTCATCCAGCCTCTGTCAAGCCTCAGGGTGCACAACGGGGAGACAGTCAGATTTCATGCGAGGGTTTCTGGCATTCCCAAGCCAGAAATCCAATGGTTTCATAACCAGCAGCTAATTCTACCAACAAAAGATGTAGTTTTCCATTTTGAGGAGTCCACAGGCATGGCTTTAATGCTTATAGTTGATGCTTACTCAGAGCATGCTGGGCAGTACTCTTGCAAAGCAGCCAATAGTGCTGGGGAAGCCACTTGTGCAGCTACACTCACAGTGACTCCAAAAG
>TTN-209,ENSE00004024285,1,576,1975386,1975961,TGCAAGCCCTAGATAGGCAAAGTTCTGGGAAAGATGTAAGAGAGTCCACCAAGTCCCAGGCAGTGGCAGATTCCTCTTTCACAAAGGAGGAGAGCAAAATATCTCAAAAGGAAATTAAGTCATTTCAAGGATCATCATATGAATATGAAGTGCAGGTTTTTGAAAGTGTATCTCAAAGTTCCATCCACACAGCTGCATCTGTTCAAGATACACAGTTGTGCCATACTGCATCCCTTTCACAAATTGCAGAAAGCACTGAGCTATCTAAGGAATGTGCTAAAGAGTCCACGGGTGAGGCGCCCAAGATTTTCCTGCATCTTCAGGACGTCACTGTAAAGTGCGGTGACACGGCTCAATTCCTCTGTGTTTTAAAAGATGATTCTTTCATTGATGTAACCTGGACTCACGAAGGTGCAAAGATAGAGGAATCCGAGAGACTGAAACAATCACAAAATGGAAATATTCAGTTTCTTACCATATGTAATGTTCAGCTGGTAGACCAAGGACTATACAGCTGCATTGTACACAATGACTGTGGAGAGAGGACAACGTCAGCAGTACTAAGTGTAGAAGGTG
>TTN-209,ENSE00003810791,1,57,1975962,1976018,CTCCTGAATCAATTTTGCATGAGAGGATTGAACAAGAGATTGAGATGGAAATGAAAG
>TTN-209,ENSE00004024265,1,2781,1976019,1978799,AGTTTTCTAGTTCTTTTCTGTCTGCCGAGGAAGAAGGACTTCATAGCGCCGAACTTCAATTATCTAAAATAAATGAAACACTTGAACTTTTGTCTGAATCTCCAGTTTACCCAACTAAATTTGATTCCGAAAAGGAAGGCACTGGCCCAATTTTCATCAAAGAAGTGTCAAATGCTGATATAAGCATGGGGGATGTGGCTACACTGTCTGTAACTGTCATTGGCATCCCCAAACCTAAAATTCAGTGGTTCTTTAATGGAGTGCTATTAACCCCTTCTGCTGACTACAAATTTGTTTTTGACGGTGATGATCATAGCCTGATCATTCTGTTCACCAAATTGGAGGATGAGGGAGAGTATACATGTATGGCCAGTAATGACTATGGAAAGACAATATGTAGTGCCTATCTAAAAATTAATTCCAAAGGAGAGGGTCACAAAGACACTGAAACAGAATCAGCAGTGGCAAAATCTCTGGAAAAGCTGGGAGGTCCTTGTCCTCCTCACTTCCTTAAGGAGTTAAAACCAATTCGCTGTGCTCAAGGGCTTCCTGCCATCTTTGAGTACACAGTGGTTGGAGAGCCTGCCCCTACTGTTACATGGTTCAAAGAAAACAAGCAGCTTTGCACCAGTGTTTATTACACTATCATTCATAACCCTAATGGCTCTGGAACTTTCATTGTCAATGACCCTCAGAGGGAAGACAGTGGCCTCTATATCTGTAAAGCAGAGAATATGTTGGGTGAGTCCACCTGTGCAGCAGAGCTGCTTGTGCTTCTGGAAGACACAGACATGACTGATACCCCCTGCAAAGCAAAGTCCACACCAGAGGCTCCTGAGGATTTTCCACAGACACCCTTAAAGGGTCCCGCAGTTGAAGCACTTGACTCAGAGCAGGAAATTGCAACGTTTGTAAAAGACACCATTTTGAAAGCTGCTTTAATTACAGAAGAAAACCAGCAACTATCTTATGAGCATATTGCTAAAGCCAATGAATTGAGCAGTCAGCTTCCTTTGGGAGCTCAGGAATTGCAATCCATTTTGGAGCAAGACAAGCTCACTCCTGAAAGCACCAGGGAATTTCTTTGCATCAATGGCAGTATTCACTTTCAGCCTCTCAAGGAACCATCTCCCAACCTACAGCTGCAGATTGTACAGTCCCAGAAAACCTTCTCCAAAGAAGGTATTCTAATGCCTGAAGAGCCTGAGACACAGGCAGTTCTATCAGATACCGAGAAAATCTTCCCAAGTGCCATGTCCATAGAACAAATTAATTCATTAACAGTTGAGCCTCTGAAAACTTTATTAGCTGAACCTGAAGGGAATTATCCACAGTCTTCAATAGAACCTCCAATGCATTCTTATCTAACCTCTGTGGCTGAGGAAGTACTTTCACCAAAAGAAAAGACAGTATCTGACACCAACAGAGAGCAAAGAGTGACTCTTCAAAAGCAAGAGGCACAAAGTGCGCTCATCTTGAGTCAGAGCTTAGCTGAGGGACACGTGGAGAGTCTCCAGAGTCCTGATGTCATGATCTCTCAGGTAAACTATGAGCCCCTAGTCCCTTCAGAACACTCATGCACAGAAGGAGGTAAAATTTTGATAGAAAGTGCAAATCCACTGGAAAATGCAGGGCAAGATTCTGCGGTCAGAATTGAGGAAGGCAAGTCCTTAAGATTTCCACTAGCACTTGAAGAAAAGCAGGTACTGCTCAAAGAAGAGCATTCTGACAACGTGGTGATGCCCCCAGACCAAATCATTGAGTCTAAAAGAGAGCCCGTGGCAATAAAGAAAGTGCAGGAGGTACAGGGAAGGGACCTTCTTTCTAAGGAAAGCTTGCTTTCTGGTATTCCAGAAGAGCAGAGATTAAACCTGAAAATTCAAATCTGCCGGGCTTTGCAAGCAGCCGTGGCCAGCGAGCAGCCAGGTCTTTTCTCTGAGTGGCTAAGAAATATTGAAAAGGTGGAGGTCGAGGCTGTAAACATCACCCAAGAGCCCAGACACATCATGTGCATGTACCTTGTTACTTCGGCAAAGTCTGTAACAGAAGAAGTAACCATCATTATTGAAGATGTTGATCCTCAAATGGCTAACCTGAAAATGGAACTTAGGGATGCTTTGTGTGCTATTATATATGAGGAAATAGACATCCTAACAGCTGAGGGTCCTAGAATTCAGCAAGGAGCCAAAACAAGTTTGCAAGAAGAAATGGATTCTTTTTCAGGTTCACAGAAGGTTGAACCCATTACTGAACCAGAAGTTGAATCTAAATATCTGATCTCAACTGAAGAGGTCAGTTATTTTAACGTGCAAAGTAGGGTTAAATATTTGGATGCCACACCTGTCACTAAAGGGGTTGCTTCAGCTGTTGTCTCTGACGAAAAACAAGATGAGAGTCTGAAACCATCAGAGGAAAAAGAGGAGTCTTCCTCTGAAAGTGGTACTGAGGAGGTTGCTACAGTAAAGATACAGGAAGCTGAGGGTGGCTTAATCAAAGAGGATGGCCCCATGATACATACACCTTTAGTGGACACTGTTTCTGAGGAAGGTGATATTGTACACCTCACAACATCCATAACAAATGCTAAAGAGGTGAATTGGTATTTTGAGAATAAACTGGTGCCTTCAGATGAAAAGTTCAAGTGTTTACAAGATCAAAATACATATACGCTAGTCATCGACAAAGTAAATACCGAAGACCATCAAGGAGAGTATGTCTGTGAGGCCTTGAATGACAGCGGAAAAACAGCAACTTCAGCCAAACTCACTGTAGTAAAAAGAG
>TTN-209,ENSE00003805227,1,279,1978800,1979078,CTGCCCCAGTGATCAAGAGGAAAATCGAACCCCTGGAAGTAGCACTGGGCCACCTAGCCAAATTCACCTGTGAGATCCAAAGTGCTCCCAATGTCCGGTTCCAGTGGTTTAAAGCTGGCCGAGAAATTTATGAGAGTGACAAGTGTTCTATTCGATCTTCAAAGTATATCTCCAGCCTTGAAATCCTGAGAACCCAGGTGGTTGACTGCGGCGAGTATACATGCAAAGCTTCCAATGAGTATGGCAGTGTCAGCTGTACAGCCACACTAACTGTGACAG
>TTN-209,ENSE00003808619,1,564,1979079,1979642,AGGCATATCCACCAACCTTTCTCTCCAGACCTAAGTCCCTTACAACTTTTGTGGGTAAGGCAGCCAAGTTCATCTGCACAGTGACAGGGACTCCTGTGATAGAAACCATTTGGCAGAAAGATGGTGCTGCACTCTCACCTTCACCTAACTGGAGGATTTCCGACGCAGAAAACAAACACATTTTAGAACTCTCAAACCTTACCATTCAAGATAGAGGAGTTTATTCTTGTAAGGCTTCCAACAAGTTTGGAGCAGACATCTGCCAAGCAGAGTTGATCATCATTGATAAGCCACATTTCATTAAAGAATTAGAGCCTGTGCAGTCCGCTATCAATAAGAAGGTCCACCTTGAGTGCCAAGTAGATGAAGACAGAAAAGTCACAGTTACGTGGAGCAAAGATGGGCAAAAACTCCCCCCAGGGAAAGATTATAAGATCTGTTTTGAAGATAAAATAGCAACACTTGAGATTCCTTTGGCCAAACTGAAAGATTCAGGAACCTATGTCTGTACAGCTTCAAATGAGGCTGGAAGCAGCTCCTGCTCAGCCACAGTCACTGTCAGAG
>TTN-209,ENSE00003811334,1,282,1979643,1979924,AGCCACCATCCTTCGTGAAGAAGGTGGATCCCTCTTATTTAATGCTCCCAGGTGAATCAGCACGCCTCCATTGCAAGCTGAAAGGCTCACCTGTGATCCAGGTTACTTGGTTTAAAAATAACAAAGAACTCAGTGAAAGTAACACAGTCCGAATGTATTTTGTCAATTCTGAGGCTATACTTGATATTACGGATGTAAAAGTTGAAGACAGTGGGAGTTACTCATGTGAAGCAGTGAATGACGTCGGCAGTGATAGCTGCAGTACTGAAATAGTTATCAAAG
>TTN-209,ENSE00003807496,1,279,1979925,1980203,AACCTCCTTCTTTCATCAAAACTCTTGAGCCTGCAGACATAGTGAGAGGAACAAATGCTCTACTTCAGTGTGAAGTCTCAGGCACTGGACCATTTGAAATTAGCTGGTTCAAAGACAAGAAACAAATTCGAAGTAGTAAAAAATACAGATTGTTTTCTCAGAAGTCTCTTGTGTGTCTGGAGATCTTTTCGTTTAATAGTGCAGATGTTGGTGAATATGAATGTGTTGTTGCTAATGAAGTCGGCAAGTGTGGCTGCATGGCAACCCACTTACTCAAAG
>TTN-209,ENSE00003806831,1,279,1980204,1980482,AACCTCCAACCTTTGTAAAGAAAGTAGATGATTTGATTGCACTAGGAGGACAAACCGTTACCCTGCAAGCTGCTGTGAGAGGGTCAGAGCCCATTTCTGTCACATGGATGAAAGGTCAAGAGGTCATCAGAGAAGACGGAAAAATCAAAATGAGCTTTTCCAATGGTGTTGCAGTCTTGATAATCCCTGATGTTCAGATTAGTTTTGGAGGCAAATACACGTGCCTGGCTGAAAATGAAGCTGGAAGCCAAACATCTGTTGGGGAATTAATAGTTAAAG
>TTN-209,ENSE00003801788,1,279,1980483,1980761,AACCTGCCAAAATCATTGAGCGAGCAGAACTGATCCAGGTGACAGCAGGAGATCCCGCCACACTGGAGTACACAGTGGCAGGCACGCCAGAACTGAAGCCCAAATGGTACAAAGATGGGAGACCCTTGGTCGCCAGTAAAAAATACCGAATAAGTTTTAAAAACAATGTTGCCCAGCTCAAATTTTATTCAGCTGAGCTGCACGACAGTGGCCAATACACATTTGAGATTTCCAATGAAGTGGGCAGCAGCTCCTGTGAGACTACATTCACTGTATTAG
>TTN-209,ENSE00003804186,1,288,1980762,1981049,ATCGAGACATTGCTCCATTTTTTACCAAACCCTTGCGCAACGTGGATAGTGTTGTTAATGGTACCTGCAGACTGGACTGCAAAATTGCAGGCTCCCTCCCCATGAGGGTGTCCTGGTTTAAGGATGGCAAAGAAATAGCTGCTTCTGACAGATACAGGATAGCATTTGTGGAAGGCACAGCCTCTTTGGAGATCATCAGAGTAGACATGAATGATGCAGGGAATTTCACTTGTCGAGCCACAAATTCCGTGGGAAGCAAAGACAGCAGTGGAGCCCTGATTGTGCAAG
>TTN-209,ENSE00003805178,1,279,1981050,1981328,AACCACCCAGTTTTGTAACTAAACCCGGCTCAAAGGATGTTCTGCCTGGCTCAGCAGTCTGCCTGAAGAGCACTTTCCAAGGATCTACTCCTCTCACAATCAGATGGTTTAAGGGCAACAAAGAGCTGGTTTCTGGTGGAAGCTGCTATATTACCAAAGAAGCTTTAGAGAGTTCCCTGGAACTCTATTTAGTAAAAACCTCTGATTCGGGCACGTACACATGTAAAGTCAGCAATGTCGCTGGAGGGGTGGAATGCAGTGCAAACTTGTTTGTAAAAG
>TTN-209,ENSE00003806856,1,282,1981329,1981610,AACCTGCCACATTTGTTGAAAAGTTAGAGCCATCACAGCTGTTAAAGAAGGGAGATGCCACCCAGCTAGCCTGCAAAGTAACTGGTACCCCTCCAATTAAAATAACATGGTTTGCAAATGATAGAGAAATTAAGGAGAGCAGCAAACACAGAATGTCTTTTGTGGAGTCTACTGCAGTTCTAAGACTGACAGATGTTGGCATCGAAGACAGTGGTGAATATATGTGTGAGGCCCAAAATGAGGCTGGCAGTGACCACTGCAGTAGCATTGTAATAGTCAAAG
>TTN-209,ENSE00003804074,1,279,1981611,1981889,AGTCACCTTATTTTACCAAGGAATTTAAGCCAATTGAAGTCTTAAAGGAGTACGATGTCATGTTGCTGGCTGAGGTGGCAGGCACTCCTCCCTTTGAGATCACTTGGTTCAAAGATAACACAATCCTGCGAAGTGGTAGAAAGTATAAGACTTTCATTCAGGATCATCTGGTTAGCCTGCAGATCCTCAAGTTTGTAGCTGCAGATGCTGGCGAATACCAGTGTCGGGTGACCAATGAGGTGGGCAGCAGCATCTGCAGTGCCAGGGTGACTTTAAGAG
>TTN-209,ENSE00003807057,1,279,1981890,1982168,AACCCCCATCCTTCATAAAGAAGATCGAGAGTACCAGCTCCCTCCGGGGAGGCACAGCTGCCTTCCAGGCCACTCTGAAGGGCTCCTTGCCAATTACGGTGACTTGGCTAAAAGACAGCGATGAAATCACTGAAGACGATAATATAAGAATGACCTTTGAGAACAATGTGGCCAGTTTGTACCTCAGTGGCATTGAAGTCAAGCATGATGGGAAATATGTCTGTCAGGCCAAAAATGATGCAGGAATACAAAGATGTTCTGCATTACTCTCAGTAAAAG
>TTN-209,ENSE00003807032,1,279,1982169,1982447,AACCTGCAACAATCACCGAGGAAGCTGTGTCTATAGATGTCACCCAAGGAGACCCAGCCACTTTGCAGGTTAAATTTTCAGGGACTAAGGAGATTACAGCCAAATGGTTTAAAGATGGCCAAGAACTGACCCTGGGCTCAAAATATAAAATCAGTGTCACTGATACAGTCTCAATACTGAAGATTATTTCTACAGAAAAGAAAGATAGTGGAGAATATACTTTCGAGGTCCAAAATGATGTTGGGAGGAGCAGCTGCAAGGCTAGAATTAATGTATTAG
>TTN-209,ENSE00003810010,1,288,1982448,1982735,ATCTTATCATACCTCCTTCATTCACCAAAAAGCTGAAGAAAATGGACAGCATTAAAGGTTCTTTCATTGATTTAGAATGTATAGTGGCTGGGTCACATCCCATAAGCATCCAGTGGTTCAAAGATGACCAAGAAATATCAGCTAGTGAAAAGTACAAATTCTCTTTTCATGACAATACTGCCTTCTTGGAAATCAGCCAGCTGGAAGGTACAGACAGTGGGACATACACTTGTTCTGCCACAAATAAGGCAGGGCACAACCAATGCAGTGGGCATCTGACAGTCAAAG
>TTN-209,ENSE00003805733,1,279,1982736,1983014,AACCCCCTTACTTTGTGGAAAAGCCACAGTCACAAGATGTCAATCCCAACACAAGGGTACAGTTAAAGGCTCTTGTGGGTGGCACTGCACCCATGACAATAAAGTGGTTTAAAGATAACAAAGAGTTACACTCAGGAGCAGCCCGCTCAGTTTGGAAGGATGACACCTCTACCAGTCTAGAGCTCTTTGCAGCCAAAGCTACCGATTCTGGAACCTACATTTGCCAACTAAGCAATGATGTTGGCACAGCAACCAGCAAAGCCACTCTCTTTGTAAAAG
>TTN-209,ENSE00003805836,1,282,1983015,1983296,AACCTCCTCAATTCATTAAGAAGCCCAGTCCAGTCTTAGTGCTGAGGAATGGACAGTCAACAACATTTGAATGCCAAATAACAGGCACTCCTAAAATCCGAGTGTCTTGGTATCTAGACGGGAATGAAATAACAGCCATTCAGAAACATGGCATTTCCTTCATTGATGGTTTAGCCACTTTCCAGATTTCTGGTGCCAGGGTAGAAAATAGTGGGACTTATGTGTGTGAAGCTCGAAATGACGCAGGCACGGCGAGCTGCAGCATTGAACTCAAAGTGAAAG
>TTN-209,ENSE00003802637,1,279,1983297,1983575,AACCCCCCACCTTTATCAGAGAGCTGAAGCCTGTGGAGGTAGTAAAATATAGTGACGTGGAGCTGGAGTGTGAAGTTACGGGAACACCTCCGTTTGAAGTCACTTGGCTGAAGAATAACAGGGAAATTCGAAGCAGCAAAAAATACACATTGACCGACAGAGTGTCTGTGTTTAACCTCCATATAACCAAGTGTGACCCTTCAGACACTGGGGAATACCAGTGCATTGTATCCAATGAAGGCGGCAGCTGCTCATGCAGTACTAGAGTTGCCCTGAAAG
>TTN-209,ENSE00003809504,1,279,1983576,1983854,AACCACCATCATTCATTAAGAAGATAGAAAATACCACTACTGTTTTGAAAAGTTCTGCCACCTTTCAGAGTACCGTGGCAGGTTCTCCTCCTATTTCTATAACCTGGCTAAAGGATGATCAGATTCTTGATGAAGATGATAATGTCTATATTTCATTTGTGGACAGTGTGGCCACACTTCAAATCAGAAGTGTGGATAATGGACACAGTGGGAGATATACCTGTCAAGCCAAGAATGAGTCAGGAGTTGAGAGGTGTTATGCTTTCCTTTTAGTACAAG
>TTN-209,ENSE00003802968,1,279,1983855,1984133,AACCAGCTCAAATCGTAGAGAAAGCTAAATCAGTTGATGTTACGGAGAAAGATCCCATGACCTTGGAATGTGTTGTGGCTGGAACACCAGAACTCAAAGTGAAATGGCTTAAAGACGGGAAACAAATAGTTCCCAGTAGATACTTTTCAATGAGTTTTGAAAATAACGTGGCCAGTTTTAGAATTCAGTCAGTAATGAAGCAGGACAGCGGTCAGTACACTTTCAAGGTGGAAAATGACTTCGGAAGCAGTAGCTGTGATGCCTACTTAAGAGTGCTAG
>TTN-209,ENSE00003810612,1,288,1984134,1984421,ATCAAAATATTCCTCCATCATTCACCAAAAAATTAACCAAAATGGATAAAGTTCTGGGCTCTTCTATTCATATGGAGTGCAAGGTGTCTGGTTCACTTCCCATTAGTGCTCAGTGGTTTAAGGATGGAAAAGAAATATCTACAAGTGCAAAATACAGACTTGTGTGCCATGAGAGATCTGTGTCTCTGGAAGTTAATAATCTGGAATTAGAAGATACTGCAAATTACACATGCAAAGTGTCAAATGTAGCAGGAGATGATGCATGCAGTGGCATCTTAACTGTGAAAG
>TTN-209,ENSE00003806423,1,279,1984422,1984700,AACCACCAAGCTTCCTAGTGAAACCTGGGCGACAGCAAGCCATACCTGATTCTACAGTGGAATTTAAGGCAATACTAAAAGGAACACCACCATTTAAAATAAAATGGTTTAAGGATGATGTGGAACTTGTCTCAGGTCCTAAATGTTTCATTGGCTTGGAAGGGTCGACTAGCTTCTTAAATCTCTACTCAGTGGATGCTTCTAAGACTGGACAGTATACTTGCCATGTTACCAATGATGTTGGTAGCGACTCTTGTACTACGATGTTGCTTGTGACAG
>TTN-209,ENSE00003805536,1,282,1984701,1984982,AACCACCAAAGTTTGTAAAGAAATTAGAAGCCTCCAAAATTGTGAAAGCAGGTGACTCTTCACGACTTGAATGCAAGATAGCTGGATCCCCAGAAATCAGAGTTGTGTGGTTCCGAAATGAACATGAACTTCCAGCCAGTGATAAGTACAGAATGACTTTCATTGACTCAGTGGCCGTCATACAGATGAACAATCTCAGTACTGAGGACAGTGGAGATTTCATTTGTGAGGCTCAGAATCCCGCTGGCAGCACAAGCTGCAGTACCAAGGTTATAGTAAAAG
>TTN-209,ENSE00003807762,1,279,1984983,1985261,AGCCACCTGTTTTTAGCAGCTTCCCTCCTATAGTAGAAACCCTTAAAAATGCTGAAGTCAGTCTTGAATGTGAACTTTCGGGAACACCACCGTTTGAGGTGGTATGGTACAAAGACAAGCGGCAACTCAGAAGCAGCAAGAAATACAAGATTGCATCCAAAAACTTCCACACAAGTATTCACATTCTCAATGTGGACACTTCAGACATCGGTGAATACCACTGCAAAGCACAGAATGAAGTGGGAAGTGATACTTGTGTTTGTACTGTAAAATTGAAAG
>TTN-209,ENSE00003809887,1,282,1985262,1985543,AACCACCAAGATTTGTCTCCAAACTGAACAGCCTCACTGTTGTAGCCGGAGAGCCTGCTGAATTACAAGCATCCATAGAAGGCGCCCAGCCTATTTTTGTCCAGTGGCTTAAAGAGAAGGAAGAAGTGATTAGAGAAAGTGAAAACATCAGGATTACATTTGTGGAAAATGTTGCAACTCTACAGTTTGCAAAAGCAGAGCCAGCTAATGCTGGAAAGTATATCTGCCAAATCAAGAATGATGGTGGAATGAGGGAGAACATGGCCACACTGATGGTCTTAG
>TTN-209,ENSE00003811356,1,279,1985544,1985822,AGCCCGCAGTCATTGTTGAGAAGGCAGGACCGATGACGGTGACTGTAGGAGAAACGTGCACTCTGGAGTGTAAGGTGGCTGGCACTCCGGAACTCTCTGTTGAATGGTACAAGGATGGAAAGCTGTTGACCAGCAGCCAAAAACACAAATTTAGCTTCTACAACAAAATCTCTTCCTTAAGGATTCTCTCAGTTGAAAGGCAAGATGCAGGCACATACACTTTCCAGGTTCAAAATAATGTTGGGAAAAGCAGCTGCACAGCTGTGGTTGATGTTTCAG
>TTN-209,ENSE00003804298,1,288,1985823,1986110,ACCGAGCAGTTCCTCCCTCTTTCACACGAAGACTGAAAAATACTGGTGGGGTGTTAGGTGCTTCTTGCATCTTGGAATGCAAAGTAGCTGGATCATCACCTATTTCAGTTGCCTGGTTTCATGAGAAAACCAAGATTGTCAGTGGAGCAAAGTACCAAACCACATTTTCAGATAATGTCTGCACATTGCAGTTGAATTCTCTGGATTCCTCAGATATGGGCAATTACACATGCGTGGCTGCTAATGTCGCTGGGTCTGATGAATGTCGTGCAGTGCTAACTGTACAAG
>TTN-209,ENSE00003807700,1,279,1986111,1986389,AACCACCCTCTTTTGTGAAAGAACCTGAACCTTTGGAAGTACTACCAGGCAAAAATGTAACCTTCACAAGCGTTATTAGAGGAACCCCTCCATTCAAAGTCAACTGGTTCAGAGGTGCCAGAGAACTAGTGAAAGGAGACCGGTGCAACATCTATTTTGAAGACACTGTGGCAGAACTGGAATTATTTAATATTGACATATCTCAGAGTGGGGAATACACCTGTGTGGTTTCTAACAACGCTGGCCAAGCATCTTGCACTACCCGTCTCTTTGTGAAAG
>TTN-209,ENSE00003803086,1,279,1986390,1986668,AACCAGCTGCATTTTTGAAGAGATTAAGTGATCATTCTGTAGAACCAGGGAAGTCCATAATTCTGGAGAGCACCTACACTGGAACACTTCCAATTTCTGTCACTTGGAAAAAGGATGGTTTTAACATAACTACCTCTGAAAAATGTAACATAGTCACAACAGAGAAAACTTGTATCCTGGAAATTCTGAATAGCACAAAAAGAGATGCAGGGCAGTATTCCTGCGAGATTGAAAATGAGGCAGGAAGGGATGTTTGTGGAGCTCTGGTATCTACATTAG
>TTN-209,ENSE00003806655,1,279,1986669,1986947,AACCGCCTTATTTTGTTACGGAACTGGAACCTCTGGAGGCAGCAGTTGGAGATTCGGTTTCTTTACAATGCCAAGTTGCTGGGACACCAGAAATTACAGTGTCTTGGTACAAAGGAGATACCAAATTACGGCCAACTCCTGAATACAGGACCTACTTTACAAACAATGTGGCCACACTTGTTTTTAATAAAGTGAACATCAATGACAGTGGAGAGTACACATGCAAAGCAGAAAATAGTATAGGAACTGCTTCTTCTAAGACTGTGTTCAGAATTCAAG
>TTN-209,ENSE00003805355,1,288,1986948,1987235,AGCGCCAACTCCCACCTTCTTTTGCAAGACAATTAAAGGACATTGAACAAACTGTGGGGTTACCTGTTACACTCACTTGTCGATTAAATGGCTCTGCACCCATCCAAGTGTGCTGGTATAGAGATGGAGTACTTTTAAGAGACGATGAAAATCTACAGACTTCATTTGTAGATAATGTGGCAACTTTAAAAATTTTGCAAACTGACTTGAGTCACTCTGGCCAGTACTCTTGCTCAGCTTCCAACCCACTTGGAACAGCATCTTCTAGTGCTAGACTCACAGCAAGAG
>TTN-209,ENSE00003804884,1,288,1987236,1987523,AACCCAAGAAATCTCCCTTCTTTGACATCAAGCCTGTATCTATAGATGTTATTGCTGGAGAAAGTGCTGATTTTGAGTGTCATGTTACTGGTGCTCAACCGATGCGAATCACTTGGTCAAAAGATAACAAGGAGATCCGTCCTGGAGGAAACTATACAATCACATGTGTGGGAAACACTCCTCATTTGAGAATTCTTAAAGTAGGCAAAGGAGACTCTGGTCAATATACTTGCCAAGCAACCAATGATGTTGGCAAAGACATGTGCTCAGCTCAGCTCAGTGTAAAAG
>TTN-209,ENSE00003805805,1,282,1987524,1987805,AACCTCCAAAGTTTGTTAAGAAATTAGAAGCTTCAAAAGTTGCAAAGCAGGGAGAATCCATTCAACTGGAATGTAAAATAAGTGGCTCCCCAGAAATCAAAGTTTCATGGTTCCGAAATGACAGCGAACTTCATGAAAGTTGGAAATACAACATGTCATTCATTAATTCTGTGGCATTGCTTACGATCAATGAAGCTAGTGCTGAAGACAGCGGGGACTACATTTGTGAGGCTCATAATGGTGTTGGTGACGCCAGCTGCAGCACAGCGTTGACAGTGAAAG
>TTN-209,ENSE00003803146,1,279,1987806,1988084,CACCTCCTGTTTTCACCCAGAAGCCTTCTCCAGTAGGAGCTCTTAAAGGTTCTGATGTGATTCTCCAATGTGAAATTTCGGGAACTCCCCCATTTGAAGTAGTATGGGTTAAAGATCGAAAGCAGGTTAGAAACAGCAAGAAATTTAAAATCACTTCAAAACATTTTGATACAAGTCTTCATATCCTTAATCTTGAAGCCTCCGATGTCGGGGAATATCACTGCAAAGCTACTAATGAGGTGGGAAGTGACACGTGTTCTTGCTCTGTCAAGTTCAAAG
>TTN-209,ENSE00003806016,1,282,1988085,1988366,AACCTCCACGATTCGTGAAAAAGCTAAGTGACACCTCAACCCTTATTGGGGATGCTGTTGAGTTACGGGCCATAGTGGAGGGCTTCCAGCCAATTTCTGTTGTCTGGCTGAAAGATAGAGGTGAAGTCATCAGAGAGAGTGAAAATACCAGGATTTCATTCATTGATAACATTGCAACCCTCCAGCTGGGGAGTCCAGAAGCATCTAATTCTGGAAAATATATATGCCAAATCAAAAACGATGCTGGAATGAGAGAATGCTCTGCAGTCTTGACTGTACTAG
>TTN-209,ENSE00003808302,1,279,1988367,1988645,AACCAGCAAGAATCATAGAGAAGCCCGAACCCATGACTGTCACTACTGGAAATCCTTTTGCATTAGAGTGTGTAGTGACTGGAACACCAGAACTCTCAGCCAAGTGGTTCAAAGATGGAAGAGAATTGTCTGCAGACAGCAAACATCACATTACATTCATCAATAAAGTGGCTTCCCTTAAAATCCCCTGTGCCGAAATGAGTGACAAAGGATTATATAGCTTTGAAGTGAAAAACAGTGTTGGCAAAAGTAACTGCACTGTATCCGTCCATGTTTCTG
>TTN-209,ENSE00003802442,1,288,1988646,1988933,ATCGGATTGTGCCTCCTTCCTTCATCCGCAAGCTGAAAGACGTGAATGCCATCCTGGGGGCCTCAGTTGTTTTGGAGTGCCGAGTCTCTGGCTCAGCCCCGATTTCAGTTGGCTGGTTTCAGGATGGAAATGAGATTGTTAGTGGGCCCAAATGTCAGTCCAGCTTTTCGGAAAACGTCTGTACTTTGAATCTGAGCTTGTTGGAGCCCTCCGACACAGGCATATACACGTGTGTGGCTGCCAATGTAGCTGGTTCCGATGAGTGCTCAGCAGTCCTGACTGTGCAAG
>TTN-209,ENSE00003809965,1,279,1988934,1989212,AACCACCATCTTTTGAACAAACCCCTGATTCTGTGGAAGTTTTGCCTGGAATGAGCCTCACATTCACCAGTGTCATCAGAGGCACCCCTCCTTTCAAGGTCAAGTGGTTTAAAGGCAGCAGGGAACTGGTGCCTGGGGAGTCATGCAACATCTCTCTGGAAGATTTTGTCACAGAACTGGAGTTGTTTGAGGTGCAGCCATTAGAAAGTGGAGACTATTCTTGCCTCGTTACAAATGATGCTGGCAGTGCTTCCTGTACCACACATCTTTTTGTGAAAG
>TTN-209,ENSE00003809650,1,279,1989213,1989491,AACCAGCCACCTTTGTGAAAAGATTGGCTGATTTCAGTGTTGAGACAGGAAGCCCCATAGTTCTCGAGGCCACATACACTGGCACACCTCCAATCTCAGTGAGCTGGATAAAGGACGAGTATCTTATTTCACAATCTGAGAGATGCAGTATTACTATGACAGAAAAATCTACCATACTGGAAATTCTTGAGAGCACAATAGAGGATTATGCACAGTACAGCTGCCTGATAGAAAATGAGGCTGGTCAAGATATCTGTGAAGCTCTGGTGTCTGTCTTAG
>TTN-209,ENSE00003810498,1,279,1989492,1989770,AACCACCGTACTTTATTGAACCTCTGGAACATGTGGAAGCAGTCATTGGAGAACCTGCAACTTTACAGTGTAAAGTGGATGGAACTCCAGAAATTAGAATTTCTTGGTATAAAGAACACACAAAGCTACGATCAGCTCCTGCATATAAAATGCAATTCAAAAATAACGTTGCTTCCTTAGTAATCAACAAAGTGGATCACAGTGATGTGGGAGAGTATTCATGCAAGGCAGACAACAGTGTGGGGGCAGTCGCTTCTTCAGCTGTGCTTGTTATCAAAG
>TTN-209,ENSE00003807178,1,288,1989771,1990058,CGCGCAAACTTCCACCTTTCTTTGCAAGAAAACTGAAAGACGTTCATGAGACTCTAGGCTTCCCAGTTGCATTTGAATGCCGCATCAATGGCTCAGAACCTCTTCAAGTGTCTTGGTACAAGGATGGGGTTCTTTTGAAAGATGATGCTAATTTGCAGACATCTTTTGTTCATAATGTAGCAACTCTTCAGATTTTACAAACTGACCAGAGCCACATAGGGCAGTATAATTGCTCTGCTTCTAATCCTCTTGGGACTGCTTCATCCAGTGCCAAGCTCATTCTCTCAG
>TTN-209,ENSE00003808579,1,288,1990059,1990346,AGCATGAAGTGCCTCCTTTCTTTGATCTAAAGCCTGTATCAGTAGATCTTGCTCTTGGAGAAAGTGGTACTTTTAAATGTCATGTAACTGGGACTGCACCAATCAAAATCACTTGGGCCAAAGATAACCGAGAGATTCGCCCTGGAGGCAACTACAAGATGACTTTGGTAGAAAATACTGCCACTCTGACAGTTCTCAAAGTAGGCAAAGGCGATGCCGGGCAGTACACCTGCTATGCAAGCAACATCGCTGGAAAAGACTCTTGTTCTGCTCAGCTGGGTGTACAAG
>TTN-209,ENSE00003801249,1,282,1990347,1990628,AACCACCCAGGTTCATTAAGAAGCTAGAACCTTCAAGAATTGTGAAACAGGATGAATTCACAAGGTATGAATGCAAAATCGGTGGGTCTCCAGAAATCAAAGTTTTATGGTATAAGGACGAGACTGAAATTCAAGAGAGCAGTAAATTCAGAATGTCATTCGTTGACTCGGTGGCTGTGCTGGAAATGCACAATCTCAGTGTTGAAGACAGTGGAGACTACACCTGTGAGGCCCACAATGCAGCAGGCAGTGCCAGCAGCAGCACATCCTTAAAAGTTAAAG
>TTN-209,ENSE00003810208,1,279,1990629,1990907,AACCACCCATTTTCCGCAAAAAGCCTCATCCTATAGAGACACTGAAAGGAGCTGATGTTCACCTTGAATGTGAGCTTCAGGGCACTCCCCCATTTCACGTTTCTTGGTATAAAGACAAGAGAGAACTTAGGAGCGGCAAGAAGTACAAGATAATGTCTGAGAACTTCCTAACCAGTATCCACATCCTGAATGTCGATGCTGCAGACATTGGGGAATATCAGTGTAAAGCCACAAATGATGTGGGAAGCGACACTTGCGTTGGTTCCATCGCTCTCAAAG
>TTN-209,ENSE00003802440,1,282,1990908,1991189,CACCACCAAGATTTGTGAAGAAGCTCAGTGACATATCTACTGTCGTTGGTAAAGAAGTTCAGCTGCAGACTACCATTGAAGGCGCTGAACCCATTTCAGTGGTGTGGTTCAAAGATAAGGGAGAAATCGTTAGAGAAAGTGACAACATATGGATTTCTTATTCAGAAAACATTGCAACCTTACAGTTTTCAAGAGTGGAACCAGCCAATGCTGGAAAATACACTTGTCAGATCAAAAACGATGCTGGGATGCAAGAGTGCTTCGCCACGCTATCCGTTCTCG
>TTN-209,ENSE00003802351,1,279,1991190,1991468,AGCCTGCAACAATTGTAGAAAAGCCAGAATCCATAAAAGTTACCACGGGAGACACCTGTACCTTGGAGTGTACAGTAGCTGGCACCCCTGAACTCAGTACTAAGTGGTTTAAGGATGGAAAAGAGCTAACAAGTGACAACAAATACAAAATAAGCTTCTTCAACAAAGTATCCGGCCTTAAGATCATCAATGTAGCACCGAGTGACAGTGGGGTATACAGTTTTGAGGTGCAGAACCCTGTTGGCAAAGACAGCTGCACAGCTTCATTGCAGGTTTCAG
>TTN-209,ENSE00003807933,1,288,1991469,1991756,ACCGAACCGTTCCTCCTTCATTCACAAGAAAATTGAAAGAGACAAATGGTCTATCCGGCTCCTCAGTTGTAATGGAGTGTAAAGTCTATGGGTCACCTCCAATCTCTGTCTCCTGGTTCCATGAAGGAAATGAGATCAGTAGTGGAAGGAAATACCAGACCACCCTGACAGATAATACTTGTGCTTTAACTGTGAACATGCTGGAAGAATCAGACAGTGGTGACTACACATGTATAGCTACTAATATGGCTGGTTCTGATGAATGTAGTGCTCCTTTGACTGTGAGAG
>TTN-209,ENSE00003804939,1,279,1991757,1992035,AACCACCATCTTTTGTTCAGAAACCTGATCCCATGGATGTTTTAACTGGGACCAATGTAACTTTCACAAGTATCGTAAAAGGAACACCTCCTTTCAGTGTTAGCTGGTTCAAAGGTAGCAGTGAACTAGTACCAGGTGACAGATGCAACGTGTCTTTGGAGGATTCAGTTGCTGAACTGGAGTTGTTCGATGTAGATACATCACAAAGTGGAGAATATACTTGCATAGTTAGCAATGAAGCTGGCAAGGCTTCTTGTACAACACATCTCTACATAAAAG
>TTN-209,ENSE00003810094,1,279,1992036,1992314,CCCCAGCCAAATTTGTGAAGAGGCTGAATGATTACAGCATAGAGAAAGGAAAACCCCTGATCCTAGAGGGTACATTCACTGGAACTCCTCCCATTTCGGTTACCTGGAAGAAAAATGGCATAAATGTAACTCCTTCTCAGAGGTGTAATATAACTACGACTGAAAAATCGGCAATCCTGGAAATTCCAAGTAGCACAGTAGAGGATGCAGGACAATACAACTGCTACATTGAAAATGCCTCTGGAAAAGATTCCTGTTCAGCACAAATACTCATACTAG
>TTN-209,ENSE00003811103,1,279,1992315,1992593,AACCACCGTATTTTGTCAAGCAGTTGGAGCCGGTTAAGGTGTCTGTTGGAGATTCTGCCTCTCTACAATGCCAGCTTGCTGGAACCCCTGAAATTGGGGTATCCTGGTATAAAGGAGATACAAAATTGAGACCCACTACGACTTACAAAATGCATTTTAGGAATAATGTTGCTACACTGGTTTTCAACCAGGTTGATATTAATGATAGTGGAGAATATATCTGCAAAGCTGAAAACAGCGTGGGAGAAGTTTCTGCATCAACTTTCCTTACCGTTCAAG
>TTN-209,ENSE00003801476,1,288,1992594,1992881,AGCAAAAACTTCCACCATCATTTTCTCGACAATTGAGAGATGTTCAAGAAACAGTTGGACTGCCAGTTGTTTTTGATTGTGCCATAAGTGGATCAGAACCTATCTCCGTGTCTTGGTATAAAGACGGCAAGCCATTGAAAGACAGCCCAAATGTACAAACATCATTTTTAGACAATACAGCCACACTCAATATTTTTAAAACTGACCGGAGCCTTGCAGGCCAGTATTCCTGCACAGCTACAAACCCTATAGGCTCTGCTTCTTCCAGTGCCAGGCTCATTCTCACAG
>TTN-209,ENSE00003808430,1,288,1992882,1993169,AGGGGAAGAACCCACCCTTCTTTGACATCCGTCTTGCCCCTGTGGATGCTGTGGTGGGAGAAAGTGCTGACTTTGAGTGCCACGTCACGGGCACACAACCGATAAAGGTCAGCTGGGCCAAAGACAGCAGAGAAATACGAAGTGGCGGAAAGTACCAGATTAGTTATCTGGAAAACAGCGCCCACCTGACAGTCCTCAAAGTAGACAAAGGAGATTCTGGACAATATACCTGCTATGCTGTGAATGAAGTGGGAAAAGACTCTTGCACAGCTCAGCTGAATATAAAAG
>TTN-209,ENSE00003809007,1,291,1993170,1993460,AGCGGCTCATCCCACCAAGTTTCACTAAAAGACTCTCAGAGACAGTAGAAGAAACAGAAGGGAATTCTTTCAAACTTGAGGGACGTGTGGCTGGTTCCCAACCTATAACTGTTGCCTGGTACAAAAATAATATAGAGATACAACCAACTTCTAACTGTGAAATAACATTCAAGAACAACACGTTAGTGCTGCAAGTCAGGAAAGCAGGCATGAACGACGCTGGTTTGTACACATGCAAAGTGTCCAATGATGCAGGCTCTGCTCTGTGCACGTCTTCAATCGTCATCAAAG
>TTN-209,ENSE00003803910,1,288,1993461,1993748,AACCTAAGAAGCCACCTGTATTTGATCAGCACCTTACTCCAGTAACAGTGAGTGAAGGAGAATACGTGCAGCTCAGCTGCCATGTCCAGGGATCTGAGCCAATTAGGATCCAGTGGTTGAAGGCTGGCAGGGAAATAAAGCCTTCAGACAGATGCAGCTTCAGCTTTGCTAGTGGGACAGCTGTACTGGAACTCAGAGATGTGGCTAAAGCAGATTCGGGAGATTATGTGTGTAAAGCTTCAAATGTGGCTGGAAGTGACACTACCAAATCAAAAGTGACCATTAAAG
>TTN-209,ENSE00003804245,1,93,1993749,1993841,ACAAACCAGCTGTGGCCCCAGCAACCAAGAAAGCTGCGGTAGATGGAAGACTCTTTTTTGTGTCAGAACCTCAGAGTATCAGAGTCGTAGAAA
>TTN-209,ENSE00003801649,1,286,1993842,1994127,AAACCACTGCGACCTTCATTGCAAAAGTTGGAGGTGACCCAATCCCAAATGTTAAATGGACAAAAGGGAAGTGGAGACAGCTGAACCAAGGAGGTCGTGTTTTCATCCACCAAAAAGGCGATGAAGCAAAACTGGAGATTAGGGACACCACAAAAACTGATTCTGGGTTATACCGATGCGTGGCATTTAACGAACATGGTGAAATTGAAAGTAATGTTAACTTACAGGTGGATGAAAGGAAGAAACAAGAGAAAATTGAAGGCGATCTTAGAGCAATGCTGAAAAA
>TTN-209,ENSE00003805371,1,184,1994128,1994311,GACTCCAATCTTAAAGAAAGGAGCTGGAGAAGAAGAGGAAATTGATATCATGGAACTTCTCAAAAATGTTGATCCTAAAGAATATGAAAAATATGCCCGCATGTATGGAATCACTGACTTCCGAGGTCTTCTTCAAGCATTTGAACTGCTCAAGCAAAGCCAAGAAGAAGAGACACATAGACTG
>TTN-209,ENSE00003802112,1,90,1994312,1994401,GAAATTGAGGAAATAGAGAGGTCAGAGAGGGACGAAAAGGAATTTGAGGAACTTGTATCATTTATTCAGCAAAGACTGTCACAGACAGAG
>TTN-209,ENSE00003810323,1,268,1994402,1994669,CCTGTCACTCTGATCAAGGACATTGAAAATCAGACAGTTTTGAAAGATAATGATGCTGTCTTTGAAATTGACATTAAAATTAATTATCCAGAAATCAAGCTTTCGTGGTACAAAGGAACTGAAAAACTGGAACCCAGTGATAAATTTGAAATAAGCATTGATGGTGACCGACATACACTCAGAGTCAAAAACTGTCAACTTAAAGACCAGGGCAATTATCGATTGGTTTGTGGTCCACACATCGCTAGCGCTAAACTAACTGTAATTG
>TTN-209,ENSE00003810781,1,261,1994670,1994930,AGCCTGCATGGGAACGGCATCTTCAGGATGTGACTCTGAAAGAAGGCCAGACTTGCACCATGACATGCCAATTTTCTGTACCAAATGTAAAATCTGAATGGTTCAGAAATGGCAGAATCCTTAAACCCCAAGGTAGACATAAAACAGAAGTGGAACACAAAGTCCATAAATTGACCATTGCAGATGTTCGAGCAGAAGACCAGGGTCAGTACACCTGCAAATATGAAGACCTTGAAACTTCAGCAGAACTCAGAATCGAAG
>TTN-209,ENSE00003805599,1,210,1994931,1995140,CTGAACCAATTCAGTTTACAAAGCGCATACAGAACATCGTGGTGAGTGAGCATCAGTCTGCCACCTTTGAGTGTGAAGTGTCCTTTGATGATGCCATTGTAACATGGTACAAAGGACCAACAGAACTGACAGAGAGCCAGAAATACAACTTCAGGAATGATGGCCGCTGCCATTATATGACCATCCACAATGTGACCCCAGACGATGAAG
>TTN-209,ENSE00003809461,1,78,1995141,1995218,GTGTCTACTCGGTCATCGCTCGGCTGGAGCCAAGAGGTGAAGCAAGAAGCACGGCAGAGCTGTACCTAACGACGAAAG
>TTN-209,ENSE00003805821,1,27,1995219,1995245,AAATCAAACTTGAGCTGAAGCCTCCTG
>TTN-209,ENSE00003803485,1,60,1995246,1995305,ATATTCCTGACTCCAGAGTTCCAATCCCAACCATGCCTATCAGAGCAGTGCCACCAGAAG
>TTN-209,ENSE00003803812,1,84,1995306,1995389,AAATCCCTCCTGTGGTTGCTCCTCCTATCCCCCTTTTGCTACCAACACCCGAAGAAAAGAAACCACCACCAAAACGTATTGAAG
>TTN-209,ENSE00003804844,1,72,1995390,1995461,TTACCAAAAAGGCTGTGAAGAAAGATGCCAAAAAAGTTGTTGCAAAGCCCAAAGAGATGACACCACGTGAAG
>TTN-209,ENSE00003810688,1,48,1995462,1995509,AGATTGTCAAGAAGCCTCCACCTCCTACTACCTTAATTCCAGCAAAAG
>TTN-209,ENSE00003806388,1,405,1995510,1995914,CTCCTGAAATCATTGATGTATCCTCTAAAGCTGAAGAAGTAAAAATAATGACTATAACCAGAAAGAAAGAGGTTCAGAAAGAAAAAGAAGCTGTGTATGAGAAAAAGCAAGCAGTCCACAAGGAGAAGAGAGTCTTCATTGAATCTTTCGAAGAACCTTATGACGAACTGGAGGTAGAACCATACACAGAGCCATTTGAACAACCTTATTATGAAGAACCAGATGAAGACTATGAAGAGATTAAGGTAGAAGCTAAAAAAGAAGTTCACGAGGAATGGGAAGAAGATTTTGAAGAAGGGCAAGAATACTATGAAAGGGAAGAAGGCTATGACGAAGGGGAGGAAGAGTGGGAAGAGGCTTACCAAGAAAGGGAAGTAATTCAAGTTCAAAAGGAGGTCTATGAAG
>TTN-209,ENSE00003803093,1,63,1995915,1995977,AATCACATGAGAGAAAAGTTCCAGCCAAAGTACCTGAAAAGAAAGCACCACCACCTCCTAAAG
>TTN-209,ENSE00003802009,1,78,1995978,1996055,TTATAAAGAAGCCAGTAATTGAAAAAATTGAAAAGACTTCTCGAAGAATGGAGGAAGAAAAAGTTCAAGTCACCAAAG
>TTN-209,ENSE00003806356,1,78,1996056,1996133,TACCTGAAGTTTCAAAGAAGATTGTTCCACAAAAACCTTCCCGGACTCCAGTACAGGAAGAAGTTATTGAAGTGAAAG
>TTN-209,ENSE00003803112,1,87,1996134,1996220,TACCAGCTGTGCATACAAAGAAGATGGTTATTTCAGAAGAAAAGATGTTCTTTGCTTCTCACACAGAGGAGGAGGTGTCAGTCACAG
>TTN-209,ENSE00003811115,1,81,1996221,1996301,TCCCCGAGGTACAAAAGGAAATTGTTACTGAAGAGAAAATTCACGTTGCCATTTCCAAAAGGGTTGAACCACCACCTAAAG
>TTN-209,ENSE00003810048,1,84,1996302,1996385,TCCCTGAGCTACCTGAGAAACCAGCTCCAGAAGAAGTGGCCCCTGTTCCTATCCCTAAAAAAGTGGAGCCCCCAGCACCAAAAG
>TTN-209,ENSE00003809302,1,84,1996386,1996469,TTCCTGAGGTTCCCAAGAAACCCGTGCCAGAGGAGAAAAAGCCAGTTCCTGTGCCTAAGAAGGAACCTGCTGCTCCCCCAAAAG
>TTN-209,ENSE00003811271,1,84,1996470,1996553,TCCCAGAGGTGCCAAAGAAACCTGTCCCTGAAGAAAAGATTCCCGTTCCTGTTGCAAAGAAAAAGGAAGCTCCCCCAGCTAAAG
>TTN-209,ENSE00003811169,1,81,1996554,1996634,TTCCTGAAGTACAGAAGGGAGTTGTGACAGAAGAAAAAATAACCATTGTAACTCAAAGAGAGGAATCTCCACCACCAGCAG
>TTN-209,ENSE00003802187,1,84,1996635,1996718,TGCCAGAAATACCAAAGAAGAAAGTTCCTGAAGAAAGGAAACCTGTTCCTCGGAAGGAGGAAGAAGTTCCACCACCACCAAAAG
>TTN-209,ENSE00003810484,1,84,1996719,1996802,TGCCAGCTCTGCCTAAGAAACCCGTCCCAGAGGAGAAAGTTGCAGTGCCAGTTCCTGTCGCTAAGAAAGCTCCTCCTCCCCGAG
>TTN-209,ENSE00003810121,1,102,1996803,1996904,CTGAAGTCTCTAAGAAAACTGTTGTAGAAGAAAAGAGATTTGTTGCTGAAGAAAAACTATCCTTCGCAGTTCCTCAAAGAGTGGAAGTCACGCGGCACGAAG
>TTN-209,ENSE00003805410,1,114,1996905,1997018,TATCTGCAGAGGAGGAATGGAGTTACTCAGAAGAGGAGGAAGGTGTGTCCATTTCAGTTTATAGAGAAGAAGAAAGAGAGGAGGAGGAAGAAGCAGAGGTTACAGAATATGAAG
>TTN-209,ENSE00003801264,1,81,1997019,1997099,TGATGGAAGAGCCTGAGGAATATGTTGTGGAAGAAAAGCTGCACATTATTTCTAAGAGAGTGGAAGCTGAGCCAGCTGAAG
>TTN-209,ENSE00003805756,1,78,1997100,1997177,TGACAGAGAGGCAGGAGAAGAAAATTGTACTGAAACCAAAAATTCCTGCTAAAATAGAGGAGCCTCCACCGGCTAAAG
>TTN-209,ENSE00003808334,1,84,1997178,1997261,TTCCTGAAGCACCTAAGAAAATTGTGCCAGAAAAGAAAGTTCCTGCTCCAGTTCCTAAAAAGGAAAAGGTGCCCCCACCTAAAG
>TTN-209,ENSE00003808052,1,84,1997262,1997345,TGCCAGAAGAGCCAAAGAAACCAGTTCCAGAAAAAAAGGTTCCTCCAAAAGTCATTAAGATGGAAGAACCTCTCCCAGCCAAAG
>TTN-209,ENSE00003803067,1,84,1997346,1997429,TGACTGAGAGGCACATGCAAATTACCCAGGAAGAAAAAGTTCTTGTTGCTGTAACTAAAAAAGAGGCGCCTCCAAAAGCAAGAG
>TTN-209,ENSE00003808806,1,84,1997430,1997513,TGCCAGAGGAACCGAAGAGAGCTGTCCCAGAAGAAAAAGTTCTGAAACTCAAACCTAAAAGAGAGGAGGAACCACCAGCTAAAG
>TTN-209,ENSE00003805330,1,81,1997514,1997594,TGACTGAATTCAGAAAAAGAGTGGTTAAAGAAGAAAAAGTATCAATTGAAGCTCCAAAAAGAGAACCTCAACCCATCAAAG
>TTN-209,ENSE00003807878,1,207,1997595,1997801,AAGTAACTATAATGGAAGAGAAAGAAAGGGCTTATACCCTAGAAGAAGAAGCTGTTTCAGTACAACGGGAAGAAGAATATGAGGAATATGAAGAATATGATTATAAAGAATTTGAGGAGTATGAACCAACAGAAGAATATGACCAATATGAAGAATACGAGGAGCGGGAGTATGAACGATATGAAGAGCATGAAGAATACATCACAG
>TTN-209,ENSE00003806244,1,78,1997802,1997879,AACCAGAGAAGCCTATCCCTGTAAAGCCTGTCCCAGAAGAACCAGTTCCCACAAAACCAAAGGCCCCACCGGCTAAAG
>TTN-209,ENSE00003810594,1,75,1997880,1997954,TGCTGAAGAAAGCTGTCCCTGAAGAAAAAGTACCAGTGCCCATTCCTAAGAAACTCAAACCTCCACCACCCAAAG
>TTN-209,ENSE00003809388,1,93,1997955,1998047,TGCCTGAAGAACCAAAGAAAGTTTTTGAGGAAAAAATACGTATTTCAATTACCAAACGTGAAAAAGAGCAGGTGACTGAACCCGCTGCTAAAG
>TTN-209,ENSE00003807405,1,78,1998048,1998125,TGCCCATGAAGCCCAAGAGGGTTGTCGCAGAAGAAAAAGTACCTGTCCCTAGAAAAGAAGTAGCACCACCTGTTAGAG
>TTN-209,ENSE00003810081,1,162,1998126,1998287,TGCCAGAAGTGCCTAAAGAACTTGAACCAGAAGAGGTTGCCTTTGAAGAGGAAGTTGTAACCCATGTAGAAGAATATCTTGTAGAAGAAGAAGAAGAGTACATTCATGAAGAAGAGGAGTTCATAACTGAGGAAGAAGTGGTGCCAGTGATACCAGTCAAAG
>TTN-209,ENSE00003806496,1,84,1998288,1998371,TGCCTGAGGTACCCAGGAAACCTGTTCCAGAAGAGAAGAAACCTGTTCCTGTTCCCAAGAAGAAGGAAGCTCCACCGGCAAAAG
>TTN-209,ENSE00003802498,1,78,1998372,1998449,TGCCTGAGGTTCCTAAGAAGCCAGAGGAGAAAGTTCCTGTGCTTATTCCTAAAAAGGAGAAGCCTCCGCCAGCAAAAG
>TTN-209,ENSE00003809653,1,84,1998450,1998533,TTCCTGAAGTGCCCAAGAAACCTGTGCCAGAGGAGAAAGTACCAGTACCAGTTCCTAAAAAGGTGGAAGCTCCACCTGCCAAAG
>TTN-209,ENSE00003810862,1,84,1998534,1998617,TGCCAGAGGTACCCAAGAAGCCTGTGCCTGAGAAGAAGGTGCCAGTTCCTGCTCCTAAGAAAGTGGAGGCTCCACCTGCAAAAG
>TTN-209,ENSE00003805059,1,84,1998618,1998701,TGCCAGAGGTGCCCAAGAAGCTCATCCCAGAAGAAAAGAAACCAACACCTGTTCCGAAAAAAGTGGAAGCACCACCACCCAAAG
>TTN-209,ENSE00003801382,1,297,1998702,1998998,TGCCAAAGAAACGTGAACCAGTTCCAGTTCCTGTAGCTCTACCTCAGGAAGAGGAAGTTCTATTTGAAGAAGAAATTGTTCCTGAAGAGGAAGTTCTACCTGAGGAAGAGGAAGTTCTACCTGAGGAAGAGGAAGTTCTACCTGAAGAAGAGGAAGTTCTACCTGAAGAAGAGGAAATTCCACCTGAGGAAGAGGAAGTTCCTCCCGAAGAAGAATATGTACCTGAGGAAGAAGAATTTGTACCTGAAGAAGAAGTCCTTCCAGAAGTTAAACCTAAGGTGCCAGTACCTGCACCAG
>TTN-209,ENSE00004025982,1,87,1998999,1999085,TGCCTGAAGTGCCAAAGAAACCTGTACCAGAGAAGAAAGTCCCTGTTCCCGCCCCTAAAAAAGTGGAACCTCCACCACCACCCAAAG
>TTN-209,ENSE00003805240,1,75,1999086,1999160,TGCCTGAAATTAAGAAGAAAGTGACAGAGAAGAAAGTGGTCATTCCCAAGAAAGAGGAGGCTCCCCCTGCCAAAG
>TTN-209,ENSE00004025997,1,84,1999161,1999244,TGTCTGTGGTACCTAAGAAACCTGAGCCAGAAAAGAAGGTCCCTCCTCCTGGTCTTAAGAAAGCAGTGGCCCCTCCTGCCAAAG
>TTN-209,ENSE00003804875,1,75,1999245,1999319,TTCCTGAGGTGCCTAAGAAGGTGGAAGAAAAACGAATCATTCTCCCTAAAGAAGAGGAAGTTCTACCAGTTGAAG
>TTN-209,ENSE00003801552,1,96,1999320,1999415,TGACTGAGGAGCCTGAAGAAGAGCCTATTTCAGAAGAAGAAATCCCAGAAGAACCACCTAGCATAGAGGAAGTTGAAGAGGTGGCACCACCTAGAG
>TTN-209,ENSE00003804385,1,78,1999416,1999493,TGCCTGAAGTGATTAAGAAAGCAGTACCTGAAGCACCTACTCCTGTTCCTAAAAAAGTGGAGGCACCACCAGCTAAAG
>TTN-209,ENSE00003805135,1,69,1999494,1999562,TGTCAAAGAAAATTCCTGAGGAAAAAGTACCTGTTCCTGTTCAGAAAAAAGAGGCACCCCCAGCCAAAG
>TTN-209,ENSE00003808243,1,75,1999563,1999637,TGCCTGAAGTACCAAAGAAAGTCCCAGAAAAGAAAGTCCTTGTGCCTAAAAAGGAAGCTGTTCCCCCAGCTAAAG
>TTN-209,ENSE00003808353,1,297,1999638,1999934,GGAGAACTGTCCTTGAAGAAAAAGTATCAGTTGCCTTCCGCCAAGAAGTAGTAGTAAAAGAAAGACTAGAATTAGAAGTAGTAGAAGCAGAAGTGGAAGAAATTCCGGAAGAAGAAGAGTTCCATGAAGTTGAAGAATATTTTGAAGAAGGCGAGTTTCATGAAGTAGAAGAATTCATCAAATTAGAACAACATAGAGTTGAAGAAGAACACAGAGTTGAAAAAGTTCATAGGGTAATAGAAGTTTTTGAGGCTGAAGAAGTGGAAGTATTTGAAAAACCAAAAGCTCCACCTAAAG
>TTN-209,ENSE00003807571,1,81,1999935,2000015,GGCCTGAGATATCTGAGAAAATCATCCCTCCAAAAAAACCGCCCACTAAAGTTGTTCCTCGAAAAGAGCCACCAGCTAAAG
>TTN-209,ENSE00003808118,1,78,2000016,2000093,TACCGGAGGTGCCTAAGAAAATTGTGGTAGAAGAAAAAGTACGTGTTCCTGAAGAGCCCAGAGTTCCACCAACTAAAG
>TTN-209,ENSE00004025978,1,84,2000094,2000177,CACCCGAAGTACCCAAGAAAATTGTCCCAGAAGAAAAAGTTCGTGAAGCTGTTCTGAAAAAGCCTGAAGTTCCACCAGCTAAAG
>TTN-209,ENSE00004026002,1,75,2000178,2000252,TTCCTGGGATGCCTAAGAAAAGTGTTCAAGAAGAAAAATCACCTATTGTTATTTCTGAAGACACAGAGATGTACA
>TTN-209,ENSE00004025998,1,84,2000253,2000336,TTTATGAAGCATCTGAAGAAGCAGTCCTAGAAGAAAAAGTACTTGTGACTCAACCTCAAAAGACAAAACCCAAACTAGCAAAAG
>TTN-209,ENSE00004025971,1,84,2000337,2000420,TGCCTGAGCCACCCAAGAAAGTTGTTCCAGAAGACAAAATATATGTGACTATTCCTAAAAAGAGAGAAACACCAGCAACTAAAG
>TTN-209,ENSE00001725280,1,84,2000421,2000504,AACCTGATACAACCAGAGGCATTTTTCCAGAGGTGGAGCCACCTGAGGCTATTCCTGAAATTCCAGAACATCCTCCAACTGAAG
>TTN-209,ENSE00004024308,1,78,2000505,2000582,AGTTTGAAGTCTTCAAGGAAGTCATTCCAGAGGGAGAAACTCCTATTGTTAAAAGAAGAAAAACACCATCACCAACAG
>TTN-209,ENSE00004025995,1,84,2000583,2000666,TGCCTGAATCACCTCGAGAAATTGTCCCTGTAAAGGAAACACCCATGGCTGCTCCCCTTGAAATTGAAATACCTCCCACTAAAG
>TTN-209,ENSE00004024272,1,84,2000667,2000750,CACCAGAAGCTATGAAAGAAGTTGTCCCTGAAATGAAAATATTTGAGGATGTACCTGAAGAGCCAGAAACTCCACGTATGAAAA
>TTN-209,ENSE00004024280,1,75,2000751,2000825,CGCCCGAAGCTCCTCAAGAAATTATTCCTGCCAAGACAGTTCCTTCCAAAAAAAGAGAACCCCCATCAGTTAAAG
>TTN-209,ENSE00004024279,1,84,2000826,2000909,TGCCTGAAGCTCTCCAAGAAATTGTCCCTGAAAAGAAAACGCTTGTGGTTCCTCTCAGAAAGCCTGAAGTCCTTCCTGATGAAG
>TTN-209,ENSE00004024286,1,78,2000910,2000987,TGCCGGAGGCTCTCAGAGAAGTTGTCCCGGAAAAGAAAGTGCATCCTCCCCAAAGGGCTGAAGTTGTACCTGTCAAAG
>TTN-209,ENSE00004024310,1,84,2000988,2001071,TGCACGAAGCTCCCAAAGAGATTATCCCTGAAAAGAAAGTGTCGGTGGTGCCTCCTAAAAAGCCTGAAGTCCCACCTGTTAAAG
>TTN-209,ENSE00004024305,1,84,2001072,2001155,TGCCAGAAGCTTCCAAAGAGGTTATCCGCGAAGAGAAAGTGCCCTTGGCTCCTCCTAAAGAGCCTGAAGTCCCACCTGTTAAAG
>TTN-209,ENSE00004024294,1,84,2001156,2001239,TACCAGAGCCTCCCAAAGAAGTAGTTCCTGAAAAGAAAGCGCCAGTGGCTCCTCCTAAAGAGCCTGAAGTCCCACCTGTTAAAG
>TTN-209,ENSE00004025974,1,84,2001240,2001323,TGCCTGAGGCTCCCAAAGAAGTTGTTCCTGAAAAGAAAGTGCCAGTGCCTCCTCCTAAAAAGCCTGAAGTGCCACCCACAAAAG
>TTN-209,ENSE00004025967,1,84,2001324,2001407,TCCCAGAGGTGCCAAAGGCAGCTGTCCCAGAAAAGAAGTTGCCTGAAGCTATTCCTCCCAAACCGGAAAGTCCTCCCCCTGAAG
>TTN-209,ENSE00003807304,1,90,2001408,2001497,TGCCTGAAGTGCTGCCACCGAAGGAAGTGGTCCCAGAAAAGAAAGTACCGGTGCCTCCTGCCAAAAAGCCAGAAGCTCCACCTCCTAAAG
>TTN-209,ENSE00004026001,1,84,2001498,2001581,TTCCTGAAGCTCCTAAAGAAGTTGTACTTGAAAAGAAAGCATCTGTGGCTGTGCCCAAAAAACCGGAAGCCCCACGTGCAAAAG
>TTN-209,ENSE00004025988,1,84,2001582,2001665,TGCCTGAAGCTGCTCAAGAAGTTGTCCCAGAAAAGAAAATTCCCAAGGCACCAATCAAAAAACCAGAAGCCCCCGCAGTTACAG
>TTN-209,ENSE00004025983,1,81,2001666,2001746,TGCCAGAAGTTCCTCAAGAAGCCACAGAAAAAGAAATTCCCGTGGCTCCACCCAAAAAACCAGAAGCTCCAATTGTCCCAG
>TTN-209,ENSE00004025976,1,81,2001747,2001827,TGCCTGAAGCTCAAGAAGTTGTCCCAGAAAAGAAAGTTCCTAAGGCTCCTCCCACAAAACCAGAAGCCCCACCTGCCACAG
>TTN-209,ENSE00004025986,1,81,2001828,2001908,TGCCTGAAGTCCCACAAGAAATTGTGCCAGAAAAGAAAACACTGGTGCTTCCTAAAAAGCCAGAAGTTCCACCTGTTACAG
>TTN-209,ENSE00004025969,1,84,2001909,2001992,TGCCAGAGGCTCCCAAAGAAGTTGTCCTTGAAAAGAAAGTGCCCTCGGCTCCTCCTAAAAAGCCTGAAGTCCCACCTGTTAAAG
>TTN-209,ENSE00003802745,1,84,2001993,2002076,TGCCTGAGGCTCCCAAAGAAGTTGTTCCTGAAAAGAAAGTGCCAGTGCCTCCTCCTAAAAAGCCTGAAGTGCCACCCACAAAAG
>TTN-209,ENSE00003809569,1,84,2002077,2002160,TCCCAGAGGTGCCAAAGGCAGCTGTCCCAGAAAAGAAGGTGCCTGAAGCTATTCCTCCCAAACCGGAAAGTCCTCCCCCTGAAG
>TTN-209,ENSE00004025984,1,90,2002161,2002250,TGCCTGAAGTGCTGCCACCGAAGGAAGTGGTCCCAGAAAAGAAAGTACCGGTGCCTCCTGCCAAAAAGCCAGAAGCTCCACCTCCTAAAG
>TTN-209,ENSE00004026000,1,84,2002251,2002334,TTCCTGAAGCTCCTAAAGAAGTTGTACTTGAAAAGAAAGCATCTGTGGCTGTGCCCAAAAAACCGGAAGCCCCACGTGCAAAAG
>TTN-209,ENSE00004025966,1,84,2002335,2002418,TGCCTGAAGCTGCTCAAGAAGTTGTCCCAGAAAAGAAAATTCCCAAGGCACCAATCAAAAAACCAGAAGCCCCCGCAGTTACAG
>TTN-209,ENSE00004025973,1,81,2002419,2002499,TGCCAGAAGTTCCTCAAGAAGCCGCAGAAAAAGAAATTCCCGTGGCTCCACCCAAAAAACCAGAAGCTCCGATTGTCCCAG
>TTN-209,ENSE00004025979,1,81,2002500,2002580,TGCCTGAAGCTCAAGAAGTTGTCCCAGAAAAGAAAGTTCCTAAGGCTCCTCCCACAAAACCAGAAGCCCCACCTGCCACAG
>TTN-209,ENSE00004025981,1,81,2002581,2002661,TGCCTGAAGTCCCACAAGAAATTGTGCCAGAAAAGAAAACACTGGTGCTTCCTAAAAAGCCAGAAGTTCCACCTGTTACAG
>TTN-209,ENSE00004025970,1,84,2002662,2002745,TGCCAGAGGCTCCCAAAGAAGTTGTCCTTGAAAAGAAAGTGCCCTCGACTCCTCCTAAAAAGCCTGAAGTCCCACCTGTTAAAG
>TTN-209,ENSE00004025993,1,84,2002746,2002829,TGCCTGAGGCTCCCAAAGAAGTTGTTCCTGAAAAGAAAGTGCCAGTGCCTCCTCCTAAAAAGCCTGAAGTGCCACCCACAAAAG
>TTN-209,ENSE00004025989,1,84,2002830,2002913,TCCCAGAGGTGCCAAAGGCAGCTGTCCCAGAAAAGAAGGTGCCTGAAGCTATTCCTCCCAAACCGGAAAGTCCTCCCCCTGAAG
>TTN-209,ENSE00004025987,1,90,2002914,2003003,TGCCTGAAGTGCTGCCACCGAAGGAAGTGGTCCCAGAAAAGAAAGTACCGGTGCCTCCTGCCAAAAAGCCAGAAGCTCCACCTCCTAAAG
>TTN-209,ENSE00004025975,1,84,2003004,2003087,TTCCTGAAGCTCCTAAAGAAGTTGTACTTGAAAAGAAAGTATCTGTGGCTGTGCCCAAAAAACCGGAAGCCCCACGTGCAAAAG
>TTN-209,ENSE00004026003,1,84,2003088,2003171,TGCCTGAAGCTGCTCAAGAAGTTGTCCCAGAAAAGAAAATTCCCAAGGCACCAATCAAAAAACCAGAAGCCCCCGCAGTTACAG
>TTN-209,ENSE00004025980,1,81,2003172,2003252,TGCCAGAAGTTCCTCAAGAAGCCGCAGAAAAAGAAATTCCCGTGGCTCCACCCAAAAAACCAGAAGCTCCAATTGTCCCAG
>TTN-209,ENSE00004025994,1,81,2003253,2003333,TGCCTGAAGCTCAAGAAGTTGTCCCAGAAAAGAAAGTTCCTAAGGCTCCTCCCACAAAACCAGAAGCCCCACCTGCCACAG
>TTN-209,ENSE00004025996,1,81,2003334,2003414,TGCCTGAAGTCCCACAAGAAATTGTGCCAGAAAAGAAAACACTGGTGCTTCCTAAAAAGCCAGAAGTTCCACCTGTTACAG
>TTN-209,ENSE00004025990,1,84,2003415,2003498,TGCCAGAGGCTCCCAAAGAAGTTGTCCTTGAAAAGAAAGTGCCCTTGGCTCCTCCTAAAAAGCCTGAAGTCCCACCTGTTAAAG
>TTN-209,ENSE00004026004,1,84,2003499,2003582,TGCCAGAGGCTCCCAAAGAAGTTGTTCCTGAAAAGAAAGTGCCAGTGACTCCTCCTAAAAAACCTGAAGTCCCACCTGTTAAAG
>TTN-209,ENSE00004025977,1,84,2003583,2003666,TGCCAGAGGCTCCCATAGAGGTTGTTCCTGAAAAGAAAATGCCCTTGGCTCCTCCTAAAAAGCCTGAAGTCCCTCCTGTTAAAG
>TTN-209,ENSE00004025991,1,84,2003667,2003750,TACCAGAGGCTCCCAAAGAGGTTGTTCCTGAAAAGAAAGTGCCCTCGGCTCCTCCTAAAAAGCCTGAAGTCCCACCTGTTAAAG
>TTN-209,ENSE00003806373,1,84,2003751,2003834,TGCCAGAGGCTCCGAAAGAAGTTGTTCCTGAAAAGAAAGTGCCAGCGGCTCCTCCTAAAAAGCCTGAAGTCACACCTGTTAAAG
>TTN-209,ENSE00003807489,1,84,2003835,2003918,TGCCTGAGGCTCCCAAAGAAGTTGTTCCTGAAAAGAAAGTGCCAGTGCCTCCTCCTAAAAAGCCTGAAGTGCCACCCACAAAAG
>TTN-209,ENSE00003805050,1,84,2003919,2004002,TCCCAGAGGTGCCAAAGGTAGCTGTCCCAGAAAAGAAGGTGCCTGAAGCTATTCCTCCCAAACCGGAAAGTCCTCCCCCTGAAG
>TTN-209,ENSE00003808824,1,84,2004003,2004086,TGTTCGAGGAGCCTGAGGAAGTTGCCCTAGAAGAGCCTCCTGCTGAAGTTGTGGAAGAGCCAGAGCCAGCGGCGCCTCCACAAG
>TTN-209,ENSE00003807203,1,84,2004087,2004170,TGACCGTACCACCTAAGAAACCTGTCCCAGAAAAGAAAGCACCTGCTGTCGTTGCCAAAAAACCTGAACTACCACCAGTGAAAG
>TTN-209,ENSE00003811260,1,84,2004171,2004254,TGCCCGAGGTGCCCAAGGAGGTTGTTCCTGAAAAGAAGGTGCCTCTGGTGGTTCCCAAAAAGCCAGAAGCCCCACCTGCTAAAG
>TTN-209,ENSE00003806229,1,78,2004255,2004332,TGCCTGAAGTTCCAAAAGAAGTTGTTCCAGAAAAGAAAGTAGCTGTTCCCAAAAAGCCAGAAGTCCCACCAGCAAAAG
>TTN-209,ENSE00003807893,1,84,2004333,2004416,TGCCAGAAGTGCCAAAGAAACCTGTCTTGGAAGAGAAACCAGCTGTTCCTGTTCCAGAAAGAGCGGAGTCTCCTCCCCCAGAAG
>TTN-209,ENSE00003809515,1,108,2004417,2004524,TATATGAAGAACCTGAGGAAATTGCTCCTGAAGAGGAAATTGCTCCTGAAGAGGAAAAGCCAGTTCCTGTTGCAGAAGAGGAGGAACCAGAGGTTCCACCTCCAGCAG
>TTN-209,ENSE00003804845,1,78,2004525,2004602,TGCCTGAAGAGCCCAAGAAGATCATCCCAGAGAAGAAAGTTCCTGTCATCAAAAAACCAGAAGCACCGCCTCCTAAAG
>TTN-209,ENSE00004025992,1,78,2004603,2004680,AACCTGAGATGCCAAAGAAAGTTGTTCCAGTGAAGAAGGTCCCAACTGTTAAGAAGCCAGAAACACCAGCAGCTAAAG
>TTN-209,ENSE00004025972,1,84,2004681,2004764,TGCCTGAGGTGCCCAAGAAACTTGTTCCAGTAAAGAAAGAACCTGTGCCTGTTACCAAAAAACCAGAAGTTCTTCCAGAAAAAG
>TTN-209,ENSE00004025968,1,84,2004765,2004848,TGCCCAAAGTGCCTGAGAAAATCATCCCAGAAAAGGAAGTGTCTGTGCCTATCCCTGCAGAGCCAGAAGTTCCACCTGCTGAAG
>TTN-209,ENSE00004025985,1,81,2004849,2004929,TTGAAGAGACTCCTGAGGAAATAATATATGAAGAAAAAGCATCTATAACCATTGGTAGAAAAGAGACTCCCCCTGTTGAAG
>TTN-209,ENSE00004025999,1,75,2004930,2005004,AACGTGAAATTGAAAAGTATATTAAACCTGAAGAGCCCGAACCTGAACCACAGCCTGAAGAAATACCAGTAAAAG
>TTN-209,ENSE00003806702,1,111,2005005,2005115,AACCTGAACCTGAAAAGGTTATTGAGAAGCCAAAACTCAAACCAAGACCCCCACCTCCTCCACCTGCTCCACCTAAGGAAGATGTGAAGGAGAAAATATTCCAACTTAAAG
>TTN-209,ENSE00003809179,1,69,2005116,2005184,CTATTCCAAAGAAGAAAGTTCCTGAAAAACCTCAGGTTCCAGAAAAAGTGGAGCTTACACCTCTGAAAG
>TTN-209,ENSE00003807205,1,90,2005185,2005274,TACCAGAACCACCACCTCCAAAACCTGTTGAAGAGGTTGAAGTACCTACTGTTACAAAAAGGGAAAGGAAGATTCCTGAACCAACAAAAG
>TTN-209,ENSE00003806747,1,63,2005275,2005337,TGCCTGAAATCAAGCCAGCAATACCTCTCCCTGCACCTGAACCGAAACCAAAGCCCGAAGCAG
>TTN-209,ENSE00003810755,1,90,2005338,2005427,AAGTGAAAACAATCAAACCACCTCCTGTGGAACCTGAACCAACCCCCATCGCTGCCCCAGTAACAGTGCCAGTGGTTGGAAAGAAAGCAG
>TTN-209,ENSE00003806122,1,51,2005428,2005478,AAGCCAAAGCACCTAAGGAAGAGGCTGCCAAGCCAAAAGGTCCTATCAAAG
>TTN-209,ENSE00003804858,1,402,2005479,2005880,GTGTACCCAAAAAGACTCCTTCACCAATAGAAGCCGAAAGGAGAAAGTTAAGGCCAGGAAGTGGTGGAGAGAAACCTCCTGATGAAGCCCCGTTCACCTACCAGCTAAAGGCTGTGCCACTGAAGTTTGTGAAAGAAATCAAAGACATCATCTTGACAGAATCAGAGTTCGTTGGCTCTTCAGCAATCTTTGAATGTTTGGTCTCCCCTTCCACTGCAATTACAACCTGGATGAAAGACGGTAGCAATATCCGTGAGAGTCCCAAGCACAGGTTTATTGCAGATGGTAAAGACAGAAAGCTGCACATCATTGATGTTCAACTTTCCGATGCTGGTGAATACACCTGTGTTTTACGTTTGGGAAACAAAGAAAAGACCTCCACGGCTAAACTTGTTGTAGAAG
>TTN-209,ENSE00003803996,1,279,2005881,2006159,AACTTCCTGTGCGTTTTGTAAAAACACTGGAAGAGGAAGTCACAGTGGTCAAAGGACAGCCATTGTACTTGAGCTGCGAGTTAAACAAAGAGCGTGACGTGGTCTGGAGGAAGGATGGCAAGATTGTGGTGGAGAAACCTGGCCGAATTGTGCCAGGCGTCATTGGCTTGATGCGGGCTCTGACCATCAACGATGCAGATGACACAGATGCTGGAACATACACAGTTACTGTGGAAAACGCCAACAACCTGGAGTGTTCATCTTGCGTAAAAGTAGTAG
>TTN-209,ENSE00003807976,1,276,2006160,2006435,AAGTCATTAGAGATTGGCTGGTGAAACCTATACGAGACCAGCATGTGAAACCCAAGGGGACAGCTATTTTTGCCTGTGATATAGCAAAAGATACTCCAAACATTAAGTGGTTCAAAGGATATGATGAAATCCCTGCGGAACCAAATGATAAGACTGAAATACTGAGAGATGGAAATCATCTGTACCTCAAAATTAAGAATGCTATGCCAGAAGATATTGCTGAGTATGCAGTGGAAATTGAAGGAAAAAGATACCCTGCAAAGCTGACACTTGGAG
>TTN-209,ENSE00003804328,1,140,2006436,2006575,AGCGTGAAGTTGAACTGCTTAAACCAATAGAGGACGTTACCATTTATGAGAAAGAAAGTGCAAGCTTTGATGCAGAAATCTCAGAGGCAGACATTCCTGGACAATGGAAACTGAAAGGAGAACTTCTAAGGCCCTCACCT
>TTN-209,ENSE00003802254,1,127,2006576,2006702,ACTTGTGAAATCAAAGCAGAAGGTGGAAAACGCTTCTTAACTTTGCACAAAGTCAAACTGGACCAAGCTGGTGAAGTCCTCTACCAGGCCCTTAATGCAATTACAACTGCCATTTTGACAGTAAAAG
>TTN-209,ENSE00003811410,1,264,2006703,2006966,AAATCGAACTTGACTTTGCTGTGCCCCTGAAGGATGTCACTGTTCCAGAAAGGCGACAGGCTCGATTCGAATGTGTCCTCACCCGAGAGGCAAATGTTATATGGTCCAAAGGACCTGATATAATTAAGTCATCTGACAAATTTGATATCATCGCTGATGGAAAGAAACATATTCTTGTTATTAATGATTCTCAATTTGATGATGAAGGGGTCTATACTGCTGAGGTGGAGGGCAAGAAGACCTCAGCTCGGTTGTTTGTCACAG
>TTN-209,ENSE00003805150,1,267,2006967,2007233,GTATAAGACTGAAATTCATGTCACCTCTTGAAGATCAAACAGTAAAAGAAGGTGAAACAGCAACTTTTGTTTGTGAACTTTCTCATGAAAAAATGCATGTAGTCTGGTTCAAAAATGATGCCAAACTCCATACAAGCAGAACAGTACTCATCTCTTCTGAGGGCAAGACTCACAAATTGGAAATGAAAGAAGTGACATTGGATGATATATCTCAGATAAAAGCTCAAGTCAAGGAGCTGAGCTCCACAGCACAGCTGAAGGTCTTAG
>TTN-209,ENSE00003801907,1,264,2007234,2007497,AGGCCGATCCCTACTTCACTGTGAAATTACATGACAAAACTGCAGTGGAGAAGGATGAGATTACTTTGAAGTGTGAAGTGAGCAAAGATGTACCAGTGAAATGGTTCAAAGATGGTGAAGAGATTGTCCCTTCACCCAAATATTCTATCAAGGCAGATGGCCTGCGCCGCATCTTAAAAATCAAAAAGGCGGACCTTAAAGATAAAGGCGAATATGTGTGTGACTGTGGCACAGACAAGACCAAGGCAAATGTTACTGTTGAGG
>TTN-209,ENSE00003802031,1,140,2007498,2007637,CTCGACTAATAAAAGTGGAAAAGCCTCTGTACGGAGTAGAGGTGTTTGTTGGTGAAACAGCCCACTTTGAAATTGAACTTTCTGAACCTGATGTTCACGGCCAGTGGAAGCTGAAAGGACAGCCTTTGACAGCTTCCCCT
>TTN-209,ENSE00003811443,1,127,2007638,2007764,GACTGTGAAATCATTGAGGATGGAAAGAAGCATATTCTGATCCTTCATAACTGTCAGCTGGGTATGACAGGAGAGGTTTCCTTCCAGGCTGCTAATGCCAAATCTGCAGCCAATCTGAAAGTGAAAG
>TTN-209,ENSE00003811384,1,267,2007765,2008031,AATTGCCTCTTATCTTCATCACACCTCTCAGTGATGTTAAAGTCTTCGAGAAAGATGAGGCTAAGTTTGAGTGTGAAGTATCCAGGGAGCCCAAAACATTCCGTTGGCTAAAAGGAACCCAGGAAATCACAGGTGATGACAGATTTGAGCTTATAAAGGATGGCACTAAGCATTCAATGGTGATCAAGTCAGCTGCTTTTGAAGATGAAGCAAAATACATGTTTGAAGCTGAAGATAAGCACACAAGTGGCAAACTGATCATTGAAG
>TTN-209,ENSE00003801954,1,267,2008032,2008298,GAATCCGGCTCAAATTCCTCACCCCTCTCAAAGATGTAACTGCCAAAGAGAAGGAAAGTGCTGTATTTACTGTGGAGTTATCTCATGATAACATCCGAGTTAAATGGTTCAAGAATGACCAGCGCCTACACACCACCAGGTCGGTCTCAATGCAAGACGAAGGGAAAACTCATTCGATCACATTCAAAGACCTGTCTATTGATGACACCTCCCAAATTAGAGTAGAAGCTATGGGGATGAGTTCAGAAGCTAAACTCACTGTGCTTG
>TTN-209,ENSE00003809996,1,267,2008299,2008565,AGGGAGACCCATATTTTACAGGAAAACTTCAAGATTATACTGGTGTAGAGAAAGATGAAGTTATTCTACAGTGTGAAATTAGCAAAGCAGATGCACCAGTGAAATGGTTTAAGGATGGGAAGGAAATAAAGCCATCCAAAAATGCTGTTATTAAGGCAGATGGCAAGAAACGCATGCTAATCCTAAAGAAAGCCTTGAAATCAGATATTGGACAGTACACCTGTGACTGTGGGACAGATAAGACCTCAGGAAAACTTGACATTGAGG
>TTN-209,ENSE00003804589,1,140,2008566,2008705,ATCGGGAAATTAAACTGGTGCGACCCCTGCACAGTGTGGAGGTGATGGAGACTGAGACAGCACGCTTTGAAACCGAAATCTCTGAAGATGATATCCACGCCAACTGGAAACTCAAGGGAGAGGCCCTACTCCAAACACCT
>TTN-209,ENSE00003805931,1,127,2008706,2008832,GATTGTGAAATTAAGGAAGAAGGCAAAATACACTCCCTTGTTTTGCACAACTGTCGCCTGGACCAGACGGGTGGGGTGGATTTCCAAGCTGCCAATGTTAAATCTAGTGCCCACCTCCGAGTTAAGC
>TTN-209,ENSE00003811344,1,143,2008833,2008975,CACGAGTAATTGGTCTTCTGAGGCCTTTAAAGGATGTCACCGTGACTGCAGGGGAAACAGCCACCTTCGACTGCGAGCTCTCCTACGAAGATATCCCAGTGGAATGGTATCTCAAAGGGAAGAAACTAGAGCCCAGCGATAAG
>TTN-209,ENSE00003802375,1,124,2008976,2009099,GTGGTCCCACGTTCAGAAGGAAAAGTTCATACACTTACTCTGAGGGATGTAAAGTTAGAAGATGCTGGGGAAGTCCAACTAACAGCAAAAGATTTCAAAACTCACGCCAACCTCTTTGTGAAAG
>TTN-209,ENSE00003806733,1,267,2009100,2009366,AACCCCCAGTTGAATTCACTAAGCCTCTTGAGGACCAGACGGTCGAAGAGGGAGCCACTGCAGTGCTGGAGTGTGAAGTCTCCAGAGAAAATGCTAAGGTGAAATGGTTCAAAAATGGGACAGAAATCCTCAAAAGCAAGAAGTATGAAATTGTTGCTGATGGCAGGGTCAGAAAACTTGTTATACATGACTGTACCCCAGAGGATATTAAAACATACACTTGTGATGCTAAGGATTTTAAGACTTCCTGTAACCTGAATGTCGTGC
>TTN-209,ENSE00003807497,1,98,2009367,2009464,CTCCTCATGTGGAATTCTTAAGACCACTCACCGACCTTCAAGTTAGAGAAAAAGAAATGGCTCGATTTGAGTGTGAACTTTCCCGAGAAAATGCTAAG
>TTN-209,ENSE00003802530,1,169,2009465,2009633,GTTAAGTGGTTTAAAGATGGTGCTGAAATTAAAAAGGGCAAAAAATATGACATCATATCCAAGGGAGCAGTGCGCATTCTTGTCATCAACAAATGTCTACTGGATGATGAAGCTGAATATTCCTGTGAAGTAAGGACAGCGAGAACTTCTGGCATGCTGACAGTTCTGG
>TTN-209,ENSE00003811387,1,267,2009634,2009900,AAGAAGAAGCTGTCTTTACCAAAAATCTTGCCAACATTGAAGTTAGTGAAACAGACACTATAAAACTGGTTTGTGAAGTCTCCAAACCTGGCGCAGAAGTGATTTGGTATAAAGGGGATGAGGAGATCATTGAAACAGGAAGATATGAAATACTGACTGAAGGACGGAAGAGAATCCTGGTCATTCAGAACGCTCACCTTGAGGATGCTGGCAACTACAACTGTCGACTCCCAAGCTCTCGAACCGATGGCAAAGTCAAAGTACATG
>TTN-209,ENSE00003802653,1,267,2009901,2010167,AACTGGCTGCTGAATTTATCTCAAAGCCTCAAAACCTTGAAATACTTGAAGGAGAAAAGGCTGAATTTGTCTGCTCTATATCAAAAGAAAGCTTTCCAGTCCAGTGGAAGAGGGATGATAAGACACTTGAATCTGGAGATAAATATGACGTTATTGCTGATGGTAAAAAGAGGGTCCTAGTTGTGAAAGATGCCACATTACAAGATATGGGCACTTACGTTGTCATGGTAGGGGCCGCCAGAGCAGCAGCTCACTTGACAGTCATTG
>TTN-209,ENSE00003802540,1,279,2010168,2010446,AAAAACTCAGGATCGTAGTTCCTCTTAAGGACACCCGGGTGAAGGAACAACAGGAAGTTGTCTTCAACTGTGAAGTCAATACTGAAGGTGCCAAAGCCAAATGGTTCAGAAATGAAGAAGCTATATTTGATAGTTCAAAATACATCATTCTCCAAAAAGACCTAGTCTACACCCTCAGAATTAGAGATGCACACTTAGATGACCAAGCCAACTATAATGTGTCTTTGACCAATCACAGAGGTGAAAATGTTAAAAGTGCAGCCAATCTAATAGTAGAAG
>TTN-209,ENSE00003802874,1,409,2010447,2010855,AGGAAGACCTTAGGATTGTTGAGCCTCTTAAAGATATTGAAACAATGGAGAAGAAATCTGTCACATTCTGGTGCAAGGTGAATCGTCTCAATGTAACACTGAAGTGGACCAAAAATGGTGAAGAAGTGCCTTTTGACAACCGTGTCTCATACAGAGTTGATAAGTACAAGCACATGTTAACCATTAAAGACTGTGGCTTCCCAGATGAAGGTGAATACATTGTCACTGCTGGACAAGATAAATCTGTTGCTGAGCTTCTCATCATAGAAGCCCCGACAGAATTTGTGGAACACTTGGAAGATCAGACAGTCACTGAGTTCGATGACGCTGTCTTCTCCTGCCAGCTCTCCAGAGAGAAAGCCAATGTAAAATGGTACAGAAATGGGAGAGAAATCAAAGAAGGCAAAAA
>TTN-209,ENSE00003804130,1,125,2010856,2010980,ATACAAATTTGAAAAAGATGGAAGTATACACAGACTCATTATAAAAGATTGCAGGCTGGATGATGAGTGTGAATATGCTTGCGGGGTAGAAGACAGGAAGTCTCGTGCTAGACTTTTTGTGGAAG
>TTN-209,ENSE00003807647,1,267,2010981,2011247,AAATTCCTGTTGAGATCATCAGGCCTCCACAAGATATTCTTGAAGCCCCTGGTGCTGATGTTGTCTTTTTAGCAGAACTCAATAAAGATAAGGTGGAAGTCCAATGGCTAAGAAATAACATGGTTGTTGTCCAGGGTGATAAACACCAGATGATGAGTGAAGGAAAGATACATCGACTACAGATTTGTGATATTAAGCCCCGTGACCAGGGTGAATACAGATTTATTGCCAAAGACAAAGAAGCCAGAGCTAAGCTTGAACTGGCAG
>TTN-209,ENSE00003802353,1,270,2011248,2011517,CTGCACCAAAAATCAAGACAGCTGACCAAGACCTTGTGGTTGATGTTGGCAAGCCTCTGACAATGGTGGTGCCATATGATGCCTACCCCAAAGCAGAAGCTGAATGGTTTAAAGAAAATGAACCTTTATCTACAAAAACCATTGATACTACGGCTGAACAAACTTCTTTCAGAATTTTAGAAGCCAAGAAAGGAGACAAAGGGAGGTATAAAATTGTGCTTCAGAACAAACATGGAAAAGCAGAAGGATTCATCAATTTAAAAGTTATTG
>TTN-209,ENSE00003809195,1,303,2011518,2011820,ATGTTCCTGGGCCAGTACGTAACTTAGAAGTGACAGAAACATTTGATGGTGAAGTGAGCCTTGCTTGGGAAGAACCTTTAACTGATGGTGGAAGCAAAATCATAGGTTACGTTGTTGAAAGACGTGACATTAAGAGAAAGACCTGGGTTCTGGCCACAGACCGTGCAGAGAGTTGTGAGTTTACTGTCACTGGTCTACAGAAAGGAGGAGTTGAGTACCTATTCCGTGTGAGTGCAAGAAACAGAGTTGGCACTGGTGAGCCAGTAGAAACTGACAATCCTGTAGAAGCAAGGAGTAAATATG
>TTN-209,ENSE00003803170,1,303,2011821,2012123,ATGTTCCAGGCCCTCCTTTGAATGTAACCATCACTGATGTGAATCGATTTGGTGTCTCACTGACATGGGAACCACCAGAGTATGATGGAGGTGCTGAGATCACAAACTACGTCATTGAATTAAGAGACAAGACTTCTATCAGGTGGGATACTGCCATGACTGTGAGAGCTGAAGACCTGTCTGCAACTGTTACTGATGTGGTAGAAGGACAGGAGTACAGTTTCCGAGTGAGAGCCCAAAATCGAATTGGAGTTGGAAAACCAAGTGCAGCCACACCCTTCGTCAAAGTTGCTGATCCAATTG
>TTN-209,ENSE00003806295,1,188,2012124,2012311,AGAGACCAAGTCCTCCTGTAAACCTAACTTCCTCAGATCAGACTCAGTCATCAGTTCAGCTCAAATGGGAACCTCCTCTGAAAGATGGAGGAAGCCCAATATTAGGCTATATAATTGAGCGATGCGAAGAAGGAAAAGATAATTGGATTCGTTGCAATATGAAACTTGTCCCTGAACTGACTTACAAG
>TTN-209,ENSE00003810732,1,115,2012312,2012426,GTTACCGGATTGGAAAAAGGAAATAAATATTTATATAGAGTATCTGCAGAAAATAAAGCTGGTGTTTCAGATCCATCTGAAATTCTTGGTCCTCTCACCGCTGACGATGCATTTG
>TTN-209,ENSE00003809985,1,285,2012427,2012711,TTGAACCAACAATGGATTTAAGTGCATTTAAAGATGGTCTGGAAGTTATTGTCCCAAATCCTATCACGATCCTGGTTCCAAGTACAGGCTATCCAAGGCCAACTGCAACCTGGTGTTTTGGAGATAAAGTACTAGAAACAGGGGACCGGGTGAAAATGAAGACCTTGTCTGCCTATGCCGAACTTGTCATTTCTCCAAGTGAACGTTCAGACAAGGGCATTTATACACTGAAATTAGAAAACCGTGTGAAAACAATTTCTGGGGAAATTGATGTCAATGTAATTG
>TTN-209,ENSE00003808828,1,152,2012712,2012863,CTCGCCCAAGTGCACCCAAAGAATTGAAATTTGGTGATATAACCAAGGACTCAGTACATTTGACTTGGGAACCACCTGATGATGATGGAGGAAGTCCGTTAACTGGATACGTTGTTGAAAAACGAGAAGTCAGCCGGAAAACATGGACTAAA
>TTN-209,ENSE00003803811,1,148,2012864,2013011,GTTATGGACTTTGTGACTGATCTAGAATTCACAGTTCCTGATCTTGTTCAAGGAAAAGAGTACTTATTTAAAGTTTGTGCTCGTAACAAATGTGGCCCTGGAGAACCTGCATATGTTGATGAACCTGTAAATATGTCAACTCCTGCAA
>TTN-209,ENSE00003803944,1,178,2013012,2013189,CGGTACCTGACCCACCAGAGAATGTTAAATGGAGAGATCGAACAGCCAATAGCATCTTCTTAACATGGGATCCACCTAAAAATGATGGTGGTTCACGCATCAAAGGATATATAGTTGAAAGATGTCCACGTGGTTCTGATAAATGGGTTGCCTGTGGAGAACCTGTTGCAGAAACAAA
>TTN-209,ENSE00003802090,1,122,2013190,2013311,AATGGAAGTGACAGGTCTTGAGGAAGGCAAATGGTATGCCTACCGCGTGAAGGCCTTAAACAGGCAGGGTGCTAGCAAACCAAGCAGACCCACAGAGGAAATCCAGGCTGTGGACACACAAG
>TTN-209,ENSE00003809522,1,288,2013312,2013599,AGGCCCCAGAAATCTTCCTCGATGTGAAGCTCCTTGCTGGTCTCACTGTAAAAGCTGGGACCAAGATTGAACTTCCTGCCACCGTAACCGGAAAACCTGAACCTAAAATAACTTGGACAAAGGCTGATATGATTCTGAAGCAGGACAAAAGAATTACCATTGAAAATGTCCCTAAGAAATCCACAGTGACTATTGTTGATAGTAAGAGAAGTGACACTGGCACATATATCATTGAGGCTGTGAATGTGTGTGGCCGGGCCACTGCTGTGGTGGAAGTGAACGTCTTAG
>TTN-209,ENSE00003804879,1,297,2013600,2013896,ATAAACCCGGACCACCAGCTGCCTTTGACATCACAGATGTAACCAATGAGTCATGTCTTCTAACATGGAACCCACCACGCGATGATGGTGGATCTAAGATCACAAACTATGTTGTGGAGAGACGAGCAACTGATAGTGAAGTGTGGCACAAGCTCTCATCCACCGTCAAGGATACAAACTTCAAGGCCACCAAATTAATCCCCAATAAAGAGTACATCTTCAGAGTTGCTGCAGAAAACATGTATGGTGTTGGTGAACCAGTTCAGGCCTCTCCAATAACAGCCAAATATCAGTTTG
>TTN-209,ENSE00003809410,1,187,2013897,2014083,ATCCACCTGGTCCTCCAACTCGCCTAGAACCTTCTGATATCACTAAAGACGCAGTGACTCTCACATGGTGTGAGCCAGATGATGATGGTGGCAGCCCAATCACAGGATACTGGGTTGAAAGACTGGATCCTGATACAGATAAATGGGTTAGATGCAATAAGATGCCAGTAAAGGACACAACATACAG
>TTN-209,ENSE00003808827,1,116,2014084,2014199,AGTGAAAGGTCTCACTAATAAGAAAAAATACAGATTCCGTGTGTTGGCTGAAAATCTTGCTGGACCTGGAAAACCAAGCAAATCAACTGAACCAATCTTAATAAAGGATCCCATAG
>TTN-209,ENSE00003806136,1,300,2014200,2014499,ATCCTCCATGGCCCCCTGGAAAACCAACTGTAAAAGATGTAGGCAAAACATCAGTAAGGTTGAATTGGACAAAACCAGAACATGATGGAGGTGCAAAGATTGAGTCTTATGTCATTGAAATGCTGAAGACTGGAACAGATGAGTGGGTCAGAGTGGCGGAAGGGGTTCCCACCACTCAGCACTTGCTCCCAGGGCTCATGGAAGGACAGGAATACTCATTCCGAGTTAGAGCTGTGAATAAGGCTGGGGAAAGTGAACCCAGTGAACCCAGTGACCCTGTGCTTTGCCGGGAGAAGCTAT
>TTN-209,ENSE00003804290,1,300,2014500,2014799,ATCCTCCATCACCACCACGCTGGCTTGAAGTTATTAATATCACAAAAAATACAGCAGACCTAAAATGGACAGTTCCTGAGAAAGATGGAGGGTCCCCCATCACCAACTACATTGTGGAAAAGAGAGACGTCAGGCGAAAAGGCTGGCAAACAGTGGATACCACTGTCAAGGACACCAAGTGCACAGTCACCCCACTGACTGAGGGCTCTTTATATGTGTTCCGAGTTGCTGCAGAAAATGCTATAGGACAAAGCGACTACACCGAAATTGAGGACTCTGTGCTGGCCAAAGACACCTTTA
>TTN-209,ENSE00003803723,1,106,2014800,2014905,CCACTCCTGGACCACCCTACGCCCTGGCAGTGGTTGATGTGACAAAACGACATGTTGACCTAAAGTGGGAGCCACCTAAAAATGATGGTGGAAGACCAATACAGAG
>TTN-209,ENSE00003805819,1,197,2014906,2015102,ATATGTCATTGAGAAGAAAGAAAGGTTAGGTACCCGTTGGGTGAAAGCTGGAAAGACTGCAGGACCTGACTGTAACTTCAGAGTAACTGATGTCATCGAAGGAACAGAGGTCCAGTTTCAGGTTCGGGCTGAAAATGAAGCTGGAGTTGGCCACCCAAGTGAACCCACAGAAATCCTATCCATTGAAGATCCAACAA
>TTN-209,ENSE00003806467,1,306,2015103,2015408,GTCCTCCCTCACCACCCCTTGACCTACATGTGACTGATGCTGGGAGAAAACACATTGCCATTGCTTGGAAGCCTCCAGAGAAAAATGGTGGAAGTCCTATCATAGGATACCATGTTGAAATGTGTCCAGTAGGCACTGAGAAATGGATGAGAGTTAATTCTCGCCCAATAAAGGACTTGAAATTCAAGGTTGAAGAAGGTGTTGTTCCTGACAAAGAATATGTCCTGAGAGTGAGAGCAGTCAATGCTATTGGTGTCAGCGAGCCATCTGAAATCTCTGAAAATGTGGTTGCCAAAGACCCAGACT
>TTN-209,ENSE00003808061,1,279,2015409,2015687,GCAAGCCAACAATTGACCTGGAGACTCATGACATTATTGTTATTGAAGGTGAAAAGTTAAGCATTCCTGTTCCCTTCAGAGCTGTCCCAGTTCCAACTGTTAGTTGGCATAAAGATGGCAAAGAAGTTAAAGCAAGTGATAGATTAACAATGAAGAATGATCACATCTCTGCACACCTTGAAGTTCCCAAGAGTGTCCGTGCAGATGCCGGAATTTATACCATTACACTGGAGAATAAGCTCGGCTCAGCAACAGCCTCAATCAATGTCAAAGTCATAG
>TTN-209,ENSE00003811164,1,300,2015688,2015987,GCCTACCTGGACCATGCAAAGATATTAAAGCAAGTGACATTACCAAGAGTTCTTGTAAGTTAACTTGGGAACCTCCAGAATTTGATGGTGGAACCCCAATTCTTCATTATGTCCTGGAGCGCAGAGAAGCTGGGAGGAGAACATATATACCAGTCATGTCTGGTGAGAACAAACTGTCATGGACTGTGAAGGATCTCATACCAAATGGTGAATACTTCTTCCGTGTTAAAGCAGTCAACAAGGTTGGTGGAGGAGAATATATTGAACTGAAAAATCCAGTCATTGCTCAAGATCCAAAGC
>TTN-209,ENSE00003805132,1,303,2015988,2016290,AACCCCCTGATCCACCTGTAGATGTAGAGGTTCATAATCCTACAGCGGAGGCAATGACTATTACATGGAAGCCACCTTTGTATGATGGAGGGAGCAAGATAATGGGCTACATCATAGAGAAGATTGCTAAGGGTGAAGAAAGGTGGAAGAGATGCAATGAACACCTGGTACCAATCCTGACCTATACAGCAAAAGGACTTGAAGAGGGGAAAGAGTACCAATTCCGTGTGCGAGCAGAGAACGCCGCGGGTATTAGTGAACCTTCTCGGGCTACTCCTCCAACCAAAGCTGTAGATCCCATTG
>TTN-209,ENSE00003805056,1,363,2016291,2016653,ATGCCCCCAAAGTCATTCTGAGAACAAGCCTAGAAGTGAAACGAGGTGATGAAATAGCACTTGATGCAAGTATTTCTGGATCACCTTACCCAACTATTACATGGATAAAGGATGAAAATGTTATTGTACCAGAGGAAATTAAGAAGCGTGCAGCACCCTTGGTTAGGAGAAGGAAGGGTGAAGTTCAAGAAGAAGAACCATTTGTCCTGCCTCTGACACAGCGTTTGAGTATTGACAACAGCAAAAAGGGAGAATCTCAGCTACGCGTCCGAGATTCTCTCCGACCTGACCATGGTCTGTATATGATCAAAGTTGAAAATGACCACGGTATTGCAAAAGCTCCTTGTACTGTCAGTGTGTTAG
>TTN-209,ENSE00003811138,1,303,2016654,2016956,ATACACCGGGACCACCAATCAACTTTGTATTTGAAGATATCAGAAAGACCTCAGTCCTTTGTAAATGGGAACCACCCCTTGATGATGGTGGCAGTGAAATCATAAACTACACTTTGGAAAAGAAAGACAAGACAAAACCCGACTCAGAATGGATTGTTGTCACTTCAACACTTAGACATTGCAAATATTCAGTAACAAAACTGATTGAAGGAAAAGAGTACCTCTTCCGTGTAAGAGCTGAAAACAGATTTGGGCCAGGTCCACCATGTGTTTCAAAGCCACTTGTGGCTAAAGATCCATTTG
>TTN-209,ENSE00003809346,1,300,2016957,2017256,GACCACCTGATGCACCAGATAAGCCCATTGTGGAAGATGTTACCAGCAACAGTATGCTAGTGAAATGGAATGAACCAAAAGATAATGGAAGCCCCATTTTGGGTTACTGGCTTGAAAAACGTGAAGTTAACAGTACACATTGGTCTCGTGTCAACAAAAGCCTTCTGAATGCCTTGAAAGCCAATGTAGATGGCTTATTAGAAGGACTCACCTATGTCTTCAGAGTATGTGCTGAAAATGCAGCTGGACCTGGAAAGTTCAGTCCACCTTCAGATCCCAAAACAGCACATGATCCAATCT
>TTN-209,ENSE00003806782,1,297,2017257,2017553,CTCCTCCTGGGCCACCTATCCCAAGAGTCACTGACACAAGCTCTACAACTATTGAACTAGAATGGGAACCCCCAGCTTTCAATGGTGGTGGGGAAATTGTTGGCTATTTTGTTGATAAGCAGTTGGTTGGCACAAATGAATGGTCACGCTGCACAGAGAAGATGATCAAGGTCCGTCAGTACACCGTCAAAGAAATCCGAGAGGGTGCTGATTACAAACTTCGGGTGAGTGCTGTCAATGCCGCAGGGGAAGGACCGCCTGGAGAAACACAACCTGTTACTGTGGCTGAACCACAAG
>TTN-209,ENSE00003804121,1,285,2017554,2017838,AGCCTCCAGCTGTGGAACTGGATGTTTCTGTCAAGGGTGGAATACAAATAATGGCTGGGAAGACTCTTAGAATTCCAGCTGTGGTGACTGGTCGCCCTGTACCTACAAAAGTATGGACCAAAGAAGAAGGGGAGCTGGATAAAGACCGTGTTGTAATAGACAACGTTGGAACCAAATCTGAACTAATTATCAAGGATGCACTGCGAAAAGACCATGGCAGATATGTGATTACAGCTACAAATAGCTGTGGTTCCAAATTTGCAGCAGCCAGGGTAGAAGTTTTTG
>TTN-209,ENSE00003804454,1,294,2017839,2018132,ATGTCCCTGGTCCAGTTCTTGACTTAAAACCTGTTGTAACAAACAGAAAAATGTGTCTACTTAACTGGTCTGATCCAGAAGATGATGGAGGAAGTGAAATAACAGGCTTTATCATTGAAAGAAAAGATGCCAAGATGCATACTTGGAGACAACCAATAGAGACTGAGAGATCTAAATGTGACATCACAGGTCTGCTTGAGGGACAAGAATATAAGTTCCGTGTTATTGCCAAGAACAAGTTTGGCTGTGGCCCTCCTGTTGAAATAGGACCAATTCTTGCAGTTGATCCACTAG
>TTN-209,ENSE00003803420,1,300,2018133,2018432,GTCCTCCAACATCTCCAGAGAGGCTCACATACACTGAAAGGACAAAGTCCACTATCACACTTGACTGGAAAGAGCCCCGCAGTAATGGTGGCAGTCCCATCCAAGGATATATCATTGAAAAACGGCGTCATGACAAACCTGACTTTGAAAGAGTTAACAAGCGACTCTGCCCAACCACATCTTTTCTGGTTGAAAATCTTGATGAACACCAAATGTATGAGTTCCGTGTCAAAGCTGTCAATGAAATTGGTGAAAGTGAACCATCCCTACCTCTTAATGTAGTCATACAAGATGATGAAG
>TTN-209,ENSE00003809028,1,309,2018433,2018741,TGCCTCCAACTATTAAGTTGCGTCTGAGTGTTCGAGGAGACACTATCAAAGTTAAGGCAGGAGAGCCTGTCCACATCCCTGCAGATGTGACAGGCCTTCCAATGCCTAAGATTGAATGGTCCAAAAATGAAACTGTAATTGAAAAACCCACTGATGCACTTCAGATAACCAAGGAAGAGGTATCCCGAAGTGAGGCAAAAACTGAGCTTAGCATTCCCAAAGCGGTCCGGGAGGACAAAGGCACTTACACAGTTACTGCTTCCAATCGCCTTGGCTCAGTGTTCCGAAATGTTCACGTTGAAGTATATG
>TTN-209,ENSE00003801894,1,191,2018742,2018932,ACCGCCCATCCCCACCAAGAAATCTTGCTGTTACTGACATTAAAGCTGAATCTTGCTACTTGACATGGGATGCCCCTCTTGATAATGGTGGCAGTGAAATCACCCATTATGTTATTGACAAACGTGATGCAAGTAGGAAGAAAGCAGAATGGGAGGAAGTCACCAACACTGCTGTAGAGAAAAGATATGGG
>TTN-209,ENSE00003809851,1,430,2018933,2019362,ATCTGGAAACTTATCCCCAATGGTCAGTATGAGTTCCGAGTCAGGGCAGTGAATAAATATGGAATCAGTGATGAGTGCAAATCAGATAAAGTAGTCATTCAAGATCCTTATCGCCTTCCTGGACCTCCAGGAAAACCAAAAGTTTTGGCACGCACCAAAGGATCAATGCTAGTGAGCTGGACTCCTCCTTTGGACAATGGTGGCTCTCCAATTACTGGCTACTGGCTGGAGAAAAGAGAAGAGGGAAGTCCTTATTGGTCACGTGTTAGCCGAGCACCAATAACCAAAGTGGGATTGAAAGGCGTGGAATTTAATGTTCCTCGTTTGCTTGAAGGCGTTAAATACCAGTTCAGAGCCATGGCAATAAATGCTGCAGGAATTGGTCCTCCCAGTGAACCATCAGATCCAGAGGTTGCAGGAGATCCCATAT
>TTN-209,ENSE00003808594,1,309,2019363,2019671,TTCCACCGGGGCCACCTTCTTGCCCAGAAGTTAAAGATAAAACGAAGTCAAGCATCTCACTAGGATGGAAACCTCCAGCCAAAGATGGTGGCAGCCCAATCAAAGGATACATTGTAGAAATGCAAGAAGAAGGTACTACTGACTGGAAAAGAGTAAATGAACCAGACAAACTTATAACTACCTGTGAATGTGTGGTGCCTAATCTGAAAGAGCTCAGGAAGTACAGATTCAGAGTGAAAGCTGTCAATGAAGCTGGTGAATCTGAACCAAGTGATACAACTGGGGAGATCCCTGCCACTGATATTCAAG
>TTN-209,ENSE00003810473,1,149,2019672,2019820,AGGAACCAGAAGTTTTCATTGACATTGGAGCACAGGACTGTCTGGTTTGTAAAGCTGGCTCACAGATTAGGATTCCTGCTGTCATCAAGGGACGCCCAACACCAAAATCATCTTGGGAATTTGATGGAAAGGCAAAGAAAGCAATGAAG
>TTN-209,ENSE00003801625,1,33,2019821,2019853,GATGGAGTTCATGACATACCCGAAGATGCACAG
>TTN-209,ENSE00003802643,1,130,2019854,2019983,CTGGAGACTGCTGAAAACTCCTCAGTAATTATTATTCCGGAGTGTAAACGATCTCATACAGGCAAATACAGCATCACAGCCAAGAATAAAGCAGGACAAAAGACTGCAAATTGCAGAGTTAAAGTCATGG
>TTN-209,ENSE00003804239,1,300,2019984,2020283,ATGTACCAGGCCCACCCAAAGATCTGAAAGTCAGTGATATCACAAGGGGTAGTTGCAGACTTTCATGGAAGATGCCAGACGACGATGGAGGAGACAGGATCAAAGGCTATGTTATTGAGAAGAGGACTATTGATGGAAAAGCCTGGACCAAAGTCAATCCAGACTGTGGAAGCACCACATTTGTAGTGCCTGATCTCCTCTCTGAACAGCAATATTTCTTCCGTGTGCGAGCAGAAAACCGTTTTGGTATTGGCCCACCTGTGGAAACCATTCAGAGGACCACTGCCAGAGATCCGATAT
>TTN-209,ENSE00003806278,1,318,2020284,2020601,ATCCTCCTGATCCTCCTATTAAACTCAAGATTGGCCTCATCACAAAGAACACAGTGCATCTGTCATGGAAACCCCCGAAGAATGATGGGGGCTCCCCTGTTACCCACTATATTGTTGAGTGCCTTGCATGGGACCCTACTGGGACAAAGAAAGAAGCCTGGAGGCAGTGCAATAAGCGTGATGTGGAAGAACTGCAATTTACTGTTGAAGACCTAGTAGAGGGTGGGGAATATGAATTCCGAGTCAAAGCTGTCAATGCTGCAGGAGTCAGCAAGCCTTCAGCCACTGTTGGCCCTGTGACTGTCAAAGACCAGACAT
>TTN-209,ENSE00003801391,1,297,2020602,2020898,GCCCACCATCAATTGATCTAAAAGAATTCATGGAGGTTGAAGAAGGAACCAATGTTAACATTGTGGCCAAAATTAAAGGTGTGCCATTCCCGACACTAACCTGGTTTAAAGCTCCTCCAAAGAAGCCTGATAACAAAGAACCTGTTCTCTATGACACCCATGTCAACAAACTGGTGGTAGATGATACTTGCACTTTAGTTATTCCGCAGTCTCGCAGGAGTGACACTGGCTTATATACCATCACAGCTGTAAATAATCTGGGAACAGCATCAAAGGAGATGAGACTGAATGTCCTGG
>TTN-209,ENSE00003806021,1,300,2020899,2021198,GTCGTCCTGGCCCTCCAGTGGGACCCATAAAATTTGAATCTGTTTCAGCAGATCAAATGACACTATCTTGGTTTCCACCTAAAGATGATGGTGGGTCTAAGATTACAAACTATGTAATTGAGAAAAGAGAAGCTAACAGGAAGACATGGGTCCATGTCTCCAGTGAACCTAAGGAGTGCACGTACACGATTCCCAAATTGCTAGAAGGCCATGAATATGTATTCCGAATCATGGCCCAGAATAAATATGGCATTGGAGAACCTCTTGACAGTGAACCTGAAACAGCAAGAAACCTCTTCT
>TTN-209,ENSE00003803442,1,315,2021199,2021513,CTGTCCCTGGAGCACCAGATAAACCAACAGTTAGCAGCGTGACTCGTAACTCCATGACTGTCAACTGGGAAGAGCCAGAATATGATGGAGGCTCTCCTGTGACAGGGTACTGGCTGGAAATGAAAGACACCACTTCAAAGAGATGGAAGAGAGTTAACCGAGATCCTATCAAAGCCATGACTTTGGGTGTTTCTTATAAAGTGACTGGTCTTATTGAAGGTTCCGACTATCAATTCCGGGTATATGCAATCAATGCTGCTGGCGTGGGTCCAGCAAGTCTGCCATCAGACCCAGCGACTGCTAGAGATCCAATTG
>TTN-209,ENSE00003801787,1,149,2021514,2021662,CCCCTCCTGGTCCTCCATTTCCCAAAGTGACAGATTGGACTAAATCATCTGCAGATCTGGAGTGGTCTCCCCCACTAAAAGATGGTGGATCCAAAGTAACTGGATACATCGTTGAATATAAAGAAGAAGGAAAAGAAGAATGGGAAAAG
>TTN-209,ENSE00003802004,1,151,2021663,2021813,GGTAAAGATAAAGAAGTGAGAGGAACAAAGCTTGTTGTGACAGGATTAAAGGAAGGAGCATTCTACAAATTTAGAGTTAGAGCAGTCAACATTGCTGGCATTGGAGAACCTGGAGAGGTCACAGATGTCATTGAAATGAAGGACAGACTTG
>TTN-209,ENSE00003808790,1,282,2021814,2022095,TTTCACCTGACCTTCAGCTAGATGCCAGTGTCAGAGATAGAATTGTTGTCCATGCTGGAGGGGTGATCCGAATCATTGCCTATGTGTCTGGAAAGCCTCCTCCAACCGTCACCTGGAACATGAATGAAAGAACCTTACCTCAAGAAGCCACCATTGAGACCACAGCCATTAGCTCATCCATGGTCATCAAGAACTGCCAGAGGAGCCATCAAGGCGTCTATTCTCTTCTTGCCAAAAATGAAGCCGGAGAAAGAAAGAAGACAATTATTGTTGATGTATTAG
>TTN-209,ENSE00003807896,1,303,2022096,2022398,ATGTTCCAGGTCCCGTTGGAACACCATTCCTAGCTCACAACCTAACCAATGAGTCCTGCAAACTGACATGGTTTTCTCCAGAAGATGATGGAGGCTCTCCAATCACCAATTATGTCATTGAAAAGCGTGAATCTGACCGCAGAGCATGGACCCCAGTGACATATACAGTTACCCGACAAAATGCTACTGTCCAGGGTCTCATTCAAGGAAAAGCCTACTTTTTCCGAATTGCGGCTGAAAATAGTATTGGCATGGGTCCATTTGTTGAGACATCAGAGGCACTTGTTATCAGAGAGCCAATAA
>TTN-209,ENSE00003801753,1,303,2022399,2022701,CTGTACCAGAGCGTCCTGAAGACCTGGAAGTCAAAGAAGTTACTAAAAATACTGTAACTTTGACTTGGAATCCTCCTAAGTATGATGGTGGGTCAGAAATTATTAACTATGTCCTAGAAAGTCGGCTCATTGGGACTGAGAAGTTCCACAAAGTTACAAATGACAACTTGCTTAGCAGAAAATACACTGTTAAAGGCTTAAAAGAAGGTGATACCTATGAGTACCGTGTCAGTGCTGTCAACATTGTTGGACAAGGCAAACCATCATTTTGCACCAAACCAATTACTTGCAAGGATGAGCTGG
>TTN-209,ENSE00003807039,1,282,2022702,2022983,CACCCCCAACGCTTCACCTCGACTTCAGAGATAAGCTCACGATTCGAGTTGGTGAAGCTTTTGCCCTCACTGGCCGTTACTCAGGCAAACCAAAGCCTAAGGTTTCCTGGTTCAAAGATGAAGCTGATGTGCTGGAAGATGATCGCACTCATATAAAGACTACACCAGCAACACTTGCTTTAGAGAAGATCAAGGCCAAACGTTCAGATTCCGGCAAATACTGTGTGGTTGTGGAGAACAGTACAGGCTCTAGGAAAGGTTTCTGTCAAGTTAATGTTGTTG
>TTN-209,ENSE00003804106,1,300,2022984,2023283,ACCGTCCTGGACCACCAGTAGGACCAGTTAGTTTTGATGAGGTGACCAAAGATTACATGGTTATCTCTTGGAAGCCTCCTTTAGATGATGGAGGCAGTAAAATCACCAATTATATTATTGAGAAGAAGGAAGTGGGTAAAGACGTCTGGATGCCAGTGACATCTGCAAGTGCTAAAACAACATGCAAAGTTTCTAAACTACTTGAAGGAAAAGATTATATTTTCCGGATACATGCTGAAAATCTGTATGGAATAAGTGATCCTCTGGTGTCTGATTCAATGAAAGCCAAAGATCGTTTCA
>TTN-209,ENSE00003801817,1,303,2023284,2023586,GGGTTCCTGATGCACCTGATCAGCCAATTGTTACAGAAGTTACCAAAGACTCTGCATTAGTAACCTGGAATAAGCCACATGATGGAGGAAAACCCATCACAAACTACATCCTGGAAAAGAGAGAAACTATGTCTAAACGATGGGCTAGAGTTACCAAAGATCCTATTCATCCATACACTAAATTTAGGGTTCCTGATCTTCTAGAAGGATGTCAGTATGAATTCCGGGTTTCTGCAGAAAATGAAATTGGTATTGGAGATCCAAGCCCACCATCCAAACCAGTCTTTGCTAAAGATCCAATTG
>TTN-209,ENSE00003810564,1,309,2023587,2023895,CTAAACCAAGTCCACCTGTTAATCCTGAAGCAATAGATACAACATGCAATTCAGTCGATCTAACTTGGCAGCCACCACGTCATGATGGTGGGAGCAAGATTCTGGGTTATATTGTTGAGTACCAGAAAGTTGGAGATGAAGAGTGGAGAAGAGCCAATCACACCCCTGAGTCATGTCCTGAAACTAAATATAAAGTCACCGGTCTTCGGGACGGTCAAACCTATAAGTTTAGAGTGTTAGCAGTCAATGCAGCTGGTGAATCAGATCCAGCTCATGTTCCGGAGCCAGTCCTAGTAAAAGACAGGCTTG
>TTN-209,ENSE00003807476,1,282,2023896,2024177,AACCCCCTGAGTTGATTCTTGATGCCAACATGGCAAGAGAACAACACATTAAAGTTGGTGATACTCTAAGACTTAGTGCCATCATCAAAGGAGTGCCATTCCCAAAAGTAACTTGGAAAAAAGAAGACAGAGATGCTCCAACTAAAGCAAGAATTGATGTGACTCCAGTTGGTAGCAAGCTTGAAATTCGTAATGCTGCCCATGAAGATGGTGGAATTTATTCTTTAACAGTGGAGAATCCAGCTGGTTCAAAAACTGTCTCAGTAAAAGTACTTGTATTAG
>TTN-209,ENSE00003807363,1,300,2024178,2024477,ATAAACCTGGGCCACCTAGAGATCTGGAAGTCAGTGAAATTAGGAAAGATTCATGTTACCTTACTTGGAAAGAACCACTGGATGATGGTGGTTCTGTTATTACCAATTATGTGGTTGAGAGGAGAGATGTTGCCAGCGCCCAGTGGTCACCTCTCTCAGCTACATCAAAGAAAAAGAGTCACTTCGCTAAGCATCTGAATGAAGGCAACCAGTACCTCTTCCGAGTAGCTGCGGAGAACCAGTATGGACGTGGTCCTTTTGTTGAAACACCAAAACCAATCAAGGCTTTGGATCCTCTCC
>TTN-209,ENSE00003808994,1,294,2024478,2024771,ATCCCCCAGGGCCACCCAAGGACCTGCACCATGTAGATGTTGACAAGACTGAAGTCTCCCTAGTCTGGAATAAGCCGGATCGTGATGGTGGTTCTCCAATCACTGGATATTTGGTAGAATATCAAGAAGAAGGCACCCAGGACTGGATTAAATTTAAGACTGTGACAAACTTAGAGTGTGTGGTTACTGGACTACAACAAGGAAAGACCTATAGATTCCGTGTAAAAGCTGAAAACATTGTGGGTCTTGGTCTCCCTGACACAACTATCCCGATAGAATGTCAAGAAAAACTAG
>TTN-209,ENSE00003810188,1,2967,2024772,2027738,TGCCTCCATCCGTGGAGCTAGATGTGAAATTAATTGAAGGTCTTGTGGTAAAGGCTGGAACCACAGTCAGATTCCCTGCTATTATAAGAGGTGTGCCTGTTCCTACTGCAAAGTGGACAACCGATGGGAGTGAGATTAAAACCGATGAGCACTACACAGTTGAAACAGACAACTTCTCATCAGTACTTACCATTAAGAACTGCTTAAGGAGAGACACTGGGGAATATCAAATCACAGTTTCCAATGCAGCCGGTAGCAAAACAGTAGCCGTACATCTTACTGTTCTTGATGTTCCTGGGCCACCAACAGGTCCTATTAATATTCTGGATGTTACTCCTGAACACATGACTATCTCATGGCAGCCACCTAAGGATGATGGAGGAAGCCCTGTGATAAATTATATTGTTGAGAAACAAGATACAAGGAAAGACACGTGGGGTGTTGTCTCTTCCGGAAGCAGTAAGACAAAGCTGAAAATCCCACATCTGCAGAAGGGCTGTGAATATGTTTTCCGAGTTAGAGCAGAGAATAAGATAGGTGTTGGTCCTCCCCTTGACTCCACACCTACTGTTGCTAAGCATAAATTTAGTCCTCCGTCTCCTCCTGGTAAACCAGTGGTTACTGACATTACTGAAAATGCAGCAACAGTGTCTTGGACCCTGCCAAAATCTGATGGTGGCAGTCCAATAACTGGCTACTATATGGAACGTCGAGAAGTAACTGGCAAATGGGTGAGGGTCAACAAAACACCTATCGCTGACCTGAAGTTCAGAGTGACTGGACTCTATGAAGGAAATACATATGAGTTTAGAGTTTTTGCTGAAAATCTTGCAGGACTAAGCAAACCATCCCCAAGTTCTGATCCAATAAAAGCTTGCCGGCCCATCAAACCACCTGGACCACCTATTAATCCTAAACTGAAAGACAAGAGCAGAGAAACAGCTGATTTGGTGTGGACAAAGCCTCTCAGTGATGGTGGTAGCCCCATTCTAGGATATGTAGTGGAATGTCAGAAACCTGGCACAGCACAATGGAACAGGATTAATAAAGATGAACTCATTAGGCAATGTGCCTTTAGGGTACCTGGACTAATTGAAGGAAATGAGTACAGATTCCGTATAAAGGCAGCTAATATTGTAGGAGAGGGTGAGCCAAGAGAACTAGCAGAATCTGTGATTGCAAAAGATATCCTTCATCCTCCAGAAGTAGAACTTGATGTTACTTGTCGTGATGTTATTACCGTGAGAGTAGGCCAAACTATCCGCATTCTAGCTCGAGTCAAAGGCAGACCTGAACCAGACATAACTTGGACTAAGGAAGGCAAAGTATTGGTCCGAGAAAAGAGGGTGGACCTTATTCAGGATCTACCTCGTGTTGAGTTACAAATTAAAGAAGCTGTTAGAGCTGATCATGGCAAGTATATCATCTCAGCTAAGAACAGCAGTGGACATGCCCAAGGTTCAGCCATCGTTAACGTCCTTGACAGACCTGGGCCTTGCCAGAATTTGAAGGTTACCAATGTAACCAAAGAGAACTGTACAATTTCTTGGGAAAACCCACTAGATAATGGTGGCTCAGAAATAACAAACTTCATAGTAGAATATCGCAAACCAAACCAGAAAGGCTGGTCAATTGTTGCATCAGATGTCACTAAACGATTAATCAAGGCCAACCTTTTAGCCAACAATGAATACTATTTCCGAGTTTGTGCAGAGAATAAAGTAGGTGTTGGGCCAACCATCGAAACAAAAACTCCCATTCTGGCTATTAACCCTATTGACAGACCAGGTGAGCCTGAAAACCTTCACATTGCAGATAAAGGAAAGACATTTGTCTATCTAAAGTGGCGGAGGCCTGACTATGATGGTGGCAGTCCAAATCTGTCATATCATGTTGAGAGAAGGCTTAAGGGCTCCGATGACTGGGAAAGAGTGCATAAAGGAAGCATTAAAGAAACTCACTACATGGTTGACAGATGTGTTGAAAACCAGATTTATGAGTTCAGAGTGCAAACAAAGAATGAAGGTGGGGAAAGTGACTGGGTGAAGACAGAGGAAGTTGTTGTGAAAGAAGACTTACAAAAACCAGTACTTGATCTGAAATTAAGTGGGGTCCTAACTGTCAAAGCAGGGGACACCATTAGGCTTGAGGCAGGGGTTAGAGGCAAACCATTCCCAGAAGTTGCATGGACCAAGGACAAAGACGCTACAGACTTAACAAGATCACCAAGGGTCAAGATTGATACCCGTGCTGATTCATCTAAATTTTCTCTTACTAAAGCAAAGCGAAGTGATGGGGGTAAATATGTAGTTACGGCAACTAACACGGCTGGCAGTTTTGTGGCCTATGCCACTGTCAATGTTTTAGATAAGCCTGGTCCTGTGAGAAATCTGAAAATTGTTGATGTGTCCAGTGATAGGTGTACTGTTTGCTGGGATCCACCAGAAGATGATGGTGGCTGTGAAATCCAAAATTATATTCTAGAAAAATGTGAGACAAAGCGAATGGTTTGGTCTACCTATTCTGCTACTGTCTTGACACCTGGTACTACAGTAACACGTCTCATAGAAGGAAATGAATATATTTTCAGAGTCCGTGCAGAAAATAAAATAGGCACAGGGCCTCCAACAGAAAGTAAACCAGTCATAGCCAAAACCAAGTATGATAAACCTGGTCGCCCTGATCCCCCAGAAGTCACTAAAGTAAGCAAAGAAGAGATGACTGTGGTTTGGAATCCACCTGAATATGATGGTGGAAAGTCTATAACTGGATACTTTTTGGAGAAAAAGGAAAAGCATTCAACACGATGGGTCCCTGTCAACAAGAGTGCAATCCCTGAGAGACGTATGAAAGTACAGAATCTCCTCCCAGACCATGAATATCAGTTCCGTGTCAAGGCAGAAAATGAAATTGGAATTGGAGAACCAAGCTTGCCTTCAAGACCGGTGGTGGCAAAAGACCCCATAG
>TTN-209,ENSE00003811401,1,321,2027739,2028059,AGCCACCTGGTCCACCAACCAATTTCAGAGTGGTTGATACAACCAAACATTCCATAACTCTTGGGTGGGGAAAACCAGTCTATGATGGTGGTGCACCGATCATTGGATATGTTGTGGAAATGAGACCAAAAATAGCAGATGCGTCTCCTGATGAAGGCTGGAAACGGTGTAATGCTGCAGCACAGCTTGTACGCAAGGAATTCACTGTTACCAGCTTGGATGAAAACCAGGAATATGAGTTCAGGGTGTGTGCCCAAAACCAAGTTGGTATTGGGCGCCCTGCAGAGCTAAAGGAAGCTATCAAACCTAAAGAAATACTAG
>TTN-209,ENSE00003805661,1,285,2028060,2028344,AACCTCCGGAGATTGATTTGGATGCCAGCATGAGGAAACTGGTCATAGTGAGAGCAGGATGCCCTATTCGTCTCTTTGCTATAGTGAGAGGACGACCAGCCCCTAAAGTCACTTGGCGAAAAGTTGGCATTGATAATGTGGTCAGAAAAGGACAAGTTGATCTGGTTGACACTATGGCCTTCCTTGTCATCCCCAATTCTACCCGTGATGACTCAGGAAAATATTCCTTAACACTTGTGAACCCAGCAGGAGAAAAGGCTGTATTCGTAAATGTCAGAGTATTAG
>TTN-209,ENSE00003804742,1,300,2028345,2028644,ACACTCCTGGGCCTGTGTCTGATTTAAAAGTTTCAGATGTCACTAAAACATCATGCCATGTGTCCTGGGCCCCTCCTGAAAACGACGGTGGGAGCCAAGTGACACATTATATCGTGGAGAAACGTGAGGCAGACAGAAAGACATGGTCGACCGTTACCCCAGAAGTTAAGAAAACAAGCTTCCATGTAACCAATCTTGTCCCTGGGAATGAGTATTACTTCAGAGTAACTGCTGTCAACGAATATGGCCCTGGCGTCCCAACAGATGTCCCAAAACCAGTGCTTGCATCAGATCCTCTAA
>TTN-209,ENSE00003810357,1,303,2028645,2028947,GTGAGCCGGATCCCCCAAGGAAATTAGAAGTGACTGAAATGACCAAGAACAGTGCCACCTTAGCCTGGTTACCTCCCCTACGTGATGGAGGTGCTAAAATCGATGGCTACATCACTAGTTACAGAGAAGAAGAGCAGCCTGCAGATCGCTGGACAGAGTACTCAGTGGTAAAAGATCTGAGCCTTGTTGTCACTGGCCTAAAGGAAGGAAAGAAATACAAATTTAGAGTAGCGGCCAGAAATGCTGTTGGAGTCAGTTTGCCAAGAGAAGCTGAAGGAGTGTATGAAGCCAAAGAACAACTGT
>TTN-209,ENSE00003801707,1,276,2028948,2029223,TGCCACCAAAGATCCTTATGCCAGAGCAAATAACTATCAAAGCTGGGAAAAAACTCCGAATTGAAGCCCATGTGTATGGAAAGCCTCATCCCACCTGTAAATGGAAAAAAGGAGAAGATGAAGTTGTCACATCCAGCCACCTGGCAGTGCATAAAGCAGACAGCTCTTCAATTCTGATCATAAAAGATGTGACTAGGAAAGACAGTGGTTACTACAGCCTCACAGCAGAGAACAGTTCTGGGACAGACACTCAGAAAATCAAAGTTGTAGTCATGG
>TTN-209,ENSE00003810399,1,300,2029224,2029523,ATGCCCCCGGCCCCCCTCAGCCTCCATTTGACATTTCTGATATAGACGCTGATGCTTGCTCCCTGTCATGGCACATCCCTCTGGAGGACGGAGGCAGTAACATCACCAATTATATAGTGGAGAAGTGTGATGTAAGCCGAGGTGACTGGGTCACGGCTCTAGCTTCAGTCACAAAAACTTCCTGCAGGGTTGGAAAGCTGATCCCAGGCCAGGAGTACATCTTCCGGGTCCGTGCTGAAAACCGATTTGGCATTTCAGAGCCTCTCACATCTCCAAAGATGGTTGCGCAGTTCCCATTTG
>TTN-209,ENSE00003810448,1,303,2029524,2029826,GTGTTCCTAGTGAACCAAAGAATGCACGAGTCACCAAAGTCAACAAGGACTGTATTTTTGTTGCTTGGGACAGACCAGATAGTGATGGAGGGAGCCCCATTATTGGTTATCTGATTGAACGCAAGGAAAGAAACAGTTTGCTGTGGGTGAAAGCCAATGATACTCTTGTCCGGTCAACTGAATATCCTTGTGCTGGCCTTGTAGAAGGTCTTGAGTATTCATTCAGAATCTATGCCCTAAACAAAGCTGGATCCAGCCCACCCAGCAAACCCACAGAATATGTAACTGCAAGAATGCCAGTTG
>TTN-209,ENSE00003802505,1,300,2029827,2030126,ATCCTCCTGGGAAACCTGAGGTTATTGATGTCACCAAGAGTACTGTATCTCTGATCTGGGCTCGTCCAAAGCATGATGGAGGCAGTAAAATTATTGGCTATTTCGTAGAAGCTTGCAAACTTCCTGGTGATAAATGGGTACGGTGCAATACTGCACCTCACCAGATTCCCCAGGAAGAGTACACAGCTACTGGCCTAGAAGAGAAAGCTCAGTATCAATTTAGAGCTATTGCCAGGACCGCGGTAAACATTAGCCCACCTTCTGAACCTTCTGATCCAGTGACTATCCTCGCAGAAAATG
>TTN-209,ENSE00003806397,1,288,2030127,2030414,TCCCTCCCAGGATAGACCTGAGTGTGGCTATGAAATCTTTGCTTACTGTGAAAGCTGGAACTAATGTCTGCTTGGATGCTACTGTTTTTGGTAAACCGATGCCAACAGTTTCTTGGAAAAAAGATGGCACACTGCTAAAACCAGCAGAAGGCATAAAGATGGCCATGCAGCGGAATCTGTGCACCTTGGAGCTATTCAGCGTGAACCGGAAGGACTCAGGAGACTATACCATTACTGCTGAAAATTCAAGTGGTTCTAAATCAGCCACCATTAAGCTTAAAGTGTTAG
>TTN-209,ENSE00003807889,1,297,2030415,2030711,ATAAACCGGGTCCTCCAGCATCTGTTAAAATCAACAAAATGTATTCAGATCGTGCTATGCTTTCTTGGGAACCGCCTCTTGAAGATGGAGGCTCAGAAATCACCAACTATATTGTTGACAAACGTGAAACAAGCAGGCCCAACTGGGCTCAAGTCTCTGCAACTGTGCCTATCACCAGCTGCAGCGTGGAGAAACTTATAGAGGGCCATGAGTATCAGTTCCGTATTTGTGCTGAAAATAAATATGGAGTAGGCGATCCAGTCTTCACTGAACCAGCAATTGCCAAAAACCCATATG
>TTN-209,ENSE00003811290,1,303,2030712,2031014,ACCCACCAGGACGCTGTGATCCTCCTGTTATTAGCAACATAACCAAAGATCACATGACAGTCAGCTGGAAGCCACCAGCAGATGATGGGGGCTCACCCATCACTGGCTATTTGCTTGAAAAGCGGGAAACCCAGGCTGTTAACTGGACTAAGGTCAACAGAAAACCTATTATAGAAAGAACATTAAAAGCAACAGGTCTTCAAGAAGGTACCGAATATGAGTTCCGTGTTACAGCTATAAATAAAGCTGGACCAGGCAAACCCAGTGACGCATCCAAGGCCGCTTATGCTCGGGACCCTCAGT
>TTN-209,ENSE00003808853,1,306,2031015,2031320,ATCCTCCTGGCCCACCGGCTTTCCCTAAAGTATATGATACAACTCGCAGCTCTGTGAGTCTATCTTGGGGCAAGCCAGCCTATGACGGCGGCAGCCCTATCATTGGTTATCTCGTTGAAGTAAAACGGGCTGACTCCGATAACTGGGTGAGGTGCAACTTACCACAGAATCTACAGAAAACCCGCTTTGAGGTTACTGGCCTGATGGAAGACACACAATATCAATTCCGTGTGTATGCCGTTAATAAGATTGGATACAGTGACCCCAGTGATGTGCCAGATAAACACTATCCCAAGGACATCTTAA
>TTN-209,ENSE00003807542,1,288,2031321,2031608,TTCCACCTGAGGGAGAACTTGATGCGGACTTAAGGAAGACACTCATATTACGTGCTGGAGTTACTATGAGACTATATGTACCAGTAAAAGGACGCCCACCTCCAAAGATTACTTGGTCTAAACCAAATGTCAATCTAAGAGACAGGATTGGACTGGACATAAAGTCAACTGACTTTGACACTTTCTTGCGCTGTGAAAATGTGAACAAATATGATGCAGGAAAATATATCTTAACCCTGGAGAACAGCTGTGGTAAAAAGGAATATACCATTGTTGTGAAAGTGCTTG
>TTN-209,ENSE00003810775,1,291,2031609,2031899,ATACTCCTGGGCCACCTGTCAATGTGACTGTTAAGGAAATATCCAAAGACTCTGCTTATGTTACCTGGGAGCCTCCCATTATTGATGGCGGAAGCCCCATCATAAACTATGTGGTACAAAAACGTGATGCAGAGAGGAAATCCTGGTCTACAGTGACAACTGAGTGCTCCAAAACAAGCTTCAGAGTAGCTAATTTGGAGGAGGGAAAATCCTACTTCTTCCGAGTGTTTGCTGAAAATGAGTATGGCATTGGTGATCCCGGTGAAACTCGTGATGCTGTCAAAGCTTCCC
>TTN-209,ENSE00003811210,1,288,2031900,2032187,AAACTCCTGGACCAGTTGTGGACCTGAAAGTGAGGTCTGTATCTAAGTCATCCTGTAGCATTGGCTGGAAAAAGCCTCACAGTGATGGTGGAAGTCGGATTATTGGATATGTAGTTGATTTCCTGACTGAAGAAAATAAGTGGCAACGAGTTATGAAATCCTTAAGCCTACAGTACTCTGCAAAAGATTTGACTGAAGGGAAGGAATATACCTTCAGAGTGAGTGCTGAGAATGAAAATGGAGAAGGAACCCCAAGCGAAATCACTGTTGTGGCAAGGGATGATGTTG
>TTN-209,ENSE00003805436,1,588,2032188,2032775,TGGCTCCTGATCTTGACTTAAAGGGTCTACCTGATTTGTGCTACTTGGCTAAAGAAAACAGCAACTTCCGGCTTAAGATCCCCATAAAAGGCAAGCCAGCTCCATCAGTCTCCTGGAAGAAAGGGGAAGATCCTCTAGCAACTGACACTAGAGTCAGTGTTGAGTCATCTGCGGTTAACACAACTCTTATAGTGTACGATTGCCAAAAATCTGATGCTGGAAAATACACAATCACACTTAAGAATGTTGCTGGCACCAAGGAAGGAACTATCTCCATAAAGGTTGTTGGCAAGCCTGGCATCCCCACTGGACCAATCAAATTTGATGAAGTCACAGCAGAAGCCATGACCTTAAAGTGGGCTCCTCCAAAGGATGATGGAGGTTCTGAAATCACCAACTATATCCTAGAGAAGAGGGATTCTGTGAACAACAAGTGGGTGACGTGCGCCTCAGCTGTCCAGAAAACCACCTTTAGAGTAACCAGACTTCATGAGGGCATGGAATATACCTTCAGGGTCAGTGCCGAAAATAAATATGGTGTAGGGGAAGGCCTGAAATCGGAGCCAATTGTTGCGAGACATCCATTTG
>TTN-209,ENSE00003808777,1,105,2032776,2032880,ATGTGCCTGATGCTCCCCCACCTCCCAATATTGTGGATGTCAGACACGATTCAGTATCTCTAACTTGGACTGACCCCAAGAAAACTGGTGGTTCTCCAATTACAG
>TTN-209,ENSE00003806939,1,198,2032881,2033078,GGTATCATCTCGAGTTCAAGGAAAGAAACAGCCTTTTGTGGAAGAGAGCTAACAAGACTCCGATAAGGATGAGAGACTTTAAAGTGACAGGATTAACTGAAGGTCTTGAATATGAATTCCGAGTTATGGCAATCAATTTAGCAGGTGTGGGCAAGCCAAGCCTACCATCAGAGCCTGTTGTGGCACTGGACCCAATTG
>TTN-209,ENSE00003811024,1,297,2033079,2033375,ATCCTCCTGGAAAACCTGAGGTTATTAACATAACAAGGAATTCAGTGACTCTCATTTGGACTGAACCTAAATATGACGGTGGTCATAAGTTAACTGGATATATAGTGGAGAAGCGAGATCTACCTTCGAAGTCTTGGATGAAAGCCAACCATGTTAATGTCCCAGAATGTGCCTTTACTGTAACTGACCTTGTTGAGGGTGGAAAATATGAATTCAGAATTAGAGCAAAGAATACAGCAGGTGCTATCAGTGCTCCATCAGAAAGTACAGAAACCATTATTTGCAAGGATGAATACG
>TTN-209,ENSE00003803896,1,588,2033376,2033963,AGGCACCAACAATTGTCCTTGATCCCACAATAAAAGATGGGCTAACAATTAAAGCAGGGGATACCATTGTTTTGAATGCCATTAGCATTCTTGGCAAACCCCTTCCAAAATCAAGTTGGTCCAAGGCAGGAAAAGACATTAGACCATCAGATATCACTCAGATAACTTCAACCCCAACATCTTCCATGCTTACTATCAAGTATGCCACTAGAAAAGATGCGGGTGAATATACCATCACTGCTACCAATCCTTTTGGCACGAAGGTGGAACATGTGAAGGTAACAGTCCTTGATGTACCTGGTCCCCCAGGTCCTGTTGAAATCAGTAATGTTTCTGCTGAAAAAGCAACACTTACATGGACACCTCCCTTGGAAGATGGCGGCTCACCAATTAAGTCCTATATACTTGAAAAGAGAGAAACCAGCCGACTTTTGTGGACAGTGGTTTCTGAAGATATTCAGTCTTGCAGGCATGTGGCAACCAAACTTATCCAAGGAAATGAGTACATCTTCCGGGTCTCAGCTGTAAACCACTATGGCAAAGGAGAACCTGTACAGTCTGAACCTGTCAAAATGGTAGACAGATTTG
>TTN-209,ENSE00003807419,1,303,2033964,2034266,GTCCCCCTGGCCCTCCTGAAAAACCAGAGGTATCAAATGTCACTAAGAACACTGCCACTGTCAGCTGGAAAAGGCCAGTGGATGATGGTGGCAGCGAAATTACAGGATATCATGTAGAAAGGAGAGAAAAGAAAAGCCTGCGATGGGTGAGAGCAATAAAAACACCAGTTTCCGATCTCAGGTGCAAAGTAACAGGACTGCAAGAAGGAAGCACCTACGAATTCCGTGTCAGTGCAGAAAACAGAGCAGGAATTGGTCCACCCAGTGAGGCTTCAGATTCTGTTCTGATGAAAGATGCAGCAT
>TTN-209,ENSE00003811193,1,17106,2034267,2051372,ATCCTCCAGGACCACCTTCAAATCCGCATGTCACTGATACTACCAAGAAATCTGCTTCTTTGGCATGGGGCAAGCCTCATTATGATGGTGGACTTGAAATCACTGGCTATGTCGTGGAGCATCAAAAAGTAGGAGACGAGGCCTGGATAAAAGATACCACAGGAACCGCCCTCAGAATCACTCAGTTCGTTGTTCCTGATCTTCAGACTAAAGAAAAATACAACTTCAGAATCAGTGCCATCAACGATGCAGGTGTTGGGGAGCCAGCGGTGATTCCAGATGTTGAAATCGTAGAACGGGAGATGGCTCCTGATTTTGAACTAGATGCCGAGCTTCGAAGAACACTTGTTGTTAGAGCAGGACTCAGTATTAGGATATTTGTGCCAATTAAAGGTCGTCCTGCTCCTGAAGTGACATGGACCAAAGATAACATCAACCTGAAAAACCGAGCCAACATTGAAAATACGGAATCATTTACTCTTCTGATTATCCCAGAATGTAACAGATATGATACCGGTAAATTTGTCATGACCATTGAAAACCCGGCTGGGAAGAAAAGTGGCTTTGTGAACGTCAGAGTCTTGGACACGCCAGGCCCAGTCCTCAACCTGCGGCCTACAGACATCACAAAGGACAGTGTCACCCTGCACTGGGACCTCCCTCTGATAGATGGAGGCTCACGTATAACAAACTACATTGTAGAGAAACGTGAAGCAACACGGAAATCTTATTCCACAGCCACCACTAAGTGCCATAAATGCACATATAAAGTTACCGGCTTGTCTGAAGGGTGTGAATATTTCTTCAGAGTGATGGCAGAGAATGAATATGGAATTGGTGAGCCAACAGAAACTACAGAGCCCGTAAAAGCCTCTGAAGCACCATCTCCACCAGACAGCCTTAACATCATGGACATAACTAAGAGCACCGTCAGCCTGGCATGGCCTAAGCCCAAACACGATGGTGGCAGCAAGATCACTGGCTATGTGATTGAAGCCCAAAGAAAAGGCTCTGACCAGTGGACCCACATCACAACCGTGAAAGGGTTAGAATGTGTTGTGAGGAATCTAACTGAAGGAGAGGAATATACCTTCCAAGTGATGGCAGTGAACAGCGCGGGGAGAAGTGCCCCTAGAGAAAGCAGACCCGTCATTGTCAAGGAGCAGACAATGCTTCCAGAGCTGGATCTCCGTGGCATCTATCAGAAACTGGTCATTGCCAAAGCTGGTGACAACATCAAAGTTGAAATTCCAGTGCTCGGTCGACCGAAGCCCACAGTGACATGGAAAAAAGGAGACCAAATTCTTAAACAGACACAGAGAGTTAATTTTGAAACCACAGCGACTTCAACCATTTTAAATATCAATGAGTGTGTCAGAAGTGATAGTGGGCCCTATCCATTAACAGCAAGGAACATTGTAGGAGAGGTTGGTGATGTCATCACCATTCAAGTCCATGATATCCCAGGGCCACCTACTGGACCAATCAAATTTGATGAAGTTTCATCTGATTTTGTAACCTTCTCTTGGGACCCACCTGAGAACGATGGTGGTGTACCAATAAGCAACTATGTAGTGGAAATGCGGCAGACTGACAGTACTACCTGGGTTGAGTTAGCAACCACCGTTATACGTACTACCTATAAAGCCACCCGCCTTACTACTGGATTAGAGTATCAGTTCCGTGTAAAAGCTCAGAATAGATATGGAGTTGGACCAGGCATCACATCAGCATGCATAGTTGCCAACTATCCATTTAAGGTTCCTGGACCTCCTGGTACCCCTCAGGTAACTGCAGTTACCAAGGATTCAATGACAATTAGCTGGCATGAGCCACTTTCTGATGGTGGAAGCCCCATTTTAGGATATCATGTTGAAAGAAAAGAACGAAATGGTATTCTCTGGCAGACTGTGAGCAAAGCTTTAGTACCAGGCAACATTTTCAAATCAAGTGGACTTACAGATGGTATTGCTTATGAGTTCCGGGTGATTGCAGAAAACATGGCAGGCAAAAGTAAGCCAAGCAAGCCATCAGAACCTATGTTGGCTCTGGATCCCATTGACCCACCTGGAAAACCAGTACCTCTAAATATTACAAGACACACAGTAACACTTAAATGGGCTAAGCCTGAATATACTGGGGGCTTTAAAATTACCAGTTATATCGTTGAAAAGAGAGACCTTCCTAATGGACGGTGGCTGAAGGCCAACTTCAGCAACATTTTGGAGAATGAATTTACAGTCAGTGGCCTAACAGAAGATGCTGCATATGAATTCCGTGTGATCGCCAAAAATGCTGCAGGTGCCATCAGTCCACCATCTGAGCCATCTGATGCTATCACTTGCAGGGATGATGTTGAGGCACCAAAGATAAAGGTGGATGTTAAATTTAAGGACACGGTTATATTAAAAGCAGGTGAAGCATTCAGACTGGAAGCTGATGTTTCAGGCCGCCCACCTCCAACAATGGAATGGAGCAAAGATGGAAAAGAGCTGGAAGGCACAGCAAAGTTAGAAATAAAAATTGCAGATTTCTCTACTAATCTGGTAAACAAAGATTCAACAAGAAGGGATAGTGGTGCCTATACCCTTACAGCGACTAATCCTGGTGGCTTTGCTAAACACATTTTCAATGTCAAAGTTCTTGACAGACCAGGCCCACCTGAAGGACCTTTGGCTGTAACTGAAGTGACATCAGAAAAGTGTGTACTATCATGGTTCCCTCCACTGGATGATGGAGGTGCCAAAATTGATCATTACATAGTACAGAAACGTGAAACCAGCAGATTGGCATGGACAAATGTAGCCTCAGAAGTCCAAGTAACAAAGCTAAAGGTCACTAAACTCTTGAAAGGCAATGAATACATATTCCGTGTCATGGCTGTAAATAAATATGGAGTGGGAGAGCCACTGGAATCAGAGCCTGTGCTTGCAGTGAATCCTTATGGACCCCCTGATCCGCCCAAAAACCCTGAAGTGACAACTATTACTAAAGATTCGATGGTTGTCTGCTGGGGACATCCTGATTCTGATGGTGGAAGTGAAATCATCAATTATATTGTGGAACGGCGTGATAAAGCTGGCCAACGCTGGATTAAATGCAACAAAAAAACTCTTACTGATTTAAGATATAAAGTGTCTGGACTGACAGAAGGACATGAATATGAGTTCAGGATTATGGCTGAAAATGCTGCTGGAATTAGTGCACCAAGTCCTACCAGTCCATTTTACAAGGCTTGTGACACTGTGTTTAAACCTGGACCACCAGGTAACCCACGTGTTCTGGATACAAGCAGATCATCCATTTCAATCGCTTGGAATAAACCTATCTATGATGGTGGTTCAGAAATCACTGGGTATATGGTTGAGATTGCCCTGCCAGAGGAAGATGAATGGCAGATTGTCACTCCACCAGCAGGACTCAAGGCAACTTCGTATACTATCACTGGCCTCACAGAGAATCAGGAATATAAGATCCGCATCTATGCCATGAATTCCGAAGGACTTGGGGAACCTGCCCTTGTTCCTGGAACTCCAAAGGCTGAAGACAGAATGCTGCCTCCAGAAATTGAACTGGATGCTGACCTGCGCAAAGTTGTTACTATAAGGGCCTGCTGCACCCTGAGACTTTTTGTTCCCATCAAAGGAAGGCCTGCACCTGAGGTGAAGTGGGCCCGGGACCATGGAGAATCTTTAGATAAAGCTAGCATCGAATCCACAAGCTCTTACACCCTGCTTATTGTTGGAAATGTAAACAGATTTGACAGTGGCAAATATATACTAACTGTAGAAAATAGTTCAGGCAGCAAGTCTGCATTTGTCAATGTTAGAGTTCTCGATACACCAGGCCCCCCACAGGATCTGAAGGTAAAAGAGGTCACTAAGACATCTGTCACACTCACATGGGACCCACCTCTCCTTGATGGAGGTTCAAAAATCAAGAACTATATTGTTGAAAAGCGGGAATCAACAAGAAAAGCATATTCAACTGTTGCAACAAACTGCCACAAGACTTCCTGGAAGGTAGACCAGCTTCAAGAAGGCTGTAGCTACTATTTCAGGGTTCTCGCAGAAAATGAATATGGCATTGGGCTGCCTGCTGAAACCGCAGAATCTGTGAAAGCATCAGAACGACCTCTTCCTCCAGGAAAAATAACTTTGATGGATGTCACAAGAAATAGTGTGTCACTCTCTTGGGAGAAACCAGAGCATGATGGAGGCAGCCGAATTCTAGGCTACATTGTGGAGATGCAGACCAAAGGCAGTGACAAATGGGCCACGTGTGCCACAGTCAAGGTCACTGAAGCCACTATCACTGGATTAATTCAGGGTGAAGAATACTCTTTCCGTGTTTCAGCTCAGAATGAAAAGGGCATCAGTGATCCTAGACAACTGAGTGTGCCAGTGATCGCCAAAGATCTTGTCATTCCACCAGCCTTCAAACTCCTGTTCAATACTTTCACTGTACTGGCAGGTGAAGACCTAAAAGTTGATGTTCCATTCATTGGCCGCCCTACCCCAGCTGTAACCTGGCATAAAGATAATGTACCACTGAAGCAGACAACTAGAGTAAATGCAGAGAGCACAGAAAATAATTCACTACTGACAATAAAGGACGCCTGCCGAGAAGATGTTGGCCATTATGTGGTTAAACTGACTAACTCAGCTGGTGAAGCTATTGAAACCCTTAATGTTATCGTTCTTGACAAACCAGGGCCTCCAACTGGACCAGTTAAAATGGATGAAGTGACAGCTGATAGTATTACTCTTTCCTGGGGCCCACCCAAGTATGATGGTGGAAGTTCTATCAATAATTACATTGTTGAGAAACGGGACACTTCCACAACCACCTGGCAAATTGTATCAGCTACAGTTGCAAGGACAACAATAAAGGCTTGCAGACTGAAGACTGGATGTGAATATCAGTTTAGAATTGCAGCTGAAAACAGATATGGGAAGAGTACCTACCTCAATTCAGAGCCTACTGTAGCCCAATATCCATTCAAAGTTCCTGGTCCTCCTGGCACTCCAGTTGTCACACTGTCCTCCAGGGACAGCATGGAAGTACAATGGAATGAGCCAATCAGTGATGGAGGAAGTAGAGTCATTGGCTATCATCTAGAACGCAAGGAAAGAAATAGCATCCTCTGGGTTAAGTTGAATAAAACACCTATTCCTCAAACCAAGTTTAAGACAACTGGCCTTGAAGAAGGTGTTGAATATGAATTTAGAGTCTCTGCAGAGAACATCGTGGGCATTGGCAAGCCGAGTAAAGTATCAGAATGTTATGTGGCTCGTGACCCATGTGATCCACCAGGACGGCCAGAGGCAATCATTGTCACAAGGAATTCTGTGACTCTTCAGTGGAAGAAACCCACCTATGACGGTGGAAGCAAGATCACTGGTTATATTGTTGAGAAGAAAGAATTACCTGAGGGCCGTTGGATGAAAGCCAGTTTTACAAATATTATTGACACTCATTTTGAAGTAACTGGCCTAGTTGAAGATCACAGATATGAGTTCCGGGTTATAGCCCGAAATGCCGCAGGAGTGTTTAGTGAGCCTTCAGAAAGCACAGGAGCAATAACAGCTAGAGATGAGGTAGATCCACCACGAATAAGTATGGATCCAAAATACAAAGACACAATCGTGGTTCATGCTGGTGAATCATTCAAGGTTGATGCAGATATTTATGGCAAACCAATACCAACCATTCAGTGGATAAAAGGTGATCAGGAGCTTTCAAACACAGCTCGATTAGAAATAAAGAGCACCGACTTTGCCACCAGTCTCAGTGTAAAAGATGCAGTACGTGTCGACAGTGGAAATTACATACTGAAGGCCAAAAATGTTGCAGGAGAAAGATCAGTTACTGTGAATGTCAAGGTTCTTGACAGACCAGGGCCACCTGAAGGACCTGTTGTTATCTCAGGAGTTACAGCAGAAAAATGCACACTAGCTTGGAAACCCCCACTTCAGGATGGTGGGAGTGACATCATAAATTATATTGTGGAAAGGAGAGAAACCAGCCGCTTAGTTTGGACTGTGGTTGATGCCAATGTGCAGACTCTCAGCTGCAAGGTTACTAAGCTTCTTGAAGGCAATGAATATACTTTCCGTATAATGGCAGTAAACAAATATGGTGTTGGTGAACCTCTTGAATCTGAGCCAGTAGTTGCCAAGAATCCATTTGTAGTACCAGATGCACCAAAAGCTCCAGAAGTCACAACAGTGACCAAGGACTCAATGATTGTTGTATGGGAAAGACCAGCATCTGATGGTGGTAGTGAAATTCTTGGATATGTTCTTGAGAAACGGGATAAAGAAGGCATTAGATGGACAAGATGCCATAAGCGTCTGATTGGAGAGTTGCGCCTGAGAGTAACTGGACTCATAGAAAATCACGATTATGAGTTCAGAGTTTCTGCTGAGAATGCTGCTGGACTTAGTGAACCAAGCCCTCCTTCTGCTTACCAAAAGGCTTGTGATCCTATTTATAAACCAGGACCCCCAAACAACCCCAAAGTCATAGACATAACCAGATCTTCAGTATTCCTTTCTTGGAGCAAACCAATATATGATGGTGGCTGTGAAATTCAAGGATACATTGTTGAAAAATGTGATGTGAGTGTTGGTGAATGGACAATGTGCACTCCACCAACAGGAATTAATAAAACAAACATAGAAGTAGAGAAGCTGTTGGAAAAGCATGAATACAACTTCCGTATCTGTGCTATTAATAAAGCTGGAGTTGGAGAACATGCTGACGTCCCTGGACCTATTATAGTTGAAGAAAAATTAGAAGCACCAGACATTGATCTTGACCTAGAACTAAGGAAAATCATAAATATAAGGGCAGGTGGCTCCTTAAGGTTATTTGTTCCTATAAAAGGTCGTCCTACACCAGAAGTTAAATGGGGAAAGGTGGATGGTGAAATCCGAGATGCAGCTATAATTGATGTCACTAGCAGTTTCACCTCTCTTGTTCTTGACAATGTCAACCGATATGATAGTGGAAAATATACGCTTACATTAGAAAACAGCAGTGGAACAAAGTCTGCCTTTGTTACTGTGAGAGTTCTGGACACGCCAAGTCCACCTGTTAACCTGAAAGTCACAGAAATCACCAAAGACTCAGTATCAATTACATGGGAACCTCCTTTGTTGGATGGGGGATCCAAAATAAAAAATTACATTGTTGAGAAACGTGAAGCCACAAGAAAATCATATGCTGCTGTTGTAACTAACTGCCATAAGAATTCTTGGAAAATCGATCAGCTCCAAGAAGGTTGCAGTTATTACTTTAGAGTCACAGCTGAGAATGAGTATGGTATTGGCCTTCCTGCCCAGACTGCTGATCCAATTAAGGTTGCAGAAGTGCCACAACCTCCTGGAAAAATAACTGTGGATGATGTCACCAGAAACAGTGTCTCTCTGAGTTGGACAAAACCTGAACATGATGGTGGCAGTAAAATCATTCAGTATATTGTGGAAATGCAAGCTAAACACAGTGAGAAATGGTCAGAGTGTGCTCGAGTAAAGTCTCTTCAGGCAGTAATTACCAACCTAACTCAAGGGGAAGAATATCTTTTTAGAGTTGTTGCTGTAAATGAAAAGGGGAGAAGTGATCCTCGGTCCCTTGCAGTTCCAATAGTTGCCAAAGATCTGGTAATTGAGCCAGATGTAAAACCTGCATTCAGTAGTTACAGTGTACAGGTTGGCCAAGATTTGAAAATAGAAGTGCCAATTTCTGGACGTCCTAAGCCAACCATTACCTGGACTAAAGATGGTCTCCCACTGAAGCAGACCACAAGAATCAATGTTACCGATTCACTGGATCTCACCACACTCAGTATTAAAGAAACTCATAAGGATGATGGTGGACAATATGGAATCACAGTTGCCAATGTTGTTGGTCAGAAGACAGCATCCATCGAAATTGTAACTCTAGATAAACCTGATCCTCCAAAAGGACCTGTTAAATTTGATGACGTCAGTGCTGAAAGTATTACATTATCTTGGAACCCTCCATTATATACAGGGGGCTGCCAAATCACCAACTACATTGTTCAGAAAAGAGATACAACCACCACAGTATGGGATGTTGTTTCTGCTACTGTTGCTAGAACTACACTCAAAGTGACCAAACTGAAAACTGGTACAGAATACCAATTTAGAATATTTGCCGAAAACAGATATGGACAAAGCTTTGCCTTAGAGTCTGATCCAATTGTAGCTCAATATCCCTACAAAGAACCAGGCCCTCCAGGTACACCATTTGCCACAGCCATTTCCAAAGACTCCATGGTCATACAGTGGCATGAACCAGTCAACAATGGTGGAAGCCCCGTCATAGGTTACCACCTGGAGAGAAAAGAAAGAAACAGTATTTTGTGGACAAAGGTCAACAAAACTATTATTCATGACACCCAATTCAAAGCACAGAATCTTGAAGAAGGCATTGAATATGAATTCAGAGTGTATGCTGAAAATATTGTTGGTGTAGGCAAAGCAAGCAAGAATTCTGAATGCTATGTAGCCAGAGATCCCTGTGACCCACCAGGAACCCCAGAACCAATAATGGTTAAAAGAAATGAAATCACTTTACAGTGGACCAAACCTGTGTATGATGGTGGAAGTATGATTACAGGCTACATTGTAGAGAAACGTGATTTGCCTGATGGTCGTTGGATGAAAGCTAGCTTTACAAATGTCATTGAAACTCAATTTACTGTGTCAGGTCTTACTGAAGATCAAAGATATGAATTCAGAGTCATTGCAAAGAATGCAGCTGGTGCAATAAGTAAACCCTCTGACAGTACTGGACCAATAACTGCCAAGGATGAGGTTGAACTCCCAAGAATTTCAATGGATCCAAAATTCAGAGACACAATTGTGGTAAATGCTGGAGAAACATTCAGACTTGAGGCTGATGTCCATGGAAAGCCCCTACCTACCATTGAGTGGTTAAGAGGAGATAAGGAAATTGAAGAATCTGCTAGATGTGAAATAAAGAACACAGATTTCAAGGCTTTACTTATTGTAAAAGATGCAATTAGAATTGATGGTGGGCAGTATATTTTAAGAGCTTCCAATGTTGCAGGTTCTAAGTCATTCCCAGTAAATGTAAAAGTATTAGATAGACCAGGACCTCCAGAAGGGCCAGTCCAGGTTACTGGAGTCACTTCTGAAAAATGCTCTTTAACATGGTCTCCACCACTTCAAGATGGTGGCAGTGACATTTCTCACTATGTTGTTGAAAAGCGAGAAACCAGTCGACTTGCCTGGACTGTTGTTGCTTCAGAAGTTGTGACCAATTCTCTGAAAGTTACCAAACTCTTAGAAGGTAATGAATATGTTTTCCGTATAATGGCTGTCAACAAATATGGTGTTGGAGAGCCTTTGGAATCTGCACCAGTACTAATGAAAAATCCATTTGTGCTTCCTGGACCACCAAAAAGCTTGGAAGTCACAAATATTGCCAAAGACTCCATGACCGTCTGTTGGAACCGTCCAGATAGTGATGGTGGAAGTGAGATTATTGGTTACATTGTAGAGAAAAGAGACAGAAGTGGCATTCGATGGATAAAATGTAATAAACGCCGCATTACAGATTTGCGTCTAAGAGTGACAGGATTAACAGAAGATCATGAGTATGAATTCAGGGTCTCTGCAGAAAATGCTGCTGGAGTTGGGGAACCAAGTCCAGCTACAGTTTATTATAAAGCCTGTGATCCTGTGTTCAAACCTGGCCCACCTACCAATGCACACATTGTAGACACCACTAAAAATTCAATCACACTTGCCTGGGGTAAACCCATCTATGATGGCGGCAGTGAGATCTTGGGATATGTAGTAGAAATCTGTAAAGCAGATGAAGAAGAATGGCAAATAGTTACTCCACAGACTGGCCTGAGAGTCACTCGATTTGAAATTTCAAAACTCACTGAACACCAAGAGTATAAAATACGAGTCTGTGCCCTCAACAAAGTTGGTTTAGGTGAGGCTACATCAGTTCCTGGTACTGTGAAACCAGAAGATAAACTTGAAGCACCTGAACTTGACCTTGACTCCGAATTAAGAAAAGGAATTGTTGTAAGAGCTGGTGGATCTGCCAGAATTCACATTCCATTCAAAGGTCGTCCAACGCCTGAGATCACTTGGTCTCGAGAGGAAGGTGAATTCACAGATAAGGTCCAAATTGAAAAGGGAGTAAACTATACCCAACTATCAATAGATAACTGTGATAGAAATGATGCTGGAAAATACATTCTTAAGTTGGAAAACAGCAGTGGATCAAAGTCTGCTTTTGTAACTGTGAAAGTTCTTGACACTCCAGGACCACCACAGAATTTGGCAGTCAAAGAAGTGAGAAAAGATTCTGCCTTCCTGGTATGGGAGCCACCCATCATTGATGGAGGGGCAAAGGTCAAGAACTATGTGATTGACAAACGTGAGTCAACCAGAAAAGCGTATGCTAATGTGAGTAGTAAATGCAGCAAAACAAGTTTTAAAGTGGAAAACCTTACAGAAGGAGCCATTTATTACTTCAGAGTCATGGCTGAAAATGAATTTGGAGTTGGTGTTCCAGTGGAAACTGTTGATGCCGTGAAAGCTGCTGAACCTCCTTCCCCACCAGGAAAGGTTACACTCACTGATGTGTCCCAGACCAGTGCATCACTTATGTGGGAGAAACCTGAACATGATGGCGGTAGCAGAGTCCTGGGGTACGTTGTTGAAATGCAGCCCAAAGGAACTGAAAAATGGAGCATTGTGGCTGAATCCAAAGTCTGTAATGCAGTTGTTACTGGTTTGAGTTCTGGACAAGAATATCAGTTCCGTGTCAAGGCTTATAATGAGAAAGGAAAAAGCGATCCAAGAGTGTTGGGTGTTCCTGTCATAGCCAAGGACTTGACTATACAGCCTAGTTTAAAGTTACCATTTAACACATATAGTATCCAAGCTGGAGAAGATCTTAAAATAGAAATTCCAGTTATAGGCCGACCAAGACCTAACATTTCTTGGGTCAAAGATGGTGAGCCTCTTAAACAGACAACAAGAGTAAACGTTGAAGAAACAGCTACCTCAACTGTTTTGCACATTAAAGAAGGTAACAAAGATGACTTTGGAAAATACACCGTAACGGCAACAAATAGTGCAGGCACAGCAACAGAAAATCTCAGTGTTATCGTTTTAGAAAAGCCTGGACCTCCAGTTGGCCCAGTTCGGTTTGATGAAGTTAGTGCAGACTTTGTAGTCATATCTTGGGAACCTCCAGCCTATACTGGTGGCTGCCAAATAAGCAACTACATTGTAGAGAAGCGAGATACAACCACCACCACTTGGCACATGGTATCAGCAACAGTTGCAAGAACAACAATTAAAATAACCAAACTGAAAACAGGCACGGAGTACCAGTTTAGAATTTTTGCTGAAAACAGGTATGGAAAAAGTGCCCCACTGGATTCTAAGGCAGTTATTGTACAATATCCATTTAAAGAACCTGGACCACCTGGAACTCCTTTTGTGACATCAATCTCAAAAGATCAGATGCTTGTGCAATGGCATGAGCCAGTGAATGATGGAGGCACCAAAATTATTGGCTACCATCTTGAACAGAAAGAAAAGAACAGTATTTTATGGGTCAAGTTAAATAAGACCCCCATTCAGGACACCAAATTCAAAACAACTGGGCTTGATGAGGGCCTTGAGTATGAGTTCAAAGTTTCTGCTGAAAATATTGTTGGCATTGGCAAGCCTAGCAAAGTGTCAGAATGCTTTGTTGCTCGTGATCCATGTGACCCACCTGGTCGCCCTGAAGCCATTGTTATTACAAGAAACAATGTCACACTGAAATGGAAGAAACCTGCCTATGATGGTGGTAGCAAAATAACAGGTTATATTGTAGAAAAGAAAGATCTACCTGATGGCCGCTGGATGAAAGCCAGCTTTACCAACGTATTAGAAACTGAATTTACAGTGAGTGGACTTGTAGAAGACCAAAGATATGAATTTAGAGTAATTGCAAGAAATGCAGCTGGAAACTTTAGTGAACCATCTGATAGTAGTGGTGCCATTACTGCAAGAGATGAAATTGATGCACCAAATGCCTCTCTGGATCCAAAATATAAAGATGTCATCGTTGTTCATGCAGGAGAGACTTTTGTTCTTGAAGCCGACATCCGTGGCAAACCTATACCTGATGTTGTTTGGTCAAAAGATGGAAAAGAACTTGAAGAAACAGCTGCTAGAATGGAAATTAAATCTACTATTCAGAAAACAACTCTTGTTGTCAAAGACTGTATACGGACTGATGGAGGACAATATATTCTGAAACTCAGCAATGTTGGTGGTACAAAGTCTATACCCATCACTGTAAAGGTACTTGACAGGCCAGGGCCTCCTGAAGGGCCTCTGAAAGTTACTGGAGTTACTGCGGAAAAATGTTACCTGGCATGGAACCCACCTTTGCAAGATGGTGGTGCTAATATTTCACATTACATCATTGAAAAGAGGGAGACAAGCCGACTCTCTTGGACCCAGGTTTCAACTGAGGTACAGGCCCTTAACTACAAAGTTACTAAACTTCTTCCTGGTAATGAGTACATTTTCCGTGTCATGGCTGTGAATAAATATGGAATTGGAGAGCCCTTGGAATCTGGGCCTGTTACGGCCTGTAATCCTTATAAGCCACCAGGTCCTCCCTCAACACCTGAAGTCTCAGCAATCACCAAAGATTCTATGGTAGTAACATGGGCACGCCCAGTAGACGACGGAGGTACCGAAATTGAGGGCTACATTCTTGAAAAACGAGATAAGGAAGGCGTTAGATGGACCAAGTGCAACAAGAAAACATTAACGGATCTGCGGCTCAGGGTAACTGGTCTTACCGAAGGCCATTCCTATGAATTCAGAGTTGCTGCTGAAAATGCAGCTGGTGTGGGAGAACCTAGTGAGCCATCTGTTTTCTACCGTGCGTGTGATGCCTTGTATCCACCAGGTCCCCCAAGCAATCCAAAAGTGACGGACACTTCCAGATCTTCTGTCTCCCTGGCATGGAGTAAGCCAATTTATGATGGTGGCGCACCTGTTAAAGGCTATGTTGTAGAGGTCAAAGAAGCTGCTGCGGATGAATGGACAACCTGCACTCCACCAACAGGATTACAAGGAAAGCAGTTCACAGTGACCAAGCTTAAAGAAAACACTGAATATAACTTCCGTATTTGTGCCATCAATTCTGAAGGTGTAGGTGAACCTGCAACTCTACCTGGCTCAGTGGTTGCTCAGGAGAGGATAGAGCCACCAGAAATAGAACTCGATGCTGATCTCAGAAAGGTGGTCGTTCTGCGTGCAAGTGCTACTTTACGCTTATTTGTCACTATCAAAGGTCGACCAGAACCCGAAGTTAAATGGGAAAAGGCAGAAGGCATTCTCACTGACAGGGCTCAGATAGAGGTGACCAGCTCATTTACAATGTTGGTGATTGATAATGTTACCAGATTTGACAGTGGTCGGTATAATCTGACATTAGAAAATAATAGTGGCTCCAAAACAGCTTTTGTTAACGTCAGAGTTCTTGACTCACCAAGTGCCCCTGTGAATTTGACCATAAGAGAAGTGAAGAAAGACTCAGTGACGTTGTCCTGGGAACCACCACTTATTGATGGTGGAGCTAAGATTACAAACTACATTGTCGAAAAACGAGAAACTACAAGAAAAGCCTATGCTACCATTACAAATAATTGCACTAAAACTACTTTCAGAATTGAAAATCTACAAGAAGGATGTTCTTACTACTTCCGAGTCTTGGCTTCCAATGAATATGGGATTGGTTTGCCAGCTGAAACAACAGAACCCGTTAAAGTGTCTGAACCACCCCTCCCACCTGGAAGAGTAACTCTTGTTGATGTGACCCGTAATACAGCTACAATTAAGTGGGAGAAACCAGAAAGTGATGGTGGCAGCAAAATTACTGGTTATGTGGTTGAAATGCAGACTAAAGGGAGTGAAAAGTGGAGCACCTGCACACAAGTTAAGACTCTAGAAGCAACTATATCTGGCTTAACTGCAGGAGAAGAGTATGTCTTCAGGGTAGCTGCAGTTAACGAAAAGGGAAGAAGTGATCCAAGACAACTTGGAGTGCCAGTAATTGCAAGGGATATTGAAATAAAGCCTTCAGTTGAGCTTCCTTTCCATACTTTCAATGTAAAGGCTAGAGAACAACTTAAGATTGATGTGCCATTCAAAGGAAGACCTCAAGCTACTGTGAACTGGAGAAAAGATGGTCAGACTCTTAAAGAGACAACTAGAGTCAATGTTTCTTCTTCAAAGACTGTAACATCACTATCTATTAAGGAAGCTTCAAAGGAAGATGTTGGAACTTATGAATTATGTGTTTCAAACAGTGCTGGATCCATAACAGTTCCTATTACTATAATTGTCCTTGACAGACCAGGACCTCCAGGTCCTATACGTATTGATGAGGTTAGTTGTGACAGCATAACCATTTCTTGGAATCCTCCAGAATATGATGGTGGCTGCCAAATTAGCAATTACATTGTTGAAAAGAAAGAAACCACCTCTACAACATGGCACATAGTTTCACAAGCAGTTGCAAGAACATCCATTAAAATAGTTCGCCTGACAACAGGAAGTGAGTATCAGTTCCGTGTTTGTGCAGAAAACCGCTATGGAAAGAGCTCCTACAGTGAATCTTCAGCTGTTGTTGCAGAGTATCCATTCAGTCCCCCAGGTCCTCCTGGTACTCCTAAAGTTGTGCATGCCACAAAATCTACCATGCTTGTAACCTGGCAAGTGCCAGTTAATGATGGAGGAAGTCGAGTAATTGGCTATCATCTTGAGTATAAAGAAAGAAGCAGCATTCTTTGGTCAAAAGCAAATAAAATCCTCATTGCTGATACTCAAATGAAAGTCTCCGGCCTTGATGAAGGACTGATGTATGAGTATCGTGTATATGCTGAAAATATTGCTGGAATTGGTAAATGCAGTAAATCTTGTGAACCAGTCCCTGCAAGAGATCCTTGTGACCCTCCTGGACAACCTGAAGTCACAAATATCACAAGAAAATCAGTGTCACTTAAATGGTCTAAACCACATTATGATGGTGGAGCTAAGATCACAGGATACATTGTTGAACGCAGAGAACTACCAGATGGCCGGTGGCTGAAGTGCAATTATACTAATATACAAGAAACATACTTTGAAGTAACTGAACTTACTGAAGATCAGCGTTATGAATTCCGGGTTTTTGCAAGGAATGCTGCTGACTCAGTTAGTGAGCCATCTGAATCCACTGGGCCTATTATAGTTAAAGATGATGTTGAGCCTCCAAGAGTTATGATGGATGTCAAGTTCCGAGACGTTATTGTTGTCAAAGCTGGAGAGGTCCTTAAGATAAATGCAGACATTGCAGGGCGACCTCTGCCAGTAATTTCCTGGGCCAAGGATGGTATAGAAATTGAAGAAAGAGCAAGAACAGAAATCATCTCAACAGACAATCATACTTTGTTAACAGTTAAAGACTGTATAAGACGAGACACTGGGCAATATGTACTAACACTGAAGAATGTTGCCGGCACTCGGTCTGTGGCCGTTAATTGCAAAGTACTTGATAAGCCTGGTCCACCAGCAGGACCACTTGAAATAAATGGCCTCACTGCTGAGAAATGCTCTCTTTCCTGGGGACGTCCCCAAGAAGATGGTGGTGCAGATATCGACTATTACATCGTAGAAAAACGTGAAACAAGCCACCTTGCATGGACAATATGTGAAGGAGAGTTACAGATGACATCCTGTAAAGTAACCAAGTTACTCAAAGGCAATGAATATATATTTAGAGTAACTGGTGTTAATAAATATGGTGTTGGTGAGCCCCTAGAGAGTGTAGCTATAAAGGCACTAGATCCATTTACAGTTCCAAGTCCACCCACGTCTTTGGAAATTACTTCTGTGACCAAAGAATCTATGACACTTTGCTGGTCAAGACCCGAGAGTGATGGAGGTAGTGAAATATCTGGATATATAATTGAAAGGCGAGAGAAAAATAGCCTAAGATGGGTGCGTGTAAACAAAAAACCAGTTTATGATCTAAGAGTGAAATCAACAGGACTTCGGGAAGGATGTGAATATGAATATCGTGTTTATGCAGAAAATGCTGCTGGCCTAAGTCTTCCAAGTGAAACCTCTCCCTTAATTAGGGCAGAAGATCCAGTGTTCCTACCATCTCCTCCATCCAAACCCAAAATTGTGGACTCAGGCAAGACAACTATAACTATTGCCTGGGTTAAGCCGCTGTTTGATGGTGGGGCCCCGATAACTGGATATACTGTAGAATACAAAAAATCTGATGACACTGACTGGAAAACTTCCATTCAGAGCTTACGAGGGACAGAATATACAATAAGCGGACTAACAACAGGAGCTGAATATGTTTTCAGAGTAAAATCTGTCAATAAGGTTGGTGCTAGTGACCCCAGTGATAGCTCTGACCCTCAGATAGCAAAGGAAAGAGAAGAAGAACCTTTATTTGATATTGACAGTGAAATGAGGAAGACCTTGATTGTCAAGGCTGGTGCCTCATTTACCATGACTGTGCCTTTCCGAGGAAGACCAGTACCCAATGTCTTGTGGAGTAAGCCAGACACTGACCTCCGTACTAGAGCTTATGTTGATACCACAGACTCTCGTACATCACTGACCATTGAAAATGCCAACAGAAATGACTCTGGAAAGTACACATTAACAATTCAGAATGTTTTGAGTGCTGCTTCACTGACCTTAGTTGTCAAAGTTTTAGATACCCCAGGTCCTCCAACCAACATTACTGTGCAAGATGTAACCAAAGAGTCTGCAGTGTTATCCTGGGATGTTCCTGAAAACGATGGTGGAGCACCAGTGAAGAATTACCACATAGAAAAACGTGAGGCCAGCAAGAAAGCATGGGTCTCTGTGACCAACAACTGTAACCGCCTCTCCTACAAAGTTACCAATTTACAAGAAGGAGCTATCTATTACTTCAGAGTCTCTGGAGAAAATGAGTTTGGTGTTGGTATACCAGCTGAAACAAAGGAAGGAGTAAAAATAACAG
>TTN-209,ENSE00003802597,1,297,2051373,2051669,AAAAACCAAGCCCACCTGAAAAACTTGGAGTAACAAGTATATCCAAAGACAGTGTTTCCCTGACCTGGCTGAAGCCTGAACATGATGGCGGAAGCAGAATTGTACACTATGTCGTTGAAGCACTAGAAAAAGGACAGAAAAACTGGGTTAAATGTGCAGTGGCAAAGTCAACCCATCACGTTGTTTCCGGTCTGAGAGAGAATTCTGAATACTTTTTCCGAGTGTTTGCTGAAAATCAAGCTGGCCTGAGTGACCCGAGAGAGCTTCTGCTTCCTGTTCTTATTAAGGAGCAACTAG
>TTN-209,ENSE00003802941,1,588,2051670,2052257,AACCACCTGAAATTGATATGAAGAATTTCCCAAGTCACACTGTATATGTTAGAGCTGGTTCAAACCTTAAAGTTGACATTCCAATCTCTGGAAAACCACTTCCCAAAGTGACCTTATCAAGAGATGGTGTCCCCCTTAAGGCAACCATGAGATTTAATACCGAAATTACTGCTGAGAACCTGACCATCAATCTCAAAGAAAGTGTTACAGCTGACGCTGGGAGATATGAAATCACTGCTGCCAACTCCAGTGGTACAACCAAAGCTTTCATTAACATTGTTGTGCTAGACAGGCCTGGTCCTCCAACTGGCCCTGTTGTTATTAGTGATATAACTGAAGAAAGTGTGACTCTCAAATGGGAGCCACCTAAGTATGACGGTGGAAGTCAAGTTACCAACTACATTCTACTCAAAAGAGAAACAAGTACTGCAGTGTGGACTGAAGTGTCTGCAACAGTTGCAAGAACCATGATGAAAGTCATGAAACTGACCACAGGAGAAGAATACCAATTCCGCATCAAGGCAGAAAACCGCTTTGGCATCAGTGATCATATAGATTCAGCTTGTGTGACTGTCAAACTACCATACA
>TTN-209,ENSE00003808789,1,303,2052258,2052560,CAACACCTGGACCACCATCTACACCATGGGTCACTAATGTTACTCGAGAAAGCATCACTGTGGGCTGGCATGAACCAGTGTCAAATGGAGGCAGTGCAGTCGTAGGCTATCACCTGGAAATGAAAGACAGAAACAGTATTTTATGGCAAAAAGCCAACAAACTGGTCATCCGCACAACTCACTTCAAAGTCACAACAATCAGTGCTGGACTTATTTATGAATTCAGGGTGTATGCAGAAAATGCTGCTGGAGTTGGAAAACCTAGCCATCCTTCTGAACCAGTCTTGGCAATTGATGCTTGTG
>TTN-209,ENSE00003806587,1,297,2052561,2052857,AACCCCCAAGAAATGTTCGTATCACTGATATTTCAAAGAACTCTGTCAGCCTTTCATGGCAACAACCAGCTTTCGATGGAGGTAGCAAGATTACAGGCTACATTGTTGAGAGACGTGACCTTCCAGATGGCAGATGGACCAAGGCCAGCTTCACCAATGTTACTGAAACTCAATTCATCATCTCTGGCTTGACTCAGAATTCCCAGTATGAATTCCGTGTCTTTGCTAGGAATGCTGTTGGTTCCATTAGCAATCCATCTGAGGTTGTAGGGCCCATTACTTGCATCGATTCTTATG
>TTN-209,ENSE00003807681,1,288,2052858,2053145,GTGGTCCTGTAATTGATTTGCCTCTAGAATATACAGAAGTTGTCAAATACAGAGCAGGTACATCTGTGAAGCTCAGAGCTGGCATTTCTGGCAAACCTGCGCCTACTATTGAGTGGTATAAAGATGATAAAGAATTACAAACCAATGCACTGGTGTGTGTTGAAAATACCACGGACCTCGCATCTATACTCATCAAAGATGCCGATCGCCTTAATAGTGGATGCTATGAATTAAAACTAAGGAATGCCATGGGCTCAGCCTCAGCCACCATCAGAGTACAGATCCTTG
>TTN-209,ENSE00003811102,1,300,2053146,2053445,ACAAACCAGGCCCACCTGGTGGACCAATTGAATTTAAGACTGTAACTGCTGAGAAGATCACCCTTCTCTGGCGGCCTCCAGCTGATGATGGTGGTGCAAAAATCACTCACTACATTGTGGAAAAGCGTGAGACAAGCCGCGTTGTGTGGTCTATGGTGTCTGAACATTTGGAAGAGTGCATCATTACAACCACCAAAATTATCAAAGGAAATGAATACATCTTCCGGGTCCGAGCCGTGAACAAATATGGAATTGGCGAGCCACTGGAATCTGATTCCGTTGTAGCCAAGAACGCATTTG
>TTN-209,ENSE00003802386,1,303,2053446,2053748,TTACACCTGGGCCACCAGGCATACCAGAAGTGACAAAGATTACCAAGAATTCGATGACTGTTGTATGGAGCAGGCCAATTGCAGATGGCGGTAGTGATATAAGTGGCTATTTCCTTGAAAAACGAGACAAGAAGAGCCTAGGATGGTTTAAAGTACTAAAAGAGACTATCCGTGACACCAGACAAAAAGTAACAGGACTCACAGAAAACAGTGACTATCAATACAGAGTTTGTGCTGTAAACGCTGCTGGACAGGGTCCATTTTCTGAACCATCTGAATTCTACAAAGCTGCTGATCCTATTG
>TTN-209,ENSE00003809908,1,306,2053749,2054054,ATCCTCCAGGTCCACCTGCTAAGATAAGAATCGCAGATTCAACCAAGTCATCCATCACCCTTGGCTGGAGTAAGCCTGTCTATGATGGGGGCAGTGCTGTTACTGGGTATGTTGTCGAGATAAGACAAGGAGAGGAAGAGGAATGGACTACTGTCTCTACCAAAGGAGAGGTCAGAACTACAGAATATGTGGTATCCAACCTGAAACCTGGAGTCAATTACTACTTCCGGGTATCTGCTGTAAACTGTGCTGGACAAGGAGAACCTATAGAAATGAATGAACCTGTACAAGCTAAAGATATACTTG
>TTN-209,ENSE00003808993,1,1767,2054055,2055821,AGGCACCAGAGATTGACCTGGATGTGGCTCTCAGAACTTCTGTTATTGCCAAAGCTGGTGAAGATGTACAAGTGTTGATTCCCTTTAAAGGCAGACCTCCACCTACTGTCACATGGAGAAAAGATGAGAAGAATCTTGGCAGTGATGCCAGATACAGCATTGAAAACACTGATTCATCCTCATTACTCACCATTCCTCAAGTTACTCGCAATGATACAGGAAAATATATTCTCACAATAGAAAATGGAGTTGGTGAACCTAAGTCTTCAACTGTGAGTGTTAAAGTGCTTGACACACCAGCTGCCTGCCAGAAACTACAGGTTAAACATGTTTCTCGAGGCACAGTCACTTTGCTCTGGGATCCTCCTCTCATTGATGGAGGATCTCCAATAATTAATTATGTCATTGAAAAGAGAGATGCCACCAAGAGAACATGGTCTGTCGTGTCACACAAATGTTCTAGCACATCCTTCAAGCTAATAGATTTGTCGGAGAAGACTCCATTCTTCTTCAGAGTTCTTGCAGAAAATGAAATTGGAATTGGGGAACCCTGTGAAACTACAGAGCCAGTGAAGGCTGCTGAAGTACCAGCTCCTATACGTGATCTCTCAATGAAAGACTCAACAAAGACATCTGTCATCCTCAGCTGGACCAAACCTGACTTTGATGGTGGTAGCGTCATCACAGAATATGTTGTAGAAAGGAAAGGTAAAGGTGAACAGACGTGGTCCCACGCTGGCATAAGTAAGACATGTGAAATTGAGGTTAGCCAACTTAAGGAGCAGTCAGTCCTGGAGTTCAGAGTGTTTGCCAAAAATGAGAAAGGACTGAGTGATCCTGTCACTATTGGGCCAATTACAGTGAAAGAACTTATTATTACACCTGAAGTTGACCTGTCAGATATCCCTGGGGCACAAGTCACTGTGAGAATTGGGCACAATGTGCACCTTGAATTACCTTATAAGGGAAAACCCAAACCATCCATCAGTTGGCTGAAAGATGGCTTGCCACTGAAAGAAAGTGAATTTGTTCGCTTCAGTAAAACTGAAAACAAAATTACTTTGAGTATTAAGAATGCCAAGAAGGAGCATGGAGGAAAATACACTGTTATTCTTGATAATGCAGTGTGTAGAATTGCAGTCCCCATTACAGTCATCACCCTTGGCCCACCATCAAAGCCCAAAGGACCCATTCGATTTGATGAAATCAAGGCTGATAGTGTCATCCTGTCATGGGATGTACCTGAAGATAATGGAGGAGGAGAAATTACTTGTTACAGCATCGAGAAGCGGGAAACTTCACAAACTAACTGGAAGATGGTGTGTTCAAGTGTTGCCAGAACGACTTTCAAAGTTCCTAATCTAGTCAAAGATGCTGAGTACCAGTTTAGAGTGAGAGCAGAAAACAGATACGGAGTCAGCCAACCACTTGTCTCAAGCATTATTGTGGCAAAACACCAGTTCAGGATTCCTGGTCCCCCAGGAAAGCCAGTTATATACAATGTGACTTCTGATGGCATGTCACTAACTTGGGATGCTCCAGTTTATGATGGTGGTTCAGAAGTTACTGGATTCCATGTTGAAAAGAAAGAAAGAAATAGCATCCTCTGGCAAAAAGTTAATACATCACCAATCTCTGGAAGAGAATATAGAGCCACTGGACTGGTAGAAGGTCTGGATTACCAATTCCGTGTATATGCTGAAAATTCTGCTGGCCTAAGCTCACCTAGTGACCCAAGCAAATTTACCTTAGCTGTTTCTCCAGTAG
>TTN-209,ENSE00003811205,1,294,2055822,2056115,ACCCACCTGGCACTCCTGACTACATTGATGTCACCCGGGAAACCATCACACTTAAATGGAACCCACCATTGCGTGATGGAGGCAGTAAGATTGTGGGCTATAGCATTGAGAAACGGCAAGGAAATGAACGCTGGGTGAGATGCAACTTTACTGACGTCAGTGAATGTCAGTACACAGTTACAGGACTCAGTCCTGGGGATCGCTATGAGTTCAGAATAATTGCAAGAAATGCTGTTGGAACTATAAGCCCGCCCTCACAGTCTTCTGGCATTATTATGACAAGAGATGAAAATG
>TTN-209,ENSE00003808021,1,288,2056116,2056403,TTCCACCAATAGTAGAGTTTGGCCCTGAATACTTTGATGGTCTCATTATTAAGTCCGGAGAGAGCCTTAGAATTAAAGCTTTGGTACAAGGAAGACCAGTGCCTCGAGTAACTTGGTTCAAAGATGGAGTGGAAATCGAAAAGAGGATGAATATGGAAATAACCGACGTACTTGGATCCACCAGCCTATTTGTTAGAGATGCTACTCGGGACCATCGTGGTGTATACACAGTGGAAGCCAAAAATGCATCTGGTTCTGCAAAAGCAGAAATTAAAGTGAAAGTACAAG
>TTN-209,ENSE00003804355,1,300,2056404,2056703,ATACACCAGGAAAAGTAGTTGGGCCAATAAGATTCACCAATATTACTGGGGAGAAGATGACTCTGTGGTGGGATGCCCCACTCAATGACGGTTGTGCTCCCATAACCCACTACATCATTGAAAAACGGGAAACCAGCAGACTTGCCTGGGCACTAATTGAGGATAAATGTGAAGCCCAAAGTTACACTGCCATTAAACTAATAAACGGCAATGAATACCAATTCCGTGTTTCTGCAGTTAACAAGTTTGGTGTTGGCAGGCCACTTGATTCTGATCCAGTGGTTGCTCAAATACAATATA
>TTN-209,ENSE00003807046,1,2067,2056704,2058770,CTGTTCCTGATGCCCCTGGCATTCCAGAACCTAGCAACATAACAGGCAACAGCATTACCCTGACATGGGCAAGGCCAGAATCAGATGGTGGCAGTGAAATTCAACAGTATATCCTTGAAAGAAGAGAAAAGAAAAGCACAAGATGGGTAAAAGTGATCAGCAAACGACCAATCTCTGAAACAAGATTCAAAGTCACTGGTCTGACAGAAGGCAATGAGTATGAATTCCATGTCATGGCTGAAAATGCTGCAGGAGTTGGACCTGCAAGTGGCATCTCAAGACTCATTAAATGTAGAGAGCCCGTCAACCCACCAGGTCCTCCCACAGTGGTCAAAGTAACAGACACATCAAAGACAACTGTGAGCTTAGAATGGTCCAAACCAGTGTTTGATGGTGGCATGGAAATAATTGGGTATATTATTGAAATGTGTAAGGCCGACTTAGGAGACTGGCACAAGGTGAATGCAGAGGCATGTGTGAAAACAAGATATACAGTCACTGATCTACAAGCAGGTGAAGAATACAAATTCCGAGTTAGTGCTATCAATGGTGCTGGAAAAGGCGACAGCTGTGAAGTGACTGGCACAATTAAAGCAGTTGACCGGTTAACAGCTCCTGAGTTAGACATAGATGCAAACTTCAAACAGACTCATGTTGTTAGAGCTGGGGCCAGTATTCGCCTCTTCATTGCCTACCAAGGTAGACCTACTCCTACAGCTGTGTGGAGCAAACCAGACTCTAACCTTAGCCTTCGGGCTGATATCCATACAACAGATTCCTTCAGCACCCTCACTGTGGAAAACTGCAACAGAAATGATGCAGGGAAATATACCCTTACTGTGGAAAACAACAGTGGTAGTAAGTCAATCACATTCACCGTGAAAGTGCTAGACACTCCAGGCCCACCTGGCCCAATTACCTTCAAAGATGTGACCCGGGGATCTGCTACATTGATGTGGGATGCCCCTCTTCTTGACGGTGGTGCCCGAATCCATCATTATGTGGTAGAGAAACGAGAGGCAAGTCGCCGTAGTTGGCAGGTTATCAGTGAAAAATGCACTCGTCAGATCTTCAAGGTCAATGACCTGGCCGAAGGTGTTCCGTACTATTTCCGTGTTTCTGCAGTAAATGAGTATGGTGTTGGTGAGCCCTATGAAATGCCAGAACCAATTGTAGCCACAGAACAGCCTGCTCCACCTAGGAGACTTGATGTTGTTGATACTAGCAAATCCTCCGCAGTCTTAGCTTGGCTTAAACCTGACCACGATGGAGGCAGCCGGATCACTGGCTACCTGCTTGAAATGAGACAAAAGGGATCTGACTTCTGGGTTGAAGCTGGTCACACCAAACAGCTAACTTTCACAGTAGAGCGTCTTGTTGAGAAAACTGAATATGAATTCCGTGTGAAGGCCAAGAATGATGCTGGCTATAGTGAACCCAGAGAAGCCTTCTCTTCTGTCATCATTAAGGAGCCTCAAATCGAGCCCACTGCTGACCTCACTGGAATTACCAATCAGCTTATAACTTGCAAAGCAGGAAGCCCATTTACCATTGACGTACCAATCAGTGGTCGTCCTGCCCCCAAAGTAACATGGAAACTGGAAGAAATGAGACTTAAAGAGACAGATCGAGTGAGCATTACAACAACAAAAGACAGAACCACACTGACTGTAAAGGACAGCATGAGAGGTGACTCTGGAAGATACTTCTTGACCCTGGAAAATACAGCTGGTGTTAAAACATTTAGCGTCACAGTTGTGGTCATTGGAAGGCCAGGTCCAGTAACCGGCCCCATTGAGGTCTCATCTGTCTCAGCTGAATCGTGTGTCCTGTCATGGGGAGAACCTAAAGATGGAGGAGGCACTGAAATTACTAATTACATAGTTGAAAAGCGTGAATCGGGTACAACAGCTTGGCAGCTTGTCAATTCCAGTGTCAAGCGCACTCAAATTAAAGTCACTCATCTCACAAAATACATGGAATATTCTTTCCGTGTCAGTTCAGAGAACAGATTTGGTGTCAGCAAACCTCTAGAATCAGCACCAATAATTGCTGAACATCCATTTG
>TTN-209,ENSE00003810611,1,303,2058771,2059073,TCCCACCAAGCGCTCCTACCAGACCTGAGGTCTACCATGTGTCTGCCAATGCCATGTCTATTCGTTGGGAAGAACCCTACCACGATGGTGGCAGTAAAATCATTGGCTACTGGGTTGAGAAGAAAGAACGTAATACAATTCTTTGGGTGAAAGAAAACAAAGTGCCATGCTTAGAGTGCAACTACAAAGTAACTGGTTTAGTAGAAGGACTGGAATATCAGTTCAGAACTTATGCACTCAATGCTGCAGGTGTTAGCAAGGCCAGCGAAGCTTCAAGACCTATAATGGCTCAAAATCCAGTTG
>TTN-209,ENSE00003803222,1,306,2059074,2059379,ATGCACCAGGCAGACCAGAGGTGACAGATGTCACAAGATCAACAGTATCACTGATTTGGTCTGCCCCAGCGTATGATGGAGGCAGCAAGGTTGTGGGCTACATCATAGAGCGTAAGCCAGTCAGTGAGGTAGGAGATGGTCGCTGGCTGAAGTGCAACTACACCATTGTATCTGACAATTTCTTCACCGTGACTGCTCTCAGTGAAGGAGACACTTATGAGTTCCGTGTGTTAGCCAAGAATGCAGCAGGCGTAATTAGCAAAGGGTCTGAATCTACAGGCCCTGTCACTTGCCGAGATGAATACG
>TTN-209,ENSE00003801213,1,291,2059380,2059670,CTCCACCCAAAGCCGAACTGGATGCCCGATTACACGGTGATCTGGTTACCATCAGAGCAGGTTCTGATCTTGTTCTGGATGCTGCAGTTGGTGGCAAACCTGAACCCAAAATTATCTGGACCAAAGGAGACAAGGAGCTAGATCTCTGTGAAAAAGTCTCTTTGCAGTATACTGGCAAACGAGCAACTGCTGTGATCAAGTTCTGTGACAGAAGTGACAGTGGAAAATACACTTTAACAGTGAAAAATGCCAGCGGGACCAAGGCCGTGTCTGTCATGGTCAAAGTGCTTG
>TTN-209,ENSE00003809128,1,297,2059671,2059967,ATTCCCCTGGCCCATGTGGAAAGCTCACCGTCAGCAGAGTAACACAGGAGAAGTGCACTTTAGCCTGGAGCCTTCCGCAGGAAGACGGAGGAGCAGAAATCACTCACTACATCGTGGAAAGACGCGAGACTAGCAGGCTCAACTGGGTGATTGTTGAAGGCGAATGCCCAACCCTATCCTATGTCGTTACCAGGCTCATCAAGAACAATGAGTACATATTCCGAGTGAGGGCAGTAAACAAATATGGCCCTGGTGTGCCTGTTGAATCAGAGCCAATTGTAGCCAGAAACTCATTCA
>TTN-209,ENSE00003803385,1,306,2059968,2060273,CTATTCCATCACCACCCGGCATACCTGAAGAAGTTGGGACTGGCAAAGAGCATATCATCATTCAGTGGACAAAACCTGAATCTGATGGTGGCAATGAAATCAGCAACTACCTAGTAGACAAACGTGAGAAGAAGAGCCTGCGCTGGACACGTGTCAACAAAGACTATGTGGTGTATGATACCAGGCTGAAGGTGACCAGCCTGATGGAGGGTTGTGATTACCAGTTCCGGGTGACCGCAGTGAATGCAGCTGGTAACAGTGAGCCCAGCGAAGCTTCCAACTTCATCTCATGCAGAGAACCATCAT
>TTN-209,ENSE00003807140,1,306,2060274,2060579,ATACCCCTGGACCACCTTCTGCTCCAAGAGTTGTGGATACCACCAAACACAGCATTAGTTTGGCATGGACCAAACCCATGTACGATGGTGGTACTGACATTGTAGGATATGTTCTGGAAATGCAAGAGAAGGACACTGATCAGTGGTACCGAGTGCATACCAATGCCACAATAAGAAATACTGAATTCACTGTGCCAGACCTTAAAATGGGCCAGAAATATTCCTTCAGAGTTGCTGCCGTGAACGTGAAGGGTATGAGCGAATACAGCGAATCAATTGCTGAAATTGAGCCCGTGGAAAGAATAG
>TTN-209,ENSE00003809946,1,282,2060580,2060861,AAATACCAGATCTTGAGCTTGCAGATGATCTAAAGAAGACTGTGACCATCAGGGCTGGGGCCTCCTTGCGCTTGATGGTGTCTGTATCTGGAAGACCACCTCCTGTCATAACGTGGAGCAAGCAGGGCATTGACCTTGCAAGCCGGGCAATTATTGACACCACTGAGAGCTACTCATTGCTAATAGTGGACAAAGTTAATCGGTACGATGCTGGAAAATACACAATTGAAGCTGAAAACCAATCTGGCAAGAAATCAGCAACAGTCCTTGTTAAAGTCTATG
>TTN-209,ENSE00003810384,1,594,2060862,2061455,ATACTCCTGGTCCCTGTCCTTCAGTGAAAGTTAAGGAAGTATCAAGAGATTCTGTGACTATAACTTGGGAAATTCCCACGATTGATGGTGGAGCTCCAGTCAACAATTACATCGTTGAGAAGCGTGAAGCTGCTATGAGAGCATTCAAAACAGTAACTACCAAATGCAGCAAGACACTTTACAGAATTTCTGGACTTGTAGAAGGAACCATGTACTATTTCAGAGTGCTGCCAGAAAATATTTATGGCATTGGAGAACCTTGTGAAACATCTGATGCAGTACTGGTCTCAGAAGTGCCTTTGGTGCCTGCAAAGCTAGAAGTGGTCGATGTCACCAAATCCACTGTTACCCTTGCCTGGGAAAAACCACTCTACGATGGTGGTAGCCGACTCACTGGATATGTTCTCGAGGCCTGCAAAGCTGGCACAGAGAGATGGATGAAGGTTGTCACCTTAAAACCCACAGTCCTAGAGCACACTGTTACTTCCTTAAATGAAGGTGAACAATACTTATTTAGAATAAGGGCACAAAATGAGAAAGGTGTGTCAGAACCAAGAGAGACTGTCACAGCCGTGACTGTACAAGACCTCAGAG
>TTN-209,ENSE00003802641,1,288,2061456,2061743,TGTTGCCAACAATCGATCTTTCTACAATGCCTCAGAAGACCATCCATGTCCCAGCTGGCAGACCAGTAGAGCTGGTGATACCTATTGCTGGCCGTCCACCTCCTGCTGCTTCCTGGTTCTTTGCTGGTTCTAAACTGAGAGAATCAGAGCGTGTCACAGTTGAAACTCACACTAAAGTAGCTAAATTAACCATCCGTGAAACCACTATCAGAGATACTGGAGAATACACACTTGAATTGAAGAATGTTACCGGAACTACTTCAGAAACCATTAAAGTTATCATTCTTG
>TTN-209,ENSE00003806194,1,300,2061744,2062043,ACAAGCCTGGTCCACCAACAGGACCTATTAAGATTGATGAAATTGATGCTACATCAATTACCATTTCCTGGGAACCACCTGAATTGGACGGTGGTGCTCCACTGAGTGGTTATGTGGTAGAACAACGTGACGCTCATCGTCCAGGATGGCTGCCCGTTTCTGAATCAGTGACTAGGTCCACGTTTAAGTTTACCAGACTCACCGAAGGAAATGAGTATGTGTTCCGTGTGGCTGCAACAAACCGCTTCGGGATTGGCTCTTACTTGCAGTCTGAGGTCATAGAGTGTCGCAGCAGCATCC
>TTN-209,ENSE00003805894,1,303,2062044,2062346,GTATTCCTGGACCCCCAGAAACATTACAGATATTTGATGTTTCCCGTGATGGCATGACACTTACTTGGTACCCACCAGAGGATGACGGTGGCTCCCAAGTGACTGGATATATTGTGGAGCGCAAAGAAGTGAGAGCAGATCGATGGGTCCGTGTAAATAAAGTACCTGTGACAATGACACGGTACCGCTCCACTGGCCTTACTGAAGGCTTAGAATATGAACACCGTGTCACAGCCATTAATGCAAGAGGGTCTGGGAAACCAAGTCGTCCTTCCAAACCCATCGTTGCCATGGATCCAATTG
>TTN-209,ENSE00003808643,1,303,2062347,2062649,CTCCTCCAGGAAAGCCACAAAACCCAAGAGTTACTGATACAACAAGGACATCAGTCTCCCTGGCCTGGAGTGTTCCAGAAGATGAAGGAGGATCTAAAGTCACAGGCTACTTGATTGAAATGCAAAAAGTAGATCAACATGAATGGACCAAGTGTAACACCACTCCAACCAAGATTCGAGAGTATACTCTAACACACCTACCTCAGGGTGCAGAATACAGGTTCCGCGTCCTAGCTTGTAATGCTGGTGGACCTGGTGAGCCTGCTGAGGTACCAGGAACAGTCAAAGTCACTGAAATGCTTG
>TTN-209,ENSE00003805779,1,585,2062650,2063234,AATATCCTGATTATGAACTTGATGAAAGATACCAAGAAGGTATCTTTGTAAGGCAAGGTGGCGTCATCAGACTTACCATACCAATCAAAGGAAAACCATTCCCAATATGTAAATGGACCAAGGAAGGCCAGGATATTAGTAAGCGTGCCATGATTGCAACATCTGAAACACACACTGAGCTTGTGATCAAAGAAGCAGACAGGGGTGATTCTGGCACTTATGACCTGGTTCTGGAAAATAAATGTGGCAAGAAGGCTGTCTACATCAAGGTCAGGGTGATAGGAAGTCCCAACAGTCCAGAAGGGCCACTGGAATATGATGACATCCAAGTCCGCTCTGTGAGGGTCAGCTGGAGACCTCCTGCTGATGATGGTGGTGCTGACATCTTAGGCTACATCCTCGAGAGACGAGAAGTGCCTAAAGCCGCCTGGTATACCATTGATTCCAGAGTCCGAGGTACATCTCTGGTGGTAAAAGGCCTCAAAGAGAATGTAGAATACCATTTCCGTGTTTCAGCAGAAAACCAGTTTGGCATAAGCAAACCCTTGAAATCTGAGGAACCAGTCACACCAAAAACACCATTGA
>TTN-209,ENSE00003806836,1,306,2063235,2063540,ATCCTCCAGAACCTCCAAGCAATCCTCCAGAAGTACTCGATGTAACCAAGAGTTCTGTTAGCTTGTCCTGGTCCCGGCCCAAAGATGATGGTGGTTCTAGAGTCACAGGCTACTACATCGAACGCAAAGAGACATCCACTGACAAGTGGGTCAGACACAACAAGACTCAGATCACCACCACAATGTACACTGTCACAGGGCTTGTTCCCGATGCTGAGTATCAGTTCCGCATCATCGCACAGAATGATGTTGGCCTGAGTGAGACCAGCCCTGCTTCTGAACCAGTTGTTTGCAAAGATCCATTTG
>TTN-209,ENSE00003810204,1,300,2063541,2063840,ATAAACCAAGCCAACCAGGAGAACTTGAGATTCTTTCAATATCCAAAGATAGTGTCACTCTACAGTGGGAGAAACCTGAATGTGATGGTGGTAAAGAAATTCTTGGATACTGGGTTGAATATAGACAGTCTGGAGACAGTGCCTGGAAGAAGAGCAATAAGGAACGTATTAAGGACAAGCAATTCACAATAGGAGGTTTGCTGGAAGCTACTGAGTATGAATTCAGGGTTTTTGCTGAGAATGAGACTGGGCTGAGCAGACCTCGCAGAACTGCTATGTCTATAAAGACTAAACTCACAT
>TTN-209,ENSE00003805486,1,576,2063841,2064416,CTGGAGAGGCCCCAGGAATACGCAAAGAAATGAAGGATGTTACCACAAAATTGGGTGAAGCTGCTCAACTCTCATGCCAGATTGTTGGAAGGCCTCTTCCTGACATTAAATGGTACAGATTTGGTAAAGAGCTCATACAAAGCCGGAAATACAAAATGTCTTCAGATGGACGCACACACACTCTTACAGTAATGACAGAGGAACAGGAAGATGAAGGTGTTTATACCTGCATAGCCACCAATGAGGTTGGAGAAGTAGAAACCAGTAGTAAGCTTCTCCTGCAAGCAACACCGCAGTTCCATCCTGGTTACCCACTGAAAGAGAAATATTATGGAGCTGTGGGTTCCACACTTCGGCTTCATGTTATGTACATTGGTCGTCCAGTACCTGCCATGACTTGGTTCCATGGTCAGAAACTTTTGCAAAACTCAGAAAACATTACTATTGAAAACACTGAGCACTATACTCATCTTGTCATGAAGAATGTCCAACGTAAGACTCATGCTGGGAAATACAAAGTCCAGCTCAGCAATGTTTTTGGAACAGTTGATGCCATCCTTGATGTGGAAATACAAG
>TTN-209,ENSE00003801306,1,306,2064417,2064722,ATAAACCAGACAAACCTACAGGACCAATTGTGATCGAAGCTCTATTGAAGAACTCCGCAGTGATCAGCTGGAAACCACCCGCAGATGACGGAGGCTCCTGGATCACCAACTATGTGGTGGAAAAATGTGAGGCCAAGGAGGGGGCTGAATGGCAATTGGTGTCTTCAGCCATCTCAGTGACAACCTGTAGAATTGTGAACCTCACAGAAAATGCTGGCTATTACTTCCGGGTTTCAGCTCAGAACACTTTCGGCATCAGTGACCCTCTAGAAGTGTCCTCAGTTGTGATCATTAAGAGTCCATTTG
>TTN-209,ENSE00003808123,1,594,2064723,2065316,AAAAGCCAGGTGCTCCTGGCAAACCAACTATTACTGCTGTCACAAAAGATTCTTGTGTTGTGGCCTGGAAGCCACCTGCCAGTGATGGAGGTGCAAAGATTAGAAATTACTACCTTGAGAAGCGTGAGAAGAAGCAGAATAAATGGATTTCTGTGACAACAGAAGAAATTCGAGAAACTGTCTTTTCAGTGAAAAACCTTATTGAAGGTCTTGAATACGAGTTTCGTGTGAAATGTGAAAATCTAGGTGGGGAAAGTGAATGGAGTGAAATATCAGAACCCATCACTCCCAAATCTGATGTCCCAATTCAGGCACCACACTTTAAAGAGGAACTGAGAAATCTAAATGTCAGATATCAGAGCAATGCTACCTTGGTCTGCAAAGTGACTGGTCATCCAAAACCTATCGTCAAATGGTACAGACAAGGCAAAGAAATCATTGCAGATGGATTAAAATATAGGATTCAAGAATTTAAGGGTGGCTACCACCAGCTCATCATTGCAAGTGTCACAGATGATGATGCCACAGTTTACCAAGTCAGAGCTACCAACCAAGGGGGATCTGTGTCTGGCACTGCCTCCTTGGAAGTGGAAG
>TTN-209,ENSE00003808212,1,5609,2065317,2070925,TTCCAGCTAAGATACACTTACCTAAAACTCTTGAAGGCATGGGAGCAGTTCATGCTCTCCGAGGTGAAGTGGTCAGCATCAAGATTCCTTTCAGTGGCAAACCAGATCCTGTGATCACCTGGCAGAAAGGACAAGATCTCATTGACAATAATGGCCACTACCAAGTTATTGTCACAAGATCCTTCACATCACTTGTTTTCCCCAATGGGGTAGAGAGAAAAGATGCTGGTTTCTATGTGGTCTGTGCTAAAAACAGATTTGGAATTGATCAGAAGACAGTTGAACTGGATGTGGCTGATGTTCCTGACCCACCCAGAGGAGTCAAAGTTAGTGATGTCTCACGAGATTCTGTCAACTTAACATGGACTGAGCCAGCCTCTGATGGTGGCAGCAAAATCACCAACTACATTGTTGAAAAATGTGCAACTACTGCAGAAAGATGGCTCCGTGTAGGACAGGCCCGAGAAACACGTTATACCGTGATCAACTTATTTGGAAAAACAAGTTACCAGTTCCGGGTAATAGCTGAAAATAAATTTGGTCTGAGCAAGCCTTCAGAGCCTTCAGAACCAACCATAACCAAAGAAGATAAGACCAGAGCTATGAACTATGATGAAGAGGTAGATGAAACCAGGGAAGTCTCCATGACTAAAGCATCTCACTCTTCAACCAAGGAACTCTATGAGAAATATATGATTGCTGAAGATCTTGGGCGTGGTGAGTTTGGAATTGTCCATCGTTGTGTTGAAACATCCTCAAAGAAGACATACATGGCCAAATTTGTTAAAGTCAAAGGGACTGATCAGGTTTTGGTAAAGAAGGAAATTTCCATTCTGAATATTGCTAGGCATAGAAACATCTTACACCTCCATGAATCATTTGAAAGCATGGAAGAATTAGTTATGATCTTTGAGTTTATATCAGGACTTGACATATTTGAGCGCATTAACACAAGTGCTTTTGAACTTAATGAAAGAGAAATTGTAAGTTATGTTCACCAGGTCTGTGAAGCACTTCAGTTTTTACACAGTCATAATATTGGACACTTTGACATTAGACCAGAAAATATCATTTACCAAACCAGAAGAAGCTCTACCATTAAAATCATAGAATTTGGTCAAGCCCGTCAGCTGAAACCAGGGGACAACTTCAGGCTTCTATTCACTGCCCCAGAATACTATGCACCTGAAGTCCACCAGCATGATGTTGTCAGCACAGCCACAGACATGTGGTCACTTGGAACACTGGTATATGTGCTATTGAGTGGTATCAACCCATTCCTGGCTGAAACTAACCAACAGATCATTGAGAATATCATGAATGCTGAATATACTTTCGATGAGGAAGCATTCAAAGAGATTAGCATTGAAGCCATGGATTTTGTTGACCGGTTGTTAGTGAAAGAGAGGAAATCTCGCATGACAGCATCGGAGGCTCTCCAGCACCCATGGTTGAAGCAGAAGATAGAAAGAGTCAGTACTAAAGTTATCAGAACATTAAAACACCGGCGTTATTACCACACCCTGATCAAGAAAGACCTCAACATGGTTGTGTCAGCAGCCCGGATCTCCTGTGGTGGTGCAATTCGATCTCAGAAGGGAGTGAGTGTTGCTAAAGTTAAAGTGGCATCCATTGAAATTGGCCCAGTTTCTGGGCAGATAATGCATGCAGTTGGTGAAGAAGGAGGACATGTCAAATATGTATGCAAAATTGAAAATTATGATCAGTCTACCCAAGTGACTTGGTACTTTGGCGTCCGACAGCTGGAGAACAGTGAGAAATACGAAATCACCTACGAAGATGGAGTGGCCATCCTCTATGTCAAAGACATTACCAAATTAGATGATGGTACCTACAGATGCAAAGTAGTCAATGACTATGGTGAAGACAGTTCTTATGCAGAGCTATTTGTTAAAGGTGTGAGAGAAGTCTATGACTATTACTGCCGTAGAACCATGAAGAAAATTAAGCGCAGAACAGACACAATGAGACTCCTGGAAAGGCCACCAGAATTTACCCTGCCTCTCTATAATAAGACAGCTTATGTAGGTGAAAATGTCCGGTTTGGAGTAACTATAACTGTCCACCCAGAGCCTCATGTAACATGGTATAAATCAGGTCAGAAAATCAAACCAGGTGACAATGACAAGAAGTACACATTTGAGTCAGACAAGGGTCTTTACCAATTAACAATCAACAGTGTCACTACAGATGATGACGCTGAATATACTGTTGTGGCAAGGAACAAATATGGTGAAGACAGCTGTAAAGCAAAGCTGACAGTAACCCTACACCCACCTCCAACAGATAGTACCTTAAGACCCATGTTCAAAAGGTTACTGGCAAATGCAGAATGCCAAGAAGGCCAAAGTGTCTGCTTTGAGATCAGAGTGTCTGGCATCCCCCCACCAACATTAAAATGGGAGAAAGATGGTCAGCCACTGTCCCTCGGGCCTAACATTGAAATTATCCATGAAGGCTTGGATTATTATGCTCTGCACATCAGGGACACTTTGCCTGAAGACACGGGTTATTATAGAGTCACAGCCACTAACACAGCTGGGTCCACCAGCTGCCAGGCTCACCTACAAGTGGAACGCCTGAGGTACAAGAAACAGGAATTCAAGAGTAAGGAGGAGCATGAGCGACACGTACAAAAACAAATTGACAAAACCCTCAGAATGGCTGAAATTCTTTCTGGAACTGAAAGTGTACCACTGACACAGGTAGCTAAAGAGGCTCTGAGAGAAGCTGCTGTCCTTTATAAACCGGCTGTAAGCACCAAGACTGTAAAAGGGGAATTCAGACTTGAGATAGAAGAAAAGAAGGAGGAGAGAAAACTCCGGATGCCTTATGATGTACCAGAGCCACGCAAGTATAAGCAGACTACCATAGAAGAAGACCAACGCATCAAGCAGTTCGTGCCCATGTCTGACATGAAGTGGTATAAAAAGATACGTGATCAGTATGAAATGCCTGGGAAACTTGACAGAGTTGTACAGAAACGACCCAAGCGCATCCGCCTTTCAAGATGGGAACAGTTCTATGTGATGCCTCTTCCACGCATTACAGATCAATACAGACCTAAATGGCGTATTCCTAAACTGTCCCAAGATGATCTTGAGATAGTGAGACCAGCCCGCCGGCGTACACCTTCTCCTGATTATGACTTTTACTACCGACCTAGAAGACGTTCTCTTGGGGACATCTCTGATGAAGAATTACTCCTCCCCATTGATGACTACTTAGCAATGAAAAGAACAGAGGAAGAGAGGCTGCGTCTTGAAGAAGAGCTTGAGTTAGGTTTTTCAGCTTCACCCCCAAGTCGAAGCCCTCCACACTTTGAGCTTTCTAGCCTACGTTACTCTTCACCACAAGCTCATGTCAAGGTGGAGGAAACAAGAAAAGACTTCAGGTATTCAACCTATCACATCCCAACGAAGGCTGAAGCTAGTACAAGTTATGCAGAACTGAGGGAACGGCATGCCCAGGCTGCGTACAGACAGCCAAAGCAACGGCAAAGAATCATGGCTGAGAGGGAGGATGAAGAGTTGCTTCGCCCAGTTACGACCACCCAGCATCTCTCAGAATACAAAAGCGAACTTGACTTCATGTCAAAGGAGGAAAAGTCTAGAAAGAAATCAAGGCGACAAAGAGAAGTGACAGAAATAACAGAAATTGAGGAAGAATACGAAATCTCAAAACATGCTCAAAGAGAATCATCCTCATCTGCGTCTAGACTACTGAGACGACGGCGCTCCCTGTCTCCAACTTATATTGAGTTAATGAGGCCAGTGTCTGAGCTGATCCGGTCACGTCCACAACCGGCTGAGGAATACGAAGATGACACAGAAAGAAGGTCACCTACTCCAGAGAGAACTCGCCCACGATCCCCCAGCCCTGTGTCTAGTGAGAGATCACTCTCGAGATTTGAGAGGTCTGCAAGATTTGATATCTTTTCCAGGTATGAGTCCATGAAAGCTGCTTTAAAAACTCAGAAGACATCAGAAAGGAAGTATGAAGTTTTGAGTCAGCAGCCTTTCACACTGGACCATGCCCCTCGAATCACACTGAGAATGCGCTCGCACAGGGTACCATGTGGCCAAAATACACGTTTTATTTTAAATGTTCAGTCTAAGCCAACTGCCGAGGTTAAATGGTACCACAATGGTGTGGAACTCCAAGAAAGCAGTAAGATTCATTACACCAACACGAGTGGAGTCCTCACCCTGGAAATTCTGGACTGTCATACTGATGACAGTGGAACCTACCGTGCTGTGTGCACCAACTACAAGGGCGAAGCTTCTGACTATGCAACGTTGGACGTGACAGGAGGGGATTATACCACCTATGCTTCCCAACGCAGAGATGAAGAGGTCCCCAGATCTGTTTTCCCTGAGCTGACAAGAACAGAGGCGTATGCTGTTTCATCATTTAAGAAAACATCTGAGATGGAAGCTTCGTCTTCTGTCAGGGAAGTGAAATCACAGATGACGGAGACAAGGGAAAGTCTCTCCTCATATGAACACTCTGCATCTGCAGAAATGAAAAGTGCTGCATTAGAAGAAAAGTCACTGGAAGAAAAATCCACAACCAGAAAGATCAAGACGACTTTGGCAGCAAGAATTCTAACAAAGCCACGGTCCATGACCGTCTACGAGGGCGAGTCTGCAAGGTTTTCTTGTGACACCGATGGTGAGCCGGTACCAACTGTGACCTGGCTGCGTAAAGGACAAGTGCTAAGTACTTCTGCCCGCCACCAAGTGACCACCACAAAGTACAAATCAACCTTTGAGATCTCTTCAGTCCAGGCTTCCGATGAGGGCAATTACAGCGTGGTGGTAGAAAACAGTGAAGGGAAACAAGAAGCAGAGTTCACTCTGACTATTCAAAAGGCCAGGGTAACTGAAAAGGCTGTGACATCACCACCAAGAGTCAAATCCCCAGAGCCTCGGGTGAAATCCCCAGAAGCAGTTAAGTCTCCAAAACGAGTGAAATCTCCAGAACCTTCTCACCCGAAAGCCGTATCACCCACAGAGACAAAACCAACACCAACAGAGAAAGTTCAGCACCTCCCAGTCTCTGCCCCACCAAAGATTACTCAGTTCCTGAAAGCAGAAGCTTCTAAAGAGATTGCAAAACTGACCTGTGTGGTTGAAAGCAGTGTATTAAGGGCAAAAGAGGTCACCTGGTATAAAGATGGCAAGAAACTGAAGGAAAATGGGCATTTCCAGTTTCATTATTCAGCAGATGGTACCTATGAGCTCAAAATCAATAACCTCACTGAATCTGATCAAGGAGAATATGTTTGTGAGATTTCTGGTGAAGGTGGAACGTCTAAAACCAACTTACAATTTATGGGGCAAGCCTTTAAGAGTATCCATGAGAAGGTATCAAAAATATCAGAAACTAAGAAATCAGATCAGAAAACCACTGAGTCAACAGTAACCAGAAAAACTGAACCAAAAGCTCCTGAACCAATTTCCTCAAAACCAGTAATTGTTACTGGGTTGCAGGATACAACTGTTTCTTCAGACAGTGTTGCTAAATTTGCAGTTAAGGCTACTGGAGAACCCCGGCCAACTGCCATCTGGACAAAAGATGGAAAG
>TTN-209,ENSE00003811220,1,157,2070926,2071082,GCCATTACACAAGGAGGTAAATATAAACTCTCTGAAGACAAGGGAGGGTTCTTCTTAGAAATTCATAAGACTGATACTTCTGACAGTGGACTTTATACTTGTACAGTAAAAAATTCAGCTGGATCTGTGTCCTCTAGCTGCAAATTAACAATAAAAG
>TTN-209,ENSE00003801641,1,692,2071083,2071774,CTATAAAAGATACTGAGGCACAGAAAGTCTCTACACAAAAGACTTCTGAAATTACACCTCAGAAGAAAGCTGTTGTCCAAGAGGAAATTTCCCAAAAAGCCCTAAGGTCTGAAGAAATTAAGATGTCAGAGGCAAAATCTCAAGAAAAGTTAGCCCTCAAAGAGGAAGCTTCAAAGGTTCTGATTTCTGAAGAAGTCAAGAAATCAGCAGCAACCTCCCTGGAAAAATCCATTGTCCATGAGGAAATCACTAAAACATCACAGGCATCAGAAGAAGTCAGAACTCATGCTGAGATTAAAGCATTTTCTACTCAGATGAGCATAAACGAAGGTCAAAGACTGGTTTTAAAAGCCAACATTGCTGGTGCCACTGATGTGAAATGGGTACTGAATGGCGTAGAGCTTACCAACTCTGAGGAGTACCGATATGGTGTCTCAGGCAGCGATCAGACCCTAACCATCAAGCAAGCCAGTCACAGAGATGAAGGAATCCTCACCTGCATAAGCAAAACCAAGGAAGGAATCGTCAAGTGTCAGTATGATTTGACACTGAGCAAAGAACTCTCAGATGCTCCAGCCTTCATCTCACAGCCTAGATCTCAAAATATTAATGAAGGACAAAATGTTCTCTTTACTTGTGAAATCAGTGGCGAGCCATCCCCTGAAATCGAATGGTTTAAAAACAACCTGCCA
>TTN-209,ENSE00003801638,1,154,2071775,2071928,ATTTCTATTTCTTCAAATGTCAGCATAAGCCGCTCCAGAAATGTATACTCCCTTGAAATCCGAAATGCATCAGTCAGCGACAGTGGAAAGTACACAATTAAGGCCAAAAATTTCCGTGGCCAGTGTTCAGCTACAGCTTCCTTAATGGTCCTTC
>TTN-209,ENSE00003805382,1,303,2071929,2072231,CTCTAGTTGAAGAACCTTCCAGAGAGGTAGTATTGAGAACAAGTGGTGACACAAGCTTGCAAGGAAGCTTCTCGTCTCAGTCAGTCCAAATGTCTGCCTCCAAGCAGGAGGCCTCCTTCAGCAGTTTCAGCAGCAGCAGTGCTAGCAGCATGACTGAGATGAAATTTGCAAGCATGTCTGCCCAAAGCATGTCCTCCATGCAAGAGTCCTTTGTAGAAATGAGTTCCAGCAGCTTTATGGGAATATCTAATATGACACAACTGGAAAGCTCAACTAGTAAAATGCTTAAAGCAGGCATAAGAG
>TTN-209,ENSE00003809884,1,1319,2072232,2073550,GAATTCCGCCTAAAATTGAAGCTCTTCCATCTGATATCAGCATTGATGAAGGCAAAGTTCTAACAGTAGCCTGTGCTTTCACGGGTGAGCCTACCCCAGAAGTAACATGGTCCTGTGGTGGAAGAAAAATCCACAGTCAAGAACAGGGGAGGTTCCACATTGAAAACACAGATGACCTGACAACCCTGATCATCATGGACGTACAGAAACAAGATGGTGGACTTTATACCCTGAGTTTAGGGAATGAATTTGGATCTGACTCTGCCACTGTGAATATACATATTCGATCCATTTAAGAGGGCCTGTGCCCTTATACTCTACACTCATTCTTAACTTTTCGCAAACGTTTCACACGGACTAATCTTTCTGAACTGTAAATATTTAAAGAAAAAAAAGTAGTTTTGTATCAACCTAAATGAGTCAAAGTTCAAAAATATTCATTTCAATCTTTTCATAATTGTTGACCTAAGAATATAATACATTTGCTAGTGACATGTACATACTGTATATAGCCGGATTAACGGTTATAAAGTTTTGTACCATTTATTTTATGACATTTTACAATGTAAGTTTTGAAACTAACTGTTGGTAGGAGAAAGTTTCTTATGGAACGAATACCCTGCTCAACATTTAATCAATCTTTGTGCCTCAACATACTGTTGATGTCTAAGTATGCCTCAGTGGGTTGAGAAAATCCCCATTGAAGATGTCCTGTCCACCTAAAAGAGAATGATGCTGTGCATATCACTTGATATGTGCACCAATACCTACTGAATCAGAAATGTAAGGCATTGGTGATGTTTGCATTTACCCTCCTGTAAGCAACACTTTAACGTCTTACATTTTCTCTGATGATGTCACACAAAATTATCATGACAAATATTACCAGAGCAAAGTGTAACGGCCAACACTTTGTTCGCTCATTTTACGCTGTCTCTGACATAAGGAGTGCCTGAATAGCTTGGAAAAGTAACATCTCCTGGCCATCCCTTCATTTAACCAAGCTATTCAAGTATTCCTATGCCAGAGCAGTGCCAACTCTTGGAGGTCCCAGAGTGCAGCCAATGCCTTTGTGTGGTAGTTCTAAATTTTAATTGCACCTGAAAAACCTGGGCACCTAAGCAATGAGCCACAGCAAAAAGTAAAGAACAACAACAAAATAAAGCTGTTGTTAAATTTTAAACAATATTACTAATTGCCCAAAATGTCAATTTGATGTAGTTCTTTTCATGCAAGTATAAATTCAATTGTTAGTTATAATTGTTGGACCTCCTTGAGATAGTAACAACAAAATAAAGCAAGCTATCTGCACCTCAAAA
>TTN-209,,0,2556,2073551,2076106,GTGAGCAGCAACTTTTCTTATTTTAATAGTAGAGTCACTTTCTTATTGATCTCTGGCTCTGGATTATTTGTGTGTGCTAAATGCCTATGTACAAGTGTTTGTATGACTATTTCTTGCCAGTGCTGACCCATTATTTAAATCTGCTTGTTAAATTCTATTTTAAAATGTCTGAACATTTTTCCTTAAAAAGTTGAAAGCTTTATTATATCAGCTAAATGATTCCATGATTCAAATTGTTTAAGTTCACTTAATATTCTAAAAGTTGAGGTCTGAAATGTTGAGAGAAATGTTTACTTCTTTTCTAGACTCTCTTTGCCTGTTGAGAATGTTCAAGGTTATATTACTCAATGATAAAGTTAAGCACACCAAGAATAGCTCTGATAAAATGCATGTGGTATCAGCTACACCCTGATGACTTTTTAAGGGAATCAACTGCTGAGGTATCAGTTGCAGGACAGTGACAGAACACTTGCCTGCTGTCAGTCAACCTTGGAGAGTTTAGGAGAGTTTATTTTAAGAGCATGACATTTTAGACGCATACCTTCAGCCCCAGTTAGACAAAGGCCTGTGAAGAGCAAGTGCTAAGGCAATAAAATTTACCTAGACAATAGGAATGTAAGATCAATTTAAGCTGGTTAATTGCAACATAGTTGGAGATTTGGAATAAAATGATATAATTGTTTTCTAAAATATTCAGAATCTCTTCATGCATTTTAACTCAGCACACAGTCCAATTATATATTTTGAGATAAATGTTGACACTAAGAAGGGTAAGAAATAATGTTTAAAGGAAAGGTTTCTTACTTCTAAATACACTTTGATTTCTCATCTTCCTAGAATTTGATTACTAATTGTCAATGCCTGTAAATACATAGATATATAATTAGGTATTCTATGTCTAAGAGGACAGCTATTTTTAGATATACTAACTTATAAACAGACAAAGTTAGACACAGAAAGTTGTTCATCCCAAAGATAATATGCTACAAAAAGGAGTTTCTGACAAAAAAAATTTATGAAAGCTTTTGGATATTATCTGATTTTTCCAAATATAAATTTTATTGTCTCAGAGAATGCTGGTTTCATTTTTTTAACTAAGTAGAAGGTTACAGTAAGGAACAGAATTATCACTAAGAAGATTATTGCTCCATGAAGTTTTAGTAAACAAAGAATTTAATGAAAAATAGTAATGAAGTGATTGACAATTCAGAAATGTTCTATTTCAGAACAGAATAGTCATGTTGAATAATTAGGTATTTATGCATCAGAAAATTCTTCACATAATGTCTCTGAAACTGATAGGCAAAGTACTTTCTTGCACTTAACAAAATGACTTAACTGCAAATTTTATATTCGTTTCTTTGATGTTGAATATTTTACTTTATGAAAGCATAGGCCTTTTCACTTCATCTACATTTTACACCAGCCTTCCATTATTCAAAGTTTGCAAATTGTTCCATATTAAGAACTCAAGCCAGCATTTTTCTTTCAGAACTATAATAAACTTTGGCCTGTTCACTAAAATTTAAATTTTTCTGAATATTTACTTCAGCAGTAACAACATTTACTGCACAGTTACAGTATGAAGAAATGTTAAGAAATAGAAAGCACCGTATGCCGTCTACAAAAAGCTTGCATATTTGATAAGGCTTGCCAAAGCTTCTCCAGTCAGGAAAGAGATTACAAAGTTCAGATTTTTACTTCTGGCAACTATTTTAAGTAATCAGATAATGTCTGAATCAATGTCAACTTTATAAATATAGAGTGAACGAAAAATATTGGGGAGAAGGAAAATTTTTAAAATAATTTTCACTTACTAAGCTGATGCAGAGGTTTATTTATTTTAATTTTTTTTTTTTTTTTTTTTTGAGACAGAGTCTCATTCTGTCACCCAGGCTGGAGTGTGGTGGCACCATCTTTGCTCACTGCAACCTCCACCTCCTGGGTTTAAGCAATTCTCATGCCTCAGCCTCCCAAGTAGCTGGGACTACAGACATGGGCCACCACGCCTGGCTAATTTTTGTATTTGTAGTAGAGACAGGGGTTTCACCATGTTAGCCAAACTGGTCTCAAACTCCTGACCTCAAGTAATCCTCCCGCCTCGGCCTCCTAAAGTGCTGGGATTACCAGCATGAGCCACCACGCCAGGCCCAGAGGTTTATTTTACATTTATCACATGTCTTGTCTCTCTAATTACACTTCACTAACCCTGCATTGCTGTGGTTTTCTTCTTCAACTCTGAACCTGGTTTTCCACCATTGGTAAGACTGTATATTCCCTCTTTGACCACTAGGGTTCATTCCTTGTTCTGTTTGGCTAATACTTTTTTCCATTTCCCCTTACACTTGCTACTTTGGGTTAGGCTTTAAGTCAACTCAATGATGAACTATGCAAAACTGTTCAAGCCACAAAAGAGAAGACCTGCCCATCACTCTAGGCCCACAGATGACCTATGGAGCAATCCATTTGGAGAAACGTGTGTCTCTGCTATCTGCAAAGCAGCTCCAGAGTGACCCTTAGCTGGGACACCCTAATTTATTTTCTCTTCTTTTTCAG
>TTN-209,,0,2210,2076107,2078316,GTAAGCTCACACATTCACACTTTTGTTTTTTTTTCCTTTGCCTCCTCTCCAGTAAGTTAACGTTGCTGCAGGACTTGACGCCAAGTTTAAGCCCTGCTTTCACTTCGGAAAATTAGTCCAACACTATGGAAAGGTCATTTTAAGGGTATACCATTCACAGAGTACTGACAAAATCTGACAATATAATGGCTTGAAATGTTTTATTCATATTTATTATTCCACAAAGCAAAAATAATTAGTGTTGGATTAAAATTGCCGTTAGAATCCAGCAACTAAATAGGACCAAATTTAGTCATTCTATATTTGGGCTCAGCTGCAGAGCCAGACTGGAAGCCAAGAACTCAAGCCCAATAGAAGCCAGCCACAGAGCCATGGGGTAGGCAGTCTGGGCTGCCTGCTCTGGACACCTGAACTTCAGTTGGTTCACACGCAAAATAACAGTGCATCTAATTTTCCTCAGAGGCAGAGCTGTTCAGTAATTAACCAACTCCTCATTATTTTATTATTTTATTTTCAATCTTTATTGAGTGATTCTAATGAATTAAAAGACTTTCCAATCGTTTTGAAATGACAGAAAATAATATGCTTCTCGGGTGTCTCTATTTAAAAGGAAGCAAACACTAACCCTAGAATTTTATCTGAAAGGAAGTTCATCTCTTTTTTGCCTTCTTTTTCTTCCTCATAACTCAGTTTATGGATGGTTCAAAAAAATGCATGGTATCATCTTATGAAAAAATGGAGAGTAGTGTATGAACTATATTGTAAATAATTTTAAAATTAATCAATATTTTCTCTTTCTGTAGTATTGTAACGAGCCATGTAAGATGGATACGGATTAAAAAAAATCATGCTTAATTCTTAATTTAGTGCACTTCCATGGTTCATTGCCCACTTCTTTTTTAAAATTTTATGGCTTATAATAAAGATATAAAATAAAATTTCTTTTTTTCTCTTTTTTTCTATTATATGCACCAATCTTATTCATAACTGGATAATACTTTCTTTTACATTGTACAAATATCATATAATCATTGCTTATTTTCTATTGTACATATATAGACCAATGAAATTCCCTTTTCATTGGTCTATATATGTACAATAGAAAATAAGTCTTACCGACTTCCAAATAATTTACCTATTTATCTGGTAACACTCAGTAACTTCTGAACTGAGCAGAACACATATGACTTCAGTGGGAATTTGCCTCCTTGAGAAGTAGTGGAATCTGGCTACTTCATATCTTCTTGTTCCTTCAAACTATATGCAAATAAATTATTACAAAGACACTACTGAAAATATCCAATACCCATAAATCAGTCCAATAAACTATTTAATTGGCCATAGTGGGAGATGGGCTAATGTATAAACAACAAAATAGACTTTCTCTAGATTATCTTTACCTACCAGCGTAAGTAGATAGAGCATCAACCTTTATGCCAAGTGTGAAATAAATCATGCCCTGAATGTGCCTCGTACATTCTCAATGTACAGAGTTTTAATATATTTAAAACATCAAACCATGGACATGTAGTTCTTGGCTCTACAATTTATGGCAGATAAAGAGAATTTGGCTTTCTACCTGCAATTCCAATGATCCATGTTGTTCTGGAAGACTAGGTTTGGATTAGTCTCTTATGAGAAATTGCTTGTCCATGTTACAATGTTTTTACTGATTGCACTTGTGAAAGCAGAAGAGTCCAAGAAGACAGTGTCCCTGTAACCACAGAGGAGGGAGGAGGGCATGCCTCCTGGGCTTGTCAGGCAGAAACTGGAGATCAGTTTGCTGCTTTTGTTCTTCACTTGCTCTCAAAGAGGACAACAATCACTCTTTATTTCAAATTTTCCTTGGTTCTTCATTTTTATAAGTCCCTTTCATGATTTTAATGTTGTCTATTAAATTGCATCAGATAGAGCCCTAGGCAGGCAGGCAGGAGATGGAAATTCTAGTCCCCTCTGTGTCACTGCTAGCTGAAGGACCTTGGAAAAATCATTAGGCCTCTTTTGGTCTCAGTTTCCTCCCTTCCTGCCTTCCTAATGGTCTGCAGGTTTACACACTGATCATGCAACTGTAGGGTTTTCCCTATCATTAAGTGGCATTCCATGCTGGAAAGCTTTTACAGATTCGGACAAGGCAGTGAACATGATGGGACAGAGCAGAGGACTTTGTGGTGCCCATTCAAACATAAAGGTGAATTGTTCTTGCTCTTCAG
>TTN-209,,0,1455,2078317,2079771,GTAGGCTGCTGGGGACCTGCCAATCCTCTGCTCCCCCAGAGGACATCTCCAGCAAATTGGGAAAGGAGTCCAGAAAAAGCTATGGGCAGAGGTAGATGCAGCTCTTAAACTACAGAAGGGTCTACTGGAGGCTGAATTATTTATAACCAAGTTGTTTGCCTTTTGGAATTTAATTTTCCTCTAGAGTACATCGTAAAAGTGACTGAGAATCAGTTTCTCAATACACATATTAAACACTCAAAAGTATGTTAAGGAAATATTAAAAATCATGTTTCTCAGCAAGTAGAAAAGCTTGGAGCCTTGTTTATAAGTCCTTTAAGGAATAAGACATATTCTCCAGGGAAGTGTGAATCTCCAGGAATTCACACTTTAACAAGCATCCAGATAATTCTGATGCCGGTAGTCTACAGACCACCCATTTAAGAGGCATGTAAACATACCCAGAAGAAAATAAATGCTTGTTTATTATTCAAATGCATGACACTGTTTCCCCAGAAAACTTATCACCAATCTTAGTGGCCTCTGTTGTTTTTCTCTATCCTTTACTACCTAGTGAGACATTAGTATACAGAATATTGCATGCCTTTACATGTTTTATAACAATATCTTACATGAGCTACGTAAAGTTACATATGCTTATCCAATAAACTTTACCTTCAATGATGTTCAATTATAGGGCTATAATTGACCTAAGCAGAAACCACATCAAGTAACATCAGGTAGAACTTTAGCATGCACCCAGAAAATTCACAAATGGAAAATGCACAGGGTTGGCAGCACCTGCTGTTGTTTATTACTCAAAATCATGTCAAAGTTAATTCCACTCACTCCTCACACTTATAAAAAATTTCCTTCAACATAACCAAAAAAATCCCCTTTCTGTAACACAATTAAAATGAAGTAATGTTATTATTGGGATTAACGTTTTAAATGCAAGTAAATATTTGGGTTATTTGAATACCTATCAAGTTGGAGAAGGTTTAGAATTTTAAAAATTAAATTAAAAATGTAATGATTCTTTAAGTAACAGGTACACCCATCGTAGCAACCACTGGAATTCATTTTAATGCAACTTACTGGAATATGCAACATGGCTTTCACATATTAATAGAGCGCTAGATGTGAGGTAGAGGGGGAAGTACCAGAAAGATTCTCAAGAAATGTTATAACAAAATCTAGAGCTTTTATTTAAAACAAAGAAACAAAAGGTGGTGGCCTAAACTGCTCAGCAAAACAAAGCAAATAAAATAAAATATGGTGGTGAGAAAGCCTTCTGTAATCTCCTGGCTCCCATTCTTGCTGTCATTGCTGGGTGAGCTGGGTTCAAGGACATTCAAGGATGTTTAGATTGGCGAGTCATCACCTGGTTTTGGAATTGGAGCTGTGATTATTTAAAAATACCTTGTAGGGAGCACCCTGGCTCTCACTCTTGACTTTGTTCTCTTGTCCCCGCAG
>TTN-209,,0,484,2079772,2080255,GTACGTGCTGGAGGTTGAGGAACAGAGAGAAGGGGAGAGAGCTGGTTTGTGTCTAAATGGGGCCAAGCGTCCACTTGCCACCTCTCACAGCCCTGGGAAGAATGCTGTGAGCTGATATAAAAGCTGGCTTTTCGACACCCATGAAAAGTCCCTGAGATTCTAGTCAGGAGCGCAGAATAGAAGCAATCTGTGCTTATGAATCTCATTATAAACTGGAAAGGGTTTCAATTAAGTGATCTACATTTCCAAATTATTGGCAAATAATGAAATTTTAAAAAATCATTCTAAGTAAATTTTTATCTTGTAATGAACATTTTCTATTTTTAAACCTAATTTATATTCATGCAAAATCCAAAACTTTCTGCAATTTTCTCCATTGGGATATCCAGAAAATCTTTTTGACTTTGTAGTCAGAATTAACAGAATCTCTTTTAAAATGGGTCATTGTGCCCCCTCCCAAACATTCATCTTTCCCTTCCCACAG
>TTN-209,,0,93,2080256,2080348,GTATTTTTCTATACTGTTGGTTTTCAAGCCTTTCAGGCTGTTGCGTCCCCAGCTATTCCTCCTCAACGTGGGCTTTGTTTTAATCTTTTACAG
>TTN-209,,0,4234,2080349,2084582,GTAAAGCTGCCATAGAGAGAGCAGATTATTGCACATTTTGGAACTAGGTTTTGAAACGAGAAAGATTCCCTTGTCCCCCTCGCAGGGCATGCGACGCGGAGAGTGGTTCGCTTCTTCAGTGTCCCGCTGCTCAAACCTCTAGGGGAGCATACAAACGGGCAGGTTGTGGGGCTCCGTGTTCCTCTGGACATCCAGCCGCTTGTGTGTCTGCCTACTAGGGTCTCAGGGGTTTTTATAGGCATAGGGTGTGGGCGTGGCAGGTCAGGGTGATCTTGGGAAATGCAACATTTGGGCGGGAAGGCAGGAGTGTTTGTCCTCACCTAGGTCCATGGGCACAGGCCTCGCTAGGGACCACGCACTTCTCTTCCCAGCACTTCCCTGCCCTCCTCCCGTGTAAGTTTCATGCACTCAAAAATGTAGCAGGTGACAAAGGAGGTAAACCAAGAAGTTACTGAATATGATTTTCACAAATCCTCACTGTCCACAGGTAAATTGAAGACCCTTATAAACTTCTGAATTCTTATTTATATTTCATGTAATAAATATCTACTTTAGGGGCCAAAATATGGCACAGTGAAAGGAGAAGAGCACAGAAGTTAGAGTTCAAAGCCCTAAGGACAAATCAGCCTGATCACTTAACAGTTTGATTTAGGGCAATAAGTATAAATAATAAAATAATTGTTATTATATATGGATCACTTCCTCTATCAGATTGGAACTATACATACATTATCTCATTAAATGTTCACAACCTGTAAGAATTATTATCCTCAATGTTATTGATAGGTAACTGGAATTAAAGAAGTTAAGCAGTTTATTTAAGGTTTCAGTTGTGTCATCTGTAAATTAAAGAGAGTCACAATAAGAATGATCTCAAGCTGCATTTTGGGGCTTCAATGAGATAATTAGTTGAAAGTGCCTTGTAAATAGAAAATAATTATGCCAATATTCTTATATTCAGATGGTAAGTAAAACCTTTTAAATATTTTGCATATGCTTGTGTTATTTTATCTAGAAAATAAAATGGACTTCTATGCTTACTTAATATGGAAGTATTTTAGAAGGTGATCATGTATCATGATCAGGGCTCAGAAATTATATAATCAAGTGTAAATTGTCCACAACAGTTTTGAAAGTTTGGGATTTAGTTTATCATGATGAAACTTTTAATATGATGAAATGAAAAATGTACAAAATTTGAGCAAAGAAGTGTTTATTGATCAATTTAAATGAAATAAAAAACACATGGATGTTCCCTGCCAAGAAAATTTTTTATAAAAGAATAATAAGGAGATAGTTGACCTAAATAATATTCAAACATACTGTAAAGTTACTATAATCAGAACAGTATGGTATTGGTAAATGAATAGAAAAATACACCAGGGGAACAAAACAGAGAGTCCAGAAAGAGATCCAAGTATAATAGATCCAAGTATATAGGGAATTCAAAAAGCAAAGTGGCCTTTCAATTCAGGGGAGGGAGAGGTATTTTAATAAAGAATGCTGGTCCAATTAGCTATCCATCTGGAAGCAAACAAACATAAACCTCTGCCTCTCACTATTTACAGAATAAATTTCAGCTTGATTAAATAGTTAAAAAATGAAAAAAAAAGAGAAGACAATCTGCAAAAGCATTTATGGGTGAAAGCTTTTAAAAAGACAGTTACAGATTCAACTACATAAAAATCAACATGTATGTATGGCAAAAGCAAAAAGTCATTTCTAAACCAAACAGCACTTGTGAAAAAATTTTAAGACCTTTCTCCTCCTCAAGGTACTTCATTGCCTCTGCCATAAAAGTATCACAATAAACATAAAATGGCTACAAGGTAGACAACACCAGCCTAGAAACAGTATATAACATACAAAATTACGTAAGCTTATGCTGGATAAGACCCATAAACAAGCAAAATATTGAAATGGATTAAAAGAAATGGATCTGGGGGAATGTTTGCAACACTTACGACAAATAACCAATAAATGCACTAAATGCATTAAAAATCATCCACAAATTAATTTTTAAAGGAAAAAAATGCAACACAAAAAAAGACAAAAGATACAAAAAAGTATTTAACATAAGAGGCAATGTAAAAGTCCAATAAACATGTGAAAAAAAATGCTAGATGTTTTCCAATTTTTATTGTTTTAGCCACAAAAATGTAAAGATATTGGCAAACACTAACATGAAACCTTGAACAAAAAGCTTACTTTAAAAAACATGTCTAGCAGTCGAATAAAAAAAAATGTTCAGTCTCAGGCTAAATCCAAGTTTGCACACCATGAAATCACAACACAAGCCAAATGCAATTTCTTGAGGAGATAACAACCTAACTATATTTTAAAACCCAAGCCTAAGGGTCATTTAGAATCATGGAGTGTCCCTGATCCCATGGAGCATTTTGACCATCTTAGCAGTTTTGAAAGTTCATTAATAACCATCCAAATTGCCCCAAAATTTTGCTTTCCAATAATTAAGAAATAAAATGCCAATTTGCAGAGAAAATAATGGTTATCAAAGATAGACTGCTTCCTAAATATCTCATAGTTTAATCTTGATTTTTGTTGTAGAGTAAGGCAAACATATTTCATTGAATAAGGTGCATTGTATCTCGCTGTGACCAGGTGATTATTTTTTGTTGTAAGTACAGAAATAAGCACTCTCCTATAATGACCAAAATTACAATGATTTTCACAGTTATGGGCTTACCTGTGTCCTGCTGTTAATCAGTCATGTCATGCTAATCATGTCTTTAACTCTTTTTGAATTAAACCCATTTACTAAGTACAGCAAGAACAAGGCACAGGGTGAAACTTAAAAGCACATGTCTCTTTGCTTTTCTTCAGTTAGTGGAAACCACACATTATTCTAACTTGGTTTTTGTTATATTTCAAAGGCAGTCATGTTCAGAAAAGAGGCTTATTCCCTAGATTTCCCTTTAGTTTGATTACAACTTCATTTACAAAATGTAAATGGATTTTCACACAAAAAAAGCCATTCTTCGAGAAAATAAACATTTCTTCGTGAAACTGGTTAATGTTGTAATGTACTGTTAGGGTACTCTGTAAGTTAGAGAAAATATCAACTGTACCTTGAGCTTAATTAGAATAATCATTTCATGTATGATCAGTGTAAGCTAAATATCCTAGATAGTGACAAGATGCATTTATAAACATTTTCTTATATGCAGAATTAATAAAATGCAATGATAGGGCAATACTGCCACCTAGAGAGGAAAATGTAATAAGCCTTATTAAGAATTAAATCAGTTCTGAAAAAAATTTTACCTTACAATAGTTGGCCAATCCCCAGAATTATTGCTATAGATCAGAAATAGTCTTTTTTGGCCATCAGTGCTGGGATTTAGCACCCAAATTCTTCAACTGATGCTACTTGCACTTTGGATACACCTAAAAAGCAAACAATGAAAACTATTCTGGAAGAAGCAACTTTATCAATTTACCCAAAAATCACAGAATCATTAGTTTTTAAGTTAGTCAATTCCCACAATAACTCTAAAGATATTTAAAATAAGTCCAGAGTGCAATACAAGGGGGGCGAGTGTAAACAAATATGGAGGAAATTAAAAGTAGCTGTCCACAAACACTTCGGCTAAAGCAGCAATTTGCAAAGTGCACTGCACAACCTGTACCCAGCAACATGCTGCAGAAAGCTTCCTGAGGATGTGTCCCCCTGTCCTGGAAATTCACAAGGCATACTGACATAGTAAAGGCTGTGGGAAGTCCTGCAGGGGAAAAAAAAAAATGGCTTAAGCTGCTTAGTCAAGAGTGGCACAAGCATTTTGATTACAGAAACCTTTCTTCTTATAACACCTATTTGACATCCTCTAACCCCCCCAGAATTGGAATACAGAGATGAATTTGGAATACAGAGGTTGCTGGATTTGACATGTCTTTCCTTTGGCTGCATATTAAAGAAGTAGCTTTTTCTGTTGTGATTTTTTTTTTTTTTTAATGTGAGAAGGTGCAAGGCACAAAATCTCCAGCTTATTTGGAATTAAAGCTGATTCTCTTACAGGGTTACAGCAGATAAGAATAGGTTTATTGAGATTTAAAACAAATTACTTCCAAGTACATTATTTACCCTCTGAATGGGTTATGGAGGCACACATTTTAAAACTCTGCCTTAAAGCACTTCCAGCTTTTCATCTCATGATTCACATCCAGTTACCCCTCCTTGCTTTGACATTCTTGACCTCTGCCTTTTGGTTTTCAG
>TTN-209,,0,370,2084583,2084952,GTACTGTCAGAATGGTTTTGTTTTTCCTTATTTCACATTCTAGTTTCTCCAACTGGATTTCTGCCATGAAACTCAGTCTGTATAAATTGGAGGAAAAATGCATATGAACATAAAAATATAGCAGCAACTGAAGACCAAATTCAGTAGTCATGCTTTGTAAAACCATTTTTAATTAGGACAAAAGCTCCAATCTGTGAAGTTTCCATAATATACAGGTTTTAATGATACAGTCTCTGTATTTCTTGGCAATAATAAATGCTTATGTATGAGTGTATTTTGCTCTAGGTGGCTCAGTTTTCCAGTATGCTTTTTTATTTTCTACTGGGCATGTCATTTAAAAAAGTAATCTACTTGGTCATTTCTAATCTAG
>TTN-209,,0,857,2084953,2085809,GTACGTGCGAGGCTGCCATGGGGCACCCGCAGAGCCACGTCCTTCAGTGCACATTAACTCAACCACCATCCACTGAGCTTGGCATGCAGCTGTGCTCAATTCATTCTGAAGACAGCCTTGAGCCCAGCAGGGCCCAGACTTTTAGAACTTTCTGAGCAAAAGGTGGTCGGAGATGTCAAAGGTGTTGACAATGTGAGTATCACAAGAGCAGAGTAGGCCAGAAATACCTGGGCTATATGAGCAGGCAAAAGTCAACTATGGTATTCAAGGTAGGAAGGCAAAGAGTGGCCAGAGAAACAGAGACCAGTCAATTCCAGAGCTCAGTCACTGCACACACTGGATGTGGAAACTACTATTTCAGGGAAGGCATTACATTTCTCTAAGTTTCCCCAAAGGACTTTTGTTTTTACTTTTCTCAAAACAAACATGACACTTGATTCATAGCTGGAACAGTGTCATAAATCCAGGATAATGTCCCACCTCGCATTTGAATAGATTTTCTGTTACAGTTTAAAATCATTCCAGCTTTCCTCCTTATCCTCTTGTGTGACATTTATGTCTAAATCCTGACAGATTATTGTAACTTTTTTTTCTTTTCTGAGACAGAGTCTCGCTCTGTCACCCAGGCTAGAGTGCAGTGGCATGACCTCCGCTCACTGCAGCCTCCGCCTCCTGGGTTTAAGTGATTCTTGTGCCTCAGTCTCGTGAGTAGCTGGGATTACAGGTGTGCGCCACCACACCCAGCTAATTTTTGTATTTTTTAGTAGAGGATTTCACCATGTTGGCGAGGCTGGTCTTGAACTAATTTTTATGTAAGATGCATTAAGGTGTTTTCTTCCTTTCTCTATGAAAAGCAG
>TTN-209,,0,1206,2085810,2087015,GTGAAAATGGGTTTGTATTTTAAATTCACTGAGGTTCTTACAGGGGTCAACACAGATAATCACCTTTACCATGAAGAGTGTTGTTCCTTGGGCCACATGGTTGTTAGCATACTAATAAGATCCCCTTGTTGTATGTGTAAATTTCTGGGTACTGGATACCAAAGTTTGGTAGTGTCCCTGAATGCTCCCCTTGTGAGTATGAAAAAGAACTCTGTGAACATACACCAGGAGTAGAAACAGGGGTCTCATCACATTGATCTGGGGATGCACTAAGTATAAGACTATAGGGAGAGGACAGATGGCTAAAACCAGGAGGAAGAAATAGATGCTGAGGCAGGAATGGGGAAAAGTGGAGGAGACACTGAACTCACTTTGCTTTAGAAATCTTAGCAACTGCTTCCTGGCTCCTTCGGAAGACATTTGCACATGAGTTTGAAGTGGAATGGACAGCATGGCTTTAACAAGCCAAATGACCAGAAAAGGTGAAAAGGACAGCCCCATGGTTGGCGGCATTTGGGGACAGATTGGAAAATGCCAGTTAGTAGAGCTCTTGGCCAGTGGAACCAGTTGGCAGTTGGGTGGTTTGAGAAGATGAATTTCAAGTCCCTTTCAGCCTTGAGATCCTGTGTTTCAGTGATGAGATATTTGAGAATGGCAAAGAGGCAAATAGAGAAAACTGTCCCCCTACATACGCATATACCTTAGGTGCCCAGATGGAAACAGCATTCTTCACAGTATTTAGGAAAACTGACAAAACAAAAATATTGTATAAATGCAGATTATAAATTATCCATGCTTGATTTCTCACATGTAAAATAAAAAGATCAGACAAAATTACTTCTAAAGTCTTCCATTCTGATATATATTCTAAGATTACCTTTAGATGACAGAATTAGTACAGAATAATATTGCCATAGATCTATTTGTAAACATTGGAAGTCATTTTAAAGAAGACTACAATTCTGCTGTTCAAAACAAAGTGTTGAATTCAACTTTGTTTTCTCTAAGCAGCCTACATAATTTACAGTTTAAGGAGAGAAAGAGCATGATCTTATTTATGAACATGGGATTATTTATTTTATTTAGTGACATCTGCAGAAAAGGGATTTTACATCTTCAAATTCCTATGTTGTTATATTTAATAAACACCATATTATTTCATTGGGCATCAGGAAATAAAGTTTTTTCTTAAATCATTCTTTGCAG
>TTN-209,,0,1226,2087016,2088241,GTAAGTCTGATTTTCTAAATATTTTGTAGTTTGTTGACAATATCACATTACAGCCAGCTGCAGGTAGCTTATAGTCAAAACCCTTAAATGGAGAAGTCTTTGGTTGTATATTTTTTGTTATTGTTCCTCTATGTCTAGTATTGAAACTCAGGATGGAAATTATGTTCACATTGCACTATTTTCCACTCACTTGATCAGTTTTCAGGAGATTGTCTACAGAACAGTTTAGGGCACATCTATGAACTTTCTAGAACATACATAAATGGATGATAGATATCATGCCAGTCCAGTTACCCACCGGGACAGTTGGTTTCTTCGTGCATAGCCTAAGCCCTCAGTCACTTAGATTGTAATGCACAAACTTTACATGCACACACACATGCACACACACACACACACACACACACATATACACATACATCAGCCATAAACACCCCGAATAAATAGCAAGGGAAAGTGAGGATATGCCAGACATCGGAGAAAGCAAATACTTCCTCAAAAAAAAAAATTCCTTCAATTCACGGTTGATAAACAGTGACCTAGAAGCATTTGCTGCTGTTGTGCCGTAGAGCTGTGTGAGGACAATCTCAGTGTCACTAAAATCCACATCTCTCCCGTATGTGAAATCAAACCTTTAAGTGTCAGGAGAGAGGCATTTATCTTGAATTCTTCCATGTCAAAGAGGGCGCCTGTGCTCATCCTCCTTGAACTCAAGCTCTTTGCTGATCTTAGAGCTACTTTCTTTAAAGGTCCAGTTGAGAACCTTGTACACTTAAAAGGCTGACCAGAGGCTGCTGACTGAATTTCCCTCTCCTTACTGTGAGTGAGACATTTTGAAAGCAGCAAGAACCCTACTTAGGATAATCAAAGGCATAGAAATCCCCATTGCCATTGCAATGCTGGTGACTGGCAAGTTCAGCTGGCCTATGGTTTTCCAGCCACTTGTCAGCAGCCACCCACCGGGTTCCCTAACACGTTGACATGTCTCAAGATGAGATATGTTCAGTTCTAGGACAATTTGCTAAGGCGCATGTGGGCAGAAAAGAAGCCCATTCCTCAGGAAAGCAGTCTATGTATTAAGCACAAGTGTAGGCCCCTGAAATGGAAATCTGACATTTTATCGTTCACCACTAAGCATCCTGTATTTTCCTGAGTGTTTCAAGGATGTCTTCCCATTGCTTTTGTATCTTTTGAAACTCAAATCTTTATTTTACTCTAAACATCAG
>TTN-209,,0,592,2088242,2088833,GTGATGACTTCCTGCCAATGTGAAAGTCACTCTTGCACCATTTCATTTGCAAATCACCTACATTTTCATCATGGATCTTAATCATCACTTCTTCACTTCCACCTCTTCTTATAATGCAAATAGAAAATTTCTTTTCCCACACAGCTACCTTTCACTGTCAATTCATTCCTAACTTTCAGACTTTCTTTGGCTTGTTACTAATATAATATAATAATTCACTTTAATATCTTCCTATTGAAGCAGATGTCCGTAAACAAGTCAATTCATAATACAAAAAATTATGTGCTATTTACAGTGCTACTGAAATGTCTCAGAGATTGCAGTTTTAAAAAATGTGAAAAGTACAAAATAGCACTCATTAGTCTTTTATTGCTAATCACATTTTTTTCTTTTAAACTGGACTTATTGTTTTGATATTTTTGCCAGTGAAACAGTATGGATGATCAAAGTAACTCAAATGATATATTTTAGTGCAATTAAAATTTCCTTGAATAGGAAGAAATTTTGCCTCCTTTCTTTTTGACTTACGTTTCTTTTATTAAAGATTTATGGAATTTAATGACTATTTTCTTACTTTCTTTTGTATGATCAG
>TTN-209,,0,480,2088834,2089313,GTGAATACAGATATTTGAGCTGTGAAAAGTTCATCTTTAAACTAATTTCTAGTAAACTATTAACTACAATATGGTATGAATTATTAATCTGTATTTGCCTTTTAAAATCCCTAACTAAAAACAAAATGGTAAATATGAGACTGATTATCATTAATTTTATCTGCACATTTGATTTTCATCCATCTGTAACATTTATAATTCATTTTATTCACCATTATTCTTTGCATGAAGATTAGCATTTTTTAGCTTAATTTTTAAAAAGTGACACAGGGACTCATCTAGAGGTTTTTTAATAGCTAACATTTCTAAGTTTTGTGATTCTCAGTCAGTATATGTAGACATTGCCGGTGAAAGTTTATTTCTCTTGTGTATTTAACCCTGAATAACCATCTTGCATCCCCATGAGGAAGGGGGAAGGGTCATACTATGTGTGTTTGAAGCCCTGTTCAACTTAAATCTTGATTTTACTGTAATAATCAG
>TTN-209,,0,3218,2089314,2092531,GTGACTATTGTTGTTCCAAGTGTGAAATCCCCTATTATAATACATTAATACCACATATCATGTGAAATTCCTTATTGTAATACATTAATATCAAGTCTCTGAATTTCTTATGTATGAGTCACTATTAACCAAATTTATTTTTTAGACAATTAAATAATTGGAAACTAAAAAAATTTATTATTGTTAATATTACTACATATCCCTTTCTCCACTTATCTCTTCACCATTATTGTCAACATTTTATTAACATCTGGGAATCTTCCAGAAGTTGATTAAAATTGCATGCAGGCTAATTTTAAGAGGCCCATGAACATTTTTTAAAAACACGGAAGATGTATAAGTAAATGATGACTCTTACTCACTGTCAAGAAGATGTGTGTTTTGAAGGGTCATAAATTCAGTATATTATGTTATGGAGTATGACTTATTTCAGTAAATTACCCATAATTTTCTTTGTATGAAACTTTATCTTTTTTCCCTCCTGTAAATATCAGAGGAGAAGATAAGCTGAAAAAATTATAATGCATGCTGTAGCAGCTCCCACTAAAGCTAAACAAGATGCATATTAAAATCTAGAGAAGGAAGTATCCAAACAGAACAATTACACATAAGCCATGAAAAGATTACCGTATCTATTTGTAGCTATGAAATATCCATGAATTAAACTGTTTCCCATGACTCTGTCATTTACTCCAAATGAGCCATTTACCTAATTGTATTCTTTATTGCTAATATACCACTTGAAAATTAGCAACTAAAGTTTTTCCATTTCATTAGCAGGATGGCCTGAATCCTATTTGTATTTCCCTCAGTGTCATTTTCTGACTCTACATCTTTTTTTTCTAAGATATGATTTAAGATAAACTTTTTAAACCTTTACTCAAATCTAACATTTAATGGCATATCAGCCTTTCAGAAGTCTCATAAATGACAGAAATTCCACTATGCAACATACTTCATGAGTGATTAACTTTTTACTTTTGTTTCCATTCAAATTTTGTCATGAATTGACTATCTTGTTTTTGTTAAAAATTAGCTAAGGATGGAAGCTGAGAAAATGTTTATACCTGAAGTAGTAGTTACCACTGCAAAATCTGCTGAACCAGCCACACCGCCAATGACTAGAGAAGGATTCACTATTAAACAAAAACAAATACATCTTTTTCGAGAAGAGATGAAAACTGATGCTATGGAGGTGAAAAGTATTGTTTCATCCCATTTCATCATCAACTCTCATAACTTTTCATCCGTCGTGAATTGTGCTTCTAGTGTTCCATCTAATTGTTTAACTGATCAATAAAACAATAGAGATGGTTAGATTCAGTCCATCCTCCAGTTGAACAGTGAGCATTTCTAGTAGTGAAAAGTCAGACCAAATAATACTCTTCTTTATGTCTCCTAAATTTATTCTCAGCATTTAACTCGTATGAATTGGAGTATTCTAGTCCAATTTGTCTTCCTGCTTCTCTAGGTTACAAACATGTGAGAGATATCAAAGTCCACTAAGAAATAAAAGCGGTTACCAGCATACTCATTTGTAGTCCACCAATAAGTGTGTGTATATAAATCTGATATACAATAATTCAAGGAAAAAACAGACAGATGCTTCCTCAATTTAAAATATTTTACCATGATTAAGATTTTTCCATATGTTTAAAATCAAGAACAAAATTTAAATATTTCAGTTGTGTGATATTTAGTCATATGACAGTTTCTTTGACAGTTTCTTTTATCATTGTTAAAATAAAATTAAGACTTAAGCTGACTACTTCATAGCAGACTGGCTAAAAGGTTCAAATGAGATATAGTGGAAATGTGATCACACTACAATCAAAATAATATTTATTTATTTAGTGTTATCTGTCGAAGATGTTAACATTTTAAAATGTCTATACAATTAAAGTCAGCTCATTGCCAATATAGTTTTTAAAAAAGAAAAAAATAAATGGACAAACTTAACTCACCTAAGCCTCATGTGTATTTTATGTTTTTTTCTGAGATGATGCAATCTAAAGTGAAGATGGTATTTGCAGTCCTTCGAGGCAGATGAAATTGTTTGTGTCTTCCTAAAAGGAAGCCCTGGATAAAGCCCATGATCACTAAAGACCCAATTCCATCTCAGAAAAATCTCATTTATATCTTGAATGGTTCAGAGAATAATTTTTAAAGATATGCAGGTAGCATAGTTGAAGAATGTTTCTGATGCATTCTAGATTCTATTCACAGGTATAGAAAACTGAATATTAATAAAATTTTCCAATCTTACTTTTAAAATGCACTTTTAAAATGTACTTTTAAAATGAACATGGCTATGTGATTTTTGAGGTATGCTGTTTCCAAGTATCACATAGAATCATAATATCTAAGCCACATCAGCTAGTTTGCCTTCTTTAAAAGAGAACCTCCTCTGCAAATTGTATTTCCATTAATGTTCATCAGACTCAGAAACGAGAAAATAATATTTGTTTCATTCTTTGCTTTAACTCTCCATAATAATGAAAGTAAATTAAACTTCAATGTGAAAGGTTGTTCTCTTGAATCCAAACATGATAACACTTTCATTTTAATCACAATATTTTTATTTGCACGGGGTTCTCTTTGTCATCTGTGTGTTTTAAGAAAGGTATTTTCTGATAGATTAAACAATCTTACCCTTAGGGAATCATAAGTAAATTCATATGCTCACTCTGTGTTTGTGAGCTTTCATGTTATGTCCGATTTGCATGCAACCATATAACTCTGTAGTCACTGATTTTTCTGGACAGGATGATGACGGTATTTGAGTGCACTTATATCATCACTGTCACTGCATTAATACCAGACTAAATGGTCAACAAGATAATAAAAATAATCAGTGAAAAGAACCAGCTCCAAAATTCTGATTTTCCAATTGCTGATTGATTGTCTGCCTGGAAAAATTCTAGAAAATTTCAAAATCTTCTTGTGATTTTATGTTCATATTGTGATTGTCCTATGTTGTGTATATGTGATTTAATGTCTAGTATAATTAAGTAGGTGTACAGAGAGTATATCTAAATAGATGTCTGTACAATATAATAATCAATGAAATAGTCCCTAAAAGTGTTTCTGAGATACATTTCTAGACACGTTAACACTGCTGTATAATGTGGACGCCATCTGCCTGTCCTGATGCCCAGGAGATATTCCAGCCTGATCTCGATATTCCTATGTATTAATTCTGGAAACCTTGTCTCCAG
>TTN-209,,0,105,2092532,2092636,GTGAGTCTATACCTGCTGATTTTTCACCTTGTTCATGGTAAAGCAAGCCTCACTGCTGTGGTCATCTGGTGATCAATGGTATCACTGAGTTTCATTTCAATGCAG
>TTN-209,,0,1268,2092637,2093904,GTAAGAAGTTACAGAGCATGATACAGAAATGTTTAAAGGAAATAAGTATCTAACCTGTGAAACAGAGCATCTCTGGGGTAGGCCAATGGAGGATTCTTTTTTGGTGATGTGTGTGTGCGTGTGTTTGCATTCACAGTGGGCCCAGACACCCTAAAGATTTGGTTTCTGAAACTCGCCCAGGGGAGTGAGCCTAGAGTCACAAGTGGTTATCTTATACCTCTGAGGAGAGACAAATCCACACAGGCTTCTCTCTAGTTCACATTTCAGGGACAGCTCAAACTCAATTGTTTTGATTACTATTGTTCTAATGATTTTGTGAAAGGTAGTGTGTTACACAGCATAGTTTTACTTATGCTGTGAGACATTTCAGAGTAACTTAACTGTGAATGTGTTTCAATAATAAAGACAGACATTGAGAAATCATATATTTATATACTCAATATAGCAAGATGGAGAGGTGGTACTGTATGGTGGTCGGGTTGGATTGTGGAATCAAATAGCTCTGGATTAGTGCCCTATCTTCTCCCTTATAATCTCTGTCATCAGGAGAAAGTAAGCATACATGTAAAATGCAAGTAAAAAGGACATAAAAACCTGCAGTTGTCAGCATGTAATAAATCCTTGATATTAGTCACTATTGTTATTATACACATCCAAGAAATAGAACCCAAACCTTCTATGCCTTCAAAGAACTGTAAGTTACATATAATGCCTATATTTGATTTAGTCCCAAATTACAAAACAAATAACCATAGACCACAACAGAATAAAAGCAGTAAGGAAACCTTTAAAATATTTTTTCTGAATGTCTTCATGTTTACCTTTCACATAGATTTGTGGCTAAAACCCAAATGTACTATTGCAAAGTAGTTCTTAGGCATTTACCAACAATTTCAATAATTTCTTAATTTTGAATCTCCCACTGTGGTATTTTCAAAAGTGGCATTCATCGGAATGGTTAAGTGAAAATTCGTGACTAAGCTTTAGAAGATCCTGTCCTTTTATGATAAAAGCTGTAAAATAAGGAGTTCTGAATACAACTCTTTAAAAAAGATATTTTAAAATTTGTTTTACAAACTAACAGGCATGACAAGGAGCTTTATAATTGGCTTATCTCTAAATGACTTTTCATTAACTGTGTGATAATGAGTGCTAATGAGAACATTAAAGAACAGACCTTATAGAAAATAGGCTCAGACTCAGTCCAAGAGGGCTAGCCATCGGAGGATGGTTAAATGACTTTATTTTCTGACTCTGTTTCCATGTAG
>TTN-209,,0,284,2093905,2094188,GTTGGTCACTGGTTACCCGCTGTTACATGGTCCACTCCCATTGAGCAGGGCCAGGTGGTTGGCTAGTTTGTACTGAAAAGTAGCCAGTGGAGTCTTGCCTTTCTCCTTTGCCATACTAAGACTTGATTTTTATGGAGCATAGTATGGGTCAGAGATCATTTTCTCAAATTATTTTTATAATTATTTTTATATTTTTATAATTATATAATGTTGCATGAGCTAAGAGTTTATGAGATTTCCCTTAATTTCATGAGCATTTTGTAATATAATTTGTAAAAATCTAG
>TTN-209,,0,655,2094189,2094843,GTGAGTAAAGAAGTTGATAATGCTGGACCCTATTCATATCTCCTCAAATCATTTTAATACACGTTTGCAAAGATCAGTTTCTCAAATTAATACAAAAATGACATTAGTGAGCTTACAGATGCTCATTTTAAGACCGTATTTGGTCTGGAAGACCATATTTGACCATATTTGGCAAGGAAGAAGGGAATTCTATGTGGTACATCATTCATGGATTCAAAAGATTTAATGAGCTTCTAATATGCAGAAGGCATTATTGCAGGAGCTGTGCAGACATAAAGACCAATCCATCCCTCTTTGAAATATTTTCTTTGCCATCAGAGAAAATGTACACAAACAAGCATAATAAAATATATAAGGTGATAAACATCACAACAGAAGGAGAATCCATGGGAGGCATAGATTCATTCCAGTTGGTGATACCATGGCAAAGCTTTGTTGAATAGGTAGCATTTGCTATTGAGCCTTACAGCTCTTTACTAATATATTAGTATATTATATAAATATTAGTTTCTCTACTACTATTTCTGGAGTCCTGATTAAAAGGCCATTTTGTGGCAGTTGAAATGCATAAGTTCAAACTCTACATTTGTTACAAAACAGAAGTGATTAATGAATATGCACACGTATCATTATTTATTTTTTCTCCTCTCTTCAG
>TTN-209,,0,203,2094844,2095046,GTTAGTGGCCACCCTCCCACAGTCCTAATGCACATGCCATCACTTTCATCTGACACTCTTTTCCACAATATGGTTTCTGTGCACCTTGAAATGATGTCCCTTTTTGGAACTTGGGGGGAGATTATATGGTCAATTTAACTGTCAGTGCTAAGCAGGGGTCACTAAACATCTCATCTCAATGAGAAACTTTTGTCTTCTTTTAG
>TTN-209,,0,111,2095047,2095157,GTAAAATATTTTGCTAATTAGTAGCTGTTCTAGTACCATTTTGACTTTCAGCCCCACCAGTATTGGCAAATTGCAACCCGGAAGCTAATATGAGGGGAATTCTCTTTCCAG
>TTN-209,,0,948,2095158,2096105,GTATTTTGATGGCTGAATATAGAGTTCTCTGTGACTTGTATAATACGTGCATGAAGCCTAGAGTAGAATTTACTCACCCCACCGACCCTGAGCATAGGCTCTTTCATTGTGGAGCCTTCTTAGTTTGTTTTGAGGTATTTTTACATTTTTTTTGTGCAAAGTCTTCCTAAGAAATAAAGCTATGTGACAAAAGTGGATGGAAGATATATTTCTTTACATTATAGTTTAATTCATTGAGTTTGTGAAAGTAGAGAAAATATGGATTTTCACACAAACACACCCACACACACACACACACACACACACTTCCAGAAAAGATTTGAGACAATTTTCAATAAAAACATGTAATAACTAAGTGACTAAAAGATAGAAGAATAGCCATGTAATGAAGAAGAAAGCTAGTTATGCACAAAAATCTATGCTAGTAATTTTTCTTCAATTCAATATAAAATTTAGCTCTGAATATTTTGCAATTTAAGATAAAAAGAGCAACCTGGTAATCTAAAAATGTAGGTGCCGTACCTTCATAATAATAAATATAATGTACCAGAGAGTTAATACTGAAATATTTGAAGGAATTTATTGTTTTAATTATTCATTTGATCTCTGAATGAAATAATGAGAAAAATAACGAACAAAGAGAAAATACCTGTTGTTTAAGTGACCTGATCATTTGCTAACATAAACACTGAAAACCACTTAATTTCATGACTGATTCTAGCAATAAATATTCTTTAAAATGAATATTTTAACTTATTTGGCCCTAATTACTCATGTTCTTGCATTTTTCTCAATTTTCAGCAATCTTATAATCTATTGTGGAGCTTAGTCATATGTTTAGGGTCATTGAATTTTATACCACAGATCCACTCACAGATAAGTCCAATTATTTTACCCACAGAAGAGTTGTTGATAACTGATTTTTAAATTTTGTACATTTACATAAAG
>TTN-209,,0,915,2096106,2097020,GTAAGTGCAACTCCAGTTTCTATGTGCATGATAAGAACTGAAATACAAGGAGATAGCAGTGCTGTCCGTTTGCTGAAAAACCTGTTGCCACTTACTGGTTCTGATACTTTGCCCCAGTGTCTTTGCCTCAGTTGTATGGAAAATGTTTTAGACCACATGGCCTCAAAAACTATACTGTCATTAAACTTCTGAGGTTCTAGCAATAGTTTCTTTTTGTTGTATTTGTTTCTAGGCATATCATGCCTCTGAAAATGCAGAGATTCTAAATCCGGTTGCCTTCCAGGCCCAGGCAGGTAACAGTGAGCTCAATGAAAACAGTAGCAAACTGGAGAGTAGGTGCCCTGCCTCAAAGAGACAGTAGCTGTGTTGTTGCCAGGCATGCACCAGGCTGTTACCAGGCTCAGTGTTGCTAGAGCTCCTGATATCTTAAAGAAAACCTGGAAGTCAGGATTTTCAATGTTTATAACTTGAAAACAAATGTAACAGCTTTCATGCTAGACTGTTCACATTTACAGTGAACTGGCTCACACTCTGTTTCACTTGACCTACACAGTATCCCTTAGAGGAAATTACAATATTATCTTCATTTAGCAGATAAAGCACTCAATATTCAGGAAGGTAAATGAATTGTTAAAAGACACACAGCAAATTAGGAAGTCCTCCGTGGTAGATCCCCCCAAAACTGACTGCTAATATAAAATTCTTTCTACAATTGTAATGGCTGGTTGGATTTGTTAGTGTTAGTTTGGTTTCCAAATTCCATCTAGAAAATATTGAGCACTTCAATAGTAGATATTTGGAAAATTTGGTTTTTGGTTATCAACTTTCCCCAGTGTAGAGTTTACCTGAATGCATAGTGGTATGACTGTTTTCTAATAAGAGCATTAAAAATTAACTGATGTTCTTAACTCTTAG
>TTN-209,,0,537,2097021,2097557,GTGAGTATAAAAGTAATGACCAACCAAACAATTTCATAAATTATACTTTCCTTTTTTTATTTGATATTTTCATTTTCAAGTGATGAGCTCGGGGTTAGACAGCTATTAGAAGGTCCAAGTTCACTGTTGCTAAGTTTCCTTAATCTTCATGGTATGTTGCACCTGTGAGTTTAGAAATAGAGATTACATATAGGCCATAAATGTGACTTTAAAAATAGGGCTTATAATATATTAAGGAAAACACCAATATTAGCACAGCTGAGTTCATTCATGCCAAGATCTCTTCATCTGTGTGATAAGCTAATGTAACCTCTAACCCAAATCTAACTCCTGCTTTTGGAATACCTTTCTACCCAAGATGCCACAACATTCACTGGGAAAGATGACCATAATGCAGATTAAAACAAACAAACCAAAAAGTCCTCTAGATTCTTCTCCCAGCTAAAAACTTCAACAGTCTAGCTCAGATACATCTCCTTAAATAATTTATATCAGTAAGGATATGTATTTTTAACAGACCATAATCTTTTTGCATAG
>TTN-209,,0,110,2097558,2097667,GTAAAATATAAACATTTATCATAGCTCCTTGCCACAGTAAAGATACAAATTGGTTAAAATATAACTATTTGATGTAAATTTTATTCATACATGCATGGTATTCTTTGCAG
>TTN-209,,0,898,2097668,2098565,GTAAGACTTGTAATAATTTGGGTTATTTAGTATGTAAATTGTTTTCAAAACATCAAATAGTAGCAAATTGCTATTGTGTAAGAAGAAAATCGAGGGCTAAAATGGCACAGAAACTTACCATTGGCAACACCAACAATTGCCAGAAGTTTTTATTTCTTGCCCCTGTGTAAGATGAGCAAAGAATTTTCATCAGTGTAACATACTGTTTATTTTCCTAGTGCTATAGCTAATATCACAATAGCTCTTATTTGACACCTGATTTTTACATATGTAAATTTATACAACAGCCCTGCAATAAAAAGATGACTATTATTGGTTTGGAAATAGGAACACTGAGGCCCTGGGAATCTATGAAAATTGTCTTAATTCATCCAGCCTGTAAGCGGTGGTGCCAGCATTCAAACTCCAAGTCAGTCTGGCTGCAATGTGTAGATGGAGTCTTGTTTTGCTTTGTTTTGTTTCCAAATTCATTTCTATGTTTTCCTCCTCTGAGATAAAGAATGTGTATTTTTTATTTTTCCATAAATGTATTCATTGGTTTACTTATCCAACCAACATTTATTAGGATGTTTTAGTAGTTAAATCAAAAAAGTCTAGTGACTGATTAAATCCAAGTGGTAAGGAAAAGAGAGTATTGAGGATTATTCCAAGATTTTTGAGCCTGGGTACCTGGATATACTGAATGACTACCAGCTAAAATTGAGAATATAGGAAAAACATAGTTGTGGGGGCAACAATAATATATTCTATTTTAGATCTGAATGAGTTTGAGGTGCCTTCTAATACGTGCAAGAAGTAAATTCTAAAATAACATGAATAATGAATAAGACAAAATGAAGTTTGTTTTGCTGAGTTTTCTTTATGCCTCACGAAAGTATTGTGTGTCTTTGTTTTGCAG
>TTN-209,,0,119,2098566,2098684,GTAAGCGTGATAAGTTTTTGCTCATGAATCATAAAAACACAAAAACAAGCTTATGTATGCATCTAACAATTTTTAAAAACTATTTTAAAATCTACTTTCTTTTAAACATATTTTCACAG
>TTN-209,,0,102,2098685,2098786,GTAAAATGAGATAAAATAAAAATAAATGAATTTTCTTATCACTTGGGTTATAAACAGGTATTTCAGCCTTACTCCCTCTAAATCATGACCTTTCTCTTTCAG
>TTN-209,,0,99,2098787,2098885,GTAAGTATGGAAATAATAAAGCTAAGCTCATTATACAAATCCAATAACCAGGGAAGCTATACCACTATATTGATTATTCCCTCCCCCAACTTTTTATAG
>TTN-209,,0,153,2098886,2099038,GTAATTTGCATGTCTTTCCTTTGATGGACCTGTCTTTGTATTCAAGAATATCCATGAGTGTGTTTACTTTTATTTTCTTTCCCCATTCCTCAGGTTGAGAATTTAATTTAATATAATGTGCTCTCCCCTTTTTCCCCCACCTTTTTCTTGTAG
>TTN-209,,0,447,2099039,2099485,GTATTCAACAACGAAGGATTTCATTGTTTACCTAAGCTCTAAAGTCACCCTTAGCATGTGGTAAAATTAGCTATGCAATTTTTCTTTCATGAAACAATTATTTGGAAATTGACTATAAGTTTCATAGCCAGAATCATAAATTTATGTTCGTAATTAAGAATGTTAACAATTTGACCATTTGGATTTTTTAAAGTAGTATTATCTTGATTTTTAGCTTTTAAGTTTTTTATTGAAGCATAATTCTTTACTTTCAAAAATATTTAAAAATTAAAATAAAATAACTGCTTCTTATTGAAAATTTATCTCTCAGCCCATCAGCGGGTAGATATTAAGAATACACCTGATAGTATGGGGGAGATAAAAGACATACAAGACATCATCTCTATCCTAAGTCTAGATGCATACCTCTCCAAAAAAATTGATTTATCTTTCTGTTATACACTTCAG
>TTN-209,,0,96,2099486,2099581,GTAAGTCCTCCCATTCCTGTCAGCCTGCAGTGAGCATCATTATGGTTTATTGATAAAAAATGATCATAACATTCTTTTTCTCCCCATATTTCACAG
>TTN-209,,0,112,2099582,2099693,GTGAGTCCTAATTATAAAATTTTATGTTTACACTATTAAGCAACATAAAGAACTTCAAGGAGCAGACAATTTCAACAAAATTCATTCATCTTGTGTGTGTATGATTTTGCAG
>TTN-209,,0,92,2099694,2099785,GTAAGGATTATTCTACCTATCTAATAATTACTTTAAGCATTCTACTTTCCCAGTGTAACAATAACCAAGAGATTATTTTATTTTTTCCCCAG
>TTN-209,,0,1637,2099786,2101422,GTTGGTATATTTATTAACCTAAATTCTTACGAGGAGTGATTGTTATTTTAAGAAATTATTATTCATTTCCCCCAAAATTCCTTTCAGTTTCCCACTTCCATGCCTCTGCTTATGCTGTTCCCAAAGCCAATAGTACTTGCAACACCATTCCCACCAGCCTAAATTACAAATGTTCTTCTAGGCCTACCTCAAACGTCACCTTCTCCATTAAACCTTCCTTAATCTCTCCATTTGTATATGATCTCTTCCTCATCCAACCCCAGGATCACTTTATATGTGCCTCTTTCCTAGTGTTTATTATGCACTTGTCTTATTCCCCATTTCCTCTTTCAATATCAGTGTATAAACTCCTGAAATCTGGAATTCTATTTGTATATTCCAATATATTGCAAATGACAGATAATCAATTGGTGTTTGCTGTATTGAGCTTTATTTAAACTTCCTTACTCTAAAGAATTATTTCCTTTTTTAGCCATTCTTGCTTCTTTAGCCTTTGTGCCTTTTATTTTCTTCCTACTTTTTAATGAAATCAATAAATATTTTCAAAATACAGCTTAATGTAACTGTATTTCTTATGATATCATGTAGAAATAAGACCATCATTCAGTAGAATTTCTTAGCTTTACAATGAAGAATAAAAAATGTAAATCAATTGCCAGAAAAAACTAGAAGTCATCATTAATTTGTTTGGTTCATTACAGTTTAAATTTTGAGGAGTTGAGATGTTACATTCAGATCGTGTTGTCCATTACATCTAGTATTGAAGCAAGTCATATGGTAATGATTTGTCTTATTTGGTATGAAAGTTTCATGGTTTATACTTACTTACGTTATAAGATTTCTTCAGAGATCGGACCATGAAAAGACTTGTAAAACAAAATTTCAGATTCAGCATTTTTATACATTTAATATAAATTACATGTTTTAAATGTGTGGAAACAGGAATAAACTATGAACTCCTCTGTGATTTCACCCAGTGTTTTTAAAGTACCTACCATTGGTCAGACACTTGTAGAAACTCAGGACACAAAACTAAATAAGAAATGATTTTTTTCTTGAGAAATTCATAATTTAGAGAGGACAGATACATAAGCAACTAGCTTGTTAAAGCAGTAATTATTTCTGCTAATGGATGATAAGAGTGGAGGCAATGGGGTGAAACTTCATAGAATGGGCGACATTTGCCAACACAGTGATTTTTAATATATAGAAATCCTCAATGTAGTAGAAACATTGATGACTCGTACATTTTGTTTAGCAAATTTTTATGTAGTCAAAATATCAGATTCCCAGGAAATAATCATTAAAAGACCAAGTAAAATGCTTTTGAAGAAGAAGGAATTGGGTTAGAGACTATCCTGGTGGTATACTGTTCTAAGAATTTCCTATTAATTCAACAGTTATTTTTTCTTCACAAAACTTTTCTGATTCCAGTATTTCTCCTAATTATCAGTTATGCATACTTAGAATAAGGGATTTCTTTGGTACCTTCTCAATATGGGTAAAAACAATCATAGACATTTCATGATTTCAAAATCATGTTCTTAAATTTGATATTTTATATTTACTTCTGCAAAGATTTTCCCATTGTGTGAATATGTTTAAAGGACTCATACTGTACATCTCTTGTTCCAAAG
>TTN-209,,0,535,2101423,2101957,GCAAGTAACATAGGATTTGTCCTTTTCAAATCATATTACAATCTTGATCGTTATCGTTTTAAAAGACAAACGATATGGCCATTTTGGATACCATAAATTTTCATTTCATAAAGTCATTCTAGATCCTCTAAACCTTCCTGAGACACATTCCACAAGGTACAAAATTGCTTATCAAATGCGTTTATGCAAAAAAGCCATTTCTTAGGTTAAAGCTCTGTGAAACAGCTAAATCAGACACTGATTCTCCATTCGTCTTTCACCCTTCTCCAATCAGTCTATTATGCTGCTAATACATAGCTATGCAAACTTCATACTACTAAAGCATAGAAAAATCATTTCACGATGTACATGTCCAGTTGGATCCCAGGTTCCCCTAAATAATCTCAGGTGTTTTTTAAAACAGAGGTGCTGCATAACTGTAAAATGTTTGGTAGCCATTCTTTTGCAGGGTGAGTAAGCAATGATCTTGTTCAGGACTTCTTTTCCTTGATGATGTCATCTATATTTTCTAACCCAATCATAAATTTGTCTTTAG
>TTN-209,,0,91,2101958,2102048,GTAAGTTGATTTAGAAACACTTTTCAAGCAGTCAGCCCATGGTTACCATTAAGTTAACCCTATCACTGAATTGCTCCAATTTTCCTCTTAG
>TTN-209,,0,120,2102049,2102168,GTAAGTATCAGGCAGCCCCCTACAGCCCTTTCCTTAATGAACCCCATGTATCTATTTGTTTGGTTTCATCTACTTTTTAAACAAATTGTATTAACTGAAGTGCTCTTTGATTTTACCAAG
>TTN-209,,0,745,2102169,2102913,GTAAGTTAAAAAATATATATATATATATACACATATATATAAAATATCAAATATTCAGTAGATTCATTGATATTCTATATCCTACACTTTGCTGACCACTCAAAAATCCTTGATTGGGTGGGCAGGGTGGCTCAAGCCTGTAATCCCAGCACTTTGGGAGGCCAAGGCAGGAGAATCACTTGAGATCAAGATTTTGAGACCAGGCTGGGAAATACAATGAGATCCTGCCTCTAGCAAAGACAAAAGGAAAAAAAAAAATTAGCTGGGCATGGTGGCACACACTTGTAGTCCCAGCTACTCAGGAGGCTGAGGTGGGAAGATCGCTTGGGCCCAGAAGGCCAAGGCTGCAGTGAGCCACAATCACGGCACTGCACTGCAGCCTGGGCGACAAAGTGAGAACCTGCCTCAAAAAATAAAGAAAAAAAATTGTTAATTGAAACATCTAGTATGTGGTTACACTGAGTAAAGCACTAGTATCTCCACCTGGATAAAATGTTCCAGTTAGAGTAGCATTGAAAGGCTACCTGGAAAGATGCCTCAGTGTCTATCACTTGATCTTTCTGTTCCTCTGTGAGTTGGCACTGTCCTGTATAGTACATGGAAGGTATCAAAGCTTATATCTCTAAACTGTAATCTCCTCAACAGACGCACTAAAAACATTCCAAATTTTTATTCTGCACCTGTTATAACCCACATCATATTTACGTAAAGTCTCCTTGGGTGTTTTTTCTTTTCTCCTTTGCAG
>TTN-209,,0,517,2102914,2103430,GTATGGTTTCATACATATTAGATCCATAGAAAAAATGTCATACATGCTTTATAAAATTTAGTGTATCAATTAATGAATGGATAAATAAAATGTGGGATAGCCATACGATGGGATATCATTCAGCAATAAAAAGGAAGCACTACGATATGCTACAACATGGATGAACCTTTAAAACTTTATGCTAAGTGAAAGAAGCCAGAGACCATACAAAGACCACATATTGTATGATTCCATTTATATGAAATGTCCAAGATACACAAATCTATAGAGATGTAGATTGGTGGTTGCTTAGGTCTACAGGGGAGACAATAGAAAAGTCCTTGGGGTGATGGCTAAGGGTTACATGATTTCTTCTTGGGGAATGAGAATGTTCTAAAATTATGGTGATGGCTACACAATGATGAATACATGGAAATTCATTGAATTGTATACTTTAAATTGGTGGATTGTACAGTATGTGAATTATATCTCAATAAAGCTGTTAAAAATGTTAATTTTTCTACATGCTATTTTCCAG
>TTN-209,,0,89,2103431,2103519,GTCAGTTGTTTTGTCTTGCTACATTCCAGTAATTCCCAGTTTCCTCTGAATCACCATACGGTAAACTCGAATTTCCATTTCATCCATAG
>TTN-209,,0,1146,2103520,2104665,GTATTGTCTACATACTAAATGTTTTGAAAAATCATCAGTAGTCCATAATCTATCATTTTATATTTTAATGTTTCCCTTTTACATTTTCTAACCACCATCCTTTAAAGAATTAAATCAGCTCATTCTTACTTGGCTTAGACTCTCTTATGCTGACCTCAATTTAGTCACAGTTTCCACTCAGGGAATAAGGGTGTCCCTAGCAGCTGTCTAAATACGTTAATTAAAGCAGCTGTAGAAATTTCACTGTCTAATAAATGGCTGCTTGCCAAGCAGCACCAACCAGAAAAGAATTAAAATGTAAATCGTGAGGTTCACACATCAATTAGAATTAAGGAAATTTAGAACAAGGTGATATTTTCTCAGAAGGTTTCTATCTGTGGAGAGGCAAGTGTCAAGGAACTTAGTGGCTAGAAATACTTTCTGTGAAGTCTAAGAGAAAGCCCTGTCCAAGCCGTGCTGGGTTCCTGGCAAGGATGCTGGGCACTCTTGCTGTCGGCTGCATTTACAGAGCTTGTCCTCATAAGTGTCCACCATCCCAAATGATATAATGGAGGAAACATGTCTAGAGAAATACCAGTTGAGTTCAGCTTTATCATATTGCTCATCCAAAGAAAACCAGGCTTTACAGACTGTGGACTATAATGAAAAAGGCTTCAATGAGGACTCAGATAACCTGGAGATGTCTTCCATCATTTATTTGCCAATTCTGAACCTCAGTGTTCTCACTCTTAAAATGAGGATAATAATTCCTACCTAGCCCACAAAGTTATTATTCATATAAAATGAAATCAAATTAAGTAATAACTTTTTAGACAATAAAAAGCCCCCAAAGGTAAAGCATCATTATATCCCTTATTAGTAAATAAGAAGCAAACATTTAAGGATGAAATAATTGTCTCTTTGGGGCAGCTCCTTTCCTCCATGCAGCTGTAAACACAATTCTCTACAAGAGAAGTTTATGTACCATTTGTCCAATACTAGGCAGGAAAAATTAGAGAGTGCTATAATCAGCCAACTTATTACATTATAATATATTGGTTTCACATGCCATTCATTGACCAGTTTTAGAAATTGATTAACTGGGAGGAAACCAGAGCTTCAAGTTTTTGTTGTTGTTGTTGTTTTTTTATGTTGTTCCATCAACAG
>TTN-209,,0,1569,2104666,2106234,GTATGTAGGGACAGATTTCAGCATATTTTGTGGATCCATCAGAAATAATCCTCCTGTTTAAGTCACTAAATTCTTGTAACTTGAAGGAAATTTCTAAAGAACCTATGGTATTCATGTGGTTCCAGCTACATTTTTTTTCACATTATATCTATGGAAAAGGGAGGGCAGCTGTTAAAAGACCTATTGAGAAGTTATTTTCAGAAAGCACCTGATGGCCAGATCCTCATCTGGTTGCTCAAAACTATTGAACACCCATTGGGTGTCCATTTTCATATACCCCAGATGAGCTTCTAGATTCGCTGTTAAACTATTTTAGTTCTCTGCCCTCTGCCTGAACTGCTCAAGTCCTAGCAGCACTACCAAGTGAAAGGGGTGTTTCCAGCCTCTGATATGGAGTGCCTGGGAGAACTCAAAAGTCCTCTTTGAGACCCTGGAAGGCCTAGAGAGCCTCAGGCAATGTGGAACTCGATCCTCTCTACCCCAAGCTCTAAGAACAGGGGCTCTTACTTTGGACAGGGAATTCCACATGCTACCAAGCACTCCTGAGGAGCCTCTGAGCAGTCCCCAGGGAAGTGCTGTTAAACCTCTGCTCTCCTCATTAGAAATCTTAAGGCTGAATCTCAAGCTGACCTTGTTTTGAGTCTAACCTAGATGCAAGAGAAAAATGGAACCTCCCTTCCTATTCTCATCCTAGGCCATATCTCTTTGAATAAAATACCCCTGAGGCAGATGCAGGAACTCCAGGGGTAATCTCAAGATTCACAAAGATGAACCATATCGCCAGCATTCCCTAGGTTCCTAGAAGACCAAATGGTCATGGCATCCAGTTCTTATTATCTCTGTATTAGTAGTGGAGAAACTGAGGCACAGAAAAGTAAAGATCTTTTCTATGATAGTGTCAGAAACCAGCCTCACAGAAGTCATTTCTTCTAATTTCTGGGTTCCATGAACTAACCAGGTCCCCTCACTCATCACAGCACTGAGAATATGCTTTAGTTAGCAAAACAGGAAAGCTGAATTTGTTAAGTCTACCTAATGGCATTTAACTAGATCTGAAATAGTGTTAATTCAGTCATTCATTCAATACTTACTGATTGCATTTTACTGGCACTGGTACATAACAAAATGACTATGACATAAACACAAATACTTGCAAAACAAACAAACTGGAATGATATGAGCCTCTTCACCACATGATTTGTCCAAATGAATTTTAAAAATAGGTAGCACACGGAAGTTATTGTATAATTCATTCAGGTGTCCATCGCTAAGCCCCCACCACAAACAGAAACTGGGATAATCAGGTTAACTCGGCACTCTCAGCATGCCCCCCAAATATCAAAAATATCTTTCTGAAGCTATTCCCTCTGCATGTGGACAAATTCCAAGTGCTTTCTTCATTCTTAGCACAAAGAATGTTCTAATATTCTGAGGCAAGTAAAAATACCACAATTCCAAAATTTTGTCTCTGGATGTATAACTAGCCAGCAACAAATTAATGTAGAGTTTTGCATGCTCTCTTGTGTTTTTACACTTTTTCATGGGCTATTTGTCAACATTTACTCCTAG
>TTN-209,,0,224,2106235,2106458,GTAGGAATGCCTCGCTACTTCCAGCTGAAAATAAAACCTAAGAAGCAGGCTTTTGTCCTTTCCCAGTGCATTTAAAAATACAATTTGGAGCTCATAAAAGTAGATTGCTACCCAACTTTGAAAGCACTCTGCAGTGAAATAAATTAAGATAAACCTACATGCTCCCTTCTGTGAGGTCTCTATGGTGACTTAATCATGACAAATCTTGTGGTTTCTTTCTTTAG
>TTN-209,,0,5004,2106459,2111462,GTAGGTTTAAGAACAAAAGGTGTCATTGCCAATACTTACAAATAATTACATGGGAAAAACATTCTGTCAGCTTCTCCTCCATCACAAACATCTCTCATGCATAATTTGAAGCTTAATGGAAATCTAACAGAAAACTTATTTCAATTATTAAATTAAGAATTAGATAAGTGTTTTTCACTATTTTGTGCCCTTAATAATGGTTGTTTATGTTATGTTATGTGTTCTTTATCACAATAAAAAAATTAGTGTTTTTCACTAATATTAAAAAAGGTCATGTTCCCTTTATGATTGTAGCTGCACTTTAATTTCTTCATTGATAAAATACAATGACAAAACTAAAATTATTAGATTATAATAGCATCTACATATAATTCAAAAGAATAATACATTTATATAAGACATTATTCAGTCTATGGACAATGCTTGTGTGAAAGGTATCCTTTGGAAGACAATATCCTATAGTGGTCAAAAGTCGGGGCTTCATTGTCAAAGATGCTGAATTTGAATCTTGCCTTCAATATATATCATGTCTCTCGTTCTCCTTCTGTCATGAATACATTGAGTATATGATTGCATTCAATCCTAGAAAATATATTTTATGAGGCTAGGAATTCCGTTTTAGTGCCTAGAATTTGGCATCTGAAAAATAGTACCTGCTAGAAGGTAAGCTCTATGAAAACAAGAGTGGATGGTTGCCCCAGAATATCACCTGATACATAGTAGATACTCCATAAGTAATTGTTGACTGGACTAATTAATGATGGTTAAATGACTGTTACCAAACACTTAAGATTATTATCAAGATTAAGTTAGGTAACTCAAGTCAGCACATAGCACAGTGCTCATCATACAGTAATCAATCAGAGTTAGCTGCTACCATTTTTAATTGGGGCATGCTTCTCAAGTACCACCAGCCAATTTCCTCATCCCAGGAATCTGATCTTGGTAGAATGAGACAATATATGTGGAACCACTTCAAGTCATAACTGATTGTCTATAATCACAATTATTTGAGAGTTTCCCAGCCAAAGGGAAACTCTCAAAGCTTGGGCATCTCCCAGCCCTCTTATTAGGCTGATGCAAAAGTAATTGCAAAGTTGTATTGTTTTGTTTATTATGCTTCTCCCATTAGTTTATAATCCAATCTCTACCTTGTCAAGATTTATTTTTCTCAACAGGTTAGTACTTCAGTTGGTCTTCTGACCCAATTATTTCCTCCTCAGGAATGGAGATGGTGATCTAGAAATCTAATAGACCTATTTGATTTTATGAGCATAATTAAAAGATATAATGTATGTAAAGCACCTATAGGCATGGCTGCCAGGTAACTGGGGCTCAATACATTCATTTTATTATAGCCATAGAGAGGAATTATATAAACATCAATGTTTAGTATTGTATGGCCAGTATGGACAAATACCATAGACTGTATATTTGAGGGATAGTGTTCAAGAAATGCTAAATATTAATAAATGAGGACTGATTTGATAATATCCTACTAACACAATAATACAAAATATATTTTAAAAGCAAGTTCATTAAAGCTACACTAAATAATTTATCCATTTATTTAATTTTTAGAGGAATTTTTTAATATAAACATATATGTACATCATTCAAAGTAGTAATATTTGTCTTAACTATATTGGTATAGTGCTTTTAAGTCTATAACATATTAACATATGGTAGTATTGCCTTTAAAGTGTTGTAGAAATACACCTGAAGCACTCTACAAGACACCAATTGGGGTAGAAAGAGAAAAATTTCACTATCTTTTCTGCATAACCAATGTCTTTAAAAAGGTTTGAATAGGCTTTGTAAACTGAGAAGATCATTAACTTCCTATGTGTGGTAATATCTGTACACATATAGTGGTTTTAGCATCCTCTTATAAATTTGTTTTCTATATGAAAGAAATTAAATTCATTAAATAGAATGACCCTTCAAAAACTTGCCAACTCACATAGTTTCATACCACTGGGACTAAAAATATTTACAGAACTTCCTCTGGCCAGGTATTGCCTTAAGTAAGTGTAGCCCTGCTTTCCACAAATTGGAAAGAAATTGGGAGTCTTCAGAAGCTCCCATGTTCTTGGGGGTTGTAATACTTTCTGAAGCATGAAACGTGGCCCTGAGCAACCAGGTGCTGTTTCTAACAGCGAAAATGTTACCTATTGAAGGTCTCCAGTGCCACCTACTGGTAGAGGAGTAATTTGGAAAAGCAGAATCTTAAAATGTAAAAAAGCTATTTTTTTGCTGTTTATTCTACAGATGATGAGTCAGTGTCATTTGGAGGCTTACAGAGTGACAGCTAGCTAAACAGAAATGATGAATAATTAGTTTAACAATGATATTGTCTGTTATTCATTTAAGCATCTGTGCAATTTTAATTCTACCATTTATTGTTTCCCTGCTATTGAGATATTACCCTAGGTGCTGGGGTGCAGATCTTGCTCTTGCCTTTAAGGAGCTTGACATGTAGGTGAGGAGATGCATGCACACAACTATATCCCAAGGTTGTAAGTGCTATTAACAGGCCCACGTACTCATCATTCTCTGTCTGGGAGAGAGCCAGAGAAAGATGTGTGAACTGAGCATTGAAAAATATGTAGGATCATTGAACACAGTGGCATCCTATGATGAGAAAACAACATCTCCAAGTCATCAAAACTTGCAATAATGCTTCATGTGCTAGAAGCAAGTGGTTTAAGTACAGTTGGAAAGTGATATCATGAGTGGGTAAGAAGGCTGGATAATACAGCAAAGGCCGTGCTAAAGTTTTTGGTATTCTATGCTGAAGATTTTGGAATTGATCTTGTTTACATTTAGGAGACACTGCAGGATTTTTAAGCCCCTGGGTACCATGATCAGGTTTACTTTTTAGAAGTGATACTGTGATAGGGAAAGAAGGGATGGACAGATGTGGGAGGCAAGACTGGCAGTCAGGAACTGGAGAGAGATTATTACAATAGGCCTGGAGAGCGTGGATGAGGCCCTCAGCCAGGGCAGTCAGGAGAGACAAGTGGGGTATTGCAGAAGTAGTAATATGGGAGAAGAATGGCCTCAAAGAAGACACGAGAGGCTAATGAGTAACGCAGATCATGGCATCACAGCCACAAGCACCAAGTCCACTACCAAGAAAAGTTTTACCTGTTAACTCACTTATTGTGTGCAGTTCATGTCCAGTGGCAGTTCATGTGTATCCTGGTGCCTCATTCAGTTCACCAAAGGAAGAAGCTGTCAGTAGAAATAAGCAGAGAACCTTGTAAGAGGATGTACCATTGATGATCTCACACACACACACACACACACACACACACACACACACCCCTTCACACAAACTAAATAGGGGTGGTGTTTCATGTTATATCACATGGCACTGTCTTTTGGCGTGTTATTGAAGACAACGTTGCTTCCATCTGTGATGTTAGATATTCTTGCTATAATGACTGACTTGTGCCAGTGGCTTATAAAGCCCTTCCATGTGTGTTATATCATTTAATTCTCACAGCAATTATATGCAACGAATAGCCCATAAATTATTACGCATGCCATTTTACAAATGAAAAGACTAATCCAGAAAGCTTAAATGACATTTCCAAGGCCACACAGCTGACAAGTTGTAGTGTCAAGATTTCATTTTCTTTATATGTATATATTTTGATGGAGTCTTGCTCTGTCACCAGGCTGGAGATCTCGGCTCACTGCAACCTCCCCCTCCCGGGTTCAAGCTATTCTCCTGCCTGAGCCTCCTGAATAGCTGGGATTATAGGTGTGTGCCACCACACCTGGCTAATTTTTGTATTTTCAGGAGAGACTAGGTTTCACCACGTTCGTCAGGCTGTTCTCGAACTCCTGACCTCGTGATCTGCCCGCCTCAGCCTCCCAAAGTGCTGGGATTACAGGTGTGAAGCACCGCGCCTGGCCAGGATTTCATCTTCTACTTTACCTTACTATCTAAGGAACTGAACAGATTTGTTACTCTAAGAGGAGAACCTGCCATTTATACACATCTACCATCATGGGCAGGAGAGTAACTTTTATAGACAAGTATTGGCATTAAAATGCAGACAAATGCTAGATGATTGGACTATTAGAAGATCATCTTGGATGGTTTTGAGACCAAGAAGTGGTATAGTGACTGTGCTCCAAAAACAAGATGGCTTTGATTTTGGCTATTCAAACAGTTAACTAAAATTAAAGTGCATATCACCTACAATTATTACAACACAATAACCTGCTACTTTACTGTAATTTGGGTTTTTACTTTCTATTATTTTAAGATGGTTCAAATCCTTATATAGAAATAGCTAGCTTTATTATAATGTCTTATAACTGCCACTCTGAAAAGAGTCAAATGTATCTAAGATGCTCAAATACCATAATAAATCACCCTCTTTATTTAAAAAATTATTTTCTCTACAATTATTTGTGCCATATATACTGCGTACTGAAACCTTTTGCTCATTAGTAACAAAGATAGAGATTTTTTTTCTACAGCCTTCAAAGGTATCTATTTTAGACTTTTCATATCTTGATCTTCTCAGCTCTCTTTTTGATTGATTTTTCTGCAAACCAAAAGTGGAGATTTTTCTCATTTCCTGTCCCAGAAGGCAACTACAAGCCCAGATCAAACCTTTCCTGATGACTCTTCTTAGGACTGTCTTTTTCTCAAAGTCACTGAATATGTCAAAATCTTGTCTCTGCTTCCACTGCATGACATGCAAATGTCTAAAGAGAATGTAACTGAAGTTCTATCATTTTAAACATTACAACCAGTTCAACCTTAGGACAAGCTATATTTTTCTATCATTACATTTCCTTCTTGAAGATGAAAGGAAATCATTTAACAATAGTAGATATGGCATGCCCAGAGAAAAGTATCATGTTATTAAGTCAAATATGAAATGTAGGCACTAGTATTATTAACATTGTGTTTGCAGGTAAATTGTAAAAATCCACTCATTTTTGTGGTTGAAGTATCTCTTTTCTTTTGTGTCGCAG
>TTN-209,,0,1067,2111463,2112529,GTAAAGTAAAACAACTTTCAGAACCCCATTTAAATATAGATCGAATCTTAACAATGTCTGTAACAATTACTCAAGAGTTCATGTAAATCATTGTTGTTCCTACCATTCTCTTCTAATTCAACTAATTATTTCCCTGTTATATGCCATGGTCTCGCCTCTCCTTTACCACTTTTCATTGTGAATCATAGACCATCACGTTTCATTTGGCCCCGCTTTTTCTCTGTAACAATTTGTAATGTATTGCTGCTGTCACCAGCTGTCATGCTTCCTAATCAGCATGAATCAGAAGGGGGCGAAATATGCTGCATAAATAGGTAGATTTGTTTTCTCAATTGGCTAAGATAAAAATTAAATTTTAAAAACATCTAAGAGTGTTATCATCCTCCTATCATGCTGACACAATTTTGATTTCACAAAAGCTAGACCGTTTCAGGTCTGTACACCAGCGAGCTATATTCATCCTCCTCTCAAGAATGTCTTAGTGTTAAGAAGTCCAGTCCTAAAGTGGTTTAACATTTCTGTTAGTTGGGGCTCTTAAATTGTAATCAGAAACACTTCCTCAGTAACATGGGGAATTTGATTCAAACAAGGATAGCATTTTTATATAGTGGTACTATTTTTCCTGAGCAAATATAGTCTATGTAGTATTAAGTACATACAAATACATAAGGATTTAGAGAAACTATTTTTTTCTTAACCTTATGCATTAACTGTAACTAGATGTTTTTTTAAATAATGAATTTAAAGTGGTTTAAAATTAAAAAGTTGACTTTACAACAAGAGGAAGAAAGAAAAGAATATCCAAAACCCTGTTGGGTACTCCACTATTGCCTTCATGAACAATGTAGTGAAGTTCCTTAGCCCATTCATGTCTCAGCTTGCTTCTCTGGGAAATGGAAGTGAACTTGTGTGACTTCGAGTCAATAGTGACATACAAGGACAAGGCAGTAGGAGTGGACTGAATTCTAGTCCATTATTGAAATTTGTGACAAATCTGTAGACAACTCCAAATGAGTTCTGGTTTCAGTGCAAGGTAAGACATTAAAAATTGGTATGCTTCTTTTCAG
>TTN-209,,0,744,2112530,2113273,GTAAAGCCCATCTTGCTTCAAGGACTTTGATTTGCTGTATACCTCTCAGTCCCACTGTTACTAATGAGAGTCTCTGCTGTTTGTTTTATTGCATACTGTGGTCAGTCCATAACTTACTAATAAAATAACATGCAATAACTCCCGCTAGGTCCTCAATTATGGGTTAACCTACATACTTTAAATTTCACTGAAGTATGTGTTCTATGCACTAGAGAACCAATAATTATTTTATTAGGCACCACCTTTGCTTGGCTTCTTTACTCTTCTAAGCAATATTGTATCATTGCATCATTAAATGATCTATTTGCTGATTATTACTTACTGTACTTAAAGTAAGTACAGTATTACTTACTGTACTTAAAGTAAGTACAGTATTACTTACTGTACTTAAAGCATACAGTGGACGGAGAGCAAATGCTAACCCAAATACAGTCAGCTAGAGGGAGAGAGAGAAAGACAGACTGGGTCACTTTGGATAGCTGAAATGACAACAGAAAGAAGGAACCAGATACTGCATGGCATCTGCATGAGTCTTCATCAACCACTCAGCACTGAATCACCAGGAATGAATTTTCTTTTGTGTGATCCTGACATCTAGATCATATTGCATCTGGCATGCTGCTTTCAAGTGACAACTACGTCTTTCATCTTCATCTTCCATGCCATTTTGTGTTACTAACATGGGCAAGTGACAAAGCTTAGATCTTAATATTCTTTTCTTTTTCTTGTCACTTGATTATACAG
>TTN-209,,0,3041,2113274,2116314,GTTAATTGATTTTTAGCTATGACTTGCTTCATTTCATCCTCATCGCTTTATGCAGCTTTTCTGCCATGCAAATTCAATCGACGAATATATTAATTAGAATATCTCTAAATTAGCACCCTATTCATAAGTGACTTCTGAAAGTCAGCCAAGTCATTGGCCATGATTATCCTGAAAATTTAACTTACCAGTCTAGATTCAGAAAGTTTAATTTTTAAACGTAGGTTCGGGAAGCAAAGGTTTATTTCCTATGTGCTGCATTTTCTAATATTTACCAACGCACTACCAAGAAAGTGTAGCAAAGTTAAAATGTTGTATTCTGAGAAGTACTTATTGGGTATTTATTATTGTGCCAGATACTGTGGTAAATTTCAGTTTAATTGTTTTAATAGCAAGAGGTTCAACAATTCTTATCTCCTCTTTATTTTCACATCTGGAGGTTCTAGTTGTTTACAAAGGGGCCATGAAAATAGAAAATTGGGACCAAGTACAGTGACTCATGCCTGTAATCCCAGCACTTTGGGAGGCCGAGGCAGCCAGATCACTTGAGGTCAGGAGTTTGAGACCAGCCTGGCTAATATGGTGAAACCCCATCTCTACTAAAAATACAAAAATTAGCCAGGCATGTTGGATGTTGGTGCATGCCTGTAATCCCAACTACTCAGGAGGCTGAGGCCAGGAGAATCGCTTGAACCCAGGAGGCAGAGGTTGCAGTGAGCCGAAATAGGGTCACTGTACTCCAGCCTGGGCAACAGAACTAGACTCCATCTCCAAAAAAGAAAAATAGAAAATTGAAAATTGGGCACTGAAAATAACAAAGCTCTCTCTGGACCAAAATTAGAAGTCTCTAGATATTTCTCCATAAATGATGCTGCTTTTACAGGCTTAAAATCCTCCTGGAATTGTATAATTTTCTCATGGCAAGATCACAATTTTTGTCGTTATTGGGCTTGATTCTCCATTATGTCTGGAAGAGCAGGAATAAACTTGTCTGGGCAAGTAATAACTTCTTCCTCTTATCCATGGACTTTCCTTTTGGATATTAATGAAATGAGAAAAATATTTTTCAGGTGCCATAAGCCTGTGTTGTGTGCCCGTAGTCAAAACAGCTTCACTGAGTCTCATGGAAGGAAGCTGGTGGAATAAATTCAGGCATCTCCAGGGGTCTGTGGAAAGCTCTGGCCTCAAGTTCCTCCCTGATCCTGGCCATAGTGGTGTTAGGGATGAAAAGGGGGCAATGCAGTGCTATGTAGGTGCACAGCCATCTCTGCACAGAATTTTGAAACAGTGGCCTTTCTTCCTACCCAGTACAGAGAATACAGTTTATTGATTCATATAATGTATCCGCAACACCTACTCACCAAAAAGAGGTCTTATTCTTTCTTAATGAGATTTTGTTCTATAGCTATCTCTCATTCTGTCACCGTAGCCTACAAAGGCAATATCTCAAGAACTGAGGTCTAGTTATGTAAATTAGATAGAAAATTCCACCAGCCAGAGAGTTGACCCTCAATTTCACTACAGCTGCTGGCTAGCACAGTAATCACACAGAGTCACTATTTATTTGGAGGTGTTGTCTACAAGTCCTGTAGGTGACAGTGTGACAATTTTTTCAGTAATGTAATTGGGAGTTGGCTGTGTTGTGAAGGTGGGAGAAATGTAGATCTCTTAACTCACTTCCTAAAGAATCTAGTGCTATAGTGCGGTGTTTGACTGTCATATTCCCAGAATTGATTTGAACTCGGCTCTTTTGCCCTAGGATCTCCAGTTCATTCAGTTCCAATTGATAATATTATTAAAGTGTTCTTGAAGCAAAAGAATTTTTTTGAACATCCAACTGCCTTACTTGTACCTAAGAAAGTTGAAAGATAAGACATTTTTAGATGTTTGAAGAGTGAAAGATCAGGCACAGTTGTCTAATTATTTGACATAGGCCAGTCTTTATATGTTCCTTTTTTATTTTGGCTTAATAAGTTCATATAGGCTACAGAGTTATCCACCAAGATCAAGTAGGAATGTCAAACCCCTGGAAGTCTTTTTGAATACAGTTATTATGTGCATAATAAACATAAACATATCATATATAAGTTTCATGACTAACATGCTGCCTTTCCTTCTCATCCTAATGACATTCCATCTTCTCCACATTCAGCATGTTTTTCATTCTTACAAACACAGCTAATTTATGCCTTTCCCTAACTTTATTCTTACCTAGCAAAAGAATCGCAAGCCAGAGCACTTACAAAAATTACTCTGGGTTCTGACACTAAAAGTATTAAAACACTCAGAGAGTCACAAATTAAAACAACCCGTGAAGTAAAAAGAGAATCGTCAAAGAAAACATCAAGTTTGTCATTAACTTCATGCCAAAAACCGTAAGAAACTGAGAACAAGGGAATAAAGTCTACTGACAGGATACCACGTGGACTGAAGACTGAGAGTGATACGAGAGCCCCAGCCTTTCCCAAGGAGCTGCCCTAGATATGACTGTGTCTAAAAGCTGTGCATATTCCTTGTGGAATAAAAACAGTTTTGATAAGTCTTTGTTTTGTTTCTTAATATGTAATTTGGACTTCATGTAGTTCAAAGTTTGAAAGGTGATTCAAATCAAAGGAGTGTTTACTAGCAGGAAAAACTGAGAATAGCCCTCTGCTAAAGTAGCAATTTAGAAAATGCATGTTCTTTCTAAATGTGATTTCATCTCTTAGCAAGTGTTTAGTCAATAGGACATTTTTTAGAAAATAATATTCCTTCGGTTTGTAGATTGCTTTCTGCATGCATGTAAAGGCATGGGGAATTATAGAACTAAAAGTGGAAATTTCATGAAGAACCTAAAATAAAAATGTTTTAAATCTTTCTGTCAACATTGTCATGTGTTTTATCAGCTCAATAGTTTGTTTGGCATGGACTTTTTGGTAAATTTGGGGAATGTAGTTTTCTGTTGTTATAATAAAAAGAAAACTTTAATCATACAAGTCATGAATTGATGCAGAAAATATATGCAATTAATCACTAAAATCTCTTTATATGTTTTTCTATTTTAG
>TTN-209,,0,11202,2116315,2127516,GTATTGTTATAATGGATGTGAGATTTAAGTAGAAATTCTAAAGGATTAATAGGATCCTTGAGTTGCCTTCTTTCTCTTAGTATTATTGAGAAAAAAATGACATAGATATACAAATATATCTCTTAGAGTATATATTACTATGTCGCATGCTTGGTTTAGAATTTTGATGGTTACATGCATTTCACAGTAATTTATTGTAAGTTAATTTAAAATTTTGTATTTAAAATTTATCAGCCAAATTCAACTTTATGTTTGCAGTCATTTCCAAAAGTGTATATTAGGAGAAGTTGTCATCTTAATGCATGAAATCATGAAGTAGAAGTTTGTTTTCAAAATCACGGTGAATTACATTGAAAATAGACAATAACCTAGCTGTCATTCTCAGAATGCAATGTCATGAATGAATTATGATTGAAATGCTACTTTACTGAGGTTGTGTGAAAACATTACATTCCCATCTGGTTTACACTTCATTCACATATATCATTTTAACATTGATATGTCTCTTACACTGGCTTGCAGATAGCTGCCTTATGTGATCCTTATTGCCTGCTTTTCTTTGCATAACATTGTGACTTTATGGCTGTATTAGTTCGAATAAACGCCTTCTCATTTTATTTTAGCTAATTATTTATGGTTATAGTTCTTGTATATACTCTTTAAATAGTTGATTCTCAAAAATATAATAATTTAATCTACAATCAAAAGAATCAGAAAGGGCGTTTATTCCACTCTCTGCAAGTCAGGTAAGATTTTCCACTTAGCCATCAAAAGAACAAAGTTTTCCTGCTCTCAAAACAAATATGCACAGGAACATGTTATTTTGAAATGCATTTTTGCTTGTTCAAGAAGAAATTTCAACAGTTTGAAGAAAAGACCAGACAACGAACGATTTTCGTGTCAGAATCTTTTAAACAGAGCATGGTGTTGCGTTTATTCGAACAAATATGGTGAGTGAATTTTTCTATGGATTTGTGAGATCTGTAGCATGCAATTTATTTCATTTCCTATTTTGCAATTTTATTTACTTTCAACTTTTTCAAGTTCTATGGAAAATAGTAAAGGTTTTTTTTTTTTTTTCCAGAATTATTCTCTGAGGGGGAATCTGAACATTCAGAAAGGGATACACGTGACGCCTTTTCAGATTCTGAAGACATAGACCACAAATCCATGGCTGCTAAAAGATATGCAAGTAGAATATCATCTACAAGCTCCTGGCCTGAATATTTTAAGCCTTCTTTTACCCAGAAACTTACATTTAAATATGTTTTAGAGGGTGAACCGGTTGTTTTTACATGTAGATTAATTGCCTGTCCAACTCCAGAAATGACTTGGTTTCATAACAATCGGCCCATCCCAACAGGTCTTCGTCGGATTATAAAAGCTGAGAGTGATTTACACCATCACTCTTCCAGCTTAGAGATTAAAAGGGTCCAAGACAGAGATTCTGGAAGTTATAGGTTACTAGCAATTAATAGTGAAGGGTCTGCAGAATCAACTGCATCATTGCTTGTTATCCAAAAAGGGCAAGATGAGAAATATTTAGAATTTCTGAAAAGAGCAGAACGGACACATGAAAATGTGGAGGCTTTAGTTGAAAGGGGAGAAGATAGGATAAAGGTTGACCTGAGGTTTACTGGCTCTCCCTTTAACAAAAAACAAGATGTGGAACAAAAGGGAATGATGAGAACTATACATTTTAAGACAATGAGTTCTGCCAAGAAAACAGATTACATGTATGATGAAGAATATTTAGAAAGTAAATCTGACATAAGAGGTTGGCTTAATGTAGGTGAAAGTTTCCTGGACAAGGAGACCAAAGTGAAGTTGCAACGTTTAAGGGAGGCTAGAAAAACATTAATGGAGAAAAAGAAATTATCTCTTTTAGATACGTCTTCTGAAATAAGCTCAAGAACTTTGAGAAGTGAAGCTAGTGATAAAGATATTCTGTTCTCTAGAGAGGACATGAAAATCAGATCTATGTCTGATCTAGCTGAAAGTTATAAGGTAGATCATTCAGCTGAGAGTATTGTGCAAAATCCACATGCCCTTTCTAATCAAATGGATCAAAATATAGAATCTGAGGAACTTCCCACAAGCTTTCAAACTATTGTTGATGAAGAAATTTTCCAGACTGAAATAAGAATGAGCCAAGAAGCACTGGTAAAGGAAAGTCTACCAAAAGACCATTTATATGGTGAAATTCTAGTAAATGAAAATACCCAAGCAAGAGGACAGCTGGAAGAAATTATGGCCAATACTACAATTGGAGAGTCATCCACATATATCACTAATGTATGTGAGAAGGAGGAAGTATATGAGACTCCTGAAAATGTGTCTCAAGCTATTACACCACATGCCAGCGAATCTTTTGGTACACTTGTAAATGTTGAAGAAAGTGAAGAAATAGCTAGTGAAAGAATAAAAAAGGATGATTTGAGAGAATTACAACTCTCTGCTTCTACACGAATTGATGAATTCAAAACCGAACAGAAGGAAGAAAACATGAGATTTTTTGAAAATTCTTTTCGAAAACGCCCACAACGTTGCCCACCTTCATTTCTTCAAGAAATTGAATCTCAAGAAGTTTATGAAGGTGACAGTTGTAATTTTGTGTGTCATTTTCAAGGATATCCTCAACCTATAGTGACGTGGTATAACAATGACATGCCAATCCCACGTAATCAAAACTTTATCATTCATTCGTTGGAAAACTATTCAATATTAACTCTTTCATCTGTTCATCATCAGAATGAAGGTTCTATTACTTGTGTGCTATTTAACCAATATGGAACAGTAAAAACAACCAGTATGCTTAAAGTGAAAGCAAAACAAAAACATGATGTCAAAGCACATAAAGTCCCAGTGTTCCATGACTACTTGGATGAGGAAGAAGAGTTAGCATTGGTGTTTGACCAAGCAAAAGGCGCCCATCCATCTATGAGTCAAGAGGGCCAAACAAATCTTCATTTGTTAAAAACTAACCCACCAGTTCCTCCCTCTGGAGACACAGAATTGCTTTCCTTTCCTGTAGAAATTCAGGTAACAGCAGCTACTCCTATCCCAGAACAGGATAAAGAGTCTAAAGAAGTGTTTCAAACTGAGGAGCTGGAACCTAAAGCAATGCCTCAAGATCAAGTTACTCAATCACCAAAACACAGATTTGTATTTTTGTCTGATATTACTAATGAACCACCAAAAATGTTACAAGAAATGCCAAAGCATGCCAGGTGTAGAGAAGGGGATTCCATCATTCTTGAATGTTTAATATCTGGTGAGCCCCAGCCAGTTGTAACATGGTTTCAAAATGGAGTCCTTTTAAAGCAGAACCAGAAGTTTCAGTTTGAAGAAGTTAATTGTAGCCACCAATTATATATTAAGGATGTTAATTCTCAAGATTCTGGAAAATATAAATGTGTTGCTGAAAACAATTCAGGGGCAGTTGAAAGTGTTTCAGATCTAACAGTGGAGCCTGTCACTTATAGAGAAAATAGTCAATTCGAAAATATTGGTGAAATTTATGGAAAATATTCCAGAGATCAGCAACTGCAAGACCAGGGAGAATCTGTAAGGGCACATTTTTATGATTATCCAGCTGGTCCCTTTACTCCCTGGACAAATGTAAAAGAATATTCAGTAAGGGACTATTTTCAAAGCCTTGAGACTATTGAGCAAATAGACCAGAAAGAGCAGGTGCGTTGCATACCTTCTAGAGAAAAAATTCCCAGATTTGTGCATGGTGCTTCAAGAACCATAAAAATCAGCAAGCCCATCAGGGCTGAATTCATACAATGTCAGGCTGAAGGGAAAGAGAGACATGTAAGTGAAAAATCAAAGCTGCACCAAGCAGAGGGTACTGTTTATCCATTTGTTGATGATTTCAGTGATGTCACTATTAAGAAAGAAATAAGAAATAATTTTGGAAAACTTGGTAGATCAGAAAAGGAAAATGTACAAGAATGTGCCCAAAGTGACTATTTACCAAATATTCACTCTGAGAGAATTTCTGACAGTTACAATACAAAAGATTCATCTGCCATTGTATATGAAGAATCCCTTGGTGAAGAGATACACTACCCGGGGAAAAAGGTGAAGCATAGAATTATCGAATTTGAAAAATTACATGTAGAAAAAGGAGTTCTAGAAAAAAGACCTACCAGAACATCAATTGTTAATCCTCCTCAAAAGAAGATTGATGACAAAGCCTTTTCATTAAAGCAAAGAGAATCAAGATCAAGCAATCTAAATGCAAATATGTATCAGGCAGAGAAAATGTCTCCAAATACTGAATCAGATTCATCTAACATTGCAATAAATTTAAAGCTGCTTTCCTCTCAAACTCATAAAGAATTTGACGCACAAGAAAGGGAACAACAGGAAAAAATAAGTCTTATAGATAAACCTGCAATTTCTAAAAGAGCTGAACATGAATCACCTATTACATTTGACTTAAAGCAGTTTCACACTCAAATAAAACACACAGATGTGAAATTCCAAGAATTAGATAGTGGTCAACCAGAAGAAGCTTATTTTAAAATCCAACATCCTGCTGACACTGAGAACATTGTATTTGATCTAAAACAAATGTATTCTCATATAGGAGATCCAGCTCTGGAGTTCCAAGGGCAAGAAACTAGGGAACAGCAGGAAATACATTATAAAGAAAAAATTCCTAGCCCTGAAACGTTACAACCTGACACACACAATATCTCTAAAAGTGTGCAAAATAATGTATTTGCCAGTCAAGAAATTTCTTCCAGTCAAGAGCTTTCAAATAGAACTATGGTGGAGAAAAGTAGTATTGATGAAAATTCCATTTCTTTAGAAAAAGAAGTCCGACATGTACAGGAACAAAACTTAGACATTTTAAAAACTGATCTTTCTCTTAAATCCTTTTCTGAAGAAATCTATAGTGAATCATGTGCCCTACTTCCAACCTCATCTGCAGATATAGAAGAAACTGATCTTTCTGAGAAAAGTTGTCCTCTAGAAAATGGAGGCAGAAGTTCCATCTCACATTTGAAAAAAGCAGCAAGTGAGGAAAAGCCTTTAGGGGTTGGTGAAATGGAAGAAGAATGCACTCTAGAACCAGAGTTGGCAGCATTTCCAAAGCAGGATGGTGGGACACAGGAATATACAGATGCCACTTTGGAAGACCACAGAGGTGATGTTCAGGAAGCTGACACACTCCATAGACAGCTCTCCCTGAGTCAGTGCTTCCCACTCTTGATGACTGAAGAACAACAGAATCCAGGTGAACAAATAAGTACAAACATTCATGCCTCTGGAGAAGAAAAATGTTATGAAGAAGTTCAAGTTCAGAATGAAGCTTCTTTCTCCACTTTAGAAGGAGAAATGATAGAAACTAGTTTTTCTCAAAATATTCCTAAATTAGATGAGGCACATACCACTGAGGCAGCAGAATCTGAGACCTCCCTAACACAATATTTACTTGCTGCTGGAAAGCGTGAGGTTCCTGAAACTAAAGACACCAGAGACCAGGCAAAGCTTGTCCAGAGTGAATCAATCACTTCAATGGAGGTGGAAGAAGTAACTTTCAACACTGTGTATGAATACTACAACCAGAAACAGGAATCACTAGGTCGTCCACTTTCTCCTGAGTCTGACATTTCCATTGGTGTGGGAAGTACAACCAGTGAAGAAATATCTGAGTTAGATCAGTTTTATACCCCACCATCATCTGTTGAATATTTTGAATCTCCAAAGTCCCCTGACTTATATTTTAATCCTTCAGATATAACTAAACAATCCTCAATACATTCAGGAGGTGAGACAGTTGAAAGATATTCCACACCTTTAGGGGAAGTTGCTGAAAGATATTCAACACCTTCCGAAGGTGAGGTAGGAGAAAGATACTCCACACCCCCAGGGGAGACACTAGAGAGATACTCCACACCTCCAGGAGAGACTCTAGAGAGATACTCCACACCCCCAGGAGAGACTCTAGAGAGATATTCCACACCCCCAGGAGAGACTCTGGAGAGATACTCCACACCCCCAGGAGAGACTCTAGAGCGATATTCCACACCCCCAGGGGAGGCACTAGAGAGATATTCTATTCCTACTGGAGGACCAAACCCCACTGGTACTTTTAAAACATATCCATCAAAAATAGAAAGGGAAGACGGTACACCAAATGAGCATTTCTACACACCTACAGAAGAGAGGGGTTCAGCTTATGAAATATGGCGTTCCGATTCATTTGGTACACCCAATGAAGCCATTGAGCCAAAAGACAATGAAATGCCTCCATCTTTTATTGAACCTCTGACCAAAAGGAAGGTATATGAAAACACAACACTAGGCTTCATTGTTGAAGTTGAAGGTCTTCCAGTTCCTGGTGTGAAATGGTATCGAAATAAATCTTTACTAGAGCCAGATGAAAGAATCAAAATGGAAAGAGTGGGTAATGTGTGTTCACTGGAAATTTCTAACATTCAAAAAGGAGAAGGGGGAGAGTACATGTGTCATGCTGTAAACATCATAGGGGAAGCAAAGAGCTTTGCAAATGTAGACATAATGCCCCAGGAAGAAAGAGTGGTGGCACTACCACCTCCAGTAACACATCAGCATGTCATGGAGTTTGATTTGGAACACACCACATCATCAAGAACACCTTCTCCTCAAGAAATTGTCCTGGAAGTTGAATTAAGTGAAAAAGACGTTAAAGAATTTGAGAAGCAGGTGAAAATAGTGACAGTTCCCGAATTTACTCCTGACCATAAAAGTATGATTGTGAGTCTAGATGTTCTTCCATTTAATTTTGTAGATCCAAATATGGATTCAAGGGAGGGAGAAGACAAAGAACTAAAAATTGATTTAGAAGTATTTGAAATGCCTCCTCGCTTTATAATGCCTATTTGTGATTTTAAAATTCCAGAAAATTCAGATGCTGTATTCAAATGTTCAGTCATAGGGATCCCGACTCCCGAAGTTAAGTGGTATAAAGAATATATGTGTATTGAGCCAGATAATATTAAATACGTGATTAGCGAGGAGAAGGGAAGTCACACTCTTAAAATTCGAAATGTCTGTCTTTCTGATAGTGCAACATACAGGTGCAGAGCTGTGAATTGTGTAGGAGAGGCTATCTGTCGGGGATTCCTCACCATGGGAGATTCTGAAATATTTGCTGTGATAGCAAAGAAAAGCAAAGTGACTTTAAGCAGTTTAATGGAAGAATTGGTCTTAAAGAGCAACTACACAGACAGTTTTTTTGAATTTCAGGTGGTGGAAGGGCCTCCCAGGTTTATCAAAGGTATTTCTGACTGTTATGCACCAATAGGTACAGCAGCATATTTTCAGTGCTTAGTTCGTGGCTCTCCAAGACCCACGGTTTACTGGTACAAAGATGGAAAATTAGTCCAAGGAAGAAGGTTCACTGTTGAGGAAAGTGGCACAGGGTTCCATAACCTGTTTATAACAAGCTTAGTAAAGAGTGATGAAGGAGAGTATAGGTGTGTAGCTACAAACAAATCAGGAATGGCTGAGAGCTTTGCAGCACTCACCTTAACTTAAAATGTAATGTTTTAGTGCCTCAGTAATTATTAGCATTGATCTGAGTGCTTTCATATTTTCCAAATTATGTGGATCTAATAAACTTCCAAACAGGTCCACCATATTTGAATTCATTACCTTGGAGACCCCTAAAGAAATAATCTCTATGTAGAAATCTCATCTTTGTAATACATGTAAATATTTTGTTATCTGAACTGTGGAATCATCACTTGTGTCAATCATGCTGTGTAATATCAAACACAATTAAATCTCTCCTTGGCTACCTAATTGTTTGTACTTCTATTTACCCTCATGCCTCCTCCACAAAGTGTTTCAGTGGAATGGACTCTCTTTTAGCAGATAAACCATATATGCAAAAGTACAATGTAAAAGTGGAGACCATATCAGATGACCACGCAGACAAATTGGTAAGGGCAAATCTCTCTGCTCCCATTCTAAGTTATTTTTGGAATTTTAACCCCTTTGCATCCAAACTCATGTTTATTTACTTTGACTTAGAATAGGCAAAACAAACAACAAAAACCAGCTTCTCCCAATTGGCAACTAACTCTATAATCTGTTTGACATTTCAATCTTAATATATTAACTTCATCTCTTTTAAAAATGTTTTCGTTATTAATATTCCTCTTCATAAGTGCTTTAATTCTCACTGGCTTCAAGGGACCAATTGTGCTCTTTGTGGGCAGGGTTCACCTAGACATTTGCAAAATAAGCAAATAGATCTTTCCACTTTTGGAGATACCTTATTTTTCTCCATTTTTGAGATGACATCAAGTGTAAAATGCAGCAATAATTTAGTATTGGCCTGGGGAAAAAAGGGAAACTATCATATTGTGTTTACATATAGATTTTAAAACTGTATTCTGATTTCAGAATCTTTAAAATTTAAAAAAAGGTGGGATATTTTTAGAATTGAGACAATATGGTAATTTGTATTTCAGATTATATATAAATAACAAGATAACAAGCTTTCCTATCAGTTTCACTGAATTTCATCTTTAAAACGAATATAGCTTAATAAGCATTCAATTTTTATTGTGATGTTTATGTTTCTAAAGTAACTCTTTAATTTTGTCTTTTAAAATTAAAATAACAGTAAATTAACATACTCCTTAATATCTTACCTATATACTAATGTGGACCCAAGTCTTCTCATATAAGACTCGACAAATATAAAAAATTCTGAAAATGAAGGGTAGGACCAAAAGACCTTAGAGGTGATCATTCAACAATACAATTCTGTGTTAAGCTAATAGTAATTATTCTTAATACAATTTAGAATAAACTTTAATTTTGTAACAAAGGACGAGAGAAATAATATTACAATGAAAGATAAATTTTATCTCCCTCCACCTCTTAAATTACTTATTGTTACTTAATGGCTACATTTGTCACCTGCATTTAGCAATATTTAAGTACCATTATCATATTTAAAATGCTAATTTTAATTAGAAATGTAAACAATTTAAATTTAATTTTCAAAAGAATTCATATCCAATTATGTTTATTATGTTTCTTTCATCTATCAGTCTTTATTCTCAACATGGGAATTCTCTAACAGCTATCCAAATTAAAGAAGCAATAGAGACAATGTACAGAAAATAGGCAGAGCAGCCAGGCCTCCCCTGCCTCCCTCACAAAAAAAATTTTGAATTATCTGTTTGAGCCACCATAACTCATCAGCATAGATACACTATTGTAGAACAATCATTCCTGTTCCAACCAGTGAGCACACAATATCTGTGATAATAATTATAGACATAATGTAATATATCACATCACAAATTCCTGAAATAAAACTAATTCTATAGATTAGGAACTTAGAGATTTATTCTGCACTTAGTCACATAATGGATGTTAAAATTAACGAGAAACTCAGATTGAGGCAAACATGACAAGCATGCTTTACTCAAACATCATACAGCACAGCAACAGTTCAAACCTTGTTTCTTAAAAAAAGAGAAAGAGAGAAATAGAAAAATGTTTTTATGTCCTACTGGATTTCAGGAAGAGCTGAAAAACACTCTTATTCATATAGTAAAGAGGGCTTTGTTTGGTTTTGCTCATTAGAATTCTGTAATTCTGTTAGTTTCAAGTATGGTGAGCTTGAGTATACGCAGAATAACAGTGACTGAATAAAGAAAAGTAAGCCTTGGCTTACTTTAATTGTCATAGATAATGAAATGGAATTTTTTATTTTCTGACTCAATGGCACGTAACATAAAACCCCAAAATATTAATTTCTCTGATTCTGGATAAAGAATTTATTGTATTGCACATAGTTGAGTTTAGACAATTAATAGCTGCTACCACAACATGTAATTTTTTAAACTATGCCTTTCAAGTTTCAGCACATTTGAATTTCATTTACTATCCTTTTTATGGCTAATAATACCATGGCTTGAAGTAAAATATTTGCAAATAGTTCAACATAGTAGTGAGTAAGGGTATTTTAACTGTATTCACATTCACTCCCTTTACAGATATTTTGTGAGTTCAAGTGAAGGGAAAGGTAACGCGAATTATGTATTGTAGATTAAATGCGAAGTTAAGTGATCACCATTAATATGTAAAATTATCAATGGTTTTATGGTTTACTTAAAATAATAAATACCTGAATATGTATTCTGCATGCTATAGATGAGTTTCTCCAGTATTTTTACAGCCAGCAGACACTTGAGTCCTGTCTTCTAATGCTTATATGCTAGAACAGAAAGGAATTAAGGTGTAAGTCTATTTCATGTGATGCAAGTGAAGTCACCAAATAAAATCATAAAACTGCCTTTTGCTAAGGCAATAAAACTACTAATAACAGGCCTGTTCTACATAGCTAAGAGGTTTAATAAAAAATCGAATTCCTTGTTTAAAATTACATGTCTTTCATCCTGTCATCCAGGATACTGTTTAAAGAGTCTCTGTTATGCACTGCTTTGTTTCTTGCTCAGTGGTTCTGTATAGGTTTTCTTATACAATAAAATACAATGAACTTTTAATATTGGAGTTGTTTTCTCTTATTTTTGATTATCTTATTTTCTTGGCTAATGCCTTATTACAAAGGCTTTGTTCAAGTAATATGGTGATTTACATAGATGAAAGAAGGCCTGCATTTCTAGAAACTGAAAACAGTGGTTCTCTTACAAATCCAAATTAAACATTTCCTGTAGCCTCTTATTTTTAATAATGACTTTAGAGGCAGTAATTAGAACATCAATGGTTTATTTTGGAAATAATCAGTCTTTAACAAAGAAGATTATTCTTAACCTCAAGAAAACTCTAAATATAAATAACAATTCTGGATCTTTTTAGAAGTTGATTTAAATAATGCTGGATTATTATAACTATTTAATTAGCAGTTTTTCAAACTTTAAAATTGGAATTATATCTCAAGAAAAACTCATGAGAGCATTTTTAAAACATGAACTCTATCACAGATGAAGTGGATCAAAAATTGCTTTTGTACAGTATCTATAATTTTGCATAATTTTATATGTTAAGCTAAGAAAAATTTAGAAATGTGCTTTTTGATACATTAATCTTGGAATAATCTAATCATTCCAGGAATAAAGCAGAAGAAGGCCATCAACTGGTGTCTAATTCTTTGATTTCTATTTTTATATTAAATAAAATTTTATAGTAAAATAATAATCATTTTTCCCCATACAG
>TTN-209,,0,780,2127517,2128296,GTTGGATTTTAAGGATAAAATAGATCAAATGCTAACATTCACTGGATTGTAATGATTTAGCTTGCATCACTTAAATTTTCACTTATCTGCCACTTCCAGAATGTAATTTATTTAGAGTAAGAATGAAATCACAGACATAATCATGGTTATGAACTCACCTTTTCCCTTACTGCCCTGTTGGGTGCTATGCTATCATATCCATGGTACTATTTATTTTAAAAATAAAACATATTTTCATATGTTTCATAATACCAATAGATAAGCTTTTAGTTAATTTTCATATGAAGATAACTTTCATAATATGTAATAAAAAGTATCAGTGAACACCTAGCCACTCTGAAATCACTGGTCTCACCCTTAGATTTAAAATAACCATGATTAGTTGTCTGTTTCTTTTTTCTGTTTATTTTTTGTTGTTGTTTCACTTCATCACTTTATTTAGTATATCATGTTTCTTCACATTATTTTCAGTGTTCCCATTCAGCATGGTATATTTAAAGAATATATCATGTTGTTATGCATATAATCCAATAGCATCACATTTTTTCACAATTCACTGCAAAGCAATGATTGAATAGGTTTTTTTTAAAAAAAGCTTATTGTCTTCTTTTGCCTTCAATGATCTTTCTCATTTTCCAGTCACTTGCCTTAAACTGCTGTAATCCATCTCACCAATTTCAACTGTTTTACTCCATTAACAGCAACAAAAGTTAGAAGAAAAACAAAAATGTCATATGCCTGATAAGGAGGCATGTTAATGGACTCTACTTCCCTTTGCAG
>TTN-209,,0,2007,2128297,2130303,GTAAATGCCATACATTGGCACAGATGTTGTCACTTCATTTCATATTGTTGTCCTTTTTGCTTTCTGTACATGTGTGGGAAATGCTTGTATTACCAACTGGAGAGACCAACAACCAAGACAGTAACATGGTAGGTAGGTACTGCAGAGCCTATATGGGATAAGAAATCATTATTTACAGTCACATTTCTACTACTGACCAAAGAAAAAATAATTTATTATTTGAGAACAAAGTTAAGTAATCAAATGAGCTCAGCTTGGCCCTTCATATAAAACATATCAGGACAGTTTGGTGCCACTAAAAAAAAATAATGTCTCAATGTATTTAAAAATTTTAAATCAAATAACCAATTAAGAACAGAATTACAAACTTAAAAAAGTCAGTGTCTAAGTCTAAAATTAAATCCTAATGTAAGACAGGGAGCTAGTATAGGACTGAAAACTAGGATTCTCTCTAGGCATTTTTACTAATTTAAAAATAAGACGGCTGGGCACGGTGGCTCACGCTTGTAATCCCAGCACTTTGGGAGGCCAAGGCAGGCGGATCACAAGGTCAGGAGATCGAGACCATCCTGGCTAACACAGTGAAACCCGATCTCTACTAAAAATATAAAAAATTAGCCAGGCGTGGTGTCACGCACCTGTAGTCCCAGCTACTTGGGAGGCTGAGGCAGGAGAATTGCTTGAAGCCAGGAGGCAGAGGTTGCAGTAAGCCAGGATTGCACCACTGCTCTCCAGCCTGGGCAACATAGCGAGACTCCACCTAAAAAAAAAAAAAGAAAGAAAGAAAATAAGACAACTACACAAATATCCTATTCCCAATTTTCTAATTGATATGTAGGGTGACTTTCAAATAGTTAACACTCATCAAATACTTGAATGCCTTCATTAACCAAAATATTAGTAGCAAGCTTTTCTTCCTTTCTTCCTACCTTCTTTCCTTCCTTCCTTCCTTCCCTCCTTCCCTCCCTCCTCTCTATCTTTCTTTCTTTCTTTTCTTTCTTTCCCTCTTCCCAAGAGAAAGTGTGAGTATGAACTGTGGTTTGAGGACAGGGGTAGAGGTACAGTCAAGCCATACTTGGACTGTTGGGGAAGGCTGTCCCTTGGTCTTCTTTGTCAATGAGAATATCAAGGGGAAGGGCAAATGCAGCACATCTCTTGAATGTGAAAACGATGAGGTTCCCTATAGCTTCCTCTTCTCTACAATCCTTTTACGTGATCCTAAGAAAAACCCAGGCCCATGATGACCCAACCAGTGCTTTTCACTCTGGTCAAAATGTCTCCATAAAACCAAGTACATGATATTATTCATACTGACGCGTTTGGAAGTTTCTTTACTCAAATTAGGTCAATTTAGGAATGCGACTAATATTGAAGCTTCAGATAATAAGAGGAAAGGATAAGGAGGATGACTTAAAAAAATTAAAAAGAGAGGTTCTGAAAGTCTGGCTTCAAGATGCAGAATGGAAAGGGGAAGTTGCTGCTATTAAATATTTTTACAAGTTTGAGTTGGCCTAGAGGATGCATTCATAGTTAAGCCATATAAGAATTTCCAGGCAGTTGACATGAGGGTTAGAAAGACATTACAAAACTACTTCAATCTTCTTATCACTTAATATCCCTACTCTTCAGAAGAGTCAAATACATTTTCTTTATCTTCCTTACATAATCTTCTAATTTGCAGAATTAAAGTATCAGCTCAATAGCTTATCAAATAATTAAACAAGCAGCCACTAAAATGGACAAATCTTTAGTAATGTTACTTAATAAAGGAACGCTTGTCTTTTCTTTGATAGAGACAAGTAAAGTGATGTCTTGCTCCCTTATAAAGAACACTCTCATCCCTTTCCTTTGACAATCTTTTGTTCTTATTAACACATTACTCCATTTTAAATTATGGCTCATGTCTATCTAAAGACTTAACTCATCTTTTCTCTGTCTTGGAATATATAATTACAGCAAGTGCTTTGGTGGGGACTAAATGTAATGCTGGAAAAATTTCTTTTGCAG
>TTN-209,,0,522,2130304,2130825,GTAAGAAACGTGTGAATGTATTTTCTAGTCCCTTCTCTGCAAGGAATCCTCAGTAGAAAAACTGTTGGCAAACAATTCAGTCAGTACACTTTGTTATTAAAATAATGTCATTCAGCAAACATTATGGTTTGGGAAAGTCCTGGCATTGTTTGATTTTATTTTTTTAATCCTCTTCAAAGTTCACTTAACTTTTGTTCTTTTAAATTGTCTGCTATTAACAAAGCTTGCTTAAAATTTCTTCTAAGAAAAAACTCCAAGTGTCTGAGCAATTCTTAACTATCTTCTTTTATAAAATTCTTCTTTGTGTAGGTAGTCTGTTTATTGTTGTTTTATTTTAAATCAAGAGACTGGGAAAGTGTCTTAGAATGATAGGAACCTATTAAATGCACCACAGCTTTTACAGAAATTTTGTGGAGATATTTTATGTGTGTTGGGTCTCTTTGTTGTATATGTCTACTTTTCTTTTGCGGAGTTTATGTTTCAGATATCTTCTCCTTTTTCTTTTTTGTAAACTTCATGTAG
>TTN-209,,0,100,2130826,2130925,GTTTGTTTACTGAGTTTCCATCCAGTATTTTTCTGAGAAAAGATTTCCCTTTTAATTACTTATTACCCATTACTTACACAATGCTTTCATGCTTTTGTAG
>TTN-209,,0,435,2130926,2131360,GTTAGTGCTTGAAAAACTAATGTCTCTTTAATAAATTGTCAAACTAGCTTTCTTACCCCATGGAAGAAAAACTGGTACTTTCTTCTCTTGTCCTATCCTTTAAATTTGTTTTGTCTTGGTTTGACCTGGGACCTTGGGAACAAAGTCAGTAACTTTCACCTGGTCTTTTTCCCGAGACTAGTGTAAATATCTATTATCTGATAACAAAAGGGAATAATAAGCCATTTTGTCAGCTGACAAACATGTATCATCTATGCCTCTGTCTCTTGGATGGAATTATAATTATTCTTAACTTTTATTTCTTCTTCTAATTAACACTATGAAATAGTAGTATTGGGACAAGATAAATATAATCTTGAAAAAACTCTTAAATATAGATGGTGTTGAAAGTGTTTGGGAATTGATATGTTTTATATGCTCTCTTTCCTTAACTAG
>TTN-209,,0,96,2131361,2131456,GTTTGTGTAGGAACATTTAAACCTCAAATTGCTATTTAGAATTAAAGTGAAACCCTAACAAGCATTTAGGGTGCTAACTATTTCATACCATTGTAG
>TTN-209,,0,117,2131457,2131573,GTTAGTATTTTTAGAAAATGATGCTACATATGCATTTGAAACCCAACAAATGGCCTAAAGTCAATCACTGAGCACTCTTCTATATTGACCTTTTCTCCCTTCTTGTGCAACACACAG
>TTN-209,,0,115,2131574,2131688,GTTGGCTGGAGACTTTGCATTTTATCCTTATTAAAGATTATGTTCAAATTAAGTCATCTTCCCTTAGATCAACCCTCTTAACTCTTTGAAATTCTTTCTTATACCCCTTCTTCAG
>TTN-209,,0,92,2131689,2131780,GTTTGCATTGTTTTCTTGACATCTTTGTGCTAACCTTGTTATAAATTCTTTCCTCTTTCTCACATTTCTTAATAACTTCCTTCCTTCCACAG
>TTN-209,,0,94,2131781,2131874,GTTTGTGTTCACTTTGCCTCTTGTGTTGCCAAAGTTATGGCCCATGGCACAGACCCCTCCTCCCTTAATGCAAATCATTCCTTTTTTACTGTAG
>TTN-209,,0,109,2131875,2131983,GTTAGTGTTGGTTCCAGTGAGGGACTGGCTTTTCTGAAGAGTCAATTCTTTTTTTTAAGCCACTTTTGCTATAGGGATAATATTGATTGAGAATTCATTCTTCTGTTAG
>TTN-209,,0,101,2131984,2132084,GTTGGTTCAGAACGTTTGCCTTGGGTTTGAGGAAGAAATGCAGATGTAAGCCTTTCAGCAGGGTAATGCACAACCCACATCTATCCCTTTGTTTTCTACAG
>TTN-209,,0,132,2132085,2132216,GTTGGTATTGTTCTTCTACAGAGAGGATTGGGCATTTCCATGCTCCTTCTTCCCTTAAAATTTAAAAAAAAAAACAAAAACAAATTAGTAGATTGACCTTTTTTTGTTGTTGTTTGCTTTTTCATTGAATAG
>TTN-209,,0,133,2132217,2132349,GTTGGCAAATTTTATTTCCACTTATCAAGAACTTACAAAATATTTTTGTTTCATTTCTAAATTTTCACCTTTATTGCTAAGTTATAAAATAAAACTTCCTATTTTCTTTTGCTTGTTTTTTCTTTCACCTCAG
>TTN-209,,0,147,2132350,2132496,GTCTGGTCTCTACATCTCCTCACTTTCTTGCTTGTCTAGATTTTCTTGCCTGGGGTGGGCCGGGGCGGGGGACGCTTAAGACAGCAGTTTTGCCCAGTGACCTGTTTTTAAAAATATTCAACATCACAATTCTTTTTCCATCTTTAG
>TTN-209,,0,97,2132497,2132593,GTTCGTGAATGGAATCTATTCTCCATTTTGGCTGTGCTGCCTGATAAGTTTGGGGTCTTCCCTTGAGTAAGCTACTGTCTTCCTTTTGAATCTTTAG
>TTN-209,,0,118,2132594,2132711,GTCAGTTATACAAGAAGCAGCCTATCAAATAAAAATTCTGTAACGCTTTTAAATCTTATCATTATGGGTAGGAGTTACAATATGTTTCTTCTTTTCACACTCTCTTATTTAATCACAG
>TTN-209,,0,112,2132712,2132823,GTTTGTAAGCTATTCTCTTTCAAAGATAGTCTATAGCGACAGTTTCATTAGCAGACATTATTTCTAGTGGAGTTACCAATGTAACTCATCCACATTTTCATTTTTACTACAG
>TTN-209,,0,102,2132824,2132925,GTTTGTATCTTCACCCCAGTCAGCTTCCCTTATTTATAGTATGTCCTTTGTAAACAAATAGCAAGAGATTAATGGATGTGTTTTGCTGTTTGCATTGGACAG
>TTN-209,,0,246,2132926,2133171,GTTAGAATTTCTTTACCTCTTCTTGATTCTTCCTTGCGAATGCTTCTTAAATGTATCACTCTTGCCTTTGTATCCTTTAGAGCTAAAATCTCTATGATTCTGGTTCTTTAGATACATATTCATTGTGTTCAAGAAATATTCAGCCATTGCCTCTTTCCAAGAGTGTTTTCTTAAATGTCCATAAAACTGTCACAATAATTCAACTGCAAGCAATTTAATTAAATATATCTCTCTTAAAATCTATAG
>TTN-209,,0,213,2133172,2133384,GTGTGCAAATTTGATTCCTTTATGTTTCTGTCTGACTGTGTCTTTGGTTCTCTGTATTCAGTTACAATGTCTCTAAACAATCAAGAAAGTAGTATTCTTTCTAACATAGTAAACAGTATTTGCTCATGTTTTTCTCTTGCCTGTATACTATCTAATTTAACTATTGTTATTTATTTCTGTTCCCTGATACTCTCCTCTTTCCTGACTCTTTAG
>TTN-209,,0,1043,2133385,2134427,GTAGACATCTTGTTCTTGTGTTTCTCATTAAATGAAAACCACCTTCTCCCCTGGGTATTATAGCTCTTTATTCATTTACTATCATTTTAGTTTCCATTTGAGATCATAGAATATTTTTCTGAGCTAGTATTATTTCCCTTTTTAGATGGTTTCCTTCTTGAATTTTGCTTACATGTAACTAGTCATTATGAAATATTTTTGTTATTCCAGTGTCATAATTCTGATTACCTCAACACATTTGCCAAACATCAAACGTGATGTTTCAAAACTGCACAAAAAAATGAAGTAGGCATTTTAAAATTAGTCTTTTGCTTTCAATCAACTTACAGATATATCATTCTCACTATAATCTATATCATTAATAACAAGCACTTTTACTATATCTATGCAAAGTGAAAGCAATACAGGTTTTAAACTTATGTTTAAAACAGGACAATAATATTTTTTCCTTCTCTCTCAAGGATCACTTCCTATCCTTTAAAAATTATATGACTATACCTTGGTACAAATAGTATCTGTGTTTTTTTGCTGCAATTTTCCAGTGCTTTTTTTTTTTGTCACAAAGGCCAAGTTTGTCTTGTTTTAAGACAATTATTGCAGTAATCATTTGCTGAAATGGAAGACTTAGATCACGGATGTTGTGATGACTTCCAAGTGTCTGTTATAGAACATATACAAAAAAAATCATCCTTGAAATTAGAATTCCATACTTCATGCAAATCATTATTTATTGCTATACTTGCTTGTTTGCAATTTTTGTATCAATCTTTGTAGCCTAAGATACATCAGTAAGGTGTAGTAGATAGAATGTTGAACTGTTCAGTAACGACATCTAGGATCTATCTGGGTTCTCTGCCCATCTAGCTGGTTATCTTGTGAAGGCAAATGGCTTCTGAGGCTGTTATCCCATGAGAGTGTTAGTGCTGGACTCTACTTACCCATTAGAATATCTTAAACCTTTCTTCCAATTTAAAGACAAATAAAAAATTTTCATTTTGTGAAATTCAGTAGCCCAATTCATGAGAAATTCTTGTTTTTTGCAG
>TTN-209,,0,118,2134428,2134545,GTAAATATAGTTCATCCACATGGCAGAAATGTCATAAATGTGCAAAATCCTACTTTTTTCACTCTCGCATGATCTGGACAATCTTTTCAACAATTTCCATCCATCTTTTCCTGTTCAG
>TTN-209,,0,829,2134546,2135374,GTTGGTACAATAGCCCACGATAGAAACTGGTGCCAAATGCTGGAATGAATTACTAAGAGTTACTGGCAGATTCTTTTTCTGAGTTTCTTCTAGAACTATATTTATCCTCATCTATTTGAAAGGTCTAGAGGAAAGACATAGTTGATCTTTCAAACACTCTTTTCTGTTTCTGTGATTCTAACAAAAATTAGACATCTGTTTTATTGTTTAATAACTACCTGTCTATATCAATTAGCAGATACAATCATGACTCTCTTTGATTAAGCATGAAAGAATACAGAGCCCAGCATGTGCTACAAGAGTAATTGTTAAAACTAACAAGAACTCCAAAGGTTGGCATTTGATAGCAAAGCTTCCACATAAAATTAATGACAATTAAACAATTGTTTGAATAACAACTTTCAAAGAATTGTCTTTAGCACCTTAAGGTAGAGCAAAAATACCAAGTAATTCACAATAACCTGTAGACTTTGATCTACAGAGGGTCAAGTGGAAATCAATATATACTATCTAATGCACATTGTTTAAATTGTTTTGAAGTTGAGTCATGCACGAACATATATTTCTTAAGAATAATTGCTACATAAGACGACAGCAAGAGTGGTGGGAAAAACAAAAAATAAAGAAAAAACTGAAAAGAAAAAATATTAAAATAAAAAATAGCTATAATTCTATGACTGCATGTAATTATGGAATCACACTTTAAAGTCGAGAGAGAGAGCACCCTAACATAACCATCTCACTGGGAGAAACAATCTTAGTGAATGTGATAGTAGAGACAGAGTAAAGATCCCAGACTTTGACAGATGGATATCACGTTTTATTTCAG
>TTN-209,,0,116,2135375,2135490,GTTAGTTCTGCTGTTTTCTTCTGGTTGCTTATGCAAATTCCTTTTACAAGTTTCCTTCTTTCAAGTCTCTTCTATTCTTTCAAATCATGATGAGTCTCTTACCTTTCCTCACACAG
>TTN-209,,0,159,2135491,2135649,GTCAGTAGACAGTCAAACTTGTAAGGAATTTCTTACAAATTCCTCTTCAGGTGCACATCTATGTTGACAAACATTTGAAAGTGCTCTAATGTTTTATTCAAAATTGCAACTCCATCTGAAGCTTACAGGATCTTTTAATTGTTCTCCATGTCTATATAG
>TTN-209,,0,93,2135650,2135742,GTTTGCTCAAGTGGATTCACTTTTTCTGTTTTCTGTATACCGACATCCTTGTGTTTTTCTTGTGTTTAACTGCTGTGCTTTGTCACTTACTAG
>TTN-209,,0,108,2135743,2135850,GTGTGTTGTCTTATTGTCTCTTAAATCATTTGCATTCTTCTAACATGTAGCATAGTTTCTTTGATATTCATTAATTCCAGTTGCTAACTGTGAGCCTTTCTTCCTTAG
>TTN-209,,0,112,2135851,2135962,GTGATGATATTTTACAAATTAAAAAAATTCTTTTTTCCTTAACTCTTGTATCTTTATGGTGAACTTCTCATTTCATCTCCTAACACCTTAAGTATTACATGTCTCCCTACAG
>TTN-209,,0,124,2135963,2136086,GTTTGTTCACACGTCACTCTTTTTCTTTGCAAACTGTGGCTTCATATTTCATTGTCAAAGTAGAAACGACCAATGGCAAAAAAACAAACAAAAAATACACATTGCCTTTCTTCTCATCCTCCAG
>TTN-209,,0,644,2136087,2136730,GTATCATTCCATGACTTTTGACAATATTTGTTCCTTACCATATTTGCATAATTGTCTTATAAAAGTTTCTTTGGTTTTTAAATGTTTGAGAGAAACTAACTGGACATGTTAGAATTTGTGTATTAGTGTTGGAGGCAACATTAATCAAAGTTGTGTTTTCTCTTTATATTGTTCTTTACATTAGTGTAACTCTAAGTGTAATCTTATCAAAAAGTATTGTTTAATTGAAATTTGTTAAATGTTGTTTTAACTATCTAGTCCATTTTTTAATGCTTTCTTGTTATATGGCATTCTGATTTATCATTACTAAATGTTGATCAAATACATCTATAATACATTAACTTTTATGTTTTAACTTACATAGTCAAACTAAAAAAAAGAATCAACTAAATTCTCTATTAAAAATGCACATGTACCCTAAAACTTAAAGTATAATAATAATAAATTTTAAAAAACTAAAAAAAAAATGTTATGAGATTATTTAACTTAAAAGATAACTTATTTTACTGTAAAATCCTCAGAAAGTATATTCTTAATAACAAACCAGTTTAAATATAAATTTATGGGATCTTCAGCTACAAAAACAAGCTCTTTTAACATGTATAATAAATATCCCTTACTGACTGTTTTGTTTGGTTTACTAG
>TTN-209,,0,257,2136731,2136987,GTTAGACACACTAAGCTTCTTTGTTTCTTTATTCTCCTCTGATTTGGGCTCTTAGCAAAGTTATGAGTTCCAAAATAAAAGGATAATTAAGGTTATTTGGTTGCAATTCTTCAACAAGTTTTAATGAATTGTCATTTCTTGTGTCAGCATGTATTGTCATATGATCACACCAGTCACTCTTCAAGGTTCTAGATTTAATTTTTTTTTCCTTTATAGTAAGCAAGTGTTCTCATTGTTTATCTCCTTTTTTCTGGTAG
>TTN-209,,0,120,2136988,2137107,GTTTGTATACATGGACACAAAAATATATGCCCCTTCCTCCTATCTGTTCTTGCCTAACTAATAACTTGTGTGGCCATGATTCTCACATTTTTTCCTCTAACCACAAATTTCTTTCATCAG
>TTN-209,,0,150,2137108,2137257,GTTAGTAGCAAAGCACAGCCAGAGAAAAAATCAATTTACTTGATCCATGATCATTTTCCTCAAATATTCCTCTTATCCAGTAATTCAGTGATTGCACTCTTGAGTTTGAAAGGTTACTTTGTTTTCAATGCAAAATACTTCTTCTTTTAG
>TTN-209,,0,102,2137258,2137359,GTGAGTAGAATGAGATTTTTATGAATATACAATATTTCCAGGGGGTGGAGGGGCACAGAATAAAACTTCTCTTTAAACGCAAAACTACCCTTCCCCACATAG
>TTN-209,,0,190,2137360,2137549,GTCAGTGTGCAAGGATAAAGCTGCTGCTTCTCTAACACCTCTTTCATGTGGACGTGGTGCCTGCCTTCCCTGGAGTTTCTTTATTTTGTCTTCATGTTTAGTCTTAGCTCCCTTTTTTTAAGGAGCAAAAGCACTTCTCACTTGGATTTCTTTCTTCTCTTTATCTCCCCTTCCGCCTTGCAATATCTAG
>TTN-209,,0,94,2137550,2137643,GTTTGCTCTTTCCCCCAATATATACATCTTTTAAAATTTCTCTTAAGTCTTCATTAGAAGGCAAGAATTTTACCCACATGTTTTCTCCTTATAG
>TTN-209,,0,100,2137644,2137743,GTGTGTTGACAGCTACCTCTTTTTATTGCTCTCTTTCTTTTCAAACATCCTCTTTTACATGGCATGACTGACTTGCTGACTACCATCCTTTGTACCATAG
>TTN-209,,0,132,2137744,2137875,GTGATGGTGTTGTTTAACCTAGTGTGTGTGAACAGATTCATTTTCTTAAAAACGTTAAAACTTTTATGAATTGAAATATGTTGTGGATGCCTTCTCACCTGTAAATAAGGATTATCTGTAACTTCTTTACAG
>TTN-209,,0,140,2137876,2138015,GTGAGTAACTCACAGTACCCTCTTCATTGTAAAGCAGCTTCACTGCTCCAGGCCACCAAAAGGCTGGTGCCATTTAGTTTCTGCTCTGTATGTGAGAGCATGGAAATAAAAATCACCATGTTGGTCTTCATTCTTTTCAG
>TTN-209,,0,1320,2138016,2139335,GTACTTGTTAGAGTGAAGGAGCAAGATCTCTTTTACATTTTCAGTATCTTAAAATATAGGAGGGTGGGTGTGCTTGAGAGAGAGCTATGTTTAGGACCAGGGTCTAGTGATGAAAATGGATCAAGTGGATCAAGGACCTTCCAAATGGAGACAAGTATTTTTTAATTACTTTAAAAAAAAAATTTAAAACTAGGAAAACATGGACCAAAAGTCCATTTTAAGAGACTAAAAATAGAGACTAGAGAGAGATAACCGAAACTCTACAAAATTGCAAGAAAATCCTAGTTTGAAAGACGGTATCATAGGACAAAAGCGAAGTTATTGCAAATGACTTTTTTCCCACAGTACTTAGTAAATGAATGGATTTTGTCCCTCTAAGGCATAGCAAAGAGCCAAACTATCAAGCCCTTCAAGGAGAATTCAGATGAGAATGATAAGTTCAACTTACTTTCCTCCACTAGCCCCACTTAAATAATAGTGGAGGTCAGGGGCTGGGGAGTAAGTAGATCAGTATCTGCTATTATGGAAGGCAGTCATGTGTTTCTGCCACATGTTTATCGCTGCTACTGTCAGAAATTAAATAGTTCACTCAATGGACTGCTAGTCTAGTCCATTAGAGTATTTTTAAGGGTTTTTGTAGTGGTGGTTTATAAATATCTTGAAATTAAAATATAATTAGATTTAGCAGCCCATTTGCTCTATGACATATAGCTAATCACTTTTACTTCCCTATGCCTGAATTTTTTGCTTCAGTTAATGAGGAAATCATTACTCTCACACACTTCAAAGGAAAATTATGAAGGTTGAGGAAATACCCATTTAACACCTAAAAGAGGAAAATGGCATTTTAAAAATATTAAGATATCTGACCCACTTTGCCATTCCGGCTCTTCATGCTATGTAACTGATAGCATTGCAGCCTTAGGAAATAGTTCTCCACTGGTTCATATACAAGACAGTAATCAAATTCTCATTCCCCGTGGACCTCAGAGGGCTTCCACTGACAGATACATGCTATTATCTCTGATCTTGGCACTAGAGAAGGGACTCTTTTGCTGGGGAGAGGATGGCACAATAAAGAGTAATGTCTTTTTCTCCTTCTTTTAGTAATAATACTTGATGTGGATGCTTACAAAAACAAGCATATTTTATTTTAGAAATTTTCTATTTAGGTTTCATTTAACTCTTCTTCCTTGAACTGCATAAATTTGTTTTCCAGAGCTAAAGACCTCTCTAGCAAAGATTATTTTTTCCACCTCATCTTGAATTATATGCATCTGTTCCATCCCTTACCCTGTGTTTTTCCTCTTGGTTCCATAG
>TTN-209,,0,228,2139336,2139563,GTCAGCGCTCTCCCCACCTGTGTGTTTTTCACATTAGCCTCCTCTTTAATTGTCCTCTTAACTTCCTGTTTGACTCTTCAACGATGTTTTAAAATAGGGAAAGGACACAACAAAGAATTGAAAGTGTTTTTTTCACTCTCTATCTCTCTGATGGAGTGGAAGATTGATTCTTACTTTTAACTATATACTTACAGAATACATCCGTATTTTCCTTTTTTCCAATTTTAG
>TTN-209,,0,412,2139564,2139975,GTTAGATGGACTGCATTCACTTCTGCTCACTACTTCCCTTCTAATTGTAATACTCTGTTGCCCCCTCCACCCCAGCCCAGTCTTATCACTAGCAGCCTATTCCACTTTCCCTTTGTTTCCTCTCCAAGTCCTTTTCTGTTTAGTCTGCTTCCCTTTTCCAAATCCTACTGAATATCCTTTTAGATAATGTTGTAATTAGGTTTTGATTGGATTAAGAAAGCTGGAGTAGATGAGATATTCAACTTTCCTACTGAATACAAACTTTAATGTGTCCCTGCTCGCATCCACCAAAAATGCCTCTTAAATGGAAATAACACATTATCACTAGTTTGATTCCCGGCATTCACGATTTGAGCAAAATGCTGTCAGTCTCACAAATTTTAAAACCCAGGCTTTCCTCCTTTTTCATCAG
>TTN-209,,0,116,2139976,2140091,GTTAGTAAAAAGATGATGTTATCACAGATACAAGGCACACACTCACCAGGATCTGTATTTTCTTTAGTTTTTCAATTTGAGTTTAAAATATGGATATCTTTTACATTTCATTCCAG
>TTN-209,,0,524,2140092,2140615,GTTGGTTGATTTCTTGGGCTTTTCCTTCATCATTATAATAATGTAGTTCCTGATTTTCATAAATGTATATGGGTTGTTACATCTTCTATAGGATAACATGAGTCCGACATCTTCTGAATCAGCAAATTCAGAGGCAATACCATCTGTAGAATTAGAAGAAAACCATGTTCAAAAGTTATATCCCTTTCTTTTTGAGGAATTTCCAAAATGATGATAGGAATGAAAAATAGTCCCTGGATAAGGTTAAAGCAGTCTTCATTTATGCTGAAATAATTCACCACATAATTCTTCACGGCAAAGAGAGAACAAAATCCCTAGCAAGTCAACCATCACATTCTGCCCACTGATTCTCCAAGCTTTTGATAGTGTGAACCCATAGAGGAGTTTTTAATACCGTCACAAAAGAGCCAAATGGATCTAGGGATAGTCCATCAAAAAGACAGTTCTCTCTTCAAGTCATTTTATAATTGTTGTCCTTTGTTTTTTTTGTTTTGTTTTGTTTTGTTTTGTTTTGTATCATTCAG
>TTN-209,,0,109,2140616,2140724,GTCAGTTTACAAAACAGTAAAATGAATTGCATTTCATAGTTTATTAAGCATGTTTGTCATAACAATTCACAAATACTAAACCTTTTCTGATATGTGCTTTTGTGTTTAG
>TTN-209,,0,103,2140725,2140827,GTTTGTCAGACTGCTCTTCTAGATTTATACGATTAGTAATTAGATGTGTCTTTGTCTGTATGTATATGTGTTTGATTTTATATTTTCAATTTGGTCACTTTAG
>TTN-209,,0,92,2140828,2140919,GTTTGTCATGATTGCACATTTTTATCTTTGTATACAATCGATGATCTGGCATGTCTCCTTCATGACTGATTGATTATCTCTCTTGGCTGCAG
>TTN-209,,0,594,2140920,2141513,GTGATTGCAATATTTTTAAAGTGAACGAATTTGTGTTTCTTTTGAACAAGATTTAAAATGTCTGGGGAGGCCTATTTTTTAGGAAAATCTTTCCAAAGGCTTAAAATTCTGCTTAAGTAATCCTATTTACAGTTAGTGGCTTATCTTTTTCTATGGATTCTACAGAGAGATAATATGACTAAATCTTTAATTGGAAGGATTATGCAATCATTTGCTTCTATAATTAAATCTTTTTTAAAAAGTGACCATATATTTTTAAATTCCACCCCGTAAGTATCTCATGCAAATTGCTAGAAGGCAGTCTTTAAAATTACAGGAATCTGCTGCTTGCCCAGAGACATGCCTTCAGCCAACCAATTGCTTTATTGGTTTTCATACTGTTTTGCACCTACTGTGCATTAGGGTTGGTCTCAGAGTGATACTTTTGCTCCAGAAATCTATATGCTTTTCTTTATCTCCAAGTTAATTCAAGAGACATTAATAATTCCTGATTTTTAATAGAAATTGCATATATACGTGCGTTTGTATATATATAATTGTGAGAAGAGCATTTAGTAAATTAAAGTATTTGTTACTTTTATTCTGTTCCTACAG
>TTN-209,,0,139,2141514,2141652,GTTTGTGGATTCTTAAACTTTCATTTCTAGAATTAAAGTATTATAATCAAATATGAACTTAGGGAGAAATTTCTATTTCAGTAAACTGACATGGTCCAGATATTGAGCCTGAAACCTTGTCTTTCTGCTCTACTATTAG
>TTN-209,,0,778,2141653,2142430,GTATCGTTTATTTTGCAAGTGGTCCAACAAAAGTGTAATCATTTTGTAGTATAGCCTGAAGGTGTCGTTTTTATGATGATGAATGCAATTTAGGACATTTTTAAACAAATGAAAAGAAAATGTTTAAGAGGAAATAAGTTTATCTAGAGAAGAAGTCATTTTTTAAATCTGTATTTCTTTCTTTCCTCGAGACAGGATCTCATTCTGTCGCACAGGCTGGAGTACAGTGGCGTGATCTCAGTTCACTGCAACCTCTGCCTCCTGGGTTCAAGTGATTCTTGTGCCTCAGCCTCCTGAGTAGCTGGGATTACAGGCGCCTGCCACCATGACCAACTAATTTTTGTATTTTTTGGTAGAAACGGGGTTTCACCATGTTGGCCAGGTTGGTCTGGAGCTCCTGACCTCAAGTGATCCACCCGCCTTGGCCTCCCAAAGTGCTGGGATTACAGGCATGAGCCACCACACCCAGCTTATAATCTATATTTCTAAAACTTTATATATTCCCTATGATACTGAGACTACCCCTTCTTTTTACAAATTTGTGATTCTCTAAATGGCCATGAGTTACTTCTTATCATCCACCTTGTAAGTCAAAGAACAGTTTAGAATAAGCTCGTAGAAGGAGGCTGAAATGTTTAGGAACATATTCTGATATAGTGTATTTAGTTGGTTAGCCTTGATTTTTAACTAAAAATATGAGGGTTTTTTTTCTTGAAAAGCTTCATATTAGTAATCTGCTTCTAGCTTCTACTTCATATATCCTTGCAATTTCTTATAG
>TTN-209,,0,1752,2142431,2144182,GTGAGTTATCCTCACAGCCCCAACCTGTTGTGTTTTTCTTCACTGCCTGTTATATATCCATGAGCATTTCTTATGATATCTTGACCAAGTAAGTTATAACAAATATAAATACACATTATTTAACTGTGTATTTATCACTCCATATGTTTACTAAAAATATAAATTATTGTAATTTAATTATGTGGCTTCCCGAAGGAGGTGTCATTTAACGGACTAATATCTTAGGTTTCTAAATCATATCCTAAAATTCCTTTAGGTAGTTAGAAGTTTCAGCGTACTCTGAAATGTGTGCATATGTGACATATATTTTTATGAAGCACATTTGTTTTGAAATTTTTTTAATGTTCATCACCAAATATCACATTAACTTGACTATTATTGAGTTATATATTATATCACAGTCTGAAACTTTCTCCTTTCCAAGTGTATTTCTAAAGGATTATTGTTTAATGTATATTGCCCAAAGCGTTTGACCTGCAAACAAATATTAATCCCAGACAAAAGGGTAACATTTGCCCAAAAAGAAAAATAATGGGTAGAAAACATTGCATATCATTATGGAAGACATATTTAAATACACAATCATCGCTTGAGAAAATGAAATAGACCATGTTGTTTAAGGATATCTTTATCTGTTTCTCTTCACTGTAATGGCTTCCAGTAATTACAACATAGCTTCATCAAAATCACATTAAAAACTAACCTCCTAGAGCAGCCTGGAATTAATTACCAACTCTTATGATCTGGTTAGTTATCTCACAGTGCACAGGTAGTAAGTTATTATTAATAGGCTGATATCACTAATAAGTAAATATCACTGAGTTGTCTTAAAATTCCAGTTTCACCACTCATTTTGTGGAATTTAGATGCATTTAGTTTTAAAACACATTTTATAAAATGAAAAATATATACTTAGCAGTGGCTTATCTTCATGATTTACACTCATGATGGTTTTACCATGGGCAGATAAATGCTTTCTATAGAATTCTGAAGCTATTTATAAAATGTTTTTAAAGGATAGACATCAGAAGTTTTAATCTTTGCAATAACAAAAAAAATGGCCTTATTCTTTCTAGGTACAGGTCTCAGAACCATTGAACAAAATCATTACATAATACTGAGTTGTACATTGCCTTCCTATCATGTTACTCATCAATGTCTTCATCATTGGTCTTCAGTTAAACACTGAGCCTCAACTCCTAATTCCCTTGGGCTAAGATTGGATTTTAAATGCTACTGTGGCTGCATTTAATAGCTAAAGATGAACATCAGAGAAAATCACATATAAATATGTGGGCTCATGTATTACTCAAATGCTAGCTTTCTTTCCTAGAGGGTAGCAATCATTGCCGCTGGAGATAAGCAGAATTCCCAAATAAGCCCTTCATTTTCAGGGTTCAGCAAAAACACCGCTGTACACAGGTTTGAGAGAATTAATAGTGTGCTATATGGCAAAGAAGTTCATAGTAACTGCCAATGTCTGCAGTGCTTAGTAAGGACACAGAGGCTGGGGCAATTTGTGGGCAGCATGTGATGTGTTCTTTGCTTGTTTTTAAACCTTTATCTTTTTAAAAAATCCAACAAATTTAAACTATTGTCTTTAGAGAGGAATAAACCAGGCACATAATTCTGTCCTACTACAGCAACAGTGTTACCTGTTAGAGGCCAGTTTTTCTCTTTATTTGTTTCTCTTGTGGAATTTAATACTTTTTTGCCTTTATGTTCCTCATGAAAATACCTTTTCAATTCCAG
>TTN-209,,0,571,2144183,2144753,GTACAGACACCTCAAAAGTATTATGCAGCTCAAGCCAGCAACCACTCATGTTTATTTGCTTATTATGATTTCCCTAGAAATGGAATTAGATTTTTAGAAATATCAGTTGTTGCTCATCTGCAATTTGTAGGCTCCTTATTATAATTGAAATATTAGGTAATTTAACAGAAATAATGTCAATACAAAGTATCTGAAATTACTACAAGTTTACCACCCTATTTCTTGAACTTCTTTTCACCATATCCATTAAGATGTAATTAACGCAGTTCCAAAAATGATGCTATAATAATGCGATAGAAAGTAGGCTGTTGTGATACACCTGGAAAAAATAAAACCAAGTCTAAAAATATTGACACTACTAATATGATTATAGTTCAACCTTTGATAGCTATCATTAGCATAAATGTCTGAGAAGCTGCTTTATCTTCTGTAACCCACCCTTACATAGAAAGAGAATTCTGCAGTACTTACTTATCAAACTGCCAACCTCCTAAGGCTTATTTTACAAAGGGGGATATGTATTGTAATTCTGAGGTGATTGTAGTAACAAAACATGTAAATGTTTTTTCAG
>TTN-209,,0,122,2144754,2144875,GTAAGTGCACTTCATGAGAAGTACATCTTCATCTATCTTATACCTTTTACTTATGATTTAATTTTGGAAGAACTGATTTTAGAAAATTAAATTTTTATTCACTTGTTTTCATTATTCCTTAG
>TTN-209,,0,1096,2144876,2145971,GTGAGTTCAATAAAAACCACAAATCGTACAATCAGCCCTCCATATAAGTGGGTTCCGCATCCACAGTCAACCAGCCCCAGTGGAAAGTATTAAAGAACAAAAAATTTAAAAATACAAATAAACAATACAGCATAACAACCATTTACACAGCACTTACATTGTATTAGATATTATAAGTAATCTAGAGATGAAGCATATGGGAGGATGTGCATAGGTTACATGCAAATACTATGCCATTTTGCATCAGGGACTTGAGCATCTGGCCACAGGCCTCCTGAAGCCAATCTCCCAGGCATAGAGAGGGATGACTGTAATGTCCCATTCACAAAAAGAATCTCTCAAGAGTCATGGGCCATCCATCTCAAGATTCAGATTGTTAAAGAACATAGGCATATAGACATTTTCACAGAAGCAGATAAGCAAATACACAACATCTGGGTGTTCTTGTTTCATTAGAATCAATTTCCGAATTTAAGAGAAAGTTTTAAGAATGAGGTGAATGTCTATTAAGATTTTTAAACAAAAAGAAATGGCCTATAAAGAAACCCCAGTATTGTCTGTGCCTAGGTATGAAACTTTTTTTCTATATATGATTTCTTATGTTATGAATGGTTCTCTAAAACAACTGTTTTAAACATTTTCCATAATTATCATTCATTTCAATATGGTTCATTTTTCAACATAATTATTAAATTAAATCCACACTCAATTTCCACACATCGTTTCCGTGATATGTATACTATTCTATTATTAAAGTTTTCCATTGCTATTATTATTTTTTCTGATATTATAATTCATTAGCTAGGCTCTTTGGTTATAAAGTTTACAGAAATACTTCTATTATCCTTTCCCTTCTTAAAATTTTCATTCCTACATCTATATTTTATTACAATGGTCCTAATCCATCTGATCTTAATCGACTCCATCTCCAAACCCACATTTTTAAATTGTTTCACAGCTAACATGGTAAAATTAATATTTATTGAATAAAGAACATAGAAAACCTTAATGAAGTATATAATCTTTGAATGATGATAGACAATTAAAAATAAGTAGAAGACAGGTGTTTTATCCTTACTTTTTAAATTTTATTTAG
>TTN-209,,0,207,2145972,2146178,GTATGCTCCTTCATATATAGCATCATGCTAAAAAAGTCACATTTAAAACATCTCACATATTCCCTTTGAATTACCAGAATCCTATAGTTATATGACGTCATTTAATATGACCTAACCAGCATCCAGAATGGAAGCTGAATATAGTCATGCGTCCTCTAAATCAAATTTTGTTTCATCTGTAATGCCTATCATTTTTGTTCTTCTCAG
>TTN-209,,0,99,2146179,2146277,GTAAAAAGAATTATGTTGATAATAAAATGAACAAGTTATTATTGAGTATTATTATAAGGGAAGGAGTAACAAATGTGTTTTAATTCTTTATTCTCCTAG
>TTN-209,,0,102,2146278,2146379,GTAAGTTAGAAAAGGCTTATGAAATACTTGTGAGATTTAAATTACTGTTGAGCACATCTGCGTGTGATATTGAACAAAATGCGTGTTGTATCACATGAACAG
>TTN-209,,0,1483,2146380,2147862,GTGCGTGAAACACTATGGAGTCCTTGTGGGTACAGCATAGGTCAATGGCAAATGTTGTGCAGGACCCCTGCAACCCTACCTGTAGACACACACCAAAGTGGTCATGTGTTCTTATTTCCCAACACACGTTCTCATAGTATTCATCTCAAAGTTCATACAAAAGCACAAGGGAAATATTCAAATGAGTGTCAGTTCTTTTGCATCGTTCTTTTAGATTTTAATCTAGTCTAAGACATAATCTTTAACAGTTATTTCTGTCTAAAGTCTAAATTTCATGATTCTCATATCTAGGATTGTAGAAAGAAAGCTAGGAAAGGACAAGATCTCATAGATGTAAATCTGGAGGATCTTGGCTAGGAATTGATATTTTGTTTATAGGACTTAGTCTGACTTTCTCTGTACAAAATTATATAGATAACATAAACATGTCATGTGCAATTAGCAACTATTTTTCAAAAATATTTATTTCATTTTCAGATCATGTTTCAACCTTCTGAATCTCTGAAATTAAGTGAAATCTCAGAATTTAGGAGTAACAACATTCATTTCCTAATTGATTATACACATTTTCCAAAGACACCCTCAAACTGTATTGAGAAAAATTTTGGCTATGATAATAGCATCTGCTTTCAGCTATTGGTGCCCATTCGTAGTTGCTGAAACACAAATATATGACATTGGATTTACATAAGCATGTCAACTTTTCTGACTTACCTTACAATGAATATCAGTGACTGGTTGTATTTTAAATGGTTTTCAAATTAAAGGGCCAGCTGCAAGTACTAATTATTTTTTAAATAATTGATATTTTTAATATAATTCTTTAGTAAATAGAGCTCACCAGAGTACTGTGATTTCTAAGACTTTATGGTACTGTTATACATATAAGACCCTCCCCTCCAGCCTCTTCTAGAAAGCACTCCTGCCATCCACACACATACTTTGTTTGTGCCCATATGTACTTAGCAGATTTCTGAACTCTAAAATTTTTCTTTTTGAAATTTAGAAGTGCAGATTTCCGATTGCGTTTGAAATTATTTTACAGGAAAAGTTATACATATTAGATAAACAATTATAGATCCTGAATAGCAAAAATTATTTTACTGAGGCAAGAAAGAATTTCACAGAGGAATAAGTTGTAGAGTACAATCAAGTTTGTGTTCCCTAACACTTTTAAAATTTAATTTGACTTTGGGTCATTAGCTCTCTTTAGTATGTTCTTTATATAAATATTTTAAGAACTCACAATAATTTCTTTACACTTTGCTACATTCGACCAGCATGAATACACTTAAGAATTGGGATACTTTTTTGTTAGTGATGCAAAGAAGAGTGCATTTCTTCTCATTTTGGATTTTTGAACTTTTCTTGCTATTTTATAACTGGGTACAAAGATGGAGATTTTAAGTATCTGAGGTAAAAGCAAGTAAAAGAAATTCCTCTCTATATAATCTAACTTTGAACCCTCTTTGTACTTAAACAG
>TTN-209,,0,208,2147863,2148070,GTGATTTCATTGACAGTTTTCCAGTGAATGTATAATTTAAGCCTCGTCTGTTTTCTGTATTTCTACCCTGTATGCGCTCATGCTCTCATTCTATCTAGAATGCTTTTTTAGAAAAGACAAGTGTAAATAAACACATACGTATATTGAAGTAAAGAAGTGTTATTTGCAACATATCAGAAAACAAAAGTTGGATGATTTTTCACCCTAG
>TTN-209,,0,101,2148071,2148171,GTGAGGTAGCGCCATCAGAAAGCCACCCTGCCATCTTCGAAACACGTAGCCTACCTATACCATTCTGAACACAAAAATATCATTTTTTTTTTATTTTGCAG
>TTN-209,,0,452,2148172,2148623,GTAAGTTGTTTTGTAAAAATCAATCCTTGCTTACAATAAATTTGGCATAATTTTGTAAATCACAGAAGCCAAACTAAAATGTATAAGATATCTTTCTCTTTTGGGTAAAATATTTTTCAATAAAACTGTTATGCAGTAGAATTACTTTCAGTCAAATAATAAAATGTTAAACCTTGTGAGTCTGGCAAATTAGAGATAATAAGGTCTCACTCAGCTGATGCTAGAATCATGTTAAATAGAATAGCCACAGAATGAAACAAATTTTGACAGTGAACAAAACTTACCTGCGTGGTTGCATACAAAAGAATACTAATATTATTTTGTCTGTATATTAGATTCTGCCATTAGATATGCCTGACATATCTCAGGATCTAATAAATCAAACACACCTTAGTTTTCTAATAAATAGCTTGTTCTCAGTCTCTCTATGCTTATTACATGTCCCTTTCCAG
>TTN-209,,0,324,2148624,2148947,GTAAGACCCAGAACCTCAACATCTGAGCTTGGAGCAGCAATATTCTAGCACTAGGAATCTGTACGAAATTTTATACCAGCGACCAAACTGCAGCAGAGTCAGAACAAAACCTTCCATGTCATATTCTTCAGTGAGCAATTAGAAATTAAAGTAAAAAAAAAAAGTAGTTCCAGTTATAAATAAATGCTACTTTTATTTGTTCCGACTGATGAATTCGTACTATAATACCTATGAAGTACTGAAAGAAATGCATGAGACTTTTCATTATATTTTACGCAAAATAAGAAACTAAAACATGTTACTAACGGCATTTATTTTCTTCAG
>TTN-209,,0,2205,2148948,2151152,GTATTATACCTCATCTACCTAGATGTCGAAATAAGAATTTCACTCTGCTGACCCGAAAAATGTTGCTTAATACAACGCATTGGCCCTCTAGTGGTCAAGAGGTGGAATTGCCTTTCAAAATGTAAATTACTTTCTCAAAGTATTAGCTAACTAAATGTGTAAGTTATGTGCTTAAAACTCTGAAAATCATCAAACAAAATACTATTTTGGTATTAAAATATTTTATTTTAATGAAATTACTGAAACATTAATAGAGAACTAATTTAATGTTTCATATTTTCCTAACTACTATGTATAACAAAAAGAATAATGGAACCAATTTCTAGTGCAGCTTATAGAAATAAACCATAGTAGTTTACAGCCAAATTGCAAATTATAGCTTGTGGCTTTTCTCAATTTATAGTATTAACTACTCTTAAAAATTTACTATTTTGTCACATAAAATATGATTTAGAATACTTATGAAATATTTGACTTCTTTTGTACCTAAGGCATGATCTCACCAATAAAGAGATCTTAAGTGTTCCAAGGAATTGCTCCTCTCAAATACTCAGTAGAGAAGTTGTAGTATTTGTGTCCCAAAGCTTCTCAACTAAATTAGACAACAGATTTCCTGGGACTTTCTGGAGTTATAGGGAGTTCAGAAATGCTGTCAGAATTCTCCCAGCATGGTCAGAAAAAATTCTGTATGTCAAAATCACATTTTTCTATAGCTAAGTCACTACTACTGTATTAGATTCAAGGGGTGGAAATGGTAGGCCCTTAACACCCGCTATAATTGGCATTAAACGCTTGACCTATTTTTCAGCCAGCCTTAGAGGAAATTCAATTAGAAACTTCCAATTTTGTGACTAATGCAACCTCATTAACAAAGAGAAGCATTTTTATGATTCATACGAACATAAGCATTTTATCTAGCTGTGAGAACAGAGAGGAACAAGAATCAACAATCATAAATTGGATTTCCATTTCTATTTCTGTTGTCAAAAATAATAACTTATGTTAATGAATGATTTGTTCTTTGACTGGTAGTATCAACATGGCTAAGTTTGGTACTCACTGTGAAACTTGAGAAGTTAAATAATGTTTTAAAAATTAAAAAAGAGGCCTGGCGCGGTGGCTCACGCTTGTAATCCCAGCACTTTGGGAGGCCGAGGTGGGCGGATCACGAGGTCAGGAGATCGAGACCACGATGAAACCGCGTCTCTACTAAAAATACAAAAAATTAGCCGGGCGTGGTGGTGGGCACCTGTAGTCCCAGCTACTCAGAGAGGCTGAGGCAGGAGAATGGCGTGAACCCGGGAGGCGGAGCTTGCAATGAGCCGAGATCGAGCCACTGCACTCCAGCCTGGGTGACAGAGTGAGACTCCGTCTCAAAAAAAAAAAAAAAAAAAAATTAAAAAAGAGTGGGCTGGGCGCGGTGGCTCACGCCTGTAATCCCAGCACTTTGGGAGGCCGAGGCGGGCGGATCACAAGGTCAGGAGATCGAGACCATCTTGGCTAACACGGTGAAACCCCGTCTCTACTAAAAATACAAAAAATTAGCCGGGCGCGGTGGCGGGCGCCTGTAGTCCCAGCTACTCGGGAGGCTGAGGCAGGAGAATGGTGTGGACCTGGGAGGCGGAGCTTGCAGTGAGCCGAGATTGCGCCACTGCAATCCGGCCTGGGCTAAACAGCGGGACTCCGTCTCAAAAAAAAAAAAAAAAAAAAAAAAAAAAAAAAAAAAAAAAAAAAAAGAGTGTTATTTATTCATGAATACAAAAGGCCATAATCAAGTATGATTAGGAACCGTGGTTAAGGTATAACAGCTGCACAACAAAGGACTTTAAACCCACTTGTTACTCTTCCTCCTAACATATTTGTGTTCGTCCCTAAGGATGAAGCAAAGATGAAAATGTGTACTTTACTATTTATGATATCACTTAGATTCACACTCCATGTTCTGAAAACTTTAACTCTCAGCAGACATAAAATCAGTGAAGATGTAAGATCACAGTACATTTTCTATATCCCTCCAAAACAATTTTTTTGCATCTAGTCCTAGATCTTTCCAAAACAAATATCTTGTAGTAATATGCAGAATCTCGCTACTATCAACATATGGAAAAATAAAATATTTCAATAAAATTCCTAGTTTCCTGAAAGCATTTTAGTTACTTACACCAGAAATATTTTTTCTTTTTTTTTCTTTTTTTTTTTTTTTAG
>TTN-209,,0,1674,2151153,2152826,GTATTATAATTAATCAAAAAGCAGTCTTAACACTTTTTTCTTGGCCAAAACTTTTAAATTCTAAACAGTGGAGGGTGAAGGAAGGGTAAGAGTTTGCAATCACAAAATGGTACCTCTCCCTTCACTCACTTTCGCCCTCGTCTTTGACTCAGTCCTCACTCTCTCAACTCCTTTTTTCCCCCTTTTCTCTTTCCTGTCCTCCTGAGCCCCTGGGAACCAATGACAACACCAGTGTATTCTGGTTATTTCTGGATGAAAATTTAAAGAAGGTCTTGCCCAGAAATCCAACAGCTATTCTTTTTTTTTCTTTTTTATTTTATTGTAAATTGACTATTTACTATTGTGTATATATTTATGGGGTACAAAGTGATGTTATGATCTGTGAATACAATATGGAATAATTAAATCAAGCCAATTAACATATCCATCACCTCAAATACTTAACATTTTTGTGGTGAGAATATTTGAAATTTACTCTTAGCGATTTTGAAATGTACAGTACACTATTATTAACTATATTCACCACTCTGTGCAACAGATCTCAAGAAAAGCCATGTTTCTTCTGTCTAAGATTTTGTACCCTTTGACCAACATTTCCCCATTCCCTCAAATCCCCAGCCTCTGTAACCATCATTCTACTCTTTATGAATTCAACTTTTTTAGTTCCACATCTAAGTGAGAACTTACAGTCTTTGTCTTTCTGTGCCTGGCTTATTTCACTTAGCATAATCTCCAGTTCTATCCATGTTGTCACAAATGACAAAATTCCCTTTTTTTATAAGGCTGAATAGTATTCCATTGTGTATTTATATACCACCTTTTCCTTATGTATTCATCCATTGATGGACACTTAGGGTGTTTCCATAACTTGGTCTTTGTGAATAATGCTGCAATGAACATGGAAGTACCCAACAGCTGGTCTTGATAAAGTCACATCAATGTAAGATCAAGGGTTGCTGCTAATTTTAAGAGGTTGCTGCAACCCACCTCAGTATCTTTCCTGATTTAGGTGATCTAAATATCAATATTTGAAGAAAAAATACTTTATGAAGGAGGATCAATTCAAATCACTTTAACTTTCAATATATCCTCGAAGATTTTTAGGAAAACAGTTGGATAACTAAATTTAAACAAATAGTTTTAACTCATTTGACTAAGATTAGAGTACAGCAACCTCCATAAAGAAGGAAAATATGGAAACACAAGGCATCATTCATCATTCAGACTTTTCTGAGTGGTCATTTGTGAAACATCATGGAATAAGAGGACACTCAAAAAGCATGGATATTTCATGAACTTCATAGTTAATAATTGAAAAAGTCTAATGTGTTATTTTTAGCATTGGACATATTAAACATTCTCTTCATGCTTAATGTTAACTTATTAGAAATCAATCTAAACTAGAACCAATTTAAATGATCTTAAATCAATCTAAACTAGAATCAAACTTTGGCCTTTTGCATGTTTGATTTTTGTTAATATGGCCTTGCATAGCATTTCTAATGAGCTAGATTTGGAAATTATAGAAGCATTATTATGATTCCTGGAAGGGCTGGTGTATGAGTAGTAGTCATAGCTCCTACAAACAACTAACAATGATGTGGAGGATTAGTAAACATTAATAATAATGTAATCTAAAAATAAACACACATTTTTATGTTTTTAAACTCCCAG
>TTN-209,,0,851,2152827,2153677,GTAAATAAAGATAAATTATTTTTATTCTGTTTATTCCTGAGATTTGCACTTCTGCTAACTATTCTTATTTTAAATATTAGGCTTCCAACTTATTGAAAGTTGTGGAGTCTCCTCTGCTGTGTTAAATTTAGCATTAGAAATGATGGCTATTTCATATTGCCCCTTTCCCAGGAAAACAAACCCAGGCAGATGTTTATGCTGCCTCTGTGCAATGGTCTCAGAGAAAGAAGAAGTGAGGGCTAGAAAGGAAGGGCCATTCCTTATTTTTTTATTGTAGTTAACACAAATGTTAAGAGTCATATAAATAATGAGAGCCCTTAAGAACTTTAAAAATCTGTTATCTAAAAGTACCTAATTAACTTGGTTACATAATTTTAAATGTTGTTTTTATGAAACTGACTAAGGGATCATATGCAATAGTCAAAAACCTAGGTTTAAAATTAGAAATGTTTTTGAAATAATAATCAGAACTTTTTAAAAAGGTTAACTGTATAAATATGAAATATAAATTCCATGAACTTATCGAATATTAAAACTATTCCACTGGAAGAAACTAGGGGTTCTGCAAACTGGAGCTCTCATGGAATAATAGAAGGTGTGTCCATTTGATAATATTTATTGAATCCATTTTTTCATACTGGAAAAATCCTCAAATCAAGAGTAGAATGCATCTTGATACTCTACTATGTTCCATAGTCAAAAATTTAAATGGAACCAATACAAAAAAAAAAAACAAATTATCAATAAAATAGATCTGAAATACTGATGTTGTTTAACTAGGTAGATTTTTGTTTAGTGAAGCAGTTGGATGGATAGAATTAATATGCTAATAGTATCTTTATCTATTTTAG
>TTN-209,,0,454,2153678,2154131,GTATGTATAAACTGAATGACTTGTTTCCCTCTTTTCTTCATTTTTGCTCAGTTCATTAAATTTTCAATGCTATGAACCTGATTTGCAGTTTATGTGAAATAGTTAAAATGATCTTAGATTTTTTTAAGGTTAGAAATCTTTTAAAAGTTATTTTCCTCAGAGTTACTTTCATGCTTTGACATTACAAGCTAAATCATTTAGTCTTATTACTAACACTAAATTCCAAGTGCTAATTTCTAATGCAGAAGTTCAAGTTTTACTTTTACTGCCTTGTTGCATCTCTGCTTGATCCTGCTTCAAATCCTAGCACTAAGAATTGTGTTGGTAATAACGATCCCAAATATAATACTTCACACGATTATATATTATCCTTACCTTATCTCATTTGCAATTAACAACCTAAGAGAACTTACCTATTTAAGCATCCCTTCTTATTCCTGTGTTTTTATTTCAG
>TTN-209,,0,441,2154132,2154572,GTAAGTAATTAGAAATATTTAAATAGACTAGAGCATCAACATCATTATCATGGCTTGTTTGGCAGCAATGTATAAATCAGCAGTTCAATCCAATAGGCACAACTTCTTCTCTAAGCTTTATTGTGAATGATTTTTTTTTCTTAAAATTTCTATCTAATTGATTTCATTAAAAAATCAAAAGATGATAAAAATTGTAATGGTAAACTTAAATATAACCAAAATATGTTAAGTACAGAAACTTGTACCCAGAGTTCAAAGTTGTGCGTAAAGGTCAAAGAAAAAAAAACCGAACTCATCTCTCTCTTTAAAAAATGATACATGTATCTGCATATACACTTATAGGTGTGTATAAACACATATACACAGAGAGAGAGAGATAGAGAGAGAGAGAATTTTAATAGGAATTCTAAAAGTACTGCAATTTCTCTAAAATGCTTGCAG
>TTN-209,,0,152,2154573,2154724,GTATTATTTAAAACATTCCTAGCACCCATGTACACAAGTAATATGTTTACTGATCTATACTCACATTAGTTATTTATATAATCAAATACTTTTAAATTTTGTGCAAAGCAATATTCTTCAAAATACAAATATATTTGTACATATTTTTAAAG
>TTN-209,,0,590,2154725,2155314,GTATACATCTTTGTGTTTCAGCTACAAGTTCAAAATTTTTTTATTTATGTGTATGGACATGTGTACATATATTGCTAAGTAACTCACAAATCTGAAACGACCAAAAACAGCACATTTTTACATAATACAAATTTTATGTTGAGTTGCACATATGTTTAATTTAAATAGTAACATTATCTACTTTGTTTCTAGTTCTGCTTAAAAATTACATTTTTTTATTATAAAGAAGGTTTGTGTTTAATTAGTAGTTTGCTAACTTCACTATGCAATGCATTCCATTGCATATAATATTCCCTGTCCTCTTATTTATAGAAATAGACCCTAACAGATTTGGAAAAGCACAACATTGTGTGTGAAGAAGTTGTGTCTATTTGATTCTCATTTAAGAATGTTTGATGAAGGCTGCATGCATTGTTTGTCCCTATAGATCAAAACATGATTTGTTTTCTTGTCAATACTGAATTTGTTCTCAAGCTACCATATTAACCCACTCATTCTGTGTCTAAATACTTGAGTATAAAATCCATGTGTTTGATCTGATGTCTTGTACTAAAAAAAAGGAATACTAATGTGAAATACTCTCTTTAAAG
>TTN-209,,0,232,2155315,2155546,GTATAAGGCAAACTGGAATGTGGGGGCTCAAATGGAAGGGTTTTAGGCAGATTTTTATCCCTCTTGTTGTCTAATTTGTGATCGTGTAGACATTTCTGTCTCCTTGTAAATTCTGTCATCTTTTTCATTTCATGTTTGTCTCTGTTTTCATTTTTATTTTAATGTTCTTTGTAAATTACAATTACCACCCACAACATGGCATATCAGTAATTAAAATGTACATTTTTTTAAG
>TTN-209,,0,1028,2155547,2156574,GTATTAGTAATTCATTCTAAGTTTAAACTCTTTTAATAAAAATTAGTACAAATACCATAGTAAAACATTTATGTTAGTATTAAATAATAGATTTAGTCACAGTGTGCATACCTATAGCCACTATGTACAAAGGATGTGATGGGGGACGGGAAGAACCATGAGGAAGGCACAGGGGGAAAAAAGTGAAAATTATGGGAGGCTCCATTCCCTGCTTCAGAGAGTTTGCAATCTCGTAACCTGTTACTTGGAAATACAGTGTCCTGGAGCCAGTTCATGCTAGCTCACCAGAGCCTATGGTTACATTTTCAGGAATTTTGCCAGTCAGTAGTTTAACACCACCATTATTAAAAATTAGATTATGTAAATTTACAGTCCAATAAAGTATATTTTTAAATATTAATAAATACTCAAAACTCCTATTTTACTGCATTTTGTTCTTATCTGTGTTTCTGAGATTGTTTCCATCTTTGTGTCTGTGTGGTGGAAATGCCATATAATGTACTACTGCACATCTCTTTCCAACTCCAGGACAATGACATCACCTTGACAGCCAGGGTGGGAGGGAGTGTTTATACCACCTTGGAAATCGGAAATCTGCAAGCACTATAGATCAAGGCTCCACCCCCTCCATCCCACCCAAATTGTTAAACATTTAAGACACAAAAAAATCTAATGCAATTGTATTTATGAAACTGCTTTATAAAAGTAAAGGTTACAAAAAAAAAAACTAACTTCATAGTTATCGATGTTCATAAAAAGCTGGTTTCTGAGGAACTGACACAGGCACCTCCGAGGGAGGATTGCTCCTACCTGTTCCTGACAAAGTAGAGGCTTCTGCAGTTAAAGGTGACAGCAGTCACATTTTCTAATTAGCCATTCAGCCATCTTCATTTACTCTCATTTCTAAAGCATAATTTTCTTGCATTCAGTTGGTATAAAAAGGGAATCTCTATTTAATTCTAAGTCTTACAACAACATATGCCTTGTCAAATGCACACTTTCTCAAAAATGGCACTTTTCTTTTAAAG
>TTN-209,,0,397,2156575,2156971,GTAGAATAATATTTGTGAAAAAAATAATTCTTAGCATCCATCTTGTATCTTTTTCTATAAGATCTGTGTATTAACAAAATAGCATCTGTAAACCATCTATAATATATTTAATTCTGTGTATATTGATTTCATTTATTTGTGGTGATGTGTTATACAAGTATTGGTAACATTTCTAAACTCCAGATCACGCTAACTGGGTCTTTGTCTGCTTGTGTAATGTATGTAATGTCTATATGGTGTTGAGGTATTTAGCTTTCATTTCTACCACAAGTAGGCATATTTAAATTACTTCCTAATTCTCACACTGTTAGTGAAGATTTATGCTTTAATGTAATCTTAGATGTCTCAGAAGGTGACTAGAATATTCCACATTATTTCAACAATTGTATCTTTAAAG
>TTN-209,,0,2119,2156972,2159090,GTACGCCAGAGCCAATGATGGGGAGACTCTTTGCTCCAAGTGCCAGCCTTTTGCTTTCTACGATCTTCATATGTACTATGCTGCCTTTGTCTTTTGTCTCTTTTACATTCTTCTTGTGTTTTTACTGTTTGTCAGCTTCCGTGCCATGCTCTTGACATACTTTATTTATTATACTGAATATTCCTAAGACATCACCAAAAAGTATTGTTAAAGGAAGTAACTATGTCAAACTGCTATCTTACATTTTTAATATCTTCCCTCTTTTAGAGAAAGAGGAAATGTTTGTGAAACTTGTTTTCTACTGACATGTTTCTAGGAAAAAACCTTTCATCCTTCATAAATGTAACTTTTTCTTAATAAAAGCAGTTTCATGCATTATGAAGAGGTGGAGACAGGCAATGACAACTGGAGAGTGTCTGGCAGAACTGAATGTTAATTACATAAAGACGTACATAGTACCACGCTTCTTAAAAGTCAATAGTGGCGAGTCTTCAATAGTGGGGAACATACAGATTTTTTGAAGTTTACTTTCACCATTTTCTTGAGACCTTAACTGAGCTTCAGTATTTGCCATAAATGTTTCCGTTATCTAATTAGCTAGTCAAAGTACCTTTCACAGAGGTATGTTTGAATGAAAATGTGCTGCTGTGGTATATCACAAATCCCTTGCTTTGGTTTGTTTGGGATTTTTTTGGCGATAAAAGGCACTATCTTATTGAAGCACTGAAGCTACAATTGCACGCATCCATTCAGTTATAGAGAGACTCAGCAAGAATTCAACATTATCCAATTTAGGAGAAACCAGACCTAACTAAAATAGTACATTTTGAATAGTGTTCCCTTGGCCTGACTTTGCAATGTTTCTATTTTCTTCCTGAATCAAATATGCTTCTCTCTTTCTCAAACTCTTGGCTCTTTCAAAATTCTTTTGATTATCTAACCATTAAATACAAAGGTCATGTTAGTAAAACCAATACTAATACTAAAGCTACTTGAGACAGATCGTCTTAGATAAATTAAATCCATTGTTATTATGTACTACATTTCCCCATACAAAGCATAAAGAACCTTTTCTATATACTATCTGAACATTCTTGACTGTTTGTGTAATCACTAATTCGTTTTCAGCAAAGTCATATATGTCTTCTAAAGGAGACACAGAGGCATCTCTCATTTACTCATAAAAACAAATACACATAGTATAATAGCACGTATATATATATAAATACTGCATGTATATATAGCATAACATATACATATATAAATTAACAGCTATATAATTGCACCAAAATATTACAAATGCACGTGCAGAGGTGCAGGGATTCACAAAAGCTGCCAATATTGTATTTAAAATGAGAACAATTATTGCCAATAATGCATGCTGTTAAAATTCATCTTCCAATTAAAAAGTCAACATTATCCATTCTTAGAATAGATAAATCAAATACACTGTAAACATTTTTTAGGTTGAAAACCCTGTTCAAAACTCTAGAGCCCCTTAGAAAAAAAAAGCACAAATACACATACCCACAAAATTCTGCACACAAAGCTCTGTAAAGTCATTAACACATGGGTATCAGATTGAGAGACCTACTCTAGAGTGTTTCCTGAGTTTTGAATTCACTACAGGCACACCCCCCAAAAATGAGAGGAGAAATGTGGGGAAGAGAAGTAAGTTACACATATTCAACTATTCTAAGACTTCTTAGTCTTAGTCTAAAATAGTCTTAGATAAACTAAAGCCATTGTTATTAAGTACTCCATTTCTCAATACAAAGCGTAAAGAAGTTTTCTATATACCATATCCACATTCTTGATTGTTTGTGTCATCACTAATTTGTTTTTAGCAAGGTCATACAATATATAAAGGATGAATTCTGTGCACAACTTTGTTACATAACTCATTTTTGCCTAAATGCCTCTAAAACATTATTTGTGATATTTATCACATTGTGATCCTTGGAATAGTATAGTTAGTTTAATTTTCTGGATAATTTTGCTGATGCATAGATAATCCATAACAACATTAATGTACTACATAAAGATTTGTGCATGTGCCTATGTTCTTTCATAAAAGTGATATATGTCTGAACTAACATTGTGTTTCAAAAACTTTAAG
>TTN-209,,0,217,2159091,2159307,GTACAGTGGCTTTCGACGTAAAGCCCTATCTTTTATCTTTGATACAAAATATGTTGTGTTTAATTATCTGTTCATTGAGTTAGTTTAATTCTAAATGAATGTTTTGTGGTGAGAACTGAACAAAAGTGTCTGTCCACCCGTCTGCTTTCTTAAAAAAAATAACTGTGCATAGCTACTTTAGAAAATATAAAGTCAATTCTAAAAATGTCTCTTCAAG
>TTN-209,,0,141,2159308,2159448,GTACTTAATCCCATCTCCATGAAATAACCTTGTCTTTCCTTCAAGCCTCTTTAATTGCATGTCTTCTTTAATTGCCACTTCTATGTTGCTCATTTATTTGGCCTTTTTGACAAATTTTAAAATTCAATACTATCCTTTAAG
>TTN-209,,0,153,2159449,2159601,GTATTGTTTCTCCATCTTCCCAAGAACTGTCTTTATGTTCCAGTGATTTTGTTAGTTTTGTGATATGAGTGCACTGTGGGTGTATTTCTTTGTTTTGCACTGGGCTTCAATGAGATCACATTAAATTTCTAAAAGTGCATAATGTCTCTAAAG
>TTN-209,,0,274,2159602,2159875,GTAGGATTTGCCTCAATCCTCTGACAAAAAAAAAAAAAAAAAAAAAAAATCTTCGAGTGTGTTAAATTCTTGCTTTTTCCATCTGGTCTGTGCTTATACTGATCCATTGTCTCACTTGCAGTGAAACTTTTGTGTTTATGTCCTTGTGATATGTAACTTGTTTTCCCATTTTGCTAGTCAAAGTGGTGTACTGTGCAACTCTTCCCCAAATTCTAGAAAGTGAGAATTGTTAAAATTCTTGATTTTAAACTTCAACTTTAACACTTTCTTAAAG
>TTN-209,,0,452,2159876,2160327,GTATATAATCGGAAGTCAGGGGATAAATGAGTTTGTGTGTGTTTCCTCAAAGTCTCTTCTTCTTCCACATGTGATTGTTTACTTTAGAACATGTCCTCATCAGTTATTTCTCCTTATGTTGGTATTAGAATGTGTCTACCTTTTGTAGCCTTCTGGGACTGAGTCTTTTGTGTCTATGTTGGCCTTGAATCATTCGAAGGAAGTGGATGAGTCCCGAAAATGTTATAATTTTGAAAGTGGCCACACTTGGACATAACTCAAGTATCATTCTCAGTCTTGGGCTGTACTTGCCCTCATCTTAAATTAGCTTCCTCCTTCTTATAGTGAGGAAGTACCATGAAGCTATGTCCTAAGCAGATAGAAGAACAGTTATCCATCTGTAGTGACCACATGGCTGTATATACATCTGTATCTCAGCAGGCTGAATTTAAATGAAACCTTATCTTTTAAAG
>TTN-209,,0,2512,2160328,2162839,GTAAACAATGCAAATAAGCTAGAGATGATCTGGGGTTTTGATGAGGTGTTTTCTTTCACAAATTGTCTACAGACCAATGAAAAGAGACAGAAAAAAGTGACACAAATTCAGTGAACATCTACCAGTCTCATTAAATGAATATTTTGATCAAAACACAAGATTCAGGAGGATTATACTAGATTAGAGAAATCCAGTGTATTTCTTCTGCATCCCTTCTTACTTGCCTACATAGAATAAAAGAGGCTTCATATTTATATATAATTAATCAGGGCAGGTATCTCCATATACATATATCCTTTCATTAAACAGGACTTGGCTTCAGCATGGTGGGCTGGCATAAGCTTTACCTTAGTAGCCTAATGCCTAATTGGTGTTTCTCAAACATTGCTTGTACCACAATCCACAGACAGAAATATATTTTATATTATAATCCTTTAATTTTTTTATTCTAGGCATTTAAAAAATACAAGTTATAATCCATTAAGTCAATTGCAGAAGTCACTATAATGTCTTAAAATGTTTTAAAATGAGCAAGAAAATATATTACCTCATTACATTCCAGGAGTCAATGCCATATTTGTGAGTCTGAAGCCCTGAACACATAAGGCTTTCCTGTATTTTACATATGGAGAAAACCATTGTGTTATATATGGGATCAGACTGACTTGTTACTCAGATCTTTTCATACCTATAATGCTAATTATCTATAGTTTCTTAAGGACAGAACCAACAAACTATTCCATTGGGATATTTTTTCAATGAATTAAGGCAGCACCAGGTTTCCAACTAAAATCCAGCATTCTGGCTAGAGCCATGTGGCCAAAAGAACTTTCCTAAGAAAGTTCCTAAGGTCTGCTTTTAAAGAGAAATCAATAAGCTCCTTAACCAAACTAACTCTCTCCCCAGTGAGAAGATGAGTAGAATTGAAGTACATTTAGATGTCCCAAGTATCTGTTTTTATCTGTCTAATAAAAGATGGCACACCATGCCCCTTTTTTCACTTGGAACAAAAGCCCATGTAAAAATCCAAGGTGCCATAGTCTTAGTGGAATGCCTTGGAATAGGCCAAGATGGGACATGACTCCCAGGAGGAAATCCATTAACTCTGTTGTGCTTCCTGGAAGAGGCCATGATGGTGGACATAAGTCAGGAAGCTGGTAGATTTGAAGACGACTCCATCTTTTCTAAAAGTGTTTGTAAAACCAAACATAGTCTGATTTCAACTTTTGACACTATAAACTTCCTGTAGTACTCCAGACTCTAGTTAAAAGGAGAAACACTGTGATTATTTTTATGTTCTCATTATGCCCCAAAGATGGGTGGCTTGTTAGGTTTACTTTCAGCGTAAGGAGCAGATATGTTTTTAACCAGACACTTCTATTCCTTATTTAACTTTGACCAGGCATGGTGGCTCATGCCTATAATCCCAGTGCTTTGGGAGGCTGAGAAGGGAGGATTGCTTGAGCACAGGAGTTCAAGACCAGCCTATGCAACATAGCAAGCCCCATTCTACAAAAATTAAAAAAACAGCTAGGCATGGTGGCATGCACCTCTAGTCCCAGCTACTCAGGAGGCTGATGCAGGAGGATCATTTGAACCCAGGAGTTCGAGGTTACAGTGAGCTGTGATTACACCACTGCATTTTAGCCTGGGCAACAAAGCAAGACATTGTCTTAAAAAAAATTAAAACTGGCCGGGCGCGGTGGCTCACGCCTGTAATCCCAGCACTTTGGGAGGCCGAGGCGGGTGGATCACGAGGTCAGGAGATCGAGACCATCCCGGCTAAAACGGTGAAACCCCGTCTCTACTAAAAATACAAAAAATTAGCCGGGCGTAGTGGCGGGCGCCTGTAGTCCCAGCTACTTGGGAGGCTGAGGCAGGAGAATGGCGTGAACCCGGGAGGCGGAGCTTGCAGTGAGCCGAGATCCCGCCACTGCACTCCAGCCTGGGCGACAGAGCGAGACTCCGTCTCAAAAAAAAAAAAAAAAAAAAAAAAATTAAAACTGTATACACTTAGGCTCAAAAATCATGTGAAGCCTCCTGCCTCTTCTACCATACCTGCCCCACAAAACTGGCGGGGAAAACAATATGGAATATTATCTTACAATTCACTTAAATCCTCAAGTATGTTTCTGCCCTGTGGCCTTCAAATCTACAGTGCTCTGCTATTTGTGAAACTCATCTTCAAATTCTTCTGTTCTTATTAACTCAGCTATTATAATCGTTTCTTGTCCCGTACTTGTCCTGTCGTTGCTGTGGATATAAGCATTATTATCTGTATGACACATTTGAAAATTAAGTTAATGAAACCTATTTCCCATTTCCCATACTCTTCATTAACGCATGTGCTTTGATTAAAATGCTCTTTGAGTATTTTAAATAGGAACAAGCAGGGGTTTGGCAAGGGTTAAACTTTTGCTATTTTGATTACTCTTTGAAGTGATAAATTAAAGCTAAAAATAAACATGAAAAACACTGTAATTTATCTTCTTTAAAACTGCTGTCTTTAAAG
>TTN-209,,0,187,2162840,2163026,GTATGCTGACTCTTTAATTAGTTTTATCCCTATGTTAGCTTGTCTCCTTCTTTATGTTTCCTTATAGCTAATTTGTCATCCATATTGCAAATATTGATAAATATCATGTCTAATAAAAAGATCCCTTACACTTTTATCGAAAAGAAATCTAGACATTTCTACAAACATATTTTATAATCTTTTCAAG
>TTN-209,,0,263,2163027,2163289,GTATGATTTCTTTCAAAGAAATGCAACACTATTTATTTTAATGTATATAATAATACCTTCACATTTGCATAACTGTCTTATGCATAACAATTTGCATAACTGTCTACGTTTTGTCAGAACACATGTATGAACGTATTTACTGAGTATAGTCATTAACGTTTGTATATATGTGCAATCTTTTCAAAAAGTGAATGCTAAGCCCCACAACTGTGTCACTTCATATGTAAGGCAAACTCATATTCTTAAACCTAATCTTTCTAAAG
>TTN-209,,0,156,2163290,2163445,GTATATTGGATTTTATTTTATTCTCAAGACTGTCTTTTTTTAATCTTAAATTGATACATTCTTCAGATTTTTTAAACATTAACCAGAAAATAAGTGTGCCTGTGTTTAGTGTTTTCCATATCGTATGTTTGATGGTATTGCCTGGTATCTTTTAAG
>TTN-209,,0,252,2163446,2163697,GTAAACAAACCTCCCCAGCAGAAAAACTAGGAACATATGGCTTGTCTTTCTTTCTCTCTGCTGCTGTTCTTTGGGTCATACTGTTTATATGTTGGTGGGTGACAATGGTGTCTTTGGGTAGAGTATTACTTGTGATGTTTTTGTGTGTGTGCCTTGTAAATTCTTCTATTCTAAAATCACAGTACTTTCTGGCTAGTATATTTTTTACGTCCACTTTGATATAACTCCCTAATCCTAAAATTATCTTTTAAG
>TTN-209,,0,247,2163698,2163944,GTACATCCGCCCTTCCATTATGCACAATATTGTACTTGCCCTACTCTCTTTACCAAATACACTGGTTATGGGGGCTGGTTTTTGTTGTTGTTGTTGTTGTTGATGTTGTTGTTGTTGTTACAGTTGTTGTTTTATGTTTGAAATAATGAAAATGTCAAGTGTTTATGTTTGGGCTACTACTTTATGGCTGCCTTTTTGTGGTTTGAAAGAGGGAAACAATACTTTAAAGTGAAATCTCTCTTTAAAG
>TTN-209,,0,707,2163945,2164651,GTATACTGACTCTTAAAAAAAAAAAAAAAATCAAAATAAGCATCCAGACACTAAAACTAATCTAGTGGAATAGGTTCCATTAGAAAAAAAAAGACATAGTATAAAGTAAGCAATATAAGTTTGTTAATGCATATCACTTCAAAACTAAACATTTTTGATAACAGAAAGTACTTTTTTCTTAAAAAAAAGTGAGGCTTCTTCTAAACGTATGTGAATAATTTTCCTTAATCTGTATTTGTCTTCTAATGTCTTTTCCATATACTAAACTCATCTGCCTAGATGCTTGCTTTATGTGGCAATCTCTGATGAAATTTTTAATTTTTTCAATTCTGAATTTTCTACATTGTACCAATAGAGCTAAGGAAAATGTCTTAGAAGTGAGGTGAAGAAACTATTCATGTAACATAGGTTTCTGTCTAATGCTTCTACTTAGTTTGATAGTCATTATTTATGCTGTTTAGTTGTCTTTTTAAACTTTTATAAATACTACTTGATTTTCCTAAAATTATTCAATGTCTTTGACGTACTTCATATGTATATTAGAGTAAGTTTATTTCCAAGTCTATTGATTTTCTTGCTTTTTAAATGAAAGTTTAATCAGGCACTGTTATGGTTGTCTTTGTCCTTGAATTGTTTGAACAAAATTTCTCTTCACACACACATTTTCAGAATCTTGCAATTCACTTTTAATAATTACTCCTTTAAAG
>TTN-209,,0,307,2164652,2164958,GTATATTGAACTTTGATTAAGTAATGTGAGGCATGAAACTATCTGGCTCTTTGCCTTCTAGTTCCCAATCTGACTCCTATACTTTATTAGCTTATTGTTGATTAAGGGCAGGGTATATAACATTTGAAATCACAATTGCTAAATATACTCTATGATACCTTGACTGGCCAAAAAAGAACAGTCAGGGTCTCCCATAATCAGTGCATGAAACAAACGCAAAAGAATAAAATCAAAGCACATTGTTACTATCAGTCATCCTTAAAAGTGCTTTAAAGTAAAGTGCTGCCTGTTGTTAATATTGTTTCAG
>TTN-209,,0,958,2164959,2165916,GTATGAGCAAAACTGCAAACTCAAAACCACACTAAATATGTGCACACTCAAACAAGATAAAACAAGATAAATCATAACAAGATAAAAATTTGGATACCCAAAGAAATTTGGAAAGAACTTTGTTTCATTTCGCAAATGCGGAATTTTCTTCTTTGATAACTTCTAGAAAAAATTTTAAAAACCCTCTATAAATCTTAAGGTTATTGTTAGACTTTTGTTCCGGGAATAATCTAATACCCCCCTCATTTTTGCTCGTATGCAAAATAGCAAATGTCCCTAAGTTTCTTTTTCAAAAAGGTTACAAGTTTATCTTCAAGTGCCCGTGATCATTCTAGTACATGGTTAAAAATTTCTGAACATCCTTTATTCTAAAACTTGCTATTACGGAGTATGATAGGCTATTGAGAAAATGTATTTACCCACAGGGTTCCCATTATCAAAACTTGACAATGACTGCTTCAAAAGTTAAGATAGAGATGTAAGCTAACACAAGCTGTTGTGTTTTACCTAATGAAGGTCAAATTTGTTGGCATATAGTTTGGGCTTCAAATTGTTTATTTTACTCAAAGAATAAATCTCTATTGAAATTTTGAAATGAATCAATCTTATTTCACTTATTCAGTCTCTGATGTTTCATAGCCCAACTTTGAGAACATTCTACATAGTCTTACTGATAGCTTTAAAAAAACCATATTATAGGGGAGTTTCAGCCAGGAATTTATCTACCTGAAATGAAATGAGAATTTTAATATGTAAGAATTACCTAATTAAAGAAAATAGCAAGAAGGAAAGGGCAATATGAGCTTGTTCTGCTTGGATCTCTGATTCTTGCCTACTTCAATAGGCTATGGCTATACTGTAGATAAAAGATATTATTTCAATTATTTGATTCCTTTTAAGAAATGTTTAAACTTATATTCTAAGTCTAACATGAAATACCTTGTATGTACTTTTAAAG
>TTN-209,,0,210,2165917,2166126,GTAGAGTGAAAAAAACATTATTACCTGTAAGAGATCTTTGTTTCCTCCATGTCTGTCCTACTATAAAAATATATGTAAAAGTGGCAGTGTACAAATTATGTGTGTGTTTGGGAATATTATGTTGTATTTGTCTTTCTTAACTTTTTGTTCTTGCTAGCCTTGAGAAACCTGTTTCAATTTTTAAAATCTCTTAATATTGATATTTTGAAG
>TTN-209,,0,204,2166127,2166330,GTACATTACTGAGTAATAATCACCAAAAACAACTTTGTTATGTATGTTCTAAAATCATGTCTTCCTAGCCCGTCTGATGGTCTGTGTTTTTGCTGAGTAGGATGTTCTTGTCCTGATTCTTACATTTCAGTTTTTTATGTGTATTTATTACATAGTATTCAAGGAGTTGGTTTTAATGCTCTTTAATAATTAATATCTTTAAAG
>TTN-209,,0,747,2166331,2167077,GTATAATGATTTCCTTCCTCGATTGTGATCTTTTCTGATGCCTCTTTTGAAATTAATGTAACTATGATTCATTTCATTTTGTTGTTTCATGTCTTTTAAATTAGTTGTCAGCAGAATGTTGGATGTAAAAATGTGTAAATACAGGATAAGAAGATAATGCCTTTAAAAGGAAAAATTATTTCTAAATACATCCATAGCCTGTTAGCCAGTGGCTGTGTCCTGCCACATGGCTACAATACATATAAAATAGAATGTTTGGGTTTAAAATCAGTGACCGTTTGGCATATTCCTGATTTACCTAAATGATGTAATGATACCATAATATTCACCAAGCTTTGGTAACTGTTTATTCATTCTAAATTCATTTTGAAGATTTTTTTTAAAGCTAACCAGTTTCCAGTCATTTTCCCCCTGATTCATACTAAGTATGAAGTATACTAATTGAGAAGTAAATTTCACTTTTCAGGAAGGATATTTCTTTCAAGCAGAGATATTTGAACACTAAACCTCATTTCACATTTGGGCTCTGCTACTTCATGTTTACTTGGGTACTTCTGTGTACTTGTATTTATATGAAGCTCAGAATCCTTTCCACAGAGAGTATATAGTTTCTTAAAGATGAACAATCGCATATGTATCTCATTAAAGGAAGATACATTATTCTATCTGCTTAAAGTACAGCAAAACAAGCATTGGCTGGGTGGCCTTTTACTGACAATAAAATTTCCTTATACTTCATATTTCAAG
>TTN-209,,0,198,2167078,2167275,GTACCTAATGGCACTCATTTTAATGTTTTGTTCGTCTTTTGCTGTTGAATTCCTCTTCAGTTCTGTGTGTGAAAACTTCTTTTGTGGGAAAAGTAAATCTTGTCCTTTCTTCTGTTATAAATGGGCCTGTGTTTCTAAGGTGTCTTAATTTTGTTGAGTCATTGGCAAATGTCCAACTTAAAGATAATATCTTTAAAG
>TTN-209,,0,211,2167276,2167486,GTAGATGATGCCTCCTGCAAAGGGCTGTGCAACAGCATCTTTGGAGTTTGGGGGTCTGATTTGGTCAGATTCTGGGGGTTATTGGCAGCACCAATGATTGCTTACTTTAAAGCAGATATTTTTAGATGCTGAAATATGATTTCTACAGGTGCTTTTCACATTTTATTTCTTTCCTGCAAAATTTCCAACATTCTTAATAATATCTTTAAAG
>TTN-209,,0,182,2167487,2167668,GTACACCACCATTCATTGACGGGTATCTAAGAGACTTCATCTGCCTAGAAATAGTTAACTTTCTTCTGAGTTCAAAACCTTGTGTGTGTGTCACTGTCCGTTGTTAAAAAACATTAGCTGTGTTTTATATGGATGTGTTGTTACTAGTAGTTAGAACTTAACAATAAACAATATCTTTAAAG
>TTN-209,,0,508,2167669,2168176,GTACATCCTTATAATCCATCAGTGGAATAGCATGATAATTCACCCATGCAGCATAACTTGGTGAGCCATAGCAGATCTTTCCCCATGACAATATTAACAACATTAATGCCATGACAAGCGCCTCTCAACTGGCCACAGGAGCAGTTTACCCGGTATTCATCTCTGAATTTTACCATCAAATTATGCTTATGCTCAATGGTTGGCTCCTCCTCTTTAGTGGAAAGTTCTTCAAGTAAAATACATTCCTTTTGCATATCAAAATGGACAAAACCATCATTTACCAGGCATTGTGTCTTGTCTTTATCACCAGTCCACGTTTTTTTCGGTGTTTTTTATTTTAATTTTTGTGTATTTTCTGGCCTTTGTTTTGTGGCTATTATAATTTTCAGTCTTAAAGTGAAATTGATAGAATATCTATGCTGCTTCAGTTAAGGCCTTACATTGCCAGCCTTAAAATCTTAGCTATGGGTAAAAAATGTGACACTAACTCTATTTGATATCTTTGAAG
>TTN-209,,0,249,2168177,2168425,GTACATGAACTTGCAATGTTGCAATATTTTTATTTCACATTTGCATATGGGTAAAAATTAATTGGTTTAATTCTGTACTCTTTGGGATGCAACTCTTTAGAGAAAATTAAATATTTTATTTTAAAAATAAAATGCTTCTTGGAATACCTTTGTCATACTTTTATTACCTTATCTTAATCTTTTGAAACTATGCTTGGAATCAGTATTTTTATGTCGTATAAAATTTTTCTCTAAATCATTTCGTTAAAG
>TTN-209,,0,205,2168426,2168630,GTACATAATTTCATCACTTAGAGTACTTGGGGGAAAAAACTCACATCTATGTATACTCACATACAAATTTCCCCATTACATTGTACATTTTTAAAGTGTCTATCTGGTTAGAAATATGTCAGATATTTTGTGATTCTTTTTCATATCTATTGCTCTAAGACATTTTAAAAGAACATATTCCTAAATATAAATAATATCTTTAAAG
>TTN-209,,0,207,2168631,2168837,GTACATTAATCTGTAACAGAGCCATGGTAAAAGACAAAACTAACTGGTGTTATACAGCCTTACTAATTATAATTAATGCTTAGTATTTATGTTGATAATAATTGATGCTTTGTGATCACAGAATATTTGCCTTTCATAAGCTTCTTCATTGTTGTGAATATTTTACATAAAAGTGATGTTTGTACCCTTGAATAAATATCTTTAAAG
>TTN-209,,0,333,2168838,2169170,GTATAGCAGCTCTTCTTGGAATCATCAAGGCCTCTTTTGTGTTGAATTCTGCTTTCCCATCCTTTTGTTCATCTCCAGTTTTATCTATAATCCTTTACCCTCTGTGATTGACCACCTAAATCTTAGAAAACATTCCAGACATGTGTGTTCTTATTGTGTATCTGCCTTGTGTATCTGTCTATTGTAAATTATCTAAATGTCTTTTCAAATCACATATTATGTTTACATGTTTGTGGTCTTATCCTCACGTGTCTCTTTCATATATATATATATATATATATATATGACCATGTATATGTGGTTTTTAATGCCTTCAAATGAAATGTTTTTAAG
>TTN-209,,0,1205,2169171,2170375,GTACACCTCCCCAAAGTGAATACACATTGTTCACCCATAGCTTGGTCACATAAATTATGATGAAACTGGGTTTTAGGAAAATTATATTTACAAAATGGATAATCACACAGTTACATATTTACTTCTAACGATGTTCAGGAACACTGATATCTACTTTTTTCACTGATACAAAGCAGTATTCAAGAACAAAGATGAAAGGAAGCATTGTCCCAGAACTGATACAAAAGTTCTGATTTCATATCATTTGATTAAACATCATAGTTTTCATGGAGATATATTTAAATATATATGAATAAGTATACTATATATTTAAATGTATTGAAAACTATTATGAATAAATATTCTTAAATTTCTTCCTTCAACCATTTATATTAAATGCCTTTTTAACACCAGGCTAAAAAGAAAAAAAGATGAATGTATTTATCAAAACACAGAATAATAGTTATGTCTTCTAATACATATATATAAAGGGCAGCCCAACAGGTTTTGATTTTAGCGTTGACTTTACACCTTGTTGTATTACTCTCAGCGAGTCCTTTAACCAACCTGAGCCTGAAGTTATTTTCCTGTAAATTGGGGATGCTAATATCAGTCTTAATGGGCTCAGCTATTATGGTGAGAATTAAATAAAGTAAGGTATTAAAGTAGTCTATCATTGAATGAATAGTATCCAGATTTAACATATTCAATCAGCTCATAGTACAGGACAGAATTAATATATTTGTGCTTTAAAGCTCAATAATATTTTCTACAAAAGATGCTGGCATGGCTGCTTAAAATCAGCATAACCCTCGCATCAGGCCATATAGTTATATAATCAAATGAAATAGTAAAGCTGATCTTTTATTGGATATCAACGATTCAGAAATACTTTCTAGACAATAAATTACTAGTGAAATTTAAATGTATGAAATGATATTAGGTTGGTGCAAAAGTAATTGCGGTTTTTAGCATTAAAAGTAATGTCAAAACCGCAATTATTTTTGCACCACCCTAATAGCATCTGTCCTCTGATAATGACATATGCTGCTGGTCCCTTGCTTTACAAATCCCAATTACATTATAATATCTGGGCTCCCAACTAACATGACAGACCTGTCTTGAGCGACTGTTAACACATTGGTCTTTCTGGGTGTGGGGTCTTCTTGGTTTCTCTTTTTTTGTCCTTCAAAATAAATCCTTATCATGAAATGATGTCTTTAAAG
>TTN-209,,0,166,2170376,2170541,GTATTGCTATTCCGAAGTAAATTAGACTATGCCATTTCCTTCCTTCTCCTATAAAAGTCAAAATGTCCTGTTTCCGTATTTGTTAATACAACTTATATTACTGCTGTGTCTACTTGTCTTTGTGTGTGTGAAACTGAACTTATAAAATAAAATAATATTTTTAAAG
>TTN-209,,0,557,2170542,2171098,GTACATCATCCCATAACAGGGATATGTTTGCTGCACCGATGTTGAACTGTGGTTCTATCCACACAGGACACTCAACATAAATGTGTGCATTGTATGGTCTGTCATTCACATTCGTCATTTCTGACTCTTTTGCACCCAAGTTTGTGTTGTGTCCATTTTTTCACTTGGTGTTGGTGTGCTTTACATCGTTTCTCTATGTATGTTGTTTCTAAAAAATAAAAATATATCTTTAAAGAGCCAAAAATAACTAAGGAACTAGTCCCTGAAATACCCATTTCTTCATACCCATTTCTTCCTACAAAAAAAAAAAAGACAAAAGAAAAAAGAAATAGAGGCTCCAGCAGTAAAAAGTAGAATTTCTCTTTAATAAACCCTAAATCTTAAACCACAAACCTTTTTATTCTTTTCTCATTAACCGATTCTGTGAAATGTCAATGTTTCATCTTGTGTATGTGCCTTGTGATATTTACTCTCTTATGTTGGAAACTGGAAACGTGGTCTTTATTCTTCTTTGGTTCTTGCATTTTAAGTGTCTAAAATAATCAATGTCTCTCAAG
>TTN-209,,0,629,2171099,2171727,GTAGATAACTTTCTAAGAAAATAACATTTCAAAGTCATCCTTGTCTTATTATTGTCTAATATTTGAAGTAGGTAAATGTAAAATTTACCCCAGGAAATCAACATATTCAGATTCTAAAATAAATTATTATTAACCTAATAGAAATTGGGCAGGCAAATTAATATTATTTGAATCTCTTTGCATGTTCAGCCTGTTTGTCTGTTTGCTATTTGTTTTATTTTAATTAGAATTCATGAAGGGAAACTGTATTTGCTGTGGGAAATTTTTCATCAAATGACTTAGTAGGCAACTGTAAAATAAGCTTATCCAAGAGAAATTCCAGTTAAGCCTGAGTAACTGGTGCAGAAAATCTGATTTCTACCCCAAGTGGCTGTTTGACTTCAAACAAGTCTTTCATTAAAAAAAAAACAATAATAATTTTTTTATTATTATAAATTATCTGAAGTCCTTTCCAGTTCACAAATGCTGGGATATGCCTAACATATTTTGAAGACCCAGTAGAGATTTTTTAAGGACTAGTGAGTTTACACAAGCGTTTCGAAGGCTGAGCAGTTTTCAGATATTATCACTGTAGTCTAATATTCAAAATAATTATAAAAATAATTTACAAAATAATAATCTTTTTAAAG
>TTN-209,,0,603,2171728,2172330,GTATAACCGCTTTTAAGGATTGAACATTTAAAATTCCTGGTGTTCCAAATCTTTCTCAGTAGCTAAATCTAAGATTCACCAGTATGCTTTTCTTATATCGTATCCATGATAAAGTGAAGATTAATTATTCCTGGCACCTGAATCTATGTGTCCTTTTTTTACCCTAAATTTTTCTACAACATCTGCAATACAACTAAGAATGAGAGATTACTATTTTGTTATTGGCGATTGAATTTTTTTCTGACCAGGCCCTACTATAATAGTTTCTCCTAGATTTCAATCCTTAATTTTGTTTTTAATATTAATATGGGGGGAATCTATTTCTCTGGTGAAAGTGTTCATTTTTTAAGAAAAATCTTTAATTTACTATTCCTGAAGAGTGTGATAATATTTTGCATAATTGGTATTACATTTGCTTATAGGATTTCTAAGTAATATCCTTTACACCTCTAGGGTTCCTACTCCACATTTATTATTACCATTTAGGTTGCTAATATCTTTTAAAAATAAGTCAATGTTTTGTGATATTTATTTATTGGTATATGGGTGGTGTTCTGCTCATCACATGCCACTTTTCAAAATGTTCATAAAATTTCTTTTAAG
>TTN-209,,0,929,2172331,2173259,GTATATCAAATCCTCATTATTAATATCTTTAACTTCCCATTAATTTTCTTTCTTAAAAGCAACATTTTCTTTTTTGACTGCCTTCTTATAATCATTTAGATAGTGAACTGATTAAGGACCAGTAAAAATATAACTCATTCCATTTCTTTAATCTTTTCTAGGATGTTAACGAATAATTGTGTGCATGTGTTTACGTATGAATTATTCTAGAAGCTTCTTAACTGAGAATTTTAATATATTAGTATGTCTCTATATACTTATACACATAGCAATGGATCCCTCTTCCCCACATTTTAGATTTTATTCCATAAGTGGAACGGAGTTTTCTTCTGTGTTATAATAATTATTTTACTATATTTATTATTTTATGGAACAAACCTAATGCTTGGATAATAACTATTTTAAAGAGCCTCACGTCCCTTTTGTAATGTTTAGCCCAAGCATTCAAGGTTATTACAAAATGTCTACTTTTCCCTGCTTCCTAATTCACTTAATGCTTCAGACAGTGCTCTTAAGCAGTTAGATTATGCTGTCCCTGTCATAGTAGACTCCTCAGCTAATAGAAGAGTGCACAGCAGAAAGTGAGGCCAGTGTCAGGGCTTAAATACTCTACAATGGTAATCACTTCAAAAAAGTCTTCATCAAGTTAAAAATAGTAAAAGTGAGTCCATATTGGTAATCCCTGTTATTAAAAGAAAAAAAAAAGAATGGCACAGGTACTTTGTGGACATTTCTTCTTCTATAGGAATGTTAGAACAAATGAGTGATTTGAGAAAGTATCTTTATTGCCTCTAAAATGGATGTCCCACAGTACAGAGTGACTTCTGAAAAACTTTAATTATTGTAATGTTGGCGTTGTCTCTGGTGTTTTTATTTCATGTGTGTTATTGAACATTCTCAGCTAACTAAAACACCTAATATCTTTAAAG
>TTN-209,,0,153,2173260,2173412,GTACATCTTCTCTTTTAAACCTGACTTCCTCTTCTGTCTTTTTTCGTTAAGACTTTTATGTTTCATGTCTCTGTGTCTTGATTGTTTTTGATGATTTTTGTCTATGAAAGCTTGCTCTCGACAGTCCTAAATATTAAAACTGTATCTTTAAAG
>TTN-209,,0,139,2173413,2173551,GTATTTTTGGAAAGATCCTGGATTTTCGTGTATTGTTGCATGCAATCCTTTATTCAGTTTTAAAAATATATATTTTGAATGTACATCTTTATTTCTTCAGTGTTTAAAAAAATAAGTCTTAAAATAGATGCTCTTTCAG
>TTN-209,,0,800,2173552,2174351,GTATAGGGAATTCTTCAAATACTACAAATTCTTATATCTTGCTCTAACTTTCCTTTGAAAGTAAATTTTGTGTTCAGTTTGGAAGATTAGAAACCCCATGAAATACTTTAAACATGAGTTTAAACTAGTTGACACAAAGATTAATATCTCTTAACCACACGGAGTATAATTTTAGTAGATGATAGTAATATTTGATATCTACTTATCTAAGGAGGTCACTGTATGAATTTGGGGATTATTTTTTAAATCTGACTAAGAATGTTACACAATTGTTACAGGTACCAAAATAACTGACCAGTGTCATTGGTTAAGTGAAAAAGAAACTCCTCAGTTCACTGAGGAATTTACATGTTCAGGCAAAATAATCACTGCTTTAACATTTTAGTCAACTGTTCACAAACTGAGAAATACTTACCAAAAGCTTTTGCCAGTTTATGATACTTTCATTAGAGAAACAACATTAAGGAAGTGAAGTATTGTTAATGGCACCTGTATTCTAGCATACTGTGAAGACAAGCCATAGCACAAATAAGTTATCTGCAATACCACTCTAGATCTTGCACAAATTAACAATATATGTGTAATATGAAGGAATGTGTGTGTGTGTGTGTTTAGCATATATAGCAAATTACAATATACATGATATTTAGCAAATCAAATCTCTTTTGGAAATAAGTGTGTTATAAATTAAAAAAATATAGATAAAGAATTTTGTGACCCCTCATTGTACTAACGTTAGTAGTAGTGCTCCAAAATACTTCAAGAGTTCATTCTAAACCAAAATACTAATATCTTTGAAG
>TTN-209,,0,794,2174352,2175145,GTATCTTCTTTGTGAAAAATTACTACTTAACTTTACATACAATAGCACCTTGGTTGCTTTATAAGCACAAGTTTGCATTCCACTTGATGTCTTTCTTCTGTATTTCTTGTTTCTGACATGTCTAAAACAAACTAATATCTTTAAAGCAGCTGAGGGTCCAAGGGAAGTTCTACCAAAAAAAGACAGTCACTGTTGTTATACCTAAAACAACCAAAGCAAATATCTCTAGTAACCAAATAGTGAGCCCAAATTTCCTCCTTTGGTGCTATTTGGTTATATATTCACTAACATGCTTACTGATAAACACATGTTTTTCTATTTATTATTAATTATATTAACCTGGCAAATATAAATACATAGTGAATATGTGTTTAATGTTCTTGCTTTGTTCATTTTTGCAAATCTCTTAAATTTCACAATAGAAATAAAAACAGTATCTAATAAATAATATAAACTTATTTCTTTAAAGTCTCTGAAGCATGTGCGTAAGTTATCACTGAAGAGAAGGTAGCAACTCTTCCACAAAAACAAACAGTAATAGCACCAGCTGAAGGTGTACTGTTAATTTTTCTTCTCAAGTTCTTACCATTCTAACATGGGAAATTTCCCTGGATTTTTGTTATTATATATTTTTTAAATTCAATGCATTTGAAATACTGTAATGTATTTGATAAAGTGTTGTCTGCATTTTATATTGTTGCTGTGTTCTGTTCTGTGTTTATATCTCTCATGCTCTGCTTGTTAAAAAATTGTATATTTAAAAATAAAAGAAATTATTACTATTATCTTTAAAG
>TTN-209,,0,542,2175146,2175687,GTAACTGGCTTTTCTCATTCATCATTAATATAAAATCCTTTTTTATTCACTTACTATGTAAGAGAGACCTTTCTCTTCTCAATGCCACAAGATGGCTATGAATGACATAAACTTCAATTTATGTTCTATAACATAATCCTGCCTTTTGAGGCAATGTTTTAGGCGTAAAGACATAAGCCCAAAGTTATCATTTGTATTGATCCTCTTATTTAATAACTAAATAATATTGATCCCTCAACTTCTCTTTCAAAAATAATTCATTTTGGAAGCTCTTCTGAAGTAGCTCTGGAAAAAAAAAAGTGTGCTCTAAATGGCAATAGAAAATGATACTATCTCCAAAGAGCAAAGTGTTTCTGATATAATGAATCAAGAACTCATCGACAAAGCAATTCAGAGAAATGCAATGACTACATTTGACTTATAGTTGACTTATAATTGAGGGGTTTTTGGCGTTCATCTTGTTAGATGCCCCTTCTAGGCTTGCTATGTTTACACCCAACTATAATGTTCTGAAAAAATAAGATAAATAAATATCTTTAAAG
>TTN-209,,0,144,2175688,2175831,GTATACAGTGATGCTAATCAGAACATGAAATAATTCTTGGTTTAGTTTTTCATGGTTTAAAGTGAATGTGTGTGACATTAAATCCTTGTATTTCGTATCTTATATTTGTTATCTGTAACAATTAATATACTAATATCTTTAAAG
>TTN-209,,0,1651,2175832,2177482,GTGAGTGTAGAAAAATTAGTGGTTCTTTTTCGTTTCATTTATGTCCTTAAATTCACTATGTTTGTCTTTTTAGCTTTGAAAAGTAAATATACTAAACTCTTATAAAAGCCTAACATGCCACAAATATATGACTCAAATAATCTTAGTGTCTATTATCCTCAGACAAGTTATATTTCCTCACCAATTTAAAAAAGAAATACTCTACTTATCAGAGTGTATGATTTCAGAAAAGTCAGTTGTCTTGTTAAATTTTCCTAACCTATTCTGTATACAAGTGTCTTTTGCTTTGAAGCAATTTATTTTCTCAGATCATGAAGTAACTTAACTCCATAATATTTTAATTGGATTTTATAAAATCAAAATGTTTCACCATTATTTTTTTTTTTACTCTTGATAACCATAATTGGAAACATTTTGGCAAAACTGCTCAAAGGACCCTAGGTTTACAAGGCCACTCAAACCTCAAAAGAATTCTCACGACCTTTTTTTTTGGGGGGGGGTTTCATACAAAATTAGGTTTAAATAATTTGAATTATGAAATAATCCAAATAGTAAAATATTGTGAATAGAATACTGTTCAACAACCTGAATAGTAAAAGTGACAGTAGTCAAAATATTCTTCCTTTTTTTTTTTTTTTTGAGATGGAATCTCACTCTGCTGCACCCAGGCTGCAGTGCAGTGGCACGATCTTGGCTCACTGCAACCTCCGTCTCCTGGGTTCAAGCTATTCTCCTGCCCCAGCCTCCCGAGTGGCTGGGATTACAGGTGCCTACCACCAGGCCCGGCTAATTTTGTGTATTTTTAGTAGAGACAGGGTTTTACCATGTTGGTCAGGCTGGTCTCAAACTCCTGACCTCAGGTGACCCGCCCACCTCAGCCTCCCAAAGTGCTGGGATTACAGGCATGAGCCACTACACCAGACCCGCTTCCATTTTTTTTAATCTAAAAAATTTCCTGTTGAAACTCAACTTTCTTGTTGTTCATCCTGTTATACTAAGTTGGGATAAAATAATATAATCACTTCCTCCTTTGAATATCCTTTCTATTCTTGACTTTAGTTATTGTTTTCAGACAGTTTTTCTTTCTAAAGGCTGGAGAAATTTTTGTTGTCTTTATTTGCCTTATTTTCTAAGTATTTAATTTTTTTAATTTTCTGCCTCCAAACCCTAAATGGCTTTTACATTCATATTAAACTGTGAAACCATATATTAGATGTGATTTGAAAATATAGATAATGAGGCTTCTAGAAAGGGAAAAGACTTACATGAATTTCTAGTAGGTCAAATATCGGAGAATTCTCAATGTGCAATTCAGCATCTTCCCTGTTCTTTATAGACAAATCCATTAAAAATAAGACCAATAGGACAATTTTACCAATAACTTTCTTAAGGCAAAATGAAGAATTATATAGTCCTTGCCTGAACAATTCCTCCATTTTATTATCATCATCATAGAGAAATGCTTAGAGTCTTACATCATGAAACTGGGAGTGAGGCTATCCCCAGCCAATGCATTCTAGCCACTAATTTGCCTCTATGTGCTACTATTAATTTTGGTGATGAATGTGGTATTATATATTATATTTTTCTTAATACACTTCTTTATCCACCTTGAAACATCCTAATTATTTAAATACTAATATCTTTAAAG
>TTN-209,,0,112,2177483,2177594,GTATATAACACCAATGATCCACTCTGAAGAAAAATTATTTTTTGGCCCCTTTTAAAAAGCTCAATATTTTTCTTCACCATTTATAAATATAACTATACTCATATCTTTTAAG
>TTN-209,,0,122,2177595,2177716,GTATATTTCAAATACATCAAACCCAGATGAGTATCTTTAGCTTTATGACTCAAACATTGCATGCTTTTTATAATTTACTGTTTTTACAACTTTTAAATGTAAACCTACTAATATCTTTAAAG
>TTN-209,,0,334,2177717,2178050,GTATAATTCTCTAGTTAGGAAAATCTAAAGAAGAAAATATACTGTCTTCAGTCTGCAAAATATTTAATGTTTAATATACATTCTCACAACCTCTAATGTTAAAATACTGTGTTTAAAGGATCTGATATACCCACAACAAAGAATGACCTATGACTTGCCCCCAAGAAAGTCAAGTCCCACACATATAATATACAAAGATAAAATATTAGAACAAAAATAACATTTCTAACATAAAGATATCTGAAATGATATTAACATATCTAACTTTCTTAGTATGTCATGTCTTTATGCCTTTGCCTTTTCTCAATTAAAAAAAATACTAATATCTTTAAAG
>TTN-209,,0,1032,2178051,2179082,GTACAAGTTGGAAGAAAGTCACCTTTTTAATCTCATGTTTGCAGTTGTACTTAACACATGTAAAAATACTAATATCTTTTAAGCCAAAGTGGCTACAGTGGAAATCATTTCAGAGATGGATCCCCCAAGTAGAAGCTCAACCAAATGTATTCATGTCCCAGTGAGTCACTCAAGAGACAACAGAGGGAAAAAATACCTTTAGCTTATACACATGAAAGATAGTTGAGTCAGTGTATTTTTATGAGGACTCCAAAGAAAATATATATACACATATTATGATCAAAACATGTCTTAAAGAAAATATTAATTCAGTGTGAAGCTGATCTGTAATATCTCTACAAGATTAGAGCACCTGAGACCCTCCCAGAATATCCTCCAACCTAGGGAAAAATAATTCCAGTTAAAGCTGGAAATCTCCCCTCCATGTTCATTTGCTCCTCTCATAGCCTATCTTTTATTTTTCAAGCATCATTTTTTTTCATTTTGAATATCTTTAGATAAGTCAAAACATGAAAAAGCTTTAAAACCTCCAGAACAATAATTTCATCATAACACCCATGGTATTCTGTAATTTGAAGAATATCTGAATATTTTGATATTTTTTCTCAGTCTGGAATCTTTTGGTTGTTCTCCTCTCTCCTAAACTTGAAAAACACTCACCTTTTTAAGGTGCCTGAGGTGTGAATACAAAAAAATGCCGACCTAGATTTTTCGAAGTGGCTGTAATTTGTTTTTCTCAACATAATAGCTAGAGGTATAGCATTAATTATAATCAATGTTTCCACTTTCCATGATCTAGTTTTCTATGCATCTACCATTCCAAGAAATAAAATTACTAATACTGATAGTGCCTGAGGTGACCAAGAAAACAGCCGCTTATAACCAAATACTCACACTGCTACAAAAGATCCGATTCTGGGGGCGGGGAGTGGGAGAAGGTTCCCATCTGGAATGTTCTGTATGTGCAGTTAAGATGGGAACTCTTTACTCCTCTTCATAACTCCAAAGTACAATGCATTCATATCTTTAAAG
>TTN-209,,0,247,2179083,2179329,GTATCGTTCATCCTGCCATTCCTTCCTTCATTTATTAGAGTGCTTAGCATGTACAGGGTGCTAGGGAACTGGAGAATAATAAACAAAGACAATTAATATGTGGTTCCTCTCCTCAAGATTGTATACCTCCTCAGATTCTTTAAAGGAATCATCTTTTTAGCCATAAATATCACTTTGGTTCAGCTCATTTAATTAATGTCTCCACTGATCCTTTTAACCTCTAACCATAATACTAATATCTTCAAAG
>TTN-209,,0,450,2179330,2179779,GTACGTTACCTCTGAACAAATGTGGAAGAAGAAATTATCTGTCCTCTGCTCTTAAAACTATGGTTTCTTCCTAATACTCTTCATAAATTCTAAATATAAACATACTAATATCTTTTAAGTGTCTGAGGTTCCACAGGAAGTTTCCTCTAAAAAGAAATTATTTATGGCTGTTTCTGCCAAAACAGAAAACACTCCTGCTGGAAGTATTCATTCAACAAATCCTTTATAATGAGAGTGTAGAGTGTCGCGAGAGCTCTGTGAGGTTCTGGAGGAGGGGGAGCACCTCCTCTCAAGGATCCACTAACCCCTTAAAAGACTTAGCCTATTGGTGGAACAAAGGGAGGATGGAGGAAAGAGAAGAAAATGTGGTTATATTTCCTAACTTATTGTGGTTACTGTTTTCCATTAATCATTTTAACTCTTAAATGTGAATTGCTAATATCTTTCAAG
>TTN-209,,0,114,2179780,2179893,GTACAAGTCACCATGCTCTCAGGGTCAAGAACTAGCTCTTGTAGTTTTGAGAATATTTTTGCTATTCCTAGTTATCTGCATAACACTAAACATAAAACTACTAATTTCTTAAAG
>TTN-209,,0,116,2179894,2180009,GTATATCTTGCTGGAAGCTTAGAGGGGTGGGAACATGTCTTTTCTTGTATAAATGTTTTTCCTGATTGTGTTGATTCTTGTAACTTCTAAATGTAAAATTATTAATATCTTCAAAG
>TTN-209,,0,361,2180010,2180370,GTACATTCTTAACTGTCTTTTTATGGTGGGATAGTGGGTGGGGCGATAGAAAGGACCACCTTTCTAGTTTTGAAAATTATTTTGATGTGTACATGTGAATCATGTCTGTGTTGACTCTTGCAACTCAAGTGTAAATGTATTAATATCTTCAAACTGCCTGAAGCTCCCAAAGAAATGGCTACCAAAAAGAAAATACCGGAAGTTCCTCCTCTAAAACCTGAAACACCACCTATTATGGGAACTTGTTACCACTGATCTCAGCTCAGGAGAAAAAAATAGCTCTTTTGTTCTTGAAAATGTCTTTGTATCTATCTAGTAATCTCTGTATTTTCTGAGTGTAAAAATACTAATATCTTTCAAG
>TTN-209,,0,112,2180371,2180482,GTATTTGTCACTGACTTTAGGCTTCAGAAGACCTAATTCTTCTGCTCTTGACAATATTTTTTTCTAGCGGTCTTCATAACACCTAAATGTAATTTCACTAATATCTTTCAAG
>TTN-209,,0,108,2180483,2180590,GTAGTTGCCACTGACCTTAGGCTTCAGATCTCATTCTTTTGCTCTTGAAGATATTTTTTCCAGTGGTCTTCATAACTTCTGAATGTAATTTTGCTAATATCTTTTAAG
>TTN-209,,0,110,2180591,2180700,GTATTTGTCACTGATTTTAGGCTTCAGATGATGTATCTCTTCTGCTCTGGAAAATATTTTTCTAGTGGTCTTCATAATGCCTAAATGTAATTTCACTAATATCTTTCAAG
>TTN-209,,0,83,2180701,2180783,GTAGACACCCTCTTGTTGCTGTGTTTGATATTGTTTGTTTGTCTTTACTTTGTCTAATAATGAAAATACTAATATCTTTAAAG
>TTN-209,,0,210,2180784,2180993,GTAATGCCAAAGCTATACAAACTATAGGAGAAAAATAACTGTTATTTTAACTAGGAAATTACATGTTAAAAATCCTACTACATAAAGATGATATAATTCTAAAGAAAACAAATGTCAATCGCTATCCAAAATATCTTGGTGGGTGTTTATATGCAAAAGGCATCCATCATTTTCACCTTTTCTAAACACAAATTACAAATATCTTTGAAG
>TTN-209,,0,153,2180994,2181146,GTAGGTATCATTACACATTGTCAGTCGGGGGGCCCTGGGGAAAGACTGCATAGAAGTGTCCGCCGATCTCACAAGTTGTATTTGCTTGGGTAAATGTGGAGTCGATATTCCCCCTTTATAGCTTCTAACTAAAAGATACTAATATCTTCAAAG
>TTN-209,,0,112,2181147,2181258,GTATTTATTCCCTCTCCTCTGCTAAGAAAAACTTATCGTCTGTACCCCTCACAATCACTGTAATATATACCTTCACCATTCATAAATTATAAAAATACTAATATCTTTCAAG
>TTN-209,,0,114,2181259,2181372,GTACATGTCAGCTCAACCTTATCCTGCAGAAGAAATCTCTCTTCCATTCCTGAAAACAATTTTAGTCCATTCCTCTTCATTAACCTAAGTATAAAACTACTAATATCTTTCAAG
>TTN-209,,0,115,2181373,2181487,GTACACTTTAGCCCTGACTTCATTCTGCAGAAGAGATATCTCCTCTCCTACTGTAAACAATTTTAGCCCATTTCTCTTCATTAACTTAAGTCTAAAACTACTAATATCTTTCAAG
>TTN-209,,0,113,2181488,2181600,GTATTTTTTACCCCTGTCCTTTTTCTGCAGAAGAAATATCTCTTCTGATCTTAGAAATATTTTACTCCATTTGTCTCATTAACCTAAGTGAAAAACTACTAATATCTTTCAAG
>TTN-209,,0,105,2181601,2181705,GTACTTGTCATTTGACCTTAAGCTTCAGAAGATCCAATTCCTCTGCTGTATATTTTGCTAGTAGTCTCCATAGCTCCACATGTAACTTTACTAATATCTTTTAAG
>TTN-209,,0,2503,2181706,2184208,GTATTTGTCACTGATTTTAGGCTTCAGATGATCTATCTCTTGTGCTCTGGAAAATATTTTTCTTTTTATATATATATATATTTTTATTATACTTTAAGTTCTAGGGTACATGTGCACAACGTGCAGGTTGTTACGTATGTATACATGTGCCATGTTGGTGTGCTGCACCCACTAACTCGTCATTTACATTAGGTATGTCTCCTAATGCTATCCCTCCCCCATCCCCCCACCTCACAACACACTCCGGTGTGTGGTGTCCCCCTTCCTGTATCCATGTGTTCTCATTGTTCAATTCCCACCTATGAATGAGAACATGCAATGTTTGGTTTTTTATCCTTGTGATAGTTTGCCAAGAATGATGGTTTCCAGTTTCATCCATGTCCCTACAAAGGACATGAACTCATCATTTTTTATGGCTGCATAGTATTCCATGGAGTATATGTGGAACATTTTCTTAATCCAGTCTATCATTGATGGACATTTGGGTTGGTTCCAAGTCTTTGCTAATATGAATAGTGCCGCAATAAACATACGTGTGCACGTGTCTTTATAGCAGCATGATTTATAATCCTTTGGGTATATACCCAGTAATGGGATGGCTGGGTCAAATGGTATTTCTAGTTCTAGATCCCTGAGGAATCGCCACACTGACTTCCACAATGGTTGAACTAGTTTACAGTCCCAGCAACATTGTAAAAGTGTTCCTATTGCTCCACATCCTCTCCAGCGCCTGTCGTTTCCTGACTTTTTAATGATCACCATTCTAACTGGTGTGAGATGGTATCTCATTGTGGTTTTGATTTGCATTTCTCTGATGGCCAGTGATGATGAGCATTTTTTCTTGTGTATTTTGGCTGCATAAATGTCTTTTTTTGAGAAGTGTCTGTTTGTATCCTTCGCCCACTTGTTGATGGGGTTGTTTTTTTCTTACACGTTTGTTTGAGTTCATTGTAGATTCTGGATATTAGCCCTTCGTCAGATGAGTAGATTGCAAAAATTTTCTCCCATTCTGTGGGTTGCCTGTTCATTCTGATGGTAGTTTCCTTTGCTGTGCAGAAGCTCTTTAGTTTAATTCGATCCTATCTGTCAATTTTGGCTTTTGTTACCATTGCTTTTGGTATTTTAGACATGAAGTCCTTGCCCATGCCTATGTCCTGAATGGTATTGCCTAGGTTTTCTTCTAGGGTTTTTATGGTTTTAGGTCTAACATTTAAGTCTTTACTCCATCTTGAATTAATTTTTGTGTAAGGTGTAAGGAAGGGATCCAATTTCAGCTTTCTACATATGGCTAGCCAGTTTTCCCAGCACCATTTGCTAAATAGGGAACCCTTTCCCCATTTCTTGTTTTTGTCAGGTTTGTCAAAGATCAGATGGTTGCAGATGTGTGGTATTATTCTGAGGGCTCTGTTCTGTTCCATTGGTCTATATCTCTGTTTTGGTACCAGTACCATGCTGTTTTGGTTACTGTAGCCTTGTAATACAGTAGCGTGACGCCTCCAGCTTTGTTCTTTTGGCTTAGGATTGACTTGGCAATGTGGGCTCTTTTTTGGTTCCATATGAACTTTAAAGTAGTTTTTTCCAATTCTGTGAAGAGAGTCATTGATAGCTTGACGGAGATGGCATTGAATCTATAAATTACCTTGGGCAGTATGGCCATTTTCACGGTATTAGTTCTTCCTATCCATGAGCATGGAATGTTCTTCCATTTGTGTCCTCTTTTATTTCGTTGAGCAGTGGTTTGTAGTTCTCCTTGAAGAGGTCCTTCACATCCCTTGTAAGTTGGATTCCTAGGTATTTTATTCTCTTTGAAGCAACTGTGAATGGGAGGTCACTCACGATTTGGCTCTCTGTTTGTCTGTTATTGGTGCATAAGAATGCTTGTGATCTTTGCACATTGATTTTGTATCCTGAGACTTTGCTGAAGTTGCTTATCAGCTTAAGGAGATTTTGGGCTGAGACGATGGGGTTTTCTAGATATACAATCATGCCATCTGCAAACAGGGACAATTTGACTTCCTCTTTTCCTTATTGAATACCCTTTATTTCTTTCTCCTGCCTGATTGCCCTGGCCAGAACTTCCAACACTATGTTGAATAGGAGTGGTGAGAGAGGGCATCCCTGTCTTGTGCCAGTTTTCAAAGGGAATGCTTCCAGTTTTTGCCCATTCAGTATGATACTGGCTGTGGGTTTGTCATAAATAGCTCTTATTATTTTGAGATACGTCCCATCAATACCTAATTTATTGAGAGTCTTTAGCATGAAGGGCTGTTGAATTTTGTCAAAGGCCCTTTCTGCATCTATTGAGATAATCATGTGGTTTTTGTCGTTGGTTCTGTTTATATGATGGATTACGTTTATTGATTTTTGTATGTTGAATCAGCCTTCCATCCCAGGGATGAAGCCCACTTGATCATGGTGGATAAGCTTTTTGATGTGCTGCTGGAAAATATTTTTCTAGTGGTCTTCATAATGCCTAAATGTAATTTCACTAATATCTTTCAAG
>TTN-209,,0,83,2184209,2184291,GTAGACACCCTCTTGTTGCTGTGTTTGATATTGTTTGTTTGTCTTTACTTTGTCTAATAATGAAAATACTAATATCTTTAAAG
>TTN-209,,0,210,2184292,2184501,GTAATGCCAAAGCTATACAAACTATAGGAGAAAAATAACTGTTATTTTAACTAGGAAATTACATGTTAAAAATCCTACTACATAAAGATGATATAATTCTAAAGAAAACAAATGTCAATCACTATCCAAAATATCTTGGTGGGTGTTTATATGCAAAAGGCATCCATCGTTTTCACCTTTTCTAAACACAAATTACAAATATCTTTGAAG
>TTN-209,,0,153,2184502,2184654,GTAGGTATCATTACACATTGTCAGTCGGGGGGCCCTGGGGAAAGACTGTATAGAAGTGTCCGCCGATCTCACAAGTTGTATTTGCTTGGGTAAATGTGGAGTCGATATTCCCCCTTTATAGCTTCTAACTAAAAGATACTAATATCTTCAAAG
>TTN-209,,0,112,2184655,2184766,GTATTTATTCCCTCTCCTCTGCTAAGAAAAACTTATCGTCTGTACCCCTCACAATCACTGTAATATATACCTTCACCATTCATAAATTATAAAAATACTAATATCTTTCAAG
>TTN-209,,0,114,2184767,2184880,GTACATGTCAGCTCAACCTTATCCTGCAGAAGAAATCTCTCTTCCATTCCTGAAAACAATTTTAGTCCATTCCTCTTCATTAACCTAAGTATAAAACTACTAATATCTTTCAAG
>TTN-209,,0,115,2184881,2184995,GTACACTTTAGCCCTGACTTCATTCTGCAGAAGAGATATCTCCTCTCCTACTGTAAACAATTTTAGCCCATTTCTCTTCATTAACTTAAGTCTAAAACTACTAATATCTTTCAAG
>TTN-209,,0,113,2184996,2185108,GTATTTTTTACCCCTGTCCTTTTTCTGCAGAAGAAATATCTCTTCTGATCTTAGAAATATTTTACTCCATTTGTCTCATTAACCTAAGTGAAAAACTACTAATATCTTTCAAG
>TTN-209,,0,105,2185109,2185213,GTACTTGTCATTTGACCTTAAGCTTCAGAAGATCCAATTCCTCTGCTGTATATTTTGCTAGTAGTCTCCATAGCTCCACATGTAACTTTACTAATATCTTTTAAG
>TTN-209,,0,2502,2185214,2187715,GTATTTGTCACTGATTTTAGGCTTCAGATGATCTATCTCTTGTGCTCTGGAAAATATTTTTCTTTTTATATATATATATATTTTTATTATACTTTAAGTTCTAGGGTACATGTGCACAACGTGCAGGTTGTTACGTATGTATACATGTGCCATGTTGGTGTGCTGCACCCACTAACTCGTCATTTACATTAGGTATGTCTCCTAATGCTATCCCTCCCCCATCCCCCCACCTCACAACACACTCCGGTGTGTGGTGTCCCCCTTCCTGTATCCATGTGTTCTCATTGTTCAATTCCCACCTATGAATGAGAACATGCAATGTTTGGTTTTTTATCCTTGTGATAGTTTGCCAAGAATGATGGTTTCCAGTTTCATCCATGTCCCTACAAAGGACATGAACTCATCATTTTTTATGGCTGCATAGTATTCCATGGAGTATATGTGGAACATTTTCTTAATCCAGTCTATCATTGATGGACATTTGGGTTGGTTCCAAGTCTTTGCTAATATGAATAGTGCCGCAATAAACATACGTGTGCACGTGTCTTTATAGCAGCATGATTTATAATCCTTTGGGTATATACCCAGTAATGGGATGGCTGGGTCAAATGGTATTTCTAGTTCTAGATCCCTGAGGAATCGCCACACTGACTTCCACAATGGTTGAACTAGTTTACAGTCCCAGCAACATTGTAAAAGTGTTCCTATTGCTCCACATCCTCTCCAGCGCCTGTCGTTTCCTGACTTTTTAATGATCACCATTCTAACTGGTGTGAGATGGTATCTCATTGTGGTTTTGATTTGCATTTCTCTGATGGCCAGTGATGATGAGCATTTTTTCTTGTGTATTTTGGCTGCATAAATGTCTTTTTTTGAGAAGTGTCTGTTTGTATCCTTCGCCCACTTGTTGATGGGGTTGTTTTTTTCTTACACGTTTGTTTGAGTTCATTGTAGATTCTGGATATTAGCCCTTCGTCAGATGAGTAGATTGCAAAAATTTTCTCCCATTCTGTGGGTTGCCTGTTCATTCTGATGGTAGTACCTTTGCTGTGCAGAAGCTCTTTAGTTTAATTCGATCCTATCTGTCAATTTTGGCTTTTGTTACCATTGCTTTTGGTATTTTAGACATGAAGTCCTTGCCCATGCCTATGTCCTGAATGGTATTGCCTAGGTTTTCTTCTAGGGTTTTTATGGTTTTAGGTCTAACATTTAAGTCTTTACTCCATCTTGAATTAATTTTTGTGTAAGGTGTAAGGAAGGGATCCAATTTCAGCTTTCTACATATGGCTAGCCAGTTTTCCCAGCACCATTTGCTAAATAGGGAACCCTTTCCCCATTTCTTGTTTTTGTCAGGTTTGTCAAAGATCAGATGGTTGCAGATGTGTGGTATTATTCTGAGGGCTCTGTTCTGTTCCATTGGTCTATATCTCTGTTTTGGTACCAGTACCATGCTGTTTTGGTTACTGTAGCCTTGTAATACAGTAGCGTGACGCCTCCAGCTTTGTTCTTTTGGCTTAGGATTGACTTGGCAATGTGGGCTCTTTTTTGGTTCCATATGAACTTTAAAGTAGTTTTTTCCAATTCTGTGAAGAGAGTCATTGATAGCTTGACGGAGATGGCATTGAATCTATAAATTACCTTGGGCAGTATGGCCATTTTCACGGTATTAGTTCTTCCTATCCATGAGCATGGAATGTTCTTCCATTTGTGTCCTCTTTTATTTCGTTGAGCAGTGGTTTGTAGTTCTCCTTGAAGAGGTCCTTCACATCCCTTGTAAGTTGGATTCCTAGGTATTTTATTCTCTTTGAAGCAACTGTGAATGGGAGGTCACTCACGATTTGGCTCTCTGTTTGTCTGTTATTGGTGCATAAGAATGCTTGTGATCTTTGCACATTGATTTTGTATCCTGAGACTTTGCTGAAGTTGCTTATCAGCTTAAGGAGATTTTGGGCTGAGACGATGGGGTTTTCTAGATATACAATCATGCCATCTGCAAACAGGGACAATTTGACTTCCTCTTTTCCTTATTGAATACCCTTTATTTCTTTCTCCTGCCTGATTGCCCTGGCCAGAACTTCCAACACTATGTTGAATAGGAGTGGTGAGAGAGGGCATCCCTGTCTTGTGCCAGTTTTCAAAGGGAATGCTTCCAGTTTTTGCCCATTCAGTATGATACTGGCTGTGGGTTTGTCATAAATAGCTCTTATTATTTTGAGATATGTCCCATCAATACCTAATTTATTGAGAGTCTTTAGCATGAAGGGCTGTTGAATTTTGTCAAAGGCCCTTTCTGCATCTATTGAGATAATCACGTGGTTTTTGTCGTTGGTTCTGTTTATATGATGGATTACGTTTATTGATTTTTGTATGTTGAATCAGCCTTCCATCCCAGGGATGAAGCCCACTTGATCATGGTGGATAAGCTTTTTGATGTGCTGCTGGAAAATATTTTTCTAGTGGTCTTCATAATGCCTAAATGTAATTTCACTAATATCTTTCAAG
>TTN-209,,0,83,2187716,2187798,GTAGACACCCTCTTGTTGCTGTGTTTGATATTGTTTGTTTGTCTTTACTTTGTCTAATAATGAAAATACTAATATCTTTAAAG
>TTN-209,,0,210,2187799,2188008,GTAATGCCAAAGCTATACAAACTATAGGAGAAAAATAACTGTTATTTTAACTAGGAAATTACATGTTAAAAATCCTACTACATAAAGATGATATAATTCTAAAGAAAACAAATGTCAATCACTATCCAAAATATCTTGGTGGGTGTTTATATGCAAAAGGCATCCATCATTTTCACCTTTTCTAAACACAAATTACAAATATCTTTGAAG
>TTN-209,,0,153,2188009,2188161,GTAGGTATCATTACACATTGTCAGTCGGGGGGCCCTGGGGAAAGACTGTATAGAAGTGTCCGCCGATCTCACAAGTTGTATTTGCTTGGGTAAATGTGGAGTCGATATTCCCCCTTTATAGCTTCTAACTAAAAGATACTAATATCTTCAAAG
>TTN-209,,0,112,2188162,2188273,GTATTTATTCCCTCTCCTCTGCTAAGAATAACTTACTGTCTGTACCCCTCACAATCACTGTAATATATACCTTCGCCATTCATAAATTATAAAAATACTAATATCTTTCAAG
>TTN-209,,0,114,2188274,2188387,GTACATGTCAGCTCAACCTTATCCTGCAGAAGAAATCTCTCTTCCATTCCTGAAAACAATTTTAGTCCATTCCTCTTCATTAACCTAAGTATAAAACTACTAATATCTTTCAAG
>TTN-209,,0,115,2188388,2188502,GTACACTTTAGCCCTGACTTCATTCTGCAGAAGAGATATCTCCTCTCCTACTGTAAACAATTTTAGCCCATTTCTCTTCATTAACTTAAGTCTAAAACTACTAATATCTTTCAAG
>TTN-209,,0,113,2188503,2188615,GTATTTTTTACCCCTGTCCTTTTTCTGCAGAAGAAATATCTCTTCTGATCTTAGAAATATTTTACTCCATTTGTCTCATTAACCTAAGTGAAAAACTACTAATATCTTTCAAG
>TTN-209,,0,105,2188616,2188720,GTACTTGTCATTTGACCTTAAGCTTCAGAAGATCCAATTCCTCTGCTGTATATTTTGCTAGTAGTCTCCATAGCTCTACATGTAACTTTACTAATATCTTTTAAG
>TTN-209,,0,113,2188721,2188833,GTATTTGTCACTGACCTTAGGCTTCAGATGATCTAATTCTTTTGCAGTTGAAGACATTTTGTTCCAGTGGTCTTCATAACCCCTAAATGTAATTTTACCTAATATCTTTTAAG
>TTN-209,,0,109,2188834,2188942,GTATTTGTCACTGGCTTTAGGCTTCAGAAGACTGAACTCTTCATTTCTTGAAAATACTTTTCTAGTGGTCTTCAAACTTCTAAATGTAATTTCACTAATATCTTTTAAG
>TTN-209,,0,111,2188943,2189053,GTATTTGTCACTGGCTTTAGGCTTCAGAAGATCAAACTCCTCTATTCTTGAAAATATTTTTTCTAGTGGTCTTCATAACCCCTAAATGTAATTTCACTAATATCTTTTAAG
>TTN-209,,0,111,2189054,2189164,GTATTTGTCATTGAGTTTAAGCGTCAGAAGATCTATCTCTTCTACTCTTGAAAATATTTTTCCTAATGGTCTTCATAACTTCTAAATGTAATTTCACTAATATCTTTTAAG
>TTN-209,,0,110,2189165,2189274,GTATTTGTCACTGATTTTAGGCTTCAGATGATCAAACTCTTCTGCTCTGGAAAGTATTTTTCTAGTGGTCTTCATAATGCCTAAATGTAATTTCACTATTATCTTTCAAG
>TTN-209,,0,84,2189275,2189358,GTAGACACCCTCATGGTGCTGTGTTTGATATTGTTTGTTTGTCTTTACTTTGTCTAACAATGAAAATAATAATATCTTTTAAAG
>TTN-209,,0,128,2189359,2189486,GTAATAATGAAACTATTCAAATTAGTGTTTTTTAAAAAAATCTTTCCTTAGTGTTGTAAAAACATTTTTTTGCAAACTATCTCAGTTTTAGTCAATTCTGGCATTAAAATGAGCTCATGTCTTTAAAG
>TTN-209,,0,134,2189487,2189620,GTACATGGCAAGAAAGCTGCTAGGACACCTCGGCCACTCTTTCCCCTTCCTGCCCTGATAATTCTGGGTGCTCTGAGCTTTTGTCTTGTTTCTCAATCTTCGTTCTTTCTAAAACATACCTTCTAATTCTTTAG
>TTN-209,,0,129,2189621,2189749,GTATTCCTCACTGCCACTAACTCCCTAACAAAAAACTTTCTTTGAAGTGTCATATTCTACTGTTCTGCTTCATGATTTTCACATTTCATTGAAACCATGAGCTTAAACAACTACTAATATCTTTTATAG
>TTN-209,,0,132,2189750,2189881,GTATATGTGGCTGTCCACTGTTTGATGGGGGCGGATGGAGCCCCCAGCTTCTAAAAGGGTTTTGTTCTGTGTAAATGTGATGAATGTTTACTGGTGATTGTTTCTAATGTTAAAATACTAATATATTTGAAG
>TTN-209,,0,408,2189882,2190289,GTACATGTCACTAATGAGATTCTGCAGAAAAGCACTCACCCTTGTCTAATAAGTCACCTATTATCAAACCTTTTGTTTGCGAGTCCTCTTAAATTTGCAACTACAAAACTGTCATTCTGGATTTTTAGGGTCTGAATACTTTTTAATAATTTTTTCATTGACTTTAAAAAGTGATATATTTACTTATTACAAGCATTGGAAAAGTTTACTAACTTGGTTCTTTTATTCTTAATAGGCCATATTTTCCTCCCCACTATATGAGGGTCCAAAGACAGATCACTGACCTTATTGTGAAATTTGTTCTTGGATCTGTCCCTGGGTTATTTGAGCAAAATGTGAAGTCGATGTGGTATAAATTTAATATACTTCTCAACTACTCATAAGAAAAATGAATTAATATCTTTAAAG
>TTN-209,,0,479,2190290,2190768,GTACACGTGAGACCGGTGATTAATGACCTTGCCACTTGCGACTATTTCTAATTTAAGCTTTGTTCTTCTTCCTTCCTAACTCATTATTTCTTGGTCATTTTCTAACCTTTAATTATTTGTCTTAATTCATCATTCTAAATTAGCTCCAATCTCAAATCTATTTTGGGTTATTGGTCCACAGTATCTACATAAGTCATAGTAAGCTATATTAAACAAAGCTTCTCCAATGTACATAGAAAGTAAGGCAGGAGAACTAATGATTATAAATGACATTAAACACTAAAAGGGCTTTGCAAGCATTTGAATCAATAGACAAAGAAGTCAGTGCAAATGAGATAGATTTTATCTAAACAAAAATAAGAGAAGGTATCAATTGAAACAAAGGAAGAAATCAAGATTACTATTTATCGTGTTTAGTGTTTGTCCATCTTAGAATATTGTTCCATACATTGAAATAAAATTAACTAATATCTTTAAAG
>TTN-209,,0,269,2190769,2191037,GTACAAAGCAGAATCCACTGTATGGGAAAATACAGTCATTTCATTTTTCATGTCTATATATCTTCCTTAAGGCAAAATATCAGTCTTGTATCTTGTTGCCTGAAATCTGACTACATTAAGAACAAAAGTTATTTCTACACATAAAACTTTGGACCCACAGAATTTGGTCCCACATATACCAAGAAATATGTGTGGTTTTTAATTCATTCATTAGCATTAAATTTTTCATTGTAATCACCTAATTCTAAAAGAAATTCCTATTATTCAAG
>TTN-209,,0,185,2191038,2191222,GTACTCATGTTAAAATGAATACTTCATTTTTGTGGTGTCTACAATTTTACACTCTTCTTATTGTGTGTTGTGTTGTATTATATGTTTGTTAACTCTTACCTATATGTTACAGTGTTGAATAAACTTGTATGTATATCTTACATCTCACAACTTTGTATTATTAAATGCTACTGATATCTTTAAAG
>TTN-209,,0,222,2191223,2191444,GTATTCACTTCATCGTTGGCATCATAAAAAAGAAAGTATTCTGATATCTTAAAGTGGAATCCAATAAGTTGTCCTCATTGTTGTTGCATAACTAAGGACAAAAATTTCCTTATTTTGCTTTCATTAATTTTAATGCTGCTCCAATAAATACAGGTTTTTTATTCTTAATATTTTAAAATGTTTTTAAATACTATTTTTAAAACAAAACTAATATCTTCAAAG
>TTN-209,,0,1783,2191445,2193227,GTACCTACCATGAAGAAAAAATAGATTTCTCTAACTGCTATTTAAGCATGTTAATAATAGGTCTTAGAGAAAAACATACTGAATGTGAATTTATGTTAAAACCATATTGCACAGAAAAAAGGGAAATAATGAAGGGAAAAAAATGAAACAGACAAGCAGGAGTGAAAAAATGAGTGGGATTCAGTTGTGCTGTGATATATCACATGGCTACAACTAGTAGAAAAGAACCTTCTCTCATTCAATGTGTAAAACAGCTCAATTCAACATATTTTGTTGAATGTTGACCATTAACAAGACATCATATTAGAAAAATTAAGGCCTGATTCTGTCTTCAAATAAGTTAAATCTGGTGAGAGGATAGAAAGATAACAGGACTCTAATACAGACAGGAAGTGATTACACATAGCAAGTGAATACAAAAGGGCTGCAGAAACACACGGCAAGAAAAGATTAAGTTCAGGCAGAGGCATCATGGGAAGCTGTGTTAAACTGAATTTAAATTTTGATGGACTTTTACATGTAGAAATTGAGGAAATAAGGCCGGATGTGGTGGCTCACGCCTGTCATCCCAACACTTGGGGAGGCCAAGGTGGGTGGATCACTTGAGGTCAGGAGTTCAAGACCAGCCTGGCCAACATGGTGAAACCCCGTCTCTACTAAAAATACAAAAATTAGCTGGGGGTGGTGATATGTGCCTGTAATCCCAGCTACTTGGGAGGCTGAGGCAGGAGAATTGCTTGAACCCAGGAGGCAGAGGTTGCAGTGAGCTGAGATAATGCCACTGCACTCCAGCTTGGGTGACAGAGTGAGCCTCTGTCTCAAAAAAATTAAAAAAAAGAAATTGAGGACATGATATCCCATGGAAAGGGAAGAGCATATTGAAAGGCACAGAGATAGAAGGGTCTAGAATGTTCAAGGATTGTCAAGTAAACTTATGTCAAGTAAACTCAATTTGAGTATGGATTGGCTGTGGAATGTCTTGAAAGATAATACCAGATATAAAGATGGGGTCATATTTTGGAGTACTTCAAATGCCAGTAAAAGGCTTGTACTTTTTTCTGTAGGCAATAGGAAGCTTCAAAGATTTTGAAGCAGGCTTACATATTAATAGGATTTGGGCTTTAGAAAGATAACTGGCAGCAATTTCAGCTACTAAATAGTAAAGACCCATTGCAATTATTTAAGGTCTTTAAGAGTTGGACAAGATCCGTGGCGGCAGAAATGGAAAGGGGGACTGGGTTTGAAAGAGATGGAGACTTAGTGGCCTCTGACCATTATCAAAACCATTAGGGAAATTGAGGAGCCCAAGATCATTGTAAGGTTTAAAGCTAGATGGCCAAAAGAATGGTTCATTGGGTCTCTGAACTAACGTTAGAGGAAAATGGTAGATGTGCTTTTCACCTTTAAAGCATAAAAGTTGGGAGTGTGTATCAGGAGCTTAAGAAAGAGATCAGGCCTAGAGATGTAGATCTTAAAGTCATTCACATGTAAATAAGAATTGAGTGTGCAGGAACAATTACTCAGAAAATGTAGAGCAAATTTTTTTAAGTGTCAAAGTTAGACCACCTTCATTTAAGTGTACACAGAGGACTAGAAGCAAATGAAGAAAGCTGAGAAGATTCATATATAAAATTAGGATGTCCAAAATGGTGCCATGTCTCAGAAGCCATTTTCCCCATGAAATCTAAGATGAAGCTCTTGCCCCTGCATTCTTTGCCTGCTCTTTAGACAATCTTGCATGTCTTCTAAATTCTTAATAGTAAACAAAATCATATCTTTAAAG
>TTN-209,,0,236,2193228,2193463,GTACACGGCTTCTCCATAAATCTTGGAAAGATGACAATTGTCTTCATCCTCTTGCTTTGATTGTAGATGAATCTTACGTATTTGTCTGTCTGTATTGAAGTTATTGATATTTGGGGGGTCATCTGAATAATCTGTTATAGAGTGTTACTTAATGTAACTAGGTTGATATGTTAGAATAGTAGTTGCAGTATTCTGTTCTAAATATAGTCTAAAATAAAATACTATGTTTTTTAAAG
>TTN-209,,0,504,2193464,2193967,GTATATATATATATATATATATACATTTTTTTAATCTCCTGAAGATTCCTGTTAGAATTACAAAAGCATTTACAGGACAATATTCCTTCTTGAAATTATATACAAGAGCAGTCTAGCATGTTTGACTGCTTTATTTTTGAAATAGTTACACTTCTTTTAAGTTAGAATCTTTAATTTAGTTACTGTTGTTGGTAATTACAATTTCCAAAAGGTACAGTTTACTGAAGCAAAATGGAATAATTGCCTTGGATCCTCAAATGATAACACGGTATCAAATTTTAAAAGTCATCTCATTTGCCATCAATATACATTGAATAATCTAATTAATAGGCAGTTCAAGTAAAAGAACTTTTTCTTATACGTGAATTTTTCTATACATGAATTTGTATGAATTGTATATTTTTATTTTGTGACTGTAATCTTTGCATCAATGTGAAATTTGTATGAGTCTTTTTGAAGAACTTTACATTGCAACCTCATCTCCTTTGTCAACATTCTTTAAAG
>TTN-209,,0,454,2193968,2194421,GTATTCAATCCAGTGGACTTAAATCTTCTTTATCATATTCTTTCTCTTGAAATGTATATGGTTTATGTTGTTGTACATATGTAGTATGTCTGTTCCCATTTGTATGTAAAGTATTCTTTGTTGTAAATGTGAGCCTCATTCTTAGGTTTCCATGTAACTTGTACTGTTTCTCTCATGTCAACTGTGGCTTGTCTGGATGCTTTGTTTGTTGTTGTTATTGGTGCCTTTGCTGTATTTCTCATCATCTTTGTAAAGGGTTGATATTTTTATGTTTTATGTTCTGTGTTTTATGTTGGATACTGGTATTACGTACCTTAAAAAGTAAACTTTGTACTTCATATATATATATATATATATATATATATATATATATATATATAATTTCTATTAAATATACTACATATCCACATGCTAACATATACATATACTAACACCTCTGAAATACTCTTTCAAG
>TTN-209,,0,1303,2194422,2195724,GTAAAAAATGCCACTTCCAAAGTTTTATTAGCCTGCTTCAAACTTCTATCCAGCCATCTGAAATGATGCTTGCAAGAAATGTATGACTTTTAGAAGTGTGTACTTTCAGACATGATTGTACTGTGAGATTGCATAGAGCTGTCTCTTCTGCTGCCCCATGGTTCCTGGGTTGCTTGTCATGCCATGCCTGCTGCTGCAAAAGTCAGAAAGTACATTGATAGCGTCATCCGGGATATCTGAATGCAGGCACTGTCCAATTAACTTTCTTTTGTGGAGTGGGGAGAAAGAGTTTTCTGATTTCAAAGCCTGATTGCTATACATATCATTGCGATCTTATGCTTAAGGAATGTATAAGAAATCCTTGCAAGATATTTTTAATATTGCAGTAACACATTTACATAAAAGCCAAAACTTTGTTCTTAAAGAATTGCATGTGCTTTTAAATATATTACAAGTAATATAGTTATGATTTCCAGTAGCTGATATGTGCCTATATATCATGAAAGGAAAGCATATGAATGACTTGTTACAGTTCCCCCATCTCTTTTTTTTTCTTGCAACTTAAAGAAGTGTTCTGTGTGGTTCTCAGGGGAGCTGGAAAGAGTGGTTATGAAGACATTTGGTATCCAGCATTTATTATTAAACTTCCCTTCCCCCTTCTTATATTTTGATTTTTCTATGAATTGACACAATGTTACTTAATTTTAAAAATATCAGTTTCTTTAAAAGCTGAAATAAACTGGCAGAAACATATTATTCTTATTTTAATAAAAAGTTGTCTTGTGACGTCATATGATTCCCCAATCTAAAATTATCTAGATATAATCTTAGATATGCACTTTCCCTATACAGACCTATGTATCTTCAAACCACAGTCTTCCAGCATAAGACATTGCTGCTGGTGATTCTTGCCCTCTACAACCCTCATAGCCATTAGGGGGACCTTCTGGCACCTCTTGAAAGGCCACCCATCTGTTAATTGACACTCCATGAAGACACACACATAAATACATTTCCCTTAATGTAAAATATATGCTTAAAGGAAAATTTCTTCCTCCTGCCAATAACAAAAATTGTCTTCTTTTTCTGCTGGTCTTTAATTAACTACTGAACTTTGGAGTAAAACTGCAGTCTGTTTTCATGGTTCGAATGCTGCTTGTATGTTCTTTGAAGGCTGTTCTTGGCTGTTATTAATGCTTTCTGGTTATAAGCAAAGCTTGGTTTTGATTCTTGGAGTAGAAAGTTAATCACTTGCTTCAGATTAAATATACAAATAACAAAAGTAAAATCATATTCTTTAAAG
>TTN-209,,0,3917,2195725,2199641,GTATTTCACAGGCTGAAAAATACATACTTATGTAGTACCCCTTTACCTGACTCCTTGCTCTTTCTGCCTCCATCGAATGTTCTGTCTCTCTTTTTCAATGATCAGAGAGTAGTCCCATTCATTTCTTATATTTCTGTGGCTTTTATGGTCCTGGCTCATGAGTGTTGCTTCCTTTGTCTCCCATCCATTTCATACATGTATAGACATGGTCTATCTTTGTCTCATCTACATATGTCTTCTTGCATTTTCCTAAACTTAAAAATAACAAATTTTACTGGTTAGCCAAAATTGATATCAAGAGACATATGAGATTAAAATGCTGAGAGCTAGTAGTAAACTGTTTTGACATTTCACCTGACATAAAAATTTTAGCCAATGTAATAAGCACTAAAAATAAGTCCTATCTTCCTTTTATATTATTAAGGTTATTTGTAGGGATTTCCTTAGGACTTTCATGTCACTCTCTTCTCACTGGCTCTAAGTCATTCTCTGAGGGGTACGGAACTCACATTTCAGAAAAATTTCCTTATTACTGTAGGTAATTTTTCAAAATGTATTTTTCTGTAAACAATATTTTCCCTAATAAGGTCTCATCTAAAATTAGACCCTAAAGAAAACTAAATGAATTATAAGAGTCTAGAAAACATCTATCAAAAATAAACATAATTTTTCTAATGGGTAGTAGTGTTCTGTTCAAGTAATCAACACATTCAGACCTAGAAATTAAGACTGTTTCTGGTCACTCTGAAATTTTGGGGAAAAAAGTCACCCATATAAATATACATTTCCTGATTTCATAAAGAGGCAATTACAAAATAATGTTATCATGGATATTGATCATAAACATTAAAATAGCATATAATCACATATAATGACTTTAAAAATAATAGCTACAATGTTGGGTTCTCAAACATCAATAAGATTTTTAAAATCAAATAATAATATAAAAAATGCACAGATATATTTTCACTATGTTCATTATATCAGTAAAGAAAATCTATATTATGCCTCCTCACTTTACATTAATTAGATGCATGTGCTTCCTTCTGGGTTTGAGCAATAAAAATAGTTATTAAGAAGATTGGTACCTCTAAAATAGTATTGAAGGCCAACACAATTTATCCTGGATAAAATACGTAATGTTTAACTTTAAAATTTTTACTTAAAATATTTGACATTAAAAAAATGATTATTCAAAACGAAATACATATTTGCCTATTGTAGGTTTAAATTTTTGAAATAAGAGTTAAGCAGTTATCTTTATCACATAAAAAACCATTTAATGAATTGCAAATATCTTGTTTAAAGCCCTAAATAGGAAGTTTTATAGAAATATCTAAAAATTCAGATTCCTAATAGCAAATAGTTACACAATACAAATAAATACTGTTTTAAATTAGATTTTAATTGACATTAGTAGAGAGGAAAATGGTTTAATAATCACCACGTGTTCCTTTCTTTCACCATTCAAATCTATGAGGGCCATAATAGCAAAAGAGGCTGCTCTATAAAATAGCATCATCCACCATGCTCAGTATTCACTGTAGACGCAACAGGAAATTTTGAATTCCTTGCGTTCCTTAATTTGAATGAATTTAAGAACATTTTCTTATTCATGAAAAACGAGCTTCCAACACCAGCTTTGAAATTTTATAATTCTATAATTTTAAATATTTTATCCAGCATTATTTCAAAAAGGAAATCTTAAGAAAGGCTACTCTTCTTCTGTTCAGAAAGTGAGATATGGCCCTTCCCCAGCATCAAAGTCACAAACCGGAACTCTTGGCCACCTTCTTCCCTCAGTGGAGAAGACTGAATGATGGCACTAACACTTGCCAGTATCATTTTCATACATTTAGTGGTTGGGTAGATAACATCGTAGATTTGGACAATCTACAATTGCAGTTTGGGACAAAGATGCTGTCAAGAACCCTGTAATTTGATGAAAGATTCATAAAGTCAGTATGGAGCAACATCCTCTACATGCATTTAAAATGAATACATTTGCCTGCAGTTAATGGAGTTGAATTTCATCACAAGGCTGTATAGATATTTGCAGAGGAGATAACTTGAAATGTATCATTTAAACTTAAATTCTGTGGTATTTATATGCAGCGAAAATTGTTACTTAATGCACTACAGTTAACTAGTTTTAGGAGAGACATTTTTCTTGTTGAAATTCCGTTTTTATATAAATTCACTTCAAAATTTGAAATCATATTCTTTTAAGTGCCTGGAGGTGAAAAGAAAGTTCGCAAATTACTTCCGGAACGTAAACCTGAACCAAAGGAAGAAGTTGTTCTGAAAAGCGGTATAGTATTTTTCAACCATTCTGTCAGCGTTAAGTATATTTTAAAAATGAACTTGAAAGCTTACAAAATGTTTCTGTCCTTTGGTTTTCTTTGAATTGGTTCGCTATTTATCAAAATTTGTTTGTAGTTTCATTGAAAATTAAGAAAAATGTCATTTCCAGATCTTTTTTTTTAAAAAAAAAAGACAGAAATTTTGTGAGCATTCACAGTATTTTGAAATTTAAAATGTTAATAGACATAACTAAGTTGATAATATTCTAAACTAACAACAACTATGACTGCCATTTTCATAACCAAATTATGTAGTAAAGTACACTAAACCTATTAAATACCTTACATGAAACTACTTTAGCTTAAATTCAATATTCAGTTTTAAAGTGTGACACAGGATCACCACAACTAATAAATAACATTTTTAAAAAACTGAACATTTCTTTCTGACTAATAAAATATTAAAGAATGAGAAACAAGATAGTCAAATGAAGAATTAAGTTCTAACATTGTCTTCACATAGAATTACTGATTTTTAGGCTACATTTCTTCAGATATCTCTGCTTAAGTAAACTTTCTACTTATTTACATACTCATTAAATCATTAACATTTAATTATTATTATAATTCGTTGCTATTCAAATTATTCATTTTGTGTTGGAGCTGTTTCTCCCACAGACTTGTCTCAGAATAGACCCTCTATCTAGATAGAAACAAAGTAACTTTGAGTGCTATTATAATTGACAACCTTTGATTTTAAAAAAAACAAAACAAAAAACACTTTCGGTGTAAATGCTTACTTTCCAGAGTGCTAGGTAGCATGCTTTTTTTCATTTTCCTTGCTTTGTACATTATTTGCATTTGTCAAGCTTATTCAACATCTTCATTAGTTTGTCTTGGTTTACATATAAACCTTTTTGTCTTTAAAGTTCTAAGAAAAAGACCTGAAGAAGAAGAACCTAAAGTAGAACCTAAAAAACTAGAAAAAGTTAAAAAACCTGCAGGTAGGAATCTCAGTGACAATTTGTAAGATTATCTTTTAACAAAATGGACATTTAACAAAAGGTTTATCTTGTAAACATAAATGAAGTTAGATGTAAACATGGCTTCATATTTCATCTGTGATGTAGTCTCTGTTTTCCATTGTCTGCTTTCTGTTTAAATATTTTTATAGTAATTCCCAAATCCATTCATGTATTTCCCTGCACTTCATTCTTATCATTACTTTGCAACTTAAGTTCTTCCAGTAGAAATGACTGAAATAATCAAGTGGCTATTCATGGGAGGGTGTCAGCAAAGGTTTCATAATCTGGGGGCTTTTAAATGGGTTGGTTTTTATCATTAGCCTATTCTCAAAGGGCAAAATTATTGGGAACTATTATAGAAGTGATTTAGAAGGAGAGAGCTAAGGGGAGTGGAAGATAAGTGGATGGAATAAAAGGAAGAAAAATAAATGGAAGCAGAGTCAAGAAAATAAAATAGAAATTACTTGATAAACTATAAGGTTTTTTAAAAAACCATCCATAGAGTTTTTGAAAAATAAATTGATATTTCAGATGAGGTGCTTCCTAAATATTCAAATATTAACACTGAAAAAATAATCTTATCTTAAAG
>TTN-209,,0,430,2199642,2200071,GTACAAATCTACTGTCATTCTTAGTTGTCTCTAAAAATGCAAATATGTATCATTTAAAATATCATTACACTGACATCAAGATTTGAACACATGACCTTAATCTGTTAATCACATATGGCTTAATTTTCTTTACCATCTCACTCTCCTATGCAATTGGCTAATGATTACTCAGTTGCTAAATAAGTTACCTGAAAAAAAATTGTATTTATGGGCAATGAGATAAATAACAACATTAAAACCAAGAACATTGCCTTACTATATTTTCCAAATATTTTGTTTAAAATGAAAACTAATCAAATACTTGATTTGATAATTATATGTATATAAATTCTAATATCTTCCAAGATACGTGGGCTTAATTTTAGTTTTGACTTTGTGAAAAACTTCAAAAATCCTGTAATAATCTGCCCTCTACTCTAAATTATTTCAG
>TTN-209,,0,259,2200072,2200330,GTGAGCAAGCTTATCCTCAATGTCAACAGCATATTCTTTCTGTATTCACACACATAACATGTACTTAATAAAAGATAGTAGGTGAAAGTCAGTATGTATCAAATGATTTCTAACGTCTCAAAATGCTTAATATACTATTCTCTTAAAAACTAGTTATTTGAAGATTTCAAAATTATATCAGAAGAGGCAAATAAGCTACCAAATAAGTTTTTAGGAAGTGACAAATTGATACACTAATGCAATGGACTTCTCTCTACAG
>TTN-209,,0,2279,2200331,2202609,GTATTTATCCTGTAGCTTTCTTTTTGCTAGTTTGTTTTGGTGACTTAATAAAAGTATTCACACTTGATTAAAATTCAAGCCCTGTTTATGCTGCAACATAGGTATCATTTCAACTTCGGAGGTTTATGGTAAGTTTCTACCTTTTCTTCATGTGATATCCTTTATCCACCTTGTCTCTTGCCCAGTGGGTGAATATTGTGCCTTAACTGGAATGTACGTTCCTGGGTTGCACCATTTCTTTCATATGCTTTGGAGATTAAGTAATGAATATGTTTGGGGCTGATAAAAACTAAGGAGACAGGCAGAGACCCTGTAAGGGTATACATATAAGAATCCCATGAAGCTTCAAATTTCCCTTATACCCTATTGGAACAATTTCTCTTTTTTAAAAAAGTGTGTATATTGGGATAATGTAAAAGTTCTGGAAATGGATAGTGTTGATGGTTGTACAATATTGTGAATGTATTTCATGCAACTGAATTGAATACTTAAAAATGGCTAAAATGGTAAATTTTATGTTAGGTATATTTTACCACAATAAGAAAGAAAAAGAAAAAAGAGACTCCATATTTCAGTCTTTTAATCTGTATAAGGAATTAGATCAATAATAATTTTCTTAAATGTTCTAACTTAATGATATAGGTATCTCAAGTCCAAACTTAAAGCACCTATTAATTGTATATGAACTATTTAGTATAGTTCATCATTTAAGTGATAATTTGAGATATAATTGATCAAAACTGATTTGATGTGTAATTGATAGTCATTGATAAACATACACATCCTGACTATTTGCCCTTTGGCTCACTATCTGGGTGATGAGATCACTCATATCCCAGACCTCAGCATCATGAAATATATCCACATAACAAAACTGCACATGCATCCCATGAGTTTAAAATAAAAGTTGAAATTATTTTTTTAAAAAAGAAACAACAAAACCAAAAATAAAACAAAGTAAATTTAAAGCGGGGGCGGTGGTGGTGGGGTGGGGAGAAGGCATGTATTGATAATTTTCTAAGATGTGAAGAATCTAAGATATTCAATATAATGCCTTGACAATTTGTTCCTATGGAAAAATGATCATCTCCACTGATAAAGCACAAAATAAAAAATTCAGGGTGAATTTAAAAAAAAAAAAAGAGAACTATTTGTTACATTCCACAGTGAGATGTGCATAGGCCCCGGGAATAACATTTAGAAATGTCCATAATAGTTTGACAGAGAAATTTTTTAATTTAATTTTCTGAACCTAATAATAAAAATTGGCTTATATCTTTAATAAATCAATAAATAAAACTATTTGGAAAAATTATATTATTTTAGATTATTAATTCAATAATTAGTCATTTTATATTTGTTTATATATTTTTATATAAATTATTTAGAAATTTTTTTATTTAAAATTATCTCAAAATATTTGGACATTACCATGTTTAATGACATAAAAAAATACACTATATTCTTTTGACTGTAGTTTAATTTTTAATATTTGTGTTATATTTTGTTGCTGATGTTTATGATTTGGGCATATTCTTTTAAACTTTTATAATGTCAACGTAGTACTTTTATTATTCAGAAAAAGGTGATGAACTGCTCTTGTCTAATTAAGTATGTATAAAAATAAAGCTATTCTCAGTTATCCTGGGGGCTGAAGCTAGAGAACTCATTCCACAGTTTATACTGTCCCTGTATTAATAATGGAATCAAACTCTAAATGTCAGAACTCTCTTGCTTCTGCCTTACTTCATTGTCTAAAGGAAATCTTCAAAGAAACTCATGCATGTGTGGTACATGGACTCTTTTTCCTTAGTCTTCCCTGGATTTGTTTGTCTGCCCAATTTAGACATAAAAAGAAAGGCTTTTGGTAACCTCTCAGCCATTTCCCTTTTCCCTACACTGATTTATTGACAAAACCTTATTTCCTTGGTTCACATAATCAGGACTTACATAAACATATAAAATATTTTGCACAGCTAGGCAGGAGCAAAACTTTTCCTCACAAGGCAACAGTAAGCCTTCCAAAAATGGGAAGATAATAAGGCACTTGCTGAAAGAAGTTGTTAATCCTAAATATGTTGGCAGTTTAGCTTGAGCTCTTCAGTCTCAGAATATGCCTTCCTGGAAATGTGATTATCCATAGAAGTCATATAAATGAAACCAATTTCTCTTTATGCGTTAATATTTATAATGGAGCATGACTCACCCTCCATGGTTTACTATTAAACATGAAATAAGTCCGAAAAGTGTTTAAATGCTGAGTTTTATTTTTATTTCAG
>TTN-209,,0,569,2202610,2203178,GTGAAATTCATTTTTCTAGTACTTGCATTGTAACCTTCCACTCTGAATTTCCAAAGTTCATATTCAAGGGGAAAAAAATTTCAAAATTCATAACAATTTTTATTTTTTCTAATTGATTCTACTAAAACTAGCATGTTTTCTGATATTTCAAATAATACTTTTAGTATTATGCAAGGAGATATATATATATATATATATATATATATATATATATATATATATCCAACTATATTTTAGCATAGTGAATCCCATAAGTTCTTAGCTTCATTTTTCATATGCATGGTATTTATACATGGCAGATAAAATAATTAGACATTAATCTGGCTATTTTATACTTCAGATTAAAACTTGAGAAAAGGGACATTTATTATTCATGGATTCCTTATACCATCTCATTTTCCTGCCTGAAACAAGGCAGTATAAACTCAATTGGCCTTTCAATTGCCTGGTCTTTAGTTTTCTCGTCTTCTAATTGCTTTACGGCTGGTTTTATCCAGCAGGCAGCCAAGTATGAACTTTCTGACTCCTAAGGAGATGCCAAATCAACTTTTTATTTTACTTTGAATTAG
>TTN-209,,0,156,2203179,2203334,GTAATTTCTAGTCTTCTGAACATAATCTATATTAAACTTTAATGTAACAAACCTTAGTAGCAACTTGCATTGTAGTTTTACAAAACCTCTTATTTCCAAGTTTTATTTCATTGAAAATATTGTATTTATTGAAATATATACTGAAATTCTCCATAG
>TTN-209,,0,247,2203335,2203581,GTTAGTACTTTCCTGGGAGATTTCGTTCTGCTTATTGTTACACTAAGAAAATGGAAGAAAGGACCTCGTTTCCCAGTATTACAATATCAGAAATCTTGTACCTAAGAGGGGAATAACAATATATCCTACAGTGGATTAATTATGCCCAGTATTGTGAAATTTTTCCTATTCCTGAAATTTACTAAGGAAGCTATGTATATTACTTGTTCAGACCTTAATCATTTTTTCTGATCTTATTTTCATATAG
>TTN-209,,0,135,2203582,2203716,GTATAAAATCTTACCTTTTATTCAAATTATAAGTTTTGCGTATGTGTAAAGCCAAATAACACACCAAAACACATAAAAGCAAAGCATCGTTGGGTTGTCTAAAGCATTATGTTACTTCATCCCTGACCAATACAG
>TTN-209,,0,315,2203717,2204031,GTGAGTAATTTCACATTTTAAATTGTTAGTCATATAAAATAACCACATCCAATATTCAGGATCTATATCCTAGATTCGGGTTGCTTTAATAATAATGGAGTTAATGGAGTCTTCTAAAGTCTCCAAGAAGGAAAGAAATTTTACGTATCATTTGGGGACAACTTGAACAATTTGTGTAAAATGTTATGACAGGGAATTCTCTGCTTACTTTTATTAGTAGTAATTTTTAAAACTCTATAGAAATTTGTATCTGAAACACTTCTCCTATAGGGAATTTATCTCTTTCAAATGGTTACTAAAACTATTGTTTTTCAG
>TTN-209,,0,93,2204032,2204124,GTATGGGGCTTTTAGAATTTGGGGAGGGGTCTCAACTTTATTTCACTTCCCTGTGCATTCTGAAAAGCCTCATTCTTAATGTCTGATTTTCAG
>TTN-209,,0,282,2204125,2204406,GTAAGCGAGCTAATGAGATCTGTGACATCCCATAAAGGCATGCAAATATATGACTTTAAAGATAGGACGCCAAGTTCTAAAAGCTGTGATAATGCATCACTAATTAACTTTCACAGTGTTACCAAAACAACCCCCCTTAATTTGTTTTTAGTGGAGCTCTATTTGGAAAGATGAATAAATAAGTGCCATGTGAAATGGGTCCCTTTTACTCAGGCAGATTAGAATGGAATCTTTCTGAAGGTGAATTGTGTTTCTGAGGCATTATCTATGCTTGCATTTCAG
>TTN-209,,0,140,2204407,2204546,GTAAATGTAACCAAGTATAACCAGATAGCCAGTTTCTGAATCATGGGAGTGGGGAGTAATAAAATATTTTGCAACCTTTTACTCTTTAATAAACTTTAATTTTCACATTCTTCTAATTTTATGCTAAATGTCTTTTACAG
>TTN-209,,0,86,2204547,2204632,GTGAGTTGCTCAACAATGTAAAATTTACCCTATCTGAATCTGCAGTTTATTAGTTCAGTCATGCTAACAAAACTGTATCATTTCAG
>TTN-209,,0,142,2204633,2204774,GTAAGTCAAGATTAGCTAATTATATAGGAGAGGGGTTGCTTGGTTGTGTAGGGTGAAAAAAGGCATAAAATATCTTGATGATTTGTAGGAATAACTATATAAATGATGTTCTTTCTTTCCTTCTAACCCTCACTCCAAACAG
>TTN-209,,0,125,2204775,2204899,GTATGCTCTACTTGTCAGCCACGTTTTTGTATTTTCTCTGCAAGACTTCCTGATACACCCCTGCATTGATCAAGGGTCATCAATGGAAACGTATTCTGACTTCATCCACTGTCCACTTCTTTCAG
>TTN-209,,0,112,2204900,2205011,GTAAATAGTTTTATCAAATAGTCCACCCCAAAATCATTTTTTTTGCCTTTAGTTTTATATTTCTTCTTTAAAGTGCTTCAATTAATAAGTTCTTTCTTTTTTTTCTTGATAG
>TTN-209,,0,846,2205012,2205857,GTAAGTGCTTTTTAAATTTTAATTTTACTGCATTAAATTCAACAGAAATTTGTGGAGTATCTATTCTATAAAATAGTCTTCTAAGTGTTATATTGCATGAAAGCAGCCCAACTCCTTAAGAAGCTATCACATATGTAATCAGGCTTATTTCTAAAACACTTTACCTTCATTACTATAAGTTAATGAAGATTCTAGCTTACACCCACAAAATAGCCAATTAAAAGCCAACTTAAAATTCTTCATTAATTATTGAGCCCTGTCATGTTTAAAATAGGAGTATATAAATACTTTCTATCTCTTCATTTTATCAAAATTATTTCAGAGGAATGTTTTTCAAGTTTCCCATAAGAGAAGATATTACATAATTTACATTAATAAGCCTCATTGTTTTTCTTGGCCACCTAATATCAACAAGATTAAACATGAAGGCTAACATATATAGACATGATTAAAGGCAAACTATTAATTGATTAAGAAAAACTAACAATGTGAACCTGAAAGCTTAAAAGTAAACTAGACATAATAGAGTTGCTAAGAATTAGAAATTTACCCAAATAATGGAGGAACACAAAATTGTATTTGAAGCTAAATTTCAGTCTTTTTAGCTACTGTTAATAAAATGTTTCAAAATTCAATATGAATGGATTAGATCTTGATAAATCCCACACACTGATTCCCTTCCTAATATTTAGAGAACTTTTGAACATAAACAGGTTAAATGATTGAACACTTGACACAATTTTAAAAGATACTCAGAACTCTGTGAGTTGTGTCTTAAACTTTCCAAGAGATTGTCATTTCCCTAAGGTGATTAATAAAAGCTTTTCACTTATACTTTACTTGCAG
>TTN-209,,0,90,2205858,2205947,GTAAGGAAATTTCCATGAGTTTCACTCTTGAAGCATTGGGGTTATTTGTGCCAGAGGCTAATGACCCATGCTGGCCCTTCACTTTTCTAG
>TTN-209,,0,436,2205948,2206383,GTAAGGCTATTTCTGAACTTGTCAACACCTAAAGGAGCTGTGTGAATTAGAAAAGAACAGGTGAAAGTCAGAGTGGATGCAGGACATTTAAAACATGATAGCAGTTTCTCTATCAGACCCTAAGCCAAAGAGAGATGTCAGGGTCTATGAATGGGCTCAGACTGGCACACTTGCATTACTTTTGATCCAGCAGAGTGAGTATAAGGTTGTAGATACTCTGTGATGCTGCTAGTTGGCTCAGAATTATACAGCTAAAATAAATGTGGCTTTCCTCTTAGTACTTGTAAGCTTTACTTCCTAAAAAAAGAGCTCAAAGTTATATAAAGTTTCATCACCATTTATTTGTTGCATTCCTTTAATTAAGATAATCTATCCTTAGAACAAAATTTCAAAGAAAATTATTTTCTATGAAAGTTTTTCTGTTTTGTTGGTACAG
>TTN-209,,0,797,2206384,2207180,GTAAGTATTGTATATTTTTCAGGGAAATTAAATAAACACTTTTTCAGAAAATGAATGTGAGTGAAATTAATTGGACCTATTTTATTAGTTAGAAAATATTATTAAAACACAAAAACTGGCTCTCTTGTATTTGCCACTTTGACATTCCAATACAGAAGTGGTTCAAATCGTAAAGTTTTGGAAATTTTGTTGACCTTGCCATTTGAACAAAAGAAAATTTAGCAAATCAGATTTTCCTGCTCTGTAGTCCTCTCATTGAAAGTAGATACACATACAATGAGAATCTAACTCAGAACCCTTAAAGACCACTTCCCTCAAGTGGCTGTGCAACTAGAGCACCAGAAAGACAAGCTTTGCTGTGTGGGCATTTTAGATTCAAGAAAGAAGGTGGGAAGCATTAGGCTAACGTTTCTGGAAGGTGCAAAGTGTTTGATGGATAGGGACAGCCTCTGATTGAGGGCCCCTTGTCCTCTCCCAATCAGAGTCTTAGTTATTTTGGAAGTCACATACCTTATGTAGCAAGAAGAACTTGACGCCTGGCAGAGAGACAGATGCAGCACAGATTTCTCGCTGACCTTGTACGTCAGAACGAAAGGGCCCCTACATATACTCGCTCTCTGGCTACCAGCTCTCCCCTTCTCAGCGCCGTGGGGCCACGTTCACGTGGGAGTTAAAATAGTGGCCAGTCCTGTGGCTTCTTGAAGAAAGCAACCATGAAGATTCATATCTAAGTCTCTATTTATTCTTTTGGGATTACAAAATGAGTAACGCAAAGCTGTTTCTTCCCTCTCGAAAAG
>TTN-209,,0,3904,2207181,2211084,GTAAAAAGCAGGCATGCCTTGTCTTTCCCGTTCTTTTTCTGGAGTTCTTCCACCTTCACTTGTATGTTCCTTATTCTTTGCTCTTTCTAATGTCTCTTCCTCTGTCTTTGCCTTTCTCTTTCCGCCTTTAGCCTGATTTCTGCTGAAACTGTAAAGCCAATTTTTTGCATTTTTTCTTAGGTTTAACCTGATGATTTTTTTATTGAAATTGAAATAAATTTAAAGTATGATCATGTTTTAGTTTTTTGAAGAAAAGACAAGACTCATTGACTATGAATGATAGTTTGATTAACCAGAAGGCAGGAAGGATCAAAAAGGCTTTCTGATTGCACGCTCTGCAGCCATGGTGCACATTAAGTTTTAAGACTAACGCTCTCCATCCTATTTAGTGTTCTGCATATAAGGGGATTAAGAGGAGAAGACTGAAATTCCATTTCGGGCAGTTGATCAAGTAGTTGAGATAACTTCTGGGCAGATTTGCTCTTCAAGCATTTCTCCAAAGCTATTTTTAACCTTCAAGTGCTCTGGGCTGTGCGATATCTGGAATGCAAGTGGACTATTTAAAGTGCAACTGATGGTACTGACAAGAAAGAAGGGCTCTGTGGTTATCCACATATGTGGATGAAATATTTTTTTTAAGCTTTGGTAAATAACTAGCTCCTGCTTTTAGCTTTTACTAACATTCTTTATGCCCAAGATTTTACCCATAAGTAAAAACTAAGGGATTATTCAGATAGGCCCACAATACAATTTGCCTAAATTGATCTATATGTTTTGTCCCCAGAAACAACATATGTCTTTAAATTATCTTGACAATCCATCATTAATTTTGAATTCTTAAAATAAAATATATGGAATATGTCCAGCCTGGGTTGGAAATAAAGCACAGGACAGTACATTGTTCTGTGACATATTCCCCCAATATTTCAGAAATACTATTAAATGTGCTATAAAGATCTCAACAAAAATCAAACTTTGAAGACTTAAAGGAATATAATTAAAAAGTGATTCAGTTTAACAAAAAGCCACAGCATTGACTGAAGTATTTGAAAGCAATGCCTTCAAGTAACTGCTTTGAAACAAACAAACAAACAACAACAACAACAACAAAACTAGTATTCCACTAAAGTGATTACAGGGTAATTCACCAGCAGTCATCTGATAGGTAACGCCTGCCTGTTATACAGATAATAAGATCTTCTTGGTCTCCTTTTCCAGTGACCAGAAAAAGCAGCAGTACATTCCATTTGTAGCATGGGAATTAAGTTACATATCACAAAACCTTCCTTACAATGAGGTCTTCTAAATATTGAACTGAGGGAGGCACCTCTACCTTCAAGCTTATTGTTTGAAAAAATATATTTTGCCTATCATGCATGATTTAATTAACTTCATGTCTAAAGGCAGAGAATTGGTTGCTTTTTCAAGATTCTTTCTAGATCTGCAAATTCATGATTTATATATAGGAACACTGCTTAAAGACAAATGATATTATTTTTTCATTACCAAATATCTTTTTGTCATAGTAAGAGCTTCTTATTAAAAGATCAGTCTCAGTTCTAATACAAAAACTGCACTATTTTAATTCAAATGTAGACTCCTAAAAATCTTATTCACATTTTATTTTTAAAAAATTCTCATTGTAACTAAAATTTTTTCTAGGGTTAGAAAGGATCAGTTTACTATAATTCTATAGGGCCCCTTTACATCTCTTTTGGCATAGGAATTTTAATCCTTTACTCTAGGCACCCGAAATACCTTAGCCTTTTGTGAACTTGCTCTTGCATTACTTAAATGTCTCTTTTCAAAAAGAACTTAAATATAAACTTTGAAGTAATAAAATCATTTTGTTACATGTGGCAGATTTTGTTTAAATTAAGTCTGTCAGAACAAACTTGCTCTTGTCAATGTAATTCCGAACTTTAATACTCATTTTATGTAAAAATTTTCGCCTTCAAAACTACAATAACCAAACAAGCAAAAACAAGCTGTAGGAATAGGAAATATGAAGAGAAACTTGTAGACATGAGTTGTTTGCATTTTTTCTTTGTTGTTGTAGTTGTTTTTGGCTGTCAGTTTAAGAAAGGACTGCCAAGTTCCAAATGGCATTTGATAATTTTAAAGTTAAATTTTAAATTTGATAAAATTAAAGTTTAAATACAAAACTTTAATAGTTTTGTCATGGTCATAAGCCTACCGTATTATATTAATATGCTTCCACTATAAATAAATATTTTTAAAATCTCTAACATTATTCTTACAATCTACTGCAAAATCTTCAACATTCATTTCATTGGTTTATTTTTATAAGGCACCTACCAGTTTTCCTTTTTTTTCTTTTAACATAGTGGAGGTAGATTGTATACAAGCTGTTTATTGAGACATACTGCATTCTGAGCAGTGTCCTAGAGTAGCTACAGAGGAACTCAGATGATAAAGCAACATAATATTAATAGATAAAATATATCTGTGGGTGGGTTAGAAACTGAGACACCTTTTCAAATAGCCAAAAGTTGCATGCCAAAATTTATACTGAAATGTTATTAAAAAAACAAATTTTTCCCATTTCAGCACCATGCCCTCGGATAAGTAGCTCTGTTCCAAGGGCATATTTAACTACCCCCTCCTAGCTGTTATTTTTCCTTATTATGTTTTTTGGCCACTCTCAATTATTAAGATAATTATGTGACTAACCATGCCCAGTTCTTAATTAAAGAAAACACTTTTAGATGAAACCTTATTTCTGATTCTTTTCTTTACACTAGCATAACAAATAGTTCCACTGGTGAAAAACTTTACATTATTTTTAACGCTAAGTAAACTCTTAAGCAGTGCAAAATCAGTCTGGATGACAGGGCACAGCTTCTTAGGAATTTTATATCATAGAACTGGAAGAACCCCCAAGTCTCTTATCTTTGCTGTCAGAATGACCCCTATCTGTCGCACCATTGACATCTGATTTTCCCATTCCTGATGCTTAGACACATGAAAAAGGAAGAAGAGTCCAACTTTCATTTGCAGTTTTGAACAAAATTAATAGGTTGTACAAATTATTTAATCACAGGTTTAATTGGTTTGCAAAATAAGTTTAATTGCTAAAATAAATGGGAAGAAGAGTTATAGCTTGTTGTTGCATGGCAAACACCTTACATACAGAACATAAGGTTTACTTTTAGCTTGCCATAGCTGATATTTTCTTTCATCCTTTCATGAATTCGCTTTTCTAAGTTCTTCCTTTATATGTATATAAGCCCAGGGGCAGAATGGGGGCACACATATATATACACATATACGTATATACTATATGTGCTGTATATCTACGCATATGCAAAAAAGACCACAAATGTAAACAGAAACTGGCCTGGGCAATTTCAATGTGAAAGGCCACCTAGTAATTATATAAAGGTAACTATGAAACCCTAAAATTTTCTTGAAAGATCCCAAACTGCATAGTATTCCATGGTGTATATGTGCCACATTTTCTTAATCCGGTCTATCATTGTTGGACATTTGGGTTGGTTCCAAGTCTTTGCTATTGTGAATAATGCCACAATAAACATACGTGTGCATGTGTCTTTACAGCAGCATGATTTATAGTCCTTATACCCAATGCTAGATGATGAGTTAGTGGGTGCAGGGCACCAGCATGGCACATGTATACATATGTAACTAACCTGCACATTGTGCACATGTACCCTAAAACTTAAAGTATAATAATAATAAATAAATTTAAAAAAAAGATCCCAAACTATTGGTTGAAATGATTTTTGAATGCATACGTGCTAAATAGATGATTATAAAACAACTTGGAAAGCTCTATTTCCATTTATTTTTATCTAAATGAATTAAATGCACCCATATACTAGATTGCTGTTTCATGTATTCTTTTTTTAAAAACAACTAG
>TTN-209,,0,541,2211085,2211625,GTAATTACAAGGCTTATTTTAAAAACATGTATAAGGCAGAGGCTCATGAACAATGCCAACTCTCAATTATCTTTATATGATGAGTACTATAGATGTTTAAAATCAACCAAATAATCAAAAGTCTGATTTTACTTTTTAGCATAACAAAATAATTCACAGACTATCTTTTTAAAGAGCCAAAATTGACTAGCATAGGTTTTACTTCCTCCTTCCATCTCTATTGTTTTTATTGCACATCCTAGATTTTCAAAAGCCAGCTGGAGGAAGAATTATTATCAAGCTAGGTATCCATCACTTTATTAACCAAGAGTTGGCTGTTATTTCCTTAATGTTTCCTAGTTTTTAAAAATGATTTTCCTCTTGTCTGTACAAATAATGATAAAATATCATTTTTAGAGGAAAATGTCTGAGTGTAATCAAAACTTGAAAATAAAACTTAGGACAGAACAAAGCCCTGGAGATGGCAGGGGAAAGTTGAGAAGGTACCAAAACTCTTGGAGAAGGAAAGGAGTACCTTGGCTAATGAGTATGATTCTTTCAG
>TTN-209,,0,1697,2211626,2213322,GTAAGTATTCTTCTTACAAAGGACTTTTCATTTGCAATTCTTTAATAACTACAACAACAAAACAACACAACACTTTTTGCATGCCCTTCTTGGCCTAACTGCATTTCTTGGCAACTTCTAGTATTGACACTGACCTAACCTGATCCTTTATGTGTTTAAAGAAAAAAAGAAAAGAAAAGTCTTATTCTATGTCTGGTCTGATTAATGATGGAGCAATCACTTTTCCCTATGCTTCTTTTCTCTCACTGAGTAGTGAGTAGATGTGCTCTTTGTCTACATGGGGTCAGCCTACTGTATGGATATCCTGATATGGATGAGGAGAAACTGAATTTTAAAGATAAGTAGGGAGTCCTAATTTTAAAAACAAAGTAAAAGTGATTTCCATGTGGAAGGAAAATGAATTTTCAGGTGTGGGGAACAACTAGAAAATGAGCATGAAATTTCAGTCTGAATAGGAGCATACTAGAGATCTGCTGTAATATGACAAAGCACATTCACATGATTCAATCTCTGAGAATAAGAATGGATAAGAAGATGGAGTGAGGCCCTGGATCTTTTGAGTCCTGGACTCTTTGAATGAAGAGAACTCTAATGGTTTTTAACATTACTTCTTCCTCTGGTGAAAAATGTAATGTCTTTTTTCAAAATGCCACATACTAGCTTATTTGTTTCATTCATTCCTTTGTCCAGTGATGACATTTTTCTGCAAATTTTTTGTGCAATATTTGTTTGTTTGGTTTGGTTGCTTCCCATCTGTCAACAGCTACAACCTAGTGACTCTGTGCTTCATGCATCTTGTACCATGTTTTTCTTACCACTTTGTGGTTGCTCTGCTCAAGCTTATGTCAAAGTAGCTTCTTGGGTCTCCTTCTTCACCTTGACATCTACCTTCACTCCAAGAAGGCTCAGCTGCAAGGAGCATATTTTCAAACCTATTAGACAGCATTTGTCTCAGAATCTTATTGCTCAAGAATGGTCATCTTGGGAAGGACTCACAGGGAGCTCTGAAAGAAGGAAGGGCAAGGGGGCAGCTCCCTAATCCTATACACCAGCTGAATTAATTCTACAGATGAATGAAATAACAGATGTAAAATCCTAATCACCCTCCCATACAAAACACATTGCTTTATTGCACTAATAGATGTTATGCCTGACTTATATGTGACGTCTTCAAAGCTGATTTTTTTAAAAAGCTAAATGTATGTTTCAATTACAGCCTCATGCCTCTTAGCCATACACAAGGCTGGCCATAGTGCTTCACGTGTTCTATCTTTGAATTCTGCTAATTTCTCAAAGATTGTGCTAAGTGCCTTAAATAAGACAATGTTTCTTTGCCACTGGTGTCTGAAGTTTCCTTTGACATTATCTTTCAAGTCTGGTGCAGTGCAAATGAAGATTTTTCCTCCAGCTATTATTCAAAAGAACTGAGATGGCTCCCTAGTATATATACTGTACACACACACATGCACACTAGTTGAACATATAGAATGCCACATAATTTTATGTAAACTAAAGAGATATCTAAAAAGCAAAGCATCATACCTGATGGGCAGCTTCAAGTGATTTCAAAGTCAGTTGTAGTCTATTAAGATGGAAAATCCCTAAAAAAGAGTCACTTTTTCTTAATGTATACTATGGTAATGTCAGAGTAAATTTCCAGAAACCTCATTTTGAATTCTGATGACATTCTCTTACAG
>TTN-209,,0,661,2213323,2213983,GTCTGTGACTGTATACCTGTCATCTTGTACTGTCAAATAACTTTATATTTACTTTTGGTCTAGCCAAAATGGAAAAAAAAAAGTTAGTCACAACTTCTCTGGTCACCACTTTACTTTTAAAGATAATTGTAGTATAAAATGTATTCTTGACTTTAATTGCTCTCTTTTTAGTATTATTAATTTACTATTACTTGAAAAACACTGGACTCACAATCAGGAGATTTAGATATTAGTTTGAACCATATGAAAGTGCTGTTTTCTTAGATCAGAAAGTCAAATATCAGCAATTATATTTCTTTCAACTAAGTACCTCCTGTTGCTATTAACTACCATTGGCAAGTTTCTTCAAGTCTGAGCCTTAGTTTACACATCCAAGAAGTTAGTCTGCATAATGTCTAAGGCTCACTATAGCTCTAAACTTATATGATCCCATTGTTTTTAATAACTGATAATAGTATCACAGCAGCTAACTTAACAGTAATTGGTAAGATTGTTCTTGCTTTTGGGGTTTGTTTATATTTGTGTCTGCCACCTTGGTTCTTCTTCACACTATGAAGTCTTGTTGGTTGCTTTCAGAAAAACTCAGGATCATAGTTTTTCTTAAGGACACCTGTGTGAAGGAACAACAAGAAAACTGATAATCTATTTATCTTAAATATAG
>TTN-209,,0,98,2213984,2214081,GTAAGAGTAAAGTCATTCTTTGTGAAGTATATGTGTTGGGAAAAAATAATAATTTCCAGCTTAACTCAATGTGGTTTTTGTTTTTTCAATGCTTGCAG
>TTN-209,,0,106,2214082,2214187,GTATGAAAACTACAGTGAATAATCTTTTATTTCTAACAATTCACACTTGCTAGATTTAAAGTACAAAGACATATGTTTCTAATATCTTGTAACTTTTTCTTCCCAG
>TTN-209,,0,108,2214188,2214295,GTAAGTTTGTTCTTGCTTTTAGGGTTTTTTGTTTGTTTGTTTGTTTTGTATTTGTATTTACCACTTTGATCATTATTCATACTATAAAGTCTTGTCGGTTGCTTTCAG
>TTN-209,,0,89,2214296,2214384,GTAAGTAATTTATATACCACTAGAGATTTTTTCATCAGTTTCTGTTATAAAAATAATTAAAATCAACATATTTTTCTCCTTTACAACAG
>TTN-209,,0,104,2214385,2214488,GTAAGCAAGATCTTTTTATTCTCTATTTCTGTAGCTATATATACACTTTTGACAATTTAGTGGCCATCATTGCAAGCTAACTGATAATCCAATGTCTCCTTTAG
>TTN-209,,0,100,2214489,2214588,GTACATATTAAGTGAAAAAACAATTCTAATGTTACCAATTTTTTAAAATTGTTAATCAAAATGTAAACATATTTGTATTTATTTCACATTTTCTTTCCAG
>TTN-209,,0,767,2214589,2215355,GTCAGTCCCTTTATTTTAAAATATCCTTCCAATATCACAGAGTTTAGATTTCAGATTTCACAGTTATTTAATGAGGTAATCCTTGTGAGGGTCTTTCATTTCTAGCAAGCCCTACCCACATGTTAACAACTCTAATTTTGCTCACTACAAAGTAAGTGTCTTGAGTAAGAGGAAATTAATAGCAATAATCTTTACATGCCAGAGCCTTGGACAGTTGCTAGTACATGATGACTATTTATGAACTTAGGCTACAACTAAGCTATCACCCTGAGAGTCTTGGCAAATCTAAAGACGGTCTTATACTCTCCTACTTTACAAACCCCTGTGTGCCTTTTAGGTATGTTCTCATCCTGACCCAGGACATCCTTATACACTGTCCTTATGAAAAAGCCATTAGTGTACCTCTCATTCATAAGAAAAAAGTTTCTCTGATTTATTGAACTAAGTATGCAGTGCCTACTCTATCAAAAAACAAAACAAAACATGTTTTGCACTACACTGAGTCCTATGTTACTATTTTTGGCAAGGAATGCATGTCTTATGATTTTATGCCATTCTCAATCCTCTACTCTCCAATCTAATTTGCACGCACAACAACAACAAAAAGCTATGAGAACTCTAAGCCACTTAGTTTTCTCTGCTATAAAGTTACTGTAGCTTACTTCCAAGGTTATGTAACCAATATTTTCTAATAAATGCATAATAACATGATGTAGCTTGGCTACGTTTAATAGTCGAAAGCGTTCACATGTTATCTTTCTCACTAG
>TTN-209,,0,92,2215356,2215447,GTAAGCCCTTGGGTCTCTCAGACTTAATTGGCAAAGCACAATTTAAAAGCAAGACAGCACACTAAAAAAATTCCTCTATATGTGAATTTCAG
>TTN-209,,0,107,2215448,2215554,GTAAGAAGTTTTAAGTAAATTCAAGTTAGCTTTTAAGTAAATTGCAGTCTTTGCCTTCATCATCGTTACCCCAAACTCATATTTTCTTCTTCTGTGGTGAAATCCAG
>TTN-209,,0,266,2215555,2215820,GTAAGCCCATCAAAAAAGGGAAATAATTACTGCATGAAATCCAGATATTAGGCCTATCAATTAAAATAAATCAAGTTAAATGAAAGTTAATAAAAAGGTAGAATATCATAAAAATTTGGATAAAGTTTTAGAAACCCAGACTGTGCCTACTTTACTTAGTGAATTTGATAAACCTGTTAATGAGGATGATATAATTGATTACAACACTGTTTTCATAAATTGTCACTAACGTAAATGGTATGCTCCAACTCCTTCTTTTATTCCAG
>TTN-209,,0,90,2215821,2215910,GTAGGTCATTTGCATATAAAAAAGAATATTCAATGTGGATCATGGACATAACTGTATGTGTTTTTTACAAATATTAATTCATAATCGTAG
>TTN-209,,0,106,2215911,2216016,GTAAATAGATATTTTATTTTTAGATCGGGGAATAGCACATAGCTACTTTGGGGCAACAGGGACTTAAATATGGCACTGCAAACTCATTAACTTTTCTTCTTTGTAG
>TTN-209,,0,98,2216017,2216114,GTAAGGAACAAAACATTTATCATCTAAGGTGATTTGGCAGTATTAACAAATATTAGTTCAGACTATTAACAGTGACTCGTGAGTGCATTTTTTTTCAG
>TTN-209,,0,690,2216115,2216804,GTGAGTTTTGAGCAGCACTGCATCAATGCCAAAAATGAGAGTAGGGGAAATCCCAGAAGGTTGGGATGCCATACAAAAGTCTTATGTGCTACAACTTCTTACCTTTACCTCACTGAAAATGTACAAAAACTTTTTAAGAATGCATCGGTGCTAATGCTTCCTGAGGTAGCTCAACCAAGGATTGTATAATTGTAATTGTCTTGTCTTGTGAGCCTTACCAAATTTGTAATAAAAAAAAAAATTCCCTACTGACTTGGTACCTGCTAAGTACCCAATATGTACCCATTAAGCTAGAAGTGGAAAGTAAATATTTATTTCCCTGGTGGTCACACTTCTTATTCCACTAGAATACCTTAGTTGACCTAATCAGCCATTATTTCCTTGTGTTTATATTAGTTACTATTCTTTACCCTGAATTAAAATCATATTTCTGATAAGCAAACTGGTAGAATCAACACCTCATTTGCCATCTTTTTTCATGTGTACAAACTATGAAGCAGTTTTTCTTATATTGAGTCAAATATTATCATGTATCCTACTTTGCAATTTTCCCTAATATGAAATTAATGTAAGAATAATCCCTAGCATTCAAAACAACTGCAGTTTGTATCCCTGGTCATGGTAAAAATCTTTTGGGTTGGCGAAAGGGTTTTTTGGAAATAACTGATTAACTGTATTTCTTTGTCCCAG
>TTN-209,,0,156,2216805,2216960,GTGAGTACATTCTTGATGATTTCTTACCTAATCTTGTTGCCTGTTTTTGCTTTTAGACCTAGAGTTGAAGTTATGGGGCAAGGCAGGGGTTGGCAATGTGAAGAGAACTGCATAGGTGGCCTGTGTAAGACTGACTCTCTCTTCCAAATGTTGTAG
>TTN-209,,0,338,2216961,2217298,GTAGGTTTTTAATTTGGCATGAGAGTAAATGTGTACTCCTAGTCACTAAAATGGGCTTTGTTGGGGAAAATTTAAATGTTTGTCTTTTTTCATTGAGAATCCTATGCTGCCGGTGTATCTGTCTGATTTTTAAAGGTGCTGCTGAATGTACTGCCTGCTCAGGGTTTTCATGACAGTATTGAAATGAAAATGTATTCAGTTATAGTGTTGAAGTAATCCAGGTTTAATTTAAAGACTAGTATTATACCAGGGGTTTGAATTTTTGAAAGATTATGAGTACTACACAATGAAACGATTATCGACATCACAGTAAAACATCCTATTCTGTTTTCTGACAG
>TTN-209,,0,93,2217299,2217391,GTATCTATTTTTGATTTTTGTCTTATCAAATAGGCCTCTGACCTTAAATCTGCTTGAACTTGATAACATCATAAATAATCTTTTCCAATTCAG
>TTN-209,,0,117,2217392,2217508,GTAAGGAAGGTTCTCATTTTAAAAGGGGATAAACTCTTTGCAGTTACTTTCTTGAAAGAAAAAAATAAAAAAAATGGTGAACAATTTTTTTTTCTGCATCTGTAATGCCATACACAG
>TTN-209,,0,114,2217509,2217622,GTAAGTTTCTCAATCAGCTGATAAAAAAAAAAGGATGCTTATGTCAAACTTGCATTTTGGTGTCATATTTATATACAGGACATATAACATTTTACACCATTATCCTGTCTATAG
>TTN-209,,0,474,2217623,2218096,GTATGCTCAGAATCCCCATCAAGATGTTAAGACAGCAGTATATTCAAATGTTTACTCTTTAGTATTCCTTGGGATTACAGATGATTATATATTACTAAAAAAATTTTAAACTACTTTTACTCATATTTTCTATTACCTCATAATTTGAAAAATTATATAAATTCCATTCAAGGGCACATTTCTTAGTTTACTCTAAAATATTAACCTTCAGGAAGTTTCAAAGTGTTTGATCCCCCAGTATATTATGATAATGACCACTGTCATAGATATTATAATTAGATTGGTATGTTTGGCCCAGTCTAAAGTGTGTGGCAGTTAAAAAGCAATTTTTAATTTATATTGAAGTGCTTTTCAGTTAAATTTCCAAATCACCTTTTCACAATTTAAATAAATTAGTCTCTTCTGTGTAAAATAAACATAGGCTTCTTCTGCTTCTTACCATGATGATACACATGCACTTTGTTCCTAATTCAG
>TTN-209,,0,88,2218097,2218184,GTATTATTTATATAATTTTTGTGGTTATTTCGAAGTTCATATGAACTCCTTTTTGACAAACCTAAACAATGATTTCATTGGCTTGCAG
>TTN-209,,0,196,2218185,2218380,GTAAGTCACTCTTGATGTCTGGGATATATAAATTCTTCTAATATCTGCCTGTGAGCTACGATATGAGAAAATATGAAAAATTCATTACTATTATTTCCTCCTGGCTACATTACTTCTTAATGACTGCCTGCACTTTCAGACTGACTATTGGGTAATAAAAAAAAAAATGAATTTGTTTTCCTTCCTTCTTTTTCAG
>TTN-209,,0,114,2218381,2218494,GTATGCTCTTGCACTTAATCTTTGTGACAATAAGTGCTCTCGCACTTAATTTTTGTGACAGGAGATTATCACCTTTCCTCTGGTTTTCCTAATCATTGTTTATTTTATTTTCAG
>TTN-209,,0,102,2218495,2218596,GTAGAATTTGAATTAATTCATAAAGAATAACTTACACTTGGCTGCAAATTCTTAACTGTGTTTTTTCATTAATGCTAATGAAATGCTTTGTTGTTTCAATAG
>TTN-209,,0,80,2218597,2218676,GTAAGTAGTGCTGATTATACACAAGATATTGTCTAGAACTTGATGAGACTGTGGATATGAATATTTCACTCTTTTCTCAG
>TTN-209,,0,100,2218677,2218776,GTAAGAGCACAAGGTCTTTTATAGTTAATAAAATACCCTTTATTCATGCATTGCATTTTGACATACTCTGTTTTTTGCTCTTTTGAATGATATCTTACAG
>TTN-209,,0,603,2218777,2219379,GTAATCATTCTTTGAAGAAAAACCAGACATTCTTCACATGTAGAGGAAATTAGTTAACTTTGCAGTGCTATTAATAATATAATTGGCTTCATGAACTGGCCACTTGTAAACTAAATGTCACTTCTGATTATGTCTTTCCATAGGAGAAGTAAAACAATTCTAAAGAGATGAAATCGCTAAACGCTTATTAGACTAATTTATACTAGTTTTAGTTAATTGCATGTGAAATACTAATTTAAATAACAGATATTAGCATACCCAAAGAGCATTGAAATGACCACAATTTTTTAATTGCACAGCTTCACATTTTCCCATAGTGTTCTTAACCAGGGATAGTAACATTTTCTGCATTCCCCCCAGCCCTGCAAATAATGTCTGGAAATTTGTGGGGCCATTTTTGCTTGGCACACAGACTTGAGGTAGATACCACTGACATTTAGTAGTTGGGAGCCAAGGATGCTAAATGCTCTGCAGTGTGAATGACACTCCAGCACATCAAAGATTATCCTACCCAAAATACAGATAGCCCCACTTAGAGACAAGTGCATTATTAAAATGCTGATTTTTCAGGATTACTAGAATAATTATCCATTTTTGTAATAG
>TTN-209,,0,103,2219380,2219482,GTAAGTTTGGACATGGATGCACTATGGCTAAGAACTAATAAACCATAGTTTTGTTTTAAGAAGGTGGTTTTCCTGATACTAACATTTTTTTCTTGTTCTTCAG
>TTN-209,,0,113,2219483,2219595,GTAAGTTTTGTTTCATGGAGTTGCCACTTTCCCATTTTGAAATAAATGAAAATAATGTTTTGTCAGTTATTTTCATCAGAATTGAAAACATTTATTGGTTATGATCACTATAG
>TTN-209,,0,299,2219596,2219894,GTGAGTCATTAAAACTACACTTTCCAATGGAAAAAGGTTTTAGTAAAACATAAAAATAAAAAGTTTGGGAGAGAGTTAAAAGAAATGGGACATAGCTTCAGCAAGTTATCCTCAATCATATTTTATCTGCTGGCCATGTAAAAGAAATCACCTGATCTTGTTATTTATTAGCTAATGGAATACAAAGATAGATGTGGGAAAACCACAAATCATGTCAGAGGAGCATGCTCACATTTATATTTTCCATAGCAACCCTTCCCACACAAATTTTTGATTACTGTTCTCTTCTGAAATATTAG
>TTN-209,,0,128,2219895,2220022,GTAAGTTTCCTTTGGCATCTAAAGTTTGCCTTTTTACCATGTACTTTGGTATATAATTACTACAGCTTTTAAAATTGCATTTTTATGTCATACTGGGAAATTTACTTCAAATGTTATTTTTTTATCAG
>TTN-209,,0,96,2220023,2220118,GTAAGTAGTTCCTTAAGAAGAAGGTGGAGTAGAACAAGCTATTGTACATTTTAAAACCATCAGGGAGTTTGATTTGTCTATCTTCATTCATTCTAG
>TTN-209,,0,99,2220119,2220217,GTACTTAACGTTATTGGAATAAAATTATGGATATTTTCTCTATATGGGACTATTTTTTAATCTTTCATGGGCTAATGCATGACTGTTCTCTTTCAACAG
>TTN-209,,0,86,2220218,2220303,GTAAGGAATGTTGCACTGATTTTCACAGGATTTTCCCAAGTGATACTATCTTATTACATTGATTTTTGGCTTTGTTTTGTTTTCAG
>TTN-209,,0,1307,2220304,2221610,GTAAAAGAGAAGGTTTCATTGTGTTTATAGAGTAATGTTTTGCTTCTAGTTATATTATTTACTGAGCTTTATGGCTTCAAACTCCCAACAGTCTCAAAATCTATAGCTAAAGAGTAATAAGAAAAGTAAATCAAAAAACTATTAGCAACATTAAAGATATCATATTTCCTATAATTTCAATGTAATTTGTGGCTGTAAGTATATTAATCATGCATGGTTTCTTGTACTGAAAAACTTGGATCTACAGGGGCTTAATAATAACCTAGAAGTAGTTTAGACATATTATATCTCTCCAGTAGAACACATTGGAAGTCGGGTTTTTAAAACTTACTAGCGTAGTAGTTAAAGAGAATTCAATGTTCTTCTAAAAGATTAGACAATTCCTGAGAATAAATGCCTTAGTCTTCCTCTATATTCAAAAAGTCCCCATACTGGAAGGATAGAGAGGCCCAAAACCAGAAACAGCCTCCAAAGAATAGAAAACCAACCAGAGGGAATCTCCCAGAAATCAATACGAAACACTAAAATTGCACACACAGTAATGCACACTGACATCCCATCTAAGAAAGCAAAGGCTTTGAGGAAGACCCATTCCTCAAGAGACAGAAGAACTTATTCCTTCACCATCACCCCCTGAAAAAAAAAAATACATCCTATATCACTGCTGCAGCTCATCTATGAACGTCCAATATACCACAGGCTGTGCCAGAGGCACCAGAACAGAGCTGAGCTTCCACTCCTTCTGGTTGCAATAACAGTCAACAAGTATGGATTGGGTCTAGTTTTACCACTGAAAGCTTAACTCTTAGTTTGGTCCTTCAGGAAAGAAAACTTCAGCAGCATTACATACATCCTCTTTCCACCATATTTTGAACCCACATGTGAGGCAACATGACTCAAAGTATGTTCATAGACATATCCACTATCTGTTAATAAAAGAAAAAACACTTTGCTCTCAGCTGGTCATTCAAAGCAAAGCTTCACAGACTTACTTTCCTAGTTCAGTAGAATTAGAAGCATCCCCAGTTACAAAGGTAAACAATCTAAAATGTTAAATTAAAAAAGCATACGTGCCCTTGATTTATTTTTCACTGATAATCTTGATGAAAAGTTTGCTAAGAAAAATTCTGTCTACATGAATGTCTATAATTTTGGCAACTGACAAGTTTTAGGAATGATTTTAAATAAGGATGTAAGGTTATGCCAAACAGAAGGCTATTTTTTACATAATTAAGTTGAAGTGAAATATTATTTCTTACATGAATATTTATCTCATGCTAATCATTTTCACTTGCCTCTGGCTAAAG
>TTN-209,,0,118,2221611,2221728,GTGCGGAATCTGAATATAATAATAATTTTAATGCATTTTACAGTGTGCCTTTATCCCATAAGTTGAAAAAAACATCCTTATGACTTTGTTACTGTTTTTCTTTCTCTTCTCTTTGCAG
>TTN-209,,0,88,2221729,2221816,GTAAGTGACTTGCTTTCTTACATCAAAAAGGCATCCAGTGTCTGTTTAAGAATTGCCTTCTCAATATTCTCTGTTGATTCCTTTCCAG
>TTN-209,,0,402,2221817,2222218,GTAAACTCTTCTGAATATTTTCTTATACACATTAAAAGTACATGACTCTGGTTTGATGCCATTTTAATATAACCTTGGAATTTGATAATTAAACTCAAAACCACACACGATAAGCTGTTATTTTGTTATTGTAGTGTTTAGCCCCACACACATAAGGCTCCTTAGTACATAGCGTTTGATACACAGATACTCTTTTAATTGAGATCCACTATCAGGTACAATACATCTACATATTTTTATTTTAAAAAAAGCTTTCTCCTTTTCTCTGTCTTCCCATGTTTTGAGTCTATATATTTATTTCTTCTTACAGTCATCCCTCCCAAAATAAGTTGAATTTTTAAATGAGTGAAAACCAACATAAGTATATTCTCTTCAATAAATTTCTGTTTTTCTAATTTCTAG
>TTN-209,,0,1285,2222219,2223503,GTAAGTATGCTTCCGTTTCTGGGGACTAATTTCTAAAGCACAAAGTCACTAAATGGATAATTCTGCCTTAAATTTCTTATATTTTTCTATGCCAAATTATTTTATTTATTAAAATAAAAAAGGTTCATGTTCACATAGACTATCGGAAGTATATATTTATGTGTGTATACATACATGCACAGATATATACATACACACATACATAAAATCATACAGTTTGTAAACTCTTGGATTAAACCAAATATTTTATGAGGAATCACAATAATAAAGACCTGGACTATAAACTCCTATGTCTTCTGATACTTTAAATAAATTTCTATCTCATTAGATACTGGGGAAATCATCTCTCCCACTAAACAGTCAGACCTTCCAGTAGGAATTCAACAAAAAACAGAATGTTGTTAGCTTTTCTATAATATTATTGAACAAAGATTTAGGATTCTCAGGCATAGTCTGTGAGGTCAAATAAGAGAGAAAAATTCTTCTAAAAGATCTGTGAGCAGATTCGTTCAAAAATTAAAAAATACTGTGGCCATAATAATTCATCCTATTTGCTACATATCTGATTAGATTCTCTATAGAAGAAAAATTCAATTATTTGTTAAAAAGAAAATTTTAAATACTCAAGTGCTATGTGGAGCATATATACCTATATAATGAGGTAGTTATTCATTCATTTGCAAACTAGTATTGAACATGTGCTTTGTGCAAGGATCTATATTAACCACTGGAGGGGGAAAAGTTAAGATTAAAAAGACAAGTACAGTAAAAGAATTTCTGTAATTGTAAAGCACTTTCAGAAAGGTAAAGGATTGTTATGGGATTATTGTAGACACTGATCCTGTCCCTAAAGGGCATTAAGATTAGTTTGTGTTCAAAGGTTTACTAGCTATTGATGGAATCCTTTTTAAATTTTCATATTGTGGCAAATTAAATTTAAATCATGTTTTCAGTAAAGGCTATTGTAGAATTTCTTCAAAGGGATCTCAAAAGTAAAGTAGTTTTTTACCAATCATGTATAAATAGAATGTAAATCTAACAAGATAGGAAGTAGTCTTTCTATTCCCAGTTAGTTGTTTGCTTTCTCTGTTTTTGCATTAATGCTAAAGGAAAATAGACCATTTCCTTTATTTCTCTTCTCTAGAAGGCAACTGTATTTCCTTTTAGCATTTCTATTTTAATATTTTAATAGATTAAAATAATATATGATCATGTGTAGTAAAAGACTCCAGCACTTCATCAGCTTCAAAATCTGATGAAGCTTTTTTTTTTCTTTTGTTATTAG
>TTN-209,,0,131,2223504,2223634,GTACTAGTACTTACTCAGTTTATGTATTCCTCTTTTGATCTTATTATGAAATTGATTAATTTACTGAAGATATTTCAATTACTTTTGACAAATATGAGCTAAATCCTGTTAAATTGTATGTGGTATTACAG
>TTN-209,,0,87,2223635,2223721,GTAGGAAAATAACCATTCTCCTCTTTTTTCCACTGAATCACTATAAGGAGTATTTATACTACAACTGACTGTCTCCTTTTCTAATAG
>TTN-209,,0,94,2223722,2223815,GTAAAAAAATAATAATTAAAATAATTCAGAATATGGTTGACTTCAATATTGCTATGATTTCATTCAATGTATGACTACTATTTTCTTTGTACAG
>TTN-209,,0,93,2223816,2223908,GTAAGAAAGACTTTGAAAGTTGCTACAGAATAAAAACAAATTATTTTTAAGCATTTAAGGAACGTTGCTTATATTGTGATTTACATCCAACAG
>TTN-209,,0,93,2223909,2224001,GTAAGCTTTAAAATCTAAATTTAAAATATCTTCTCAAAATTGAAGTATATTATTATAAACAACGCTTAATACTTCCTTTAATTATTTTTACAG
>TTN-209,,0,1003,2224002,2225004,GTAAGTACCAATGTACTGACAAAGAATGTCCTCCTTACAGCTGCCTTCCTAGGTGTTCAATAATAGTTCACAATTAAAAGAGCTATATCTGTACCTTAGGAAGCTACTATGGCTTGAATGTAGACATGGGCACATTACTTAATTACTCATTCCTTCAATTTCCACAGAATTTTCACATTCCCTTACCTGTTACCTTTTCCCTGTTCAAAGGAGATGATGTCTGTAATTTCCTCGCTGTAATTTTCCTCGCAGTCTGTTTTATTTATCAGAGGCTAAAGCAATTTCTCTGCATGCTCCTCAAAAGGGACAGAAAGTAACCAGTCATTTTCTTAGCAACTGCTGAGACCCATTTATCTTCACAATCAAGTTTTTATTTCTCTATATGAGAAAAGATATATCCATTTTAATGAAGTATATATATATATATATATATATATATATATGGTAATAATTCTTCCTCTGATAATTACCATCACTACTGTTGTGTATTTGTTTATTCTCTCATCTAAGTGTGAAGAAACTGTAGTCACTACCCTCTTTGAATATTTCTGTCCTAAATTTGTGCAAAATGGAAAATTGCTTTCCTTTTATTAACAGTTATATTTCTTAAAAGGGGAATTCACCTTCTTGTGTATCCCTTCATAATTCTGTGTAAATATTAAAGAGAGTATCCCATGATACTCTCCTACTACAATCTCCTCTCTTCCCTTTTGTCAGGATATGAGAATATAATAATACACATCATTACATGCATAATGATGCCAAATAAAGTGAGGCAAGCACAGATACATAGCCACATGTAGATCCAATAAAAGATGCTGACCCCGTGTACCTGCTCCCCAAACTAGCGTAATAGTGTTAAAGACAGAACCATTCTTTATATTGGGCTGAGCTACAAAGTCTGCCTACAGTGGATCCAAACAACTTTATAGTAACTGTGAATTCTACTTTCTATCCCTCAATGCTTTTTGCTCCTAATGACAACTTTTTTTAAATAATCTAG
>TTN-209,,0,108,2225005,2225112,GTAAAGACTGCATGGTTTGGTTAAAATTACTTGTTTTTCTGTTCATAAATAACATTTGGCTTTAAAATCATCTGAGTGATAAAGGGTTCCTTCTTTAAACCATTTTAG
>TTN-209,,0,83,2225113,2225195,GTAAGTAGGAGAACATTTTCACATACAAAGCCATTTTTACTTTTTTTTTAAATTTCTTATAATCAATATGATCTTTTTCACAG
>TTN-209,,0,93,2225196,2225288,GTAAGCCTGGAAACCATTCCTTTTTTTTAAATCTTATTTTCCAAAAGTGCCTTGGAAAAGTCAAGAATACTAACGTATACTGGCTCTTTGCAG
>TTN-209,,0,447,2225289,2225735,GTAGGAAAACTTGGCACTAAGGAAATGCACTATGAATAAACTAAAAAATGTCATAGTTATTCTCAATCCCATTAACTTCTGTCTATACTTTTTGGATTAAGAAATCAGGAAAATAGCATAATTTTAACTCACATTCCAAACATCTGTTAATGTCAGAAATCGAATCAAAAGTTAAGTCATGTTATTACTAATCTTTTGGTTATAAACCCTGGAATGTGGAATAAATAAATCAAGGTTTAATCATTTGACAATAATTTTAAAGCATAACTCCTGCCAAGTTATTCCATTCAGTGTTGCCTGTAATATCTGATCCCTAAAACCTAAACCAGCAACAATTTTCCCAGAGTAAACAGTTAAATAGGCTGCTGGTGATGCTTTAGGAAGCCATTAAAGCAAGAAGCTACAAAGAACTATTCTAATTATAAAATGTCTATGATTTCTCCCCAG
>TTN-209,,0,88,2225736,2225823,GTAATTATCAATCCTTCCTTATGCCATCAGTATTTATGTTTCAGATTGAAGGGGAAAAATCACATTTGTAATTTTCAATTGCTTCCAG
>TTN-209,,0,1728,2225824,2227551,GTAAATACTTTCAATTTGTCTGTGCAACTTTTTAAACCAACATTCTTATTATATTTACACAAAGCTATGCTGTATGCTGTGTAACAAACATTTTGGAAAATAAGAAAAATCACCCATAATCATGTTGAACATTATTAGAATTTTTAAAAATTTCCTCCTTACTTTTTTATTCTATGTGTATTCTGTATGGTGGGTGTAAGTTTACAAATTATATAATTGAGAAAACAGATGCTAACAAGAAGACATGCATCCATGTTTCCAGTGAACCTAAAGAGTGCATGTACACAATTCTCAAATTGCTAGAAGGCCATGAATATGTATTCTGAATCATGGCCCAGAATAAATATGGCTTTTTTATAGAACTTGCCCCCATAGTGTCTATTATGTTGTTATATAGTTTTCATAGAAGCAACTTTCCTTAAACTGTACATGAATGTTTAACAATCTGCAACTTTCCTTAAACTGTACATGAATGTTTAACAATTTGCCAGTGCTGACCATTTCACATCATGAGACTCTACCCCTATCGCTAAATTATCATAATAATGCAAAAACCTGTTTGAAGGGTTTCAGTATTCTAATTGAAGAGAAGCATCATAGTTGGTTATCAATATTGCATTTCTAGTCACTGAATATAGAGTTGAACTCTATGAGGCTTTTTCATGGCTCTCACTGGAGGCTTTAGTCCAGTGATTTGCTCAGAACACGAAGCCTTTCCACTCAGGGCTCTTTCTAAGCATGTCTCTAGGCACAACAATACTCCAGCCACAGTTTTTATGTGAAAATTGCCAGTTCTATGTTGAATATAATTAATATAAGAATGGCATAAGGAAAAATATTTCATTAAGCAGTAGCCCCACAAACTTTCAGGTTAGTTTCAAGCACCTAAAGCTCTTTTGCCTAATGGTTATTACTTTAATTTGAGAACTGGTACATTTCCACGTTAATTATTTGCAACCTCCTCAAAGTCATTCTGAAATTTGGGGCCTCCTATGCTGCTTGTTGATCCACTGGTCATCCAGAAATAAACCATCTCTCTCTCCGTTTCCCCTGCAGAGGAAACTGGACATAGAAACTGACTATGCCACTCTTACCCATCTCTTGTATCCCTCTGCATGCTTGCCTCCCAGCTCCCTCCTGTCCAACTCACAAATTGCTTTTAAAAAGCATTTTTATTTTCCCTTCAGCCTCTACTAAAACCATGGTAACCAATAACTGTTGCAAACCTACTTCATTAACAAATATGGGGCTTGATGCTATGGCTCACACCTGTAATCCCCTGACTTTGGGAGGCCAAGGCAGGTGGATCACTTGAGGTCAGGAGTTCGAGACCAGCCTGACCAACATGGTGAAACCCTGTCTCTACTAAAAATGCAAAAATTAGCCTGGTATGGTGGCACATGCCTGTAGTCCCAGCTACTTGGGAGGCTGAGGCAGGAGAATTGCTTGAACCTGGGAAGCGGAGGTTGCAGTGAGCTGAGATTGTGCCACTGAACTCCAGCCTGGGTGACAGAGCGAGACTCCCATCTCAAAAAAAAAAAAAAAAAAAAAAAGTGGTTGACTGTTTTTGTATTGACTAGATAGCAGAAGGAAAAACTAACTCAATTAGTAGACACAAAACCTTACTTTCTTCAAAACAACATTTTTGTCTCCTTTTAAAAAAACAAGTGTTGAGCATTATCTTTCATTGAAGGCAAACAGCTTGAATTATTTTCTTCTTATTTCCAG
>TTN-209,,0,860,2227552,2228411,GTAAGTAAAAAAAAAAAAATGTATACTTAATCACTTCTTTACTCATTTAGTACAAGACTATGGTGAAAAAATATGTGTATAAATGCCGTACATTTCATTCACTTGACAAGCAGTTATCACACAACTACTCAGTATCTGATTTGGTAGTATTTGGACAGTGATTGTGAAAGAGATTTTACAAATATGTATAATTCATTGAATTTCTTTTTGTTTTTTTTTTTCTTTTTGGTTTTGTTTTGACACATAGTCTTACTGTTACCGAGGCTGGAGTATAGTGTCATGATCTTGGCTCACTGCAACCTCCACCTCTGAGGTTCAAGTGATTCTTGTGTCTCAGTCTCCCGAGTAGCTGGGATTACAGACATGCACCACCATGCCCAGCTAATTTTTCTATTTCTAGTAGAGGCAGGGTTTTGCCATGTTGGCCAGGCTGGTCTCAAACTCCTGGCCTCAAGTGATCCACCTGCCTCGGCCTCCGAAAGTGCTGGCATTACCACTCCTAGTTCATTTATCAAATTTCTTCCATCTATACCTCACAGATTTTTTTTTAATTTCCCACTTAATGGCATTAATAGAAACTGAATTATTTTCCTACTTCTAAAACTACCAATTCTGAAGACCTTTCCTAAATTATTTTGCCTCAACAAACCTCTATTTCCTCATCTGTCAAGTGAAGAAATTCAATTGTATTGGGTCCTTTTTAACTCTAATAGTTTTATGATGAGATCTCTTTTGCTATTTATGGGAGCAGAGAGTTTAATGTTTAAATGCAATCTTCAGAAAAGGAATATTCACTACATCCTACTACATTCTTAATGTGACATTTTTTTCTACCACAATTCCTATACTTATATTCGCAG
>TTN-209,,0,101,2228412,2228512,GTATGTGTCTACTACAATTTATACTTCTGAAACTTGCACATTTGTAGATTTGTAATAAGACATCAATAAAAATGACTTGCCTTTATAATTACAAATTTTAG
>TTN-209,,0,93,2228513,2228605,GTAAGTCTTATTTAGTGGAAAGAATAGATCTTCTGTTCTTTCAAAAGCAGAAATGGCAATAACATTTTGTGCCATGATTTTTTTTTTCTGCAG
>TTN-209,,0,92,2228606,2228697,GTATGCATTATGTTTCTTTTTAGTGATTCAATGCTTGATAAAACTAATATAAAGAAATAAATTTCTAACGCATTTTCCAACATTTGTTACAG
>TTN-209,,0,89,2228698,2228786,GTATAGTATTAATGGATTTATTCAGTTTTCATGTTATCTAACTTTGTTTTCAGCTATATGCTAATTCGTTTTTTACTTTTATTTTTTAG
>TTN-209,,0,114,2228787,2228900,GTGAGTAAAATGCTCTCACTTGTGTTTGCAAGGAAAATAGATGTCTGATTGTATGTGTTTAATTGTAATCTGCATTATGGATCAAATCTGAGTGTTCTGTTCTCTTTATTCTAG
>TTN-209,,0,101,2228901,2229001,GTAAGAATTTTACTACTTAGGCCATTAAAAATAAATTTTGATAATTTTGAGCTCTTATATGGATAAAATTACTTATCAAACTGTTATTTAACACTTTTTAG
>TTN-209,,0,85,2229002,2229086,GTAAGTTGCTTTCTCTGAATACAAAACTATTGTTTGACTGTCTTTAAGAATATTACTTTTTCATCATAACTTCTTCTTTGAAAAG
>TTN-209,,0,94,2229087,2229180,GTAATTTTTGGACTAGCAGTATTACCTTATTTCTTTTTAAAATTATTCATATAGGTGAAAATCAAAATCTAATTTTTTCATGTTTACTTTTCAG
>TTN-209,,0,318,2229181,2229498,GTAGGATGTCCTTGTTTTTTCTGATATTACAGCAACTCTTAATCTCAAGCACAGAAGTATTCGATAAATAAGTTAATGTAACATCTAAATCTGTAACATCCAAACTGTATTTAGCAAATATTTTTCCAAATAGACCTTTTACCAAAATACCTAAAAGGTACAAACAATAGTAGATTCTCATTTTTATGAAGGAAAATAAAGAGGACACTAATTGAAAAATTGGATGACCTATATTTGATTAACTGAGAATAGGCTATATAAAATTACACATTGAAGTATCACTAGTAGTAGTTAACTATATGTATATTTTACTTTCAG
>TTN-209,,0,98,2229499,2229596,GTAAGTCCTTCCCTTAGCATGTGATTCATTCACACTTAATTTCTTATGATTTCCCCACATTCTGAAAAATCAATTAATGACCTTAATGTCATTTGCAG
>TTN-209,,0,98,2229597,2229694,GTGGGTTACTAAAATGCTTCTCCCTCCCACTTCAAAAATGAATTTGTTAATAGGGATGCTGAGGAGACATGTATATCTGATTTTATGATTCTTTACAG
>TTN-209,,0,310,2229695,2230004,GTAAGTATTATGCTTTCTTCCTCCTTTTAACCCCAGTCTCCTATTTTAGCAAGGTCAAGATACTAATACCATTTTAATCCACTTCTGAAAGAGATTTCATTTGTAGAGACCGAAATAGTGTAATAAATATCTATCTCACTCATGAAACACTTTTTTGATCTGTCTCATCTTATATGTTTTGCTTTTAATGTACTGAACTACAGGTTCTATGTACATTGGAGCAAATCCATACTAAAACTCTTATGTACATTAACAAAGGGGATTTGATTAGGTTACCTAGGTAATCTTCTAAATTATGTTTTTCTTCTAG
>TTN-209,,0,1157,2230005,2231161,GTAAGTAGTCTTTGCTTCATTTATGTCATGTGGTAAGTTTATTAGAATTTCTTCTTTTATATGTAGACATTTCTCCCTGAGGAATCTAGCTCTAGAAATTCTTGAAAAACAGTAGAGAACAGTGGCTTTCAAACACATGAGTGGGCCAAAAACACACAGTAAATAAACTTATACAAACACATATATAACTAAAAAACATTTCCTGAAACAATACCCATTTATTATCATGTGCATTCTTATGTTTTCTACCCTATTCTGTGTTTTTAAAAATATTGGCTGTACAACAAACATATGAAGAAAAGCTCATCACCACTGGTCACTAGAGAAATGCAAATCAAAACCACAATGAGATACCATCTCACACCAGTTAGAATGGTGATCACTAAAAAGTCAGGAAACAACAGGTGCTAGAGAGGATGTGGAGAAATAGGAAAGCTTTTACACTGTTGGTGGGAGTGTAAATTAGTTCAACCATTATGGAAGACAGTGTGGCGATTCCTCAAGGATCTAGAACCAGAAATACCATTTGACCCAGCAATCTCATTACTGGGTATATACCCAAAGGATTATAAATCATTCTACTATAAAGACACATGCACATGTATGTTTATTGTGGCACTGTTCACAATAGCAAAGACTTGGAACCAACCCAAATGCCCATCAATGACAGACTGGATAAAGAAAATGTGGCACCACATTTACACCACAGGATACTACGCAGCCATAAAAAAGGATGAGTTCATGTCCTTTGCAGGGACATGGATGAAGCTGGAAACCATCATTCTCAGCAAACACAAGAACAGAAAACCAAACACCACATGTTCTCACTCATAAGTGGGAGCTGAACAATGAAAACACATGGACACAGGGAGGGGAGCATCACACACTGGGGCCTGTCAGGGGTTGGGAGGCTAGGGGAAGGATAGCATTAGGAGAATACCTAATGTAGACGATGTGTTGATGGGTGCAGCAAATCACCATGGCACATGTATACCTATGTAACAAGCCTGCACATTCTGCATATGTATCCCAGAACTTAAAGTATATATTAAAAAAAATTGGTGGTAATACAAGCATTAATTTGCACCAGTATAGCTCTCCACCAGAAGAAACTTATCCACCTTCCCAAAATTAATATCTTTTCATTTTACTTTCAG
>TTN-209,,0,103,2231162,2231264,GTAAGTTAAGTATTAGACAAATGGCCATCTAAATATGAAGCTCAGAAATATTTTTACGTATCAAATCCTTGTTCTTACATTTCTTTCCTCTTGGTTCATGTAG
>TTN-209,,0,90,2231265,2231354,GTATGTTTTTGTGAAGGAGAAAAAAAGTTGTTTTCTTTCTAGTTTGTTACTTAATGTAGAAACTGACATCTTCCTTGTCTTCATCTCCAG
>TTN-209,,0,369,2231355,2231723,GTAAGTTTTGGGGTTTTTTTATTGTTGTTGTTGTTTTAGTATTATGGAGGCACATTTAAATCTCGGAGTCTAAGATTTGGACTCCAAGACACAGAGAGTAGTAGAGATCTGAAGATTACAACTCCCATTTAAGAATATGTTCTATCTCTTACAATGAAGATGACATATTAAAAAAAGAAAAGGACATATAATTTCCTTTAAAGCATACAGCAAGGACTCAAAAGTGCATACTAGTTGGACGGTTATTAAAATGGGATAATTGTCTTCCTGTTGAGCTTGTTACTTAGCAGCAGGGATGATAATGTGAAATATGGAAGTTTAAACTTCTGCTGGTAAGATAAATGGTGAGTGTACCTCTTTTTGTTTTAG
>TTN-209,,0,379,2231724,2232102,GTAAGATTCTGCTGAGTATTATAGGCAAAGATGTAACAGCATTCATGATGGTCATTTTTCCTAATAAAAAACTAAATATACACCTAAGGAAAAAAGGAAAATTAAAATGATGTTTTGTATATAGACACAAACATTATGATTATGGAGAATCATAATAACATGCTAAATTAAAAAGCAAGATACACAACTGTGGCAACTATATAATTTCAATAGTTATTCAATAGTGCAGTTATTATTTGTCTATTAAAAATAAACAAAATGAAATAACACTAAAATTCCATTCTTGAAAGAAGCAGCATATGAATTTCCCACTATTATTAATAAGGATTACATAATATAGCTTTGCATACATTAAGTCCTTTATCTTATTTCTTTCCAG
>TTN-209,,0,347,2232103,2232449,GTAACTAATAAACTTCATTGGAATCCCATATTTTACTTTGGATAATGGGATGTAAATAGGATTTACAGAATAATGTGGGAGAAGACATTCATATTCTAATGTGTATTTCCTATGCACAGAATTATTCTTATGACAGAACCACGTTTTAGAGTTAAAAAGAGCTTTAGAAATCACATATTTCAATTACCTAATTTTACAAGTGAAGAAACTAAGATTCTAAAAAATTAACTAACCTCCTAGGTCATATAGGAAATTGACAATAGAAAGACTGCAGCCCAGGTCTCCAGACCTCTACTCTATACTCATTCCCCATTCCACATATTCACTCTTCTTCCTTATTCCTTCAG
>TTN-209,,0,87,2232450,2232536,GTAGGAACATTTCCCGGTGGTTTTTCATTTTATTTTTTAAAATTATCTTTTAGCCTGGGAAATTAACTTTTCAATCAATTTCTGCAG
>TTN-209,,0,101,2232537,2232637,GTAAGTGTTCATGAACGAGTTCCATATCCTGTGTTAAAAGCAGCATTAAACACCCAGGAAGGAAGTTTTCATGAAAATTTCCTATCATTATTTATTCTCAG
>TTN-209,,0,889,2232638,2233526,GTAAGTATTACCAGGGGGAGTACATAAGGCTTTTCCTATTAATCATATTCTAAGAGGGAGACTAGAACTCCCTTAGGTAGATTAATTTATTAACAAGGTGTAGAGCTGGTAACTCCAAGAGTACTTTTTAGGAGAGCTGGGTGGGTACTTTACGGTATTGTGGAACAGGCAAATCAAATGCACATGATTTGTGGTTTTGAAAAGCTTTTCATATATATAAGAATTTCCTGTCTTCAAAAGACATGAAATGAGAGAATTTTATTGGAATGTAAGAATTTTATTTTAGGAATAAAGAGGCCTTTTAACTAAGTAGTGAGCTATTTACTATTCTTAGGGTTTCTGTTTTCCAATCCACCATCTCCCTAAGTATGTGACTGGTGGGCTCTCCATCTTAATTTCCCTTCTTCTTATTTCTTCTATTTGCTTATCCTCCATGATAATTTCCCCTTTATTTGAATTACTTGATATTATATGTCACCCTCCAGGTACTTTTCTTCCTACTATGAAATAATAAAGAGAGCTAGAATATGTGGCAGAATACCTTCATGGAATATAGAAAGGAAAAAACAAGAATGAAAGGGAGCCAAAAATCAATCGTCTACTTTCCTTTTAATATATGTAGCATTTCAGAGTACATAAGGCTCATGAAAGAGGAGGTACAGATCCTCCGGGGGGAAAACCTGGTTAAGCCTAAAGCATAGTGGAAAATGGAAAGATCAACAATTAGTACAGAACAGAAAAATGATTTTGAGGATTGTATTAAGGAAGTTTTAAAGAACAAGAAATCAGCTCTAGAAAATAAATGTATTTTAGGAGTGACAAGGCCAGTCCCTGGAAATACATTTGACTATTAAATTTTTATTTAACTTCTTCACCCAAAATTAAACAG
>TTN-209,,0,92,2233527,2233618,GTAAGTCTATTTCAAAAAAGAATCATATATATTTTAAAATAGCTTATGTATTTTTTACACATTCATTTCTTATTTACCTACTATTTATCCAG
>TTN-209,,0,90,2233619,2233708,GTAAGCAAATGAACCATCATCCCATCATTTTGAGTTATATCCTTCCTTTGTTATATGGGGCTTACACTTATCATTTCTCCTTTGCTTTAG
>TTN-209,,0,167,2233709,2233875,GTAAGGCTCTATGCACACATCTTCATTTTTCCTTTATTGTCATCGAAAGTGCACTCTTGTGTCCCACTCACTAGCTTATCTAAAAATCCGTTAAAAGCTAGAACTATTTGAAAAAGTTAATCGCCTGGCCTTAAAAATAACAGTAATTTATCTCTGCTATTTTACAG
>TTN-209,,0,90,2233876,2233965,GTAAGTGTCTTAAATTCAGAAGACGTAAAGCAAAACACGGTTTTGAGGAGGCTTCTTATTATAAATCTTGCATTATCTACTTTTTTCTAG
>TTN-209,,0,425,2233966,2234390,GTATTTTGTTTGTTCTTATCCTACAGCTTTTACATCAAGATTCCTCACAAATATTTCCCTGAGAACAGTTGAACATGTGCTTATCGATAACATTATCTGCTTATACAGAAATGTGTTTTTATTTCAGTACATATGGTTAATGTTTAATTTTATTGAAAATATCCTAATGTAATAGTTAATAAAGTATTTCTTAATTATAATATCTATTTTTGTAAGTTAAAATTGTTCACCAAAAAAGACAACAACTATGCATATTCCAAGAGGAAAAAAAAAATGGCACTATGCTTGGGTAATAAAAGTATAGATACTAGCAAGAATGACTACTTGTTCAATATATATGGATATGTATAAATAATTTGGGCAACACATATATATTGTAAAATCAAGCTGCATTTATACTTGATACATCCCTGGGTCTTTTGTAG
>TTN-209,,0,89,2234391,2234479,GTAAGTCATTATATGAAGAAAAACCCAGGTGCATGTTTTACATGAAGAAAACTGGTATTTGTTTGACTGGTTTTGCTTTTATGTTTTAG
>TTN-209,,0,91,2234480,2234570,GTAGGTCCATTTTACTTTTTATGTACTTTTTTTTTTAAAGCAAATTAAGCCTCCTTCCTTTTCTGATTAAAATGTATTTTTTTCTTTGCAG
>TTN-209,,0,91,2234571,2234661,GTATGTAGAGCATGTGAGGGAATTGACATGGAAACATTTATAGCAGAGTTTAGGAAATCATGGATTTCTAATAAATTTGCTTCCTTTTCAG
>TTN-209,,0,112,2234662,2234773,GTTAGTATTTGTCTTTTTCAACACCGTTCATTCCAGAGTGCCAATATTTTATCTAAATTACCCAAAAGCCAAACTCTGAATATATACTTTTGTGTCTTTGTTTCTTTCTCAG
>TTN-209,,0,673,2234774,2235446,GTATGTTTTAAGAATAAGGAAATTCTACATATCCACGTTAATTTTGCTAGAATAGTGTGAGTCATTCTAATTAGTCGTTATTTCATCTTAAATGCTTTTGGGTTCACACCCTTCACACCCCAAACTATTCATACTATGGCACAAAATGGAATCTCTAGTGAAGAGTCTTTCATTGATTAAAAAAACAGAAATTTACGTAGCTAAAATTGGATAATATATGTTGAATTTAAGTATTATTGAATCTAACTGTATATATATGTAGGTATACATGTTTATATATATATATACACAGATTATATATATATAGTATGTGTGTATGACATATATCATATGTGTGTATGTGCGTGTGTACAGAAATTGTATATAAAGTTTTTTAAAAGATTGTTCATCTTGTTCCTCTTTTTTATCCCCATGGTGAATTTGGAGTAAATTTTATCATTTAATCTGGTCATTTTACCCTTAATTTGGATTTGAATGCTATAGCATGTAATGACATAGCTTGTGGGAGCCTTGGTTGGTTCAGAAGCAAAATGGGTTATGTAAAAAGGAAGACTAAAATCAACATAAAAATATGGCCTTCATTTAAAAGTTTTCTTTTGACAATACATGAAGAGTGCACATTTAAAAGTGCTGTAATAATTATTCACTTTCTTTTGATGCTTTGTTTTCTTAG
>TTN-209,,0,105,2235447,2235551,GTATGTCTAATTTTGTGTAGAAGCAAAATTTGAAATTATTTGCATTGATTTATGTTAATTTTCAGAAACACTTTTTCACTTTCACTTTCTATACTCATTTTTCAG
>TTN-209,,0,92,2235552,2235643,GTAAGTTGTCCAACTTTTCAAAGATCCAGGTTTTCTTTTACCATAAATGTGTTATTGTCTGTACTAATCTATAGGATTTCTCTCTTTTGTAG
>TTN-209,,0,108,2235644,2235751,GTACGTATTTGTCATGGGAAGGGCAGTTCTGATAACAAAAATGCAAATCTTACTTCTGCGAAGCAAAATATTATAAGTGCCGCTAATCTGCTTCTCTTATTACCACAG
>TTN-209,,0,1695,2235752,2237446,GTAAGCATGCTTAGCACTTTGAATCAAAATTGCTATTTAACTCAGTATTTCCGCATACCTTTTCCTGGTTCTAATCCTATAGAATAACTTTTACTCTGTGCCTTAATGGGGTTTTTGGAAGAAATTATGGACTAGCTGGGAGTCTGAGGAAAATTCCTTAAATACCTTTCCAGCCCTCTTGACTTGACTGTAAAGTGAGAGATTTAGACCTCAGGATATCTATGGGCCTTTCCAACTTCAACCTTTTATGATTGATTGTATGAGTTGGTGCTTTCATTCTGTTTTAAATTATCAGAGTCAATAATTAAACCATGGTTGAGTTCCTAGAGAATATTGCTCTTAAATAAGCCACAGACTAAACAGAGACTTCATTTTTTGGTTTTTTTTTTTTTGTTTGTTTGTTTGTTTGTTTGTTTTGAGACAGAGTCTCACTCTGTCGCCCAGGCTGTAGTGCAGTGGCACGGTCTTGGTTCACTGCAACTTCCGCCTCCTGGGCTCAAACGATTCTCGTGCCTCAGTCACCTGAGTAGCTGGGATTACAGGCATGCCCCACCACACCCAGCTAATTTTTTGTATTTTTAGTAGGGACGGAGTTTCACCATGTTGGCCAGGCAGGTCTCAACCTCCTGACCTCAGGTGATCCACCCACCTCGGCCTCCCAAAGTGTTGGGATTACAGGTGTGAGCCACCATGCCTGGTCTAAACACAGACTTTGATGATGATAGTATTAGCAGCAGCTAACATTTATTGAGGAATTTTCATGAATTCTTTCCCTTAGTTCTCACAGCCCTCATATTAGCCATCTTATAGAAGGGAAACTGAGGCTGAGAGTGCTTTTGTAACTTCCCCGTTAGGGATGGAGTGGGAATTCAGACAGACAGACTTCAGAGCCCTCTCTATCATGGTTAGTCCAAAATGCGTATTCTTCACCATTCTGGAAAATAAGTGGCACATTCAACTCAACAATGTTTTGAAAATTAAAACGTCATGAGAGTCAGGTATCCTGTGACACTTTACCTAAAAGATCTCCATTTGCTAAGAGAAAATTGAGCCACTGTAGTGTCTGGGCAAAAGTATCCACTTCCATCTTCATGCTGAGAATCTCAGGGCTGTTCATTATTTATGAATCAGGCTTTGTGGATACTGAATCAGTGTTTATGAGAGTATAAAGCAAGTCGAATTTAGTTATCTTTCTTGATAATTCCAAACAGCATGGCAGAAAATCTGTCCAGTAATTATGTAGCTCTGTGGGTAGAGAATTCAGACTTTAAGTGTCTGACATGAACCATCCACACTTGGATATCAGTGAACTGGGATGGGAAAAGAAAAAGAATAGGAGGTGCGTAGAAGAAAAGGAAAGAAAAGCTAAAGTGAAAGGAAATGTTTTAACAGCTTCTTCCATGATGTTCTCACTACCATATCCCATTTCTTCACTGGAATAAAGCAACTAATGGACTTTAAAACACATGTAAAAGGTGCTTAAGTCCCTGCACAACTCACAGTCTTTCTACCCCATCTGAGATAGAAGAGTGGCCTATAAATTTTTAATTTTTAAATAATAATTGCATAGAATTATAATGATGGTGTGTGTGTATAATTTAATAATGGCCAATGACCTTACTTTAAGGTTGGTGCAACTATTTTTTTTTCCATCCTTATAATATTTTAAATATTTCTCATCTGTTTTTCTTGCAG
>TTN-209,,0,112,2237447,2237558,GTAGGTGCTGAATACAGACCACTGTCATATTACATTTGCCTAAAGCTTAGTAATTTTGAACAAGTAGGCTTTAAAGAAGTACTAACATCGTGTTTTGTCCTTTCACTGATAG
>TTN-209,,0,236,2237559,2237794,GTGAGACATGATTTCATTAGAAAACTGAAACGTGAAAAATTTAAAAATAAACTACGCTAACCTGTGCATATGCTTTAATTTTCTTTTATATAACACCTGTCTCATTACCATCCTTTTCACAAGGTGAAAAATATAAAAAATAAAACCAATGTTCTTGGAAAGAATGCGAACATCAAAGGTATAATTTATCAGTAATGTGGATTCTTGTACCTTGTTTTCCCTTCCTTTCTAAATAG
>TTN-209,,0,106,2237795,2237900,GTAAGTGCTCATACCTGCAGCATCTTCACCTGTGTCTTCTATATTCACCTGTGTGACTAAATTGTACATGATTGTGTAATTATTTTATTGTGAATGGCCATTCCAG
>TTN-209,,0,105,2237901,2238005,GTATGTACCTACTGGTTTGATTATGTTTTTTAATAAGCATACTTCCAGGAAATCACTCTTTTTTGCTTTTAAAATTCACTGTATGTATCCATTTTATGTCTACAG
>TTN-209,,0,369,2238006,2238374,GTAAGTGATTATTATTCAAATACATTTAGTTTAGCAATTGAACATATTAGAAACAAATATATCAAGGAATGCTTTTCTTCTCTGCATCACCTTCTTACATATCTTCTTGTCACTAGAGAACTGGTCATGTAAAGCAAGAGGAATTATTTTAAGTCAGTCTAATAAACTAATTTGAAGTTCATTTTAAAGACTATGAAATGGAAAGTTGAAATTAATGACCAATATGAGTTTGGGAGATTGAATAAATTACTTATTATAAAAATTTTACTTATTTATTAAAATTATAGAATAATTGTATTGTTCTTCCATGGATGATTAAGACCTGGTTACAAATGTAATGATGCATTTACCTTCCTTATAATTTTTTAG
>TTN-209,,0,693,2238375,2239067,GTAAGCATTTACAACTTATTTCCAATGAGACTAAGAGCATTCACATTTTTAAAAAACACATTTGGCCCCTGGCCTGTAAAATGGTAACAGAAACAAATTACCCAAGGTTGCTAAGTGGATGAATTATGTCTTTCTACCTTTCAGATGAAAAGAAGAAAAAAATAATTGGCATCAATTATTTTTTCTATTATTTCACTCCATTCCCATATAAAGAGCATGCAGCAAGTGGGAATGAGTTTTTAGCTTTGTAATTTTCGCCACTTAACAGTACATAAAGAAAAGGTTCTCGAGAATAAGTGTCCATCTTTACTGAAGTTATTAAAATACAACATACATCCAACAACACAATCATCCCCTTGCTTGAATGCAGCTGATGGCCTCTTAAAAGAACTTGTGTGACTGTGCAGCAGTATTAGGAAGTACATGATCTGTAAATGTTTCACTTTCCTTTTTACAAAGAGCAATGCAAAATTAAAAACATGACAGGCATTACAAAGGGAATAATAATAGGCAAATATTTAACCCCATAGTCCAAATTCTCAATTATCAATCCTACTTTCAAAATAGGCTTTGGTAGCACAGTAGAAGTCACTACTCTTCCTGGCCTTGTGATATGGCACTACTGAAAAATATATATTTATGTATGTCTTTATTAAGCCAAACTAATACATAGTATTTCTCTTTCTTTTATAG
>TTN-209,,0,116,2239068,2239183,GTACTTTTAAAATAGCTTCTTAATGCTACAATTTATGAACTTGGATTAGAGACATGCCTAGTTGTATTTTAATGGACAAGGAAAAAGAAACTAACTCTAGAAACTTTTTCTTATAG
>TTN-209,,0,96,2239184,2239279,GTAAGTTTGCGTTTTTACTAAGCGGTACTATGTCAAAAGTTTAACCTTCCAAGCAAATGCATCTAATTGATTTGGGGTTTTGTTTTTGTTTTACAG
>TTN-209,,0,101,2239280,2239380,GTAAGAAAAATAAAAATCCTATTTCAAAGTCTCTATTATTAAATGTTTCCCCTGAATTTTATAAAATTGTATTCATACTTAATACCTTTGTTTATATTTAG
>TTN-209,,0,97,2239381,2239477,GTATGTATCACAATTTAAGGGCATATTTGTTTATTATTACTGATTCTAGTAGAACTCAGAGTGGTATATTTTAACCTTATTTTTGCATCCCTTCCAG
>TTN-209,,0,97,2239478,2239574,GTAGGAAATAGTCAACATTCTCCTTTTTAAAATTATCTCAATTTATGTGAAAATAAACTCTCAGATATTCATTCATATCTGTTTTGCCTACTGACAG
>TTN-209,,0,95,2239575,2239669,GTAAGCATGTCAAATGTTCTCACATTTATATAGCATTTTCCAGTGTGGGCAGAAAGAATGATCTTCATCATGGCTTGTCATTACACCTGTTTCAG
>TTN-209,,0,126,2239670,2239795,GTAAGTATTAACACTTTTAAATAATTTGACAGTTGAAATGTAATAGAATCAGGGGGAGAAGGGAGAAGGGCAGTCTTATCAATAGTAATTTTGTGCAATTCTCATCATCCTTATTTTCATAAACAG
>TTN-209,,0,881,2239796,2240676,GTGAGCTCCAAGAATCATACATAAATACAATGCTCCTCAAAACTATATGACAGATAATTTTCCAACACACAATCTCTAAGAATTTTTAGAATTTATGAATGGTCTAGAAAAGCACATGCTTATTTGCATGATCATAAATATAGCTTAAGTCAGAGAACATTTTAACTATTACATCTGTTAAGTTAGCAATTAGAATTGCTAAAAGTTGTACAGCATTTTCCAATTAATGAAAAAATATTCTATCAATATGAAAAGAATCTATTTTATAAATTTTCCTTAGAGAAAAATGCATTGTACTGTAATAACTGAAAAGAAAAATGGCAAAACTCCTTTTAAGAAGAGGTTTAGCAGGAACATACAGTTTCTAGTGGTTTCATAAGTTACTGACAAAGTAATTGTGACAAGAGCTTCAAAAATAAGTGGCAAATCCTTTTACAGAGTCTGAGCCCAAGAACTATAAAGGAATAGTCACTGGGACTGAATTGGGGAAGCTAAGGAAACCAATTCTTGTATTCATTAGAAATGTATTGGTGGCAAGTGATACTAACCCAGTGAAAGATAAGCAACTAAAGAAAAGTCCCTAAGAATGGGTACTTTAAGTAATGAGCTTAGCTAATAGAGAACACACAGTAAAGCTGGCCAAAGAAGTAGGGAAGAAATATCTACTTTCCTAAAGCAATTTAATTCTTAAGATAATAATATTAAATTATAATGTGGCACTCTGTGCTGTCCTATAATATCAGGAGCCCAGTTAATAAAGATTATCTTGGTGAGTGTGGACAAGAGCAATAATGCCTTTGTGAGTCTTGAAAACAAAAAATACAAATCTCAACATTTCCTTATTTGCCTAATATCTGCATCTCACTTTTTAAATTCCACAG
>TTN-209,,0,85,2240677,2240761,GTATTTATCACAGAAGCTTTTAGGTGAATTATTTTCTTCTCACACCTGTCCATGAATTAATTAAATTTTGTCATTAACTTTCCAG
>TTN-209,,0,171,2240762,2240932,GTAAGCATTTTACTTAAAATTGGCTATACAATGAGTAGATCCTCTAAAACAATATAGCTTGACCTATGATTGATCACCTCTCTAGAAAGGAACTATGTTGATTATATTTCCCCAAGAAAAAAAAAGCTATCAGGCAAATAGGAAATATGAATCTTTCATTCTGTTTTTCAG
>TTN-209,,0,119,2240933,2241051,GTATGTACCAAATAGCCAAAAAAAAAAAAAAAGTAAAGTAAAATGAAAACATTCAGAATTCGTAACAATTTACCATAAAAATAATGCTTAAGAATAAATGCCTGATTTCTTTCCCATAG
>TTN-209,,0,98,2241052,2241149,GTAAGGATGTGTGACAAAGATACAAGCAAGTTGATGTTCAGTCACCCAATTTTGATTTGAAGTAAAAATTAATTTCCTGTATTTCTTCTCTTTCATAG
>TTN-209,,0,679,2241150,2241828,GTAAGTCCACAGGCCCTTCCACCACTCTCCCCACCTCTGATTCTGAATGTTAACAAAAAAGAATTTGTTTTTAATATGCCCTAATGTAAATAAAAATAGGTCACAAAATTAACCCTGTGGTCTTTCTAAGGTTTCTAAACCTCCTTTTCTCAGGTTTCTAAACCTCCTTTTCTCAGAGGTTTTCAACACACTTAGGCTTGATTTTTTTTTTAATATCTTCACTCTTATGAAAGAGAAGAGGAGGGAGTTAGGAAGAAAGGAATGGAAGGAAGAAAAGAGAGAAGGGAAGGAGGAAGAGAGGAAAGGAAGGAGGACTGGCAATGTTATAGTGAGAAAAAAATACAGAGTGCATGCTTAATAAATGTAGAATTGAAGAAAATGAGGAACAGCAAGGAAAGTACAAAATTAAACCTCAGCATCATGCAATATACCCATGTAACAAACTGCACATGTACCCCTGAAGCTAAAAGTCAAAAATTTTTAATAAAAATAATTAAATAATTAAATGATTTAAATTAAAATTTACAAATAGTACAAAAGTGAAACTATTGGAAAAATAGTCATGTGCCTTATGTACCTTTTAAAATACCAACCAAAACCTAAGGAAAACACAAATATATGAGTCATTGTTTTAACGTATTCATATTGCCATATCGTGTTAACCTCTGTCTTGCTGCAG
>TTN-209,,0,911,2241829,2242739,GTAAGGACATTTTGTATCAGTCAAATTGATTGAGTTACAATTTATATGTGGGAAAATTCACCTTTTTGAAATATATAGTTCTATGACTTTTGAAAAATGTACTGTTTTGTAATCACCACCACAATCAAAATGTGGAATATTTTTATTACCCCGTAAAGTTCCCTTGTGTCCGTTTGTAATCAGTCCCTTCCCCACCCCAGCTGCTAGCGATTTCTGGCAAATAATTTTTAATATTCTTCTCTGGAGTCAATTTCCACTTCTTTAAGATGAGATTCATAATATATGCTTTCTATCACACTTAAAATTTTAAAACAAGTTAATATTTCTGGAAGCACTTTAAAAACTGCTGATAAATGTAAGATAATAATAGTGATTACAAATGAAGCACATTTAAGAGAAAGGAAAGTGAAAAAATGTTAAGTATTTTTAGCTGATAAAATGAATAAAATTTTCTTTTTTCTTTCTTTTGTTTTTTTGTGTTTTTTTGAGACAGAGTCTCACTCTGTCACCCAGGCTGGAGTGCAGTGGCATGATCTTGGCTCACTGCAACCTCTGTCTCCCAGGTTCAAGCAATTCTTCTGCCTCAGCCTCCTGAGTAGCTGGGATTACAGGTGCCTGCCACCACGCATGGCTAATTTTTATGTTTTTAGTAGAGACGCGGTTTCACCATGTTGGCCAGGCTGGTCTTGAACTAACTCCTGACCTCAAGTATCTGCCCACCTTGGCCTCCCAACTTGCTGTGATTACAGGCATGAGCCACCACACCCAGCCATGAATAAAATTTTCACAAGACAAAAAAACAGGCTAATGTTAACAGTCCGTTTCAACAACTCATTGAATTTGTTAGGTGGCACAGCTAATTTTCAACTTTGCAGCAACTTTAACCAGTATATTCTTATTCTTATTCTCAG
>TTN-209,,0,101,2242740,2242840,GTGAGACATATGATCATTTGCTTTCTGCAATAATTGCCATAGACTTATTTCTTAGTCCCCCTACCCCAAATGCTAAATTGAAACCCTACCTTTTTTTCCAG
>TTN-209,,0,130,2242841,2242970,GTAAGTGCCCTTTCAACCACAAAATTATAAACATTATTTCAGCACTTTTCTGTTTTTAAATGAAAGTCATTGGCTTATAATACTTGGGACTGTATTCTAATACATGTGTGCTTTCCACTTATATTTACAG
>TTN-209,,0,106,2242971,2243076,GTAAGGAATTCAGAAGAAGGGGTTAAATTAAAGAAGCAAGCCATGTTTGGTCCTTTTATTTCACCAGTAAAGCTGACTCCCTTTTCATTATTTTAAAATATTTCAG
>TTN-209,,0,622,2243077,2243698,GTAAGTAGCCTTTGGTTCTCTACTTATGATTTACAAACTAAACAAGTTAAGGCTAATTCCCCCTCTATACTAAGTAGAACCCTGGAAAGCTTTATTGGAGAGCAAGTGTTAAGAAAGAAAAGCAAGTACACACACAGGAAATATGACAAGTTCTACAGGAAACCATTCCAAGCACACAACCTCAGCAGATGTTAGATGGAGTGAACTGAGCACTTTCCTTGAGTAATTCCCTCTAATGCAATGGTTTCTTTTTAAAAATATTTCCCAACAAGATTTGAAAGGTCAACAATTGTATGCCACTTCAATGAACCTAAGTAAGGGCAAGAATACTACAGAATTATAGAGAGAATTTACAGTCCCTTAAAAGCCTATACATTATTAATCCCCTTCCAATCATAAAGAGAAAAAAACACTCTACATAAAATGTGACGATGTGCTCATTGAATCCCTATTTACCATATGATCCTAGGAAAATCACTTCAAAGAGTTTTTAAGAATTAGGCTAATATGTAAATCATGGTATGTGTCAGTAAATAAGGTAAATTCATTCCTGATATACAAGGACAAAGGATTACAGATTGAGTATTAACAGTCACTTAATATTATCTTTCATATTGTTCAG
>TTN-209,,0,98,2243699,2243796,GTATTTTATTTTTATTTTCAGTGCTTTTTATTTTTAAAGAAAAAAAAATCTCAAAAACACACTATGAAAACCACCACAATTGTATTTTCCCCCAACAG
>TTN-209,,0,362,2243797,2244158,GTGAGTACAACTTGATTTCTGTATCTTCCTATGGTAAAGTTCCATCTTTGCATAAAATTCTTTTAAACAGAAAGAAATTTTGAAAGGAAATAGCAAAGATTCAGATAAAGTACAAGTGCCTTTTCTTTCACTTTAATTGAATGTTTGCATATCTAAAAGGAGAAATATATATCCTAACCCCATTGTAAAAATAGAACTTTGGTTTTTGATATGTCTTAGTATAAAGTAACCAATTTCATCTTTCTGGAATAGCTATTTTTTAACAAAATTTTGGACTCATATAACATTCTTTTTTAAAAAAATAAGCTTTAATAAAGCTGCCTGTTTCATCTCATGACTCAAATCTTTTTTTTGTTTAATAG
>TTN-209,,0,132,2244159,2244290,GTAAAAATAAATAAATTATCATCAAGTTGAGGCTAAATGAGTTATTAACTTGGGGGTGGAGGCTATTGCACTTAAACACATACTGTTAGATGTTGCTAAATTATATTCTTTTTTTTTTTTTTTCTGATACAG
>TTN-209,,0,124,2244291,2244414,GTAACCAGTTCTTAAATGTCTCTTTCTTTTATCTTCTAAAATATTTTATCTTCTAAATTCAGCTTCCCAAAAAAAGCTTAAAATGAAATCACTTTTTAAAACACAAATCATTTGCATTCTACAG
>TTN-209,,0,740,2244415,2245154,GTAGGTTGGCTTTTGTTTTTACCCACATTTCTTCAGAAGATAATATTAGGGAAATATTTTCAAACATCCCCCCTTATATACACATACAAGAAAGTATTAAAATAAAATTATTTTCCTAATTCCAGAATACAATTTGTACACCAAAGCAGAAACACACATTTGAAGTTAGCATATGCTTTTCTATGAGCATAAAAAGCAGTTATTAAGTACCTAGTTATATGTGGTATTATATAAGATTCCATAGTGTCAGCCCCTGCTCCCAGGAATATTTAAGAATAAAGTCAGTGAATATACAAAATGGCACTACTTGCCTAAACCTTCACAGTTGCTAATTTTCCAAAGCAGTGCAAAGTTAATTAAAGAACTATTTCTATTTTACCAATTAAAATTAGTTTGCTTTCATTTCAATCTTCTGAAAGATAATTTAATGTTTTGGTTACTCAAAATCTCCCAAATCCACTTATCTCCTAAATCCGTTGACTATTCTTTTCAAGACTTTTTTCCTTAAGTCATATGAATCATCTTTGGCTCAGTTTAGTTTAAGGAATCATTACAGTGATCTCAAAAGTCACACATGATAATTTTCCAAAAGTGGAACTGAGAAAGTATTAGGTATTACCTACATTGCATGAAGAAGTTGACTTTTTTTCTTTTTATGTTTTTCACACGCAGAATCTAGAAGAGTAAAAGGTGGGGGTCTCTTTCTAATTAAGTTTGCCTTACAGAGGTTTCTTTTTTAG
>TTN-209,,0,100,2245155,2245254,GTAAGTTTAATTATGAATATATTATTGAAGAAAAACTAAAATACCATGTCTTCCACATCTGAAGAACTTCAACATTTCTTTTCTTTTTCCTTTGTCTTAG
>TTN-209,,0,525,2245255,2245779,GTAAGTATCTCCTCACCCTTCTTCCTTACATGTTTAAGGCCTTTAGATCGTTTTTTTGCCTCTCTTTCAAGCACAGAAAACTCTAAGAAGCCTTATTAAATTCCATGTGAAAGAGGGACAGCCAACTGATGTGAATTCATTCTTGTAGTCAAACTTTCTTTATAGCTACACAGAAACTTGGATAGATTACATTTCAAAGTAAAGCTACCAACTGCCGTGTAACATTTATTTGCAGGATGCACAATATGTCAATTACTTTCTATATGACTAATCATTTTTCTCCTAGTGATTCCTAGCACCTGCATGTAATGTAATGATAGAAATATAAGGATTCATGTTTTGGAGACATTGAGCTAGCTCTTGACAAATGTATGTATATATGTATTTGCTTATGCTTCAACAGCAAATTGTTTGGGTTATGCTGCTGTGTGTGTGTTGAAGTTTCCATTTCTGTAAGTCAGCGTCATATGTCATCAATTAACCAGATGTCATTGATGTTCACTGTGTATCTGCTATGCTCCACAG
>TTN-209,,0,138,2245780,2245917,GTGAGCAATAAAATTACTGGTAGAGGTAGACAAGCCAAGTAACATGGTGTAGTCTTTAGTACACACAATTCAGTAGAAAGCAAATCTTTATTTTTTTCAGTGATTCTAAGACCTTTTTTTTGTCATTGTTCCATAAAG
>TTN-211,ENSE00001465556,1,212,2245918,2246129,GAGCAGTCGTGCATTCCCAGCCTCGCCTCGGGTGTAGGGATTGCATAGAAAAGCAAAACTACACAGTCTTGACTGTGTAGTTTTGTTTTTAGGATTAGAGGCTCACCGATTCATGTCGGAGATGGTCAGAAAAACCAACTCTCCATAGGACGTCGTTTCAGAAGCAACCTTGGGCTTAGTCCCACCCTTTTTAGGCACTCTTGAGAAATCAG
>TTN-211,ENSE00003502146,1,104,2246130,2246233,AGTGCCTAGAAAGATGACAACTCAAGCACCGACGTTTACGCAGCCGTTACAAAGCGTTGTGGTACTGGAGGGTAGTACCGCAACCTTTGAGGCTCACATTAGTG
>TTN-211,ENSE00003807606,1,204,2246234,2246437,GTTTTCCAGTTCCTGAGGTGAGCTGGTTTAGGGATGGCCAGGTGATTTCCACTTCCACTCTGCCCGGCGTGCAGATCTCCTTTAGCGATGGCCGCGCTAAACTGACGATCCCCGCCGTGACTAAAGCCAACAGTGGACGATATTCCCTGAAAGCCACCAATGGATCTGGACAAGCGACTAGTACTGCTGAGCTTCTCGTGAAAG
>TTN-211,ENSE00003810976,1,288,2246438,2246725,CTGAGACAGCACCACCCAACTTCGTTCAACGACTGCAGAGCATGACCGTGAGACAAGGAAGCCAAGTGAGACTCCAAGTGAGAGTGACTGGAATCCCTACACCTGTGGTGAAGTTCTACCGGGATGGAGCCGAAATCCAGAGCTCCCTTGATTTCCAAATTTCACAAGAAGGCGACCTCTACAGCTTACTGATTGCAGAAGCATACCCTGAGGACTCAGGGACCTATTCAGTAAATGCCACCAATAGCGTTGGAAGAGCTACTTCGACTGCTGAATTACTGGTTCAAG
>TTN-211,ENSE00003809662,1,86,2246726,2246811,GTGAAGAAGAAGTACCTGCTAAAAAGACAAAGACAATTGTTTCGACTGCTCAGATCTCAGAATCAAGACAAACCCGAATTGAAAAG
>TTN-211,ENSE00003809782,1,245,2246812,2247056,AAGATTGAAGCCCACTTTGATGCCAGATCAATTGCAACAGTTGAGATGGTCATAGATGGTGCCGCTGGGCAACAGCTGCCACATAAAACACCTCCCAGGATTCCTCCGAAGCCAAAGTCAAGATCCCCAACACCACCGTCTATTGCTGCCAAAGCACAGCTGGCTCGGCAGCAGTCCCCATCGCCCATAAGACACTCCCCTTCCCCGGTCAGACACGTGCGGGCACCGACCCCATCTCCGGTCAG
>TTN-211,ENSE00003805863,1,331,2247057,2247387,GTCCGTGTCTCCAGCAGCAAGAATCTCCACATCCCCCATCAGGTCTGTTAGGTCTCCATTGCTCATGCGTAAGACTCAGGCATCCACCGTGGCCACAGGTCCTGAAGTGCCTCCCCCTTGGAAGCAAGAGGGCTACGTGGCCTCCTCATCTGAGGCTGAGATGAGAGAGACAACGCTGACAACCTCTACTCAGATCAGGACAGAAGAGAGATGGGAAGGGAGATACGGTGTCCAGGAGCAAGTGACCATCAGTGGTGCTGCGGGTGCTGCCGCCAGTGTGTCGGCCAGTGCTAGCTACGCAGCAGAGGCTGTTGCCACTGGTGCTAAAGAG
>TTN-211,ENSE00003803639,1,153,2247388,2247540,GTGAAACAAGATGCTGACAAAAGTGCAGCTGTTGCGACTGTTGTTGCTGCCGTTGATATGGCCAGAGTGAGAGAACCAGTGATCAGCGCTGTAGAGCAGACTGCTCAGAGGACAACCACGACTGCTGTGCACATCCAACCTGCTCAAGAACAG
>TTN-211,ENSE00003810843,1,138,2247541,2247678,GTAAGAAAGGAAGCGGAGAAGACTGCTGTAACTAAGGTAGTAGTGGCCGCCGATAAAGCCAAGGAACAAGAATTAAAATCAAGAACCAAAGAAGTAATTACCACAAAGCAAGAGCAGATGCACGTAACTCATGAGCAG
>TTN-211,ENSE00003803899,1,126,2247679,2247804,ATAAGAAAAGAAACTGAAAAAACATTTGTACCAAAGGTAGTAATTTCCGCAGCTAAAGCCAAAGAACAAGAAACTAGAATTTCTGAAGAAATTACTAAGAAACAGAAACAAGTAACTCAAGAAGCA
>TTN-211,ENSE00003809802,1,138,2247805,2247942,ATAATGAAGGAAACTAGGAAAACAGTTGTACCTAAAGTCATAGTTGCCACACCCAAAGTCAAAGAACAAGATTTAGTATCAAGAGGTAGAGAAGGCATTACTACCAAAAGAGAACAAGTGCAAATAACTCAGGAGAAG
>TTN-211,ENSE00003805623,1,138,2247943,2248080,ATGAGAAAGGAAGCCGAGAAAACTGCCTTGTCTACAATAGCAGTTGCTACTGCTAAAGCCAAAGAACAAGAAACAATACTGAGAACTAGAGAAACTATGGCTACTAGACAAGAACAAATCCAAGTTACCCATGGAAAG
>TTN-211,ENSE00003801659,1,294,2248081,2248374,GTGGACGTTGGAAAAAAGGCTGAAGCTGTAGCAACAGTTGTTGCTGCAGTAGACCAGGCCCGAGTCAGAGAGCCCAGAGAGCCTGGGCATCTTGAAGAATCCTATGCTCAGCAGACCACTTTGGAGTACGGATATAAGGAACGCATTTCCGCCGCAAAGGTAGCTGAGCCTCCCCAACGTCCAGCCTCAGAACCCCACGTTGTCCCTAAAGCAGTCAAGCCTAGAGTAATCCAGGCTCCTTCTGAGACTCATATCAAAACTACTGATCAAAAGGGAATGCACATATCATCACAG
>TTN-211,ENSE00003804455,1,123,2248375,2248497,ATCAAGAAAACTACAGATCTAACAACGGAAAGATTAGTCCATGTGGATAAACGCCCCCGCACAGCTAGCCCTCACTTTACTGTTTCAAAAATTTCTGTTCCTAAGACAGAACATGGATATGAG
>TTN-211,ENSE00003810306,1,282,2248498,2248779,GCATCAATAGCCGGTAGTGCTATTGCCACATTACAAAAAGAGTTGTCAGCCACATCTTCTGCTCAGAAGATCACCAAATCGGTGAAGGCTCCTACTGTGAAGCCCAGTGAGACTAGAGTAAGGGCAGAGCCCACACCCTTGCCACAGTTCCCCTTCGCTGACACACCAGATACTTACAAGAGTGAAGCTGGCGTTGAGGTGAAAAAGGAAGTAGGGGTGAGCATCACTGGCACCACCGTCCGTGAAGAGCGCTTTGAAGTACTGCACGGACGCGAAGCCAAG
>TTN-211,ENSE00003805296,1,66,2248780,2248845,GTAACAGAAACAGCAAGAGTACCAGCACCTGTTGAAATTCCTGTTACTCCACCAACTTTGGTCTCG
>TTN-211,ENSE00003806123,1,259,2248846,2249104,GGCTTAAAAAATGTGACTGTCATAGAAGGTGAATCTGTCACCTTGGAGTGCCACATCTCTGGATACCCATCCCCGACAGTGACATGGTACAGGGAAGACTACCAAATCGAAAGTTCCATTGACTTCCAGATAACCTTCCAGAGTGGAATTGCTCGTCTTATGATTCGCGAAGCATTTGCGGAAGACAGCGGGCGATTTACTTGCAGTGCTGTAAATGAGGCTGGAACCGTCAGCACATCCTGCTATCTGGCTGTGCAGG
>TTN-211,ENSE00003808554,1,64,2249105,2249168,TGTCAGAAGAATTTGAAAAGGAAACCACAGCCGTGACTGAGAAATTTACTACAGAAGAGAAACG
>TTN-211,ENSE00003804962,1,216,2249169,2249384,CTTTGTTGAGTCAAGAGATGTGGTTATGACTGATACTAGCCTCACAGAGGAACAAGCAGGGCCTGGAGAACCTGCCGCGCCTTACTTTATTACAAAACCAGTGGTCCAGAAACTGGTGGAAGGTGGGAGCGTGGTGTTTGGATGCCAAGTTGGCGGCAACCCAAAGCCCCATGTATACTGGAAAAAATCTGGTGTTCCTCTAACCACTGGATACAG
>TTN-211,ENSE00003804165,1,143,2249385,2249527,ATACAAAGTGAGTTACAACAAACAAACCGGTGAATGCAAGCTGGTGATTTCTATGACTTTTGCTGATGATGCTGGAGAATACACTATTGTTGTTCGCAATAAGCATGGAGAAACTTCTGCATCTGCTTCCTTGCTTGAAGAAG
>TTN-211,ENSE00003802603,1,206,2249528,2249733,CTGATTATGAGTTACTGATGAAGTCCCAGCAAGAAATGCTTTATCAGACACAAGTGACTGCATTTGTTCAAGAACCTAAAGTTGGAGAAACAGCACCTGGATTTGTATACTCTGAGTATGAAAAAGAGTATGAAAAAGAACAAGCCTTAATTAGGAAGAAAATGGCCAAAGATACTGTAGTGGTCAGAACTTATGTAGAAGATCAG
>TTN-211,ENSE00003807963,1,234,2249734,2249967,GAATTCCATATTTCTTCCTTTGAAGAGAGACTTATTAAAGAAATTGAATATAGAATAATAAAGACTACATTAGAAGAACTTCTTGAAGAAGATGGAGAAGAAAAGATGGCAGTTGACATTTCTGAATCTGAAGCTGTTGAATCAGGATTTGATTCAAGAATCAAGAATTATAGAATTCTTGAGGGGATGGGTGTCACTTTTCATTGCAAGATGTCTGGATATCCATTACCAAAG
>TTN-211,ENSE00003808968,1,245,2249968,2250212,ATTGCTTGGTACAAAGATGGCAAGCGCATCAAACATGGAGAAAGATACCAAATGGACTTTCTACAAGATGGCAGAGCTAGTCTGCGTATACCTGTTGTTCTTCCAGAAGATGAAGGAATCTACACTGCATTTGCCAGCAATATTAAAGGAAATGCAATTTGCTCAGGGAAATTGTATGTGGAGCCTGCTGCACCACTTGGAGCTCCGACTTACATTCCCACACTAGAGCCAGTGAGCAGAATCAG
>TTN-211,ENSE00003802614,1,272,2250213,2250484,ATCTCTCTCTCCACGTTCAGTGAGCAGGTCTCCTATACGCATGTCTCCTGCACGGATGTCACCTGCAAGGATGTCTCCTGCACGGATGTCCCCTGCAAGAATGTCCCCTGGACGTAGGCTGGAGGAGACAGATGAGTCACAACTTGAGAGACTATATAAACCAGTCTTTGTGTTAAAACCTGTTTCTTTCAAATGTTTAGAAGGGCAAACTGCCAGATTTGACTTAAAGGTTGTTGGTAGACCTATGCCAGAGACGTTCTGGTTTCATGATG
>TTN-211,ENSE00003811446,1,165,2250485,2250649,GCCAGCAAATTGTCAATGACTATACCCATAAAGTAGTCATTAAAGAAGATGGTACTCAATCACTAATTATTGTCCCTGCCACACCCAGTGATTCTGGGGAATGGACTGTGGTTGCCCAAAACAGGGCAGGCAGATCTTCAATTTCAGTGATTTTAACTGTGGAAG
>TTN-211,ENSE00003805710,1,169,2250650,2250818,CTGTGGAACATCAGGTAAAACCGATGTTTGTAGAAAAACTGAAAAATGTCAATATAAAGGAAGGTTCCCGACTTGAAATGAAAGTCAGAGCTACGGGTAACCCCAACCCTGACATTGTATGGTTGAAAAACAGTGACATCATTGTGCCTCATAAATATCCCAAAATCAG
>TTN-211,ENSE00003809358,1,1694,2250819,2252512,AATTGAAGGAACCAAGGGAGAAGCTGCCCTTAAAATCGATTCCACTGTCAGCCAAGATTCTGCCTGGTATACTGCGACTGCTATTAATAAAGCTGGCAGAGACACTACAAGATGCAAAGTAAATGTTGAAGTTGAGTTTGCAGAGCCTGAGCCAGAGAGAAAGTTAATCATCCCACGGGGGACATATAGAGCAAAGGAGATTGCAGCCCCAGAACTGGAGCCCCTCCATTTGCGATATGGCCAAGAGCAATGGGAAGAAGGTGATCTCTATGACAAAGAGAAACAACAGAAACCATTTTTCAAGAAAAAACTCACTTCCTTAAGACTTAAGCGCTTTGGGCCTGCCCACTTTGAATGCAGGCTAACACCCATTGGTGACCCAACGATGGTGGTGGAGTGGCTCCATGATGGAAAGCCACTTGAAGCAGCCAACAGGCTCCGTATGATCAATGAATTTGGGTACTGCAGCCTTGATTATGGCGTTGCATATTCTAGAGACAGTGGTATCATTACTTGCAGAGCCACTAACAAATATGGAACAGATCACACATCTGCTACCCTTATTGTTAAAGATGAGAAAAGTCTTGTGGAAGAATCCCAATTGCCTGAGGGGAGGAAAGGCTTACAGAGAATTGAAGAATTAGAGAGAATGGCTCATGAAGGTGCACTTACAGGTGTAACAACAGATCAGAAAGAAAAGCAAAAGCCAGACATTGTCTTGTACCCAGAGCCAGTTAGAGTACTTGAAGGGGAGACTGCAAGGTTCCGCTGCAGGGTAACAGGCTACCCTCAGCCCAAAGTCAACTGGTACCTCAATGGACAGCTCATCCGCAAAAGCAAAAGGTTCAGAGTTCGCTATGATGGTATCCATTACCTGGACATCGTGGACTGCAAATCATATGACACAGGTGAAGTGAAGGTCACCGCGGAAAATCCTGAAGGTGTGATAGAGCATAAAGTGAAGCTTGAGATTCAACAGAGGGAAGATTTTAGGTCTGTCCTTAGGAGAGCTCCTGAACCAAGGCCTGAGTTTCACGTACATGAACCAGGAAAGCTTCAGTTTGAAGTACAAAAAGTGGATAGACCTGTTGACACCACTGAAACCAAAGAAGTTGTGAAGTTGAAAAGGGCTGAAAGAATTACCCATGAAAAAGTGCCTGAAGAGTCGGAAGAGCTGCGCAGTAAATTCAAGCGCAGAACAGAAGAGGGCTATTATGAAGCCATTACCGCTGTGGAGCTCAAGTCTCGAAAGAAGGATGAATCCTATGAGGAACTCCTCAGGAAGACAAAAGATGAACTTCTCCACTGGACCAAAGAGTTAACTGAAGAGGAAAAGAAAGCTCTTGCCGAAGAAGGCAAAATCACGATTCCAACTTTTAAACCTGACAAGATTGAACTAAGTCCTAGTATGGAGGCTCCAAAAATCTTCGAAAGAATCCAGAGCCAAACAGTGGGCCAAGGATCTGATGCACACTTCCGGGTCAGAGTCGTGGGGAAACCAGACCCCGAATGTGAATGGTACAAAAATGGTGTCAAAATTGAACGGTCTGACCGGATCTACTGGTACTGGCCCGAAGACAATGTTTGTGAATTGGTCATAAGAGATGTGACTGCTGAGGACTCTGCCAGCATCATGGTAAAAGCCATCAACATAGCTGGAGAAACCTCCAGTCACGCATTCTTACTTGTCCAAG
>TTN-211,ENSE00003809440,1,282,2252513,2252794,CCAAGCAATTGATCACTTTCACACAGGAATTACAAGATGTTGTTGCTAAGGAAAAAGACACTATGGCAACCTTTGAATGTGAAACTTCAGAACCATTTGTCAAAGTGAAATGGTATAAAGATGGTATGGAGGTTCATGAGGGAGATAAATACAGGATGCACTCTGACAGAAAGGTTCACTTCCTCTCCATACTGACCATTGATACGTCTGATGCTGAAGATTACAGCTGTGTACTTGTGGAAGATGAAAATGTCAAAACGACTGCTAAACTTATTGTTGAAG
>TTN-211,ENSE00003802960,1,267,2252795,2253061,GTGCAGTTGTTGAGTTTGTGAAAGAACTTCAGGACATAGAAGTTCCAGAATCATATTCAGGAGAATTAGAGTGCATTGTATCCCCAGAAAATATAGAAGGAAAATGGTATCATAATGATGTGGAGCTTAAATCCAATGGCAAATATACAATTACATCTCGTCGTGGACGTCAGAACCTCACGGTCAAGGATGTAACCAAGGAGGACCAGGGAGAATACAGCTTTGTCATCGACGGGAAAAAGACAACCTGTAAATTAAAGATGAAAC
>TTN-211,ENSE00003804241,1,273,2253062,2253334,CCCGCCCCATTGCTATCCTACAAGGACTTAGTGACCAAAAAGTCTGTGAGGGTGACATTGTTCAGCTTGAAGTTAAAGTCTCCTTGGAAAGTGTGGAAGGCGTCTGGATGAAAGACGGCCAAGAAGTGCAGCCCAGTGACAGGGTTCACATTGTGATAGACAAACAATCTCATATGCTGCTCATTGAAGACATGACTAAGGAAGATGCTGGAAATTACTCTTTCACCATTCCAGCCCTTGGCCTCTCCACCAGTGGGCGTGTCTCTGTCTATA
>TTN-211,ENSE00003806988,1,264,2253335,2253598,GTGTGGACGTGATAACACCTCTAAAAGATGTTAATGTGATTGAAGGCACCAAGGCTGTGCTTGAATGTAAGGTGTCAGTCCCTGATGTGACTTCTGTTAAGTGGTACTTAAATGATGAACAAATCAAGCCTGATGACCGTGTACAGGCCATTGTGAAAGGTACTAAACAGCGACTAGTCATTAACCGAACTCATGCTTCAGACGAAGGACCTTACAAGCTGATAGTTGGCAGAGTTGAAACCAACTGTAATCTCTCTGTAGAAA
>TTN-211,ENSE00003804968,1,261,2253599,2253859,AAATTAAAATTATCAGAGGTCTTCGTGACCTTACCTGTACAGAAACTCAAAATGTGGTGTTTGAGGTTGAGCTGTCCCACTCTGGAATTGATGTCCTGTGGAATTTTAAGGACAAGGAAATCAAGCCCAGTTCTAAATATAAAATTGAAGCACATGGAAAAATATATAAATTGACAGTTCTAAATATGATGAAAGATGATGAAGGAAAATACACATTTTACGCGGGAGAAAATATGACATCTGGAAAACTTACTGTGGCAG
>TTN-211,ENSE00003809850,1,261,2253860,2254120,GTGGGGCCATCTCCAAGCCACTCACAGATCAGACCGTAGCTGAATCCCAGGAAGCTGTGTTTGAATGTGAAGTTGCCAACCCAGATTCCAAAGGCGAATGGTTGAGGGATGGCAAACACCTACCACTGACTAACAACATCAGAAGTGAGTCTGATGGCCACAAAAGGAGACTTATCATTGCTGCCACCAAATTAGATGACATTGGAGAATATACCTACAAGGTGGCCACCTCCAAAACATCTGCCAAACTCAAAGTTGAAG
>TTN-211,ENSE00003806479,1,264,2254121,2254384,CTGTCAAAATTAAGAAGACTCTGAAGAACCTCACAGTGACAGAAACACAGGATGCTGTTTTCACTGTCGAGCTTACACACCCTAATGTCAAAGGTGTCCAGTGGATCAAAAATGGAGTTGTGCTGGAATCCAATGAAAAGTATGCTATCTCTGTCAAAGGAACAATTTACTCTCTGAGGATTAAAAACTGTGCCATCGTGGATGAGTCTGTTTATGGCTTCAGGCTTGGAAGGCTTGGAGCCAGTGCCAGACTGCACGTGGAGA
>TTN-211,ENSE00003804523,1,261,2254385,2254645,CTGTCAAGATCATTAAAAAGCCAAAGGATGTGACAGCCTTGGAAAATGCCACTGTTGCCTTTGAAGTTAGTGTTTCCCATGACACTGTTCCAGTAAAATGGTTCCATAAGAGTGTGGAAATTAAGCCAAGTGACAAACACAGACTGGTCTCAGAAAGGAAAGTCCACAAGCTGATGCTGCAGAACATCTCCCCCTCAGATGCTGGGGAATACACAGCTGTGGTCGGGCAATTGGAATGCAAAGCAAAACTGTTTGTGGAGA
>TTN-211,ENSE00003807378,1,261,2254646,2254906,CATTACATATTACAAAAACCATGAAAAATATCGAGGTGCCTGAGACCAAAACTGCCTCTTTTGAGTGTGAGGTGTCCCACTTCAATGTCCCTTCCATGTGGCTGAAGAATGGTGTGGAAATTGAGATGAGTGAAAAGTTCAAGATAGTTGTGCAGGGAAAACTCCATCAGCTGATCATCATGAACACCAGCACAGAGGACTCGGCAGAATACACATTTGTCTGTGGCAATGACCAAGTCAGTGCCACCCTGACAGTCACCC
>TTN-211,ENSE00003807271,1,261,2254907,2255167,CAATCATGATTACTTCCATGCTGAAAGACATCAACGCTGAAGAAAAAGACACTATTACTTTTGAGGTGACAGTGAACTATGAAGGCATCTCTTACAAATGGTTAAAGAATGGTGTGGAAATCAAATCAACTGACAAGTGCCAGATGAGAACCAAAAAGCTCACACACTCACTGAACATCAGGAATGTTCACTTTGGGGATGCTGCTGACTACACCTTTGTGGCTGGAAAAGCAACATCAACAGCCACACTTTATGTGGAAG
>TTN-211,ENSE00003808172,1,142,2255168,2255309,CTCGTCATATAGAATTTAGGAAACACATTAAGGACATTAAGGTACTGGAGAAGAAGCGAGCCATGTTTGAATGTGAAGTTTCTGAACCTGACATCACTGTACAGTGGATGAAAGATGACCAGGAACTGCAGATCACAGACAG
>TTN-211,ENSE00003808223,1,166,2255310,2255475,AATAAAGATTCAGAAGGAGAAATATGTCCACCGCCTTCTGATCCCATCCACCCGGATGTCTGATGCTGGGAAGTACACAGTGGTGGCAGGAGGCAACGTGTCAACTGCAAAACTCTTTGTAGAAGGCAGAGATGTTCGCATCCGAAGTATTAAAAAGGAGGTTCAG
>TTN-211,ENSE00003810851,1,232,2255476,2255707,GTCATTGAGAAACAGCGTGCTGTTGTTGAATTTGAGGTCAATGAAGACGATGTTGATGCCCACTGGTATAAAGATGGCATTGAAATCAATTTCCAAGTTCAAGAACGACACAAATATGTAGTGGAAAGAAGAATCCACCGAATGTTTATCTCTGAGACCAGACAGAGCGATGCAGGAGAATACACCTTTGTGGCAGGAAGGAACAGGAGTTCTGTCACTCTCTATGTCAATG
>TTN-211,ENSE00003802092,1,285,2255708,2255992,CTCCTGAACCGCCCCAAGTTCTGCAGGAGCTCCAGCCTGTCACTGTGCAGTCTGGCAAGCCTGCCCGCTTCTGTGCCGTGATATCCGGAAGACCACAGCCCAAAATTTCCTGGTACAAGGAAGAGCAGCTGCTTTCCACTGGCTTCAAGTGCAAATTTCTTCATGATGGGCAAGAATACACGCTTTTGCTAATTGAAGCCTTCCCAGAGGATGCGGCAGTCTATACCTGTGAAGCCAAGAATGACTATGGTGTTGCCACAACATCAGCTTCACTCTCAGTGGAAG
>TTN-211,ENSE00003807103,1,126,2255993,2256118,TTCCAGAAGTTGTGTCTCCTGATCAGGAAATGCCTGTTTATCCACCTGCCATCATCACCCCGCTTCAGGACACTGTCACTTCTGAAGGGCAGCCAGCCCGTTTTCAATGCCGGGTTTCTGGAACAG
>TTN-211,ENSE00003801355,1,189,2256119,2256307,ATCTAAAAGTGTCGTGGTACAGCAAAGACAAGAAAATCAAGCCATCTCGGTTCTTTAGAATGACTCAATTTGAAGACACTTATCAACTGGAAATTGCCGAAGCTTATCCAGAAGATGAAGGAACTTACACGTTTGTTGCTAGTAATGCTGTAGGCCAAGTATCAAGCACAGCCAACCTGAGTCTGGAAG
>TTN-211,ENSE00003810791,1,57,2256308,2256364,CTCCTGAATCAATTTTGCATGAGAGGATTGAACAAGAGATTGAGATGGAAATGAAAG
>TTN-211,ENSE00004024265,1,2781,2256365,2259145,AGTTTTCTAGTTCTTTTCTGTCTGCCGAGGAAGAAGGACTTCATAGCGCCGAACTTCAATTATCTAAAATAAATGAAACACTTGAACTTTTGTCTGAATCTCCAGTTTACCCAACTAAATTTGATTCCGAAAAGGAAGGCACTGGCCCAATTTTCATCAAAGAAGTGTCAAATGCTGATATAAGCATGGGGGATGTGGCTACACTGTCTGTAACTGTCATTGGCATCCCCAAACCTAAAATTCAGTGGTTCTTTAATGGAGTGCTATTAACCCCTTCTGCTGACTACAAATTTGTTTTTGACGGTGATGATCATAGCCTGATCATTCTGTTCACCAAATTGGAGGATGAGGGAGAGTATACATGTATGGCCAGTAATGACTATGGAAAGACAATATGTAGTGCCTATCTAAAAATTAATTCCAAAGGAGAGGGTCACAAAGACACTGAAACAGAATCAGCAGTGGCAAAATCTCTGGAAAAGCTGGGAGGTCCTTGTCCTCCTCACTTCCTTAAGGAGTTAAAACCAATTCGCTGTGCTCAAGGGCTTCCTGCCATCTTTGAGTACACAGTGGTTGGAGAGCCTGCCCCTACTGTTACATGGTTCAAAGAAAACAAGCAGCTTTGCACCAGTGTTTATTACACTATCATTCATAACCCTAATGGCTCTGGAACTTTCATTGTCAATGACCCTCAGAGGGAAGACAGTGGCCTCTATATCTGTAAAGCAGAGAATATGTTGGGTGAGTCCACCTGTGCAGCAGAGCTGCTTGTGCTTCTGGAAGACACAGACATGACTGATACCCCCTGCAAAGCAAAGTCCACACCAGAGGCTCCTGAGGATTTTCCACAGACACCCTTAAAGGGTCCCGCAGTTGAAGCACTTGACTCAGAGCAGGAAATTGCAACGTTTGTAAAAGACACCATTTTGAAAGCTGCTTTAATTACAGAAGAAAACCAGCAACTATCTTATGAGCATATTGCTAAAGCCAATGAATTGAGCAGTCAGCTTCCTTTGGGAGCTCAGGAATTGCAATCCATTTTGGAGCAAGACAAGCTCACTCCTGAAAGCACCAGGGAATTTCTTTGCATCAATGGCAGTATTCACTTTCAGCCTCTCAAGGAACCATCTCCCAACCTACAGCTGCAGATTGTACAGTCCCAGAAAACCTTCTCCAAAGAAGGTATTCTAATGCCTGAAGAGCCTGAGACACAGGCAGTTCTATCAGATACCGAGAAAATCTTCCCAAGTGCCATGTCCATAGAACAAATTAATTCATTAACAGTTGAGCCTCTGAAAACTTTATTAGCTGAACCTGAAGGGAATTATCCACAGTCTTCAATAGAACCTCCAATGCATTCTTATCTAACCTCTGTGGCTGAGGAAGTACTTTCACCAAAAGAAAAGACAGTATCTGACACCAACAGAGAGCAAAGAGTGACTCTTCAAAAGCAAGAGGCACAAAGTGCGCTCATCTTGAGTCAGAGCTTAGCTGAGGGACACGTGGAGAGTCTCCAGAGTCCTGATGTCATGATCTCTCAGGTAAACTATGAGCCCCTAGTCCCTTCAGAACACTCATGCACAGAAGGAGGTAAAATTTTGATAGAAAGTGCAAATCCACTGGAAAATGCAGGGCAAGATTCTGCGGTCAGAATTGAGGAAGGCAAGTCCTTAAGATTTCCACTAGCACTTGAAGAAAAGCAGGTACTGCTCAAAGAAGAGCATTCTGACAACGTGGTGATGCCCCCAGACCAAATCATTGAGTCTAAAAGAGAGCCCGTGGCAATAAAGAAAGTGCAGGAGGTACAGGGAAGGGACCTTCTTTCTAAGGAAAGCTTGCTTTCTGGTATTCCAGAAGAGCAGAGATTAAACCTGAAAATTCAAATCTGCCGGGCTTTGCAAGCAGCCGTGGCCAGCGAGCAGCCAGGTCTTTTCTCTGAGTGGCTAAGAAATATTGAAAAGGTGGAGGTCGAGGCTGTAAACATCACCCAAGAGCCCAGACACATCATGTGCATGTACCTTGTTACTTCGGCAAAGTCTGTAACAGAAGAAGTAACCATCATTATTGAAGATGTTGATCCTCAAATGGCTAACCTGAAAATGGAACTTAGGGATGCTTTGTGTGCTATTATATATGAGGAAATAGACATCCTAACAGCTGAGGGTCCTAGAATTCAGCAAGGAGCCAAAACAAGTTTGCAAGAAGAAATGGATTCTTTTTCAGGTTCACAGAAGGTTGAACCCATTACTGAACCAGAAGTTGAATCTAAATATCTGATCTCAACTGAAGAGGTCAGTTATTTTAACGTGCAAAGTAGGGTTAAATATTTGGATGCCACACCTGTCACTAAAGGGGTTGCTTCAGCTGTTGTCTCTGACGAAAAACAAGATGAGAGTCTGAAACCATCAGAGGAAAAAGAGGAGTCTTCCTCTGAAAGTGGTACTGAGGAGGTTGCTACAGTAAAGATACAGGAAGCTGAGGGTGGCTTAATCAAAGAGGATGGCCCCATGATACATACACCTTTAGTGGACACTGTTTCTGAGGAAGGTGATATTGTACACCTCACAACATCCATAACAAATGCTAAAGAGGTGAATTGGTATTTTGAGAATAAACTGGTGCCTTCAGATGAAAAGTTCAAGTGTTTACAAGATCAAAATACATATACGCTAGTCATCGACAAAGTAAATACCGAAGACCATCAAGGAGAGTATGTCTGTGAGGCCTTGAATGACAGCGGAAAAACAGCAACTTCAGCCAAACTCACTGTAGTAAAAAGAG
>TTN-211,ENSE00003805227,1,279,2259146,2259424,CTGCCCCAGTGATCAAGAGGAAAATCGAACCCCTGGAAGTAGCACTGGGCCACCTAGCCAAATTCACCTGTGAGATCCAAAGTGCTCCCAATGTCCGGTTCCAGTGGTTTAAAGCTGGCCGAGAAATTTATGAGAGTGACAAGTGTTCTATTCGATCTTCAAAGTATATCTCCAGCCTTGAAATCCTGAGAACCCAGGTGGTTGACTGCGGCGAGTATACATGCAAAGCTTCCAATGAGTATGGCAGTGTCAGCTGTACAGCCACACTAACTGTGACAG
>TTN-211,ENSE00003804802,1,81,2259425,2259505,TGCCTGGAGGTGAAAAGAAAGTTCGCAAATTACTTCCGGAACGTAAACCTGAACCAAAGGAAGAAGTTGTTCTGAAAAGCG
>TTN-211,ENSE00003811452,1,75,2259506,2259580,TTCTAAGAAAAAGACCTGAAGAAGAAGAACCTAAAGTAGAACCTAAAAAACTAGAAAAAGTTAAAAAACCTGCAG
>TTN-211,ENSE00003807205,1,90,2259581,2259670,TACCAGAACCACCACCTCCAAAACCTGTTGAAGAGGTTGAAGTACCTACTGTTACAAAAAGGGAAAGGAAGATTCCTGAACCAACAAAAG
>TTN-211,ENSE00003806747,1,63,2259671,2259733,TGCCTGAAATCAAGCCAGCAATACCTCTCCCTGCACCTGAACCGAAACCAAAGCCCGAAGCAG
>TTN-211,ENSE00003810755,1,90,2259734,2259823,AAGTGAAAACAATCAAACCACCTCCTGTGGAACCTGAACCAACCCCCATCGCTGCCCCAGTAACAGTGCCAGTGGTTGGAAAGAAAGCAG
>TTN-211,ENSE00003806122,1,51,2259824,2259874,AAGCCAAAGCACCTAAGGAAGAGGCTGCCAAGCCAAAAGGTCCTATCAAAG
>TTN-211,ENSE00003804858,1,402,2259875,2260276,GTGTACCCAAAAAGACTCCTTCACCAATAGAAGCCGAAAGGAGAAAGTTAAGGCCAGGAAGTGGTGGAGAGAAACCTCCTGATGAAGCCCCGTTCACCTACCAGCTAAAGGCTGTGCCACTGAAGTTTGTGAAAGAAATCAAAGACATCATCTTGACAGAATCAGAGTTCGTTGGCTCTTCAGCAATCTTTGAATGTTTGGTCTCCCCTTCCACTGCAATTACAACCTGGATGAAAGACGGTAGCAATATCCGTGAGAGTCCCAAGCACAGGTTTATTGCAGATGGTAAAGACAGAAAGCTGCACATCATTGATGTTCAACTTTCCGATGCTGGTGAATACACCTGTGTTTTACGTTTGGGAAACAAAGAAAAGACCTCCACGGCTAAACTTGTTGTAGAAG
>TTN-211,ENSE00003803996,1,279,2260277,2260555,AACTTCCTGTGCGTTTTGTAAAAACACTGGAAGAGGAAGTCACAGTGGTCAAAGGACAGCCATTGTACTTGAGCTGCGAGTTAAACAAAGAGCGTGACGTGGTCTGGAGGAAGGATGGCAAGATTGTGGTGGAGAAACCTGGCCGAATTGTGCCAGGCGTCATTGGCTTGATGCGGGCTCTGACCATCAACGATGCAGATGACACAGATGCTGGAACATACACAGTTACTGTGGAAAACGCCAACAACCTGGAGTGTTCATCTTGCGTAAAAGTAGTAG
>TTN-211,ENSE00003807976,1,276,2260556,2260831,AAGTCATTAGAGATTGGCTGGTGAAACCTATACGAGACCAGCATGTGAAACCCAAGGGGACAGCTATTTTTGCCTGTGATATAGCAAAAGATACTCCAAACATTAAGTGGTTCAAAGGATATGATGAAATCCCTGCGGAACCAAATGATAAGACTGAAATACTGAGAGATGGAAATCATCTGTACCTCAAAATTAAGAATGCTATGCCAGAAGATATTGCTGAGTATGCAGTGGAAATTGAAGGAAAAAGATACCCTGCAAAGCTGACACTTGGAG
>TTN-211,ENSE00003804328,1,140,2260832,2260971,AGCGTGAAGTTGAACTGCTTAAACCAATAGAGGACGTTACCATTTATGAGAAAGAAAGTGCAAGCTTTGATGCAGAAATCTCAGAGGCAGACATTCCTGGACAATGGAAACTGAAAGGAGAACTTCTAAGGCCCTCACCT
>TTN-211,ENSE00003802254,1,127,2260972,2261098,ACTTGTGAAATCAAAGCAGAAGGTGGAAAACGCTTCTTAACTTTGCACAAAGTCAAACTGGACCAAGCTGGTGAAGTCCTCTACCAGGCCCTTAATGCAATTACAACTGCCATTTTGACAGTAAAAG
>TTN-211,ENSE00003811410,1,264,2261099,2261362,AAATCGAACTTGACTTTGCTGTGCCCCTGAAGGATGTCACTGTTCCAGAAAGGCGACAGGCTCGATTCGAATGTGTCCTCACCCGAGAGGCAAATGTTATATGGTCCAAAGGACCTGATATAATTAAGTCATCTGACAAATTTGATATCATCGCTGATGGAAAGAAACATATTCTTGTTATTAATGATTCTCAATTTGATGATGAAGGGGTCTATACTGCTGAGGTGGAGGGCAAGAAGACCTCAGCTCGGTTGTTTGTCACAG
>TTN-211,ENSE00003805150,1,267,2261363,2261629,GTATAAGACTGAAATTCATGTCACCTCTTGAAGATCAAACAGTAAAAGAAGGTGAAACAGCAACTTTTGTTTGTGAACTTTCTCATGAAAAAATGCATGTAGTCTGGTTCAAAAATGATGCCAAACTCCATACAAGCAGAACAGTACTCATCTCTTCTGAGGGCAAGACTCACAAATTGGAAATGAAAGAAGTGACATTGGATGATATATCTCAGATAAAAGCTCAAGTCAAGGAGCTGAGCTCCACAGCACAGCTGAAGGTCTTAG
>TTN-211,ENSE00003801907,1,264,2261630,2261893,AGGCCGATCCCTACTTCACTGTGAAATTACATGACAAAACTGCAGTGGAGAAGGATGAGATTACTTTGAAGTGTGAAGTGAGCAAAGATGTACCAGTGAAATGGTTCAAAGATGGTGAAGAGATTGTCCCTTCACCCAAATATTCTATCAAGGCAGATGGCCTGCGCCGCATCTTAAAAATCAAAAAGGCGGACCTTAAAGATAAAGGCGAATATGTGTGTGACTGTGGCACAGACAAGACCAAGGCAAATGTTACTGTTGAGG
>TTN-211,ENSE00003802031,1,140,2261894,2262033,CTCGACTAATAAAAGTGGAAAAGCCTCTGTACGGAGTAGAGGTGTTTGTTGGTGAAACAGCCCACTTTGAAATTGAACTTTCTGAACCTGATGTTCACGGCCAGTGGAAGCTGAAAGGACAGCCTTTGACAGCTTCCCCT
>TTN-211,ENSE00003811443,1,127,2262034,2262160,GACTGTGAAATCATTGAGGATGGAAAGAAGCATATTCTGATCCTTCATAACTGTCAGCTGGGTATGACAGGAGAGGTTTCCTTCCAGGCTGCTAATGCCAAATCTGCAGCCAATCTGAAAGTGAAAG
>TTN-211,ENSE00003811384,1,267,2262161,2262427,AATTGCCTCTTATCTTCATCACACCTCTCAGTGATGTTAAAGTCTTCGAGAAAGATGAGGCTAAGTTTGAGTGTGAAGTATCCAGGGAGCCCAAAACATTCCGTTGGCTAAAAGGAACCCAGGAAATCACAGGTGATGACAGATTTGAGCTTATAAAGGATGGCACTAAGCATTCAATGGTGATCAAGTCAGCTGCTTTTGAAGATGAAGCAAAATACATGTTTGAAGCTGAAGATAAGCACACAAGTGGCAAACTGATCATTGAAG
>TTN-211,ENSE00003801954,1,267,2262428,2262694,GAATCCGGCTCAAATTCCTCACCCCTCTCAAAGATGTAACTGCCAAAGAGAAGGAAAGTGCTGTATTTACTGTGGAGTTATCTCATGATAACATCCGAGTTAAATGGTTCAAGAATGACCAGCGCCTACACACCACCAGGTCGGTCTCAATGCAAGACGAAGGGAAAACTCATTCGATCACATTCAAAGACCTGTCTATTGATGACACCTCCCAAATTAGAGTAGAAGCTATGGGGATGAGTTCAGAAGCTAAACTCACTGTGCTTG
>TTN-211,ENSE00003809996,1,267,2262695,2262961,AGGGAGACCCATATTTTACAGGAAAACTTCAAGATTATACTGGTGTAGAGAAAGATGAAGTTATTCTACAGTGTGAAATTAGCAAAGCAGATGCACCAGTGAAATGGTTTAAGGATGGGAAGGAAATAAAGCCATCCAAAAATGCTGTTATTAAGGCAGATGGCAAGAAACGCATGCTAATCCTAAAGAAAGCCTTGAAATCAGATATTGGACAGTACACCTGTGACTGTGGGACAGATAAGACCTCAGGAAAACTTGACATTGAGG
>TTN-211,ENSE00003804589,1,140,2262962,2263101,ATCGGGAAATTAAACTGGTGCGACCCCTGCACAGTGTGGAGGTGATGGAGACTGAGACAGCACGCTTTGAAACCGAAATCTCTGAAGATGATATCCACGCCAACTGGAAACTCAAGGGAGAGGCCCTACTCCAAACACCT
>TTN-211,ENSE00003805931,1,127,2263102,2263228,GATTGTGAAATTAAGGAAGAAGGCAAAATACACTCCCTTGTTTTGCACAACTGTCGCCTGGACCAGACGGGTGGGGTGGATTTCCAAGCTGCCAATGTTAAATCTAGTGCCCACCTCCGAGTTAAGC
>TTN-211,ENSE00003811344,1,143,2263229,2263371,CACGAGTAATTGGTCTTCTGAGGCCTTTAAAGGATGTCACCGTGACTGCAGGGGAAACAGCCACCTTCGACTGCGAGCTCTCCTACGAAGATATCCCAGTGGAATGGTATCTCAAAGGGAAGAAACTAGAGCCCAGCGATAAG
>TTN-211,ENSE00003802375,1,124,2263372,2263495,GTGGTCCCACGTTCAGAAGGAAAAGTTCATACACTTACTCTGAGGGATGTAAAGTTAGAAGATGCTGGGGAAGTCCAACTAACAGCAAAAGATTTCAAAACTCACGCCAACCTCTTTGTGAAAG
>TTN-211,ENSE00003806733,1,267,2263496,2263762,AACCCCCAGTTGAATTCACTAAGCCTCTTGAGGACCAGACGGTCGAAGAGGGAGCCACTGCAGTGCTGGAGTGTGAAGTCTCCAGAGAAAATGCTAAGGTGAAATGGTTCAAAAATGGGACAGAAATCCTCAAAAGCAAGAAGTATGAAATTGTTGCTGATGGCAGGGTCAGAAAACTTGTTATACATGACTGTACCCCAGAGGATATTAAAACATACACTTGTGATGCTAAGGATTTTAAGACTTCCTGTAACCTGAATGTCGTGC
>TTN-211,ENSE00003807497,1,98,2263763,2263860,CTCCTCATGTGGAATTCTTAAGACCACTCACCGACCTTCAAGTTAGAGAAAAAGAAATGGCTCGATTTGAGTGTGAACTTTCCCGAGAAAATGCTAAG
>TTN-211,ENSE00003802530,1,169,2263861,2264029,GTTAAGTGGTTTAAAGATGGTGCTGAAATTAAAAAGGGCAAAAAATATGACATCATATCCAAGGGAGCAGTGCGCATTCTTGTCATCAACAAATGTCTACTGGATGATGAAGCTGAATATTCCTGTGAAGTAAGGACAGCGAGAACTTCTGGCATGCTGACAGTTCTGG
>TTN-211,ENSE00003811387,1,267,2264030,2264296,AAGAAGAAGCTGTCTTTACCAAAAATCTTGCCAACATTGAAGTTAGTGAAACAGACACTATAAAACTGGTTTGTGAAGTCTCCAAACCTGGCGCAGAAGTGATTTGGTATAAAGGGGATGAGGAGATCATTGAAACAGGAAGATATGAAATACTGACTGAAGGACGGAAGAGAATCCTGGTCATTCAGAACGCTCACCTTGAGGATGCTGGCAACTACAACTGTCGACTCCCAAGCTCTCGAACCGATGGCAAAGTCAAAGTACATG
>TTN-211,ENSE00003802653,1,267,2264297,2264563,AACTGGCTGCTGAATTTATCTCAAAGCCTCAAAACCTTGAAATACTTGAAGGAGAAAAGGCTGAATTTGTCTGCTCTATATCAAAAGAAAGCTTTCCAGTCCAGTGGAAGAGGGATGATAAGACACTTGAATCTGGAGATAAATATGACGTTATTGCTGATGGTAAAAAGAGGGTCCTAGTTGTGAAAGATGCCACATTACAAGATATGGGCACTTACGTTGTCATGGTAGGGGCCGCCAGAGCAGCAGCTCACTTGACAGTCATTG
>TTN-211,ENSE00003802540,1,279,2264564,2264842,AAAAACTCAGGATCGTAGTTCCTCTTAAGGACACCCGGGTGAAGGAACAACAGGAAGTTGTCTTCAACTGTGAAGTCAATACTGAAGGTGCCAAAGCCAAATGGTTCAGAAATGAAGAAGCTATATTTGATAGTTCAAAATACATCATTCTCCAAAAAGACCTAGTCTACACCCTCAGAATTAGAGATGCACACTTAGATGACCAAGCCAACTATAATGTGTCTTTGACCAATCACAGAGGTGAAAATGTTAAAAGTGCAGCCAATCTAATAGTAGAAG
>TTN-211,ENSE00003802874,1,409,2264843,2265251,AGGAAGACCTTAGGATTGTTGAGCCTCTTAAAGATATTGAAACAATGGAGAAGAAATCTGTCACATTCTGGTGCAAGGTGAATCGTCTCAATGTAACACTGAAGTGGACCAAAAATGGTGAAGAAGTGCCTTTTGACAACCGTGTCTCATACAGAGTTGATAAGTACAAGCACATGTTAACCATTAAAGACTGTGGCTTCCCAGATGAAGGTGAATACATTGTCACTGCTGGACAAGATAAATCTGTTGCTGAGCTTCTCATCATAGAAGCCCCGACAGAATTTGTGGAACACTTGGAAGATCAGACAGTCACTGAGTTCGATGACGCTGTCTTCTCCTGCCAGCTCTCCAGAGAGAAAGCCAATGTAAAATGGTACAGAAATGGGAGAGAAATCAAAGAAGGCAAAAA
>TTN-211,ENSE00003804130,1,125,2265252,2265376,ATACAAATTTGAAAAAGATGGAAGTATACACAGACTCATTATAAAAGATTGCAGGCTGGATGATGAGTGTGAATATGCTTGCGGGGTAGAAGACAGGAAGTCTCGTGCTAGACTTTTTGTGGAAG
>TTN-211,ENSE00003807647,1,267,2265377,2265643,AAATTCCTGTTGAGATCATCAGGCCTCCACAAGATATTCTTGAAGCCCCTGGTGCTGATGTTGTCTTTTTAGCAGAACTCAATAAAGATAAGGTGGAAGTCCAATGGCTAAGAAATAACATGGTTGTTGTCCAGGGTGATAAACACCAGATGATGAGTGAAGGAAAGATACATCGACTACAGATTTGTGATATTAAGCCCCGTGACCAGGGTGAATACAGATTTATTGCCAAAGACAAAGAAGCCAGAGCTAAGCTTGAACTGGCAG
>TTN-211,ENSE00003802353,1,270,2265644,2265913,CTGCACCAAAAATCAAGACAGCTGACCAAGACCTTGTGGTTGATGTTGGCAAGCCTCTGACAATGGTGGTGCCATATGATGCCTACCCCAAAGCAGAAGCTGAATGGTTTAAAGAAAATGAACCTTTATCTACAAAAACCATTGATACTACGGCTGAACAAACTTCTTTCAGAATTTTAGAAGCCAAGAAAGGAGACAAAGGGAGGTATAAAATTGTGCTTCAGAACAAACATGGAAAAGCAGAAGGATTCATCAATTTAAAAGTTATTG
>TTN-211,ENSE00003809195,1,303,2265914,2266216,ATGTTCCTGGGCCAGTACGTAACTTAGAAGTGACAGAAACATTTGATGGTGAAGTGAGCCTTGCTTGGGAAGAACCTTTAACTGATGGTGGAAGCAAAATCATAGGTTACGTTGTTGAAAGACGTGACATTAAGAGAAAGACCTGGGTTCTGGCCACAGACCGTGCAGAGAGTTGTGAGTTTACTGTCACTGGTCTACAGAAAGGAGGAGTTGAGTACCTATTCCGTGTGAGTGCAAGAAACAGAGTTGGCACTGGTGAGCCAGTAGAAACTGACAATCCTGTAGAAGCAAGGAGTAAATATG
>TTN-211,ENSE00003803170,1,303,2266217,2266519,ATGTTCCAGGCCCTCCTTTGAATGTAACCATCACTGATGTGAATCGATTTGGTGTCTCACTGACATGGGAACCACCAGAGTATGATGGAGGTGCTGAGATCACAAACTACGTCATTGAATTAAGAGACAAGACTTCTATCAGGTGGGATACTGCCATGACTGTGAGAGCTGAAGACCTGTCTGCAACTGTTACTGATGTGGTAGAAGGACAGGAGTACAGTTTCCGAGTGAGAGCCCAAAATCGAATTGGAGTTGGAAAACCAAGTGCAGCCACACCCTTCGTCAAAGTTGCTGATCCAATTG
>TTN-211,ENSE00003806295,1,188,2266520,2266707,AGAGACCAAGTCCTCCTGTAAACCTAACTTCCTCAGATCAGACTCAGTCATCAGTTCAGCTCAAATGGGAACCTCCTCTGAAAGATGGAGGAAGCCCAATATTAGGCTATATAATTGAGCGATGCGAAGAAGGAAAAGATAATTGGATTCGTTGCAATATGAAACTTGTCCCTGAACTGACTTACAAG
>TTN-211,ENSE00003810732,1,115,2266708,2266822,GTTACCGGATTGGAAAAAGGAAATAAATATTTATATAGAGTATCTGCAGAAAATAAAGCTGGTGTTTCAGATCCATCTGAAATTCTTGGTCCTCTCACCGCTGACGATGCATTTG
>TTN-211,ENSE00003809985,1,285,2266823,2267107,TTGAACCAACAATGGATTTAAGTGCATTTAAAGATGGTCTGGAAGTTATTGTCCCAAATCCTATCACGATCCTGGTTCCAAGTACAGGCTATCCAAGGCCAACTGCAACCTGGTGTTTTGGAGATAAAGTACTAGAAACAGGGGACCGGGTGAAAATGAAGACCTTGTCTGCCTATGCCGAACTTGTCATTTCTCCAAGTGAACGTTCAGACAAGGGCATTTATACACTGAAATTAGAAAACCGTGTGAAAACAATTTCTGGGGAAATTGATGTCAATGTAATTG
>TTN-211,ENSE00003808828,1,152,2267108,2267259,CTCGCCCAAGTGCACCCAAAGAATTGAAATTTGGTGATATAACCAAGGACTCAGTACATTTGACTTGGGAACCACCTGATGATGATGGAGGAAGTCCGTTAACTGGATACGTTGTTGAAAAACGAGAAGTCAGCCGGAAAACATGGACTAAA
>TTN-211,ENSE00003803811,1,148,2267260,2267407,GTTATGGACTTTGTGACTGATCTAGAATTCACAGTTCCTGATCTTGTTCAAGGAAAAGAGTACTTATTTAAAGTTTGTGCTCGTAACAAATGTGGCCCTGGAGAACCTGCATATGTTGATGAACCTGTAAATATGTCAACTCCTGCAA
>TTN-211,ENSE00003803944,1,178,2267408,2267585,CGGTACCTGACCCACCAGAGAATGTTAAATGGAGAGATCGAACAGCCAATAGCATCTTCTTAACATGGGATCCACCTAAAAATGATGGTGGTTCACGCATCAAAGGATATATAGTTGAAAGATGTCCACGTGGTTCTGATAAATGGGTTGCCTGTGGAGAACCTGTTGCAGAAACAAA
>TTN-211,ENSE00003802090,1,122,2267586,2267707,AATGGAAGTGACAGGTCTTGAGGAAGGCAAATGGTATGCCTACCGCGTGAAGGCCTTAAACAGGCAGGGTGCTAGCAAACCAAGCAGACCCACAGAGGAAATCCAGGCTGTGGACACACAAG
>TTN-211,ENSE00003809522,1,288,2267708,2267995,AGGCCCCAGAAATCTTCCTCGATGTGAAGCTCCTTGCTGGTCTCACTGTAAAAGCTGGGACCAAGATTGAACTTCCTGCCACCGTAACCGGAAAACCTGAACCTAAAATAACTTGGACAAAGGCTGATATGATTCTGAAGCAGGACAAAAGAATTACCATTGAAAATGTCCCTAAGAAATCCACAGTGACTATTGTTGATAGTAAGAGAAGTGACACTGGCACATATATCATTGAGGCTGTGAATGTGTGTGGCCGGGCCACTGCTGTGGTGGAAGTGAACGTCTTAG
>TTN-211,ENSE00003804879,1,297,2267996,2268292,ATAAACCCGGACCACCAGCTGCCTTTGACATCACAGATGTAACCAATGAGTCATGTCTTCTAACATGGAACCCACCACGCGATGATGGTGGATCTAAGATCACAAACTATGTTGTGGAGAGACGAGCAACTGATAGTGAAGTGTGGCACAAGCTCTCATCCACCGTCAAGGATACAAACTTCAAGGCCACCAAATTAATCCCCAATAAAGAGTACATCTTCAGAGTTGCTGCAGAAAACATGTATGGTGTTGGTGAACCAGTTCAGGCCTCTCCAATAACAGCCAAATATCAGTTTG
>TTN-211,ENSE00003809410,1,187,2268293,2268479,ATCCACCTGGTCCTCCAACTCGCCTAGAACCTTCTGATATCACTAAAGACGCAGTGACTCTCACATGGTGTGAGCCAGATGATGATGGTGGCAGCCCAATCACAGGATACTGGGTTGAAAGACTGGATCCTGATACAGATAAATGGGTTAGATGCAATAAGATGCCAGTAAAGGACACAACATACAG
>TTN-211,ENSE00003808827,1,116,2268480,2268595,AGTGAAAGGTCTCACTAATAAGAAAAAATACAGATTCCGTGTGTTGGCTGAAAATCTTGCTGGACCTGGAAAACCAAGCAAATCAACTGAACCAATCTTAATAAAGGATCCCATAG
>TTN-211,ENSE00003806136,1,300,2268596,2268895,ATCCTCCATGGCCCCCTGGAAAACCAACTGTAAAAGATGTAGGCAAAACATCAGTAAGGTTGAATTGGACAAAACCAGAACATGATGGAGGTGCAAAGATTGAGTCTTATGTCATTGAAATGCTGAAGACTGGAACAGATGAGTGGGTCAGAGTGGCGGAAGGGGTTCCCACCACTCAGCACTTGCTCCCAGGGCTCATGGAAGGACAGGAATACTCATTCCGAGTTAGAGCTGTGAATAAGGCTGGGGAAAGTGAACCCAGTGAACCCAGTGACCCTGTGCTTTGCCGGGAGAAGCTAT
>TTN-211,ENSE00003804290,1,300,2268896,2269195,ATCCTCCATCACCACCACGCTGGCTTGAAGTTATTAATATCACAAAAAATACAGCAGACCTAAAATGGACAGTTCCTGAGAAAGATGGAGGGTCCCCCATCACCAACTACATTGTGGAAAAGAGAGACGTCAGGCGAAAAGGCTGGCAAACAGTGGATACCACTGTCAAGGACACCAAGTGCACAGTCACCCCACTGACTGAGGGCTCTTTATATGTGTTCCGAGTTGCTGCAGAAAATGCTATAGGACAAAGCGACTACACCGAAATTGAGGACTCTGTGCTGGCCAAAGACACCTTTA
>TTN-211,ENSE00003803723,1,106,2269196,2269301,CCACTCCTGGACCACCCTACGCCCTGGCAGTGGTTGATGTGACAAAACGACATGTTGACCTAAAGTGGGAGCCACCTAAAAATGATGGTGGAAGACCAATACAGAG
>TTN-211,ENSE00003805819,1,197,2269302,2269498,ATATGTCATTGAGAAGAAAGAAAGGTTAGGTACCCGTTGGGTGAAAGCTGGAAAGACTGCAGGACCTGACTGTAACTTCAGAGTAACTGATGTCATCGAAGGAACAGAGGTCCAGTTTCAGGTTCGGGCTGAAAATGAAGCTGGAGTTGGCCACCCAAGTGAACCCACAGAAATCCTATCCATTGAAGATCCAACAA
>TTN-211,ENSE00003806467,1,306,2269499,2269804,GTCCTCCCTCACCACCCCTTGACCTACATGTGACTGATGCTGGGAGAAAACACATTGCCATTGCTTGGAAGCCTCCAGAGAAAAATGGTGGAAGTCCTATCATAGGATACCATGTTGAAATGTGTCCAGTAGGCACTGAGAAATGGATGAGAGTTAATTCTCGCCCAATAAAGGACTTGAAATTCAAGGTTGAAGAAGGTGTTGTTCCTGACAAAGAATATGTCCTGAGAGTGAGAGCAGTCAATGCTATTGGTGTCAGCGAGCCATCTGAAATCTCTGAAAATGTGGTTGCCAAAGACCCAGACT
>TTN-211,ENSE00003808061,1,279,2269805,2270083,GCAAGCCAACAATTGACCTGGAGACTCATGACATTATTGTTATTGAAGGTGAAAAGTTAAGCATTCCTGTTCCCTTCAGAGCTGTCCCAGTTCCAACTGTTAGTTGGCATAAAGATGGCAAAGAAGTTAAAGCAAGTGATAGATTAACAATGAAGAATGATCACATCTCTGCACACCTTGAAGTTCCCAAGAGTGTCCGTGCAGATGCCGGAATTTATACCATTACACTGGAGAATAAGCTCGGCTCAGCAACAGCCTCAATCAATGTCAAAGTCATAG
>TTN-211,ENSE00003811164,1,300,2270084,2270383,GCCTACCTGGACCATGCAAAGATATTAAAGCAAGTGACATTACCAAGAGTTCTTGTAAGTTAACTTGGGAACCTCCAGAATTTGATGGTGGAACCCCAATTCTTCATTATGTCCTGGAGCGCAGAGAAGCTGGGAGGAGAACATATATACCAGTCATGTCTGGTGAGAACAAACTGTCATGGACTGTGAAGGATCTCATACCAAATGGTGAATACTTCTTCCGTGTTAAAGCAGTCAACAAGGTTGGTGGAGGAGAATATATTGAACTGAAAAATCCAGTCATTGCTCAAGATCCAAAGC
>TTN-211,ENSE00003805132,1,303,2270384,2270686,AACCCCCTGATCCACCTGTAGATGTAGAGGTTCATAATCCTACAGCGGAGGCAATGACTATTACATGGAAGCCACCTTTGTATGATGGAGGGAGCAAGATAATGGGCTACATCATAGAGAAGATTGCTAAGGGTGAAGAAAGGTGGAAGAGATGCAATGAACACCTGGTACCAATCCTGACCTATACAGCAAAAGGACTTGAAGAGGGGAAAGAGTACCAATTCCGTGTGCGAGCAGAGAACGCCGCGGGTATTAGTGAACCTTCTCGGGCTACTCCTCCAACCAAAGCTGTAGATCCCATTG
>TTN-211,ENSE00003805056,1,363,2270687,2271049,ATGCCCCCAAAGTCATTCTGAGAACAAGCCTAGAAGTGAAACGAGGTGATGAAATAGCACTTGATGCAAGTATTTCTGGATCACCTTACCCAACTATTACATGGATAAAGGATGAAAATGTTATTGTACCAGAGGAAATTAAGAAGCGTGCAGCACCCTTGGTTAGGAGAAGGAAGGGTGAAGTTCAAGAAGAAGAACCATTTGTCCTGCCTCTGACACAGCGTTTGAGTATTGACAACAGCAAAAAGGGAGAATCTCAGCTACGCGTCCGAGATTCTCTCCGACCTGACCATGGTCTGTATATGATCAAAGTTGAAAATGACCACGGTATTGCAAAAGCTCCTTGTACTGTCAGTGTGTTAG
>TTN-211,ENSE00003811138,1,303,2271050,2271352,ATACACCGGGACCACCAATCAACTTTGTATTTGAAGATATCAGAAAGACCTCAGTCCTTTGTAAATGGGAACCACCCCTTGATGATGGTGGCAGTGAAATCATAAACTACACTTTGGAAAAGAAAGACAAGACAAAACCCGACTCAGAATGGATTGTTGTCACTTCAACACTTAGACATTGCAAATATTCAGTAACAAAACTGATTGAAGGAAAAGAGTACCTCTTCCGTGTAAGAGCTGAAAACAGATTTGGGCCAGGTCCACCATGTGTTTCAAAGCCACTTGTGGCTAAAGATCCATTTG
>TTN-211,ENSE00003809346,1,300,2271353,2271652,GACCACCTGATGCACCAGATAAGCCCATTGTGGAAGATGTTACCAGCAACAGTATGCTAGTGAAATGGAATGAACCAAAAGATAATGGAAGCCCCATTTTGGGTTACTGGCTTGAAAAACGTGAAGTTAACAGTACACATTGGTCTCGTGTCAACAAAAGCCTTCTGAATGCCTTGAAAGCCAATGTAGATGGCTTATTAGAAGGACTCACCTATGTCTTCAGAGTATGTGCTGAAAATGCAGCTGGACCTGGAAAGTTCAGTCCACCTTCAGATCCCAAAACAGCACATGATCCAATCT
>TTN-211,ENSE00003806782,1,297,2271653,2271949,CTCCTCCTGGGCCACCTATCCCAAGAGTCACTGACACAAGCTCTACAACTATTGAACTAGAATGGGAACCCCCAGCTTTCAATGGTGGTGGGGAAATTGTTGGCTATTTTGTTGATAAGCAGTTGGTTGGCACAAATGAATGGTCACGCTGCACAGAGAAGATGATCAAGGTCCGTCAGTACACCGTCAAAGAAATCCGAGAGGGTGCTGATTACAAACTTCGGGTGAGTGCTGTCAATGCCGCAGGGGAAGGACCGCCTGGAGAAACACAACCTGTTACTGTGGCTGAACCACAAG
>TTN-211,ENSE00003804121,1,285,2271950,2272234,AGCCTCCAGCTGTGGAACTGGATGTTTCTGTCAAGGGTGGAATACAAATAATGGCTGGGAAGACTCTTAGAATTCCAGCTGTGGTGACTGGTCGCCCTGTACCTACAAAAGTATGGACCAAAGAAGAAGGGGAGCTGGATAAAGACCGTGTTGTAATAGACAACGTTGGAACCAAATCTGAACTAATTATCAAGGATGCACTGCGAAAAGACCATGGCAGATATGTGATTACAGCTACAAATAGCTGTGGTTCCAAATTTGCAGCAGCCAGGGTAGAAGTTTTTG
>TTN-211,ENSE00003804454,1,294,2272235,2272528,ATGTCCCTGGTCCAGTTCTTGACTTAAAACCTGTTGTAACAAACAGAAAAATGTGTCTACTTAACTGGTCTGATCCAGAAGATGATGGAGGAAGTGAAATAACAGGCTTTATCATTGAAAGAAAAGATGCCAAGATGCATACTTGGAGACAACCAATAGAGACTGAGAGATCTAAATGTGACATCACAGGTCTGCTTGAGGGACAAGAATATAAGTTCCGTGTTATTGCCAAGAACAAGTTTGGCTGTGGCCCTCCTGTTGAAATAGGACCAATTCTTGCAGTTGATCCACTAG
>TTN-211,ENSE00003803420,1,300,2272529,2272828,GTCCTCCAACATCTCCAGAGAGGCTCACATACACTGAAAGGACAAAGTCCACTATCACACTTGACTGGAAAGAGCCCCGCAGTAATGGTGGCAGTCCCATCCAAGGATATATCATTGAAAAACGGCGTCATGACAAACCTGACTTTGAAAGAGTTAACAAGCGACTCTGCCCAACCACATCTTTTCTGGTTGAAAATCTTGATGAACACCAAATGTATGAGTTCCGTGTCAAAGCTGTCAATGAAATTGGTGAAAGTGAACCATCCCTACCTCTTAATGTAGTCATACAAGATGATGAAG
>TTN-211,ENSE00003809028,1,309,2272829,2273137,TGCCTCCAACTATTAAGTTGCGTCTGAGTGTTCGAGGAGACACTATCAAAGTTAAGGCAGGAGAGCCTGTCCACATCCCTGCAGATGTGACAGGCCTTCCAATGCCTAAGATTGAATGGTCCAAAAATGAAACTGTAATTGAAAAACCCACTGATGCACTTCAGATAACCAAGGAAGAGGTATCCCGAAGTGAGGCAAAAACTGAGCTTAGCATTCCCAAAGCGGTCCGGGAGGACAAAGGCACTTACACAGTTACTGCTTCCAATCGCCTTGGCTCAGTGTTCCGAAATGTTCACGTTGAAGTATATG
>TTN-211,ENSE00003801894,1,191,2273138,2273328,ACCGCCCATCCCCACCAAGAAATCTTGCTGTTACTGACATTAAAGCTGAATCTTGCTACTTGACATGGGATGCCCCTCTTGATAATGGTGGCAGTGAAATCACCCATTATGTTATTGACAAACGTGATGCAAGTAGGAAGAAAGCAGAATGGGAGGAAGTCACCAACACTGCTGTAGAGAAAAGATATGGG
>TTN-211,ENSE00003809851,1,430,2273329,2273758,ATCTGGAAACTTATCCCCAATGGTCAGTATGAGTTCCGAGTCAGGGCAGTGAATAAATATGGAATCAGTGATGAGTGCAAATCAGATAAAGTAGTCATTCAAGATCCTTATCGCCTTCCTGGACCTCCAGGAAAACCAAAAGTTTTGGCACGCACCAAAGGATCAATGCTAGTGAGCTGGACTCCTCCTTTGGACAATGGTGGCTCTCCAATTACTGGCTACTGGCTGGAGAAAAGAGAAGAGGGAAGTCCTTATTGGTCACGTGTTAGCCGAGCACCAATAACCAAAGTGGGATTGAAAGGCGTGGAATTTAATGTTCCTCGTTTGCTTGAAGGCGTTAAATACCAGTTCAGAGCCATGGCAATAAATGCTGCAGGAATTGGTCCTCCCAGTGAACCATCAGATCCAGAGGTTGCAGGAGATCCCATAT
>TTN-211,ENSE00003808594,1,309,2273759,2274067,TTCCACCGGGGCCACCTTCTTGCCCAGAAGTTAAAGATAAAACGAAGTCAAGCATCTCACTAGGATGGAAACCTCCAGCCAAAGATGGTGGCAGCCCAATCAAAGGATACATTGTAGAAATGCAAGAAGAAGGTACTACTGACTGGAAAAGAGTAAATGAACCAGACAAACTTATAACTACCTGTGAATGTGTGGTGCCTAATCTGAAAGAGCTCAGGAAGTACAGATTCAGAGTGAAAGCTGTCAATGAAGCTGGTGAATCTGAACCAAGTGATACAACTGGGGAGATCCCTGCCACTGATATTCAAG
>TTN-211,ENSE00003810473,1,149,2274068,2274216,AGGAACCAGAAGTTTTCATTGACATTGGAGCACAGGACTGTCTGGTTTGTAAAGCTGGCTCACAGATTAGGATTCCTGCTGTCATCAAGGGACGCCCAACACCAAAATCATCTTGGGAATTTGATGGAAAGGCAAAGAAAGCAATGAAG
>TTN-211,ENSE00003801625,1,33,2274217,2274249,GATGGAGTTCATGACATACCCGAAGATGCACAG
>TTN-211,ENSE00003802643,1,130,2274250,2274379,CTGGAGACTGCTGAAAACTCCTCAGTAATTATTATTCCGGAGTGTAAACGATCTCATACAGGCAAATACAGCATCACAGCCAAGAATAAAGCAGGACAAAAGACTGCAAATTGCAGAGTTAAAGTCATGG
>TTN-211,ENSE00003804239,1,300,2274380,2274679,ATGTACCAGGCCCACCCAAAGATCTGAAAGTCAGTGATATCACAAGGGGTAGTTGCAGACTTTCATGGAAGATGCCAGACGACGATGGAGGAGACAGGATCAAAGGCTATGTTATTGAGAAGAGGACTATTGATGGAAAAGCCTGGACCAAAGTCAATCCAGACTGTGGAAGCACCACATTTGTAGTGCCTGATCTCCTCTCTGAACAGCAATATTTCTTCCGTGTGCGAGCAGAAAACCGTTTTGGTATTGGCCCACCTGTGGAAACCATTCAGAGGACCACTGCCAGAGATCCGATAT
>TTN-211,ENSE00003806278,1,318,2274680,2274997,ATCCTCCTGATCCTCCTATTAAACTCAAGATTGGCCTCATCACAAAGAACACAGTGCATCTGTCATGGAAACCCCCGAAGAATGATGGGGGCTCCCCTGTTACCCACTATATTGTTGAGTGCCTTGCATGGGACCCTACTGGGACAAAGAAAGAAGCCTGGAGGCAGTGCAATAAGCGTGATGTGGAAGAACTGCAATTTACTGTTGAAGACCTAGTAGAGGGTGGGGAATATGAATTCCGAGTCAAAGCTGTCAATGCTGCAGGAGTCAGCAAGCCTTCAGCCACTGTTGGCCCTGTGACTGTCAAAGACCAGACAT
>TTN-211,ENSE00003801391,1,297,2274998,2275294,GCCCACCATCAATTGATCTAAAAGAATTCATGGAGGTTGAAGAAGGAACCAATGTTAACATTGTGGCCAAAATTAAAGGTGTGCCATTCCCGACACTAACCTGGTTTAAAGCTCCTCCAAAGAAGCCTGATAACAAAGAACCTGTTCTCTATGACACCCATGTCAACAAACTGGTGGTAGATGATACTTGCACTTTAGTTATTCCGCAGTCTCGCAGGAGTGACACTGGCTTATATACCATCACAGCTGTAAATAATCTGGGAACAGCATCAAAGGAGATGAGACTGAATGTCCTGG
>TTN-211,ENSE00003806021,1,300,2275295,2275594,GTCGTCCTGGCCCTCCAGTGGGACCCATAAAATTTGAATCTGTTTCAGCAGATCAAATGACACTATCTTGGTTTCCACCTAAAGATGATGGTGGGTCTAAGATTACAAACTATGTAATTGAGAAAAGAGAAGCTAACAGGAAGACATGGGTCCATGTCTCCAGTGAACCTAAGGAGTGCACGTACACGATTCCCAAATTGCTAGAAGGCCATGAATATGTATTCCGAATCATGGCCCAGAATAAATATGGCATTGGAGAACCTCTTGACAGTGAACCTGAAACAGCAAGAAACCTCTTCT
>TTN-211,ENSE00003803442,1,315,2275595,2275909,CTGTCCCTGGAGCACCAGATAAACCAACAGTTAGCAGCGTGACTCGTAACTCCATGACTGTCAACTGGGAAGAGCCAGAATATGATGGAGGCTCTCCTGTGACAGGGTACTGGCTGGAAATGAAAGACACCACTTCAAAGAGATGGAAGAGAGTTAACCGAGATCCTATCAAAGCCATGACTTTGGGTGTTTCTTATAAAGTGACTGGTCTTATTGAAGGTTCCGACTATCAATTCCGGGTATATGCAATCAATGCTGCTGGCGTGGGTCCAGCAAGTCTGCCATCAGACCCAGCGACTGCTAGAGATCCAATTG
>TTN-211,ENSE00003801787,1,149,2275910,2276058,CCCCTCCTGGTCCTCCATTTCCCAAAGTGACAGATTGGACTAAATCATCTGCAGATCTGGAGTGGTCTCCCCCACTAAAAGATGGTGGATCCAAAGTAACTGGATACATCGTTGAATATAAAGAAGAAGGAAAAGAAGAATGGGAAAAG
>TTN-211,ENSE00003802004,1,151,2276059,2276209,GGTAAAGATAAAGAAGTGAGAGGAACAAAGCTTGTTGTGACAGGATTAAAGGAAGGAGCATTCTACAAATTTAGAGTTAGAGCAGTCAACATTGCTGGCATTGGAGAACCTGGAGAGGTCACAGATGTCATTGAAATGAAGGACAGACTTG
>TTN-211,ENSE00003808790,1,282,2276210,2276491,TTTCACCTGACCTTCAGCTAGATGCCAGTGTCAGAGATAGAATTGTTGTCCATGCTGGAGGGGTGATCCGAATCATTGCCTATGTGTCTGGAAAGCCTCCTCCAACCGTCACCTGGAACATGAATGAAAGAACCTTACCTCAAGAAGCCACCATTGAGACCACAGCCATTAGCTCATCCATGGTCATCAAGAACTGCCAGAGGAGCCATCAAGGCGTCTATTCTCTTCTTGCCAAAAATGAAGCCGGAGAAAGAAAGAAGACAATTATTGTTGATGTATTAG
>TTN-211,ENSE00003807896,1,303,2276492,2276794,ATGTTCCAGGTCCCGTTGGAACACCATTCCTAGCTCACAACCTAACCAATGAGTCCTGCAAACTGACATGGTTTTCTCCAGAAGATGATGGAGGCTCTCCAATCACCAATTATGTCATTGAAAAGCGTGAATCTGACCGCAGAGCATGGACCCCAGTGACATATACAGTTACCCGACAAAATGCTACTGTCCAGGGTCTCATTCAAGGAAAAGCCTACTTTTTCCGAATTGCGGCTGAAAATAGTATTGGCATGGGTCCATTTGTTGAGACATCAGAGGCACTTGTTATCAGAGAGCCAATAA
>TTN-211,ENSE00003801753,1,303,2276795,2277097,CTGTACCAGAGCGTCCTGAAGACCTGGAAGTCAAAGAAGTTACTAAAAATACTGTAACTTTGACTTGGAATCCTCCTAAGTATGATGGTGGGTCAGAAATTATTAACTATGTCCTAGAAAGTCGGCTCATTGGGACTGAGAAGTTCCACAAAGTTACAAATGACAACTTGCTTAGCAGAAAATACACTGTTAAAGGCTTAAAAGAAGGTGATACCTATGAGTACCGTGTCAGTGCTGTCAACATTGTTGGACAAGGCAAACCATCATTTTGCACCAAACCAATTACTTGCAAGGATGAGCTGG
>TTN-211,ENSE00003807039,1,282,2277098,2277379,CACCCCCAACGCTTCACCTCGACTTCAGAGATAAGCTCACGATTCGAGTTGGTGAAGCTTTTGCCCTCACTGGCCGTTACTCAGGCAAACCAAAGCCTAAGGTTTCCTGGTTCAAAGATGAAGCTGATGTGCTGGAAGATGATCGCACTCATATAAAGACTACACCAGCAACACTTGCTTTAGAGAAGATCAAGGCCAAACGTTCAGATTCCGGCAAATACTGTGTGGTTGTGGAGAACAGTACAGGCTCTAGGAAAGGTTTCTGTCAAGTTAATGTTGTTG
>TTN-211,ENSE00003804106,1,300,2277380,2277679,ACCGTCCTGGACCACCAGTAGGACCAGTTAGTTTTGATGAGGTGACCAAAGATTACATGGTTATCTCTTGGAAGCCTCCTTTAGATGATGGAGGCAGTAAAATCACCAATTATATTATTGAGAAGAAGGAAGTGGGTAAAGACGTCTGGATGCCAGTGACATCTGCAAGTGCTAAAACAACATGCAAAGTTTCTAAACTACTTGAAGGAAAAGATTATATTTTCCGGATACATGCTGAAAATCTGTATGGAATAAGTGATCCTCTGGTGTCTGATTCAATGAAAGCCAAAGATCGTTTCA
>TTN-211,ENSE00003801817,1,303,2277680,2277982,GGGTTCCTGATGCACCTGATCAGCCAATTGTTACAGAAGTTACCAAAGACTCTGCATTAGTAACCTGGAATAAGCCACATGATGGAGGAAAACCCATCACAAACTACATCCTGGAAAAGAGAGAAACTATGTCTAAACGATGGGCTAGAGTTACCAAAGATCCTATTCATCCATACACTAAATTTAGGGTTCCTGATCTTCTAGAAGGATGTCAGTATGAATTCCGGGTTTCTGCAGAAAATGAAATTGGTATTGGAGATCCAAGCCCACCATCCAAACCAGTCTTTGCTAAAGATCCAATTG
>TTN-211,ENSE00003810564,1,309,2277983,2278291,CTAAACCAAGTCCACCTGTTAATCCTGAAGCAATAGATACAACATGCAATTCAGTCGATCTAACTTGGCAGCCACCACGTCATGATGGTGGGAGCAAGATTCTGGGTTATATTGTTGAGTACCAGAAAGTTGGAGATGAAGAGTGGAGAAGAGCCAATCACACCCCTGAGTCATGTCCTGAAACTAAATATAAAGTCACCGGTCTTCGGGACGGTCAAACCTATAAGTTTAGAGTGTTAGCAGTCAATGCAGCTGGTGAATCAGATCCAGCTCATGTTCCGGAGCCAGTCCTAGTAAAAGACAGGCTTG
>TTN-211,ENSE00003807476,1,282,2278292,2278573,AACCCCCTGAGTTGATTCTTGATGCCAACATGGCAAGAGAACAACACATTAAAGTTGGTGATACTCTAAGACTTAGTGCCATCATCAAAGGAGTGCCATTCCCAAAAGTAACTTGGAAAAAAGAAGACAGAGATGCTCCAACTAAAGCAAGAATTGATGTGACTCCAGTTGGTAGCAAGCTTGAAATTCGTAATGCTGCCCATGAAGATGGTGGAATTTATTCTTTAACAGTGGAGAATCCAGCTGGTTCAAAAACTGTCTCAGTAAAAGTACTTGTATTAG
>TTN-211,ENSE00003807363,1,300,2278574,2278873,ATAAACCTGGGCCACCTAGAGATCTGGAAGTCAGTGAAATTAGGAAAGATTCATGTTACCTTACTTGGAAAGAACCACTGGATGATGGTGGTTCTGTTATTACCAATTATGTGGTTGAGAGGAGAGATGTTGCCAGCGCCCAGTGGTCACCTCTCTCAGCTACATCAAAGAAAAAGAGTCACTTCGCTAAGCATCTGAATGAAGGCAACCAGTACCTCTTCCGAGTAGCTGCGGAGAACCAGTATGGACGTGGTCCTTTTGTTGAAACACCAAAACCAATCAAGGCTTTGGATCCTCTCC
>TTN-211,ENSE00003808994,1,294,2278874,2279167,ATCCCCCAGGGCCACCCAAGGACCTGCACCATGTAGATGTTGACAAGACTGAAGTCTCCCTAGTCTGGAATAAGCCGGATCGTGATGGTGGTTCTCCAATCACTGGATATTTGGTAGAATATCAAGAAGAAGGCACCCAGGACTGGATTAAATTTAAGACTGTGACAAACTTAGAGTGTGTGGTTACTGGACTACAACAAGGAAAGACCTATAGATTCCGTGTAAAAGCTGAAAACATTGTGGGTCTTGGTCTCCCTGACACAACTATCCCGATAGAATGTCAAGAAAAACTAG
>TTN-211,ENSE00003810188,1,2967,2279168,2282134,TGCCTCCATCCGTGGAGCTAGATGTGAAATTAATTGAAGGTCTTGTGGTAAAGGCTGGAACCACAGTCAGATTCCCTGCTATTATAAGAGGTGTGCCTGTTCCTACTGCAAAGTGGACAACCGATGGGAGTGAGATTAAAACCGATGAGCACTACACAGTTGAAACAGACAACTTCTCATCAGTACTTACCATTAAGAACTGCTTAAGGAGAGACACTGGGGAATATCAAATCACAGTTTCCAATGCAGCCGGTAGCAAAACAGTAGCCGTACATCTTACTGTTCTTGATGTTCCTGGGCCACCAACAGGTCCTATTAATATTCTGGATGTTACTCCTGAACACATGACTATCTCATGGCAGCCACCTAAGGATGATGGAGGAAGCCCTGTGATAAATTATATTGTTGAGAAACAAGATACAAGGAAAGACACGTGGGGTGTTGTCTCTTCCGGAAGCAGTAAGACAAAGCTGAAAATCCCACATCTGCAGAAGGGCTGTGAATATGTTTTCCGAGTTAGAGCAGAGAATAAGATAGGTGTTGGTCCTCCCCTTGACTCCACACCTACTGTTGCTAAGCATAAATTTAGTCCTCCGTCTCCTCCTGGTAAACCAGTGGTTACTGACATTACTGAAAATGCAGCAACAGTGTCTTGGACCCTGCCAAAATCTGATGGTGGCAGTCCAATAACTGGCTACTATATGGAACGTCGAGAAGTAACTGGCAAATGGGTGAGGGTCAACAAAACACCTATCGCTGACCTGAAGTTCAGAGTGACTGGACTCTATGAAGGAAATACATATGAGTTTAGAGTTTTTGCTGAAAATCTTGCAGGACTAAGCAAACCATCCCCAAGTTCTGATCCAATAAAAGCTTGCCGGCCCATCAAACCACCTGGACCACCTATTAATCCTAAACTGAAAGACAAGAGCAGAGAAACAGCTGATTTGGTGTGGACAAAGCCTCTCAGTGATGGTGGTAGCCCCATTCTAGGATATGTAGTGGAATGTCAGAAACCTGGCACAGCACAATGGAACAGGATTAATAAAGATGAACTCATTAGGCAATGTGCCTTTAGGGTACCTGGACTAATTGAAGGAAATGAGTACAGATTCCGTATAAAGGCAGCTAATATTGTAGGAGAGGGTGAGCCAAGAGAACTAGCAGAATCTGTGATTGCAAAAGATATCCTTCATCCTCCAGAAGTAGAACTTGATGTTACTTGTCGTGATGTTATTACCGTGAGAGTAGGCCAAACTATCCGCATTCTAGCTCGAGTCAAAGGCAGACCTGAACCAGACATAACTTGGACTAAGGAAGGCAAAGTATTGGTCCGAGAAAAGAGGGTGGACCTTATTCAGGATCTACCTCGTGTTGAGTTACAAATTAAAGAAGCTGTTAGAGCTGATCATGGCAAGTATATCATCTCAGCTAAGAACAGCAGTGGACATGCCCAAGGTTCAGCCATCGTTAACGTCCTTGACAGACCTGGGCCTTGCCAGAATTTGAAGGTTACCAATGTAACCAAAGAGAACTGTACAATTTCTTGGGAAAACCCACTAGATAATGGTGGCTCAGAAATAACAAACTTCATAGTAGAATATCGCAAACCAAACCAGAAAGGCTGGTCAATTGTTGCATCAGATGTCACTAAACGATTAATCAAGGCCAACCTTTTAGCCAACAATGAATACTATTTCCGAGTTTGTGCAGAGAATAAAGTAGGTGTTGGGCCAACCATCGAAACAAAAACTCCCATTCTGGCTATTAACCCTATTGACAGACCAGGTGAGCCTGAAAACCTTCACATTGCAGATAAAGGAAAGACATTTGTCTATCTAAAGTGGCGGAGGCCTGACTATGATGGTGGCAGTCCAAATCTGTCATATCATGTTGAGAGAAGGCTTAAGGGCTCCGATGACTGGGAAAGAGTGCATAAAGGAAGCATTAAAGAAACTCACTACATGGTTGACAGATGTGTTGAAAACCAGATTTATGAGTTCAGAGTGCAAACAAAGAATGAAGGTGGGGAAAGTGACTGGGTGAAGACAGAGGAAGTTGTTGTGAAAGAAGACTTACAAAAACCAGTACTTGATCTGAAATTAAGTGGGGTCCTAACTGTCAAAGCAGGGGACACCATTAGGCTTGAGGCAGGGGTTAGAGGCAAACCATTCCCAGAAGTTGCATGGACCAAGGACAAAGACGCTACAGACTTAACAAGATCACCAAGGGTCAAGATTGATACCCGTGCTGATTCATCTAAATTTTCTCTTACTAAAGCAAAGCGAAGTGATGGGGGTAAATATGTAGTTACGGCAACTAACACGGCTGGCAGTTTTGTGGCCTATGCCACTGTCAATGTTTTAGATAAGCCTGGTCCTGTGAGAAATCTGAAAATTGTTGATGTGTCCAGTGATAGGTGTACTGTTTGCTGGGATCCACCAGAAGATGATGGTGGCTGTGAAATCCAAAATTATATTCTAGAAAAATGTGAGACAAAGCGAATGGTTTGGTCTACCTATTCTGCTACTGTCTTGACACCTGGTACTACAGTAACACGTCTCATAGAAGGAAATGAATATATTTTCAGAGTCCGTGCAGAAAATAAAATAGGCACAGGGCCTCCAACAGAAAGTAAACCAGTCATAGCCAAAACCAAGTATGATAAACCTGGTCGCCCTGATCCCCCAGAAGTCACTAAAGTAAGCAAAGAAGAGATGACTGTGGTTTGGAATCCACCTGAATATGATGGTGGAAAGTCTATAACTGGATACTTTTTGGAGAAAAAGGAAAAGCATTCAACACGATGGGTCCCTGTCAACAAGAGTGCAATCCCTGAGAGACGTATGAAAGTACAGAATCTCCTCCCAGACCATGAATATCAGTTCCGTGTCAAGGCAGAAAATGAAATTGGAATTGGAGAACCAAGCTTGCCTTCAAGACCGGTGGTGGCAAAAGACCCCATAG
>TTN-211,ENSE00003811401,1,321,2282135,2282455,AGCCACCTGGTCCACCAACCAATTTCAGAGTGGTTGATACAACCAAACATTCCATAACTCTTGGGTGGGGAAAACCAGTCTATGATGGTGGTGCACCGATCATTGGATATGTTGTGGAAATGAGACCAAAAATAGCAGATGCGTCTCCTGATGAAGGCTGGAAACGGTGTAATGCTGCAGCACAGCTTGTACGCAAGGAATTCACTGTTACCAGCTTGGATGAAAACCAGGAATATGAGTTCAGGGTGTGTGCCCAAAACCAAGTTGGTATTGGGCGCCCTGCAGAGCTAAAGGAAGCTATCAAACCTAAAGAAATACTAG
>TTN-211,ENSE00003805661,1,285,2282456,2282740,AACCTCCGGAGATTGATTTGGATGCCAGCATGAGGAAACTGGTCATAGTGAGAGCAGGATGCCCTATTCGTCTCTTTGCTATAGTGAGAGGACGACCAGCCCCTAAAGTCACTTGGCGAAAAGTTGGCATTGATAATGTGGTCAGAAAAGGACAAGTTGATCTGGTTGACACTATGGCCTTCCTTGTCATCCCCAATTCTACCCGTGATGACTCAGGAAAATATTCCTTAACACTTGTGAACCCAGCAGGAGAAAAGGCTGTATTCGTAAATGTCAGAGTATTAG
>TTN-211,ENSE00003804742,1,300,2282741,2283040,ACACTCCTGGGCCTGTGTCTGATTTAAAAGTTTCAGATGTCACTAAAACATCATGCCATGTGTCCTGGGCCCCTCCTGAAAACGACGGTGGGAGCCAAGTGACACATTATATCGTGGAGAAACGTGAGGCAGACAGAAAGACATGGTCGACCGTTACCCCAGAAGTTAAGAAAACAAGCTTCCATGTAACCAATCTTGTCCCTGGGAATGAGTATTACTTCAGAGTAACTGCTGTCAACGAATATGGCCCTGGCGTCCCAACAGATGTCCCAAAACCAGTGCTTGCATCAGATCCTCTAA
>TTN-211,ENSE00003810357,1,303,2283041,2283343,GTGAGCCGGATCCCCCAAGGAAATTAGAAGTGACTGAAATGACCAAGAACAGTGCCACCTTAGCCTGGTTACCTCCCCTACGTGATGGAGGTGCTAAAATCGATGGCTACATCACTAGTTACAGAGAAGAAGAGCAGCCTGCAGATCGCTGGACAGAGTACTCAGTGGTAAAAGATCTGAGCCTTGTTGTCACTGGCCTAAAGGAAGGAAAGAAATACAAATTTAGAGTAGCGGCCAGAAATGCTGTTGGAGTCAGTTTGCCAAGAGAAGCTGAAGGAGTGTATGAAGCCAAAGAACAACTGT
>TTN-211,ENSE00003801707,1,276,2283344,2283619,TGCCACCAAAGATCCTTATGCCAGAGCAAATAACTATCAAAGCTGGGAAAAAACTCCGAATTGAAGCCCATGTGTATGGAAAGCCTCATCCCACCTGTAAATGGAAAAAAGGAGAAGATGAAGTTGTCACATCCAGCCACCTGGCAGTGCATAAAGCAGACAGCTCTTCAATTCTGATCATAAAAGATGTGACTAGGAAAGACAGTGGTTACTACAGCCTCACAGCAGAGAACAGTTCTGGGACAGACACTCAGAAAATCAAAGTTGTAGTCATGG
>TTN-211,ENSE00003810399,1,300,2283620,2283919,ATGCCCCCGGCCCCCCTCAGCCTCCATTTGACATTTCTGATATAGACGCTGATGCTTGCTCCCTGTCATGGCACATCCCTCTGGAGGACGGAGGCAGTAACATCACCAATTATATAGTGGAGAAGTGTGATGTAAGCCGAGGTGACTGGGTCACGGCTCTAGCTTCAGTCACAAAAACTTCCTGCAGGGTTGGAAAGCTGATCCCAGGCCAGGAGTACATCTTCCGGGTCCGTGCTGAAAACCGATTTGGCATTTCAGAGCCTCTCACATCTCCAAAGATGGTTGCGCAGTTCCCATTTG
>TTN-211,ENSE00003810448,1,303,2283920,2284222,GTGTTCCTAGTGAACCAAAGAATGCACGAGTCACCAAAGTCAACAAGGACTGTATTTTTGTTGCTTGGGACAGACCAGATAGTGATGGAGGGAGCCCCATTATTGGTTATCTGATTGAACGCAAGGAAAGAAACAGTTTGCTGTGGGTGAAAGCCAATGATACTCTTGTCCGGTCAACTGAATATCCTTGTGCTGGCCTTGTAGAAGGTCTTGAGTATTCATTCAGAATCTATGCCCTAAACAAAGCTGGATCCAGCCCACCCAGCAAACCCACAGAATATGTAACTGCAAGAATGCCAGTTG
>TTN-211,ENSE00003802505,1,300,2284223,2284522,ATCCTCCTGGGAAACCTGAGGTTATTGATGTCACCAAGAGTACTGTATCTCTGATCTGGGCTCGTCCAAAGCATGATGGAGGCAGTAAAATTATTGGCTATTTCGTAGAAGCTTGCAAACTTCCTGGTGATAAATGGGTACGGTGCAATACTGCACCTCACCAGATTCCCCAGGAAGAGTACACAGCTACTGGCCTAGAAGAGAAAGCTCAGTATCAATTTAGAGCTATTGCCAGGACCGCGGTAAACATTAGCCCACCTTCTGAACCTTCTGATCCAGTGACTATCCTCGCAGAAAATG
>TTN-211,ENSE00003806397,1,288,2284523,2284810,TCCCTCCCAGGATAGACCTGAGTGTGGCTATGAAATCTTTGCTTACTGTGAAAGCTGGAACTAATGTCTGCTTGGATGCTACTGTTTTTGGTAAACCGATGCCAACAGTTTCTTGGAAAAAAGATGGCACACTGCTAAAACCAGCAGAAGGCATAAAGATGGCCATGCAGCGGAATCTGTGCACCTTGGAGCTATTCAGCGTGAACCGGAAGGACTCAGGAGACTATACCATTACTGCTGAAAATTCAAGTGGTTCTAAATCAGCCACCATTAAGCTTAAAGTGTTAG
>TTN-211,ENSE00003807889,1,297,2284811,2285107,ATAAACCGGGTCCTCCAGCATCTGTTAAAATCAACAAAATGTATTCAGATCGTGCTATGCTTTCTTGGGAACCGCCTCTTGAAGATGGAGGCTCAGAAATCACCAACTATATTGTTGACAAACGTGAAACAAGCAGGCCCAACTGGGCTCAAGTCTCTGCAACTGTGCCTATCACCAGCTGCAGCGTGGAGAAACTTATAGAGGGCCATGAGTATCAGTTCCGTATTTGTGCTGAAAATAAATATGGAGTAGGCGATCCAGTCTTCACTGAACCAGCAATTGCCAAAAACCCATATG
>TTN-211,ENSE00003811290,1,303,2285108,2285410,ACCCACCAGGACGCTGTGATCCTCCTGTTATTAGCAACATAACCAAAGATCACATGACAGTCAGCTGGAAGCCACCAGCAGATGATGGGGGCTCACCCATCACTGGCTATTTGCTTGAAAAGCGGGAAACCCAGGCTGTTAACTGGACTAAGGTCAACAGAAAACCTATTATAGAAAGAACATTAAAAGCAACAGGTCTTCAAGAAGGTACCGAATATGAGTTCCGTGTTACAGCTATAAATAAAGCTGGACCAGGCAAACCCAGTGACGCATCCAAGGCCGCTTATGCTCGGGACCCTCAGT
>TTN-211,ENSE00003808853,1,306,2285411,2285716,ATCCTCCTGGCCCACCGGCTTTCCCTAAAGTATATGATACAACTCGCAGCTCTGTGAGTCTATCTTGGGGCAAGCCAGCCTATGACGGCGGCAGCCCTATCATTGGTTATCTCGTTGAAGTAAAACGGGCTGACTCCGATAACTGGGTGAGGTGCAACTTACCACAGAATCTACAGAAAACCCGCTTTGAGGTTACTGGCCTGATGGAAGACACACAATATCAATTCCGTGTGTATGCCGTTAATAAGATTGGATACAGTGACCCCAGTGATGTGCCAGATAAACACTATCCCAAGGACATCTTAA
>TTN-211,ENSE00003807542,1,288,2285717,2286004,TTCCACCTGAGGGAGAACTTGATGCGGACTTAAGGAAGACACTCATATTACGTGCTGGAGTTACTATGAGACTATATGTACCAGTAAAAGGACGCCCACCTCCAAAGATTACTTGGTCTAAACCAAATGTCAATCTAAGAGACAGGATTGGACTGGACATAAAGTCAACTGACTTTGACACTTTCTTGCGCTGTGAAAATGTGAACAAATATGATGCAGGAAAATATATCTTAACCCTGGAGAACAGCTGTGGTAAAAAGGAATATACCATTGTTGTGAAAGTGCTTG
>TTN-211,ENSE00003810775,1,291,2286005,2286295,ATACTCCTGGGCCACCTGTCAATGTGACTGTTAAGGAAATATCCAAAGACTCTGCTTATGTTACCTGGGAGCCTCCCATTATTGATGGCGGAAGCCCCATCATAAACTATGTGGTACAAAAACGTGATGCAGAGAGGAAATCCTGGTCTACAGTGACAACTGAGTGCTCCAAAACAAGCTTCAGAGTAGCTAATTTGGAGGAGGGAAAATCCTACTTCTTCCGAGTGTTTGCTGAAAATGAGTATGGCATTGGTGATCCCGGTGAAACTCGTGATGCTGTCAAAGCTTCCC
>TTN-211,ENSE00003811210,1,288,2286296,2286583,AAACTCCTGGACCAGTTGTGGACCTGAAAGTGAGGTCTGTATCTAAGTCATCCTGTAGCATTGGCTGGAAAAAGCCTCACAGTGATGGTGGAAGTCGGATTATTGGATATGTAGTTGATTTCCTGACTGAAGAAAATAAGTGGCAACGAGTTATGAAATCCTTAAGCCTACAGTACTCTGCAAAAGATTTGACTGAAGGGAAGGAATATACCTTCAGAGTGAGTGCTGAGAATGAAAATGGAGAAGGAACCCCAAGCGAAATCACTGTTGTGGCAAGGGATGATGTTG
>TTN-211,ENSE00003805436,1,588,2286584,2287171,TGGCTCCTGATCTTGACTTAAAGGGTCTACCTGATTTGTGCTACTTGGCTAAAGAAAACAGCAACTTCCGGCTTAAGATCCCCATAAAAGGCAAGCCAGCTCCATCAGTCTCCTGGAAGAAAGGGGAAGATCCTCTAGCAACTGACACTAGAGTCAGTGTTGAGTCATCTGCGGTTAACACAACTCTTATAGTGTACGATTGCCAAAAATCTGATGCTGGAAAATACACAATCACACTTAAGAATGTTGCTGGCACCAAGGAAGGAACTATCTCCATAAAGGTTGTTGGCAAGCCTGGCATCCCCACTGGACCAATCAAATTTGATGAAGTCACAGCAGAAGCCATGACCTTAAAGTGGGCTCCTCCAAAGGATGATGGAGGTTCTGAAATCACCAACTATATCCTAGAGAAGAGGGATTCTGTGAACAACAAGTGGGTGACGTGCGCCTCAGCTGTCCAGAAAACCACCTTTAGAGTAACCAGACTTCATGAGGGCATGGAATATACCTTCAGGGTCAGTGCCGAAAATAAATATGGTGTAGGGGAAGGCCTGAAATCGGAGCCAATTGTTGCGAGACATCCATTTG
>TTN-211,ENSE00003808777,1,105,2287172,2287276,ATGTGCCTGATGCTCCCCCACCTCCCAATATTGTGGATGTCAGACACGATTCAGTATCTCTAACTTGGACTGACCCCAAGAAAACTGGTGGTTCTCCAATTACAG
>TTN-211,ENSE00003806939,1,198,2287277,2287474,GGTATCATCTCGAGTTCAAGGAAAGAAACAGCCTTTTGTGGAAGAGAGCTAACAAGACTCCGATAAGGATGAGAGACTTTAAAGTGACAGGATTAACTGAAGGTCTTGAATATGAATTCCGAGTTATGGCAATCAATTTAGCAGGTGTGGGCAAGCCAAGCCTACCATCAGAGCCTGTTGTGGCACTGGACCCAATTG
>TTN-211,ENSE00003811024,1,297,2287475,2287771,ATCCTCCTGGAAAACCTGAGGTTATTAACATAACAAGGAATTCAGTGACTCTCATTTGGACTGAACCTAAATATGACGGTGGTCATAAGTTAACTGGATATATAGTGGAGAAGCGAGATCTACCTTCGAAGTCTTGGATGAAAGCCAACCATGTTAATGTCCCAGAATGTGCCTTTACTGTAACTGACCTTGTTGAGGGTGGAAAATATGAATTCAGAATTAGAGCAAAGAATACAGCAGGTGCTATCAGTGCTCCATCAGAAAGTACAGAAACCATTATTTGCAAGGATGAATACG
>TTN-211,ENSE00003803896,1,588,2287772,2288359,AGGCACCAACAATTGTCCTTGATCCCACAATAAAAGATGGGCTAACAATTAAAGCAGGGGATACCATTGTTTTGAATGCCATTAGCATTCTTGGCAAACCCCTTCCAAAATCAAGTTGGTCCAAGGCAGGAAAAGACATTAGACCATCAGATATCACTCAGATAACTTCAACCCCAACATCTTCCATGCTTACTATCAAGTATGCCACTAGAAAAGATGCGGGTGAATATACCATCACTGCTACCAATCCTTTTGGCACGAAGGTGGAACATGTGAAGGTAACAGTCCTTGATGTACCTGGTCCCCCAGGTCCTGTTGAAATCAGTAATGTTTCTGCTGAAAAAGCAACACTTACATGGACACCTCCCTTGGAAGATGGCGGCTCACCAATTAAGTCCTATATACTTGAAAAGAGAGAAACCAGCCGACTTTTGTGGACAGTGGTTTCTGAAGATATTCAGTCTTGCAGGCATGTGGCAACCAAACTTATCCAAGGAAATGAGTACATCTTCCGGGTCTCAGCTGTAAACCACTATGGCAAAGGAGAACCTGTACAGTCTGAACCTGTCAAAATGGTAGACAGATTTG
>TTN-211,ENSE00003807419,1,303,2288360,2288662,GTCCCCCTGGCCCTCCTGAAAAACCAGAGGTATCAAATGTCACTAAGAACACTGCCACTGTCAGCTGGAAAAGGCCAGTGGATGATGGTGGCAGCGAAATTACAGGATATCATGTAGAAAGGAGAGAAAAGAAAAGCCTGCGATGGGTGAGAGCAATAAAAACACCAGTTTCCGATCTCAGGTGCAAAGTAACAGGACTGCAAGAAGGAAGCACCTACGAATTCCGTGTCAGTGCAGAAAACAGAGCAGGAATTGGTCCACCCAGTGAGGCTTCAGATTCTGTTCTGATGAAAGATGCAGCAT
>TTN-211,ENSE00003811193,1,17106,2288663,2305768,ATCCTCCAGGACCACCTTCAAATCCGCATGTCACTGATACTACCAAGAAATCTGCTTCTTTGGCATGGGGCAAGCCTCATTATGATGGTGGACTTGAAATCACTGGCTATGTCGTGGAGCATCAAAAAGTAGGAGACGAGGCCTGGATAAAAGATACCACAGGAACCGCCCTCAGAATCACTCAGTTCGTTGTTCCTGATCTTCAGACTAAAGAAAAATACAACTTCAGAATCAGTGCCATCAACGATGCAGGTGTTGGGGAGCCAGCGGTGATTCCAGATGTTGAAATCGTAGAACGGGAGATGGCTCCTGATTTTGAACTAGATGCCGAGCTTCGAAGAACACTTGTTGTTAGAGCAGGACTCAGTATTAGGATATTTGTGCCAATTAAAGGTCGTCCTGCTCCTGAAGTGACATGGACCAAAGATAACATCAACCTGAAAAACCGAGCCAACATTGAAAATACGGAATCATTTACTCTTCTGATTATCCCAGAATGTAACAGATATGATACCGGTAAATTTGTCATGACCATTGAAAACCCGGCTGGGAAGAAAAGTGGCTTTGTGAACGTCAGAGTCTTGGACACGCCAGGCCCAGTCCTCAACCTGCGGCCTACAGACATCACAAAGGACAGTGTCACCCTGCACTGGGACCTCCCTCTGATAGATGGAGGCTCACGTATAACAAACTACATTGTAGAGAAACGTGAAGCAACACGGAAATCTTATTCCACAGCCACCACTAAGTGCCATAAATGCACATATAAAGTTACCGGCTTGTCTGAAGGGTGTGAATATTTCTTCAGAGTGATGGCAGAGAATGAATATGGAATTGGTGAGCCAACAGAAACTACAGAGCCCGTAAAAGCCTCTGAAGCACCATCTCCACCAGACAGCCTTAACATCATGGACATAACTAAGAGCACCGTCAGCCTGGCATGGCCTAAGCCCAAACACGATGGTGGCAGCAAGATCACTGGCTATGTGATTGAAGCCCAAAGAAAAGGCTCTGACCAGTGGACCCACATCACAACCGTGAAAGGGTTAGAATGTGTTGTGAGGAATCTAACTGAAGGAGAGGAATATACCTTCCAAGTGATGGCAGTGAACAGCGCGGGGAGAAGTGCCCCTAGAGAAAGCAGACCCGTCATTGTCAAGGAGCAGACAATGCTTCCAGAGCTGGATCTCCGTGGCATCTATCAGAAACTGGTCATTGCCAAAGCTGGTGACAACATCAAAGTTGAAATTCCAGTGCTCGGTCGACCGAAGCCCACAGTGACATGGAAAAAAGGAGACCAAATTCTTAAACAGACACAGAGAGTTAATTTTGAAACCACAGCGACTTCAACCATTTTAAATATCAATGAGTGTGTCAGAAGTGATAGTGGGCCCTATCCATTAACAGCAAGGAACATTGTAGGAGAGGTTGGTGATGTCATCACCATTCAAGTCCATGATATCCCAGGGCCACCTACTGGACCAATCAAATTTGATGAAGTTTCATCTGATTTTGTAACCTTCTCTTGGGACCCACCTGAGAACGATGGTGGTGTACCAATAAGCAACTATGTAGTGGAAATGCGGCAGACTGACAGTACTACCTGGGTTGAGTTAGCAACCACCGTTATACGTACTACCTATAAAGCCACCCGCCTTACTACTGGATTAGAGTATCAGTTCCGTGTAAAAGCTCAGAATAGATATGGAGTTGGACCAGGCATCACATCAGCATGCATAGTTGCCAACTATCCATTTAAGGTTCCTGGACCTCCTGGTACCCCTCAGGTAACTGCAGTTACCAAGGATTCAATGACAATTAGCTGGCATGAGCCACTTTCTGATGGTGGAAGCCCCATTTTAGGATATCATGTTGAAAGAAAAGAACGAAATGGTATTCTCTGGCAGACTGTGAGCAAAGCTTTAGTACCAGGCAACATTTTCAAATCAAGTGGACTTACAGATGGTATTGCTTATGAGTTCCGGGTGATTGCAGAAAACATGGCAGGCAAAAGTAAGCCAAGCAAGCCATCAGAACCTATGTTGGCTCTGGATCCCATTGACCCACCTGGAAAACCAGTACCTCTAAATATTACAAGACACACAGTAACACTTAAATGGGCTAAGCCTGAATATACTGGGGGCTTTAAAATTACCAGTTATATCGTTGAAAAGAGAGACCTTCCTAATGGACGGTGGCTGAAGGCCAACTTCAGCAACATTTTGGAGAATGAATTTACAGTCAGTGGCCTAACAGAAGATGCTGCATATGAATTCCGTGTGATCGCCAAAAATGCTGCAGGTGCCATCAGTCCACCATCTGAGCCATCTGATGCTATCACTTGCAGGGATGATGTTGAGGCACCAAAGATAAAGGTGGATGTTAAATTTAAGGACACGGTTATATTAAAAGCAGGTGAAGCATTCAGACTGGAAGCTGATGTTTCAGGCCGCCCACCTCCAACAATGGAATGGAGCAAAGATGGAAAAGAGCTGGAAGGCACAGCAAAGTTAGAAATAAAAATTGCAGATTTCTCTACTAATCTGGTAAACAAAGATTCAACAAGAAGGGATAGTGGTGCCTATACCCTTACAGCGACTAATCCTGGTGGCTTTGCTAAACACATTTTCAATGTCAAAGTTCTTGACAGACCAGGCCCACCTGAAGGACCTTTGGCTGTAACTGAAGTGACATCAGAAAAGTGTGTACTATCATGGTTCCCTCCACTGGATGATGGAGGTGCCAAAATTGATCATTACATAGTACAGAAACGTGAAACCAGCAGATTGGCATGGACAAATGTAGCCTCAGAAGTCCAAGTAACAAAGCTAAAGGTCACTAAACTCTTGAAAGGCAATGAATACATATTCCGTGTCATGGCTGTAAATAAATATGGAGTGGGAGAGCCACTGGAATCAGAGCCTGTGCTTGCAGTGAATCCTTATGGACCCCCTGATCCGCCCAAAAACCCTGAAGTGACAACTATTACTAAAGATTCGATGGTTGTCTGCTGGGGACATCCTGATTCTGATGGTGGAAGTGAAATCATCAATTATATTGTGGAACGGCGTGATAAAGCTGGCCAACGCTGGATTAAATGCAACAAAAAAACTCTTACTGATTTAAGATATAAAGTGTCTGGACTGACAGAAGGACATGAATATGAGTTCAGGATTATGGCTGAAAATGCTGCTGGAATTAGTGCACCAAGTCCTACCAGTCCATTTTACAAGGCTTGTGACACTGTGTTTAAACCTGGACCACCAGGTAACCCACGTGTTCTGGATACAAGCAGATCATCCATTTCAATCGCTTGGAATAAACCTATCTATGATGGTGGTTCAGAAATCACTGGGTATATGGTTGAGATTGCCCTGCCAGAGGAAGATGAATGGCAGATTGTCACTCCACCAGCAGGACTCAAGGCAACTTCGTATACTATCACTGGCCTCACAGAGAATCAGGAATATAAGATCCGCATCTATGCCATGAATTCCGAAGGACTTGGGGAACCTGCCCTTGTTCCTGGAACTCCAAAGGCTGAAGACAGAATGCTGCCTCCAGAAATTGAACTGGATGCTGACCTGCGCAAAGTTGTTACTATAAGGGCCTGCTGCACCCTGAGACTTTTTGTTCCCATCAAAGGAAGGCCTGCACCTGAGGTGAAGTGGGCCCGGGACCATGGAGAATCTTTAGATAAAGCTAGCATCGAATCCACAAGCTCTTACACCCTGCTTATTGTTGGAAATGTAAACAGATTTGACAGTGGCAAATATATACTAACTGTAGAAAATAGTTCAGGCAGCAAGTCTGCATTTGTCAATGTTAGAGTTCTCGATACACCAGGCCCCCCACAGGATCTGAAGGTAAAAGAGGTCACTAAGACATCTGTCACACTCACATGGGACCCACCTCTCCTTGATGGAGGTTCAAAAATCAAGAACTATATTGTTGAAAAGCGGGAATCAACAAGAAAAGCATATTCAACTGTTGCAACAAACTGCCACAAGACTTCCTGGAAGGTAGACCAGCTTCAAGAAGGCTGTAGCTACTATTTCAGGGTTCTCGCAGAAAATGAATATGGCATTGGGCTGCCTGCTGAAACCGCAGAATCTGTGAAAGCATCAGAACGACCTCTTCCTCCAGGAAAAATAACTTTGATGGATGTCACAAGAAATAGTGTGTCACTCTCTTGGGAGAAACCAGAGCATGATGGAGGCAGCCGAATTCTAGGCTACATTGTGGAGATGCAGACCAAAGGCAGTGACAAATGGGCCACGTGTGCCACAGTCAAGGTCACTGAAGCCACTATCACTGGATTAATTCAGGGTGAAGAATACTCTTTCCGTGTTTCAGCTCAGAATGAAAAGGGCATCAGTGATCCTAGACAACTGAGTGTGCCAGTGATCGCCAAAGATCTTGTCATTCCACCAGCCTTCAAACTCCTGTTCAATACTTTCACTGTACTGGCAGGTGAAGACCTAAAAGTTGATGTTCCATTCATTGGCCGCCCTACCCCAGCTGTAACCTGGCATAAAGATAATGTACCACTGAAGCAGACAACTAGAGTAAATGCAGAGAGCACAGAAAATAATTCACTACTGACAATAAAGGACGCCTGCCGAGAAGATGTTGGCCATTATGTGGTTAAACTGACTAACTCAGCTGGTGAAGCTATTGAAACCCTTAATGTTATCGTTCTTGACAAACCAGGGCCTCCAACTGGACCAGTTAAAATGGATGAAGTGACAGCTGATAGTATTACTCTTTCCTGGGGCCCACCCAAGTATGATGGTGGAAGTTCTATCAATAATTACATTGTTGAGAAACGGGACACTTCCACAACCACCTGGCAAATTGTATCAGCTACAGTTGCAAGGACAACAATAAAGGCTTGCAGACTGAAGACTGGATGTGAATATCAGTTTAGAATTGCAGCTGAAAACAGATATGGGAAGAGTACCTACCTCAATTCAGAGCCTACTGTAGCCCAATATCCATTCAAAGTTCCTGGTCCTCCTGGCACTCCAGTTGTCACACTGTCCTCCAGGGACAGCATGGAAGTACAATGGAATGAGCCAATCAGTGATGGAGGAAGTAGAGTCATTGGCTATCATCTAGAACGCAAGGAAAGAAATAGCATCCTCTGGGTTAAGTTGAATAAAACACCTATTCCTCAAACCAAGTTTAAGACAACTGGCCTTGAAGAAGGTGTTGAATATGAATTTAGAGTCTCTGCAGAGAACATCGTGGGCATTGGCAAGCCGAGTAAAGTATCAGAATGTTATGTGGCTCGTGACCCATGTGATCCACCAGGACGGCCAGAGGCAATCATTGTCACAAGGAATTCTGTGACTCTTCAGTGGAAGAAACCCACCTATGACGGTGGAAGCAAGATCACTGGTTATATTGTTGAGAAGAAAGAATTACCTGAGGGCCGTTGGATGAAAGCCAGTTTTACAAATATTATTGACACTCATTTTGAAGTAACTGGCCTAGTTGAAGATCACAGATATGAGTTCCGGGTTATAGCCCGAAATGCCGCAGGAGTGTTTAGTGAGCCTTCAGAAAGCACAGGAGCAATAACAGCTAGAGATGAGGTAGATCCACCACGAATAAGTATGGATCCAAAATACAAAGACACAATCGTGGTTCATGCTGGTGAATCATTCAAGGTTGATGCAGATATTTATGGCAAACCAATACCAACCATTCAGTGGATAAAAGGTGATCAGGAGCTTTCAAACACAGCTCGATTAGAAATAAAGAGCACCGACTTTGCCACCAGTCTCAGTGTAAAAGATGCAGTACGTGTCGACAGTGGAAATTACATACTGAAGGCCAAAAATGTTGCAGGAGAAAGATCAGTTACTGTGAATGTCAAGGTTCTTGACAGACCAGGGCCACCTGAAGGACCTGTTGTTATCTCAGGAGTTACAGCAGAAAAATGCACACTAGCTTGGAAACCCCCACTTCAGGATGGTGGGAGTGACATCATAAATTATATTGTGGAAAGGAGAGAAACCAGCCGCTTAGTTTGGACTGTGGTTGATGCCAATGTGCAGACTCTCAGCTGCAAGGTTACTAAGCTTCTTGAAGGCAATGAATATACTTTCCGTATAATGGCAGTAAACAAATATGGTGTTGGTGAACCTCTTGAATCTGAGCCAGTAGTTGCCAAGAATCCATTTGTAGTACCAGATGCACCAAAAGCTCCAGAAGTCACAACAGTGACCAAGGACTCAATGATTGTTGTATGGGAAAGACCAGCATCTGATGGTGGTAGTGAAATTCTTGGATATGTTCTTGAGAAACGGGATAAAGAAGGCATTAGATGGACAAGATGCCATAAGCGTCTGATTGGAGAGTTGCGCCTGAGAGTAACTGGACTCATAGAAAATCACGATTATGAGTTCAGAGTTTCTGCTGAGAATGCTGCTGGACTTAGTGAACCAAGCCCTCCTTCTGCTTACCAAAAGGCTTGTGATCCTATTTATAAACCAGGACCCCCAAACAACCCCAAAGTCATAGACATAACCAGATCTTCAGTATTCCTTTCTTGGAGCAAACCAATATATGATGGTGGCTGTGAAATTCAAGGATACATTGTTGAAAAATGTGATGTGAGTGTTGGTGAATGGACAATGTGCACTCCACCAACAGGAATTAATAAAACAAACATAGAAGTAGAGAAGCTGTTGGAAAAGCATGAATACAACTTCCGTATCTGTGCTATTAATAAAGCTGGAGTTGGAGAACATGCTGACGTCCCTGGACCTATTATAGTTGAAGAAAAATTAGAAGCACCAGACATTGATCTTGACCTAGAACTAAGGAAAATCATAAATATAAGGGCAGGTGGCTCCTTAAGGTTATTTGTTCCTATAAAAGGTCGTCCTACACCAGAAGTTAAATGGGGAAAGGTGGATGGTGAAATCCGAGATGCAGCTATAATTGATGTCACTAGCAGTTTCACCTCTCTTGTTCTTGACAATGTCAACCGATATGATAGTGGAAAATATACGCTTACATTAGAAAACAGCAGTGGAACAAAGTCTGCCTTTGTTACTGTGAGAGTTCTGGACACGCCAAGTCCACCTGTTAACCTGAAAGTCACAGAAATCACCAAAGACTCAGTATCAATTACATGGGAACCTCCTTTGTTGGATGGGGGATCCAAAATAAAAAATTACATTGTTGAGAAACGTGAAGCCACAAGAAAATCATATGCTGCTGTTGTAACTAACTGCCATAAGAATTCTTGGAAAATCGATCAGCTCCAAGAAGGTTGCAGTTATTACTTTAGAGTCACAGCTGAGAATGAGTATGGTATTGGCCTTCCTGCCCAGACTGCTGATCCAATTAAGGTTGCAGAAGTGCCACAACCTCCTGGAAAAATAACTGTGGATGATGTCACCAGAAACAGTGTCTCTCTGAGTTGGACAAAACCTGAACATGATGGTGGCAGTAAAATCATTCAGTATATTGTGGAAATGCAAGCTAAACACAGTGAGAAATGGTCAGAGTGTGCTCGAGTAAAGTCTCTTCAGGCAGTAATTACCAACCTAACTCAAGGGGAAGAATATCTTTTTAGAGTTGTTGCTGTAAATGAAAAGGGGAGAAGTGATCCTCGGTCCCTTGCAGTTCCAATAGTTGCCAAAGATCTGGTAATTGAGCCAGATGTAAAACCTGCATTCAGTAGTTACAGTGTACAGGTTGGCCAAGATTTGAAAATAGAAGTGCCAATTTCTGGACGTCCTAAGCCAACCATTACCTGGACTAAAGATGGTCTCCCACTGAAGCAGACCACAAGAATCAATGTTACCGATTCACTGGATCTCACCACACTCAGTATTAAAGAAACTCATAAGGATGATGGTGGACAATATGGAATCACAGTTGCCAATGTTGTTGGTCAGAAGACAGCATCCATCGAAATTGTAACTCTAGATAAACCTGATCCTCCAAAAGGACCTGTTAAATTTGATGACGTCAGTGCTGAAAGTATTACATTATCTTGGAACCCTCCATTATATACAGGGGGCTGCCAAATCACCAACTACATTGTTCAGAAAAGAGATACAACCACCACAGTATGGGATGTTGTTTCTGCTACTGTTGCTAGAACTACACTCAAAGTGACCAAACTGAAAACTGGTACAGAATACCAATTTAGAATATTTGCCGAAAACAGATATGGACAAAGCTTTGCCTTAGAGTCTGATCCAATTGTAGCTCAATATCCCTACAAAGAACCAGGCCCTCCAGGTACACCATTTGCCACAGCCATTTCCAAAGACTCCATGGTCATACAGTGGCATGAACCAGTCAACAATGGTGGAAGCCCCGTCATAGGTTACCACCTGGAGAGAAAAGAAAGAAACAGTATTTTGTGGACAAAGGTCAACAAAACTATTATTCATGACACCCAATTCAAAGCACAGAATCTTGAAGAAGGCATTGAATATGAATTCAGAGTGTATGCTGAAAATATTGTTGGTGTAGGCAAAGCAAGCAAGAATTCTGAATGCTATGTAGCCAGAGATCCCTGTGACCCACCAGGAACCCCAGAACCAATAATGGTTAAAAGAAATGAAATCACTTTACAGTGGACCAAACCTGTGTATGATGGTGGAAGTATGATTACAGGCTACATTGTAGAGAAACGTGATTTGCCTGATGGTCGTTGGATGAAAGCTAGCTTTACAAATGTCATTGAAACTCAATTTACTGTGTCAGGTCTTACTGAAGATCAAAGATATGAATTCAGAGTCATTGCAAAGAATGCAGCTGGTGCAATAAGTAAACCCTCTGACAGTACTGGACCAATAACTGCCAAGGATGAGGTTGAACTCCCAAGAATTTCAATGGATCCAAAATTCAGAGACACAATTGTGGTAAATGCTGGAGAAACATTCAGACTTGAGGCTGATGTCCATGGAAAGCCCCTACCTACCATTGAGTGGTTAAGAGGAGATAAGGAAATTGAAGAATCTGCTAGATGTGAAATAAAGAACACAGATTTCAAGGCTTTACTTATTGTAAAAGATGCAATTAGAATTGATGGTGGGCAGTATATTTTAAGAGCTTCCAATGTTGCAGGTTCTAAGTCATTCCCAGTAAATGTAAAAGTATTAGATAGACCAGGACCTCCAGAAGGGCCAGTCCAGGTTACTGGAGTCACTTCTGAAAAATGCTCTTTAACATGGTCTCCACCACTTCAAGATGGTGGCAGTGACATTTCTCACTATGTTGTTGAAAAGCGAGAAACCAGTCGACTTGCCTGGACTGTTGTTGCTTCAGAAGTTGTGACCAATTCTCTGAAAGTTACCAAACTCTTAGAAGGTAATGAATATGTTTTCCGTATAATGGCTGTCAACAAATATGGTGTTGGAGAGCCTTTGGAATCTGCACCAGTACTAATGAAAAATCCATTTGTGCTTCCTGGACCACCAAAAAGCTTGGAAGTCACAAATATTGCCAAAGACTCCATGACCGTCTGTTGGAACCGTCCAGATAGTGATGGTGGAAGTGAGATTATTGGTTACATTGTAGAGAAAAGAGACAGAAGTGGCATTCGATGGATAAAATGTAATAAACGCCGCATTACAGATTTGCGTCTAAGAGTGACAGGATTAACAGAAGATCATGAGTATGAATTCAGGGTCTCTGCAGAAAATGCTGCTGGAGTTGGGGAACCAAGTCCAGCTACAGTTTATTATAAAGCCTGTGATCCTGTGTTCAAACCTGGCCCACCTACCAATGCACACATTGTAGACACCACTAAAAATTCAATCACACTTGCCTGGGGTAAACCCATCTATGATGGCGGCAGTGAGATCTTGGGATATGTAGTAGAAATCTGTAAAGCAGATGAAGAAGAATGGCAAATAGTTACTCCACAGACTGGCCTGAGAGTCACTCGATTTGAAATTTCAAAACTCACTGAACACCAAGAGTATAAAATACGAGTCTGTGCCCTCAACAAAGTTGGTTTAGGTGAGGCTACATCAGTTCCTGGTACTGTGAAACCAGAAGATAAACTTGAAGCACCTGAACTTGACCTTGACTCCGAATTAAGAAAAGGAATTGTTGTAAGAGCTGGTGGATCTGCCAGAATTCACATTCCATTCAAAGGTCGTCCAACGCCTGAGATCACTTGGTCTCGAGAGGAAGGTGAATTCACAGATAAGGTCCAAATTGAAAAGGGAGTAAACTATACCCAACTATCAATAGATAACTGTGATAGAAATGATGCTGGAAAATACATTCTTAAGTTGGAAAACAGCAGTGGATCAAAGTCTGCTTTTGTAACTGTGAAAGTTCTTGACACTCCAGGACCACCACAGAATTTGGCAGTCAAAGAAGTGAGAAAAGATTCTGCCTTCCTGGTATGGGAGCCACCCATCATTGATGGAGGGGCAAAGGTCAAGAACTATGTGATTGACAAACGTGAGTCAACCAGAAAAGCGTATGCTAATGTGAGTAGTAAATGCAGCAAAACAAGTTTTAAAGTGGAAAACCTTACAGAAGGAGCCATTTATTACTTCAGAGTCATGGCTGAAAATGAATTTGGAGTTGGTGTTCCAGTGGAAACTGTTGATGCCGTGAAAGCTGCTGAACCTCCTTCCCCACCAGGAAAGGTTACACTCACTGATGTGTCCCAGACCAGTGCATCACTTATGTGGGAGAAACCTGAACATGATGGCGGTAGCAGAGTCCTGGGGTACGTTGTTGAAATGCAGCCCAAAGGAACTGAAAAATGGAGCATTGTGGCTGAATCCAAAGTCTGTAATGCAGTTGTTACTGGTTTGAGTTCTGGACAAGAATATCAGTTCCGTGTCAAGGCTTATAATGAGAAAGGAAAAAGCGATCCAAGAGTGTTGGGTGTTCCTGTCATAGCCAAGGACTTGACTATACAGCCTAGTTTAAAGTTACCATTTAACACATATAGTATCCAAGCTGGAGAAGATCTTAAAATAGAAATTCCAGTTATAGGCCGACCAAGACCTAACATTTCTTGGGTCAAAGATGGTGAGCCTCTTAAACAGACAACAAGAGTAAACGTTGAAGAAACAGCTACCTCAACTGTTTTGCACATTAAAGAAGGTAACAAAGATGACTTTGGAAAATACACCGTAACGGCAACAAATAGTGCAGGCACAGCAACAGAAAATCTCAGTGTTATCGTTTTAGAAAAGCCTGGACCTCCAGTTGGCCCAGTTCGGTTTGATGAAGTTAGTGCAGACTTTGTAGTCATATCTTGGGAACCTCCAGCCTATACTGGTGGCTGCCAAATAAGCAACTACATTGTAGAGAAGCGAGATACAACCACCACCACTTGGCACATGGTATCAGCAACAGTTGCAAGAACAACAATTAAAATAACCAAACTGAAAACAGGCACGGAGTACCAGTTTAGAATTTTTGCTGAAAACAGGTATGGAAAAAGTGCCCCACTGGATTCTAAGGCAGTTATTGTACAATATCCATTTAAAGAACCTGGACCACCTGGAACTCCTTTTGTGACATCAATCTCAAAAGATCAGATGCTTGTGCAATGGCATGAGCCAGTGAATGATGGAGGCACCAAAATTATTGGCTACCATCTTGAACAGAAAGAAAAGAACAGTATTTTATGGGTCAAGTTAAATAAGACCCCCATTCAGGACACCAAATTCAAAACAACTGGGCTTGATGAGGGCCTTGAGTATGAGTTCAAAGTTTCTGCTGAAAATATTGTTGGCATTGGCAAGCCTAGCAAAGTGTCAGAATGCTTTGTTGCTCGTGATCCATGTGACCCACCTGGTCGCCCTGAAGCCATTGTTATTACAAGAAACAATGTCACACTGAAATGGAAGAAACCTGCCTATGATGGTGGTAGCAAAATAACAGGTTATATTGTAGAAAAGAAAGATCTACCTGATGGCCGCTGGATGAAAGCCAGCTTTACCAACGTATTAGAAACTGAATTTACAGTGAGTGGACTTGTAGAAGACCAAAGATATGAATTTAGAGTAATTGCAAGAAATGCAGCTGGAAACTTTAGTGAACCATCTGATAGTAGTGGTGCCATTACTGCAAGAGATGAAATTGATGCACCAAATGCCTCTCTGGATCCAAAATATAAAGATGTCATCGTTGTTCATGCAGGAGAGACTTTTGTTCTTGAAGCCGACATCCGTGGCAAACCTATACCTGATGTTGTTTGGTCAAAAGATGGAAAAGAACTTGAAGAAACAGCTGCTAGAATGGAAATTAAATCTACTATTCAGAAAACAACTCTTGTTGTCAAAGACTGTATACGGACTGATGGAGGACAATATATTCTGAAACTCAGCAATGTTGGTGGTACAAAGTCTATACCCATCACTGTAAAGGTACTTGACAGGCCAGGGCCTCCTGAAGGGCCTCTGAAAGTTACTGGAGTTACTGCGGAAAAATGTTACCTGGCATGGAACCCACCTTTGCAAGATGGTGGTGCTAATATTTCACATTACATCATTGAAAAGAGGGAGACAAGCCGACTCTCTTGGACCCAGGTTTCAACTGAGGTACAGGCCCTTAACTACAAAGTTACTAAACTTCTTCCTGGTAATGAGTACATTTTCCGTGTCATGGCTGTGAATAAATATGGAATTGGAGAGCCCTTGGAATCTGGGCCTGTTACGGCCTGTAATCCTTATAAGCCACCAGGTCCTCCCTCAACACCTGAAGTCTCAGCAATCACCAAAGATTCTATGGTAGTAACATGGGCACGCCCAGTAGACGACGGAGGTACCGAAATTGAGGGCTACATTCTTGAAAAACGAGATAAGGAAGGCGTTAGATGGACCAAGTGCAACAAGAAAACATTAACGGATCTGCGGCTCAGGGTAACTGGTCTTACCGAAGGCCATTCCTATGAATTCAGAGTTGCTGCTGAAAATGCAGCTGGTGTGGGAGAACCTAGTGAGCCATCTGTTTTCTACCGTGCGTGTGATGCCTTGTATCCACCAGGTCCCCCAAGCAATCCAAAAGTGACGGACACTTCCAGATCTTCTGTCTCCCTGGCATGGAGTAAGCCAATTTATGATGGTGGCGCACCTGTTAAAGGCTATGTTGTAGAGGTCAAAGAAGCTGCTGCGGATGAATGGACAACCTGCACTCCACCAACAGGATTACAAGGAAAGCAGTTCACAGTGACCAAGCTTAAAGAAAACACTGAATATAACTTCCGTATTTGTGCCATCAATTCTGAAGGTGTAGGTGAACCTGCAACTCTACCTGGCTCAGTGGTTGCTCAGGAGAGGATAGAGCCACCAGAAATAGAACTCGATGCTGATCTCAGAAAGGTGGTCGTTCTGCGTGCAAGTGCTACTTTACGCTTATTTGTCACTATCAAAGGTCGACCAGAACCCGAAGTTAAATGGGAAAAGGCAGAAGGCATTCTCACTGACAGGGCTCAGATAGAGGTGACCAGCTCATTTACAATGTTGGTGATTGATAATGTTACCAGATTTGACAGTGGTCGGTATAATCTGACATTAGAAAATAATAGTGGCTCCAAAACAGCTTTTGTTAACGTCAGAGTTCTTGACTCACCAAGTGCCCCTGTGAATTTGACCATAAGAGAAGTGAAGAAAGACTCAGTGACGTTGTCCTGGGAACCACCACTTATTGATGGTGGAGCTAAGATTACAAACTACATTGTCGAAAAACGAGAAACTACAAGAAAAGCCTATGCTACCATTACAAATAATTGCACTAAAACTACTTTCAGAATTGAAAATCTACAAGAAGGATGTTCTTACTACTTCCGAGTCTTGGCTTCCAATGAATATGGGATTGGTTTGCCAGCTGAAACAACAGAACCCGTTAAAGTGTCTGAACCACCCCTCCCACCTGGAAGAGTAACTCTTGTTGATGTGACCCGTAATACAGCTACAATTAAGTGGGAGAAACCAGAAAGTGATGGTGGCAGCAAAATTACTGGTTATGTGGTTGAAATGCAGACTAAAGGGAGTGAAAAGTGGAGCACCTGCACACAAGTTAAGACTCTAGAAGCAACTATATCTGGCTTAACTGCAGGAGAAGAGTATGTCTTCAGGGTAGCTGCAGTTAACGAAAAGGGAAGAAGTGATCCAAGACAACTTGGAGTGCCAGTAATTGCAAGGGATATTGAAATAAAGCCTTCAGTTGAGCTTCCTTTCCATACTTTCAATGTAAAGGCTAGAGAACAACTTAAGATTGATGTGCCATTCAAAGGAAGACCTCAAGCTACTGTGAACTGGAGAAAAGATGGTCAGACTCTTAAAGAGACAACTAGAGTCAATGTTTCTTCTTCAAAGACTGTAACATCACTATCTATTAAGGAAGCTTCAAAGGAAGATGTTGGAACTTATGAATTATGTGTTTCAAACAGTGCTGGATCCATAACAGTTCCTATTACTATAATTGTCCTTGACAGACCAGGACCTCCAGGTCCTATACGTATTGATGAGGTTAGTTGTGACAGCATAACCATTTCTTGGAATCCTCCAGAATATGATGGTGGCTGCCAAATTAGCAATTACATTGTTGAAAAGAAAGAAACCACCTCTACAACATGGCACATAGTTTCACAAGCAGTTGCAAGAACATCCATTAAAATAGTTCGCCTGACAACAGGAAGTGAGTATCAGTTCCGTGTTTGTGCAGAAAACCGCTATGGAAAGAGCTCCTACAGTGAATCTTCAGCTGTTGTTGCAGAGTATCCATTCAGTCCCCCAGGTCCTCCTGGTACTCCTAAAGTTGTGCATGCCACAAAATCTACCATGCTTGTAACCTGGCAAGTGCCAGTTAATGATGGAGGAAGTCGAGTAATTGGCTATCATCTTGAGTATAAAGAAAGAAGCAGCATTCTTTGGTCAAAAGCAAATAAAATCCTCATTGCTGATACTCAAATGAAAGTCTCCGGCCTTGATGAAGGACTGATGTATGAGTATCGTGTATATGCTGAAAATATTGCTGGAATTGGTAAATGCAGTAAATCTTGTGAACCAGTCCCTGCAAGAGATCCTTGTGACCCTCCTGGACAACCTGAAGTCACAAATATCACAAGAAAATCAGTGTCACTTAAATGGTCTAAACCACATTATGATGGTGGAGCTAAGATCACAGGATACATTGTTGAACGCAGAGAACTACCAGATGGCCGGTGGCTGAAGTGCAATTATACTAATATACAAGAAACATACTTTGAAGTAACTGAACTTACTGAAGATCAGCGTTATGAATTCCGGGTTTTTGCAAGGAATGCTGCTGACTCAGTTAGTGAGCCATCTGAATCCACTGGGCCTATTATAGTTAAAGATGATGTTGAGCCTCCAAGAGTTATGATGGATGTCAAGTTCCGAGACGTTATTGTTGTCAAAGCTGGAGAGGTCCTTAAGATAAATGCAGACATTGCAGGGCGACCTCTGCCAGTAATTTCCTGGGCCAAGGATGGTATAGAAATTGAAGAAAGAGCAAGAACAGAAATCATCTCAACAGACAATCATACTTTGTTAACAGTTAAAGACTGTATAAGACGAGACACTGGGCAATATGTACTAACACTGAAGAATGTTGCCGGCACTCGGTCTGTGGCCGTTAATTGCAAAGTACTTGATAAGCCTGGTCCACCAGCAGGACCACTTGAAATAAATGGCCTCACTGCTGAGAAATGCTCTCTTTCCTGGGGACGTCCCCAAGAAGATGGTGGTGCAGATATCGACTATTACATCGTAGAAAAACGTGAAACAAGCCACCTTGCATGGACAATATGTGAAGGAGAGTTACAGATGACATCCTGTAAAGTAACCAAGTTACTCAAAGGCAATGAATATATATTTAGAGTAACTGGTGTTAATAAATATGGTGTTGGTGAGCCCCTAGAGAGTGTAGCTATAAAGGCACTAGATCCATTTACAGTTCCAAGTCCACCCACGTCTTTGGAAATTACTTCTGTGACCAAAGAATCTATGACACTTTGCTGGTCAAGACCCGAGAGTGATGGAGGTAGTGAAATATCTGGATATATAATTGAAAGGCGAGAGAAAAATAGCCTAAGATGGGTGCGTGTAAACAAAAAACCAGTTTATGATCTAAGAGTGAAATCAACAGGACTTCGGGAAGGATGTGAATATGAATATCGTGTTTATGCAGAAAATGCTGCTGGCCTAAGTCTTCCAAGTGAAACCTCTCCCTTAATTAGGGCAGAAGATCCAGTGTTCCTACCATCTCCTCCATCCAAACCCAAAATTGTGGACTCAGGCAAGACAACTATAACTATTGCCTGGGTTAAGCCGCTGTTTGATGGTGGGGCCCCGATAACTGGATATACTGTAGAATACAAAAAATCTGATGACACTGACTGGAAAACTTCCATTCAGAGCTTACGAGGGACAGAATATACAATAAGCGGACTAACAACAGGAGCTGAATATGTTTTCAGAGTAAAATCTGTCAATAAGGTTGGTGCTAGTGACCCCAGTGATAGCTCTGACCCTCAGATAGCAAAGGAAAGAGAAGAAGAACCTTTATTTGATATTGACAGTGAAATGAGGAAGACCTTGATTGTCAAGGCTGGTGCCTCATTTACCATGACTGTGCCTTTCCGAGGAAGACCAGTACCCAATGTCTTGTGGAGTAAGCCAGACACTGACCTCCGTACTAGAGCTTATGTTGATACCACAGACTCTCGTACATCACTGACCATTGAAAATGCCAACAGAAATGACTCTGGAAAGTACACATTAACAATTCAGAATGTTTTGAGTGCTGCTTCACTGACCTTAGTTGTCAAAGTTTTAGATACCCCAGGTCCTCCAACCAACATTACTGTGCAAGATGTAACCAAAGAGTCTGCAGTGTTATCCTGGGATGTTCCTGAAAACGATGGTGGAGCACCAGTGAAGAATTACCACATAGAAAAACGTGAGGCCAGCAAGAAAGCATGGGTCTCTGTGACCAACAACTGTAACCGCCTCTCCTACAAAGTTACCAATTTACAAGAAGGAGCTATCTATTACTTCAGAGTCTCTGGAGAAAATGAGTTTGGTGTTGGTATACCAGCTGAAACAAAGGAAGGAGTAAAAATAACAG
>TTN-211,ENSE00003802597,1,297,2305769,2306065,AAAAACCAAGCCCACCTGAAAAACTTGGAGTAACAAGTATATCCAAAGACAGTGTTTCCCTGACCTGGCTGAAGCCTGAACATGATGGCGGAAGCAGAATTGTACACTATGTCGTTGAAGCACTAGAAAAAGGACAGAAAAACTGGGTTAAATGTGCAGTGGCAAAGTCAACCCATCACGTTGTTTCCGGTCTGAGAGAGAATTCTGAATACTTTTTCCGAGTGTTTGCTGAAAATCAAGCTGGCCTGAGTGACCCGAGAGAGCTTCTGCTTCCTGTTCTTATTAAGGAGCAACTAG
>TTN-211,ENSE00003802941,1,588,2306066,2306653,AACCACCTGAAATTGATATGAAGAATTTCCCAAGTCACACTGTATATGTTAGAGCTGGTTCAAACCTTAAAGTTGACATTCCAATCTCTGGAAAACCACTTCCCAAAGTGACCTTATCAAGAGATGGTGTCCCCCTTAAGGCAACCATGAGATTTAATACCGAAATTACTGCTGAGAACCTGACCATCAATCTCAAAGAAAGTGTTACAGCTGACGCTGGGAGATATGAAATCACTGCTGCCAACTCCAGTGGTACAACCAAAGCTTTCATTAACATTGTTGTGCTAGACAGGCCTGGTCCTCCAACTGGCCCTGTTGTTATTAGTGATATAACTGAAGAAAGTGTGACTCTCAAATGGGAGCCACCTAAGTATGACGGTGGAAGTCAAGTTACCAACTACATTCTACTCAAAAGAGAAACAAGTACTGCAGTGTGGACTGAAGTGTCTGCAACAGTTGCAAGAACCATGATGAAAGTCATGAAACTGACCACAGGAGAAGAATACCAATTCCGCATCAAGGCAGAAAACCGCTTTGGCATCAGTGATCATATAGATTCAGCTTGTGTGACTGTCAAACTACCATACA
>TTN-211,ENSE00003808789,1,303,2306654,2306956,CAACACCTGGACCACCATCTACACCATGGGTCACTAATGTTACTCGAGAAAGCATCACTGTGGGCTGGCATGAACCAGTGTCAAATGGAGGCAGTGCAGTCGTAGGCTATCACCTGGAAATGAAAGACAGAAACAGTATTTTATGGCAAAAAGCCAACAAACTGGTCATCCGCACAACTCACTTCAAAGTCACAACAATCAGTGCTGGACTTATTTATGAATTCAGGGTGTATGCAGAAAATGCTGCTGGAGTTGGAAAACCTAGCCATCCTTCTGAACCAGTCTTGGCAATTGATGCTTGTG
>TTN-211,ENSE00003806587,1,297,2306957,2307253,AACCCCCAAGAAATGTTCGTATCACTGATATTTCAAAGAACTCTGTCAGCCTTTCATGGCAACAACCAGCTTTCGATGGAGGTAGCAAGATTACAGGCTACATTGTTGAGAGACGTGACCTTCCAGATGGCAGATGGACCAAGGCCAGCTTCACCAATGTTACTGAAACTCAATTCATCATCTCTGGCTTGACTCAGAATTCCCAGTATGAATTCCGTGTCTTTGCTAGGAATGCTGTTGGTTCCATTAGCAATCCATCTGAGGTTGTAGGGCCCATTACTTGCATCGATTCTTATG
>TTN-211,ENSE00003807681,1,288,2307254,2307541,GTGGTCCTGTAATTGATTTGCCTCTAGAATATACAGAAGTTGTCAAATACAGAGCAGGTACATCTGTGAAGCTCAGAGCTGGCATTTCTGGCAAACCTGCGCCTACTATTGAGTGGTATAAAGATGATAAAGAATTACAAACCAATGCACTGGTGTGTGTTGAAAATACCACGGACCTCGCATCTATACTCATCAAAGATGCCGATCGCCTTAATAGTGGATGCTATGAATTAAAACTAAGGAATGCCATGGGCTCAGCCTCAGCCACCATCAGAGTACAGATCCTTG
>TTN-211,ENSE00003811102,1,300,2307542,2307841,ACAAACCAGGCCCACCTGGTGGACCAATTGAATTTAAGACTGTAACTGCTGAGAAGATCACCCTTCTCTGGCGGCCTCCAGCTGATGATGGTGGTGCAAAAATCACTCACTACATTGTGGAAAAGCGTGAGACAAGCCGCGTTGTGTGGTCTATGGTGTCTGAACATTTGGAAGAGTGCATCATTACAACCACCAAAATTATCAAAGGAAATGAATACATCTTCCGGGTCCGAGCCGTGAACAAATATGGAATTGGCGAGCCACTGGAATCTGATTCCGTTGTAGCCAAGAACGCATTTG
>TTN-211,ENSE00003802386,1,303,2307842,2308144,TTACACCTGGGCCACCAGGCATACCAGAAGTGACAAAGATTACCAAGAATTCGATGACTGTTGTATGGAGCAGGCCAATTGCAGATGGCGGTAGTGATATAAGTGGCTATTTCCTTGAAAAACGAGACAAGAAGAGCCTAGGATGGTTTAAAGTACTAAAAGAGACTATCCGTGACACCAGACAAAAAGTAACAGGACTCACAGAAAACAGTGACTATCAATACAGAGTTTGTGCTGTAAACGCTGCTGGACAGGGTCCATTTTCTGAACCATCTGAATTCTACAAAGCTGCTGATCCTATTG
>TTN-211,ENSE00003809908,1,306,2308145,2308450,ATCCTCCAGGTCCACCTGCTAAGATAAGAATCGCAGATTCAACCAAGTCATCCATCACCCTTGGCTGGAGTAAGCCTGTCTATGATGGGGGCAGTGCTGTTACTGGGTATGTTGTCGAGATAAGACAAGGAGAGGAAGAGGAATGGACTACTGTCTCTACCAAAGGAGAGGTCAGAACTACAGAATATGTGGTATCCAACCTGAAACCTGGAGTCAATTACTACTTCCGGGTATCTGCTGTAAACTGTGCTGGACAAGGAGAACCTATAGAAATGAATGAACCTGTACAAGCTAAAGATATACTTG
>TTN-211,ENSE00003808993,1,1767,2308451,2310217,AGGCACCAGAGATTGACCTGGATGTGGCTCTCAGAACTTCTGTTATTGCCAAAGCTGGTGAAGATGTACAAGTGTTGATTCCCTTTAAAGGCAGACCTCCACCTACTGTCACATGGAGAAAAGATGAGAAGAATCTTGGCAGTGATGCCAGATACAGCATTGAAAACACTGATTCATCCTCATTACTCACCATTCCTCAAGTTACTCGCAATGATACAGGAAAATATATTCTCACAATAGAAAATGGAGTTGGTGAACCTAAGTCTTCAACTGTGAGTGTTAAAGTGCTTGACACACCAGCTGCCTGCCAGAAACTACAGGTTAAACATGTTTCTCGAGGCACAGTCACTTTGCTCTGGGATCCTCCTCTCATTGATGGAGGATCTCCAATAATTAATTATGTCATTGAAAAGAGAGATGCCACCAAGAGAACATGGTCTGTCGTGTCACACAAATGTTCTAGCACATCCTTCAAGCTAATAGATTTGTCGGAGAAGACTCCATTCTTCTTCAGAGTTCTTGCAGAAAATGAAATTGGAATTGGGGAACCCTGTGAAACTACAGAGCCAGTGAAGGCTGCTGAAGTACCAGCTCCTATACGTGATCTCTCAATGAAAGACTCAACAAAGACATCTGTCATCCTCAGCTGGACCAAACCTGACTTTGATGGTGGTAGCGTCATCACAGAATATGTTGTAGAAAGGAAAGGTAAAGGTGAACAGACGTGGTCCCACGCTGGCATAAGTAAGACATGTGAAATTGAGGTTAGCCAACTTAAGGAGCAGTCAGTCCTGGAGTTCAGAGTGTTTGCCAAAAATGAGAAAGGACTGAGTGATCCTGTCACTATTGGGCCAATTACAGTGAAAGAACTTATTATTACACCTGAAGTTGACCTGTCAGATATCCCTGGGGCACAAGTCACTGTGAGAATTGGGCACAATGTGCACCTTGAATTACCTTATAAGGGAAAACCCAAACCATCCATCAGTTGGCTGAAAGATGGCTTGCCACTGAAAGAAAGTGAATTTGTTCGCTTCAGTAAAACTGAAAACAAAATTACTTTGAGTATTAAGAATGCCAAGAAGGAGCATGGAGGAAAATACACTGTTATTCTTGATAATGCAGTGTGTAGAATTGCAGTCCCCATTACAGTCATCACCCTTGGCCCACCATCAAAGCCCAAAGGACCCATTCGATTTGATGAAATCAAGGCTGATAGTGTCATCCTGTCATGGGATGTACCTGAAGATAATGGAGGAGGAGAAATTACTTGTTACAGCATCGAGAAGCGGGAAACTTCACAAACTAACTGGAAGATGGTGTGTTCAAGTGTTGCCAGAACGACTTTCAAAGTTCCTAATCTAGTCAAAGATGCTGAGTACCAGTTTAGAGTGAGAGCAGAAAACAGATACGGAGTCAGCCAACCACTTGTCTCAAGCATTATTGTGGCAAAACACCAGTTCAGGATTCCTGGTCCCCCAGGAAAGCCAGTTATATACAATGTGACTTCTGATGGCATGTCACTAACTTGGGATGCTCCAGTTTATGATGGTGGTTCAGAAGTTACTGGATTCCATGTTGAAAAGAAAGAAAGAAATAGCATCCTCTGGCAAAAAGTTAATACATCACCAATCTCTGGAAGAGAATATAGAGCCACTGGACTGGTAGAAGGTCTGGATTACCAATTCCGTGTATATGCTGAAAATTCTGCTGGCCTAAGCTCACCTAGTGACCCAAGCAAATTTACCTTAGCTGTTTCTCCAGTAG
>TTN-211,ENSE00003811205,1,294,2310218,2310511,ACCCACCTGGCACTCCTGACTACATTGATGTCACCCGGGAAACCATCACACTTAAATGGAACCCACCATTGCGTGATGGAGGCAGTAAGATTGTGGGCTATAGCATTGAGAAACGGCAAGGAAATGAACGCTGGGTGAGATGCAACTTTACTGACGTCAGTGAATGTCAGTACACAGTTACAGGACTCAGTCCTGGGGATCGCTATGAGTTCAGAATAATTGCAAGAAATGCTGTTGGAACTATAAGCCCGCCCTCACAGTCTTCTGGCATTATTATGACAAGAGATGAAAATG
>TTN-211,ENSE00003808021,1,288,2310512,2310799,TTCCACCAATAGTAGAGTTTGGCCCTGAATACTTTGATGGTCTCATTATTAAGTCCGGAGAGAGCCTTAGAATTAAAGCTTTGGTACAAGGAAGACCAGTGCCTCGAGTAACTTGGTTCAAAGATGGAGTGGAAATCGAAAAGAGGATGAATATGGAAATAACCGACGTACTTGGATCCACCAGCCTATTTGTTAGAGATGCTACTCGGGACCATCGTGGTGTATACACAGTGGAAGCCAAAAATGCATCTGGTTCTGCAAAAGCAGAAATTAAAGTGAAAGTACAAG
>TTN-211,ENSE00003804355,1,300,2310800,2311099,ATACACCAGGAAAAGTAGTTGGGCCAATAAGATTCACCAATATTACTGGGGAGAAGATGACTCTGTGGTGGGATGCCCCACTCAATGACGGTTGTGCTCCCATAACCCACTACATCATTGAAAAACGGGAAACCAGCAGACTTGCCTGGGCACTAATTGAGGATAAATGTGAAGCCCAAAGTTACACTGCCATTAAACTAATAAACGGCAATGAATACCAATTCCGTGTTTCTGCAGTTAACAAGTTTGGTGTTGGCAGGCCACTTGATTCTGATCCAGTGGTTGCTCAAATACAATATA
>TTN-211,ENSE00003807046,1,2067,2311100,2313166,CTGTTCCTGATGCCCCTGGCATTCCAGAACCTAGCAACATAACAGGCAACAGCATTACCCTGACATGGGCAAGGCCAGAATCAGATGGTGGCAGTGAAATTCAACAGTATATCCTTGAAAGAAGAGAAAAGAAAAGCACAAGATGGGTAAAAGTGATCAGCAAACGACCAATCTCTGAAACAAGATTCAAAGTCACTGGTCTGACAGAAGGCAATGAGTATGAATTCCATGTCATGGCTGAAAATGCTGCAGGAGTTGGACCTGCAAGTGGCATCTCAAGACTCATTAAATGTAGAGAGCCCGTCAACCCACCAGGTCCTCCCACAGTGGTCAAAGTAACAGACACATCAAAGACAACTGTGAGCTTAGAATGGTCCAAACCAGTGTTTGATGGTGGCATGGAAATAATTGGGTATATTATTGAAATGTGTAAGGCCGACTTAGGAGACTGGCACAAGGTGAATGCAGAGGCATGTGTGAAAACAAGATATACAGTCACTGATCTACAAGCAGGTGAAGAATACAAATTCCGAGTTAGTGCTATCAATGGTGCTGGAAAAGGCGACAGCTGTGAAGTGACTGGCACAATTAAAGCAGTTGACCGGTTAACAGCTCCTGAGTTAGACATAGATGCAAACTTCAAACAGACTCATGTTGTTAGAGCTGGGGCCAGTATTCGCCTCTTCATTGCCTACCAAGGTAGACCTACTCCTACAGCTGTGTGGAGCAAACCAGACTCTAACCTTAGCCTTCGGGCTGATATCCATACAACAGATTCCTTCAGCACCCTCACTGTGGAAAACTGCAACAGAAATGATGCAGGGAAATATACCCTTACTGTGGAAAACAACAGTGGTAGTAAGTCAATCACATTCACCGTGAAAGTGCTAGACACTCCAGGCCCACCTGGCCCAATTACCTTCAAAGATGTGACCCGGGGATCTGCTACATTGATGTGGGATGCCCCTCTTCTTGACGGTGGTGCCCGAATCCATCATTATGTGGTAGAGAAACGAGAGGCAAGTCGCCGTAGTTGGCAGGTTATCAGTGAAAAATGCACTCGTCAGATCTTCAAGGTCAATGACCTGGCCGAAGGTGTTCCGTACTATTTCCGTGTTTCTGCAGTAAATGAGTATGGTGTTGGTGAGCCCTATGAAATGCCAGAACCAATTGTAGCCACAGAACAGCCTGCTCCACCTAGGAGACTTGATGTTGTTGATACTAGCAAATCCTCCGCAGTCTTAGCTTGGCTTAAACCTGACCACGATGGAGGCAGCCGGATCACTGGCTACCTGCTTGAAATGAGACAAAAGGGATCTGACTTCTGGGTTGAAGCTGGTCACACCAAACAGCTAACTTTCACAGTAGAGCGTCTTGTTGAGAAAACTGAATATGAATTCCGTGTGAAGGCCAAGAATGATGCTGGCTATAGTGAACCCAGAGAAGCCTTCTCTTCTGTCATCATTAAGGAGCCTCAAATCGAGCCCACTGCTGACCTCACTGGAATTACCAATCAGCTTATAACTTGCAAAGCAGGAAGCCCATTTACCATTGACGTACCAATCAGTGGTCGTCCTGCCCCCAAAGTAACATGGAAACTGGAAGAAATGAGACTTAAAGAGACAGATCGAGTGAGCATTACAACAACAAAAGACAGAACCACACTGACTGTAAAGGACAGCATGAGAGGTGACTCTGGAAGATACTTCTTGACCCTGGAAAATACAGCTGGTGTTAAAACATTTAGCGTCACAGTTGTGGTCATTGGAAGGCCAGGTCCAGTAACCGGCCCCATTGAGGTCTCATCTGTCTCAGCTGAATCGTGTGTCCTGTCATGGGGAGAACCTAAAGATGGAGGAGGCACTGAAATTACTAATTACATAGTTGAAAAGCGTGAATCGGGTACAACAGCTTGGCAGCTTGTCAATTCCAGTGTCAAGCGCACTCAAATTAAAGTCACTCATCTCACAAAATACATGGAATATTCTTTCCGTGTCAGTTCAGAGAACAGATTTGGTGTCAGCAAACCTCTAGAATCAGCACCAATAATTGCTGAACATCCATTTG
>TTN-211,ENSE00003810611,1,303,2313167,2313469,TCCCACCAAGCGCTCCTACCAGACCTGAGGTCTACCATGTGTCTGCCAATGCCATGTCTATTCGTTGGGAAGAACCCTACCACGATGGTGGCAGTAAAATCATTGGCTACTGGGTTGAGAAGAAAGAACGTAATACAATTCTTTGGGTGAAAGAAAACAAAGTGCCATGCTTAGAGTGCAACTACAAAGTAACTGGTTTAGTAGAAGGACTGGAATATCAGTTCAGAACTTATGCACTCAATGCTGCAGGTGTTAGCAAGGCCAGCGAAGCTTCAAGACCTATAATGGCTCAAAATCCAGTTG
>TTN-211,ENSE00003803222,1,306,2313470,2313775,ATGCACCAGGCAGACCAGAGGTGACAGATGTCACAAGATCAACAGTATCACTGATTTGGTCTGCCCCAGCGTATGATGGAGGCAGCAAGGTTGTGGGCTACATCATAGAGCGTAAGCCAGTCAGTGAGGTAGGAGATGGTCGCTGGCTGAAGTGCAACTACACCATTGTATCTGACAATTTCTTCACCGTGACTGCTCTCAGTGAAGGAGACACTTATGAGTTCCGTGTGTTAGCCAAGAATGCAGCAGGCGTAATTAGCAAAGGGTCTGAATCTACAGGCCCTGTCACTTGCCGAGATGAATACG
>TTN-211,ENSE00003801213,1,291,2313776,2314066,CTCCACCCAAAGCCGAACTGGATGCCCGATTACACGGTGATCTGGTTACCATCAGAGCAGGTTCTGATCTTGTTCTGGATGCTGCAGTTGGTGGCAAACCTGAACCCAAAATTATCTGGACCAAAGGAGACAAGGAGCTAGATCTCTGTGAAAAAGTCTCTTTGCAGTATACTGGCAAACGAGCAACTGCTGTGATCAAGTTCTGTGACAGAAGTGACAGTGGAAAATACACTTTAACAGTGAAAAATGCCAGCGGGACCAAGGCCGTGTCTGTCATGGTCAAAGTGCTTG
>TTN-211,ENSE00003809128,1,297,2314067,2314363,ATTCCCCTGGCCCATGTGGAAAGCTCACCGTCAGCAGAGTAACACAGGAGAAGTGCACTTTAGCCTGGAGCCTTCCGCAGGAAGACGGAGGAGCAGAAATCACTCACTACATCGTGGAAAGACGCGAGACTAGCAGGCTCAACTGGGTGATTGTTGAAGGCGAATGCCCAACCCTATCCTATGTCGTTACCAGGCTCATCAAGAACAATGAGTACATATTCCGAGTGAGGGCAGTAAACAAATATGGCCCTGGTGTGCCTGTTGAATCAGAGCCAATTGTAGCCAGAAACTCATTCA
>TTN-211,ENSE00003803385,1,306,2314364,2314669,CTATTCCATCACCACCCGGCATACCTGAAGAAGTTGGGACTGGCAAAGAGCATATCATCATTCAGTGGACAAAACCTGAATCTGATGGTGGCAATGAAATCAGCAACTACCTAGTAGACAAACGTGAGAAGAAGAGCCTGCGCTGGACACGTGTCAACAAAGACTATGTGGTGTATGATACCAGGCTGAAGGTGACCAGCCTGATGGAGGGTTGTGATTACCAGTTCCGGGTGACCGCAGTGAATGCAGCTGGTAACAGTGAGCCCAGCGAAGCTTCCAACTTCATCTCATGCAGAGAACCATCAT
>TTN-211,ENSE00003807140,1,306,2314670,2314975,ATACCCCTGGACCACCTTCTGCTCCAAGAGTTGTGGATACCACCAAACACAGCATTAGTTTGGCATGGACCAAACCCATGTACGATGGTGGTACTGACATTGTAGGATATGTTCTGGAAATGCAAGAGAAGGACACTGATCAGTGGTACCGAGTGCATACCAATGCCACAATAAGAAATACTGAATTCACTGTGCCAGACCTTAAAATGGGCCAGAAATATTCCTTCAGAGTTGCTGCCGTGAACGTGAAGGGTATGAGCGAATACAGCGAATCAATTGCTGAAATTGAGCCCGTGGAAAGAATAG
>TTN-211,ENSE00003809946,1,282,2314976,2315257,AAATACCAGATCTTGAGCTTGCAGATGATCTAAAGAAGACTGTGACCATCAGGGCTGGGGCCTCCTTGCGCTTGATGGTGTCTGTATCTGGAAGACCACCTCCTGTCATAACGTGGAGCAAGCAGGGCATTGACCTTGCAAGCCGGGCAATTATTGACACCACTGAGAGCTACTCATTGCTAATAGTGGACAAAGTTAATCGGTACGATGCTGGAAAATACACAATTGAAGCTGAAAACCAATCTGGCAAGAAATCAGCAACAGTCCTTGTTAAAGTCTATG
>TTN-211,ENSE00003810384,1,594,2315258,2315851,ATACTCCTGGTCCCTGTCCTTCAGTGAAAGTTAAGGAAGTATCAAGAGATTCTGTGACTATAACTTGGGAAATTCCCACGATTGATGGTGGAGCTCCAGTCAACAATTACATCGTTGAGAAGCGTGAAGCTGCTATGAGAGCATTCAAAACAGTAACTACCAAATGCAGCAAGACACTTTACAGAATTTCTGGACTTGTAGAAGGAACCATGTACTATTTCAGAGTGCTGCCAGAAAATATTTATGGCATTGGAGAACCTTGTGAAACATCTGATGCAGTACTGGTCTCAGAAGTGCCTTTGGTGCCTGCAAAGCTAGAAGTGGTCGATGTCACCAAATCCACTGTTACCCTTGCCTGGGAAAAACCACTCTACGATGGTGGTAGCCGACTCACTGGATATGTTCTCGAGGCCTGCAAAGCTGGCACAGAGAGATGGATGAAGGTTGTCACCTTAAAACCCACAGTCCTAGAGCACACTGTTACTTCCTTAAATGAAGGTGAACAATACTTATTTAGAATAAGGGCACAAAATGAGAAAGGTGTGTCAGAACCAAGAGAGACTGTCACAGCCGTGACTGTACAAGACCTCAGAG
>TTN-211,ENSE00003802641,1,288,2315852,2316139,TGTTGCCAACAATCGATCTTTCTACAATGCCTCAGAAGACCATCCATGTCCCAGCTGGCAGACCAGTAGAGCTGGTGATACCTATTGCTGGCCGTCCACCTCCTGCTGCTTCCTGGTTCTTTGCTGGTTCTAAACTGAGAGAATCAGAGCGTGTCACAGTTGAAACTCACACTAAAGTAGCTAAATTAACCATCCGTGAAACCACTATCAGAGATACTGGAGAATACACACTTGAATTGAAGAATGTTACCGGAACTACTTCAGAAACCATTAAAGTTATCATTCTTG
>TTN-211,ENSE00003806194,1,300,2316140,2316439,ACAAGCCTGGTCCACCAACAGGACCTATTAAGATTGATGAAATTGATGCTACATCAATTACCATTTCCTGGGAACCACCTGAATTGGACGGTGGTGCTCCACTGAGTGGTTATGTGGTAGAACAACGTGACGCTCATCGTCCAGGATGGCTGCCCGTTTCTGAATCAGTGACTAGGTCCACGTTTAAGTTTACCAGACTCACCGAAGGAAATGAGTATGTGTTCCGTGTGGCTGCAACAAACCGCTTCGGGATTGGCTCTTACTTGCAGTCTGAGGTCATAGAGTGTCGCAGCAGCATCC
>TTN-211,ENSE00003805894,1,303,2316440,2316742,GTATTCCTGGACCCCCAGAAACATTACAGATATTTGATGTTTCCCGTGATGGCATGACACTTACTTGGTACCCACCAGAGGATGACGGTGGCTCCCAAGTGACTGGATATATTGTGGAGCGCAAAGAAGTGAGAGCAGATCGATGGGTCCGTGTAAATAAAGTACCTGTGACAATGACACGGTACCGCTCCACTGGCCTTACTGAAGGCTTAGAATATGAACACCGTGTCACAGCCATTAATGCAAGAGGGTCTGGGAAACCAAGTCGTCCTTCCAAACCCATCGTTGCCATGGATCCAATTG
>TTN-211,ENSE00003808643,1,303,2316743,2317045,CTCCTCCAGGAAAGCCACAAAACCCAAGAGTTACTGATACAACAAGGACATCAGTCTCCCTGGCCTGGAGTGTTCCAGAAGATGAAGGAGGATCTAAAGTCACAGGCTACTTGATTGAAATGCAAAAAGTAGATCAACATGAATGGACCAAGTGTAACACCACTCCAACCAAGATTCGAGAGTATACTCTAACACACCTACCTCAGGGTGCAGAATACAGGTTCCGCGTCCTAGCTTGTAATGCTGGTGGACCTGGTGAGCCTGCTGAGGTACCAGGAACAGTCAAAGTCACTGAAATGCTTG
>TTN-211,ENSE00003805779,1,585,2317046,2317630,AATATCCTGATTATGAACTTGATGAAAGATACCAAGAAGGTATCTTTGTAAGGCAAGGTGGCGTCATCAGACTTACCATACCAATCAAAGGAAAACCATTCCCAATATGTAAATGGACCAAGGAAGGCCAGGATATTAGTAAGCGTGCCATGATTGCAACATCTGAAACACACACTGAGCTTGTGATCAAAGAAGCAGACAGGGGTGATTCTGGCACTTATGACCTGGTTCTGGAAAATAAATGTGGCAAGAAGGCTGTCTACATCAAGGTCAGGGTGATAGGAAGTCCCAACAGTCCAGAAGGGCCACTGGAATATGATGACATCCAAGTCCGCTCTGTGAGGGTCAGCTGGAGACCTCCTGCTGATGATGGTGGTGCTGACATCTTAGGCTACATCCTCGAGAGACGAGAAGTGCCTAAAGCCGCCTGGTATACCATTGATTCCAGAGTCCGAGGTACATCTCTGGTGGTAAAAGGCCTCAAAGAGAATGTAGAATACCATTTCCGTGTTTCAGCAGAAAACCAGTTTGGCATAAGCAAACCCTTGAAATCTGAGGAACCAGTCACACCAAAAACACCATTGA
>TTN-211,ENSE00003806836,1,306,2317631,2317936,ATCCTCCAGAACCTCCAAGCAATCCTCCAGAAGTACTCGATGTAACCAAGAGTTCTGTTAGCTTGTCCTGGTCCCGGCCCAAAGATGATGGTGGTTCTAGAGTCACAGGCTACTACATCGAACGCAAAGAGACATCCACTGACAAGTGGGTCAGACACAACAAGACTCAGATCACCACCACAATGTACACTGTCACAGGGCTTGTTCCCGATGCTGAGTATCAGTTCCGCATCATCGCACAGAATGATGTTGGCCTGAGTGAGACCAGCCCTGCTTCTGAACCAGTTGTTTGCAAAGATCCATTTG
>TTN-211,ENSE00003810204,1,300,2317937,2318236,ATAAACCAAGCCAACCAGGAGAACTTGAGATTCTTTCAATATCCAAAGATAGTGTCACTCTACAGTGGGAGAAACCTGAATGTGATGGTGGTAAAGAAATTCTTGGATACTGGGTTGAATATAGACAGTCTGGAGACAGTGCCTGGAAGAAGAGCAATAAGGAACGTATTAAGGACAAGCAATTCACAATAGGAGGTTTGCTGGAAGCTACTGAGTATGAATTCAGGGTTTTTGCTGAGAATGAGACTGGGCTGAGCAGACCTCGCAGAACTGCTATGTCTATAAAGACTAAACTCACAT
>TTN-211,ENSE00003805486,1,576,2318237,2318812,CTGGAGAGGCCCCAGGAATACGCAAAGAAATGAAGGATGTTACCACAAAATTGGGTGAAGCTGCTCAACTCTCATGCCAGATTGTTGGAAGGCCTCTTCCTGACATTAAATGGTACAGATTTGGTAAAGAGCTCATACAAAGCCGGAAATACAAAATGTCTTCAGATGGACGCACACACACTCTTACAGTAATGACAGAGGAACAGGAAGATGAAGGTGTTTATACCTGCATAGCCACCAATGAGGTTGGAGAAGTAGAAACCAGTAGTAAGCTTCTCCTGCAAGCAACACCGCAGTTCCATCCTGGTTACCCACTGAAAGAGAAATATTATGGAGCTGTGGGTTCCACACTTCGGCTTCATGTTATGTACATTGGTCGTCCAGTACCTGCCATGACTTGGTTCCATGGTCAGAAACTTTTGCAAAACTCAGAAAACATTACTATTGAAAACACTGAGCACTATACTCATCTTGTCATGAAGAATGTCCAACGTAAGACTCATGCTGGGAAATACAAAGTCCAGCTCAGCAATGTTTTTGGAACAGTTGATGCCATCCTTGATGTGGAAATACAAG
>TTN-211,ENSE00003801306,1,306,2318813,2319118,ATAAACCAGACAAACCTACAGGACCAATTGTGATCGAAGCTCTATTGAAGAACTCCGCAGTGATCAGCTGGAAACCACCCGCAGATGACGGAGGCTCCTGGATCACCAACTATGTGGTGGAAAAATGTGAGGCCAAGGAGGGGGCTGAATGGCAATTGGTGTCTTCAGCCATCTCAGTGACAACCTGTAGAATTGTGAACCTCACAGAAAATGCTGGCTATTACTTCCGGGTTTCAGCTCAGAACACTTTCGGCATCAGTGACCCTCTAGAAGTGTCCTCAGTTGTGATCATTAAGAGTCCATTTG
>TTN-211,ENSE00003808123,1,594,2319119,2319712,AAAAGCCAGGTGCTCCTGGCAAACCAACTATTACTGCTGTCACAAAAGATTCTTGTGTTGTGGCCTGGAAGCCACCTGCCAGTGATGGAGGTGCAAAGATTAGAAATTACTACCTTGAGAAGCGTGAGAAGAAGCAGAATAAATGGATTTCTGTGACAACAGAAGAAATTCGAGAAACTGTCTTTTCAGTGAAAAACCTTATTGAAGGTCTTGAATACGAGTTTCGTGTGAAATGTGAAAATCTAGGTGGGGAAAGTGAATGGAGTGAAATATCAGAACCCATCACTCCCAAATCTGATGTCCCAATTCAGGCACCACACTTTAAAGAGGAACTGAGAAATCTAAATGTCAGATATCAGAGCAATGCTACCTTGGTCTGCAAAGTGACTGGTCATCCAAAACCTATCGTCAAATGGTACAGACAAGGCAAAGAAATCATTGCAGATGGATTAAAATATAGGATTCAAGAATTTAAGGGTGGCTACCACCAGCTCATCATTGCAAGTGTCACAGATGATGATGCCACAGTTTACCAAGTCAGAGCTACCAACCAAGGGGGATCTGTGTCTGGCACTGCCTCCTTGGAAGTGGAAG
>TTN-211,ENSE00003808212,1,5609,2319713,2325321,TTCCAGCTAAGATACACTTACCTAAAACTCTTGAAGGCATGGGAGCAGTTCATGCTCTCCGAGGTGAAGTGGTCAGCATCAAGATTCCTTTCAGTGGCAAACCAGATCCTGTGATCACCTGGCAGAAAGGACAAGATCTCATTGACAATAATGGCCACTACCAAGTTATTGTCACAAGATCCTTCACATCACTTGTTTTCCCCAATGGGGTAGAGAGAAAAGATGCTGGTTTCTATGTGGTCTGTGCTAAAAACAGATTTGGAATTGATCAGAAGACAGTTGAACTGGATGTGGCTGATGTTCCTGACCCACCCAGAGGAGTCAAAGTTAGTGATGTCTCACGAGATTCTGTCAACTTAACATGGACTGAGCCAGCCTCTGATGGTGGCAGCAAAATCACCAACTACATTGTTGAAAAATGTGCAACTACTGCAGAAAGATGGCTCCGTGTAGGACAGGCCCGAGAAACACGTTATACCGTGATCAACTTATTTGGAAAAACAAGTTACCAGTTCCGGGTAATAGCTGAAAATAAATTTGGTCTGAGCAAGCCTTCAGAGCCTTCAGAACCAACCATAACCAAAGAAGATAAGACCAGAGCTATGAACTATGATGAAGAGGTAGATGAAACCAGGGAAGTCTCCATGACTAAAGCATCTCACTCTTCAACCAAGGAACTCTATGAGAAATATATGATTGCTGAAGATCTTGGGCGTGGTGAGTTTGGAATTGTCCATCGTTGTGTTGAAACATCCTCAAAGAAGACATACATGGCCAAATTTGTTAAAGTCAAAGGGACTGATCAGGTTTTGGTAAAGAAGGAAATTTCCATTCTGAATATTGCTAGGCATAGAAACATCTTACACCTCCATGAATCATTTGAAAGCATGGAAGAATTAGTTATGATCTTTGAGTTTATATCAGGACTTGACATATTTGAGCGCATTAACACAAGTGCTTTTGAACTTAATGAAAGAGAAATTGTAAGTTATGTTCACCAGGTCTGTGAAGCACTTCAGTTTTTACACAGTCATAATATTGGACACTTTGACATTAGACCAGAAAATATCATTTACCAAACCAGAAGAAGCTCTACCATTAAAATCATAGAATTTGGTCAAGCCCGTCAGCTGAAACCAGGGGACAACTTCAGGCTTCTATTCACTGCCCCAGAATACTATGCACCTGAAGTCCACCAGCATGATGTTGTCAGCACAGCCACAGACATGTGGTCACTTGGAACACTGGTATATGTGCTATTGAGTGGTATCAACCCATTCCTGGCTGAAACTAACCAACAGATCATTGAGAATATCATGAATGCTGAATATACTTTCGATGAGGAAGCATTCAAAGAGATTAGCATTGAAGCCATGGATTTTGTTGACCGGTTGTTAGTGAAAGAGAGGAAATCTCGCATGACAGCATCGGAGGCTCTCCAGCACCCATGGTTGAAGCAGAAGATAGAAAGAGTCAGTACTAAAGTTATCAGAACATTAAAACACCGGCGTTATTACCACACCCTGATCAAGAAAGACCTCAACATGGTTGTGTCAGCAGCCCGGATCTCCTGTGGTGGTGCAATTCGATCTCAGAAGGGAGTGAGTGTTGCTAAAGTTAAAGTGGCATCCATTGAAATTGGCCCAGTTTCTGGGCAGATAATGCATGCAGTTGGTGAAGAAGGAGGACATGTCAAATATGTATGCAAAATTGAAAATTATGATCAGTCTACCCAAGTGACTTGGTACTTTGGCGTCCGACAGCTGGAGAACAGTGAGAAATACGAAATCACCTACGAAGATGGAGTGGCCATCCTCTATGTCAAAGACATTACCAAATTAGATGATGGTACCTACAGATGCAAAGTAGTCAATGACTATGGTGAAGACAGTTCTTATGCAGAGCTATTTGTTAAAGGTGTGAGAGAAGTCTATGACTATTACTGCCGTAGAACCATGAAGAAAATTAAGCGCAGAACAGACACAATGAGACTCCTGGAAAGGCCACCAGAATTTACCCTGCCTCTCTATAATAAGACAGCTTATGTAGGTGAAAATGTCCGGTTTGGAGTAACTATAACTGTCCACCCAGAGCCTCATGTAACATGGTATAAATCAGGTCAGAAAATCAAACCAGGTGACAATGACAAGAAGTACACATTTGAGTCAGACAAGGGTCTTTACCAATTAACAATCAACAGTGTCACTACAGATGATGACGCTGAATATACTGTTGTGGCAAGGAACAAATATGGTGAAGACAGCTGTAAAGCAAAGCTGACAGTAACCCTACACCCACCTCCAACAGATAGTACCTTAAGACCCATGTTCAAAAGGTTACTGGCAAATGCAGAATGCCAAGAAGGCCAAAGTGTCTGCTTTGAGATCAGAGTGTCTGGCATCCCCCCACCAACATTAAAATGGGAGAAAGATGGTCAGCCACTGTCCCTCGGGCCTAACATTGAAATTATCCATGAAGGCTTGGATTATTATGCTCTGCACATCAGGGACACTTTGCCTGAAGACACGGGTTATTATAGAGTCACAGCCACTAACACAGCTGGGTCCACCAGCTGCCAGGCTCACCTACAAGTGGAACGCCTGAGGTACAAGAAACAGGAATTCAAGAGTAAGGAGGAGCATGAGCGACACGTACAAAAACAAATTGACAAAACCCTCAGAATGGCTGAAATTCTTTCTGGAACTGAAAGTGTACCACTGACACAGGTAGCTAAAGAGGCTCTGAGAGAAGCTGCTGTCCTTTATAAACCGGCTGTAAGCACCAAGACTGTAAAAGGGGAATTCAGACTTGAGATAGAAGAAAAGAAGGAGGAGAGAAAACTCCGGATGCCTTATGATGTACCAGAGCCACGCAAGTATAAGCAGACTACCATAGAAGAAGACCAACGCATCAAGCAGTTCGTGCCCATGTCTGACATGAAGTGGTATAAAAAGATACGTGATCAGTATGAAATGCCTGGGAAACTTGACAGAGTTGTACAGAAACGACCCAAGCGCATCCGCCTTTCAAGATGGGAACAGTTCTATGTGATGCCTCTTCCACGCATTACAGATCAATACAGACCTAAATGGCGTATTCCTAAACTGTCCCAAGATGATCTTGAGATAGTGAGACCAGCCCGCCGGCGTACACCTTCTCCTGATTATGACTTTTACTACCGACCTAGAAGACGTTCTCTTGGGGACATCTCTGATGAAGAATTACTCCTCCCCATTGATGACTACTTAGCAATGAAAAGAACAGAGGAAGAGAGGCTGCGTCTTGAAGAAGAGCTTGAGTTAGGTTTTTCAGCTTCACCCCCAAGTCGAAGCCCTCCACACTTTGAGCTTTCTAGCCTACGTTACTCTTCACCACAAGCTCATGTCAAGGTGGAGGAAACAAGAAAAGACTTCAGGTATTCAACCTATCACATCCCAACGAAGGCTGAAGCTAGTACAAGTTATGCAGAACTGAGGGAACGGCATGCCCAGGCTGCGTACAGACAGCCAAAGCAACGGCAAAGAATCATGGCTGAGAGGGAGGATGAAGAGTTGCTTCGCCCAGTTACGACCACCCAGCATCTCTCAGAATACAAAAGCGAACTTGACTTCATGTCAAAGGAGGAAAAGTCTAGAAAGAAATCAAGGCGACAAAGAGAAGTGACAGAAATAACAGAAATTGAGGAAGAATACGAAATCTCAAAACATGCTCAAAGAGAATCATCCTCATCTGCGTCTAGACTACTGAGACGACGGCGCTCCCTGTCTCCAACTTATATTGAGTTAATGAGGCCAGTGTCTGAGCTGATCCGGTCACGTCCACAACCGGCTGAGGAATACGAAGATGACACAGAAAGAAGGTCACCTACTCCAGAGAGAACTCGCCCACGATCCCCCAGCCCTGTGTCTAGTGAGAGATCACTCTCGAGATTTGAGAGGTCTGCAAGATTTGATATCTTTTCCAGGTATGAGTCCATGAAAGCTGCTTTAAAAACTCAGAAGACATCAGAAAGGAAGTATGAAGTTTTGAGTCAGCAGCCTTTCACACTGGACCATGCCCCTCGAATCACACTGAGAATGCGCTCGCACAGGGTACCATGTGGCCAAAATACACGTTTTATTTTAAATGTTCAGTCTAAGCCAACTGCCGAGGTTAAATGGTACCACAATGGTGTGGAACTCCAAGAAAGCAGTAAGATTCATTACACCAACACGAGTGGAGTCCTCACCCTGGAAATTCTGGACTGTCATACTGATGACAGTGGAACCTACCGTGCTGTGTGCACCAACTACAAGGGCGAAGCTTCTGACTATGCAACGTTGGACGTGACAGGAGGGGATTATACCACCTATGCTTCCCAACGCAGAGATGAAGAGGTCCCCAGATCTGTTTTCCCTGAGCTGACAAGAACAGAGGCGTATGCTGTTTCATCATTTAAGAAAACATCTGAGATGGAAGCTTCGTCTTCTGTCAGGGAAGTGAAATCACAGATGACGGAGACAAGGGAAAGTCTCTCCTCATATGAACACTCTGCATCTGCAGAAATGAAAAGTGCTGCATTAGAAGAAAAGTCACTGGAAGAAAAATCCACAACCAGAAAGATCAAGACGACTTTGGCAGCAAGAATTCTAACAAAGCCACGGTCCATGACCGTCTACGAGGGCGAGTCTGCAAGGTTTTCTTGTGACACCGATGGTGAGCCGGTACCAACTGTGACCTGGCTGCGTAAAGGACAAGTGCTAAGTACTTCTGCCCGCCACCAAGTGACCACCACAAAGTACAAATCAACCTTTGAGATCTCTTCAGTCCAGGCTTCCGATGAGGGCAATTACAGCGTGGTGGTAGAAAACAGTGAAGGGAAACAAGAAGCAGAGTTCACTCTGACTATTCAAAAGGCCAGGGTAACTGAAAAGGCTGTGACATCACCACCAAGAGTCAAATCCCCAGAGCCTCGGGTGAAATCCCCAGAAGCAGTTAAGTCTCCAAAACGAGTGAAATCTCCAGAACCTTCTCACCCGAAAGCCGTATCACCCACAGAGACAAAACCAACACCAACAGAGAAAGTTCAGCACCTCCCAGTCTCTGCCCCACCAAAGATTACTCAGTTCCTGAAAGCAGAAGCTTCTAAAGAGATTGCAAAACTGACCTGTGTGGTTGAAAGCAGTGTATTAAGGGCAAAAGAGGTCACCTGGTATAAAGATGGCAAGAAACTGAAGGAAAATGGGCATTTCCAGTTTCATTATTCAGCAGATGGTACCTATGAGCTCAAAATCAATAACCTCACTGAATCTGATCAAGGAGAATATGTTTGTGAGATTTCTGGTGAAGGTGGAACGTCTAAAACCAACTTACAATTTATGGGGCAAGCCTTTAAGAGTATCCATGAGAAGGTATCAAAAATATCAGAAACTAAGAAATCAGATCAGAAAACCACTGAGTCAACAGTAACCAGAAAAACTGAACCAAAAGCTCCTGAACCAATTTCCTCAAAACCAGTAATTGTTACTGGGTTGCAGGATACAACTGTTTCTTCAGACAGTGTTGCTAAATTTGCAGTTAAGGCTACTGGAGAACCCCGGCCAACTGCCATCTGGACAAAAGATGGAAAG
>TTN-211,ENSE00003811220,1,157,2325322,2325478,GCCATTACACAAGGAGGTAAATATAAACTCTCTGAAGACAAGGGAGGGTTCTTCTTAGAAATTCATAAGACTGATACTTCTGACAGTGGACTTTATACTTGTACAGTAAAAAATTCAGCTGGATCTGTGTCCTCTAGCTGCAAATTAACAATAAAAG
>TTN-211,ENSE00003801641,1,692,2325479,2326170,CTATAAAAGATACTGAGGCACAGAAAGTCTCTACACAAAAGACTTCTGAAATTACACCTCAGAAGAAAGCTGTTGTCCAAGAGGAAATTTCCCAAAAAGCCCTAAGGTCTGAAGAAATTAAGATGTCAGAGGCAAAATCTCAAGAAAAGTTAGCCCTCAAAGAGGAAGCTTCAAAGGTTCTGATTTCTGAAGAAGTCAAGAAATCAGCAGCAACCTCCCTGGAAAAATCCATTGTCCATGAGGAAATCACTAAAACATCACAGGCATCAGAAGAAGTCAGAACTCATGCTGAGATTAAAGCATTTTCTACTCAGATGAGCATAAACGAAGGTCAAAGACTGGTTTTAAAAGCCAACATTGCTGGTGCCACTGATGTGAAATGGGTACTGAATGGCGTAGAGCTTACCAACTCTGAGGAGTACCGATATGGTGTCTCAGGCAGCGATCAGACCCTAACCATCAAGCAAGCCAGTCACAGAGATGAAGGAATCCTCACCTGCATAAGCAAAACCAAGGAAGGAATCGTCAAGTGTCAGTATGATTTGACACTGAGCAAAGAACTCTCAGATGCTCCAGCCTTCATCTCACAGCCTAGATCTCAAAATATTAATGAAGGACAAAATGTTCTCTTTACTTGTGAAATCAGTGGCGAGCCATCCCCTGAAATCGAATGGTTTAAAAACAACCTGCCA
>TTN-211,ENSE00003801638,1,154,2326171,2326324,ATTTCTATTTCTTCAAATGTCAGCATAAGCCGCTCCAGAAATGTATACTCCCTTGAAATCCGAAATGCATCAGTCAGCGACAGTGGAAAGTACACAATTAAGGCCAAAAATTTCCGTGGCCAGTGTTCAGCTACAGCTTCCTTAATGGTCCTTC
>TTN-211,ENSE00003805382,1,303,2326325,2326627,CTCTAGTTGAAGAACCTTCCAGAGAGGTAGTATTGAGAACAAGTGGTGACACAAGCTTGCAAGGAAGCTTCTCGTCTCAGTCAGTCCAAATGTCTGCCTCCAAGCAGGAGGCCTCCTTCAGCAGTTTCAGCAGCAGCAGTGCTAGCAGCATGACTGAGATGAAATTTGCAAGCATGTCTGCCCAAAGCATGTCCTCCATGCAAGAGTCCTTTGTAGAAATGAGTTCCAGCAGCTTTATGGGAATATCTAATATGACACAACTGGAAAGCTCAACTAGTAAAATGCTTAAAGCAGGCATAAGAG
>TTN-211,ENSE00003809884,1,1319,2326628,2327946,GAATTCCGCCTAAAATTGAAGCTCTTCCATCTGATATCAGCATTGATGAAGGCAAAGTTCTAACAGTAGCCTGTGCTTTCACGGGTGAGCCTACCCCAGAAGTAACATGGTCCTGTGGTGGAAGAAAAATCCACAGTCAAGAACAGGGGAGGTTCCACATTGAAAACACAGATGACCTGACAACCCTGATCATCATGGACGTACAGAAACAAGATGGTGGACTTTATACCCTGAGTTTAGGGAATGAATTTGGATCTGACTCTGCCACTGTGAATATACATATTCGATCCATTTAAGAGGGCCTGTGCCCTTATACTCTACACTCATTCTTAACTTTTCGCAAACGTTTCACACGGACTAATCTTTCTGAACTGTAAATATTTAAAGAAAAAAAAGTAGTTTTGTATCAACCTAAATGAGTCAAAGTTCAAAAATATTCATTTCAATCTTTTCATAATTGTTGACCTAAGAATATAATACATTTGCTAGTGACATGTACATACTGTATATAGCCGGATTAACGGTTATAAAGTTTTGTACCATTTATTTTATGACATTTTACAATGTAAGTTTTGAAACTAACTGTTGGTAGGAGAAAGTTTCTTATGGAACGAATACCCTGCTCAACATTTAATCAATCTTTGTGCCTCAACATACTGTTGATGTCTAAGTATGCCTCAGTGGGTTGAGAAAATCCCCATTGAAGATGTCCTGTCCACCTAAAAGAGAATGATGCTGTGCATATCACTTGATATGTGCACCAATACCTACTGAATCAGAAATGTAAGGCATTGGTGATGTTTGCATTTACCCTCCTGTAAGCAACACTTTAACGTCTTACATTTTCTCTGATGATGTCACACAAAATTATCATGACAAATATTACCAGAGCAAAGTGTAACGGCCAACACTTTGTTCGCTCATTTTACGCTGTCTCTGACATAAGGAGTGCCTGAATAGCTTGGAAAAGTAACATCTCCTGGCCATCCCTTCATTTAACCAAGCTATTCAAGTATTCCTATGCCAGAGCAGTGCCAACTCTTGGAGGTCCCAGAGTGCAGCCAATGCCTTTGTGTGGTAGTTCTAAATTTTAATTGCACCTGAAAAACCTGGGCACCTAAGCAATGAGCCACAGCAAAAAGTAAAGAACAACAACAAAATAAAGCTGTTGTTAAATTTTAAACAATATTACTAATTGCCCAAAATGTCAATTTGATGTAGTTCTTTTCATGCAAGTATAAATTCAATTGTTAGTTATAATTGTTGGACCTCCTTGAGATAGTAACAACAAAATAAAGCAAGCTATCTGCACCTCAAAA
>TTN-211,,0,2556,2327947,2330502,GTGAGCAGCAACTTTTCTTATTTTAATAGTAGAGTCACTTTCTTATTGATCTCTGGCTCTGGATTATTTGTGTGTGCTAAATGCCTATGTACAAGTGTTTGTATGACTATTTCTTGCCAGTGCTGACCCATTATTTAAATCTGCTTGTTAAATTCTATTTTAAAATGTCTGAACATTTTTCCTTAAAAAGTTGAAAGCTTTATTATATCAGCTAAATGATTCCATGATTCAAATTGTTTAAGTTCACTTAATATTCTAAAAGTTGAGGTCTGAAATGTTGAGAGAAATGTTTACTTCTTTTCTAGACTCTCTTTGCCTGTTGAGAATGTTCAAGGTTATATTACTCAATGATAAAGTTAAGCACACCAAGAATAGCTCTGATAAAATGCATGTGGTATCAGCTACACCCTGATGACTTTTTAAGGGAATCAACTGCTGAGGTATCAGTTGCAGGACAGTGACAGAACACTTGCCTGCTGTCAGTCAACCTTGGAGAGTTTAGGAGAGTTTATTTTAAGAGCATGACATTTTAGACGCATACCTTCAGCCCCAGTTAGACAAAGGCCTGTGAAGAGCAAGTGCTAAGGCAATAAAATTTACCTAGACAATAGGAATGTAAGATCAATTTAAGCTGGTTAATTGCAACATAGTTGGAGATTTGGAATAAAATGATATAATTGTTTTCTAAAATATTCAGAATCTCTTCATGCATTTTAACTCAGCACACAGTCCAATTATATATTTTGAGATAAATGTTGACACTAAGAAGGGTAAGAAATAATGTTTAAAGGAAAGGTTTCTTACTTCTAAATACACTTTGATTTCTCATCTTCCTAGAATTTGATTACTAATTGTCAATGCCTGTAAATACATAGATATATAATTAGGTATTCTATGTCTAAGAGGACAGCTATTTTTAGATATACTAACTTATAAACAGACAAAGTTAGACACAGAAAGTTGTTCATCCCAAAGATAATATGCTACAAAAAGGAGTTTCTGACAAAAAAAATTTATGAAAGCTTTTGGATATTATCTGATTTTTCCAAATATAAATTTTATTGTCTCAGAGAATGCTGGTTTCATTTTTTTAACTAAGTAGAAGGTTACAGTAAGGAACAGAATTATCACTAAGAAGATTATTGCTCCATGAAGTTTTAGTAAACAAAGAATTTAATGAAAAATAGTAATGAAGTGATTGACAATTCAGAAATGTTCTATTTCAGAACAGAATAGTCATGTTGAATAATTAGGTATTTATGCATCAGAAAATTCTTCACATAATGTCTCTGAAACTGATAGGCAAAGTACTTTCTTGCACTTAACAAAATGACTTAACTGCAAATTTTATATTCGTTTCTTTGATGTTGAATATTTTACTTTATGAAAGCATAGGCCTTTTCACTTCATCTACATTTTACACCAGCCTTCCATTATTCAAAGTTTGCAAATTGTTCCATATTAAGAACTCAAGCCAGCATTTTTCTTTCAGAACTATAATAAACTTTGGCCTGTTCACTAAAATTTAAATTTTTCTGAATATTTACTTCAGCAGTAACAACATTTACTGCACAGTTACAGTATGAAGAAATGTTAAGAAATAGAAAGCACCGTATGCCGTCTACAAAAAGCTTGCATATTTGATAAGGCTTGCCAAAGCTTCTCCAGTCAGGAAAGAGATTACAAAGTTCAGATTTTTACTTCTGGCAACTATTTTAAGTAATCAGATAATGTCTGAATCAATGTCAACTTTATAAATATAGAGTGAACGAAAAATATTGGGGAGAAGGAAAATTTTTAAAATAATTTTCACTTACTAAGCTGATGCAGAGGTTTATTTATTTTAATTTTTTTTTTTTTTTTTTTTTGAGACAGAGTCTCATTCTGTCACCCAGGCTGGAGTGTGGTGGCACCATCTTTGCTCACTGCAACCTCCACCTCCTGGGTTTAAGCAATTCTCATGCCTCAGCCTCCCAAGTAGCTGGGACTACAGACATGGGCCACCACGCCTGGCTAATTTTTGTATTTGTAGTAGAGACAGGGGTTTCACCATGTTAGCCAAACTGGTCTCAAACTCCTGACCTCAAGTAATCCTCCCGCCTCGGCCTCCTAAAGTGCTGGGATTACCAGCATGAGCCACCACGCCAGGCCCAGAGGTTTATTTTACATTTATCACATGTCTTGTCTCTCTAATTACACTTCACTAACCCTGCATTGCTGTGGTTTTCTTCTTCAACTCTGAACCTGGTTTTCCACCATTGGTAAGACTGTATATTCCCTCTTTGACCACTAGGGTTCATTCCTTGTTCTGTTTGGCTAATACTTTTTTCCATTTCCCCTTACACTTGCTACTTTGGGTTAGGCTTTAAGTCAACTCAATGATGAACTATGCAAAACTGTTCAAGCCACAAAAGAGAAGACCTGCCCATCACTCTAGGCCCACAGATGACCTATGGAGCAATCCATTTGGAGAAACGTGTGTCTCTGCTATCTGCAAAGCAGCTCCAGAGTGACCCTTAGCTGGGACACCCTAATTTATTTTCTCTTCTTTTTCAG
>TTN-211,,0,2210,2330503,2332712,GTAAGCTCACACATTCACACTTTTGTTTTTTTTTCCTTTGCCTCCTCTCCAGTAAGTTAACGTTGCTGCAGGACTTGACGCCAAGTTTAAGCCCTGCTTTCACTTCGGAAAATTAGTCCAACACTATGGAAAGGTCATTTTAAGGGTATACCATTCACAGAGTACTGACAAAATCTGACAATATAATGGCTTGAAATGTTTTATTCATATTTATTATTCCACAAAGCAAAAATAATTAGTGTTGGATTAAAATTGCCGTTAGAATCCAGCAACTAAATAGGACCAAATTTAGTCATTCTATATTTGGGCTCAGCTGCAGAGCCAGACTGGAAGCCAAGAACTCAAGCCCAATAGAAGCCAGCCACAGAGCCATGGGGTAGGCAGTCTGGGCTGCCTGCTCTGGACACCTGAACTTCAGTTGGTTCACACGCAAAATAACAGTGCATCTAATTTTCCTCAGAGGCAGAGCTGTTCAGTAATTAACCAACTCCTCATTATTTTATTATTTTATTTTCAATCTTTATTGAGTGATTCTAATGAATTAAAAGACTTTCCAATCGTTTTGAAATGACAGAAAATAATATGCTTCTCGGGTGTCTCTATTTAAAAGGAAGCAAACACTAACCCTAGAATTTTATCTGAAAGGAAGTTCATCTCTTTTTTGCCTTCTTTTTCTTCCTCATAACTCAGTTTATGGATGGTTCAAAAAAATGCATGGTATCATCTTATGAAAAAATGGAGAGTAGTGTATGAACTATATTGTAAATAATTTTAAAATTAATCAATATTTTCTCTTTCTGTAGTATTGTAACGAGCCATGTAAGATGGATACGGATTAAAAAAAATCATGCTTAATTCTTAATTTAGTGCACTTCCATGGTTCATTGCCCACTTCTTTTTTAAAATTTTATGGCTTATAATAAAGATATAAAATAAAATTTCTTTTTTTCTCTTTTTTTCTATTATATGCACCAATCTTATTCATAACTGGATAATACTTTCTTTTACATTGTACAAATATCATATAATCATTGCTTATTTTCTATTGTACATATATAGACCAATGAAATTCCCTTTTCATTGGTCTATATATGTACAATAGAAAATAAGTCTTACCGACTTCCAAATAATTTACCTATTTATCTGGTAACACTCAGTAACTTCTGAACTGAGCAGAACACATATGACTTCAGTGGGAATTTGCCTCCTTGAGAAGTAGTGGAATCTGGCTACTTCATATCTTCTTGTTCCTTCAAACTATATGCAAATAAATTATTACAAAGACACTACTGAAAATATCCAATACCCATAAATCAGTCCAATAAACTATTTAATTGGCCATAGTGGGAGATGGGCTAATGTATAAACAACAAAATAGACTTTCTCTAGATTATCTTTACCTACCAGCGTAAGTAGATAGAGCATCAACCTTTATGCCAAGTGTGAAATAAATCATGCCCTGAATGTGCCTCGTACATTCTCAATGTACAGAGTTTTAATATATTTAAAACATCAAACCATGGACATGTAGTTCTTGGCTCTACAATTTATGGCAGATAAAGAGAATTTGGCTTTCTACCTGCAATTCCAATGATCCATGTTGTTCTGGAAGACTAGGTTTGGATTAGTCTCTTATGAGAAATTGCTTGTCCATGTTACAATGTTTTTACTGATTGCACTTGTGAAAGCAGAAGAGTCCAAGAAGACAGTGTCCCTGTAACCACAGAGGAGGGAGGAGGGCATGCCTCCTGGGCTTGTCAGGCAGAAACTGGAGATCAGTTTGCTGCTTTTGTTCTTCACTTGCTCTCAAAGAGGACAACAATCACTCTTTATTTCAAATTTTCCTTGGTTCTTCATTTTTATAAGTCCCTTTCATGATTTTAATGTTGTCTATTAAATTGCATCAGATAGAGCCCTAGGCAGGCAGGCAGGAGATGGAAATTCTAGTCCCCTCTGTGTCACTGCTAGCTGAAGGACCTTGGAAAAATCATTAGGCCTCTTTTGGTCTCAGTTTCCTCCCTTCCTGCCTTCCTAATGGTCTGCAGGTTTACACACTGATCATGCAACTGTAGGGTTTTCCCTATCATTAAGTGGCATTCCATGCTGGAAAGCTTTTACAGATTCGGACAAGGCAGTGAACATGATGGGACAGAGCAGAGGACTTTGTGGTGCCCATTCAAACATAAAGGTGAATTGTTCTTGCTCTTCAG
>TTN-211,,0,1455,2332713,2334167,GTAGGCTGCTGGGGACCTGCCAATCCTCTGCTCCCCCAGAGGACATCTCCAGCAAATTGGGAAAGGAGTCCAGAAAAAGCTATGGGCAGAGGTAGATGCAGCTCTTAAACTACAGAAGGGTCTACTGGAGGCTGAATTATTTATAACCAAGTTGTTTGCCTTTTGGAATTTAATTTTCCTCTAGAGTACATCGTAAAAGTGACTGAGAATCAGTTTCTCAATACACATATTAAACACTCAAAAGTATGTTAAGGAAATATTAAAAATCATGTTTCTCAGCAAGTAGAAAAGCTTGGAGCCTTGTTTATAAGTCCTTTAAGGAATAAGACATATTCTCCAGGGAAGTGTGAATCTCCAGGAATTCACACTTTAACAAGCATCCAGATAATTCTGATGCCGGTAGTCTACAGACCACCCATTTAAGAGGCATGTAAACATACCCAGAAGAAAATAAATGCTTGTTTATTATTCAAATGCATGACACTGTTTCCCCAGAAAACTTATCACCAATCTTAGTGGCCTCTGTTGTTTTTCTCTATCCTTTACTACCTAGTGAGACATTAGTATACAGAATATTGCATGCCTTTACATGTTTTATAACAATATCTTACATGAGCTACGTAAAGTTACATATGCTTATCCAATAAACTTTACCTTCAATGATGTTCAATTATAGGGCTATAATTGACCTAAGCAGAAACCACATCAAGTAACATCAGGTAGAACTTTAGCATGCACCCAGAAAATTCACAAATGGAAAATGCACAGGGTTGGCAGCACCTGCTGTTGTTTATTACTCAAAATCATGTCAAAGTTAATTCCACTCACTCCTCACACTTATAAAAAATTTCCTTCAACATAACCAAAAAAATCCCCTTTCTGTAACACAATTAAAATGAAGTAATGTTATTATTGGGATTAACGTTTTAAATGCAAGTAAATATTTGGGTTATTTGAATACCTATCAAGTTGGAGAAGGTTTAGAATTTTAAAAATTAAATTAAAAATGTAATGATTCTTTAAGTAACAGGTACACCCATCGTAGCAACCACTGGAATTCATTTTAATGCAACTTACTGGAATATGCAACATGGCTTTCACATATTAATAGAGCGCTAGATGTGAGGTAGAGGGGGAAGTACCAGAAAGATTCTCAAGAAATGTTATAACAAAATCTAGAGCTTTTATTTAAAACAAAGAAACAAAAGGTGGTGGCCTAAACTGCTCAGCAAAACAAAGCAAATAAAATAAAATATGGTGGTGAGAAAGCCTTCTGTAATCTCCTGGCTCCCATTCTTGCTGTCATTGCTGGGTGAGCTGGGTTCAAGGACATTCAAGGATGTTTAGATTGGCGAGTCATCACCTGGTTTTGGAATTGGAGCTGTGATTATTTAAAAATACCTTGTAGGGAGCACCCTGGCTCTCACTCTTGACTTTGTTCTCTTGTCCCCGCAG
>TTN-211,,0,484,2334168,2334651,GTACGTGCTGGAGGTTGAGGAACAGAGAGAAGGGGAGAGAGCTGGTTTGTGTCTAAATGGGGCCAAGCGTCCACTTGCCACCTCTCACAGCCCTGGGAAGAATGCTGTGAGCTGATATAAAAGCTGGCTTTTCGACACCCATGAAAAGTCCCTGAGATTCTAGTCAGGAGCGCAGAATAGAAGCAATCTGTGCTTATGAATCTCATTATAAACTGGAAAGGGTTTCAATTAAGTGATCTACATTTCCAAATTATTGGCAAATAATGAAATTTTAAAAAATCATTCTAAGTAAATTTTTATCTTGTAATGAACATTTTCTATTTTTAAACCTAATTTATATTCATGCAAAATCCAAAACTTTCTGCAATTTTCTCCATTGGGATATCCAGAAAATCTTTTTGACTTTGTAGTCAGAATTAACAGAATCTCTTTTAAAATGGGTCATTGTGCCCCCTCCCAAACATTCATCTTTCCCTTCCCACAG
>TTN-211,,0,93,2334652,2334744,GTATTTTTCTATACTGTTGGTTTTCAAGCCTTTCAGGCTGTTGCGTCCCCAGCTATTCCTCCTCAACGTGGGCTTTGTTTTAATCTTTTACAG
>TTN-211,,0,4234,2334745,2338978,GTAAAGCTGCCATAGAGAGAGCAGATTATTGCACATTTTGGAACTAGGTTTTGAAACGAGAAAGATTCCCTTGTCCCCCTCGCAGGGCATGCGACGCGGAGAGTGGTTCGCTTCTTCAGTGTCCCGCTGCTCAAACCTCTAGGGGAGCATACAAACGGGCAGGTTGTGGGGCTCCGTGTTCCTCTGGACATCCAGCCGCTTGTGTGTCTGCCTACTAGGGTCTCAGGGGTTTTTATAGGCATAGGGTGTGGGCGTGGCAGGTCAGGGTGATCTTGGGAAATGCAACATTTGGGCGGGAAGGCAGGAGTGTTTGTCCTCACCTAGGTCCATGGGCACAGGCCTCGCTAGGGACCACGCACTTCTCTTCCCAGCACTTCCCTGCCCTCCTCCCGTGTAAGTTTCATGCACTCAAAAATGTAGCAGGTGACAAAGGAGGTAAACCAAGAAGTTACTGAATATGATTTTCACAAATCCTCACTGTCCACAGGTAAATTGAAGACCCTTATAAACTTCTGAATTCTTATTTATATTTCATGTAATAAATATCTACTTTAGGGGCCAAAATATGGCACAGTGAAAGGAGAAGAGCACAGAAGTTAGAGTTCAAAGCCCTAAGGACAAATCAGCCTGATCACTTAACAGTTTGATTTAGGGCAATAAGTATAAATAATAAAATAATTGTTATTATATATGGATCACTTCCTCTATCAGATTGGAACTATACATACATTATCTCATTAAATGTTCACAACCTGTAAGAATTATTATCCTCAATGTTATTGATAGGTAACTGGAATTAAAGAAGTTAAGCAGTTTATTTAAGGTTTCAGTTGTGTCATCTGTAAATTAAAGAGAGTCACAATAAGAATGATCTCAAGCTGCATTTTGGGGCTTCAATGAGATAATTAGTTGAAAGTGCCTTGTAAATAGAAAATAATTATGCCAATATTCTTATATTCAGATGGTAAGTAAAACCTTTTAAATATTTTGCATATGCTTGTGTTATTTTATCTAGAAAATAAAATGGACTTCTATGCTTACTTAATATGGAAGTATTTTAGAAGGTGATCATGTATCATGATCAGGGCTCAGAAATTATATAATCAAGTGTAAATTGTCCACAACAGTTTTGAAAGTTTGGGATTTAGTTTATCATGATGAAACTTTTAATATGATGAAATGAAAAATGTACAAAATTTGAGCAAAGAAGTGTTTATTGATCAATTTAAATGAAATAAAAAACACATGGATGTTCCCTGCCAAGAAAATTTTTTATAAAAGAATAATAAGGAGATAGTTGACCTAAATAATATTCAAACATACTGTAAAGTTACTATAATCAGAACAGTATGGTATTGGTAAATGAATAGAAAAATACACCAGGGGAACAAAACAGAGAGTCCAGAAAGAGATCCAAGTATAATAGATCCAAGTATATAGGGAATTCAAAAAGCAAAGTGGCCTTTCAATTCAGGGGAGGGAGAGGTATTTTAATAAAGAATGCTGGTCCAATTAGCTATCCATCTGGAAGCAAACAAACATAAACCTCTGCCTCTCACTATTTACAGAATAAATTTCAGCTTGATTAAATAGTTAAAAAATGAAAAAAAAAGAGAAGACAATCTGCAAAAGCATTTATGGGTGAAAGCTTTTAAAAAGACAGTTACAGATTCAACTACATAAAAATCAACATGTATGTATGGCAAAAGCAAAAAGTCATTTCTAAACCAAACAGCACTTGTGAAAAAATTTTAAGACCTTTCTCCTCCTCAAGGTACTTCATTGCCTCTGCCATAAAAGTATCACAATAAACATAAAATGGCTACAAGGTAGACAACACCAGCCTAGAAACAGTATATAACATACAAAATTACGTAAGCTTATGCTGGATAAGACCCATAAACAAGCAAAATATTGAAATGGATTAAAAGAAATGGATCTGGGGGAATGTTTGCAACACTTACGACAAATAACCAATAAATGCACTAAATGCATTAAAAATCATCCACAAATTAATTTTTAAAGGAAAAAAATGCAACACAAAAAAAGACAAAAGATACAAAAAAGTATTTAACATAAGAGGCAATGTAAAAGTCCAATAAACATGTGAAAAAAAATGCTAGATGTTTTCCAATTTTTATTGTTTTAGCCACAAAAATGTAAAGATATTGGCAAACACTAACATGAAACCTTGAACAAAAAGCTTACTTTAAAAAACATGTCTAGCAGTCGAATAAAAAAAAATGTTCAGTCTCAGGCTAAATCCAAGTTTGCACACCATGAAATCACAACACAAGCCAAATGCAATTTCTTGAGGAGATAACAACCTAACTATATTTTAAAACCCAAGCCTAAGGGTCATTTAGAATCATGGAGTGTCCCTGATCCCATGGAGCATTTTGACCATCTTAGCAGTTTTGAAAGTTCATTAATAACCATCCAAATTGCCCCAAAATTTTGCTTTCCAATAATTAAGAAATAAAATGCCAATTTGCAGAGAAAATAATGGTTATCAAAGATAGACTGCTTCCTAAATATCTCATAGTTTAATCTTGATTTTTGTTGTAGAGTAAGGCAAACATATTTCATTGAATAAGGTGCATTGTATCTCGCTGTGACCAGGTGATTATTTTTTGTTGTAAGTACAGAAATAAGCACTCTCCTATAATGACCAAAATTACAATGATTTTCACAGTTATGGGCTTACCTGTGTCCTGCTGTTAATCAGTCATGTCATGCTAATCATGTCTTTAACTCTTTTTGAATTAAACCCATTTACTAAGTACAGCAAGAACAAGGCACAGGGTGAAACTTAAAAGCACATGTCTCTTTGCTTTTCTTCAGTTAGTGGAAACCACACATTATTCTAACTTGGTTTTTGTTATATTTCAAAGGCAGTCATGTTCAGAAAAGAGGCTTATTCCCTAGATTTCCCTTTAGTTTGATTACAACTTCATTTACAAAATGTAAATGGATTTTCACACAAAAAAAGCCATTCTTCGAGAAAATAAACATTTCTTCGTGAAACTGGTTAATGTTGTAATGTACTGTTAGGGTACTCTGTAAGTTAGAGAAAATATCAACTGTACCTTGAGCTTAATTAGAATAATCATTTCATGTATGATCAGTGTAAGCTAAATATCCTAGATAGTGACAAGATGCATTTATAAACATTTTCTTATATGCAGAATTAATAAAATGCAATGATAGGGCAATACTGCCACCTAGAGAGGAAAATGTAATAAGCCTTATTAAGAATTAAATCAGTTCTGAAAAAAATTTTACCTTACAATAGTTGGCCAATCCCCAGAATTATTGCTATAGATCAGAAATAGTCTTTTTTGGCCATCAGTGCTGGGATTTAGCACCCAAATTCTTCAACTGATGCTACTTGCACTTTGGATACACCTAAAAAGCAAACAATGAAAACTATTCTGGAAGAAGCAACTTTATCAATTTACCCAAAAATCACAGAATCATTAGTTTTTAAGTTAGTCAATTCCCACAATAACTCTAAAGATATTTAAAATAAGTCCAGAGTGCAATACAAGGGGGGCGAGTGTAAACAAATATGGAGGAAATTAAAAGTAGCTGTCCACAAACACTTCGGCTAAAGCAGCAATTTGCAAAGTGCACTGCACAACCTGTACCCAGCAACATGCTGCAGAAAGCTTCCTGAGGATGTGTCCCCCTGTCCTGGAAATTCACAAGGCATACTGACATAGTAAAGGCTGTGGGAAGTCCTGCAGGGGAAAAAAAAAAATGGCTTAAGCTGCTTAGTCAAGAGTGGCACAAGCATTTTGATTACAGAAACCTTTCTTCTTATAACACCTATTTGACATCCTCTAACCCCCCCAGAATTGGAATACAGAGATGAATTTGGAATACAGAGGTTGCTGGATTTGACATGTCTTTCCTTTGGCTGCATATTAAAGAAGTAGCTTTTTCTGTTGTGATTTTTTTTTTTTTTTAATGTGAGAAGGTGCAAGGCACAAAATCTCCAGCTTATTTGGAATTAAAGCTGATTCTCTTACAGGGTTACAGCAGATAAGAATAGGTTTATTGAGATTTAAAACAAATTACTTCCAAGTACATTATTTACCCTCTGAATGGGTTATGGAGGCACACATTTTAAAACTCTGCCTTAAAGCACTTCCAGCTTTTCATCTCATGATTCACATCCAGTTACCCCTCCTTGCTTTGACATTCTTGACCTCTGCCTTTTGGTTTTCAG
>TTN-211,,0,370,2338979,2339348,GTACTGTCAGAATGGTTTTGTTTTTCCTTATTTCACATTCTAGTTTCTCCAACTGGATTTCTGCCATGAAACTCAGTCTGTATAAATTGGAGGAAAAATGCATATGAACATAAAAATATAGCAGCAACTGAAGACCAAATTCAGTAGTCATGCTTTGTAAAACCATTTTTAATTAGGACAAAAGCTCCAATCTGTGAAGTTTCCATAATATACAGGTTTTAATGATACAGTCTCTGTATTTCTTGGCAATAATAAATGCTTATGTATGAGTGTATTTTGCTCTAGGTGGCTCAGTTTTCCAGTATGCTTTTTTATTTTCTACTGGGCATGTCATTTAAAAAAGTAATCTACTTGGTCATTTCTAATCTAG
>TTN-211,,0,857,2339349,2340205,GTACGTGCGAGGCTGCCATGGGGCACCCGCAGAGCCACGTCCTTCAGTGCACATTAACTCAACCACCATCCACTGAGCTTGGCATGCAGCTGTGCTCAATTCATTCTGAAGACAGCCTTGAGCCCAGCAGGGCCCAGACTTTTAGAACTTTCTGAGCAAAAGGTGGTCGGAGATGTCAAAGGTGTTGACAATGTGAGTATCACAAGAGCAGAGTAGGCCAGAAATACCTGGGCTATATGAGCAGGCAAAAGTCAACTATGGTATTCAAGGTAGGAAGGCAAAGAGTGGCCAGAGAAACAGAGACCAGTCAATTCCAGAGCTCAGTCACTGCACACACTGGATGTGGAAACTACTATTTCAGGGAAGGCATTACATTTCTCTAAGTTTCCCCAAAGGACTTTTGTTTTTACTTTTCTCAAAACAAACATGACACTTGATTCATAGCTGGAACAGTGTCATAAATCCAGGATAATGTCCCACCTCGCATTTGAATAGATTTTCTGTTACAGTTTAAAATCATTCCAGCTTTCCTCCTTATCCTCTTGTGTGACATTTATGTCTAAATCCTGACAGATTATTGTAACTTTTTTTTCTTTTCTGAGACAGAGTCTCGCTCTGTCACCCAGGCTAGAGTGCAGTGGCATGACCTCCGCTCACTGCAGCCTCCGCCTCCTGGGTTTAAGTGATTCTTGTGCCTCAGTCTCGTGAGTAGCTGGGATTACAGGTGTGCGCCACCACACCCAGCTAATTTTTGTATTTTTTAGTAGAGGATTTCACCATGTTGGCGAGGCTGGTCTTGAACTAATTTTTATGTAAGATGCATTAAGGTGTTTTCTTCCTTTCTCTATGAAAAGCAG
>TTN-211,,0,1206,2340206,2341411,GTGAAAATGGGTTTGTATTTTAAATTCACTGAGGTTCTTACAGGGGTCAACACAGATAATCACCTTTACCATGAAGAGTGTTGTTCCTTGGGCCACATGGTTGTTAGCATACTAATAAGATCCCCTTGTTGTATGTGTAAATTTCTGGGTACTGGATACCAAAGTTTGGTAGTGTCCCTGAATGCTCCCCTTGTGAGTATGAAAAAGAACTCTGTGAACATACACCAGGAGTAGAAACAGGGGTCTCATCACATTGATCTGGGGATGCACTAAGTATAAGACTATAGGGAGAGGACAGATGGCTAAAACCAGGAGGAAGAAATAGATGCTGAGGCAGGAATGGGGAAAAGTGGAGGAGACACTGAACTCACTTTGCTTTAGAAATCTTAGCAACTGCTTCCTGGCTCCTTCGGAAGACATTTGCACATGAGTTTGAAGTGGAATGGACAGCATGGCTTTAACAAGCCAAATGACCAGAAAAGGTGAAAAGGACAGCCCCATGGTTGGCGGCATTTGGGGACAGATTGGAAAATGCCAGTTAGTAGAGCTCTTGGCCAGTGGAACCAGTTGGCAGTTGGGTGGTTTGAGAAGATGAATTTCAAGTCCCTTTCAGCCTTGAGATCCTGTGTTTCAGTGATGAGATATTTGAGAATGGCAAAGAGGCAAATAGAGAAAACTGTCCCCCTACATACGCATATACCTTAGGTGCCCAGATGGAAACAGCATTCTTCACAGTATTTAGGAAAACTGACAAAACAAAAATATTGTATAAATGCAGATTATAAATTATCCATGCTTGATTTCTCACATGTAAAATAAAAAGATCAGACAAAATTACTTCTAAAGTCTTCCATTCTGATATATATTCTAAGATTACCTTTAGATGACAGAATTAGTACAGAATAATATTGCCATAGATCTATTTGTAAACATTGGAAGTCATTTTAAAGAAGACTACAATTCTGCTGTTCAAAACAAAGTGTTGAATTCAACTTTGTTTTCTCTAAGCAGCCTACATAATTTACAGTTTAAGGAGAGAAAGAGCATGATCTTATTTATGAACATGGGATTATTTATTTTATTTAGTGACATCTGCAGAAAAGGGATTTTACATCTTCAAATTCCTATGTTGTTATATTTAATAAACACCATATTATTTCATTGGGCATCAGGAAATAAAGTTTTTTCTTAAATCATTCTTTGCAG
>TTN-211,,0,1956,2341412,2343367,GTAAGTCTGATTTTCTAAATATTTTGTAGTTTGTTGACAATATCACATTACAGCCAGCTGCAGGTAGCTTATAGTCAAAACCCTTAAATGGAGAAGTCTTTGGTTGTATATTTTTTGTTATTGTTCCTCTATGTCTAGTATTGAAACTCAGGATGGAAATTATGTTCACATTGCACTATTTTCCACTCACTTGATCAGTTTTCAGGAGATTGTCTACAGAACAGTTTAGGGCACATCTATGAACTTTCTAGAACATACATAAATGGATGATAGATATCATGCCAGTCCAGTTACCCACCGGGACAGTTGGTTTCTTCGTGCATAGCCTAAGCCCTCAGTCACTTAGATTGTAATGCACAAACTTTACATGCACACACACATGCACACACACACACACACACACACACATATACACATACATCAGCCATAAACACCCCGAATAAATAGCAAGGGAAAGTGAGGATATGCCAGACATCGGAGAAAGCAAATACTTCCTCAAAAAAAAAAATTCCTTCAATTCACGGTTGATAAACAGTGACCTAGAAGCATTTGCTGCTGTTGTGCCGTAGAGCTGTGTGAGGACAATCTCAGTGTCACTAAAATCCACATCTCTCCCGTATGTGAAATCAAACCTTTAAGTGTCAGGAGAGAGGCATTTATCTTGAATTCTTCCATGTCAAAGAGGGCGCCTGTGCTCATCCTCCTTGAACTCAAGCTCTTTGCTGATCTTAGAGCTACTTTCTTTAAAGGTCCAGTTGAGAACCTTGTACACTTAAAAGGCTGACCAGAGGCTGCTGACTGAATTTCCCTCTCCTTACTGTGAGTGAGACATTTTGAAAGCAGCAAGAACCCTACTTAGGATAATCAAAGGCATAGAAATCCCCATTGCCATTGCAATGCTGGTGACTGGCAAGTTCAGCTGGCCTATGGTTTTCCAGCCACTTGTCAGCAGCCACCCACCGGGTTCCCTAACACGTTGACATGTCTCAAGATGAGATATGTTCAGTTCTAGGACAATTTGCTAAGGCGCATGTGGGCAGAAAAGAAGCCCATTCCTCAGGAAAGCAGTCTATGTATTAAGCACAAGTGTAGGCCCCTGAAATGGAAATCTGACATTTTATCGTTCACCACTAAGCATCCTGTATTTTCCTGAGTGTTTCAAGGATGTCTTCCCATTGCTTTTGTATCTTTTGAAACTCAAATCTTTATTTTACTCTAAACATCAGATAAGACAGGAAACTGAGATAACTGCTGCATCCATGGTGGTAGTTGCCACTGCAAAGTCCACAAAACTAGAAACAGTCCCGGGAGCTCAAGAAGAAACTACCACACAACAAGATCAAATGCACCTAAGTTATGAAAAGGTGATGACTTCCTGCCAATGTGAAAGTCACTCTTGCACCATTTCATTTGCAAATCACCTACATTTTCATCATGGATCTTAATCATCACTTCTTCACTTCCACCTCTTCTTATAATGCAAATAGAAAATTTCTTTTCCCACACAGCTACCTTTCACTGTCAATTCATTCCTAACTTTCAGACTTTCTTTGGCTTGTTACTAATATAATATAATAATTCACTTTAATATCTTCCTATTGAAGCAGATGTCCGTAAACAAGTCAATTCATAATACAAAAAATTATGTGCTATTTACAGTGCTACTGAAATGTCTCAGAGATTGCAGTTTTAAAAAATGTGAAAAGTACAAAATAGCACTCATTAGTCTTTTATTGCTAATCACATTTTTTTCTTTTAAACTGGACTTATTGTTTTGATATTTTTGCCAGTGAAACAGTATGGATGATCAAAGTAACTCAAATGATATATTTTAGTGCAATTAAAATTTCCTTGAATAGGAAGAAATTTTGCCTCCTTTCTTTTTGACTTACGTTTCTTTTATTAAAGATTTATGGAATTTAATGACTATTTTCTTACTTTCTTTTGTATGATCAG
>TTN-211,,0,480,2343368,2343847,GTGAATACAGATATTTGAGCTGTGAAAAGTTCATCTTTAAACTAATTTCTAGTAAACTATTAACTACAATATGGTATGAATTATTAATCTGTATTTGCCTTTTAAAATCCCTAACTAAAAACAAAATGGTAAATATGAGACTGATTATCATTAATTTTATCTGCACATTTGATTTTCATCCATCTGTAACATTTATAATTCATTTTATTCACCATTATTCTTTGCATGAAGATTAGCATTTTTTAGCTTAATTTTTAAAAAGTGACACAGGGACTCATCTAGAGGTTTTTTAATAGCTAACATTTCTAAGTTTTGTGATTCTCAGTCAGTATATGTAGACATTGCCGGTGAAAGTTTATTTCTCTTGTGTATTTAACCCTGAATAACCATCTTGCATCCCCATGAGGAAGGGGGAAGGGTCATACTATGTGTGTTTGAAGCCCTGTTCAACTTAAATCTTGATTTTACTGTAATAATCAG
>TTN-211,,0,3218,2343848,2347065,GTGACTATTGTTGTTCCAAGTGTGAAATCCCCTATTATAATACATTAATACCACATATCATGTGAAATTCCTTATTGTAATACATTAATATCAAGTCTCTGAATTTCTTATGTATGAGTCACTATTAACCAAATTTATTTTTTAGACAATTAAATAATTGGAAACTAAAAAAATTTATTATTGTTAATATTACTACATATCCCTTTCTCCACTTATCTCTTCACCATTATTGTCAACATTTTATTAACATCTGGGAATCTTCCAGAAGTTGATTAAAATTGCATGCAGGCTAATTTTAAGAGGCCCATGAACATTTTTTAAAAACACGGAAGATGTATAAGTAAATGATGACTCTTACTCACTGTCAAGAAGATGTGTGTTTTGAAGGGTCATAAATTCAGTATATTATGTTATGGAGTATGACTTATTTCAGTAAATTACCCATAATTTTCTTTGTATGAAACTTTATCTTTTTTCCCTCCTGTAAATATCAGAGGAGAAGATAAGCTGAAAAAATTATAATGCATGCTGTAGCAGCTCCCACTAAAGCTAAACAAGATGCATATTAAAATCTAGAGAAGGAAGTATCCAAACAGAACAATTACACATAAGCCATGAAAAGATTACCGTATCTATTTGTAGCTATGAAATATCCATGAATTAAACTGTTTCCCATGACTCTGTCATTTACTCCAAATGAGCCATTTACCTAATTGTATTCTTTATTGCTAATATACCACTTGAAAATTAGCAACTAAAGTTTTTCCATTTCATTAGCAGGATGGCCTGAATCCTATTTGTATTTCCCTCAGTGTCATTTTCTGACTCTACATCTTTTTTTTCTAAGATATGATTTAAGATAAACTTTTTAAACCTTTACTCAAATCTAACATTTAATGGCATATCAGCCTTTCAGAAGTCTCATAAATGACAGAAATTCCACTATGCAACATACTTCATGAGTGATTAACTTTTTACTTTTGTTTCCATTCAAATTTTGTCATGAATTGACTATCTTGTTTTTGTTAAAAATTAGCTAAGGATGGAAGCTGAGAAAATGTTTATACCTGAAGTAGTAGTTACCACTGCAAAATCTGCTGAACCAGCCACACCGCCAATGACTAGAGAAGGATTCACTATTAAACAAAAACAAATACATCTTTTTCGAGAAGAGATGAAAACTGATGCTATGGAGGTGAAAAGTATTGTTTCATCCCATTTCATCATCAACTCTCATAACTTTTCATCCGTCGTGAATTGTGCTTCTAGTGTTCCATCTAATTGTTTAACTGATCAATAAAACAATAGAGATGGTTAGATTCAGTCCATCCTCCAGTTGAACAGTGAGCATTTCTAGTAGTGAAAAGTCAGACCAAATAATACTCTTCTTTATGTCTCCTAAATTTATTCTCAGCATTTAACTCGTATGAATTGGAGTATTCTAGTCCAATTTGTCTTCCTGCTTCTCTAGGTTACAAACATGTGAGAGATATCAAAGTCCACTAAGAAATAAAAGCGGTTACCAGCATACTCATTTGTAGTCCACCAATAAGTGTGTGTATATAAATCTGATATACAATAATTCAAGGAAAAAACAGACAGATGCTTCCTCAATTTAAAATATTTTACCATGATTAAGATTTTTCCATATGTTTAAAATCAAGAACAAAATTTAAATATTTCAGTTGTGTGATATTTAGTCATATGACAGTTTCTTTGACAGTTTCTTTTATCATTGTTAAAATAAAATTAAGACTTAAGCTGACTACTTCATAGCAGACTGGCTAAAAGGTTCAAATGAGATATAGTGGAAATGTGATCACACTACAATCAAAATAATATTTATTTATTTAGTGTTATCTGTCGAAGATGTTAACATTTTAAAATGTCTATACAATTAAAGTCAGCTCATTGCCAATATAGTTTTTAAAAAAGAAAAAAATAAATGGACAAACTTAACTCACCTAAGCCTCATGTGTATTTTATGTTTTTTTCTGAGATGATGCAATCTAAAGTGAAGATGGTATTTGCAGTCCTTCGAGGCAGATGAAATTGTTTGTGTCTTCCTAAAAGGAAGCCCTGGATAAAGCCCATGATCACTAAAGACCCAATTCCATCTCAGAAAAATCTCATTTATATCTTGAATGGTTCAGAGAATAATTTTTAAAGATATGCAGGTAGCATAGTTGAAGAATGTTTCTGATGCATTCTAGATTCTATTCACAGGTATAGAAAACTGAATATTAATAAAATTTTCCAATCTTACTTTTAAAATGCACTTTTAAAATGTACTTTTAAAATGAACATGGCTATGTGATTTTTGAGGTATGCTGTTTCCAAGTATCACATAGAATCATAATATCTAAGCCACATCAGCTAGTTTGCCTTCTTTAAAAGAGAACCTCCTCTGCAAATTGTATTTCCATTAATGTTCATCAGACTCAGAAACGAGAAAATAATATTTGTTTCATTCTTTGCTTTAACTCTCCATAATAATGAAAGTAAATTAAACTTCAATGTGAAAGGTTGTTCTCTTGAATCCAAACATGATAACACTTTCATTTTAATCACAATATTTTTATTTGCACGGGGTTCTCTTTGTCATCTGTGTGTTTTAAGAAAGGTATTTTCTGATAGATTAAACAATCTTACCCTTAGGGAATCATAAGTAAATTCATATGCTCACTCTGTGTTTGTGAGCTTTCATGTTATGTCCGATTTGCATGCAACCATATAACTCTGTAGTCACTGATTTTTCTGGACAGGATGATGACGGTATTTGAGTGCACTTATATCATCACTGTCACTGCATTAATACCAGACTAAATGGTCAACAAGATAATAAAAATAATCAGTGAAAAGAACCAGCTCCAAAATTCTGATTTTCCAATTGCTGATTGATTGTCTGCCTGGAAAAATTCTAGAAAATTTCAAAATCTTCTTGTGATTTTATGTTCATATTGTGATTGTCCTATGTTGTGTATATGTGATTTAATGTCTAGTATAATTAAGTAGGTGTACAGAGAGTATATCTAAATAGATGTCTGTACAATATAATAATCAATGAAATAGTCCCTAAAAGTGTTTCTGAGATACATTTCTAGACACGTTAACACTGCTGTATAATGTGGACGCCATCTGCCTGTCCTGATGCCCAGGAGATATTCCAGCCTGATCTCGATATTCCTATGTATTAATTCTGGAAACCTTGTCTCCAG
>TTN-211,,0,105,2347066,2347170,GTGAGTCTATACCTGCTGATTTTTCACCTTGTTCATGGTAAAGCAAGCCTCACTGCTGTGGTCATCTGGTGATCAATGGTATCACTGAGTTTCATTTCAATGCAG
>TTN-211,,0,1268,2347171,2348438,GTAAGAAGTTACAGAGCATGATACAGAAATGTTTAAAGGAAATAAGTATCTAACCTGTGAAACAGAGCATCTCTGGGGTAGGCCAATGGAGGATTCTTTTTTGGTGATGTGTGTGTGCGTGTGTTTGCATTCACAGTGGGCCCAGACACCCTAAAGATTTGGTTTCTGAAACTCGCCCAGGGGAGTGAGCCTAGAGTCACAAGTGGTTATCTTATACCTCTGAGGAGAGACAAATCCACACAGGCTTCTCTCTAGTTCACATTTCAGGGACAGCTCAAACTCAATTGTTTTGATTACTATTGTTCTAATGATTTTGTGAAAGGTAGTGTGTTACACAGCATAGTTTTACTTATGCTGTGAGACATTTCAGAGTAACTTAACTGTGAATGTGTTTCAATAATAAAGACAGACATTGAGAAATCATATATTTATATACTCAATATAGCAAGATGGAGAGGTGGTACTGTATGGTGGTCGGGTTGGATTGTGGAATCAAATAGCTCTGGATTAGTGCCCTATCTTCTCCCTTATAATCTCTGTCATCAGGAGAAAGTAAGCATACATGTAAAATGCAAGTAAAAAGGACATAAAAACCTGCAGTTGTCAGCATGTAATAAATCCTTGATATTAGTCACTATTGTTATTATACACATCCAAGAAATAGAACCCAAACCTTCTATGCCTTCAAAGAACTGTAAGTTACATATAATGCCTATATTTGATTTAGTCCCAAATTACAAAACAAATAACCATAGACCACAACAGAATAAAAGCAGTAAGGAAACCTTTAAAATATTTTTTCTGAATGTCTTCATGTTTACCTTTCACATAGATTTGTGGCTAAAACCCAAATGTACTATTGCAAAGTAGTTCTTAGGCATTTACCAACAATTTCAATAATTTCTTAATTTTGAATCTCCCACTGTGGTATTTTCAAAAGTGGCATTCATCGGAATGGTTAAGTGAAAATTCGTGACTAAGCTTTAGAAGATCCTGTCCTTTTATGATAAAAGCTGTAAAATAAGGAGTTCTGAATACAACTCTTTAAAAAAGATATTTTAAAATTTGTTTTACAAACTAACAGGCATGACAAGGAGCTTTATAATTGGCTTATCTCTAAATGACTTTTCATTAACTGTGTGATAATGAGTGCTAATGAGAACATTAAAGAACAGACCTTATAGAAAATAGGCTCAGACTCAGTCCAAGAGGGCTAGCCATCGGAGGATGGTTAAATGACTTTATTTTCTGACTCTGTTTCCATGTAG
>TTN-211,,0,284,2348439,2348722,GTTGGTCACTGGTTACCCGCTGTTACATGGTCCACTCCCATTGAGCAGGGCCAGGTGGTTGGCTAGTTTGTACTGAAAAGTAGCCAGTGGAGTCTTGCCTTTCTCCTTTGCCATACTAAGACTTGATTTTTATGGAGCATAGTATGGGTCAGAGATCATTTTCTCAAATTATTTTTATAATTATTTTTATATTTTTATAATTATATAATGTTGCATGAGCTAAGAGTTTATGAGATTTCCCTTAATTTCATGAGCATTTTGTAATATAATTTGTAAAAATCTAG
>TTN-211,,0,655,2348723,2349377,GTGAGTAAAGAAGTTGATAATGCTGGACCCTATTCATATCTCCTCAAATCATTTTAATACACGTTTGCAAAGATCAGTTTCTCAAATTAATACAAAAATGACATTAGTGAGCTTACAGATGCTCATTTTAAGACCGTATTTGGTCTGGAAGACCATATTTGACCATATTTGGCAAGGAAGAAGGGAATTCTATGTGGTACATCATTCATGGATTCAAAAGATTTAATGAGCTTCTAATATGCAGAAGGCATTATTGCAGGAGCTGTGCAGACATAAAGACCAATCCATCCCTCTTTGAAATATTTTCTTTGCCATCAGAGAAAATGTACACAAACAAGCATAATAAAATATATAAGGTGATAAACATCACAACAGAAGGAGAATCCATGGGAGGCATAGATTCATTCCAGTTGGTGATACCATGGCAAAGCTTTGTTGAATAGGTAGCATTTGCTATTGAGCCTTACAGCTCTTTACTAATATATTAGTATATTATATAAATATTAGTTTCTCTACTACTATTTCTGGAGTCCTGATTAAAAGGCCATTTTGTGGCAGTTGAAATGCATAAGTTCAAACTCTACATTTGTTACAAAACAGAAGTGATTAATGAATATGCACACGTATCATTATTTATTTTTTCTCCTCTCTTCAG
>TTN-211,,0,203,2349378,2349580,GTTAGTGGCCACCCTCCCACAGTCCTAATGCACATGCCATCACTTTCATCTGACACTCTTTTCCACAATATGGTTTCTGTGCACCTTGAAATGATGTCCCTTTTTGGAACTTGGGGGGAGATTATATGGTCAATTTAACTGTCAGTGCTAAGCAGGGGTCACTAAACATCTCATCTCAATGAGAAACTTTTGTCTTCTTTTAG
>TTN-211,,0,111,2349581,2349691,GTAAAATATTTTGCTAATTAGTAGCTGTTCTAGTACCATTTTGACTTTCAGCCCCACCAGTATTGGCAAATTGCAACCCGGAAGCTAATATGAGGGGAATTCTCTTTCCAG
>TTN-211,,0,948,2349692,2350639,GTATTTTGATGGCTGAATATAGAGTTCTCTGTGACTTGTATAATACGTGCATGAAGCCTAGAGTAGAATTTACTCACCCCACCGACCCTGAGCATAGGCTCTTTCATTGTGGAGCCTTCTTAGTTTGTTTTGAGGTATTTTTACATTTTTTTTGTGCAAAGTCTTCCTAAGAAATAAAGCTATGTGACAAAAGTGGATGGAAGATATATTTCTTTACATTATAGTTTAATTCATTGAGTTTGTGAAAGTAGAGAAAATATGGATTTTCACACAAACACACCCACACACACACACACACACACACACTTCCAGAAAAGATTTGAGACAATTTTCAATAAAAACATGTAATAACTAAGTGACTAAAAGATAGAAGAATAGCCATGTAATGAAGAAGAAAGCTAGTTATGCACAAAAATCTATGCTAGTAATTTTTCTTCAATTCAATATAAAATTTAGCTCTGAATATTTTGCAATTTAAGATAAAAAGAGCAACCTGGTAATCTAAAAATGTAGGTGCCGTACCTTCATAATAATAAATATAATGTACCAGAGAGTTAATACTGAAATATTTGAAGGAATTTATTGTTTTAATTATTCATTTGATCTCTGAATGAAATAATGAGAAAAATAACGAACAAAGAGAAAATACCTGTTGTTTAAGTGACCTGATCATTTGCTAACATAAACACTGAAAACCACTTAATTTCATGACTGATTCTAGCAATAAATATTCTTTAAAATGAATATTTTAACTTATTTGGCCCTAATTACTCATGTTCTTGCATTTTTCTCAATTTTCAGCAATCTTATAATCTATTGTGGAGCTTAGTCATATGTTTAGGGTCATTGAATTTTATACCACAGATCCACTCACAGATAAGTCCAATTATTTTACCCACAGAAGAGTTGTTGATAACTGATTTTTAAATTTTGTACATTTACATAAAG
>TTN-211,,0,915,2350640,2351554,GTAAGTGCAACTCCAGTTTCTATGTGCATGATAAGAACTGAAATACAAGGAGATAGCAGTGCTGTCCGTTTGCTGAAAAACCTGTTGCCACTTACTGGTTCTGATACTTTGCCCCAGTGTCTTTGCCTCAGTTGTATGGAAAATGTTTTAGACCACATGGCCTCAAAAACTATACTGTCATTAAACTTCTGAGGTTCTAGCAATAGTTTCTTTTTGTTGTATTTGTTTCTAGGCATATCATGCCTCTGAAAATGCAGAGATTCTAAATCCGGTTGCCTTCCAGGCCCAGGCAGGTAACAGTGAGCTCAATGAAAACAGTAGCAAACTGGAGAGTAGGTGCCCTGCCTCAAAGAGACAGTAGCTGTGTTGTTGCCAGGCATGCACCAGGCTGTTACCAGGCTCAGTGTTGCTAGAGCTCCTGATATCTTAAAGAAAACCTGGAAGTCAGGATTTTCAATGTTTATAACTTGAAAACAAATGTAACAGCTTTCATGCTAGACTGTTCACATTTACAGTGAACTGGCTCACACTCTGTTTCACTTGACCTACACAGTATCCCTTAGAGGAAATTACAATATTATCTTCATTTAGCAGATAAAGCACTCAATATTCAGGAAGGTAAATGAATTGTTAAAAGACACACAGCAAATTAGGAAGTCCTCCGTGGTAGATCCCCCCAAAACTGACTGCTAATATAAAATTCTTTCTACAATTGTAATGGCTGGTTGGATTTGTTAGTGTTAGTTTGGTTTCCAAATTCCATCTAGAAAATATTGAGCACTTCAATAGTAGATATTTGGAAAATTTGGTTTTTGGTTATCAACTTTCCCCAGTGTAGAGTTTACCTGAATGCATAGTGGTATGACTGTTTTCTAATAAGAGCATTAAAAATTAACTGATGTTCTTAACTCTTAG
>TTN-211,,0,537,2351555,2352091,GTGAGTATAAAAGTAATGACCAACCAAACAATTTCATAAATTATACTTTCCTTTTTTTATTTGATATTTTCATTTTCAAGTGATGAGCTCGGGGTTAGACAGCTATTAGAAGGTCCAAGTTCACTGTTGCTAAGTTTCCTTAATCTTCATGGTATGTTGCACCTGTGAGTTTAGAAATAGAGATTACATATAGGCCATAAATGTGACTTTAAAAATAGGGCTTATAATATATTAAGGAAAACACCAATATTAGCACAGCTGAGTTCATTCATGCCAAGATCTCTTCATCTGTGTGATAAGCTAATGTAACCTCTAACCCAAATCTAACTCCTGCTTTTGGAATACCTTTCTACCCAAGATGCCACAACATTCACTGGGAAAGATGACCATAATGCAGATTAAAACAAACAAACCAAAAAGTCCTCTAGATTCTTCTCCCAGCTAAAAACTTCAACAGTCTAGCTCAGATACATCTCCTTAAATAATTTATATCAGTAAGGATATGTATTTTTAACAGACCATAATCTTTTTGCATAG
>TTN-211,,0,110,2352092,2352201,GTAAAATATAAACATTTATCATAGCTCCTTGCCACAGTAAAGATACAAATTGGTTAAAATATAACTATTTGATGTAAATTTTATTCATACATGCATGGTATTCTTTGCAG
>TTN-211,,0,898,2352202,2353099,GTAAGACTTGTAATAATTTGGGTTATTTAGTATGTAAATTGTTTTCAAAACATCAAATAGTAGCAAATTGCTATTGTGTAAGAAGAAAATCGAGGGCTAAAATGGCACAGAAACTTACCATTGGCAACACCAACAATTGCCAGAAGTTTTTATTTCTTGCCCCTGTGTAAGATGAGCAAAGAATTTTCATCAGTGTAACATACTGTTTATTTTCCTAGTGCTATAGCTAATATCACAATAGCTCTTATTTGACACCTGATTTTTACATATGTAAATTTATACAACAGCCCTGCAATAAAAAGATGACTATTATTGGTTTGGAAATAGGAACACTGAGGCCCTGGGAATCTATGAAAATTGTCTTAATTCATCCAGCCTGTAAGCGGTGGTGCCAGCATTCAAACTCCAAGTCAGTCTGGCTGCAATGTGTAGATGGAGTCTTGTTTTGCTTTGTTTTGTTTCCAAATTCATTTCTATGTTTTCCTCCTCTGAGATAAAGAATGTGTATTTTTTATTTTTCCATAAATGTATTCATTGGTTTACTTATCCAACCAACATTTATTAGGATGTTTTAGTAGTTAAATCAAAAAAGTCTAGTGACTGATTAAATCCAAGTGGTAAGGAAAAGAGAGTATTGAGGATTATTCCAAGATTTTTGAGCCTGGGTACCTGGATATACTGAATGACTACCAGCTAAAATTGAGAATATAGGAAAAACATAGTTGTGGGGGCAACAATAATATATTCTATTTTAGATCTGAATGAGTTTGAGGTGCCTTCTAATACGTGCAAGAAGTAAATTCTAAAATAACATGAATAATGAATAAGACAAAATGAAGTTTGTTTTGCTGAGTTTTCTTTATGCCTCACGAAAGTATTGTGTGTCTTTGTTTTGCAG
>TTN-211,,0,119,2353100,2353218,GTAAGCGTGATAAGTTTTTGCTCATGAATCATAAAAACACAAAAACAAGCTTATGTATGCATCTAACAATTTTTAAAAACTATTTTAAAATCTACTTTCTTTTAAACATATTTTCACAG
>TTN-211,,0,102,2353219,2353320,GTAAAATGAGATAAAATAAAAATAAATGAATTTTCTTATCACTTGGGTTATAAACAGGTATTTCAGCCTTACTCCCTCTAAATCATGACCTTTCTCTTTCAG
>TTN-211,,0,99,2353321,2353419,GTAAGTATGGAAATAATAAAGCTAAGCTCATTATACAAATCCAATAACCAGGGAAGCTATACCACTATATTGATTATTCCCTCCCCCAACTTTTTATAG
>TTN-211,,0,153,2353420,2353572,GTAATTTGCATGTCTTTCCTTTGATGGACCTGTCTTTGTATTCAAGAATATCCATGAGTGTGTTTACTTTTATTTTCTTTCCCCATTCCTCAGGTTGAGAATTTAATTTAATATAATGTGCTCTCCCCTTTTTCCCCCACCTTTTTCTTGTAG
>TTN-211,,0,447,2353573,2354019,GTATTCAACAACGAAGGATTTCATTGTTTACCTAAGCTCTAAAGTCACCCTTAGCATGTGGTAAAATTAGCTATGCAATTTTTCTTTCATGAAACAATTATTTGGAAATTGACTATAAGTTTCATAGCCAGAATCATAAATTTATGTTCGTAATTAAGAATGTTAACAATTTGACCATTTGGATTTTTTAAAGTAGTATTATCTTGATTTTTAGCTTTTAAGTTTTTTATTGAAGCATAATTCTTTACTTTCAAAAATATTTAAAAATTAAAATAAAATAACTGCTTCTTATTGAAAATTTATCTCTCAGCCCATCAGCGGGTAGATATTAAGAATACACCTGATAGTATGGGGGAGATAAAAGACATACAAGACATCATCTCTATCCTAAGTCTAGATGCATACCTCTCCAAAAAAATTGATTTATCTTTCTGTTATACACTTCAG
>TTN-211,,0,96,2354020,2354115,GTAAGTCCTCCCATTCCTGTCAGCCTGCAGTGAGCATCATTATGGTTTATTGATAAAAAATGATCATAACATTCTTTTTCTCCCCATATTTCACAG
>TTN-211,,0,112,2354116,2354227,GTGAGTCCTAATTATAAAATTTTATGTTTACACTATTAAGCAACATAAAGAACTTCAAGGAGCAGACAATTTCAACAAAATTCATTCATCTTGTGTGTGTATGATTTTGCAG
>TTN-211,,0,92,2354228,2354319,GTAAGGATTATTCTACCTATCTAATAATTACTTTAAGCATTCTACTTTCCCAGTGTAACAATAACCAAGAGATTATTTTATTTTTTCCCCAG
>TTN-211,,0,1637,2354320,2355956,GTTGGTATATTTATTAACCTAAATTCTTACGAGGAGTGATTGTTATTTTAAGAAATTATTATTCATTTCCCCCAAAATTCCTTTCAGTTTCCCACTTCCATGCCTCTGCTTATGCTGTTCCCAAAGCCAATAGTACTTGCAACACCATTCCCACCAGCCTAAATTACAAATGTTCTTCTAGGCCTACCTCAAACGTCACCTTCTCCATTAAACCTTCCTTAATCTCTCCATTTGTATATGATCTCTTCCTCATCCAACCCCAGGATCACTTTATATGTGCCTCTTTCCTAGTGTTTATTATGCACTTGTCTTATTCCCCATTTCCTCTTTCAATATCAGTGTATAAACTCCTGAAATCTGGAATTCTATTTGTATATTCCAATATATTGCAAATGACAGATAATCAATTGGTGTTTGCTGTATTGAGCTTTATTTAAACTTCCTTACTCTAAAGAATTATTTCCTTTTTTAGCCATTCTTGCTTCTTTAGCCTTTGTGCCTTTTATTTTCTTCCTACTTTTTAATGAAATCAATAAATATTTTCAAAATACAGCTTAATGTAACTGTATTTCTTATGATATCATGTAGAAATAAGACCATCATTCAGTAGAATTTCTTAGCTTTACAATGAAGAATAAAAAATGTAAATCAATTGCCAGAAAAAACTAGAAGTCATCATTAATTTGTTTGGTTCATTACAGTTTAAATTTTGAGGAGTTGAGATGTTACATTCAGATCGTGTTGTCCATTACATCTAGTATTGAAGCAAGTCATATGGTAATGATTTGTCTTATTTGGTATGAAAGTTTCATGGTTTATACTTACTTACGTTATAAGATTTCTTCAGAGATCGGACCATGAAAAGACTTGTAAAACAAAATTTCAGATTCAGCATTTTTATACATTTAATATAAATTACATGTTTTAAATGTGTGGAAACAGGAATAAACTATGAACTCCTCTGTGATTTCACCCAGTGTTTTTAAAGTACCTACCATTGGTCAGACACTTGTAGAAACTCAGGACACAAAACTAAATAAGAAATGATTTTTTTCTTGAGAAATTCATAATTTAGAGAGGACAGATACATAAGCAACTAGCTTGTTAAAGCAGTAATTATTTCTGCTAATGGATGATAAGAGTGGAGGCAATGGGGTGAAACTTCATAGAATGGGCGACATTTGCCAACACAGTGATTTTTAATATATAGAAATCCTCAATGTAGTAGAAACATTGATGACTCGTACATTTTGTTTAGCAAATTTTTATGTAGTCAAAATATCAGATTCCCAGGAAATAATCATTAAAAGACCAAGTAAAATGCTTTTGAAGAAGAAGGAATTGGGTTAGAGACTATCCTGGTGGTATACTGTTCTAAGAATTTCCTATTAATTCAACAGTTATTTTTTCTTCACAAAACTTTTCTGATTCCAGTATTTCTCCTAATTATCAGTTATGCATACTTAGAATAAGGGATTTCTTTGGTACCTTCTCAATATGGGTAAAAACAATCATAGACATTTCATGATTTCAAAATCATGTTCTTAAATTTGATATTTTATATTTACTTCTGCAAAGATTTTCCCATTGTGTGAATATGTTTAAAGGACTCATACTGTACATCTCTTGTTCCAAAG
>TTN-211,,0,535,2355957,2356491,GCAAGTAACATAGGATTTGTCCTTTTCAAATCATATTACAATCTTGATCGTTATCGTTTTAAAAGACAAACGATATGGCCATTTTGGATACCATAAATTTTCATTTCATAAAGTCATTCTAGATCCTCTAAACCTTCCTGAGACACATTCCACAAGGTACAAAATTGCTTATCAAATGCGTTTATGCAAAAAAGCCATTTCTTAGGTTAAAGCTCTGTGAAACAGCTAAATCAGACACTGATTCTCCATTCGTCTTTCACCCTTCTCCAATCAGTCTATTATGCTGCTAATACATAGCTATGCAAACTTCATACTACTAAAGCATAGAAAAATCATTTCACGATGTACATGTCCAGTTGGATCCCAGGTTCCCCTAAATAATCTCAGGTGTTTTTTAAAACAGAGGTGCTGCATAACTGTAAAATGTTTGGTAGCCATTCTTTTGCAGGGTGAGTAAGCAATGATCTTGTTCAGGACTTCTTTTCCTTGATGATGTCATCTATATTTTCTAACCCAATCATAAATTTGTCTTTAG
>TTN-211,,0,91,2356492,2356582,GTAAGTTGATTTAGAAACACTTTTCAAGCAGTCAGCCCATGGTTACCATTAAGTTAACCCTATCACTGAATTGCTCCAATTTTCCTCTTAG
>TTN-211,,0,120,2356583,2356702,GTAAGTATCAGGCAGCCCCCTACAGCCCTTTCCTTAATGAACCCCATGTATCTATTTGTTTGGTTTCATCTACTTTTTAAACAAATTGTATTAACTGAAGTGCTCTTTGATTTTACCAAG
>TTN-211,,0,745,2356703,2357447,GTAAGTTAAAAAATATATATATATATATACACATATATATAAAATATCAAATATTCAGTAGATTCATTGATATTCTATATCCTACACTTTGCTGACCACTCAAAAATCCTTGATTGGGTGGGCAGGGTGGCTCAAGCCTGTAATCCCAGCACTTTGGGAGGCCAAGGCAGGAGAATCACTTGAGATCAAGATTTTGAGACCAGGCTGGGAAATACAATGAGATCCTGCCTCTAGCAAAGACAAAAGGAAAAAAAAAAATTAGCTGGGCATGGTGGCACACACTTGTAGTCCCAGCTACTCAGGAGGCTGAGGTGGGAAGATCGCTTGGGCCCAGAAGGCCAAGGCTGCAGTGAGCCACAATCACGGCACTGCACTGCAGCCTGGGCGACAAAGTGAGAACCTGCCTCAAAAAATAAAGAAAAAAAATTGTTAATTGAAACATCTAGTATGTGGTTACACTGAGTAAAGCACTAGTATCTCCACCTGGATAAAATGTTCCAGTTAGAGTAGCATTGAAAGGCTACCTGGAAAGATGCCTCAGTGTCTATCACTTGATCTTTCTGTTCCTCTGTGAGTTGGCACTGTCCTGTATAGTACATGGAAGGTATCAAAGCTTATATCTCTAAACTGTAATCTCCTCAACAGACGCACTAAAAACATTCCAAATTTTTATTCTGCACCTGTTATAACCCACATCATATTTACGTAAAGTCTCCTTGGGTGTTTTTTCTTTTCTCCTTTGCAG
>TTN-211,,0,517,2357448,2357964,GTATGGTTTCATACATATTAGATCCATAGAAAAAATGTCATACATGCTTTATAAAATTTAGTGTATCAATTAATGAATGGATAAATAAAATGTGGGATAGCCATACGATGGGATATCATTCAGCAATAAAAAGGAAGCACTACGATATGCTACAACATGGATGAACCTTTAAAACTTTATGCTAAGTGAAAGAAGCCAGAGACCATACAAAGACCACATATTGTATGATTCCATTTATATGAAATGTCCAAGATACACAAATCTATAGAGATGTAGATTGGTGGTTGCTTAGGTCTACAGGGGAGACAATAGAAAAGTCCTTGGGGTGATGGCTAAGGGTTACATGATTTCTTCTTGGGGAATGAGAATGTTCTAAAATTATGGTGATGGCTACACAATGATGAATACATGGAAATTCATTGAATTGTATACTTTAAATTGGTGGATTGTACAGTATGTGAATTATATCTCAATAAAGCTGTTAAAAATGTTAATTTTTCTACATGCTATTTTCCAG
>TTN-211,,0,89,2357965,2358053,GTCAGTTGTTTTGTCTTGCTACATTCCAGTAATTCCCAGTTTCCTCTGAATCACCATACGGTAAACTCGAATTTCCATTTCATCCATAG
>TTN-211,,0,1146,2358054,2359199,GTATTGTCTACATACTAAATGTTTTGAAAAATCATCAGTAGTCCATAATCTATCATTTTATATTTTAATGTTTCCCTTTTACATTTTCTAACCACCATCCTTTAAAGAATTAAATCAGCTCATTCTTACTTGGCTTAGACTCTCTTATGCTGACCTCAATTTAGTCACAGTTTCCACTCAGGGAATAAGGGTGTCCCTAGCAGCTGTCTAAATACGTTAATTAAAGCAGCTGTAGAAATTTCACTGTCTAATAAATGGCTGCTTGCCAAGCAGCACCAACCAGAAAAGAATTAAAATGTAAATCGTGAGGTTCACACATCAATTAGAATTAAGGAAATTTAGAACAAGGTGATATTTTCTCAGAAGGTTTCTATCTGTGGAGAGGCAAGTGTCAAGGAACTTAGTGGCTAGAAATACTTTCTGTGAAGTCTAAGAGAAAGCCCTGTCCAAGCCGTGCTGGGTTCCTGGCAAGGATGCTGGGCACTCTTGCTGTCGGCTGCATTTACAGAGCTTGTCCTCATAAGTGTCCACCATCCCAAATGATATAATGGAGGAAACATGTCTAGAGAAATACCAGTTGAGTTCAGCTTTATCATATTGCTCATCCAAAGAAAACCAGGCTTTACAGACTGTGGACTATAATGAAAAAGGCTTCAATGAGGACTCAGATAACCTGGAGATGTCTTCCATCATTTATTTGCCAATTCTGAACCTCAGTGTTCTCACTCTTAAAATGAGGATAATAATTCCTACCTAGCCCACAAAGTTATTATTCATATAAAATGAAATCAAATTAAGTAATAACTTTTTAGACAATAAAAAGCCCCCAAAGGTAAAGCATCATTATATCCCTTATTAGTAAATAAGAAGCAAACATTTAAGGATGAAATAATTGTCTCTTTGGGGCAGCTCCTTTCCTCCATGCAGCTGTAAACACAATTCTCTACAAGAGAAGTTTATGTACCATTTGTCCAATACTAGGCAGGAAAAATTAGAGAGTGCTATAATCAGCCAACTTATTACATTATAATATATTGGTTTCACATGCCATTCATTGACCAGTTTTAGAAATTGATTAACTGGGAGGAAACCAGAGCTTCAAGTTTTTGTTGTTGTTGTTGTTTTTTTATGTTGTTCCATCAACAG
>TTN-211,,0,1569,2359200,2360768,GTATGTAGGGACAGATTTCAGCATATTTTGTGGATCCATCAGAAATAATCCTCCTGTTTAAGTCACTAAATTCTTGTAACTTGAAGGAAATTTCTAAAGAACCTATGGTATTCATGTGGTTCCAGCTACATTTTTTTTCACATTATATCTATGGAAAAGGGAGGGCAGCTGTTAAAAGACCTATTGAGAAGTTATTTTCAGAAAGCACCTGATGGCCAGATCCTCATCTGGTTGCTCAAAACTATTGAACACCCATTGGGTGTCCATTTTCATATACCCCAGATGAGCTTCTAGATTCGCTGTTAAACTATTTTAGTTCTCTGCCCTCTGCCTGAACTGCTCAAGTCCTAGCAGCACTACCAAGTGAAAGGGGTGTTTCCAGCCTCTGATATGGAGTGCCTGGGAGAACTCAAAAGTCCTCTTTGAGACCCTGGAAGGCCTAGAGAGCCTCAGGCAATGTGGAACTCGATCCTCTCTACCCCAAGCTCTAAGAACAGGGGCTCTTACTTTGGACAGGGAATTCCACATGCTACCAAGCACTCCTGAGGAGCCTCTGAGCAGTCCCCAGGGAAGTGCTGTTAAACCTCTGCTCTCCTCATTAGAAATCTTAAGGCTGAATCTCAAGCTGACCTTGTTTTGAGTCTAACCTAGATGCAAGAGAAAAATGGAACCTCCCTTCCTATTCTCATCCTAGGCCATATCTCTTTGAATAAAATACCCCTGAGGCAGATGCAGGAACTCCAGGGGTAATCTCAAGATTCACAAAGATGAACCATATCGCCAGCATTCCCTAGGTTCCTAGAAGACCAAATGGTCATGGCATCCAGTTCTTATTATCTCTGTATTAGTAGTGGAGAAACTGAGGCACAGAAAAGTAAAGATCTTTTCTATGATAGTGTCAGAAACCAGCCTCACAGAAGTCATTTCTTCTAATTTCTGGGTTCCATGAACTAACCAGGTCCCCTCACTCATCACAGCACTGAGAATATGCTTTAGTTAGCAAAACAGGAAAGCTGAATTTGTTAAGTCTACCTAATGGCATTTAACTAGATCTGAAATAGTGTTAATTCAGTCATTCATTCAATACTTACTGATTGCATTTTACTGGCACTGGTACATAACAAAATGACTATGACATAAACACAAATACTTGCAAAACAAACAAACTGGAATGATATGAGCCTCTTCACCACATGATTTGTCCAAATGAATTTTAAAAATAGGTAGCACACGGAAGTTATTGTATAATTCATTCAGGTGTCCATCGCTAAGCCCCCACCACAAACAGAAACTGGGATAATCAGGTTAACTCGGCACTCTCAGCATGCCCCCCAAATATCAAAAATATCTTTCTGAAGCTATTCCCTCTGCATGTGGACAAATTCCAAGTGCTTTCTTCATTCTTAGCACAAAGAATGTTCTAATATTCTGAGGCAAGTAAAAATACCACAATTCCAAAATTTTGTCTCTGGATGTATAACTAGCCAGCAACAAATTAATGTAGAGTTTTGCATGCTCTCTTGTGTTTTTACACTTTTTCATGGGCTATTTGTCAACATTTACTCCTAG
>TTN-211,,0,224,2360769,2360992,GTAGGAATGCCTCGCTACTTCCAGCTGAAAATAAAACCTAAGAAGCAGGCTTTTGTCCTTTCCCAGTGCATTTAAAAATACAATTTGGAGCTCATAAAAGTAGATTGCTACCCAACTTTGAAAGCACTCTGCAGTGAAATAAATTAAGATAAACCTACATGCTCCCTTCTGTGAGGTCTCTATGGTGACTTAATCATGACAAATCTTGTGGTTTCTTTCTTTAG
>TTN-211,,0,5004,2360993,2365996,GTAGGTTTAAGAACAAAAGGTGTCATTGCCAATACTTACAAATAATTACATGGGAAAAACATTCTGTCAGCTTCTCCTCCATCACAAACATCTCTCATGCATAATTTGAAGCTTAATGGAAATCTAACAGAAAACTTATTTCAATTATTAAATTAAGAATTAGATAAGTGTTTTTCACTATTTTGTGCCCTTAATAATGGTTGTTTATGTTATGTTATGTGTTCTTTATCACAATAAAAAAATTAGTGTTTTTCACTAATATTAAAAAAGGTCATGTTCCCTTTATGATTGTAGCTGCACTTTAATTTCTTCATTGATAAAATACAATGACAAAACTAAAATTATTAGATTATAATAGCATCTACATATAATTCAAAAGAATAATACATTTATATAAGACATTATTCAGTCTATGGACAATGCTTGTGTGAAAGGTATCCTTTGGAAGACAATATCCTATAGTGGTCAAAAGTCGGGGCTTCATTGTCAAAGATGCTGAATTTGAATCTTGCCTTCAATATATATCATGTCTCTCGTTCTCCTTCTGTCATGAATACATTGAGTATATGATTGCATTCAATCCTAGAAAATATATTTTATGAGGCTAGGAATTCCGTTTTAGTGCCTAGAATTTGGCATCTGAAAAATAGTACCTGCTAGAAGGTAAGCTCTATGAAAACAAGAGTGGATGGTTGCCCCAGAATATCACCTGATACATAGTAGATACTCCATAAGTAATTGTTGACTGGACTAATTAATGATGGTTAAATGACTGTTACCAAACACTTAAGATTATTATCAAGATTAAGTTAGGTAACTCAAGTCAGCACATAGCACAGTGCTCATCATACAGTAATCAATCAGAGTTAGCTGCTACCATTTTTAATTGGGGCATGCTTCTCAAGTACCACCAGCCAATTTCCTCATCCCAGGAATCTGATCTTGGTAGAATGAGACAATATATGTGGAACCACTTCAAGTCATAACTGATTGTCTATAATCACAATTATTTGAGAGTTTCCCAGCCAAAGGGAAACTCTCAAAGCTTGGGCATCTCCCAGCCCTCTTATTAGGCTGATGCAAAAGTAATTGCAAAGTTGTATTGTTTTGTTTATTATGCTTCTCCCATTAGTTTATAATCCAATCTCTACCTTGTCAAGATTTATTTTTCTCAACAGGTTAGTACTTCAGTTGGTCTTCTGACCCAATTATTTCCTCCTCAGGAATGGAGATGGTGATCTAGAAATCTAATAGACCTATTTGATTTTATGAGCATAATTAAAAGATATAATGTATGTAAAGCACCTATAGGCATGGCTGCCAGGTAACTGGGGCTCAATACATTCATTTTATTATAGCCATAGAGAGGAATTATATAAACATCAATGTTTAGTATTGTATGGCCAGTATGGACAAATACCATAGACTGTATATTTGAGGGATAGTGTTCAAGAAATGCTAAATATTAATAAATGAGGACTGATTTGATAATATCCTACTAACACAATAATACAAAATATATTTTAAAAGCAAGTTCATTAAAGCTACACTAAATAATTTATCCATTTATTTAATTTTTAGAGGAATTTTTTAATATAAACATATATGTACATCATTCAAAGTAGTAATATTTGTCTTAACTATATTGGTATAGTGCTTTTAAGTCTATAACATATTAACATATGGTAGTATTGCCTTTAAAGTGTTGTAGAAATACACCTGAAGCACTCTACAAGACACCAATTGGGGTAGAAAGAGAAAAATTTCACTATCTTTTCTGCATAACCAATGTCTTTAAAAAGGTTTGAATAGGCTTTGTAAACTGAGAAGATCATTAACTTCCTATGTGTGGTAATATCTGTACACATATAGTGGTTTTAGCATCCTCTTATAAATTTGTTTTCTATATGAAAGAAATTAAATTCATTAAATAGAATGACCCTTCAAAAACTTGCCAACTCACATAGTTTCATACCACTGGGACTAAAAATATTTACAGAACTTCCTCTGGCCAGGTATTGCCTTAAGTAAGTGTAGCCCTGCTTTCCACAAATTGGAAAGAAATTGGGAGTCTTCAGAAGCTCCCATGTTCTTGGGGGTTGTAATACTTTCTGAAGCATGAAACGTGGCCCTGAGCAACCAGGTGCTGTTTCTAACAGCGAAAATGTTACCTATTGAAGGTCTCCAGTGCCACCTACTGGTAGAGGAGTAATTTGGAAAAGCAGAATCTTAAAATGTAAAAAAGCTATTTTTTTGCTGTTTATTCTACAGATGATGAGTCAGTGTCATTTGGAGGCTTACAGAGTGACAGCTAGCTAAACAGAAATGATGAATAATTAGTTTAACAATGATATTGTCTGTTATTCATTTAAGCATCTGTGCAATTTTAATTCTACCATTTATTGTTTCCCTGCTATTGAGATATTACCCTAGGTGCTGGGGTGCAGATCTTGCTCTTGCCTTTAAGGAGCTTGACATGTAGGTGAGGAGATGCATGCACACAACTATATCCCAAGGTTGTAAGTGCTATTAACAGGCCCACGTACTCATCATTCTCTGTCTGGGAGAGAGCCAGAGAAAGATGTGTGAACTGAGCATTGAAAAATATGTAGGATCATTGAACACAGTGGCATCCTATGATGAGAAAACAACATCTCCAAGTCATCAAAACTTGCAATAATGCTTCATGTGCTAGAAGCAAGTGGTTTAAGTACAGTTGGAAAGTGATATCATGAGTGGGTAAGAAGGCTGGATAATACAGCAAAGGCCGTGCTAAAGTTTTTGGTATTCTATGCTGAAGATTTTGGAATTGATCTTGTTTACATTTAGGAGACACTGCAGGATTTTTAAGCCCCTGGGTACCATGATCAGGTTTACTTTTTAGAAGTGATACTGTGATAGGGAAAGAAGGGATGGACAGATGTGGGAGGCAAGACTGGCAGTCAGGAACTGGAGAGAGATTATTACAATAGGCCTGGAGAGCGTGGATGAGGCCCTCAGCCAGGGCAGTCAGGAGAGACAAGTGGGGTATTGCAGAAGTAGTAATATGGGAGAAGAATGGCCTCAAAGAAGACACGAGAGGCTAATGAGTAACGCAGATCATGGCATCACAGCCACAAGCACCAAGTCCACTACCAAGAAAAGTTTTACCTGTTAACTCACTTATTGTGTGCAGTTCATGTCCAGTGGCAGTTCATGTGTATCCTGGTGCCTCATTCAGTTCACCAAAGGAAGAAGCTGTCAGTAGAAATAAGCAGAGAACCTTGTAAGAGGATGTACCATTGATGATCTCACACACACACACACACACACACACACACACACACACCCCTTCACACAAACTAAATAGGGGTGGTGTTTCATGTTATATCACATGGCACTGTCTTTTGGCGTGTTATTGAAGACAACGTTGCTTCCATCTGTGATGTTAGATATTCTTGCTATAATGACTGACTTGTGCCAGTGGCTTATAAAGCCCTTCCATGTGTGTTATATCATTTAATTCTCACAGCAATTATATGCAACGAATAGCCCATAAATTATTACGCATGCCATTTTACAAATGAAAAGACTAATCCAGAAAGCTTAAATGACATTTCCAAGGCCACACAGCTGACAAGTTGTAGTGTCAAGATTTCATTTTCTTTATATGTATATATTTTGATGGAGTCTTGCTCTGTCACCAGGCTGGAGATCTCGGCTCACTGCAACCTCCCCCTCCCGGGTTCAAGCTATTCTCCTGCCTGAGCCTCCTGAATAGCTGGGATTATAGGTGTGTGCCACCACACCTGGCTAATTTTTGTATTTTCAGGAGAGACTAGGTTTCACCACGTTCGTCAGGCTGTTCTCGAACTCCTGACCTCGTGATCTGCCCGCCTCAGCCTCCCAAAGTGCTGGGATTACAGGTGTGAAGCACCGCGCCTGGCCAGGATTTCATCTTCTACTTTACCTTACTATCTAAGGAACTGAACAGATTTGTTACTCTAAGAGGAGAACCTGCCATTTATACACATCTACCATCATGGGCAGGAGAGTAACTTTTATAGACAAGTATTGGCATTAAAATGCAGACAAATGCTAGATGATTGGACTATTAGAAGATCATCTTGGATGGTTTTGAGACCAAGAAGTGGTATAGTGACTGTGCTCCAAAAACAAGATGGCTTTGATTTTGGCTATTCAAACAGTTAACTAAAATTAAAGTGCATATCACCTACAATTATTACAACACAATAACCTGCTACTTTACTGTAATTTGGGTTTTTACTTTCTATTATTTTAAGATGGTTCAAATCCTTATATAGAAATAGCTAGCTTTATTATAATGTCTTATAACTGCCACTCTGAAAAGAGTCAAATGTATCTAAGATGCTCAAATACCATAATAAATCACCCTCTTTATTTAAAAAATTATTTTCTCTACAATTATTTGTGCCATATATACTGCGTACTGAAACCTTTTGCTCATTAGTAACAAAGATAGAGATTTTTTTTCTACAGCCTTCAAAGGTATCTATTTTAGACTTTTCATATCTTGATCTTCTCAGCTCTCTTTTTGATTGATTTTTCTGCAAACCAAAAGTGGAGATTTTTCTCATTTCCTGTCCCAGAAGGCAACTACAAGCCCAGATCAAACCTTTCCTGATGACTCTTCTTAGGACTGTCTTTTTCTCAAAGTCACTGAATATGTCAAAATCTTGTCTCTGCTTCCACTGCATGACATGCAAATGTCTAAAGAGAATGTAACTGAAGTTCTATCATTTTAAACATTACAACCAGTTCAACCTTAGGACAAGCTATATTTTTCTATCATTACATTTCCTTCTTGAAGATGAAAGGAAATCATTTAACAATAGTAGATATGGCATGCCCAGAGAAAAGTATCATGTTATTAAGTCAAATATGAAATGTAGGCACTAGTATTATTAACATTGTGTTTGCAGGTAAATTGTAAAAATCCACTCATTTTTGTGGTTGAAGTATCTCTTTTCTTTTGTGTCGCAG
>TTN-211,,0,5803,2365997,2371799,GTAAAGTAAAACAACTTTCAGAACCCCATTTAAATATAGATCGAATCTTAACAATGTCTGTAACAATTACTCAAGAGTTCATGTAAATCATTGTTGTTCCTACCATTCTCTTCTAATTCAACTAATTATTTCCCTGTTATATGCCATGGTCTCGCCTCTCCTTTACCACTTTTCATTGTGAATCATAGACCATCACGTTTCATTTGGCCCCGCTTTTTCTCTGTAACAATTTGTAATGTATTGCTGCTGTCACCAGCTGTCATGCTTCCTAATCAGCATGAATCAGAAGGGGGCGAAATATGCTGCATAAATAGGTAGATTTGTTTTCTCAATTGGCTAAGATAAAAATTAAATTTTAAAAACATCTAAGAGTGTTATCATCCTCCTATCATGCTGACACAATTTTGATTTCACAAAAGCTAGACCGTTTCAGGTCTGTACACCAGCGAGCTATATTCATCCTCCTCTCAAGAATGTCTTAGTGTTAAGAAGTCCAGTCCTAAAGTGGTTTAACATTTCTGTTAGTTGGGGCTCTTAAATTGTAATCAGAAACACTTCCTCAGTAACATGGGGAATTTGATTCAAACAAGGATAGCATTTTTATATAGTGGTACTATTTTTCCTGAGCAAATATAGTCTATGTAGTATTAAGTACATACAAATACATAAGGATTTAGAGAAACTATTTTTTTCTTAACCTTATGCATTAACTGTAACTAGATGTTTTTTTAAATAATGAATTTAAAGTGGTTTAAAATTAAAAAGTTGACTTTACAACAAGAGGAAGAAAGAAAAGAATATCCAAAACCCTGTTGGGTACTCCACTATTGCCTTCATGAACAATGTAGTGAAGTTCCTTAGCCCATTCATGTCTCAGCTTGCTTCTCTGGGAAATGGAAGTGAACTTGTGTGACTTCGAGTCAATAGTGACATACAAGGACAAGGCAGTAGGAGTGGACTGAATTCTAGTCCATTATTGAAATTTGTGACAAATCTGTAGACAACTCCAAATGAGTTCTGGTTTCAGTGCAAGGTAAGACATTAAAAATTGGTATGCTTCTTTTCAGGATTTAGCAAATTTGAAGAAAATACATCAAACTCCCAATGGCATGTCTCTTTATCAGTTTCATTTAAGAAGGAGCCCCTTGGCCAAAAGCCCAGCTTCATCCAGCCTCTGTCAAGCCTCAGGGTGCACAACGGGGAGACAGTCAGATTTCATGCGAGGGTTTCTGGCATTCCCAAGCCAGAAATCCAATGGTTTCATAACCAGCAGCTAATTCTACCAACAAAAGATGTAGTTTTCCATTTTGAGGAGTCCACAGGCATGGCTTTAATGCTTATAGTTGATGCTTACTCAGAGCATGCTGGGCAGTACTCTTGCAAAGCAGCCAATAGTGCTGGGGAAGCCACTTGTGCAGCTACACTCACAGTGACTCCAAAAGGTAAAGCCCATCTTGCTTCAAGGACTTTGATTTGCTGTATACCTCTCAGTCCCACTGTTACTAATGAGAGTCTCTGCTGTTTGTTTTATTGCATACTGTGGTCAGTCCATAACTTACTAATAAAATAACATGCAATAACTCCCGCTAGGTCCTCAATTATGGGTTAACCTACATACTTTAAATTTCACTGAAGTATGTGTTCTATGCACTAGAGAACCAATAATTATTTTATTAGGCACCACCTTTGCTTGGCTTCTTTACTCTTCTAAGCAATATTGTATCATTGCATCATTAAATGATCTATTTGCTGATTATTACTTACTGTACTTAAAGTAAGTACAGTATTACTTACTGTACTTAAAGTAAGTACAGTATTACTTACTGTACTTAAAGCATACAGTGGACGGAGAGCAAATGCTAACCCAAATACAGTCAGCTAGAGGGAGAGAGAGAAAGACAGACTGGGTCACTTTGGATAGCTGAAATGACAACAGAAAGAAGGAACCAGATACTGCATGGCATCTGCATGAGTCTTCATCAACCACTCAGCACTGAATCACCAGGAATGAATTTTCTTTTGTGTGATCCTGACATCTAGATCATATTGCATCTGGCATGCTGCTTTCAAGTGACAACTACGTCTTTCATCTTCATCTTCCATGCCATTTTGTGTTACTAACATGGGCAAGTGACAAAGCTTAGATCTTAATATTCTTTTCTTTTTCTTGTCACTTGATTATACAGTGCAAGCCCTAGATAGGCAAAGTTCTGGGAAAGATGTAAGAGAGTCCACCAAGTCCCAGGCAGTGGCAGATTCCTCTTTCACAAAGGAGGAGAGCAAAATATCTCAAAAGGAAATTAAGTCATTTCAAGGATCATCATATGAATATGAAGTGCAGGTTTTTGAAAGTGTATCTCAAAGTTCCATCCACACAGCTGCATCTGTTCAAGATACACAGTTGTGCCATACTGCATCCCTTTCACAAATTGCAGAAAGCACTGAGCTATCTAAGGAATGTGCTAAAGAGTCCACGGGTGAGGCGCCCAAGATTTTCCTGCATCTTCAGGACGTCACTGTAAAGTGCGGTGACACGGCTCAATTCCTCTGTGTTTTAAAAGATGATTCTTTCATTGATGTAACCTGGACTCACGAAGGTGCAAAGATAGAGGAATCCGAGAGACTGAAACAATCACAAAATGGAAATATTCAGTTTCTTACCATATGTAATGTTCAGCTGGTAGACCAAGGACTATACAGCTGCATTGTACACAATGACTGTGGAGAGAGGACAACGTCAGCAGTACTAAGTGTAGAAGGTGGTTAATTGATTTTTAGCTATGACTTGCTTCATTTCATCCTCATCGCTTTATGCAGCTTTTCTGCCATGCAAATTCAATCGACGAATATATTAATTAGAATATCTCTAAATTAGCACCCTATTCATAAGTGACTTCTGAAAGTCAGCCAAGTCATTGGCCATGATTATCCTGAAAATTTAACTTACCAGTCTAGATTCAGAAAGTTTAATTTTTAAACGTAGGTTCGGGAAGCAAAGGTTTATTTCCTATGTGCTGCATTTTCTAATATTTACCAACGCACTACCAAGAAAGTGTAGCAAAGTTAAAATGTTGTATTCTGAGAAGTACTTATTGGGTATTTATTATTGTGCCAGATACTGTGGTAAATTTCAGTTTAATTGTTTTAATAGCAAGAGGTTCAACAATTCTTATCTCCTCTTTATTTTCACATCTGGAGGTTCTAGTTGTTTACAAAGGGGCCATGAAAATAGAAAATTGGGACCAAGTACAGTGACTCATGCCTGTAATCCCAGCACTTTGGGAGGCCGAGGCAGCCAGATCACTTGAGGTCAGGAGTTTGAGACCAGCCTGGCTAATATGGTGAAACCCCATCTCTACTAAAAATACAAAAATTAGCCAGGCATGTTGGATGTTGGTGCATGCCTGTAATCCCAACTACTCAGGAGGCTGAGGCCAGGAGAATCGCTTGAACCCAGGAGGCAGAGGTTGCAGTGAGCCGAAATAGGGTCACTGTACTCCAGCCTGGGCAACAGAACTAGACTCCATCTCCAAAAAAGAAAAATAGAAAATTGAAAATTGGGCACTGAAAATAACAAAGCTCTCTCTGGACCAAAATTAGAAGTCTCTAGATATTTCTCCATAAATGATGCTGCTTTTACAGGCTTAAAATCCTCCTGGAATTGTATAATTTTCTCATGGCAAGATCACAATTTTTGTCGTTATTGGGCTTGATTCTCCATTATGTCTGGAAGAGCAGGAATAAACTTGTCTGGGCAAGTAATAACTTCTTCCTCTTATCCATGGACTTTCCTTTTGGATATTAATGAAATGAGAAAAATATTTTTCAGGTGCCATAAGCCTGTGTTGTGTGCCCGTAGTCAAAACAGCTTCACTGAGTCTCATGGAAGGAAGCTGGTGGAATAAATTCAGGCATCTCCAGGGGTCTGTGGAAAGCTCTGGCCTCAAGTTCCTCCCTGATCCTGGCCATAGTGGTGTTAGGGATGAAAAGGGGGCAATGCAGTGCTATGTAGGTGCACAGCCATCTCTGCACAGAATTTTGAAACAGTGGCCTTTCTTCCTACCCAGTACAGAGAATACAGTTTATTGATTCATATAATGTATCCGCAACACCTACTCACCAAAAAGAGGTCTTATTCTTTCTTAATGAGATTTTGTTCTATAGCTATCTCTCATTCTGTCACCGTAGCCTACAAAGGCAATATCTCAAGAACTGAGGTCTAGTTATGTAAATTAGATAGAAAATTCCACCAGCCAGAGAGTTGACCCTCAATTTCACTACAGCTGCTGGCTAGCACAGTAATCACACAGAGTCACTATTTATTTGGAGGTGTTGTCTACAAGTCCTGTAGGTGACAGTGTGACAATTTTTTCAGTAATGTAATTGGGAGTTGGCTGTGTTGTGAAGGTGGGAGAAATGTAGATCTCTTAACTCACTTCCTAAAGAATCTAGTGCTATAGTGCGGTGTTTGACTGTCATATTCCCAGAATTGATTTGAACTCGGCTCTTTTGCCCTAGGATCTCCAGTTCATTCAGTTCCAATTGATAATATTATTAAAGTGTTCTTGAAGCAAAAGAATTTTTTTGAACATCCAACTGCCTTACTTGTACCTAAGAAAGTTGAAAGATAAGACATTTTTAGATGTTTGAAGAGTGAAAGATCAGGCACAGTTGTCTAATTATTTGACATAGGCCAGTCTTTATATGTTCCTTTTTTATTTTGGCTTAATAAGTTCATATAGGCTACAGAGTTATCCACCAAGATCAAGTAGGAATGTCAAACCCCTGGAAGTCTTTTTGAATACAGTTATTATGTGCATAATAAACATAAACATATCATATATAAGTTTCATGACTAACATGCTGCCTTTCCTTCTCATCCTAATGACATTCCATCTTCTCCACATTCAGCATGTTTTTCATTCTTACAAACACAGCTAATTTATGCCTTTCCCTAACTTTATTCTTACCTAGCAAAAGAATCGCAAGCCAGAGCACTTACAAAAATTACTCTGGGTTCTGACACTAAAAGTATTAAAACACTCAGAGAGTCACAAATTAAAACAACCCGTGAAGTAAAAAGAGAATCGTCAAAGAAAACATCAAGTTTGTCATTAACTTCATGCCAAAAACCGTAAGAAACTGAGAACAAGGGAATAAAGTCTACTGACAGGATACCACGTGGACTGAAGACTGAGAGTGATACGAGAGCCCCAGCCTTTCCCAAGGAGCTGCCCTAGATATGACTGTGTCTAAAAGCTGTGCATATTCCTTGTGGAATAAAAACAGTTTTGATAAGTCTTTGTTTTGTTTCTTAATATGTAATTTGGACTTCATGTAGTTCAAAGTTTGAAAGGTGATTCAAATCAAAGGAGTGTTTACTAGCAGGAAAAACTGAGAATAGCCCTCTGCTAAAGTAGCAATTTAGAAAATGCATGTTCTTTCTAAATGTGATTTCATCTCTTAGCAAGTGTTTAGTCAATAGGACATTTTTTAGAAAATAATATTCCTTCGGTTTGTAGATTGCTTTCTGCATGCATGTAAAGGCATGGGGAATTATAGAACTAAAAGTGGAAATTTCATGAAGAACCTAAAATAAAAATGTTTTAAATCTTTCTGTCAACATTGTCATGTGTTTTATCAGCTCAATAGTTTGTTTGGCATGGACTTTTTGGTAAATTTGGGGAATGTAGTTTTCTGTTGTTATAATAAAAAGAAAACTTTAATCATACAAGTCATGAATTGATGCAGAAAATATATGCAATTAATCACTAAAATCTCTTTATATGTTTTTCTATTTTAG
>TTN-211,,0,11202,2371800,2383001,GTATTGTTATAATGGATGTGAGATTTAAGTAGAAATTCTAAAGGATTAATAGGATCCTTGAGTTGCCTTCTTTCTCTTAGTATTATTGAGAAAAAAATGACATAGATATACAAATATATCTCTTAGAGTATATATTACTATGTCGCATGCTTGGTTTAGAATTTTGATGGTTACATGCATTTCACAGTAATTTATTGTAAGTTAATTTAAAATTTTGTATTTAAAATTTATCAGCCAAATTCAACTTTATGTTTGCAGTCATTTCCAAAAGTGTATATTAGGAGAAGTTGTCATCTTAATGCATGAAATCATGAAGTAGAAGTTTGTTTTCAAAATCACGGTGAATTACATTGAAAATAGACAATAACCTAGCTGTCATTCTCAGAATGCAATGTCATGAATGAATTATGATTGAAATGCTACTTTACTGAGGTTGTGTGAAAACATTACATTCCCATCTGGTTTACACTTCATTCACATATATCATTTTAACATTGATATGTCTCTTACACTGGCTTGCAGATAGCTGCCTTATGTGATCCTTATTGCCTGCTTTTCTTTGCATAACATTGTGACTTTATGGCTGTATTAGTTCGAATAAACGCCTTCTCATTTTATTTTAGCTAATTATTTATGGTTATAGTTCTTGTATATACTCTTTAAATAGTTGATTCTCAAAAATATAATAATTTAATCTACAATCAAAAGAATCAGAAAGGGCGTTTATTCCACTCTCTGCAAGTCAGGTAAGATTTTCCACTTAGCCATCAAAAGAACAAAGTTTTCCTGCTCTCAAAACAAATATGCACAGGAACATGTTATTTTGAAATGCATTTTTGCTTGTTCAAGAAGAAATTTCAACAGTTTGAAGAAAAGACCAGACAACGAACGATTTTCGTGTCAGAATCTTTTAAACAGAGCATGGTGTTGCGTTTATTCGAACAAATATGGTGAGTGAATTTTTCTATGGATTTGTGAGATCTGTAGCATGCAATTTATTTCATTTCCTATTTTGCAATTTTATTTACTTTCAACTTTTTCAAGTTCTATGGAAAATAGTAAAGGTTTTTTTTTTTTTTTCCAGAATTATTCTCTGAGGGGGAATCTGAACATTCAGAAAGGGATACACGTGACGCCTTTTCAGATTCTGAAGACATAGACCACAAATCCATGGCTGCTAAAAGATATGCAAGTAGAATATCATCTACAAGCTCCTGGCCTGAATATTTTAAGCCTTCTTTTACCCAGAAACTTACATTTAAATATGTTTTAGAGGGTGAACCGGTTGTTTTTACATGTAGATTAATTGCCTGTCCAACTCCAGAAATGACTTGGTTTCATAACAATCGGCCCATCCCAACAGGTCTTCGTCGGATTATAAAAGCTGAGAGTGATTTACACCATCACTCTTCCAGCTTAGAGATTAAAAGGGTCCAAGACAGAGATTCTGGAAGTTATAGGTTACTAGCAATTAATAGTGAAGGGTCTGCAGAATCAACTGCATCATTGCTTGTTATCCAAAAAGGGCAAGATGAGAAATATTTAGAATTTCTGAAAAGAGCAGAACGGACACATGAAAATGTGGAGGCTTTAGTTGAAAGGGGAGAAGATAGGATAAAGGTTGACCTGAGGTTTACTGGCTCTCCCTTTAACAAAAAACAAGATGTGGAACAAAAGGGAATGATGAGAACTATACATTTTAAGACAATGAGTTCTGCCAAGAAAACAGATTACATGTATGATGAAGAATATTTAGAAAGTAAATCTGACATAAGAGGTTGGCTTAATGTAGGTGAAAGTTTCCTGGACAAGGAGACCAAAGTGAAGTTGCAACGTTTAAGGGAGGCTAGAAAAACATTAATGGAGAAAAAGAAATTATCTCTTTTAGATACGTCTTCTGAAATAAGCTCAAGAACTTTGAGAAGTGAAGCTAGTGATAAAGATATTCTGTTCTCTAGAGAGGACATGAAAATCAGATCTATGTCTGATCTAGCTGAAAGTTATAAGGTAGATCATTCAGCTGAGAGTATTGTGCAAAATCCACATGCCCTTTCTAATCAAATGGATCAAAATATAGAATCTGAGGAACTTCCCACAAGCTTTCAAACTATTGTTGATGAAGAAATTTTCCAGACTGAAATAAGAATGAGCCAAGAAGCACTGGTAAAGGAAAGTCTACCAAAAGACCATTTATATGGTGAAATTCTAGTAAATGAAAATACCCAAGCAAGAGGACAGCTGGAAGAAATTATGGCCAATACTACAATTGGAGAGTCATCCACATATATCACTAATGTATGTGAGAAGGAGGAAGTATATGAGACTCCTGAAAATGTGTCTCAAGCTATTACACCACATGCCAGCGAATCTTTTGGTACACTTGTAAATGTTGAAGAAAGTGAAGAAATAGCTAGTGAAAGAATAAAAAAGGATGATTTGAGAGAATTACAACTCTCTGCTTCTACACGAATTGATGAATTCAAAACCGAACAGAAGGAAGAAAACATGAGATTTTTTGAAAATTCTTTTCGAAAACGCCCACAACGTTGCCCACCTTCATTTCTTCAAGAAATTGAATCTCAAGAAGTTTATGAAGGTGACAGTTGTAATTTTGTGTGTCATTTTCAAGGATATCCTCAACCTATAGTGACGTGGTATAACAATGACATGCCAATCCCACGTAATCAAAACTTTATCATTCATTCGTTGGAAAACTATTCAATATTAACTCTTTCATCTGTTCATCATCAGAATGAAGGTTCTATTACTTGTGTGCTATTTAACCAATATGGAACAGTAAAAACAACCAGTATGCTTAAAGTGAAAGCAAAACAAAAACATGATGTCAAAGCACATAAAGTCCCAGTGTTCCATGACTACTTGGATGAGGAAGAAGAGTTAGCATTGGTGTTTGACCAAGCAAAAGGCGCCCATCCATCTATGAGTCAAGAGGGCCAAACAAATCTTCATTTGTTAAAAACTAACCCACCAGTTCCTCCCTCTGGAGACACAGAATTGCTTTCCTTTCCTGTAGAAATTCAGGTAACAGCAGCTACTCCTATCCCAGAACAGGATAAAGAGTCTAAAGAAGTGTTTCAAACTGAGGAGCTGGAACCTAAAGCAATGCCTCAAGATCAAGTTACTCAATCACCAAAACACAGATTTGTATTTTTGTCTGATATTACTAATGAACCACCAAAAATGTTACAAGAAATGCCAAAGCATGCCAGGTGTAGAGAAGGGGATTCCATCATTCTTGAATGTTTAATATCTGGTGAGCCCCAGCCAGTTGTAACATGGTTTCAAAATGGAGTCCTTTTAAAGCAGAACCAGAAGTTTCAGTTTGAAGAAGTTAATTGTAGCCACCAATTATATATTAAGGATGTTAATTCTCAAGATTCTGGAAAATATAAATGTGTTGCTGAAAACAATTCAGGGGCAGTTGAAAGTGTTTCAGATCTAACAGTGGAGCCTGTCACTTATAGAGAAAATAGTCAATTCGAAAATATTGGTGAAATTTATGGAAAATATTCCAGAGATCAGCAACTGCAAGACCAGGGAGAATCTGTAAGGGCACATTTTTATGATTATCCAGCTGGTCCCTTTACTCCCTGGACAAATGTAAAAGAATATTCAGTAAGGGACTATTTTCAAAGCCTTGAGACTATTGAGCAAATAGACCAGAAAGAGCAGGTGCGTTGCATACCTTCTAGAGAAAAAATTCCCAGATTTGTGCATGGTGCTTCAAGAACCATAAAAATCAGCAAGCCCATCAGGGCTGAATTCATACAATGTCAGGCTGAAGGGAAAGAGAGACATGTAAGTGAAAAATCAAAGCTGCACCAAGCAGAGGGTACTGTTTATCCATTTGTTGATGATTTCAGTGATGTCACTATTAAGAAAGAAATAAGAAATAATTTTGGAAAACTTGGTAGATCAGAAAAGGAAAATGTACAAGAATGTGCCCAAAGTGACTATTTACCAAATATTCACTCTGAGAGAATTTCTGACAGTTACAATACAAAAGATTCATCTGCCATTGTATATGAAGAATCCCTTGGTGAAGAGATACACTACCCGGGGAAAAAGGTGAAGCATAGAATTATCGAATTTGAAAAATTACATGTAGAAAAAGGAGTTCTAGAAAAAAGACCTACCAGAACATCAATTGTTAATCCTCCTCAAAAGAAGATTGATGACAAAGCCTTTTCATTAAAGCAAAGAGAATCAAGATCAAGCAATCTAAATGCAAATATGTATCAGGCAGAGAAAATGTCTCCAAATACTGAATCAGATTCATCTAACATTGCAATAAATTTAAAGCTGCTTTCCTCTCAAACTCATAAAGAATTTGACGCACAAGAAAGGGAACAACAGGAAAAAATAAGTCTTATAGATAAACCTGCAATTTCTAAAAGAGCTGAACATGAATCACCTATTACATTTGACTTAAAGCAGTTTCACACTCAAATAAAACACACAGATGTGAAATTCCAAGAATTAGATAGTGGTCAACCAGAAGAAGCTTATTTTAAAATCCAACATCCTGCTGACACTGAGAACATTGTATTTGATCTAAAACAAATGTATTCTCATATAGGAGATCCAGCTCTGGAGTTCCAAGGGCAAGAAACTAGGGAACAGCAGGAAATACATTATAAAGAAAAAATTCCTAGCCCTGAAACGTTACAACCTGACACACACAATATCTCTAAAAGTGTGCAAAATAATGTATTTGCCAGTCAAGAAATTTCTTCCAGTCAAGAGCTTTCAAATAGAACTATGGTGGAGAAAAGTAGTATTGATGAAAATTCCATTTCTTTAGAAAAAGAAGTCCGACATGTACAGGAACAAAACTTAGACATTTTAAAAACTGATCTTTCTCTTAAATCCTTTTCTGAAGAAATCTATAGTGAATCATGTGCCCTACTTCCAACCTCATCTGCAGATATAGAAGAAACTGATCTTTCTGAGAAAAGTTGTCCTCTAGAAAATGGAGGCAGAAGTTCCATCTCACATTTGAAAAAAGCAGCAAGTGAGGAAAAGCCTTTAGGGGTTGGTGAAATGGAAGAAGAATGCACTCTAGAACCAGAGTTGGCAGCATTTCCAAAGCAGGATGGTGGGACACAGGAATATACAGATGCCACTTTGGAAGACCACAGAGGTGATGTTCAGGAAGCTGACACACTCCATAGACAGCTCTCCCTGAGTCAGTGCTTCCCACTCTTGATGACTGAAGAACAACAGAATCCAGGTGAACAAATAAGTACAAACATTCATGCCTCTGGAGAAGAAAAATGTTATGAAGAAGTTCAAGTTCAGAATGAAGCTTCTTTCTCCACTTTAGAAGGAGAAATGATAGAAACTAGTTTTTCTCAAAATATTCCTAAATTAGATGAGGCACATACCACTGAGGCAGCAGAATCTGAGACCTCCCTAACACAATATTTACTTGCTGCTGGAAAGCGTGAGGTTCCTGAAACTAAAGACACCAGAGACCAGGCAAAGCTTGTCCAGAGTGAATCAATCACTTCAATGGAGGTGGAAGAAGTAACTTTCAACACTGTGTATGAATACTACAACCAGAAACAGGAATCACTAGGTCGTCCACTTTCTCCTGAGTCTGACATTTCCATTGGTGTGGGAAGTACAACCAGTGAAGAAATATCTGAGTTAGATCAGTTTTATACCCCACCATCATCTGTTGAATATTTTGAATCTCCAAAGTCCCCTGACTTATATTTTAATCCTTCAGATATAACTAAACAATCCTCAATACATTCAGGAGGTGAGACAGTTGAAAGATATTCCACACCTTTAGGGGAAGTTGCTGAAAGATATTCAACACCTTCCGAAGGTGAGGTAGGAGAAAGATACTCCACACCCCCAGGGGAGACACTAGAGAGATACTCCACACCTCCAGGAGAGACTCTAGAGAGATACTCCACACCCCCAGGAGAGACTCTAGAGAGATATTCCACACCCCCAGGAGAGACTCTGGAGAGATACTCCACACCCCCAGGAGAGACTCTAGAGCGATATTCCACACCCCCAGGGGAGGCACTAGAGAGATATTCTATTCCTACTGGAGGACCAAACCCCACTGGTACTTTTAAAACATATCCATCAAAAATAGAAAGGGAAGACGGTACACCAAATGAGCATTTCTACACACCTACAGAAGAGAGGGGTTCAGCTTATGAAATATGGCGTTCCGATTCATTTGGTACACCCAATGAAGCCATTGAGCCAAAAGACAATGAAATGCCTCCATCTTTTATTGAACCTCTGACCAAAAGGAAGGTATATGAAAACACAACACTAGGCTTCATTGTTGAAGTTGAAGGTCTTCCAGTTCCTGGTGTGAAATGGTATCGAAATAAATCTTTACTAGAGCCAGATGAAAGAATCAAAATGGAAAGAGTGGGTAATGTGTGTTCACTGGAAATTTCTAACATTCAAAAAGGAGAAGGGGGAGAGTACATGTGTCATGCTGTAAACATCATAGGGGAAGCAAAGAGCTTTGCAAATGTAGACATAATGCCCCAGGAAGAAAGAGTGGTGGCACTACCACCTCCAGTAACACATCAGCATGTCATGGAGTTTGATTTGGAACACACCACATCATCAAGAACACCTTCTCCTCAAGAAATTGTCCTGGAAGTTGAATTAAGTGAAAAAGACGTTAAAGAATTTGAGAAGCAGGTGAAAATAGTGACAGTTCCCGAATTTACTCCTGACCATAAAAGTATGATTGTGAGTCTAGATGTTCTTCCATTTAATTTTGTAGATCCAAATATGGATTCAAGGGAGGGAGAAGACAAAGAACTAAAAATTGATTTAGAAGTATTTGAAATGCCTCCTCGCTTTATAATGCCTATTTGTGATTTTAAAATTCCAGAAAATTCAGATGCTGTATTCAAATGTTCAGTCATAGGGATCCCGACTCCCGAAGTTAAGTGGTATAAAGAATATATGTGTATTGAGCCAGATAATATTAAATACGTGATTAGCGAGGAGAAGGGAAGTCACACTCTTAAAATTCGAAATGTCTGTCTTTCTGATAGTGCAACATACAGGTGCAGAGCTGTGAATTGTGTAGGAGAGGCTATCTGTCGGGGATTCCTCACCATGGGAGATTCTGAAATATTTGCTGTGATAGCAAAGAAAAGCAAAGTGACTTTAAGCAGTTTAATGGAAGAATTGGTCTTAAAGAGCAACTACACAGACAGTTTTTTTGAATTTCAGGTGGTGGAAGGGCCTCCCAGGTTTATCAAAGGTATTTCTGACTGTTATGCACCAATAGGTACAGCAGCATATTTTCAGTGCTTAGTTCGTGGCTCTCCAAGACCCACGGTTTACTGGTACAAAGATGGAAAATTAGTCCAAGGAAGAAGGTTCACTGTTGAGGAAAGTGGCACAGGGTTCCATAACCTGTTTATAACAAGCTTAGTAAAGAGTGATGAAGGAGAGTATAGGTGTGTAGCTACAAACAAATCAGGAATGGCTGAGAGCTTTGCAGCACTCACCTTAACTTAAAATGTAATGTTTTAGTGCCTCAGTAATTATTAGCATTGATCTGAGTGCTTTCATATTTTCCAAATTATGTGGATCTAATAAACTTCCAAACAGGTCCACCATATTTGAATTCATTACCTTGGAGACCCCTAAAGAAATAATCTCTATGTAGAAATCTCATCTTTGTAATACATGTAAATATTTTGTTATCTGAACTGTGGAATCATCACTTGTGTCAATCATGCTGTGTAATATCAAACACAATTAAATCTCTCCTTGGCTACCTAATTGTTTGTACTTCTATTTACCCTCATGCCTCCTCCACAAAGTGTTTCAGTGGAATGGACTCTCTTTTAGCAGATAAACCATATATGCAAAAGTACAATGTAAAAGTGGAGACCATATCAGATGACCACGCAGACAAATTGGTAAGGGCAAATCTCTCTGCTCCCATTCTAAGTTATTTTTGGAATTTTAACCCCTTTGCATCCAAACTCATGTTTATTTACTTTGACTTAGAATAGGCAAAACAAACAACAAAAACCAGCTTCTCCCAATTGGCAACTAACTCTATAATCTGTTTGACATTTCAATCTTAATATATTAACTTCATCTCTTTTAAAAATGTTTTCGTTATTAATATTCCTCTTCATAAGTGCTTTAATTCTCACTGGCTTCAAGGGACCAATTGTGCTCTTTGTGGGCAGGGTTCACCTAGACATTTGCAAAATAAGCAAATAGATCTTTCCACTTTTGGAGATACCTTATTTTTCTCCATTTTTGAGATGACATCAAGTGTAAAATGCAGCAATAATTTAGTATTGGCCTGGGGAAAAAAGGGAAACTATCATATTGTGTTTACATATAGATTTTAAAACTGTATTCTGATTTCAGAATCTTTAAAATTTAAAAAAAGGTGGGATATTTTTAGAATTGAGACAATATGGTAATTTGTATTTCAGATTATATATAAATAACAAGATAACAAGCTTTCCTATCAGTTTCACTGAATTTCATCTTTAAAACGAATATAGCTTAATAAGCATTCAATTTTTATTGTGATGTTTATGTTTCTAAAGTAACTCTTTAATTTTGTCTTTTAAAATTAAAATAACAGTAAATTAACATACTCCTTAATATCTTACCTATATACTAATGTGGACCCAAGTCTTCTCATATAAGACTCGACAAATATAAAAAATTCTGAAAATGAAGGGTAGGACCAAAAGACCTTAGAGGTGATCATTCAACAATACAATTCTGTGTTAAGCTAATAGTAATTATTCTTAATACAATTTAGAATAAACTTTAATTTTGTAACAAAGGACGAGAGAAATAATATTACAATGAAAGATAAATTTTATCTCCCTCCACCTCTTAAATTACTTATTGTTACTTAATGGCTACATTTGTCACCTGCATTTAGCAATATTTAAGTACCATTATCATATTTAAAATGCTAATTTTAATTAGAAATGTAAACAATTTAAATTTAATTTTCAAAAGAATTCATATCCAATTATGTTTATTATGTTTCTTTCATCTATCAGTCTTTATTCTCAACATGGGAATTCTCTAACAGCTATCCAAATTAAAGAAGCAATAGAGACAATGTACAGAAAATAGGCAGAGCAGCCAGGCCTCCCCTGCCTCCCTCACAAAAAAAATTTTGAATTATCTGTTTGAGCCACCATAACTCATCAGCATAGATACACTATTGTAGAACAATCATTCCTGTTCCAACCAGTGAGCACACAATATCTGTGATAATAATTATAGACATAATGTAATATATCACATCACAAATTCCTGAAATAAAACTAATTCTATAGATTAGGAACTTAGAGATTTATTCTGCACTTAGTCACATAATGGATGTTAAAATTAACGAGAAACTCAGATTGAGGCAAACATGACAAGCATGCTTTACTCAAACATCATACAGCACAGCAACAGTTCAAACCTTGTTTCTTAAAAAAAGAGAAAGAGAGAAATAGAAAAATGTTTTTATGTCCTACTGGATTTCAGGAAGAGCTGAAAAACACTCTTATTCATATAGTAAAGAGGGCTTTGTTTGGTTTTGCTCATTAGAATTCTGTAATTCTGTTAGTTTCAAGTATGGTGAGCTTGAGTATACGCAGAATAACAGTGACTGAATAAAGAAAAGTAAGCCTTGGCTTACTTTAATTGTCATAGATAATGAAATGGAATTTTTTATTTTCTGACTCAATGGCACGTAACATAAAACCCCAAAATATTAATTTCTCTGATTCTGGATAAAGAATTTATTGTATTGCACATAGTTGAGTTTAGACAATTAATAGCTGCTACCACAACATGTAATTTTTTAAACTATGCCTTTCAAGTTTCAGCACATTTGAATTTCATTTACTATCCTTTTTATGGCTAATAATACCATGGCTTGAAGTAAAATATTTGCAAATAGTTCAACATAGTAGTGAGTAAGGGTATTTTAACTGTATTCACATTCACTCCCTTTACAGATATTTTGTGAGTTCAAGTGAAGGGAAAGGTAACGCGAATTATGTATTGTAGATTAAATGCGAAGTTAAGTGATCACCATTAATATGTAAAATTATCAATGGTTTTATGGTTTACTTAAAATAATAAATACCTGAATATGTATTCTGCATGCTATAGATGAGTTTCTCCAGTATTTTTACAGCCAGCAGACACTTGAGTCCTGTCTTCTAATGCTTATATGCTAGAACAGAAAGGAATTAAGGTGTAAGTCTATTTCATGTGATGCAAGTGAAGTCACCAAATAAAATCATAAAACTGCCTTTTGCTAAGGCAATAAAACTACTAATAACAGGCCTGTTCTACATAGCTAAGAGGTTTAATAAAAAATCGAATTCCTTGTTTAAAATTACATGTCTTTCATCCTGTCATCCAGGATACTGTTTAAAGAGTCTCTGTTATGCACTGCTTTGTTTCTTGCTCAGTGGTTCTGTATAGGTTTTCTTATACAATAAAATACAATGAACTTTTAATATTGGAGTTGTTTTCTCTTATTTTTGATTATCTTATTTTCTTGGCTAATGCCTTATTACAAAGGCTTTGTTCAAGTAATATGGTGATTTACATAGATGAAAGAAGGCCTGCATTTCTAGAAACTGAAAACAGTGGTTCTCTTACAAATCCAAATTAAACATTTCCTGTAGCCTCTTATTTTTAATAATGACTTTAGAGGCAGTAATTAGAACATCAATGGTTTATTTTGGAAATAATCAGTCTTTAACAAAGAAGATTATTCTTAACCTCAAGAAAACTCTAAATATAAATAACAATTCTGGATCTTTTTAGAAGTTGATTTAAATAATGCTGGATTATTATAACTATTTAATTAGCAGTTTTTCAAACTTTAAAATTGGAATTATATCTCAAGAAAAACTCATGAGAGCATTTTTAAAACATGAACTCTATCACAGATGAAGTGGATCAAAAATTGCTTTTGTACAGTATCTATAATTTTGCATAATTTTATATGTTAAGCTAAGAAAAATTTAGAAATGTGCTTTTTGATACATTAATCTTGGAATAATCTAATCATTCCAGGAATAAAGCAGAAGAAGGCCATCAACTGGTGTCTAATTCTTTGATTTCTATTTTTATATTAAATAAAATTTTATAGTAAAATAATAATCATTTTTCCCCATACAG
>TTN-211,,0,780,2383002,2383781,GTTGGATTTTAAGGATAAAATAGATCAAATGCTAACATTCACTGGATTGTAATGATTTAGCTTGCATCACTTAAATTTTCACTTATCTGCCACTTCCAGAATGTAATTTATTTAGAGTAAGAATGAAATCACAGACATAATCATGGTTATGAACTCACCTTTTCCCTTACTGCCCTGTTGGGTGCTATGCTATCATATCCATGGTACTATTTATTTTAAAAATAAAACATATTTTCATATGTTTCATAATACCAATAGATAAGCTTTTAGTTAATTTTCATATGAAGATAACTTTCATAATATGTAATAAAAAGTATCAGTGAACACCTAGCCACTCTGAAATCACTGGTCTCACCCTTAGATTTAAAATAACCATGATTAGTTGTCTGTTTCTTTTTTCTGTTTATTTTTTGTTGTTGTTTCACTTCATCACTTTATTTAGTATATCATGTTTCTTCACATTATTTTCAGTGTTCCCATTCAGCATGGTATATTTAAAGAATATATCATGTTGTTATGCATATAATCCAATAGCATCACATTTTTTCACAATTCACTGCAAAGCAATGATTGAATAGGTTTTTTTTAAAAAAAGCTTATTGTCTTCTTTTGCCTTCAATGATCTTTCTCATTTTCCAGTCACTTGCCTTAAACTGCTGTAATCCATCTCACCAATTTCAACTGTTTTACTCCATTAACAGCAACAAAAGTTAGAAGAAAAACAAAAATGTCATATGCCTGATAAGGAGGCATGTTAATGGACTCTACTTCCCTTTGCAG
>TTN-211,,0,95764,2383782,2479545,GTAAATGCCATACATTGGCACAGATGTTGTCACTTCATTTCATATTGTTGTCCTTTTTGCTTTCTGTACATGTGTGGGAAATGCTTGTATTACCAACTGGAGAGACCAACAACCAAGACAGTAACATGGTAGGTAGGTACTGCAGAGCCTATATGGGATAAGAAATCATTATTTACAGTCACATTTCTACTACTGACCAAAGAAAAAATAATTTATTATTTGAGAACAAAGTTAAGTAATCAAATGAGCTCAGCTTGGCCCTTCATATAAAACATATCAGGACAGTTTGGTGCCACTAAAAAAAAATAATGTCTCAATGTATTTAAAAATTTTAAATCAAATAACCAATTAAGAACAGAATTACAAACTTAAAAAAGTCAGTGTCTAAGTCTAAAATTAAATCCTAATGTAAGACAGGGAGCTAGTATAGGACTGAAAACTAGGATTCTCTCTAGGCATTTTTACTAATTTAAAAATAAGACGGCTGGGCACGGTGGCTCACGCTTGTAATCCCAGCACTTTGGGAGGCCAAGGCAGGCGGATCACAAGGTCAGGAGATCGAGACCATCCTGGCTAACACAGTGAAACCCGATCTCTACTAAAAATATAAAAAATTAGCCAGGCGTGGTGTCACGCACCTGTAGTCCCAGCTACTTGGGAGGCTGAGGCAGGAGAATTGCTTGAAGCCAGGAGGCAGAGGTTGCAGTAAGCCAGGATTGCACCACTGCTCTCCAGCCTGGGCAACATAGCGAGACTCCACCTAAAAAAAAAAAAAGAAAGAAAGAAAATAAGACAACTACACAAATATCCTATTCCCAATTTTCTAATTGATATGTAGGGTGACTTTCAAATAGTTAACACTCATCAAATACTTGAATGCCTTCATTAACCAAAATATTAGTAGCAAGCTTTTCTTCCTTTCTTCCTACCTTCTTTCCTTCCTTCCTTCCTTCCCTCCTTCCCTCCCTCCTCTCTATCTTTCTTTCTTTCTTTTCTTTCTTTCCCTCTTCCCAAGAGAAAGTGTGAGTATGAACTGTGGTTTGAGGACAGGGGTAGAGGTACAGTCAAGCCATACTTGGACTGTTGGGGAAGGCTGTCCCTTGGTCTTCTTTGTCAATGAGAATATCAAGGGGAAGGGCAAATGCAGCACATCTCTTGAATGTGAAAACGATGAGGTTCCCTATAGCTTCCTCTTCTCTACAATCCTTTTACGTGATCCTAAGAAAAACCCAGGCCCATGATGACCCAACCAGTGCTTTTCACTCTGGTCAAAATGTCTCCATAAAACCAAGTACATGATATTATTCATACTGACGCGTTTGGAAGTTTCTTTACTCAAATTAGGTCAATTTAGGAATGCGACTAATATTGAAGCTTCAGATAATAAGAGGAAAGGATAAGGAGGATGACTTAAAAAAATTAAAAAGAGAGGTTCTGAAAGTCTGGCTTCAAGATGCAGAATGGAAAGGGGAAGTTGCTGCTATTAAATATTTTTACAAGTTTGAGTTGGCCTAGAGGATGCATTCATAGTTAAGCCATATAAGAATTTCCAGGCAGTTGACATGAGGGTTAGAAAGACATTACAAAACTACTTCAATCTTCTTATCACTTAATATCCCTACTCTTCAGAAGAGTCAAATACATTTTCTTTATCTTCCTTACATAATCTTCTAATTTGCAGAATTAAAGTATCAGCTCAATAGCTTATCAAATAATTAAACAAGCAGCCACTAAAATGGACAAATCTTTAGTAATGTTACTTAATAAAGGAACGCTTGTCTTTTCTTTGATAGAGACAAGTAAAGTGATGTCTTGCTCCCTTATAAAGAACACTCTCATCCCTTTCCTTTGACAATCTTTTGTTCTTATTAACACATTACTCCATTTTAAATTATGGCTCATGTCTATCTAAAGACTTAACTCATCTTTTCTCTGTCTTGGAATATATAATTACAGCAAGTGCTTTGGTGGGGACTAAATGTAATGCTGGAAAAATTTCTTTTGCAGAGGCATATCCACCAACCTTTCTCTCCAGACCTAAGTCCCTTACAACTTTTGTGGGTAAGGCAGCCAAGTTCATCTGCACAGTGACAGGGACTCCTGTGATAGAAACCATTTGGCAGAAAGATGGTGCTGCACTCTCACCTTCACCTAACTGGAGGATTTCCGACGCAGAAAACAAACACATTTTAGAACTCTCAAACCTTACCATTCAAGATAGAGGAGTTTATTCTTGTAAGGCTTCCAACAAGTTTGGAGCAGACATCTGCCAAGCAGAGTTGATCATCATTGATAAGCCACATTTCATTAAAGAATTAGAGCCTGTGCAGTCCGCTATCAATAAGAAGGTCCACCTTGAGTGCCAAGTAGATGAAGACAGAAAAGTCACAGTTACGTGGAGCAAAGATGGGCAAAAACTCCCCCCAGGGAAAGATTATAAGATCTGTTTTGAAGATAAAATAGCAACACTTGAGATTCCTTTGGCCAAACTGAAAGATTCAGGAACCTATGTCTGTACAGCTTCAAATGAGGCTGGAAGCAGCTCCTGCTCAGCCACAGTCACTGTCAGAGGTAAGAAACGTGTGAATGTATTTTCTAGTCCCTTCTCTGCAAGGAATCCTCAGTAGAAAAACTGTTGGCAAACAATTCAGTCAGTACACTTTGTTATTAAAATAATGTCATTCAGCAAACATTATGGTTTGGGAAAGTCCTGGCATTGTTTGATTTTATTTTTTTAATCCTCTTCAAAGTTCACTTAACTTTTGTTCTTTTAAATTGTCTGCTATTAACAAAGCTTGCTTAAAATTTCTTCTAAGAAAAAACTCCAAGTGTCTGAGCAATTCTTAACTATCTTCTTTTATAAAATTCTTCTTTGTGTAGGTAGTCTGTTTATTGTTGTTTTATTTTAAATCAAGAGACTGGGAAAGTGTCTTAGAATGATAGGAACCTATTAAATGCACCACAGCTTTTACAGAAATTTTGTGGAGATATTTTATGTGTGTTGGGTCTCTTTGTTGTATATGTCTACTTTTCTTTTGCGGAGTTTATGTTTCAGATATCTTCTCCTTTTTCTTTTTTGTAAACTTCATGTAGAGCCACCATCCTTCGTGAAGAAGGTGGATCCCTCTTATTTAATGCTCCCAGGTGAATCAGCACGCCTCCATTGCAAGCTGAAAGGCTCACCTGTGATCCAGGTTACTTGGTTTAAAAATAACAAAGAACTCAGTGAAAGTAACACAGTCCGAATGTATTTTGTCAATTCTGAGGCTATACTTGATATTACGGATGTAAAAGTTGAAGACAGTGGGAGTTACTCATGTGAAGCAGTGAATGACGTCGGCAGTGATAGCTGCAGTACTGAAATAGTTATCAAAGGTTTGTTTACTGAGTTTCCATCCAGTATTTTTCTGAGAAAAGATTTCCCTTTTAATTACTTATTACCCATTACTTACACAATGCTTTCATGCTTTTGTAGAACCTCCTTCTTTCATCAAAACTCTTGAGCCTGCAGACATAGTGAGAGGAACAAATGCTCTACTTCAGTGTGAAGTCTCAGGCACTGGACCATTTGAAATTAGCTGGTTCAAAGACAAGAAACAAATTCGAAGTAGTAAAAAATACAGATTGTTTTCTCAGAAGTCTCTTGTGTGTCTGGAGATCTTTTCGTTTAATAGTGCAGATGTTGGTGAATATGAATGTGTTGTTGCTAATGAAGTCGGCAAGTGTGGCTGCATGGCAACCCACTTACTCAAAGGTTAGTGCTTGAAAAACTAATGTCTCTTTAATAAATTGTCAAACTAGCTTTCTTACCCCATGGAAGAAAAACTGGTACTTTCTTCTCTTGTCCTATCCTTTAAATTTGTTTTGTCTTGGTTTGACCTGGGACCTTGGGAACAAAGTCAGTAACTTTCACCTGGTCTTTTTCCCGAGACTAGTGTAAATATCTATTATCTGATAACAAAAGGGAATAATAAGCCATTTTGTCAGCTGACAAACATGTATCATCTATGCCTCTGTCTCTTGGATGGAATTATAATTATTCTTAACTTTTATTTCTTCTTCTAATTAACACTATGAAATAGTAGTATTGGGACAAGATAAATATAATCTTGAAAAAACTCTTAAATATAGATGGTGTTGAAAGTGTTTGGGAATTGATATGTTTTATATGCTCTCTTTCCTTAACTAGAACCTCCAACCTTTGTAAAGAAAGTAGATGATTTGATTGCACTAGGAGGACAAACCGTTACCCTGCAAGCTGCTGTGAGAGGGTCAGAGCCCATTTCTGTCACATGGATGAAAGGTCAAGAGGTCATCAGAGAAGACGGAAAAATCAAAATGAGCTTTTCCAATGGTGTTGCAGTCTTGATAATCCCTGATGTTCAGATTAGTTTTGGAGGCAAATACACGTGCCTGGCTGAAAATGAAGCTGGAAGCCAAACATCTGTTGGGGAATTAATAGTTAAAGGTTTGTGTAGGAACATTTAAACCTCAAATTGCTATTTAGAATTAAAGTGAAACCCTAACAAGCATTTAGGGTGCTAACTATTTCATACCATTGTAGAACCTGCCAAAATCATTGAGCGAGCAGAACTGATCCAGGTGACAGCAGGAGATCCCGCCACACTGGAGTACACAGTGGCAGGCACGCCAGAACTGAAGCCCAAATGGTACAAAGATGGGAGACCCTTGGTCGCCAGTAAAAAATACCGAATAAGTTTTAAAAACAATGTTGCCCAGCTCAAATTTTATTCAGCTGAGCTGCACGACAGTGGCCAATACACATTTGAGATTTCCAATGAAGTGGGCAGCAGCTCCTGTGAGACTACATTCACTGTATTAGGTTAGTATTTTTAGAAAATGATGCTACATATGCATTTGAAACCCAACAAATGGCCTAAAGTCAATCACTGAGCACTCTTCTATATTGACCTTTTCTCCCTTCTTGTGCAACACACAGATCGAGACATTGCTCCATTTTTTACCAAACCCTTGCGCAACGTGGATAGTGTTGTTAATGGTACCTGCAGACTGGACTGCAAAATTGCAGGCTCCCTCCCCATGAGGGTGTCCTGGTTTAAGGATGGCAAAGAAATAGCTGCTTCTGACAGATACAGGATAGCATTTGTGGAAGGCACAGCCTCTTTGGAGATCATCAGAGTAGACATGAATGATGCAGGGAATTTCACTTGTCGAGCCACAAATTCCGTGGGAAGCAAAGACAGCAGTGGAGCCCTGATTGTGCAAGGTTGGCTGGAGACTTTGCATTTTATCCTTATTAAAGATTATGTTCAAATTAAGTCATCTTCCCTTAGATCAACCCTCTTAACTCTTTGAAATTCTTTCTTATACCCCTTCTTCAGAACCACCCAGTTTTGTAACTAAACCCGGCTCAAAGGATGTTCTGCCTGGCTCAGCAGTCTGCCTGAAGAGCACTTTCCAAGGATCTACTCCTCTCACAATCAGATGGTTTAAGGGCAACAAAGAGCTGGTTTCTGGTGGAAGCTGCTATATTACCAAAGAAGCTTTAGAGAGTTCCCTGGAACTCTATTTAGTAAAAACCTCTGATTCGGGCACGTACACATGTAAAGTCAGCAATGTCGCTGGAGGGGTGGAATGCAGTGCAAACTTGTTTGTAAAAGGTTTGCATTGTTTTCTTGACATCTTTGTGCTAACCTTGTTATAAATTCTTTCCTCTTTCTCACATTTCTTAATAACTTCCTTCCTTCCACAGAACCTGCCACATTTGTTGAAAAGTTAGAGCCATCACAGCTGTTAAAGAAGGGAGATGCCACCCAGCTAGCCTGCAAAGTAACTGGTACCCCTCCAATTAAAATAACATGGTTTGCAAATGATAGAGAAATTAAGGAGAGCAGCAAACACAGAATGTCTTTTGTGGAGTCTACTGCAGTTCTAAGACTGACAGATGTTGGCATCGAAGACAGTGGTGAATATATGTGTGAGGCCCAAAATGAGGCTGGCAGTGACCACTGCAGTAGCATTGTAATAGTCAAAGGTTTGTGTTCACTTTGCCTCTTGTGTTGCCAAAGTTATGGCCCATGGCACAGACCCCTCCTCCCTTAATGCAAATCATTCCTTTTTTACTGTAGAGTCACCTTATTTTACCAAGGAATTTAAGCCAATTGAAGTCTTAAAGGAGTACGATGTCATGTTGCTGGCTGAGGTGGCAGGCACTCCTCCCTTTGAGATCACTTGGTTCAAAGATAACACAATCCTGCGAAGTGGTAGAAAGTATAAGACTTTCATTCAGGATCATCTGGTTAGCCTGCAGATCCTCAAGTTTGTAGCTGCAGATGCTGGCGAATACCAGTGTCGGGTGACCAATGAGGTGGGCAGCAGCATCTGCAGTGCCAGGGTGACTTTAAGAGGTTAGTGTTGGTTCCAGTGAGGGACTGGCTTTTCTGAAGAGTCAATTCTTTTTTTTAAGCCACTTTTGCTATAGGGATAATATTGATTGAGAATTCATTCTTCTGTTAGAACCCCCATCCTTCATAAAGAAGATCGAGAGTACCAGCTCCCTCCGGGGAGGCACAGCTGCCTTCCAGGCCACTCTGAAGGGCTCCTTGCCAATTACGGTGACTTGGCTAAAAGACAGCGATGAAATCACTGAAGACGATAATATAAGAATGACCTTTGAGAACAATGTGGCCAGTTTGTACCTCAGTGGCATTGAAGTCAAGCATGATGGGAAATATGTCTGTCAGGCCAAAAATGATGCAGGAATACAAAGATGTTCTGCATTACTCTCAGTAAAAGGTTGGTTCAGAACGTTTGCCTTGGGTTTGAGGAAGAAATGCAGATGTAAGCCTTTCAGCAGGGTAATGCACAACCCACATCTATCCCTTTGTTTTCTACAGAACCTGCAACAATCACCGAGGAAGCTGTGTCTATAGATGTCACCCAAGGAGACCCAGCCACTTTGCAGGTTAAATTTTCAGGGACTAAGGAGATTACAGCCAAATGGTTTAAAGATGGCCAAGAACTGACCCTGGGCTCAAAATATAAAATCAGTGTCACTGATACAGTCTCAATACTGAAGATTATTTCTACAGAAAAGAAAGATAGTGGAGAATATACTTTCGAGGTCCAAAATGATGTTGGGAGGAGCAGCTGCAAGGCTAGAATTAATGTATTAGGTTGGTATTGTTCTTCTACAGAGAGGATTGGGCATTTCCATGCTCCTTCTTCCCTTAAAATTTAAAAAAAAAAACAAAAACAAATTAGTAGATTGACCTTTTTTTGTTGTTGTTTGCTTTTTCATTGAATAGATCTTATCATACCTCCTTCATTCACCAAAAAGCTGAAGAAAATGGACAGCATTAAAGGTTCTTTCATTGATTTAGAATGTATAGTGGCTGGGTCACATCCCATAAGCATCCAGTGGTTCAAAGATGACCAAGAAATATCAGCTAGTGAAAAGTACAAATTCTCTTTTCATGACAATACTGCCTTCTTGGAAATCAGCCAGCTGGAAGGTACAGACAGTGGGACATACACTTGTTCTGCCACAAATAAGGCAGGGCACAACCAATGCAGTGGGCATCTGACAGTCAAAGGTTGGCAAATTTTATTTCCACTTATCAAGAACTTACAAAATATTTTTGTTTCATTTCTAAATTTTCACCTTTATTGCTAAGTTATAAAATAAAACTTCCTATTTTCTTTTGCTTGTTTTTTCTTTCACCTCAGAACCCCCTTACTTTGTGGAAAAGCCACAGTCACAAGATGTCAATCCCAACACAAGGGTACAGTTAAAGGCTCTTGTGGGTGGCACTGCACCCATGACAATAAAGTGGTTTAAAGATAACAAAGAGTTACACTCAGGAGCAGCCCGCTCAGTTTGGAAGGATGACACCTCTACCAGTCTAGAGCTCTTTGCAGCCAAAGCTACCGATTCTGGAACCTACATTTGCCAACTAAGCAATGATGTTGGCACAGCAACCAGCAAAGCCACTCTCTTTGTAAAAGGTCTGGTCTCTACATCTCCTCACTTTCTTGCTTGTCTAGATTTTCTTGCCTGGGGTGGGCCGGGGCGGGGGACGCTTAAGACAGCAGTTTTGCCCAGTGACCTGTTTTTAAAAATATTCAACATCACAATTCTTTTTCCATCTTTAGAACCTCCTCAATTCATTAAGAAGCCCAGTCCAGTCTTAGTGCTGAGGAATGGACAGTCAACAACATTTGAATGCCAAATAACAGGCACTCCTAAAATCCGAGTGTCTTGGTATCTAGACGGGAATGAAATAACAGCCATTCAGAAACATGGCATTTCCTTCATTGATGGTTTAGCCACTTTCCAGATTTCTGGTGCCAGGGTAGAAAATAGTGGGACTTATGTGTGTGAAGCTCGAAATGACGCAGGCACGGCGAGCTGCAGCATTGAACTCAAAGTGAAAGGTTCGTGAATGGAATCTATTCTCCATTTTGGCTGTGCTGCCTGATAAGTTTGGGGTCTTCCCTTGAGTAAGCTACTGTCTTCCTTTTGAATCTTTAGAACCCCCCACCTTTATCAGAGAGCTGAAGCCTGTGGAGGTAGTAAAATATAGTGACGTGGAGCTGGAGTGTGAAGTTACGGGAACACCTCCGTTTGAAGTCACTTGGCTGAAGAATAACAGGGAAATTCGAAGCAGCAAAAAATACACATTGACCGACAGAGTGTCTGTGTTTAACCTCCATATAACCAAGTGTGACCCTTCAGACACTGGGGAATACCAGTGCATTGTATCCAATGAAGGCGGCAGCTGCTCATGCAGTACTAGAGTTGCCCTGAAAGGTCAGTTATACAAGAAGCAGCCTATCAAATAAAAATTCTGTAACGCTTTTAAATCTTATCATTATGGGTAGGAGTTACAATATGTTTCTTCTTTTCACACTCTCTTATTTAATCACAGAACCACCATCATTCATTAAGAAGATAGAAAATACCACTACTGTTTTGAAAAGTTCTGCCACCTTTCAGAGTACCGTGGCAGGTTCTCCTCCTATTTCTATAACCTGGCTAAAGGATGATCAGATTCTTGATGAAGATGATAATGTCTATATTTCATTTGTGGACAGTGTGGCCACACTTCAAATCAGAAGTGTGGATAATGGACACAGTGGGAGATATACCTGTCAAGCCAAGAATGAGTCAGGAGTTGAGAGGTGTTATGCTTTCCTTTTAGTACAAGGTTTGTAAGCTATTCTCTTTCAAAGATAGTCTATAGCGACAGTTTCATTAGCAGACATTATTTCTAGTGGAGTTACCAATGTAACTCATCCACATTTTCATTTTTACTACAGAACCAGCTCAAATCGTAGAGAAAGCTAAATCAGTTGATGTTACGGAGAAAGATCCCATGACCTTGGAATGTGTTGTGGCTGGAACACCAGAACTCAAAGTGAAATGGCTTAAAGACGGGAAACAAATAGTTCCCAGTAGATACTTTTCAATGAGTTTTGAAAATAACGTGGCCAGTTTTAGAATTCAGTCAGTAATGAAGCAGGACAGCGGTCAGTACACTTTCAAGGTGGAAAATGACTTCGGAAGCAGTAGCTGTGATGCCTACTTAAGAGTGCTAGGTTTGTATCTTCACCCCAGTCAGCTTCCCTTATTTATAGTATGTCCTTTGTAAACAAATAGCAAGAGATTAATGGATGTGTTTTGCTGTTTGCATTGGACAGATCAAAATATTCCTCCATCATTCACCAAAAAATTAACCAAAATGGATAAAGTTCTGGGCTCTTCTATTCATATGGAGTGCAAGGTGTCTGGTTCACTTCCCATTAGTGCTCAGTGGTTTAAGGATGGAAAAGAAATATCTACAAGTGCAAAATACAGACTTGTGTGCCATGAGAGATCTGTGTCTCTGGAAGTTAATAATCTGGAATTAGAAGATACTGCAAATTACACATGCAAAGTGTCAAATGTAGCAGGAGATGATGCATGCAGTGGCATCTTAACTGTGAAAGGTTAGAATTTCTTTACCTCTTCTTGATTCTTCCTTGCGAATGCTTCTTAAATGTATCACTCTTGCCTTTGTATCCTTTAGAGCTAAAATCTCTATGATTCTGGTTCTTTAGATACATATTCATTGTGTTCAAGAAATATTCAGCCATTGCCTCTTTCCAAGAGTGTTTTCTTAAATGTCCATAAAACTGTCACAATAATTCAACTGCAAGCAATTTAATTAAATATATCTCTCTTAAAATCTATAGAACCACCAAGCTTCCTAGTGAAACCTGGGCGACAGCAAGCCATACCTGATTCTACAGTGGAATTTAAGGCAATACTAAAAGGAACACCACCATTTAAAATAAAATGGTTTAAGGATGATGTGGAACTTGTCTCAGGTCCTAAATGTTTCATTGGCTTGGAAGGGTCGACTAGCTTCTTAAATCTCTACTCAGTGGATGCTTCTAAGACTGGACAGTATACTTGCCATGTTACCAATGATGTTGGTAGCGACTCTTGTACTACGATGTTGCTTGTGACAGGTGTGCAAATTTGATTCCTTTATGTTTCTGTCTGACTGTGTCTTTGGTTCTCTGTATTCAGTTACAATGTCTCTAAACAATCAAGAAAGTAGTATTCTTTCTAACATAGTAAACAGTATTTGCTCATGTTTTTCTCTTGCCTGTATACTATCTAATTTAACTATTGTTATTTATTTCTGTTCCCTGATACTCTCCTCTTTCCTGACTCTTTAGAACCACCAAAGTTTGTAAAGAAATTAGAAGCCTCCAAAATTGTGAAAGCAGGTGACTCTTCACGACTTGAATGCAAGATAGCTGGATCCCCAGAAATCAGAGTTGTGTGGTTCCGAAATGAACATGAACTTCCAGCCAGTGATAAGTACAGAATGACTTTCATTGACTCAGTGGCCGTCATACAGATGAACAATCTCAGTACTGAGGACAGTGGAGATTTCATTTGTGAGGCTCAGAATCCCGCTGGCAGCACAAGCTGCAGTACCAAGGTTATAGTAAAAGGTAGACATCTTGTTCTTGTGTTTCTCATTAAATGAAAACCACCTTCTCCCCTGGGTATTATAGCTCTTTATTCATTTACTATCATTTTAGTTTCCATTTGAGATCATAGAATATTTTTCTGAGCTAGTATTATTTCCCTTTTTAGATGGTTTCCTTCTTGAATTTTGCTTACATGTAACTAGTCATTATGAAATATTTTTGTTATTCCAGTGTCATAATTCTGATTACCTCAACACATTTGCCAAACATCAAACGTGATGTTTCAAAACTGCACAAAAAAATGAAGTAGGCATTTTAAAATTAGTCTTTTGCTTTCAATCAACTTACAGATATATCATTCTCACTATAATCTATATCATTAATAACAAGCACTTTTACTATATCTATGCAAAGTGAAAGCAATACAGGTTTTAAACTTATGTTTAAAACAGGACAATAATATTTTTTCCTTCTCTCTCAAGGATCACTTCCTATCCTTTAAAAATTATATGACTATACCTTGGTACAAATAGTATCTGTGTTTTTTTGCTGCAATTTTCCAGTGCTTTTTTTTTTTGTCACAAAGGCCAAGTTTGTCTTGTTTTAAGACAATTATTGCAGTAATCATTTGCTGAAATGGAAGACTTAGATCACGGATGTTGTGATGACTTCCAAGTGTCTGTTATAGAACATATACAAAAAAAATCATCCTTGAAATTAGAATTCCATACTTCATGCAAATCATTATTTATTGCTATACTTGCTTGTTTGCAATTTTTGTATCAATCTTTGTAGCCTAAGATACATCAGTAAGGTGTAGTAGATAGAATGTTGAACTGTTCAGTAACGACATCTAGGATCTATCTGGGTTCTCTGCCCATCTAGCTGGTTATCTTGTGAAGGCAAATGGCTTCTGAGGCTGTTATCCCATGAGAGTGTTAGTGCTGGACTCTACTTACCCATTAGAATATCTTAAACCTTTCTTCCAATTTAAAGACAAATAAAAAATTTTCATTTTGTGAAATTCAGTAGCCCAATTCATGAGAAATTCTTGTTTTTTGCAGAGCCACCTGTTTTTAGCAGCTTCCCTCCTATAGTAGAAACCCTTAAAAATGCTGAAGTCAGTCTTGAATGTGAACTTTCGGGAACACCACCGTTTGAGGTGGTATGGTACAAAGACAAGCGGCAACTCAGAAGCAGCAAGAAATACAAGATTGCATCCAAAAACTTCCACACAAGTATTCACATTCTCAATGTGGACACTTCAGACATCGGTGAATACCACTGCAAAGCACAGAATGAAGTGGGAAGTGATACTTGTGTTTGTACTGTAAAATTGAAAGGTAAATATAGTTCATCCACATGGCAGAAATGTCATAAATGTGCAAAATCCTACTTTTTTCACTCTCGCATGATCTGGACAATCTTTTCAACAATTTCCATCCATCTTTTCCTGTTCAGAACCACCAAGATTTGTCTCCAAACTGAACAGCCTCACTGTTGTAGCCGGAGAGCCTGCTGAATTACAAGCATCCATAGAAGGCGCCCAGCCTATTTTTGTCCAGTGGCTTAAAGAGAAGGAAGAAGTGATTAGAGAAAGTGAAAACATCAGGATTACATTTGTGGAAAATGTTGCAACTCTACAGTTTGCAAAAGCAGAGCCAGCTAATGCTGGAAAGTATATCTGCCAAATCAAGAATGATGGTGGAATGAGGGAGAACATGGCCACACTGATGGTCTTAGGTTGGTACAATAGCCCACGATAGAAACTGGTGCCAAATGCTGGAATGAATTACTAAGAGTTACTGGCAGATTCTTTTTCTGAGTTTCTTCTAGAACTATATTTATCCTCATCTATTTGAAAGGTCTAGAGGAAAGACATAGTTGATCTTTCAAACACTCTTTTCTGTTTCTGTGATTCTAACAAAAATTAGACATCTGTTTTATTGTTTAATAACTACCTGTCTATATCAATTAGCAGATACAATCATGACTCTCTTTGATTAAGCATGAAAGAATACAGAGCCCAGCATGTGCTACAAGAGTAATTGTTAAAACTAACAAGAACTCCAAAGGTTGGCATTTGATAGCAAAGCTTCCACATAAAATTAATGACAATTAAACAATTGTTTGAATAACAACTTTCAAAGAATTGTCTTTAGCACCTTAAGGTAGAGCAAAAATACCAAGTAATTCACAATAACCTGTAGACTTTGATCTACAGAGGGTCAAGTGGAAATCAATATATACTATCTAATGCACATTGTTTAAATTGTTTTGAAGTTGAGTCATGCACGAACATATATTTCTTAAGAATAATTGCTACATAAGACGACAGCAAGAGTGGTGGGAAAAACAAAAAATAAAGAAAAAACTGAAAAGAAAAAATATTAAAATAAAAAATAGCTATAATTCTATGACTGCATGTAATTATGGAATCACACTTTAAAGTCGAGAGAGAGAGCACCCTAACATAACCATCTCACTGGGAGAAACAATCTTAGTGAATGTGATAGTAGAGACAGAGTAAAGATCCCAGACTTTGACAGATGGATATCACGTTTTATTTCAGAGCCCGCAGTCATTGTTGAGAAGGCAGGACCGATGACGGTGACTGTAGGAGAAACGTGCACTCTGGAGTGTAAGGTGGCTGGCACTCCGGAACTCTCTGTTGAATGGTACAAGGATGGAAAGCTGTTGACCAGCAGCCAAAAACACAAATTTAGCTTCTACAACAAAATCTCTTCCTTAAGGATTCTCTCAGTTGAAAGGCAAGATGCAGGCACATACACTTTCCAGGTTCAAAATAATGTTGGGAAAAGCAGCTGCACAGCTGTGGTTGATGTTTCAGGTTAGTTCTGCTGTTTTCTTCTGGTTGCTTATGCAAATTCCTTTTACAAGTTTCCTTCTTTCAAGTCTCTTCTATTCTTTCAAATCATGATGAGTCTCTTACCTTTCCTCACACAGACCGAGCAGTTCCTCCCTCTTTCACACGAAGACTGAAAAATACTGGTGGGGTGTTAGGTGCTTCTTGCATCTTGGAATGCAAAGTAGCTGGATCATCACCTATTTCAGTTGCCTGGTTTCATGAGAAAACCAAGATTGTCAGTGGAGCAAAGTACCAAACCACATTTTCAGATAATGTCTGCACATTGCAGTTGAATTCTCTGGATTCCTCAGATATGGGCAATTACACATGCGTGGCTGCTAATGTCGCTGGGTCTGATGAATGTCGTGCAGTGCTAACTGTACAAGGTCAGTAGACAGTCAAACTTGTAAGGAATTTCTTACAAATTCCTCTTCAGGTGCACATCTATGTTGACAAACATTTGAAAGTGCTCTAATGTTTTATTCAAAATTGCAACTCCATCTGAAGCTTACAGGATCTTTTAATTGTTCTCCATGTCTATATAGAACCACCCTCTTTTGTGAAAGAACCTGAACCTTTGGAAGTACTACCAGGCAAAAATGTAACCTTCACAAGCGTTATTAGAGGAACCCCTCCATTCAAAGTCAACTGGTTCAGAGGTGCCAGAGAACTAGTGAAAGGAGACCGGTGCAACATCTATTTTGAAGACACTGTGGCAGAACTGGAATTATTTAATATTGACATATCTCAGAGTGGGGAATACACCTGTGTGGTTTCTAACAACGCTGGCCAAGCATCTTGCACTACCCGTCTCTTTGTGAAAGGTTTGCTCAAGTGGATTCACTTTTTCTGTTTTCTGTATACCGACATCCTTGTGTTTTTCTTGTGTTTAACTGCTGTGCTTTGTCACTTACTAGAACCAGCTGCATTTTTGAAGAGATTAAGTGATCATTCTGTAGAACCAGGGAAGTCCATAATTCTGGAGAGCACCTACACTGGAACACTTCCAATTTCTGTCACTTGGAAAAAGGATGGTTTTAACATAACTACCTCTGAAAAATGTAACATAGTCACAACAGAGAAAACTTGTATCCTGGAAATTCTGAATAGCACAAAAAGAGATGCAGGGCAGTATTCCTGCGAGATTGAAAATGAGGCAGGAAGGGATGTTTGTGGAGCTCTGGTATCTACATTAGGTGTGTTGTCTTATTGTCTCTTAAATCATTTGCATTCTTCTAACATGTAGCATAGTTTCTTTGATATTCATTAATTCCAGTTGCTAACTGTGAGCCTTTCTTCCTTAGAACCGCCTTATTTTGTTACGGAACTGGAACCTCTGGAGGCAGCAGTTGGAGATTCGGTTTCTTTACAATGCCAAGTTGCTGGGACACCAGAAATTACAGTGTCTTGGTACAAAGGAGATACCAAATTACGGCCAACTCCTGAATACAGGACCTACTTTACAAACAATGTGGCCACACTTGTTTTTAATAAAGTGAACATCAATGACAGTGGAGAGTACACATGCAAAGCAGAAAATAGTATAGGAACTGCTTCTTCTAAGACTGTGTTCAGAATTCAAGGTGATGATATTTTACAAATTAAAAAAATTCTTTTTTCCTTAACTCTTGTATCTTTATGGTGAACTTCTCATTTCATCTCCTAACACCTTAAGTATTACATGTCTCCCTACAGAGCGCCAACTCCCACCTTCTTTTGCAAGACAATTAAAGGACATTGAACAAACTGTGGGGTTACCTGTTACACTCACTTGTCGATTAAATGGCTCTGCACCCATCCAAGTGTGCTGGTATAGAGATGGAGTACTTTTAAGAGACGATGAAAATCTACAGACTTCATTTGTAGATAATGTGGCAACTTTAAAAATTTTGCAAACTGACTTGAGTCACTCTGGCCAGTACTCTTGCTCAGCTTCCAACCCACTTGGAACAGCATCTTCTAGTGCTAGACTCACAGCAAGAGGTTTGTTCACACGTCACTCTTTTTCTTTGCAAACTGTGGCTTCATATTTCATTGTCAAAGTAGAAACGACCAATGGCAAAAAAACAAACAAAAAATACACATTGCCTTTCTTCTCATCCTCCAGAACCCAAGAAATCTCCCTTCTTTGACATCAAGCCTGTATCTATAGATGTTATTGCTGGAGAAAGTGCTGATTTTGAGTGTCATGTTACTGGTGCTCAACCGATGCGAATCACTTGGTCAAAAGATAACAAGGAGATCCGTCCTGGAGGAAACTATACAATCACATGTGTGGGAAACACTCCTCATTTGAGAATTCTTAAAGTAGGCAAAGGAGACTCTGGTCAATATACTTGCCAAGCAACCAATGATGTTGGCAAAGACATGTGCTCAGCTCAGCTCAGTGTAAAAGGTATCATTCCATGACTTTTGACAATATTTGTTCCTTACCATATTTGCATAATTGTCTTATAAAAGTTTCTTTGGTTTTTAAATGTTTGAGAGAAACTAACTGGACATGTTAGAATTTGTGTATTAGTGTTGGAGGCAACATTAATCAAAGTTGTGTTTTCTCTTTATATTGTTCTTTACATTAGTGTAACTCTAAGTGTAATCTTATCAAAAAGTATTGTTTAATTGAAATTTGTTAAATGTTGTTTTAACTATCTAGTCCATTTTTTAATGCTTTCTTGTTATATGGCATTCTGATTTATCATTACTAAATGTTGATCAAATACATCTATAATACATTAACTTTTATGTTTTAACTTACATAGTCAAACTAAAAAAAAGAATCAACTAAATTCTCTATTAAAAATGCACATGTACCCTAAAACTTAAAGTATAATAATAATAAATTTTAAAAAACTAAAAAAAAAATGTTATGAGATTATTTAACTTAAAAGATAACTTATTTTACTGTAAAATCCTCAGAAAGTATATTCTTAATAACAAACCAGTTTAAATATAAATTTATGGGATCTTCAGCTACAAAAACAAGCTCTTTTAACATGTATAATAAATATCCCTTACTGACTGTTTTGTTTGGTTTACTAGAACCTCCAAAGTTTGTTAAGAAATTAGAAGCTTCAAAAGTTGCAAAGCAGGGAGAATCCATTCAACTGGAATGTAAAATAAGTGGCTCCCCAGAAATCAAAGTTTCATGGTTCCGAAATGACAGCGAACTTCATGAAAGTTGGAAATACAACATGTCATTCATTAATTCTGTGGCATTGCTTACGATCAATGAAGCTAGTGCTGAAGACAGCGGGGACTACATTTGTGAGGCTCATAATGGTGTTGGTGACGCCAGCTGCAGCACAGCGTTGACAGTGAAAGGTTAGACACACTAAGCTTCTTTGTTTCTTTATTCTCCTCTGATTTGGGCTCTTAGCAAAGTTATGAGTTCCAAAATAAAAGGATAATTAAGGTTATTTGGTTGCAATTCTTCAACAAGTTTTAATGAATTGTCATTTCTTGTGTCAGCATGTATTGTCATATGATCACACCAGTCACTCTTCAAGGTTCTAGATTTAATTTTTTTTTCCTTTATAGTAAGCAAGTGTTCTCATTGTTTATCTCCTTTTTTCTGGTAGCACCTCCTGTTTTCACCCAGAAGCCTTCTCCAGTAGGAGCTCTTAAAGGTTCTGATGTGATTCTCCAATGTGAAATTTCGGGAACTCCCCCATTTGAAGTAGTATGGGTTAAAGATCGAAAGCAGGTTAGAAACAGCAAGAAATTTAAAATCACTTCAAAACATTTTGATACAAGTCTTCATATCCTTAATCTTGAAGCCTCCGATGTCGGGGAATATCACTGCAAAGCTACTAATGAGGTGGGAAGTGACACGTGTTCTTGCTCTGTCAAGTTCAAAGGTTTGTATACATGGACACAAAAATATATGCCCCTTCCTCCTATCTGTTCTTGCCTAACTAATAACTTGTGTGGCCATGATTCTCACATTTTTTCCTCTAACCACAAATTTCTTTCATCAGAACCTCCACGATTCGTGAAAAAGCTAAGTGACACCTCAACCCTTATTGGGGATGCTGTTGAGTTACGGGCCATAGTGGAGGGCTTCCAGCCAATTTCTGTTGTCTGGCTGAAAGATAGAGGTGAAGTCATCAGAGAGAGTGAAAATACCAGGATTTCATTCATTGATAACATTGCAACCCTCCAGCTGGGGAGTCCAGAAGCATCTAATTCTGGAAAATATATATGCCAAATCAAAAACGATGCTGGAATGAGAGAATGCTCTGCAGTCTTGACTGTACTAGGTTAGTAGCAAAGCACAGCCAGAGAAAAAATCAATTTACTTGATCCATGATCATTTTCCTCAAATATTCCTCTTATCCAGTAATTCAGTGATTGCACTCTTGAGTTTGAAAGGTTACTTTGTTTTCAATGCAAAATACTTCTTCTTTTAGAACCAGCAAGAATCATAGAGAAGCCCGAACCCATGACTGTCACTACTGGAAATCCTTTTGCATTAGAGTGTGTAGTGACTGGAACACCAGAACTCTCAGCCAAGTGGTTCAAAGATGGAAGAGAATTGTCTGCAGACAGCAAACATCACATTACATTCATCAATAAAGTGGCTTCCCTTAAAATCCCCTGTGCCGAAATGAGTGACAAAGGATTATATAGCTTTGAAGTGAAAAACAGTGTTGGCAAAAGTAACTGCACTGTATCCGTCCATGTTTCTGGTGAGTAGAATGAGATTTTTATGAATATACAATATTTCCAGGGGGTGGAGGGGCACAGAATAAAACTTCTCTTTAAACGCAAAACTACCCTTCCCCACATAGATCGGATTGTGCCTCCTTCCTTCATCCGCAAGCTGAAAGACGTGAATGCCATCCTGGGGGCCTCAGTTGTTTTGGAGTGCCGAGTCTCTGGCTCAGCCCCGATTTCAGTTGGCTGGTTTCAGGATGGAAATGAGATTGTTAGTGGGCCCAAATGTCAGTCCAGCTTTTCGGAAAACGTCTGTACTTTGAATCTGAGCTTGTTGGAGCCCTCCGACACAGGCATATACACGTGTGTGGCTGCCAATGTAGCTGGTTCCGATGAGTGCTCAGCAGTCCTGACTGTGCAAGGTCAGTGTGCAAGGATAAAGCTGCTGCTTCTCTAACACCTCTTTCATGTGGACGTGGTGCCTGCCTTCCCTGGAGTTTCTTTATTTTGTCTTCATGTTTAGTCTTAGCTCCCTTTTTTTAAGGAGCAAAAGCACTTCTCACTTGGATTTCTTTCTTCTCTTTATCTCCCCTTCCGCCTTGCAATATCTAGAACCACCATCTTTTGAACAAACCCCTGATTCTGTGGAAGTTTTGCCTGGAATGAGCCTCACATTCACCAGTGTCATCAGAGGCACCCCTCCTTTCAAGGTCAAGTGGTTTAAAGGCAGCAGGGAACTGGTGCCTGGGGAGTCATGCAACATCTCTCTGGAAGATTTTGTCACAGAACTGGAGTTGTTTGAGGTGCAGCCATTAGAAAGTGGAGACTATTCTTGCCTCGTTACAAATGATGCTGGCAGTGCTTCCTGTACCACACATCTTTTTGTGAAAGGTTTGCTCTTTCCCCCAATATATACATCTTTTAAAATTTCTCTTAAGTCTTCATTAGAAGGCAAGAATTTTACCCACATGTTTTCTCCTTATAGAACCAGCCACCTTTGTGAAAAGATTGGCTGATTTCAGTGTTGAGACAGGAAGCCCCATAGTTCTCGAGGCCACATACACTGGCACACCTCCAATCTCAGTGAGCTGGATAAAGGACGAGTATCTTATTTCACAATCTGAGAGATGCAGTATTACTATGACAGAAAAATCTACCATACTGGAAATTCTTGAGAGCACAATAGAGGATTATGCACAGTACAGCTGCCTGATAGAAAATGAGGCTGGTCAAGATATCTGTGAAGCTCTGGTGTCTGTCTTAGGTGTGTTGACAGCTACCTCTTTTTATTGCTCTCTTTCTTTTCAAACATCCTCTTTTACATGGCATGACTGACTTGCTGACTACCATCCTTTGTACCATAGAACCACCGTACTTTATTGAACCTCTGGAACATGTGGAAGCAGTCATTGGAGAACCTGCAACTTTACAGTGTAAAGTGGATGGAACTCCAGAAATTAGAATTTCTTGGTATAAAGAACACACAAAGCTACGATCAGCTCCTGCATATAAAATGCAATTCAAAAATAACGTTGCTTCCTTAGTAATCAACAAAGTGGATCACAGTGATGTGGGAGAGTATTCATGCAAGGCAGACAACAGTGTGGGGGCAGTCGCTTCTTCAGCTGTGCTTGTTATCAAAGGTGATGGTGTTGTTTAACCTAGTGTGTGTGAACAGATTCATTTTCTTAAAAACGTTAAAACTTTTATGAATTGAAATATGTTGTGGATGCCTTCTCACCTGTAAATAAGGATTATCTGTAACTTCTTTACAGCGCGCAAACTTCCACCTTTCTTTGCAAGAAAACTGAAAGACGTTCATGAGACTCTAGGCTTCCCAGTTGCATTTGAATGCCGCATCAATGGCTCAGAACCTCTTCAAGTGTCTTGGTACAAGGATGGGGTTCTTTTGAAAGATGATGCTAATTTGCAGACATCTTTTGTTCATAATGTAGCAACTCTTCAGATTTTACAAACTGACCAGAGCCACATAGGGCAGTATAATTGCTCTGCTTCTAATCCTCTTGGGACTGCTTCATCCAGTGCCAAGCTCATTCTCTCAGGTGAGTAACTCACAGTACCCTCTTCATTGTAAAGCAGCTTCACTGCTCCAGGCCACCAAAAGGCTGGTGCCATTTAGTTTCTGCTCTGTATGTGAGAGCATGGAAATAAAAATCACCATGTTGGTCTTCATTCTTTTCAGAGCATGAAGTGCCTCCTTTCTTTGATCTAAAGCCTGTATCAGTAGATCTTGCTCTTGGAGAAAGTGGTACTTTTAAATGTCATGTAACTGGGACTGCACCAATCAAAATCACTTGGGCCAAAGATAACCGAGAGATTCGCCCTGGAGGCAACTACAAGATGACTTTGGTAGAAAATACTGCCACTCTGACAGTTCTCAAAGTAGGCAAAGGCGATGCCGGGCAGTACACCTGCTATGCAAGCAACATCGCTGGAAAAGACTCTTGTTCTGCTCAGCTGGGTGTACAAGGTACTTGTTAGAGTGAAGGAGCAAGATCTCTTTTACATTTTCAGTATCTTAAAATATAGGAGGGTGGGTGTGCTTGAGAGAGAGCTATGTTTAGGACCAGGGTCTAGTGATGAAAATGGATCAAGTGGATCAAGGACCTTCCAAATGGAGACAAGTATTTTTTAATTACTTTAAAAAAAAAATTTAAAACTAGGAAAACATGGACCAAAAGTCCATTTTAAGAGACTAAAAATAGAGACTAGAGAGAGATAACCGAAACTCTACAAAATTGCAAGAAAATCCTAGTTTGAAAGACGGTATCATAGGACAAAAGCGAAGTTATTGCAAATGACTTTTTTCCCACAGTACTTAGTAAATGAATGGATTTTGTCCCTCTAAGGCATAGCAAAGAGCCAAACTATCAAGCCCTTCAAGGAGAATTCAGATGAGAATGATAAGTTCAACTTACTTTCCTCCACTAGCCCCACTTAAATAATAGTGGAGGTCAGGGGCTGGGGAGTAAGTAGATCAGTATCTGCTATTATGGAAGGCAGTCATGTGTTTCTGCCACATGTTTATCGCTGCTACTGTCAGAAATTAAATAGTTCACTCAATGGACTGCTAGTCTAGTCCATTAGAGTATTTTTAAGGGTTTTTGTAGTGGTGGTTTATAAATATCTTGAAATTAAAATATAATTAGATTTAGCAGCCCATTTGCTCTATGACATATAGCTAATCACTTTTACTTCCCTATGCCTGAATTTTTTGCTTCAGTTAATGAGGAAATCATTACTCTCACACACTTCAAAGGAAAATTATGAAGGTTGAGGAAATACCCATTTAACACCTAAAAGAGGAAAATGGCATTTTAAAAATATTAAGATATCTGACCCACTTTGCCATTCCGGCTCTTCATGCTATGTAACTGATAGCATTGCAGCCTTAGGAAATAGTTCTCCACTGGTTCATATACAAGACAGTAATCAAATTCTCATTCCCCGTGGACCTCAGAGGGCTTCCACTGACAGATACATGCTATTATCTCTGATCTTGGCACTAGAGAAGGGACTCTTTTGCTGGGGAGAGGATGGCACAATAAAGAGTAATGTCTTTTTCTCCTTCTTTTAGTAATAATACTTGATGTGGATGCTTACAAAAACAAGCATATTTTATTTTAGAAATTTTCTATTTAGGTTTCATTTAACTCTTCTTCCTTGAACTGCATAAATTTGTTTTCCAGAGCTAAAGACCTCTCTAGCAAAGATTATTTTTTCCACCTCATCTTGAATTATATGCATCTGTTCCATCCCTTACCCTGTGTTTTTCCTCTTGGTTCCATAGAACCACCCAGGTTCATTAAGAAGCTAGAACCTTCAAGAATTGTGAAACAGGATGAATTCACAAGGTATGAATGCAAAATCGGTGGGTCTCCAGAAATCAAAGTTTTATGGTATAAGGACGAGACTGAAATTCAAGAGAGCAGTAAATTCAGAATGTCATTCGTTGACTCGGTGGCTGTGCTGGAAATGCACAATCTCAGTGTTGAAGACAGTGGAGACTACACCTGTGAGGCCCACAATGCAGCAGGCAGTGCCAGCAGCAGCACATCCTTAAAAGTTAAAGGTCAGCGCTCTCCCCACCTGTGTGTTTTTCACATTAGCCTCCTCTTTAATTGTCCTCTTAACTTCCTGTTTGACTCTTCAACGATGTTTTAAAATAGGGAAAGGACACAACAAAGAATTGAAAGTGTTTTTTTCACTCTCTATCTCTCTGATGGAGTGGAAGATTGATTCTTACTTTTAACTATATACTTACAGAATACATCCGTATTTTCCTTTTTTCCAATTTTAGAACCACCCATTTTCCGCAAAAAGCCTCATCCTATAGAGACACTGAAAGGAGCTGATGTTCACCTTGAATGTGAGCTTCAGGGCACTCCCCCATTTCACGTTTCTTGGTATAAAGACAAGAGAGAACTTAGGAGCGGCAAGAAGTACAAGATAATGTCTGAGAACTTCCTAACCAGTATCCACATCCTGAATGTCGATGCTGCAGACATTGGGGAATATCAGTGTAAAGCCACAAATGATGTGGGAAGCGACACTTGCGTTGGTTCCATCGCTCTCAAAGGTTAGATGGACTGCATTCACTTCTGCTCACTACTTCCCTTCTAATTGTAATACTCTGTTGCCCCCTCCACCCCAGCCCAGTCTTATCACTAGCAGCCTATTCCACTTTCCCTTTGTTTCCTCTCCAAGTCCTTTTCTGTTTAGTCTGCTTCCCTTTTCCAAATCCTACTGAATATCCTTTTAGATAATGTTGTAATTAGGTTTTGATTGGATTAAGAAAGCTGGAGTAGATGAGATATTCAACTTTCCTACTGAATACAAACTTTAATGTGTCCCTGCTCGCATCCACCAAAAATGCCTCTTAAATGGAAATAACACATTATCACTAGTTTGATTCCCGGCATTCACGATTTGAGCAAAATGCTGTCAGTCTCACAAATTTTAAAACCCAGGCTTTCCTCCTTTTTCATCAGCACCACCAAGATTTGTGAAGAAGCTCAGTGACATATCTACTGTCGTTGGTAAAGAAGTTCAGCTGCAGACTACCATTGAAGGCGCTGAACCCATTTCAGTGGTGTGGTTCAAAGATAAGGGAGAAATCGTTAGAGAAAGTGACAACATATGGATTTCTTATTCAGAAAACATTGCAACCTTACAGTTTTCAAGAGTGGAACCAGCCAATGCTGGAAAATACACTTGTCAGATCAAAAACGATGCTGGGATGCAAGAGTGCTTCGCCACGCTATCCGTTCTCGGTTAGTAAAAAGATGATGTTATCACAGATACAAGGCACACACTCACCAGGATCTGTATTTTCTTTAGTTTTTCAATTTGAGTTTAAAATATGGATATCTTTTACATTTCATTCCAGAGCCTGCAACAATTGTAGAAAAGCCAGAATCCATAAAAGTTACCACGGGAGACACCTGTACCTTGGAGTGTACAGTAGCTGGCACCCCTGAACTCAGTACTAAGTGGTTTAAGGATGGAAAAGAGCTAACAAGTGACAACAAATACAAAATAAGCTTCTTCAACAAAGTATCCGGCCTTAAGATCATCAATGTAGCACCGAGTGACAGTGGGGTATACAGTTTTGAGGTGCAGAACCCTGTTGGCAAAGACAGCTGCACAGCTTCATTGCAGGTTTCAGGTTGGTTGATTTCTTGGGCTTTTCCTTCATCATTATAATAATGTAGTTCCTGATTTTCATAAATGTATATGGGTTGTTACATCTTCTATAGGATAACATGAGTCCGACATCTTCTGAATCAGCAAATTCAGAGGCAATACCATCTGTAGAATTAGAAGAAAACCATGTTCAAAAGTTATATCCCTTTCTTTTTGAGGAATTTCCAAAATGATGATAGGAATGAAAAATAGTCCCTGGATAAGGTTAAAGCAGTCTTCATTTATGCTGAAATAATTCACCACATAATTCTTCACGGCAAAGAGAGAACAAAATCCCTAGCAAGTCAACCATCACATTCTGCCCACTGATTCTCCAAGCTTTTGATAGTGTGAACCCATAGAGGAGTTTTTAATACCGTCACAAAAGAGCCAAATGGATCTAGGGATAGTCCATCAAAAAGACAGTTCTCTCTTCAAGTCATTTTATAATTGTTGTCCTTTGTTTTTTTTGTTTTGTTTTGTTTTGTTTTGTTTTGTATCATTCAGACCGAACCGTTCCTCCTTCATTCACAAGAAAATTGAAAGAGACAAATGGTCTATCCGGCTCCTCAGTTGTAATGGAGTGTAAAGTCTATGGGTCACCTCCAATCTCTGTCTCCTGGTTCCATGAAGGAAATGAGATCAGTAGTGGAAGGAAATACCAGACCACCCTGACAGATAATACTTGTGCTTTAACTGTGAACATGCTGGAAGAATCAGACAGTGGTGACTACACATGTATAGCTACTAATATGGCTGGTTCTGATGAATGTAGTGCTCCTTTGACTGTGAGAGGTCAGTTTACAAAACAGTAAAATGAATTGCATTTCATAGTTTATTAAGCATGTTTGTCATAACAATTCACAAATACTAAACCTTTTCTGATATGTGCTTTTGTGTTTAGAACCACCATCTTTTGTTCAGAAACCTGATCCCATGGATGTTTTAACTGGGACCAATGTAACTTTCACAAGTATCGTAAAAGGAACACCTCCTTTCAGTGTTAGCTGGTTCAAAGGTAGCAGTGAACTAGTACCAGGTGACAGATGCAACGTGTCTTTGGAGGATTCAGTTGCTGAACTGGAGTTGTTCGATGTAGATACATCACAAAGTGGAGAATATACTTGCATAGTTAGCAATGAAGCTGGCAAGGCTTCTTGTACAACACATCTCTACATAAAAGGTTTGTCAGACTGCTCTTCTAGATTTATACGATTAGTAATTAGATGTGTCTTTGTCTGTATGTATATGTGTTTGATTTTATATTTTCAATTTGGTCACTTTAGCCCCAGCCAAATTTGTGAAGAGGCTGAATGATTACAGCATAGAGAAAGGAAAACCCCTGATCCTAGAGGGTACATTCACTGGAACTCCTCCCATTTCGGTTACCTGGAAGAAAAATGGCATAAATGTAACTCCTTCTCAGAGGTGTAATATAACTACGACTGAAAAATCGGCAATCCTGGAAATTCCAAGTAGCACAGTAGAGGATGCAGGACAATACAACTGCTACATTGAAAATGCCTCTGGAAAAGATTCCTGTTCAGCACAAATACTCATACTAGGTTTGTCATGATTGCACATTTTTATCTTTGTATACAATCGATGATCTGGCATGTCTCCTTCATGACTGATTGATTATCTCTCTTGGCTGCAGAACCACCGTATTTTGTCAAGCAGTTGGAGCCGGTTAAGGTGTCTGTTGGAGATTCTGCCTCTCTACAATGCCAGCTTGCTGGAACCCCTGAAATTGGGGTATCCTGGTATAAAGGAGATACAAAATTGAGACCCACTACGACTTACAAAATGCATTTTAGGAATAATGTTGCTACACTGGTTTTCAACCAGGTTGATATTAATGATAGTGGAGAATATATCTGCAAAGCTGAAAACAGCGTGGGAGAAGTTTCTGCATCAACTTTCCTTACCGTTCAAGGTGATTGCAATATTTTTAAAGTGAACGAATTTGTGTTTCTTTTGAACAAGATTTAAAATGTCTGGGGAGGCCTATTTTTTAGGAAAATCTTTCCAAAGGCTTAAAATTCTGCTTAAGTAATCCTATTTACAGTTAGTGGCTTATCTTTTTCTATGGATTCTACAGAGAGATAATATGACTAAATCTTTAATTGGAAGGATTATGCAATCATTTGCTTCTATAATTAAATCTTTTTTAAAAAGTGACCATATATTTTTAAATTCCACCCCGTAAGTATCTCATGCAAATTGCTAGAAGGCAGTCTTTAAAATTACAGGAATCTGCTGCTTGCCCAGAGACATGCCTTCAGCCAACCAATTGCTTTATTGGTTTTCATACTGTTTTGCACCTACTGTGCATTAGGGTTGGTCTCAGAGTGATACTTTTGCTCCAGAAATCTATATGCTTTTCTTTATCTCCAAGTTAATTCAAGAGACATTAATAATTCCTGATTTTTAATAGAAATTGCATATATACGTGCGTTTGTATATATATAATTGTGAGAAGAGCATTTAGTAAATTAAAGTATTTGTTACTTTTATTCTGTTCCTACAGAGCAAAAACTTCCACCATCATTTTCTCGACAATTGAGAGATGTTCAAGAAACAGTTGGACTGCCAGTTGTTTTTGATTGTGCCATAAGTGGATCAGAACCTATCTCCGTGTCTTGGTATAAAGACGGCAAGCCATTGAAAGACAGCCCAAATGTACAAACATCATTTTTAGACAATACAGCCACACTCAATATTTTTAAAACTGACCGGAGCCTTGCAGGCCAGTATTCCTGCACAGCTACAAACCCTATAGGCTCTGCTTCTTCCAGTGCCAGGCTCATTCTCACAGGTTTGTGGATTCTTAAACTTTCATTTCTAGAATTAAAGTATTATAATCAAATATGAACTTAGGGAGAAATTTCTATTTCAGTAAACTGACATGGTCCAGATATTGAGCCTGAAACCTTGTCTTTCTGCTCTACTATTAGAGGGGAAGAACCCACCCTTCTTTGACATCCGTCTTGCCCCTGTGGATGCTGTGGTGGGAGAAAGTGCTGACTTTGAGTGCCACGTCACGGGCACACAACCGATAAAGGTCAGCTGGGCCAAAGACAGCAGAGAAATACGAAGTGGCGGAAAGTACCAGATTAGTTATCTGGAAAACAGCGCCCACCTGACAGTCCTCAAAGTAGACAAAGGAGATTCTGGACAATATACCTGCTATGCTGTGAATGAAGTGGGAAAAGACTCTTGCACAGCTCAGCTGAATATAAAAGGTATCGTTTATTTTGCAAGTGGTCCAACAAAAGTGTAATCATTTTGTAGTATAGCCTGAAGGTGTCGTTTTTATGATGATGAATGCAATTTAGGACATTTTTAAACAAATGAAAAGAAAATGTTTAAGAGGAAATAAGTTTATCTAGAGAAGAAGTCATTTTTTAAATCTGTATTTCTTTCTTTCCTCGAGACAGGATCTCATTCTGTCGCACAGGCTGGAGTACAGTGGCGTGATCTCAGTTCACTGCAACCTCTGCCTCCTGGGTTCAAGTGATTCTTGTGCCTCAGCCTCCTGAGTAGCTGGGATTACAGGCGCCTGCCACCATGACCAACTAATTTTTGTATTTTTTGGTAGAAACGGGGTTTCACCATGTTGGCCAGGTTGGTCTGGAGCTCCTGACCTCAAGTGATCCACCCGCCTTGGCCTCCCAAAGTGCTGGGATTACAGGCATGAGCCACCACACCCAGCTTATAATCTATATTTCTAAAACTTTATATATTCCCTATGATACTGAGACTACCCCTTCTTTTTACAAATTTGTGATTCTCTAAATGGCCATGAGTTACTTCTTATCATCCACCTTGTAAGTCAAAGAACAGTTTAGAATAAGCTCGTAGAAGGAGGCTGAAATGTTTAGGAACATATTCTGATATAGTGTATTTAGTTGGTTAGCCTTGATTTTTAACTAAAAATATGAGGGTTTTTTTTCTTGAAAAGCTTCATATTAGTAATCTGCTTCTAGCTTCTACTTCATATATCCTTGCAATTTCTTATAGAGCGGCTCATCCCACCAAGTTTCACTAAAAGACTCTCAGAGACAGTAGAAGAAACAGAAGGGAATTCTTTCAAACTTGAGGGACGTGTGGCTGGTTCCCAACCTATAACTGTTGCCTGGTACAAAAATAATATAGAGATACAACCAACTTCTAACTGTGAAATAACATTCAAGAACAACACGTTAGTGCTGCAAGTCAGGAAAGCAGGCATGAACGACGCTGGTTTGTACACATGCAAAGTGTCCAATGATGCAGGCTCTGCTCTGTGCACGTCTTCAATCGTCATCAAAGGTGAGTTATCCTCACAGCCCCAACCTGTTGTGTTTTTCTTCACTGCCTGTTATATATCCATGAGCATTTCTTATGATATCTTGACCAAGTAAGTTATAACAAATATAAATACACATTATTTAACTGTGTATTTATCACTCCATATGTTTACTAAAAATATAAATTATTGTAATTTAATTATGTGGCTTCCCGAAGGAGGTGTCATTTAACGGACTAATATCTTAGGTTTCTAAATCATATCCTAAAATTCCTTTAGGTAGTTAGAAGTTTCAGCGTACTCTGAAATGTGTGCATATGTGACATATATTTTTATGAAGCACATTTGTTTTGAAATTTTTTTAATGTTCATCACCAAATATCACATTAACTTGACTATTATTGAGTTATATATTATATCACAGTCTGAAACTTTCTCCTTTCCAAGTGTATTTCTAAAGGATTATTGTTTAATGTATATTGCCCAAAGCGTTTGACCTGCAAACAAATATTAATCCCAGACAAAAGGGTAACATTTGCCCAAAAAGAAAAATAATGGGTAGAAAACATTGCATATCATTATGGAAGACATATTTAAATACACAATCATCGCTTGAGAAAATGAAATAGACCATGTTGTTTAAGGATATCTTTATCTGTTTCTCTTCACTGTAATGGCTTCCAGTAATTACAACATAGCTTCATCAAAATCACATTAAAAACTAACCTCCTAGAGCAGCCTGGAATTAATTACCAACTCTTATGATCTGGTTAGTTATCTCACAGTGCACAGGTAGTAAGTTATTATTAATAGGCTGATATCACTAATAAGTAAATATCACTGAGTTGTCTTAAAATTCCAGTTTCACCACTCATTTTGTGGAATTTAGATGCATTTAGTTTTAAAACACATTTTATAAAATGAAAAATATATACTTAGCAGTGGCTTATCTTCATGATTTACACTCATGATGGTTTTACCATGGGCAGATAAATGCTTTCTATAGAATTCTGAAGCTATTTATAAAATGTTTTTAAAGGATAGACATCAGAAGTTTTAATCTTTGCAATAACAAAAAAAATGGCCTTATTCTTTCTAGGTACAGGTCTCAGAACCATTGAACAAAATCATTACATAATACTGAGTTGTACATTGCCTTCCTATCATGTTACTCATCAATGTCTTCATCATTGGTCTTCAGTTAAACACTGAGCCTCAACTCCTAATTCCCTTGGGCTAAGATTGGATTTTAAATGCTACTGTGGCTGCATTTAATAGCTAAAGATGAACATCAGAGAAAATCACATATAAATATGTGGGCTCATGTATTACTCAAATGCTAGCTTTCTTTCCTAGAGGGTAGCAATCATTGCCGCTGGAGATAAGCAGAATTCCCAAATAAGCCCTTCATTTTCAGGGTTCAGCAAAAACACCGCTGTACACAGGTTTGAGAGAATTAATAGTGTGCTATATGGCAAAGAAGTTCATAGTAACTGCCAATGTCTGCAGTGCTTAGTAAGGACACAGAGGCTGGGGCAATTTGTGGGCAGCATGTGATGTGTTCTTTGCTTGTTTTTAAACCTTTATCTTTTTAAAAAATCCAACAAATTTAAACTATTGTCTTTAGAGAGGAATAAACCAGGCACATAATTCTGTCCTACTACAGCAACAGTGTTACCTGTTAGAGGCCAGTTTTTCTCTTTATTTGTTTCTCTTGTGGAATTTAATACTTTTTTGCCTTTATGTTCCTCATGAAAATACCTTTTCAATTCCAGAACCTAAGAAGCCACCTGTATTTGATCAGCACCTTACTCCAGTAACAGTGAGTGAAGGAGAATACGTGCAGCTCAGCTGCCATGTCCAGGGATCTGAGCCAATTAGGATCCAGTGGTTGAAGGCTGGCAGGGAAATAAAGCCTTCAGACAGATGCAGCTTCAGCTTTGCTAGTGGGACAGCTGTACTGGAACTCAGAGATGTGGCTAAAGCAGATTCGGGAGATTATGTGTGTAAAGCTTCAAATGTGGCTGGAAGTGACACTACCAAATCAAAAGTGACCATTAAAGGTACAGACACCTCAAAAGTATTATGCAGCTCAAGCCAGCAACCACTCATGTTTATTTGCTTATTATGATTTCCCTAGAAATGGAATTAGATTTTTAGAAATATCAGTTGTTGCTCATCTGCAATTTGTAGGCTCCTTATTATAATTGAAATATTAGGTAATTTAACAGAAATAATGTCAATACAAAGTATCTGAAATTACTACAAGTTTACCACCCTATTTCTTGAACTTCTTTTCACCATATCCATTAAGATGTAATTAACGCAGTTCCAAAAATGATGCTATAATAATGCGATAGAAAGTAGGCTGTTGTGATACACCTGGAAAAAATAAAACCAAGTCTAAAAATATTGACACTACTAATATGATTATAGTTCAACCTTTGATAGCTATCATTAGCATAAATGTCTGAGAAGCTGCTTTATCTTCTGTAACCCACCCTTACATAGAAAGAGAATTCTGCAGTACTTACTTATCAAACTGCCAACCTCCTAAGGCTTATTTTACAAAGGGGGATATGTATTGTAATTCTGAGGTGATTGTAGTAACAAAACATGTAAATGTTTTTTCAGACAAACCAGCTGTGGCCCCAGCAACCAAGAAAGCTGCGGTAGATGGAAGACTCTTTTTTGTGTCAGAACCTCAGAGTATCAGAGTCGTAGAAAGTAAGTGCACTTCATGAGAAGTACATCTTCATCTATCTTATACCTTTTACTTATGATTTAATTTTGGAAGAACTGATTTTAGAAAATTAAATTTTTATTCACTTGTTTTCATTATTCCTTAGAAACCACTGCGACCTTCATTGCAAAAGTTGGAGGTGACCCAATCCCAAATGTTAAATGGACAAAAGGGAAGTGGAGACAGCTGAACCAAGGAGGTCGTGTTTTCATCCACCAAAAAGGCGATGAAGCAAAACTGGAGATTAGGGACACCACAAAAACTGATTCTGGGTTATACCGATGCGTGGCATTTAACGAACATGGTGAAATTGAAAGTAATGTTAACTTACAGGTGGATGAAAGGAAGAAACAAGAGAAAATTGAAGGCGATCTTAGAGCAATGCTGAAAAAGTGAGTTCAATAAAAACCACAAATCGTACAATCAGCCCTCCATATAAGTGGGTTCCGCATCCACAGTCAACCAGCCCCAGTGGAAAGTATTAAAGAACAAAAAATTTAAAAATACAAATAAACAATACAGCATAACAACCATTTACACAGCACTTACATTGTATTAGATATTATAAGTAATCTAGAGATGAAGCATATGGGAGGATGTGCATAGGTTACATGCAAATACTATGCCATTTTGCATCAGGGACTTGAGCATCTGGCCACAGGCCTCCTGAAGCCAATCTCCCAGGCATAGAGAGGGATGACTGTAATGTCCCATTCACAAAAAGAATCTCTCAAGAGTCATGGGCCATCCATCTCAAGATTCAGATTGTTAAAGAACATAGGCATATAGACATTTTCACAGAAGCAGATAAGCAAATACACAACATCTGGGTGTTCTTGTTTCATTAGAATCAATTTCCGAATTTAAGAGAAAGTTTTAAGAATGAGGTGAATGTCTATTAAGATTTTTAAACAAAAAGAAATGGCCTATAAAGAAACCCCAGTATTGTCTGTGCCTAGGTATGAAACTTTTTTTCTATATATGATTTCTTATGTTATGAATGGTTCTCTAAAACAACTGTTTTAAACATTTTCCATAATTATCATTCATTTCAATATGGTTCATTTTTCAACATAATTATTAAATTAAATCCACACTCAATTTCCACACATCGTTTCCGTGATATGTATACTATTCTATTATTAAAGTTTTCCATTGCTATTATTATTTTTTCTGATATTATAATTCATTAGCTAGGCTCTTTGGTTATAAAGTTTACAGAAATACTTCTATTATCCTTTCCCTTCTTAAAATTTTCATTCCTACATCTATATTTTATTACAATGGTCCTAATCCATCTGATCTTAATCGACTCCATCTCCAAACCCACATTTTTAAATTGTTTCACAGCTAACATGGTAAAATTAATATTTATTGAATAAAGAACATAGAAAACCTTAATGAAGTATATAATCTTTGAATGATGATAGACAATTAAAAATAAGTAGAAGACAGGTGTTTTATCCTTACTTTTTAAATTTTATTTAGGACTCCAATCTTAAAGAAAGGAGCTGGAGAAGAAGAGGAAATTGATATCATGGAACTTCTCAAAAATGTTGATCCTAAAGAATATGAAAAATATGCCCGCATGTATGGAATCACTGACTTCCGAGGTCTTCTTCAAGCATTTGAACTGCTCAAGCAAAGCCAAGAAGAAGAGACACATAGACTGGTATGCTCCTTCATATATAGCATCATGCTAAAAAAGTCACATTTAAAACATCTCACATATTCCCTTTGAATTACCAGAATCCTATAGTTATATGACGTCATTTAATATGACCTAACCAGCATCCAGAATGGAAGCTGAATATAGTCATGCGTCCTCTAAATCAAATTTTGTTTCATCTGTAATGCCTATCATTTTTGTTCTTCTCAGGAAATTGAGGAAATAGAGAGGTCAGAGAGGGACGAAAAGGAATTTGAGGAACTTGTATCATTTATTCAGCAAAGACTGTCACAGACAGAGGTAAAAAGAATTATGTTGATAATAAAATGAACAAGTTATTATTGAGTATTATTATAAGGGAAGGAGTAACAAATGTGTTTTAATTCTTTATTCTCCTAGCCTGTCACTCTGATCAAGGACATTGAAAATCAGACAGTTTTGAAAGATAATGATGCTGTCTTTGAAATTGACATTAAAATTAATTATCCAGAAATCAAGCTTTCGTGGTACAAAGGAACTGAAAAACTGGAACCCAGTGATAAATTTGAAATAAGCATTGATGGTGACCGACATACACTCAGAGTCAAAAACTGTCAACTTAAAGACCAGGGCAATTATCGATTGGTTTGTGGTCCACACATCGCTAGCGCTAAACTAACTGTAATTGGTAAGTTAGAAAAGGCTTATGAAATACTTGTGAGATTTAAATTACTGTTGAGCACATCTGCGTGTGATATTGAACAAAATGCGTGTTGTATCACATGAACAGAGCCTGCATGGGAACGGCATCTTCAGGATGTGACTCTGAAAGAAGGCCAGACTTGCACCATGACATGCCAATTTTCTGTACCAAATGTAAAATCTGAATGGTTCAGAAATGGCAGAATCCTTAAACCCCAAGGTAGACATAAAACAGAAGTGGAACACAAAGTCCATAAATTGACCATTGCAGATGTTCGAGCAGAAGACCAGGGTCAGTACACCTGCAAATATGAAGACCTTGAAACTTCAGCAGAACTCAGAATCGAAGGTGCGTGAAACACTATGGAGTCCTTGTGGGTACAGCATAGGTCAATGGCAAATGTTGTGCAGGACCCCTGCAACCCTACCTGTAGACACACACCAAAGTGGTCATGTGTTCTTATTTCCCAACACACGTTCTCATAGTATTCATCTCAAAGTTCATACAAAAGCACAAGGGAAATATTCAAATGAGTGTCAGTTCTTTTGCATCGTTCTTTTAGATTTTAATCTAGTCTAAGACATAATCTTTAACAGTTATTTCTGTCTAAAGTCTAAATTTCATGATTCTCATATCTAGGATTGTAGAAAGAAAGCTAGGAAAGGACAAGATCTCATAGATGTAAATCTGGAGGATCTTGGCTAGGAATTGATATTTTGTTTATAGGACTTAGTCTGACTTTCTCTGTACAAAATTATATAGATAACATAAACATGTCATGTGCAATTAGCAACTATTTTTCAAAAATATTTATTTCATTTTCAGATCATGTTTCAACCTTCTGAATCTCTGAAATTAAGTGAAATCTCAGAATTTAGGAGTAACAACATTCATTTCCTAATTGATTATACACATTTTCCAAAGACACCCTCAAACTGTATTGAGAAAAATTTTGGCTATGATAATAGCATCTGCTTTCAGCTATTGGTGCCCATTCGTAGTTGCTGAAACACAAATATATGACATTGGATTTACATAAGCATGTCAACTTTTCTGACTTACCTTACAATGAATATCAGTGACTGGTTGTATTTTAAATGGTTTTCAAATTAAAGGGCCAGCTGCAAGTACTAATTATTTTTTAAATAATTGATATTTTTAATATAATTCTTTAGTAAATAGAGCTCACCAGAGTACTGTGATTTCTAAGACTTTATGGTACTGTTATACATATAAGACCCTCCCCTCCAGCCTCTTCTAGAAAGCACTCCTGCCATCCACACACATACTTTGTTTGTGCCCATATGTACTTAGCAGATTTCTGAACTCTAAAATTTTTCTTTTTGAAATTTAGAAGTGCAGATTTCCGATTGCGTTTGAAATTATTTTACAGGAAAAGTTATACATATTAGATAAACAATTATAGATCCTGAATAGCAAAAATTATTTTACTGAGGCAAGAAAGAATTTCACAGAGGAATAAGTTGTAGAGTACAATCAAGTTTGTGTTCCCTAACACTTTTAAAATTTAATTTGACTTTGGGTCATTAGCTCTCTTTAGTATGTTCTTTATATAAATATTTTAAGAACTCACAATAATTTCTTTACACTTTGCTACATTCGACCAGCATGAATACACTTAAGAATTGGGATACTTTTTTGTTAGTGATGCAAAGAAGAGTGCATTTCTTCTCATTTTGGATTTTTGAACTTTTCTTGCTATTTTATAACTGGGTACAAAGATGGAGATTTTAAGTATCTGAGGTAAAAGCAAGTAAAAGAAATTCCTCTCTATATAATCTAACTTTGAACCCTCTTTGTACTTAAACAGCTGAACCAATTCAGTTTACAAAGCGCATACAGAACATCGTGGTGAGTGAGCATCAGTCTGCCACCTTTGAGTGTGAAGTGTCCTTTGATGATGCCATTGTAACATGGTACAAAGGACCAACAGAACTGACAGAGAGCCAGAAATACAACTTCAGGAATGATGGCCGCTGCCATTATATGACCATCCACAATGTGACCCCAGACGATGAAGGTGATTTCATTGACAGTTTTCCAGTGAATGTATAATTTAAGCCTCGTCTGTTTTCTGTATTTCTACCCTGTATGCGCTCATGCTCTCATTCTATCTAGAATGCTTTTTTAGAAAAGACAAGTGTAAATAAACACATACGTATATTGAAGTAAAGAAGTGTTATTTGCAACATATCAGAAAACAAAAGTTGGATGATTTTTCACCCTAGGTGTCTACTCGGTCATCGCTCGGCTGGAGCCAAGAGGTGAAGCAAGAAGCACGGCAGAGCTGTACCTAACGACGAAAGGTGAGGTAGCGCCATCAGAAAGCCACCCTGCCATCTTCGAAACACGTAGCCTACCTATACCATTCTGAACACAAAAATATCATTTTTTTTTTATTTTGCAGAAATCAAACTTGAGCTGAAGCCTCCTGGTAAGTTGTTTTGTAAAAATCAATCCTTGCTTACAATAAATTTGGCATAATTTTGTAAATCACAGAAGCCAAACTAAAATGTATAAGATATCTTTCTCTTTTGGGTAAAATATTTTTCAATAAAACTGTTATGCAGTAGAATTACTTTCAGTCAAATAATAAAATGTTAAACCTTGTGAGTCTGGCAAATTAGAGATAATAAGGTCTCACTCAGCTGATGCTAGAATCATGTTAAATAGAATAGCCACAGAATGAAACAAATTTTGACAGTGAACAAAACTTACCTGCGTGGTTGCATACAAAAGAATACTAATATTATTTTGTCTGTATATTAGATTCTGCCATTAGATATGCCTGACATATCTCAGGATCTAATAAATCAAACACACCTTAGTTTTCTAATAAATAGCTTGTTCTCAGTCTCTCTATGCTTATTACATGTCCCTTTCCAGATATTCCTGACTCCAGAGTTCCAATCCCAACCATGCCTATCAGAGCAGTGCCACCAGAAGGTAAGACCCAGAACCTCAACATCTGAGCTTGGAGCAGCAATATTCTAGCACTAGGAATCTGTACGAAATTTTATACCAGCGACCAAACTGCAGCAGAGTCAGAACAAAACCTTCCATGTCATATTCTTCAGTGAGCAATTAGAAATTAAAGTAAAAAAAAAAAGTAGTTCCAGTTATAAATAAATGCTACTTTTATTTGTTCCGACTGATGAATTCGTACTATAATACCTATGAAGTACTGAAAGAAATGCATGAGACTTTTCATTATATTTTACGCAAAATAAGAAACTAAAACATGTTACTAACGGCATTTATTTTCTTCAGAAATCCCTCCTGTGGTTGCTCCTCCTATCCCCCTTTTGCTACCAACACCCGAAGAAAAGAAACCACCACCAAAACGTATTGAAGGTATTATACCTCATCTACCTAGATGTCGAAATAAGAATTTCACTCTGCTGACCCGAAAAATGTTGCTTAATACAACGCATTGGCCCTCTAGTGGTCAAGAGGTGGAATTGCCTTTCAAAATGTAAATTACTTTCTCAAAGTATTAGCTAACTAAATGTGTAAGTTATGTGCTTAAAACTCTGAAAATCATCAAACAAAATACTATTTTGGTATTAAAATATTTTATTTTAATGAAATTACTGAAACATTAATAGAGAACTAATTTAATGTTTCATATTTTCCTAACTACTATGTATAACAAAAAGAATAATGGAACCAATTTCTAGTGCAGCTTATAGAAATAAACCATAGTAGTTTACAGCCAAATTGCAAATTATAGCTTGTGGCTTTTCTCAATTTATAGTATTAACTACTCTTAAAAATTTACTATTTTGTCACATAAAATATGATTTAGAATACTTATGAAATATTTGACTTCTTTTGTACCTAAGGCATGATCTCACCAATAAAGAGATCTTAAGTGTTCCAAGGAATTGCTCCTCTCAAATACTCAGTAGAGAAGTTGTAGTATTTGTGTCCCAAAGCTTCTCAACTAAATTAGACAACAGATTTCCTGGGACTTTCTGGAGTTATAGGGAGTTCAGAAATGCTGTCAGAATTCTCCCAGCATGGTCAGAAAAAATTCTGTATGTCAAAATCACATTTTTCTATAGCTAAGTCACTACTACTGTATTAGATTCAAGGGGTGGAAATGGTAGGCCCTTAACACCCGCTATAATTGGCATTAAACGCTTGACCTATTTTTCAGCCAGCCTTAGAGGAAATTCAATTAGAAACTTCCAATTTTGTGACTAATGCAACCTCATTAACAAAGAGAAGCATTTTTATGATTCATACGAACATAAGCATTTTATCTAGCTGTGAGAACAGAGAGGAACAAGAATCAACAATCATAAATTGGATTTCCATTTCTATTTCTGTTGTCAAAAATAATAACTTATGTTAATGAATGATTTGTTCTTTGACTGGTAGTATCAACATGGCTAAGTTTGGTACTCACTGTGAAACTTGAGAAGTTAAATAATGTTTTAAAAATTAAAAAAGAGGCCTGGCGCGGTGGCTCACGCTTGTAATCCCAGCACTTTGGGAGGCCGAGGTGGGCGGATCACGAGGTCAGGAGATCGAGACCACGATGAAACCGCGTCTCTACTAAAAATACAAAAAATTAGCCGGGCGTGGTGGTGGGCACCTGTAGTCCCAGCTACTCAGAGAGGCTGAGGCAGGAGAATGGCGTGAACCCGGGAGGCGGAGCTTGCAATGAGCCGAGATCGAGCCACTGCACTCCAGCCTGGGTGACAGAGTGAGACTCCGTCTCAAAAAAAAAAAAAAAAAAAAATTAAAAAAGAGTGGGCTGGGCGCGGTGGCTCACGCCTGTAATCCCAGCACTTTGGGAGGCCGAGGCGGGCGGATCACAAGGTCAGGAGATCGAGACCATCTTGGCTAACACGGTGAAACCCCGTCTCTACTAAAAATACAAAAAATTAGCCGGGCGCGGTGGCGGGCGCCTGTAGTCCCAGCTACTCGGGAGGCTGAGGCAGGAGAATGGTGTGGACCTGGGAGGCGGAGCTTGCAGTGAGCCGAGATTGCGCCACTGCAATCCGGCCTGGGCTAAACAGCGGGACTCCGTCTCAAAAAAAAAAAAAAAAAAAAAAAAAAAAAAAAAAAAAAAAAAAAAAGAGTGTTATTTATTCATGAATACAAAAGGCCATAATCAAGTATGATTAGGAACCGTGGTTAAGGTATAACAGCTGCACAACAAAGGACTTTAAACCCACTTGTTACTCTTCCTCCTAACATATTTGTGTTCGTCCCTAAGGATGAAGCAAAGATGAAAATGTGTACTTTACTATTTATGATATCACTTAGATTCACACTCCATGTTCTGAAAACTTTAACTCTCAGCAGACATAAAATCAGTGAAGATGTAAGATCACAGTACATTTTCTATATCCCTCCAAAACAATTTTTTTGCATCTAGTCCTAGATCTTTCCAAAACAAATATCTTGTAGTAATATGCAGAATCTCGCTACTATCAACATATGGAAAAATAAAATATTTCAATAAAATTCCTAGTTTCCTGAAAGCATTTTAGTTACTTACACCAGAAATATTTTTTCTTTTTTTTTCTTTTTTTTTTTTTTTAGTTACCAAAAAGGCTGTGAAGAAAGATGCCAAAAAAGTTGTTGCAAAGCCCAAAGAGATGACACCACGTGAAGGTATTATAATTAATCAAAAAGCAGTCTTAACACTTTTTTCTTGGCCAAAACTTTTAAATTCTAAACAGTGGAGGGTGAAGGAAGGGTAAGAGTTTGCAATCACAAAATGGTACCTCTCCCTTCACTCACTTTCGCCCTCGTCTTTGACTCAGTCCTCACTCTCTCAACTCCTTTTTTCCCCCTTTTCTCTTTCCTGTCCTCCTGAGCCCCTGGGAACCAATGACAACACCAGTGTATTCTGGTTATTTCTGGATGAAAATTTAAAGAAGGTCTTGCCCAGAAATCCAACAGCTATTCTTTTTTTTTCTTTTTTATTTTATTGTAAATTGACTATTTACTATTGTGTATATATTTATGGGGTACAAAGTGATGTTATGATCTGTGAATACAATATGGAATAATTAAATCAAGCCAATTAACATATCCATCACCTCAAATACTTAACATTTTTGTGGTGAGAATATTTGAAATTTACTCTTAGCGATTTTGAAATGTACAGTACACTATTATTAACTATATTCACCACTCTGTGCAACAGATCTCAAGAAAAGCCATGTTTCTTCTGTCTAAGATTTTGTACCCTTTGACCAACATTTCCCCATTCCCTCAAATCCCCAGCCTCTGTAACCATCATTCTACTCTTTATGAATTCAACTTTTTTAGTTCCACATCTAAGTGAGAACTTACAGTCTTTGTCTTTCTGTGCCTGGCTTATTTCACTTAGCATAATCTCCAGTTCTATCCATGTTGTCACAAATGACAAAATTCCCTTTTTTTATAAGGCTGAATAGTATTCCATTGTGTATTTATATACCACCTTTTCCTTATGTATTCATCCATTGATGGACACTTAGGGTGTTTCCATAACTTGGTCTTTGTGAATAATGCTGCAATGAACATGGAAGTACCCAACAGCTGGTCTTGATAAAGTCACATCAATGTAAGATCAAGGGTTGCTGCTAATTTTAAGAGGTTGCTGCAACCCACCTCAGTATCTTTCCTGATTTAGGTGATCTAAATATCAATATTTGAAGAAAAAATACTTTATGAAGGAGGATCAATTCAAATCACTTTAACTTTCAATATATCCTCGAAGATTTTTAGGAAAACAGTTGGATAACTAAATTTAAACAAATAGTTTTAACTCATTTGACTAAGATTAGAGTACAGCAACCTCCATAAAGAAGGAAAATATGGAAACACAAGGCATCATTCATCATTCAGACTTTTCTGAGTGGTCATTTGTGAAACATCATGGAATAAGAGGACACTCAAAAAGCATGGATATTTCATGAACTTCATAGTTAATAATTGAAAAAGTCTAATGTGTTATTTTTAGCATTGGACATATTAAACATTCTCTTCATGCTTAATGTTAACTTATTAGAAATCAATCTAAACTAGAACCAATTTAAATGATCTTAAATCAATCTAAACTAGAATCAAACTTTGGCCTTTTGCATGTTTGATTTTTGTTAATATGGCCTTGCATAGCATTTCTAATGAGCTAGATTTGGAAATTATAGAAGCATTATTATGATTCCTGGAAGGGCTGGTGTATGAGTAGTAGTCATAGCTCCTACAAACAACTAACAATGATGTGGAGGATTAGTAAACATTAATAATAATGTAATCTAAAAATAAACACACATTTTTATGTTTTTAAACTCCCAGAGATTGTCAAGAAGCCTCCACCTCCTACTACCTTAATTCCAGCAAAAGGTAAATAAAGATAAATTATTTTTATTCTGTTTATTCCTGAGATTTGCACTTCTGCTAACTATTCTTATTTTAAATATTAGGCTTCCAACTTATTGAAAGTTGTGGAGTCTCCTCTGCTGTGTTAAATTTAGCATTAGAAATGATGGCTATTTCATATTGCCCCTTTCCCAGGAAAACAAACCCAGGCAGATGTTTATGCTGCCTCTGTGCAATGGTCTCAGAGAAAGAAGAAGTGAGGGCTAGAAAGGAAGGGCCATTCCTTATTTTTTTATTGTAGTTAACACAAATGTTAAGAGTCATATAAATAATGAGAGCCCTTAAGAACTTTAAAAATCTGTTATCTAAAAGTACCTAATTAACTTGGTTACATAATTTTAAATGTTGTTTTTATGAAACTGACTAAGGGATCATATGCAATAGTCAAAAACCTAGGTTTAAAATTAGAAATGTTTTTGAAATAATAATCAGAACTTTTTAAAAAGGTTAACTGTATAAATATGAAATATAAATTCCATGAACTTATCGAATATTAAAACTATTCCACTGGAAGAAACTAGGGGTTCTGCAAACTGGAGCTCTCATGGAATAATAGAAGGTGTGTCCATTTGATAATATTTATTGAATCCATTTTTTCATACTGGAAAAATCCTCAAATCAAGAGTAGAATGCATCTTGATACTCTACTATGTTCCATAGTCAAAAATTTAAATGGAACCAATACAAAAAAAAAAAACAAATTATCAATAAAATAGATCTGAAATACTGATGTTGTTTAACTAGGTAGATTTTTGTTTAGTGAAGCAGTTGGATGGATAGAATTAATATGCTAATAGTATCTTTATCTATTTTAGCTCCTGAAATCATTGATGTATCCTCTAAAGCTGAAGAAGTAAAAATAATGACTATAACCAGAAAGAAAGAGGTTCAGAAAGAAAAAGAAGCTGTGTATGAGAAAAAGCAAGCAGTCCACAAGGAGAAGAGAGTCTTCATTGAATCTTTCGAAGAACCTTATGACGAACTGGAGGTAGAACCATACACAGAGCCATTTGAACAACCTTATTATGAAGAACCAGATGAAGACTATGAAGAGATTAAGGTAGAAGCTAAAAAAGAAGTTCACGAGGAATGGGAAGAAGATTTTGAAGAAGGGCAAGAATACTATGAAAGGGAAGAAGGCTATGACGAAGGGGAGGAAGAGTGGGAAGAGGCTTACCAAGAAAGGGAAGTAATTCAAGTTCAAAAGGAGGTCTATGAAGGTATGTATAAACTGAATGACTTGTTTCCCTCTTTTCTTCATTTTTGCTCAGTTCATTAAATTTTCAATGCTATGAACCTGATTTGCAGTTTATGTGAAATAGTTAAAATGATCTTAGATTTTTTTAAGGTTAGAAATCTTTTAAAAGTTATTTTCCTCAGAGTTACTTTCATGCTTTGACATTACAAGCTAAATCATTTAGTCTTATTACTAACACTAAATTCCAAGTGCTAATTTCTAATGCAGAAGTTCAAGTTTTACTTTTACTGCCTTGTTGCATCTCTGCTTGATCCTGCTTCAAATCCTAGCACTAAGAATTGTGTTGGTAATAACGATCCCAAATATAATACTTCACACGATTATATATTATCCTTACCTTATCTCATTTGCAATTAACAACCTAAGAGAACTTACCTATTTAAGCATCCCTTCTTATTCCTGTGTTTTTATTTCAGAATCACATGAGAGAAAAGTTCCAGCCAAAGTACCTGAAAAGAAAGCACCACCACCTCCTAAAGGTAAGTAATTAGAAATATTTAAATAGACTAGAGCATCAACATCATTATCATGGCTTGTTTGGCAGCAATGTATAAATCAGCAGTTCAATCCAATAGGCACAACTTCTTCTCTAAGCTTTATTGTGAATGATTTTTTTTTCTTAAAATTTCTATCTAATTGATTTCATTAAAAAATCAAAAGATGATAAAAATTGTAATGGTAAACTTAAATATAACCAAAATATGTTAAGTACAGAAACTTGTACCCAGAGTTCAAAGTTGTGCGTAAAGGTCAAAGAAAAAAAAACCGAACTCATCTCTCTCTTTAAAAAATGATACATGTATCTGCATATACACTTATAGGTGTGTATAAACACATATACACAGAGAGAGAGAGATAGAGAGAGAGAGAATTTTAATAGGAATTCTAAAAGTACTGCAATTTCTCTAAAATGCTTGCAGTTATAAAGAAGCCAGTAATTGAAAAAATTGAAAAGACTTCTCGAAGAATGGAGGAAGAAAAAGTTCAAGTCACCAAAGGTATTATTTAAAACATTCCTAGCACCCATGTACACAAGTAATATGTTTACTGATCTATACTCACATTAGTTATTTATATAATCAAATACTTTTAAATTTTGTGCAAAGCAATATTCTTCAAAATACAAATATATTTGTACATATTTTTAAAGTACCTGAAGTTTCAAAGAAGATTGTTCCACAAAAACCTTCCCGGACTCCAGTACAGGAAGAAGTTATTGAAGTGAAAGGTATACATCTTTGTGTTTCAGCTACAAGTTCAAAATTTTTTTATTTATGTGTATGGACATGTGTACATATATTGCTAAGTAACTCACAAATCTGAAACGACCAAAAACAGCACATTTTTACATAATACAAATTTTATGTTGAGTTGCACATATGTTTAATTTAAATAGTAACATTATCTACTTTGTTTCTAGTTCTGCTTAAAAATTACATTTTTTTATTATAAAGAAGGTTTGTGTTTAATTAGTAGTTTGCTAACTTCACTATGCAATGCATTCCATTGCATATAATATTCCCTGTCCTCTTATTTATAGAAATAGACCCTAACAGATTTGGAAAAGCACAACATTGTGTGTGAAGAAGTTGTGTCTATTTGATTCTCATTTAAGAATGTTTGATGAAGGCTGCATGCATTGTTTGTCCCTATAGATCAAAACATGATTTGTTTTCTTGTCAATACTGAATTTGTTCTCAAGCTACCATATTAACCCACTCATTCTGTGTCTAAATACTTGAGTATAAAATCCATGTGTTTGATCTGATGTCTTGTACTAAAAAAAAGGAATACTAATGTGAAATACTCTCTTTAAAGTACCAGCTGTGCATACAAAGAAGATGGTTATTTCAGAAGAAAAGATGTTCTTTGCTTCTCACACAGAGGAGGAGGTGTCAGTCACAGGTATAAGGCAAACTGGAATGTGGGGGCTCAAATGGAAGGGTTTTAGGCAGATTTTTATCCCTCTTGTTGTCTAATTTGTGATCGTGTAGACATTTCTGTCTCCTTGTAAATTCTGTCATCTTTTTCATTTCATGTTTGTCTCTGTTTTCATTTTTATTTTAATGTTCTTTGTAAATTACAATTACCACCCACAACATGGCATATCAGTAATTAAAATGTACATTTTTTTAAGTCCCCGAGGTACAAAAGGAAATTGTTACTGAAGAGAAAATTCACGTTGCCATTTCCAAAAGGGTTGAACCACCACCTAAAGGTATTAGTAATTCATTCTAAGTTTAAACTCTTTTAATAAAAATTAGTACAAATACCATAGTAAAACATTTATGTTAGTATTAAATAATAGATTTAGTCACAGTGTGCATACCTATAGCCACTATGTACAAAGGATGTGATGGGGGACGGGAAGAACCATGAGGAAGGCACAGGGGGAAAAAAGTGAAAATTATGGGAGGCTCCATTCCCTGCTTCAGAGAGTTTGCAATCTCGTAACCTGTTACTTGGAAATACAGTGTCCTGGAGCCAGTTCATGCTAGCTCACCAGAGCCTATGGTTACATTTTCAGGAATTTTGCCAGTCAGTAGTTTAACACCACCATTATTAAAAATTAGATTATGTAAATTTACAGTCCAATAAAGTATATTTTTAAATATTAATAAATACTCAAAACTCCTATTTTACTGCATTTTGTTCTTATCTGTGTTTCTGAGATTGTTTCCATCTTTGTGTCTGTGTGGTGGAAATGCCATATAATGTACTACTGCACATCTCTTTCCAACTCCAGGACAATGACATCACCTTGACAGCCAGGGTGGGAGGGAGTGTTTATACCACCTTGGAAATCGGAAATCTGCAAGCACTATAGATCAAGGCTCCACCCCCTCCATCCCACCCAAATTGTTAAACATTTAAGACACAAAAAAATCTAATGCAATTGTATTTATGAAACTGCTTTATAAAAGTAAAGGTTACAAAAAAAAAAACTAACTTCATAGTTATCGATGTTCATAAAAAGCTGGTTTCTGAGGAACTGACACAGGCACCTCCGAGGGAGGATTGCTCCTACCTGTTCCTGACAAAGTAGAGGCTTCTGCAGTTAAAGGTGACAGCAGTCACATTTTCTAATTAGCCATTCAGCCATCTTCATTTACTCTCATTTCTAAAGCATAATTTTCTTGCATTCAGTTGGTATAAAAAGGGAATCTCTATTTAATTCTAAGTCTTACAACAACATATGCCTTGTCAAATGCACACTTTCTCAAAAATGGCACTTTTCTTTTAAAGTCCCTGAGCTACCTGAGAAACCAGCTCCAGAAGAAGTGGCCCCTGTTCCTATCCCTAAAAAAGTGGAGCCCCCAGCACCAAAAGGTAGAATAATATTTGTGAAAAAAATAATTCTTAGCATCCATCTTGTATCTTTTTCTATAAGATCTGTGTATTAACAAAATAGCATCTGTAAACCATCTATAATATATTTAATTCTGTGTATATTGATTTCATTTATTTGTGGTGATGTGTTATACAAGTATTGGTAACATTTCTAAACTCCAGATCACGCTAACTGGGTCTTTGTCTGCTTGTGTAATGTATGTAATGTCTATATGGTGTTGAGGTATTTAGCTTTCATTTCTACCACAAGTAGGCATATTTAAATTACTTCCTAATTCTCACACTGTTAGTGAAGATTTATGCTTTAATGTAATCTTAGATGTCTCAGAAGGTGACTAGAATATTCCACATTATTTCAACAATTGTATCTTTAAAGTTCCTGAGGTTCCCAAGAAACCCGTGCCAGAGGAGAAAAAGCCAGTTCCTGTGCCTAAGAAGGAACCTGCTGCTCCCCCAAAAGGTACGCCAGAGCCAATGATGGGGAGACTCTTTGCTCCAAGTGCCAGCCTTTTGCTTTCTACGATCTTCATATGTACTATGCTGCCTTTGTCTTTTGTCTCTTTTACATTCTTCTTGTGTTTTTACTGTTTGTCAGCTTCCGTGCCATGCTCTTGACATACTTTATTTATTATACTGAATATTCCTAAGACATCACCAAAAAGTATTGTTAAAGGAAGTAACTATGTCAAACTGCTATCTTACATTTTTAATATCTTCCCTCTTTTAGAGAAAGAGGAAATGTTTGTGAAACTTGTTTTCTACTGACATGTTTCTAGGAAAAAACCTTTCATCCTTCATAAATGTAACTTTTTCTTAATAAAAGCAGTTTCATGCATTATGAAGAGGTGGAGACAGGCAATGACAACTGGAGAGTGTCTGGCAGAACTGAATGTTAATTACATAAAGACGTACATAGTACCACGCTTCTTAAAAGTCAATAGTGGCGAGTCTTCAATAGTGGGGAACATACAGATTTTTTGAAGTTTACTTTCACCATTTTCTTGAGACCTTAACTGAGCTTCAGTATTTGCCATAAATGTTTCCGTTATCTAATTAGCTAGTCAAAGTACCTTTCACAGAGGTATGTTTGAATGAAAATGTGCTGCTGTGGTATATCACAAATCCCTTGCTTTGGTTTGTTTGGGATTTTTTTGGCGATAAAAGGCACTATCTTATTGAAGCACTGAAGCTACAATTGCACGCATCCATTCAGTTATAGAGAGACTCAGCAAGAATTCAACATTATCCAATTTAGGAGAAACCAGACCTAACTAAAATAGTACATTTTGAATAGTGTTCCCTTGGCCTGACTTTGCAATGTTTCTATTTTCTTCCTGAATCAAATATGCTTCTCTCTTTCTCAAACTCTTGGCTCTTTCAAAATTCTTTTGATTATCTAACCATTAAATACAAAGGTCATGTTAGTAAAACCAATACTAATACTAAAGCTACTTGAGACAGATCGTCTTAGATAAATTAAATCCATTGTTATTATGTACTACATTTCCCCATACAAAGCATAAAGAACCTTTTCTATATACTATCTGAACATTCTTGACTGTTTGTGTAATCACTAATTCGTTTTCAGCAAAGTCATATATGTCTTCTAAAGGAGACACAGAGGCATCTCTCATTTACTCATAAAAACAAATACACATAGTATAATAGCACGTATATATATATAAATACTGCATGTATATATAGCATAACATATACATATATAAATTAACAGCTATATAATTGCACCAAAATATTACAAATGCACGTGCAGAGGTGCAGGGATTCACAAAAGCTGCCAATATTGTATTTAAAATGAGAACAATTATTGCCAATAATGCATGCTGTTAAAATTCATCTTCCAATTAAAAAGTCAACATTATCCATTCTTAGAATAGATAAATCAAATACACTGTAAACATTTTTTAGGTTGAAAACCCTGTTCAAAACTCTAGAGCCCCTTAGAAAAAAAAAGCACAAATACACATACCCACAAAATTCTGCACACAAAGCTCTGTAAAGTCATTAACACATGGGTATCAGATTGAGAGACCTACTCTAGAGTGTTTCCTGAGTTTTGAATTCACTACAGGCACACCCCCCAAAAATGAGAGGAGAAATGTGGGGAAGAGAAGTAAGTTACACATATTCAACTATTCTAAGACTTCTTAGTCTTAGTCTAAAATAGTCTTAGATAAACTAAAGCCATTGTTATTAAGTACTCCATTTCTCAATACAAAGCGTAAAGAAGTTTTCTATATACCATATCCACATTCTTGATTGTTTGTGTCATCACTAATTTGTTTTTAGCAAGGTCATACAATATATAAAGGATGAATTCTGTGCACAACTTTGTTACATAACTCATTTTTGCCTAAATGCCTCTAAAACATTATTTGTGATATTTATCACATTGTGATCCTTGGAATAGTATAGTTAGTTTAATTTTCTGGATAATTTTGCTGATGCATAGATAATCCATAACAACATTAATGTACTACATAAAGATTTGTGCATGTGCCTATGTTCTTTCATAAAAGTGATATATGTCTGAACTAACATTGTGTTTCAAAAACTTTAAGTCCCAGAGGTGCCAAAGAAACCTGTCCCTGAAGAAAAGATTCCCGTTCCTGTTGCAAAGAAAAAGGAAGCTCCCCCAGCTAAAGGTACAGTGGCTTTCGACGTAAAGCCCTATCTTTTATCTTTGATACAAAATATGTTGTGTTTAATTATCTGTTCATTGAGTTAGTTTAATTCTAAATGAATGTTTTGTGGTGAGAACTGAACAAAAGTGTCTGTCCACCCGTCTGCTTTCTTAAAAAAAATAACTGTGCATAGCTACTTTAGAAAATATAAAGTCAATTCTAAAAATGTCTCTTCAAGTTCCTGAAGTACAGAAGGGAGTTGTGACAGAAGAAAAAATAACCATTGTAACTCAAAGAGAGGAATCTCCACCACCAGCAGGTACTTAATCCCATCTCCATGAAATAACCTTGTCTTTCCTTCAAGCCTCTTTAATTGCATGTCTTCTTTAATTGCCACTTCTATGTTGCTCATTTATTTGGCCTTTTTGACAAATTTTAAAATTCAATACTATCCTTTAAGTGCCAGAAATACCAAAGAAGAAAGTTCCTGAAGAAAGGAAACCTGTTCCTCGGAAGGAGGAAGAAGTTCCACCACCACCAAAAGGTATTGTTTCTCCATCTTCCCAAGAACTGTCTTTATGTTCCAGTGATTTTGTTAGTTTTGTGATATGAGTGCACTGTGGGTGTATTTCTTTGTTTTGCACTGGGCTTCAATGAGATCACATTAAATTTCTAAAAGTGCATAATGTCTCTAAAGTGCCAGCTCTGCCTAAGAAACCCGTCCCAGAGGAGAAAGTTGCAGTGCCAGTTCCTGTCGCTAAGAAAGCTCCTCCTCCCCGAGGTAGGATTTGCCTCAATCCTCTGACAAAAAAAAAAAAAAAAAAAAAAAATCTTCGAGTGTGTTAAATTCTTGCTTTTTCCATCTGGTCTGTGCTTATACTGATCCATTGTCTCACTTGCAGTGAAACTTTTGTGTTTATGTCCTTGTGATATGTAACTTGTTTTCCCATTTTGCTAGTCAAAGTGGTGTACTGTGCAACTCTTCCCCAAATTCTAGAAAGTGAGAATTGTTAAAATTCTTGATTTTAAACTTCAACTTTAACACTTTCTTAAAGCTGAAGTCTCTAAGAAAACTGTTGTAGAAGAAAAGAGATTTGTTGCTGAAGAAAAACTATCCTTCGCAGTTCCTCAAAGAGTGGAAGTCACGCGGCACGAAGGTATATAATCGGAAGTCAGGGGATAAATGAGTTTGTGTGTGTTTCCTCAAAGTCTCTTCTTCTTCCACATGTGATTGTTTACTTTAGAACATGTCCTCATCAGTTATTTCTCCTTATGTTGGTATTAGAATGTGTCTACCTTTTGTAGCCTTCTGGGACTGAGTCTTTTGTGTCTATGTTGGCCTTGAATCATTCGAAGGAAGTGGATGAGTCCCGAAAATGTTATAATTTTGAAAGTGGCCACACTTGGACATAACTCAAGTATCATTCTCAGTCTTGGGCTGTACTTGCCCTCATCTTAAATTAGCTTCCTCCTTCTTATAGTGAGGAAGTACCATGAAGCTATGTCCTAAGCAGATAGAAGAACAGTTATCCATCTGTAGTGACCACATGGCTGTATATACATCTGTATCTCAGCAGGCTGAATTTAAATGAAACCTTATCTTTTAAAGTATCTGCAGAGGAGGAATGGAGTTACTCAGAAGAGGAGGAAGGTGTGTCCATTTCAGTTTATAGAGAAGAAGAAAGAGAGGAGGAGGAAGAAGCAGAGGTTACAGAATATGAAGGTAAACAATGCAAATAAGCTAGAGATGATCTGGGGTTTTGATGAGGTGTTTTCTTTCACAAATTGTCTACAGACCAATGAAAAGAGACAGAAAAAAGTGACACAAATTCAGTGAACATCTACCAGTCTCATTAAATGAATATTTTGATCAAAACACAAGATTCAGGAGGATTATACTAGATTAGAGAAATCCAGTGTATTTCTTCTGCATCCCTTCTTACTTGCCTACATAGAATAAAAGAGGCTTCATATTTATATATAATTAATCAGGGCAGGTATCTCCATATACATATATCCTTTCATTAAACAGGACTTGGCTTCAGCATGGTGGGCTGGCATAAGCTTTACCTTAGTAGCCTAATGCCTAATTGGTGTTTCTCAAACATTGCTTGTACCACAATCCACAGACAGAAATATATTTTATATTATAATCCTTTAATTTTTTTATTCTAGGCATTTAAAAAATACAAGTTATAATCCATTAAGTCAATTGCAGAAGTCACTATAATGTCTTAAAATGTTTTAAAATGAGCAAGAAAATATATTACCTCATTACATTCCAGGAGTCAATGCCATATTTGTGAGTCTGAAGCCCTGAACACATAAGGCTTTCCTGTATTTTACATATGGAGAAAACCATTGTGTTATATATGGGATCAGACTGACTTGTTACTCAGATCTTTTCATACCTATAATGCTAATTATCTATAGTTTCTTAAGGACAGAACCAACAAACTATTCCATTGGGATATTTTTTCAATGAATTAAGGCAGCACCAGGTTTCCAACTAAAATCCAGCATTCTGGCTAGAGCCATGTGGCCAAAAGAACTTTCCTAAGAAAGTTCCTAAGGTCTGCTTTTAAAGAGAAATCAATAAGCTCCTTAACCAAACTAACTCTCTCCCCAGTGAGAAGATGAGTAGAATTGAAGTACATTTAGATGTCCCAAGTATCTGTTTTTATCTGTCTAATAAAAGATGGCACACCATGCCCCTTTTTTCACTTGGAACAAAAGCCCATGTAAAAATCCAAGGTGCCATAGTCTTAGTGGAATGCCTTGGAATAGGCCAAGATGGGACATGACTCCCAGGAGGAAATCCATTAACTCTGTTGTGCTTCCTGGAAGAGGCCATGATGGTGGACATAAGTCAGGAAGCTGGTAGATTTGAAGACGACTCCATCTTTTCTAAAAGTGTTTGTAAAACCAAACATAGTCTGATTTCAACTTTTGACACTATAAACTTCCTGTAGTACTCCAGACTCTAGTTAAAAGGAGAAACACTGTGATTATTTTTATGTTCTCATTATGCCCCAAAGATGGGTGGCTTGTTAGGTTTACTTTCAGCGTAAGGAGCAGATATGTTTTTAACCAGACACTTCTATTCCTTATTTAACTTTGACCAGGCATGGTGGCTCATGCCTATAATCCCAGTGCTTTGGGAGGCTGAGAAGGGAGGATTGCTTGAGCACAGGAGTTCAAGACCAGCCTATGCAACATAGCAAGCCCCATTCTACAAAAATTAAAAAAACAGCTAGGCATGGTGGCATGCACCTCTAGTCCCAGCTACTCAGGAGGCTGATGCAGGAGGATCATTTGAACCCAGGAGTTCGAGGTTACAGTGAGCTGTGATTACACCACTGCATTTTAGCCTGGGCAACAAAGCAAGACATTGTCTTAAAAAAAATTAAAACTGGCCGGGCGCGGTGGCTCACGCCTGTAATCCCAGCACTTTGGGAGGCCGAGGCGGGTGGATCACGAGGTCAGGAGATCGAGACCATCCCGGCTAAAACGGTGAAACCCCGTCTCTACTAAAAATACAAAAAATTAGCCGGGCGTAGTGGCGGGCGCCTGTAGTCCCAGCTACTTGGGAGGCTGAGGCAGGAGAATGGCGTGAACCCGGGAGGCGGAGCTTGCAGTGAGCCGAGATCCCGCCACTGCACTCCAGCCTGGGCGACAGAGCGAGACTCCGTCTCAAAAAAAAAAAAAAAAAAAAAAAAATTAAAACTGTATACACTTAGGCTCAAAAATCATGTGAAGCCTCCTGCCTCTTCTACCATACCTGCCCCACAAAACTGGCGGGGAAAACAATATGGAATATTATCTTACAATTCACTTAAATCCTCAAGTATGTTTCTGCCCTGTGGCCTTCAAATCTACAGTGCTCTGCTATTTGTGAAACTCATCTTCAAATTCTTCTGTTCTTATTAACTCAGCTATTATAATCGTTTCTTGTCCCGTACTTGTCCTGTCGTTGCTGTGGATATAAGCATTATTATCTGTATGACACATTTGAAAATTAAGTTAATGAAACCTATTTCCCATTTCCCATACTCTTCATTAACGCATGTGCTTTGATTAAAATGCTCTTTGAGTATTTTAAATAGGAACAAGCAGGGGTTTGGCAAGGGTTAAACTTTTGCTATTTTGATTACTCTTTGAAGTGATAAATTAAAGCTAAAAATAAACATGAAAAACACTGTAATTTATCTTCTTTAAAACTGCTGTCTTTAAAGTGATGGAAGAGCCTGAGGAATATGTTGTGGAAGAAAAGCTGCACATTATTTCTAAGAGAGTGGAAGCTGAGCCAGCTGAAGGTATGCTGACTCTTTAATTAGTTTTATCCCTATGTTAGCTTGTCTCCTTCTTTATGTTTCCTTATAGCTAATTTGTCATCCATATTGCAAATATTGATAAATATCATGTCTAATAAAAAGATCCCTTACACTTTTATCGAAAAGAAATCTAGACATTTCTACAAACATATTTTATAATCTTTTCAAGTGACAGAGAGGCAGGAGAAGAAAATTGTACTGAAACCAAAAATTCCTGCTAAAATAGAGGAGCCTCCACCGGCTAAAGGTATGATTTCTTTCAAAGAAATGCAACACTATTTATTTTAATGTATATAATAATACCTTCACATTTGCATAACTGTCTTATGCATAACAATTTGCATAACTGTCTACGTTTTGTCAGAACACATGTATGAACGTATTTACTGAGTATAGTCATTAACGTTTGTATATATGTGCAATCTTTTCAAAAAGTGAATGCTAAGCCCCACAACTGTGTCACTTCATATGTAAGGCAAACTCATATTCTTAAACCTAATCTTTCTAAAGTTCCTGAAGCACCTAAGAAAATTGTGCCAGAAAAGAAAGTTCCTGCTCCAGTTCCTAAAAAGGAAAAGGTGCCCCCACCTAAAGGTATATTGGATTTTATTTTATTCTCAAGACTGTCTTTTTTTAATCTTAAATTGATACATTCTTCAGATTTTTTAAACATTAACCAGAAAATAAGTGTGCCTGTGTTTAGTGTTTTCCATATCGTATGTTTGATGGTATTGCCTGGTATCTTTTAAGTGCCAGAAGAGCCAAAGAAACCAGTTCCAGAAAAAAAGGTTCCTCCAAAAGTCATTAAGATGGAAGAACCTCTCCCAGCCAAAGGTAAACAAACCTCCCCAGCAGAAAAACTAGGAACATATGGCTTGTCTTTCTTTCTCTCTGCTGCTGTTCTTTGGGTCATACTGTTTATATGTTGGTGGGTGACAATGGTGTCTTTGGGTAGAGTATTACTTGTGATGTTTTTGTGTGTGTGCCTTGTAAATTCTTCTATTCTAAAATCACAGTACTTTCTGGCTAGTATATTTTTTACGTCCACTTTGATATAACTCCCTAATCCTAAAATTATCTTTTAAGTGACTGAGAGGCACATGCAAATTACCCAGGAAGAAAAAGTTCTTGTTGCTGTAACTAAAAAAGAGGCGCCTCCAAAAGCAAGAGGTACATCCGCCCTTCCATTATGCACAATATTGTACTTGCCCTACTCTCTTTACCAAATACACTGGTTATGGGGGCTGGTTTTTGTTGTTGTTGTTGTTGTTGATGTTGTTGTTGTTGTTACAGTTGTTGTTTTATGTTTGAAATAATGAAAATGTCAAGTGTTTATGTTTGGGCTACTACTTTATGGCTGCCTTTTTGTGGTTTGAAAGAGGGAAACAATACTTTAAAGTGAAATCTCTCTTTAAAGTGCCAGAGGAACCGAAGAGAGCTGTCCCAGAAGAAAAAGTTCTGAAACTCAAACCTAAAAGAGAGGAGGAACCACCAGCTAAAGGTATACTGACTCTTAAAAAAAAAAAAAAAATCAAAATAAGCATCCAGACACTAAAACTAATCTAGTGGAATAGGTTCCATTAGAAAAAAAAAGACATAGTATAAAGTAAGCAATATAAGTTTGTTAATGCATATCACTTCAAAACTAAACATTTTTGATAACAGAAAGTACTTTTTTCTTAAAAAAAAGTGAGGCTTCTTCTAAACGTATGTGAATAATTTTCCTTAATCTGTATTTGTCTTCTAATGTCTTTTCCATATACTAAACTCATCTGCCTAGATGCTTGCTTTATGTGGCAATCTCTGATGAAATTTTTAATTTTTTCAATTCTGAATTTTCTACATTGTACCAATAGAGCTAAGGAAAATGTCTTAGAAGTGAGGTGAAGAAACTATTCATGTAACATAGGTTTCTGTCTAATGCTTCTACTTAGTTTGATAGTCATTATTTATGCTGTTTAGTTGTCTTTTTAAACTTTTATAAATACTACTTGATTTTCCTAAAATTATTCAATGTCTTTGACGTACTTCATATGTATATTAGAGTAAGTTTATTTCCAAGTCTATTGATTTTCTTGCTTTTTAAATGAAAGTTTAATCAGGCACTGTTATGGTTGTCTTTGTCCTTGAATTGTTTGAACAAAATTTCTCTTCACACACACATTTTCAGAATCTTGCAATTCACTTTTAATAATTACTCCTTTAAAGTGACTGAATTCAGAAAAAGAGTGGTTAAAGAAGAAAAAGTATCAATTGAAGCTCCAAAAAGAGAACCTCAACCCATCAAAGGTATATTGAACTTTGATTAAGTAATGTGAGGCATGAAACTATCTGGCTCTTTGCCTTCTAGTTCCCAATCTGACTCCTATACTTTATTAGCTTATTGTTGATTAAGGGCAGGGTATATAACATTTGAAATCACAATTGCTAAATATACTCTATGATACCTTGACTGGCCAAAAAAGAACAGTCAGGGTCTCCCATAATCAGTGCATGAAACAAACGCAAAAGAATAAAATCAAAGCACATTGTTACTATCAGTCATCCTTAAAAGTGCTTTAAAGTAAAGTGCTGCCTGTTGTTAATATTGTTTCAGAAGTAACTATAATGGAAGAGAAAGAAAGGGCTTATACCCTAGAAGAAGAAGCTGTTTCAGTACAACGGGAAGAAGAATATGAGGAATATGAAGAATATGATTATAAAGAATTTGAGGAGTATGAACCAACAGAAGAATATGACCAATATGAAGAATACGAGGAGCGGGAGTATGAACGATATGAAGAGCATGAAGAATACATCACAGGTATGAGCAAAACTGCAAACTCAAAACCACACTAAATATGTGCACACTCAAACAAGATAAAACAAGATAAATCATAACAAGATAAAAATTTGGATACCCAAAGAAATTTGGAAAGAACTTTGTTTCATTTCGCAAATGCGGAATTTTCTTCTTTGATAACTTCTAGAAAAAATTTTAAAAACCCTCTATAAATCTTAAGGTTATTGTTAGACTTTTGTTCCGGGAATAATCTAATACCCCCCTCATTTTTGCTCGTATGCAAAATAGCAAATGTCCCTAAGTTTCTTTTTCAAAAAGGTTACAAGTTTATCTTCAAGTGCCCGTGATCATTCTAGTACATGGTTAAAAATTTCTGAACATCCTTTATTCTAAAACTTGCTATTACGGAGTATGATAGGCTATTGAGAAAATGTATTTACCCACAGGGTTCCCATTATCAAAACTTGACAATGACTGCTTCAAAAGTTAAGATAGAGATGTAAGCTAACACAAGCTGTTGTGTTTTACCTAATGAAGGTCAAATTTGTTGGCATATAGTTTGGGCTTCAAATTGTTTATTTTACTCAAAGAATAAATCTCTATTGAAATTTTGAAATGAATCAATCTTATTTCACTTATTCAGTCTCTGATGTTTCATAGCCCAACTTTGAGAACATTCTACATAGTCTTACTGATAGCTTTAAAAAAACCATATTATAGGGGAGTTTCAGCCAGGAATTTATCTACCTGAAATGAAATGAGAATTTTAATATGTAAGAATTACCTAATTAAAGAAAATAGCAAGAAGGAAAGGGCAATATGAGCTTGTTCTGCTTGGATCTCTGATTCTTGCCTACTTCAATAGGCTATGGCTATACTGTAGATAAAAGATATTATTTCAATTATTTGATTCCTTTTAAGAAATGTTTAAACTTATATTCTAAGTCTAACATGAAATACCTTGTATGTACTTTTAAAGAACCAGAGAAGCCTATCCCTGTAAAGCCTGTCCCAGAAGAACCAGTTCCCACAAAACCAAAGGCCCCACCGGCTAAAGGTAGAGTGAAAAAAACATTATTACCTGTAAGAGATCTTTGTTTCCTCCATGTCTGTCCTACTATAAAAATATATGTAAAAGTGGCAGTGTACAAATTATGTGTGTGTTTGGGAATATTATGTTGTATTTGTCTTTCTTAACTTTTTGTTCTTGCTAGCCTTGAGAAACCTGTTTCAATTTTTAAAATCTCTTAATATTGATATTTTGAAGTGCTGAAGAAAGCTGTCCCTGAAGAAAAAGTACCAGTGCCCATTCCTAAGAAACTCAAACCTCCACCACCCAAAGGTACATTACTGAGTAATAATCACCAAAAACAACTTTGTTATGTATGTTCTAAAATCATGTCTTCCTAGCCCGTCTGATGGTCTGTGTTTTTGCTGAGTAGGATGTTCTTGTCCTGATTCTTACATTTCAGTTTTTTATGTGTATTTATTACATAGTATTCAAGGAGTTGGTTTTAATGCTCTTTAATAATTAATATCTTTAAAGTGCCTGAAGAACCAAAGAAAGTTTTTGAGGAAAAAATACGTATTTCAATTACCAAACGTGAAAAAGAGCAGGTGACTGAACCCGCTGCTAAAGGTATAATGATTTCCTTCCTCGATTGTGATCTTTTCTGATGCCTCTTTTGAAATTAATGTAACTATGATTCATTTCATTTTGTTGTTTCATGTCTTTTAAATTAGTTGTCAGCAGAATGTTGGATGTAAAAATGTGTAAATACAGGATAAGAAGATAATGCCTTTAAAAGGAAAAATTATTTCTAAATACATCCATAGCCTGTTAGCCAGTGGCTGTGTCCTGCCACATGGCTACAATACATATAAAATAGAATGTTTGGGTTTAAAATCAGTGACCGTTTGGCATATTCCTGATTTACCTAAATGATGTAATGATACCATAATATTCACCAAGCTTTGGTAACTGTTTATTCATTCTAAATTCATTTTGAAGATTTTTTTTAAAGCTAACCAGTTTCCAGTCATTTTCCCCCTGATTCATACTAAGTATGAAGTATACTAATTGAGAAGTAAATTTCACTTTTCAGGAAGGATATTTCTTTCAAGCAGAGATATTTGAACACTAAACCTCATTTCACATTTGGGCTCTGCTACTTCATGTTTACTTGGGTACTTCTGTGTACTTGTATTTATATGAAGCTCAGAATCCTTTCCACAGAGAGTATATAGTTTCTTAAAGATGAACAATCGCATATGTATCTCATTAAAGGAAGATACATTATTCTATCTGCTTAAAGTACAGCAAAACAAGCATTGGCTGGGTGGCCTTTTACTGACAATAAAATTTCCTTATACTTCATATTTCAAGTGCCCATGAAGCCCAAGAGGGTTGTCGCAGAAGAAAAAGTACCTGTCCCTAGAAAAGAAGTAGCACCACCTGTTAGAGGTACCTAATGGCACTCATTTTAATGTTTTGTTCGTCTTTTGCTGTTGAATTCCTCTTCAGTTCTGTGTGTGAAAACTTCTTTTGTGGGAAAAGTAAATCTTGTCCTTTCTTCTGTTATAAATGGGCCTGTGTTTCTAAGGTGTCTTAATTTTGTTGAGTCATTGGCAAATGTCCAACTTAAAGATAATATCTTTAAAGTGCCAGAAGTGCCTAAAGAACTTGAACCAGAAGAGGTTGCCTTTGAAGAGGAAGTTGTAACCCATGTAGAAGAATATCTTGTAGAAGAAGAAGAAGAGTACATTCATGAAGAAGAGGAGTTCATAACTGAGGAAGAAGTGGTGCCAGTGATACCAGTCAAAGGTAGATGATGCCTCCTGCAAAGGGCTGTGCAACAGCATCTTTGGAGTTTGGGGGTCTGATTTGGTCAGATTCTGGGGGTTATTGGCAGCACCAATGATTGCTTACTTTAAAGCAGATATTTTTAGATGCTGAAATATGATTTCTACAGGTGCTTTTCACATTTTATTTCTTTCCTGCAAAATTTCCAACATTCTTAATAATATCTTTAAAGTGCCTGAGGTACCCAGGAAACCTGTTCCAGAAGAGAAGAAACCTGTTCCTGTTCCCAAGAAGAAGGAAGCTCCACCGGCAAAAGGTACACCACCATTCATTGACGGGTATCTAAGAGACTTCATCTGCCTAGAAATAGTTAACTTTCTTCTGAGTTCAAAACCTTGTGTGTGTGTCACTGTCCGTTGTTAAAAAACATTAGCTGTGTTTTATATGGATGTGTTGTTACTAGTAGTTAGAACTTAACAATAAACAATATCTTTAAAGTGCCTGAGGTTCCTAAGAAGCCAGAGGAGAAAGTTCCTGTGCTTATTCCTAAAAAGGAGAAGCCTCCGCCAGCAAAAGGTACATCCTTATAATCCATCAGTGGAATAGCATGATAATTCACCCATGCAGCATAACTTGGTGAGCCATAGCAGATCTTTCCCCATGACAATATTAACAACATTAATGCCATGACAAGCGCCTCTCAACTGGCCACAGGAGCAGTTTACCCGGTATTCATCTCTGAATTTTACCATCAAATTATGCTTATGCTCAATGGTTGGCTCCTCCTCTTTAGTGGAAAGTTCTTCAAGTAAAATACATTCCTTTTGCATATCAAAATGGACAAAACCATCATTTACCAGGCATTGTGTCTTGTCTTTATCACCAGTCCACGTTTTTTTCGGTGTTTTTTATTTTAATTTTTGTGTATTTTCTGGCCTTTGTTTTGTGGCTATTATAATTTTCAGTCTTAAAGTGAAATTGATAGAATATCTATGCTGCTTCAGTTAAGGCCTTACATTGCCAGCCTTAAAATCTTAGCTATGGGTAAAAAATGTGACACTAACTCTATTTGATATCTTTGAAGTTCCTGAAGTGCCCAAGAAACCTGTGCCAGAGGAGAAAGTACCAGTACCAGTTCCTAAAAAGGTGGAAGCTCCACCTGCCAAAGGTACATGAACTTGCAATGTTGCAATATTTTTATTTCACATTTGCATATGGGTAAAAATTAATTGGTTTAATTCTGTACTCTTTGGGATGCAACTCTTTAGAGAAAATTAAATATTTTATTTTAAAAATAAAATGCTTCTTGGAATACCTTTGTCATACTTTTATTACCTTATCTTAATCTTTTGAAACTATGCTTGGAATCAGTATTTTTATGTCGTATAAAATTTTTCTCTAAATCATTTCGTTAAAGTGCCAGAGGTACCCAAGAAGCCTGTGCCTGAGAAGAAGGTGCCAGTTCCTGCTCCTAAGAAAGTGGAGGCTCCACCTGCAAAAGGTACATAATTTCATCACTTAGAGTACTTGGGGGAAAAAACTCACATCTATGTATACTCACATACAAATTTCCCCATTACATTGTACATTTTTAAAGTGTCTATCTGGTTAGAAATATGTCAGATATTTTGTGATTCTTTTTCATATCTATTGCTCTAAGACATTTTAAAAGAACATATTCCTAAATATAAATAATATCTTTAAAGTGCCAGAGGTGCCCAAGAAGCTCATCCCAGAAGAAAAGAAACCAACACCTGTTCCGAAAAAAGTGGAAGCACCACCACCCAAAGGTACATTAATCTGTAACAGAGCCATGGTAAAAGACAAAACTAACTGGTGTTATACAGCCTTACTAATTATAATTAATGCTTAGTATTTATGTTGATAATAATTGATGCTTTGTGATCACAGAATATTTGCCTTTCATAAGCTTCTTCATTGTTGTGAATATTTTACATAAAAGTGATGTTTGTACCCTTGAATAAATATCTTTAAAGTGCCAAAGAAACGTGAACCAGTTCCAGTTCCTGTAGCTCTACCTCAGGAAGAGGAAGTTCTATTTGAAGAAGAAATTGTTCCTGAAGAGGAAGTTCTACCTGAGGAAGAGGAAGTTCTACCTGAGGAAGAGGAAGTTCTACCTGAAGAAGAGGAAGTTCTACCTGAAGAAGAGGAAATTCCACCTGAGGAAGAGGAAGTTCCTCCCGAAGAAGAATATGTACCTGAGGAAGAAGAATTTGTACCTGAAGAAGAAGTCCTTCCAGAAGTTAAACCTAAGGTGCCAGTACCTGCACCAGGTATAGCAGCTCTTCTTGGAATCATCAAGGCCTCTTTTGTGTTGAATTCTGCTTTCCCATCCTTTTGTTCATCTCCAGTTTTATCTATAATCCTTTACCCTCTGTGATTGACCACCTAAATCTTAGAAAACATTCCAGACATGTGTGTTCTTATTGTGTATCTGCCTTGTGTATCTGTCTATTGTAAATTATCTAAATGTCTTTTCAAATCACATATTATGTTTACATGTTTGTGGTCTTATCCTCACGTGTCTCTTTCATATATATATATATATATATATATATGACCATGTATATGTGGTTTTTAATGCCTTCAAATGAAATGTTTTTAAGTGCCTGAAGTGCCAAAGAAACCTGTACCAGAGAAGAAAGTCCCTGTTCCCGCCCCTAAAAAAGTGGAACCTCCACCACCACCCAAAGGTACACCTCCCCAAAGTGAATACACATTGTTCACCCATAGCTTGGTCACATAAATTATGATGAAACTGGGTTTTAGGAAAATTATATTTACAAAATGGATAATCACACAGTTACATATTTACTTCTAACGATGTTCAGGAACACTGATATCTACTTTTTTCACTGATACAAAGCAGTATTCAAGAACAAAGATGAAAGGAAGCATTGTCCCAGAACTGATACAAAAGTTCTGATTTCATATCATTTGATTAAACATCATAGTTTTCATGGAGATATATTTAAATATATATGAATAAGTATACTATATATTTAAATGTATTGAAAACTATTATGAATAAATATTCTTAAATTTCTTCCTTCAACCATTTATATTAAATGCCTTTTTAACACCAGGCTAAAAAGAAAAAAAGATGAATGTATTTATCAAAACACAGAATAATAGTTATGTCTTCTAATACATATATATAAAGGGCAGCCCAACAGGTTTTGATTTTAGCGTTGACTTTACACCTTGTTGTATTACTCTCAGCGAGTCCTTTAACCAACCTGAGCCTGAAGTTATTTTCCTGTAAATTGGGGATGCTAATATCAGTCTTAATGGGCTCAGCTATTATGGTGAGAATTAAATAAAGTAAGGTATTAAAGTAGTCTATCATTGAATGAATAGTATCCAGATTTAACATATTCAATCAGCTCATAGTACAGGACAGAATTAATATATTTGTGCTTTAAAGCTCAATAATATTTTCTACAAAAGATGCTGGCATGGCTGCTTAAAATCAGCATAACCCTCGCATCAGGCCATATAGTTATATAATCAAATGAAATAGTAAAGCTGATCTTTTATTGGATATCAACGATTCAGAAATACTTTCTAGACAATAAATTACTAGTGAAATTTAAATGTATGAAATGATATTAGGTTGGTGCAAAAGTAATTGCGGTTTTTAGCATTAAAAGTAATGTCAAAACCGCAATTATTTTTGCACCACCCTAATAGCATCTGTCCTCTGATAATGACATATGCTGCTGGTCCCTTGCTTTACAAATCCCAATTACATTATAATATCTGGGCTCCCAACTAACATGACAGACCTGTCTTGAGCGACTGTTAACACATTGGTCTTTCTGGGTGTGGGGTCTTCTTGGTTTCTCTTTTTTTGTCCTTCAAAATAAATCCTTATCATGAAATGATGTCTTTAAAGTGCCTGAAATTAAGAAGAAAGTGACAGAGAAGAAAGTGGTCATTCCCAAGAAAGAGGAGGCTCCCCCTGCCAAAGGTATTGCTATTCCGAAGTAAATTAGACTATGCCATTTCCTTCCTTCTCCTATAAAAGTCAAAATGTCCTGTTTCCGTATTTGTTAATACAACTTATATTACTGCTGTGTCTACTTGTCTTTGTGTGTGTGAAACTGAACTTATAAAATAAAATAATATTTTTAAAGTGTCTGTGGTACCTAAGAAACCTGAGCCAGAAAAGAAGGTCCCTCCTCCTGGTCTTAAGAAAGCAGTGGCCCCTCCTGCCAAAGGTACATCATCCCATAACAGGGATATGTTTGCTGCACCGATGTTGAACTGTGGTTCTATCCACACAGGACACTCAACATAAATGTGTGCATTGTATGGTCTGTCATTCACATTCGTCATTTCTGACTCTTTTGCACCCAAGTTTGTGTTGTGTCCATTTTTTCACTTGGTGTTGGTGTGCTTTACATCGTTTCTCTATGTATGTTGTTTCTAAAAAATAAAAATATATCTTTAAAGAGCCAAAAATAACTAAGGAACTAGTCCCTGAAATACCCATTTCTTCATACCCATTTCTTCCTACAAAAAAAAAAAAGACAAAAGAAAAAAGAAATAGAGGCTCCAGCAGTAAAAAGTAGAATTTCTCTTTAATAAACCCTAAATCTTAAACCACAAACCTTTTTATTCTTTTCTCATTAACCGATTCTGTGAAATGTCAATGTTTCATCTTGTGTATGTGCCTTGTGATATTTACTCTCTTATGTTGGAAACTGGAAACGTGGTCTTTATTCTTCTTTGGTTCTTGCATTTTAAGTGTCTAAAATAATCAATGTCTCTCAAGTTCCTGAGGTGCCTAAGAAGGTGGAAGAAAAACGAATCATTCTCCCTAAAGAAGAGGAAGTTCTACCAGTTGAAGGTAGATAACTTTCTAAGAAAATAACATTTCAAAGTCATCCTTGTCTTATTATTGTCTAATATTTGAAGTAGGTAAATGTAAAATTTACCCCAGGAAATCAACATATTCAGATTCTAAAATAAATTATTATTAACCTAATAGAAATTGGGCAGGCAAATTAATATTATTTGAATCTCTTTGCATGTTCAGCCTGTTTGTCTGTTTGCTATTTGTTTTATTTTAATTAGAATTCATGAAGGGAAACTGTATTTGCTGTGGGAAATTTTTCATCAAATGACTTAGTAGGCAACTGTAAAATAAGCTTATCCAAGAGAAATTCCAGTTAAGCCTGAGTAACTGGTGCAGAAAATCTGATTTCTACCCCAAGTGGCTGTTTGACTTCAAACAAGTCTTTCATTAAAAAAAAAACAATAATAATTTTTTTATTATTATAAATTATCTGAAGTCCTTTCCAGTTCACAAATGCTGGGATATGCCTAACATATTTTGAAGACCCAGTAGAGATTTTTTAAGGACTAGTGAGTTTACACAAGCGTTTCGAAGGCTGAGCAGTTTTCAGATATTATCACTGTAGTCTAATATTCAAAATAATTATAAAAATAATTTACAAAATAATAATCTTTTTAAAGTGACTGAGGAGCCTGAAGAAGAGCCTATTTCAGAAGAAGAAATCCCAGAAGAACCACCTAGCATAGAGGAAGTTGAAGAGGTGGCACCACCTAGAGGTATAACCGCTTTTAAGGATTGAACATTTAAAATTCCTGGTGTTCCAAATCTTTCTCAGTAGCTAAATCTAAGATTCACCAGTATGCTTTTCTTATATCGTATCCATGATAAAGTGAAGATTAATTATTCCTGGCACCTGAATCTATGTGTCCTTTTTTTACCCTAAATTTTTCTACAACATCTGCAATACAACTAAGAATGAGAGATTACTATTTTGTTATTGGCGATTGAATTTTTTTCTGACCAGGCCCTACTATAATAGTTTCTCCTAGATTTCAATCCTTAATTTTGTTTTTAATATTAATATGGGGGGAATCTATTTCTCTGGTGAAAGTGTTCATTTTTTAAGAAAAATCTTTAATTTACTATTCCTGAAGAGTGTGATAATATTTTGCATAATTGGTATTACATTTGCTTATAGGATTTCTAAGTAATATCCTTTACACCTCTAGGGTTCCTACTCCACATTTATTATTACCATTTAGGTTGCTAATATCTTTTAAAAATAAGTCAATGTTTTGTGATATTTATTTATTGGTATATGGGTGGTGTTCTGCTCATCACATGCCACTTTTCAAAATGTTCATAAAATTTCTTTTAAGTGCCTGAAGTGATTAAGAAAGCAGTACCTGAAGCACCTACTCCTGTTCCTAAAAAAGTGGAGGCACCACCAGCTAAAGGTATATCAAATCCTCATTATTAATATCTTTAACTTCCCATTAATTTTCTTTCTTAAAAGCAACATTTTCTTTTTTGACTGCCTTCTTATAATCATTTAGATAGTGAACTGATTAAGGACCAGTAAAAATATAACTCATTCCATTTCTTTAATCTTTTCTAGGATGTTAACGAATAATTGTGTGCATGTGTTTACGTATGAATTATTCTAGAAGCTTCTTAACTGAGAATTTTAATATATTAGTATGTCTCTATATACTTATACACATAGCAATGGATCCCTCTTCCCCACATTTTAGATTTTATTCCATAAGTGGAACGGAGTTTTCTTCTGTGTTATAATAATTATTTTACTATATTTATTATTTTATGGAACAAACCTAATGCTTGGATAATAACTATTTTAAAGAGCCTCACGTCCCTTTTGTAATGTTTAGCCCAAGCATTCAAGGTTATTACAAAATGTCTACTTTTCCCTGCTTCCTAATTCACTTAATGCTTCAGACAGTGCTCTTAAGCAGTTAGATTATGCTGTCCCTGTCATAGTAGACTCCTCAGCTAATAGAAGAGTGCACAGCAGAAAGTGAGGCCAGTGTCAGGGCTTAAATACTCTACAATGGTAATCACTTCAAAAAAGTCTTCATCAAGTTAAAAATAGTAAAAGTGAGTCCATATTGGTAATCCCTGTTATTAAAAGAAAAAAAAAAGAATGGCACAGGTACTTTGTGGACATTTCTTCTTCTATAGGAATGTTAGAACAAATGAGTGATTTGAGAAAGTATCTTTATTGCCTCTAAAATGGATGTCCCACAGTACAGAGTGACTTCTGAAAAACTTTAATTATTGTAATGTTGGCGTTGTCTCTGGTGTTTTTATTTCATGTGTGTTATTGAACATTCTCAGCTAACTAAAACACCTAATATCTTTAAAGTGTCAAAGAAAATTCCTGAGGAAAAAGTACCTGTTCCTGTTCAGAAAAAAGAGGCACCCCCAGCCAAAGGTACATCTTCTCTTTTAAACCTGACTTCCTCTTCTGTCTTTTTTCGTTAAGACTTTTATGTTTCATGTCTCTGTGTCTTGATTGTTTTTGATGATTTTTGTCTATGAAAGCTTGCTCTCGACAGTCCTAAATATTAAAACTGTATCTTTAAAGTGCCTGAAGTACCAAAGAAAGTCCCAGAAAAGAAAGTCCTTGTGCCTAAAAAGGAAGCTGTTCCCCCAGCTAAAGGTATTTTTGGAAAGATCCTGGATTTTCGTGTATTGTTGCATGCAATCCTTTATTCAGTTTTAAAAATATATATTTTGAATGTACATCTTTATTTCTTCAGTGTTTAAAAAAATAAGTCTTAAAATAGATGCTCTTTCAGGGAGAACTGTCCTTGAAGAAAAAGTATCAGTTGCCTTCCGCCAAGAAGTAGTAGTAAAAGAAAGACTAGAATTAGAAGTAGTAGAAGCAGAAGTGGAAGAAATTCCGGAAGAAGAAGAGTTCCATGAAGTTGAAGAATATTTTGAAGAAGGCGAGTTTCATGAAGTAGAAGAATTCATCAAATTAGAACAACATAGAGTTGAAGAAGAACACAGAGTTGAAAAAGTTCATAGGGTAATAGAAGTTTTTGAGGCTGAAGAAGTGGAAGTATTTGAAAAACCAAAAGCTCCACCTAAAGGTATAGGGAATTCTTCAAATACTACAAATTCTTATATCTTGCTCTAACTTTCCTTTGAAAGTAAATTTTGTGTTCAGTTTGGAAGATTAGAAACCCCATGAAATACTTTAAACATGAGTTTAAACTAGTTGACACAAAGATTAATATCTCTTAACCACACGGAGTATAATTTTAGTAGATGATAGTAATATTTGATATCTACTTATCTAAGGAGGTCACTGTATGAATTTGGGGATTATTTTTTAAATCTGACTAAGAATGTTACACAATTGTTACAGGTACCAAAATAACTGACCAGTGTCATTGGTTAAGTGAAAAAGAAACTCCTCAGTTCACTGAGGAATTTACATGTTCAGGCAAAATAATCACTGCTTTAACATTTTAGTCAACTGTTCACAAACTGAGAAATACTTACCAAAAGCTTTTGCCAGTTTATGATACTTTCATTAGAGAAACAACATTAAGGAAGTGAAGTATTGTTAATGGCACCTGTATTCTAGCATACTGTGAAGACAAGCCATAGCACAAATAAGTTATCTGCAATACCACTCTAGATCTTGCACAAATTAACAATATATGTGTAATATGAAGGAATGTGTGTGTGTGTGTGTTTAGCATATATAGCAAATTACAATATACATGATATTTAGCAAATCAAATCTCTTTTGGAAATAAGTGTGTTATAAATTAAAAAAATATAGATAAAGAATTTTGTGACCCCTCATTGTACTAACGTTAGTAGTAGTGCTCCAAAATACTTCAAGAGTTCATTCTAAACCAAAATACTAATATCTTTGAAGGGCCTGAGATATCTGAGAAAATCATCCCTCCAAAAAAACCGCCCACTAAAGTTGTTCCTCGAAAAGAGCCACCAGCTAAAGGTATCTTCTTTGTGAAAAATTACTACTTAACTTTACATACAATAGCACCTTGGTTGCTTTATAAGCACAAGTTTGCATTCCACTTGATGTCTTTCTTCTGTATTTCTTGTTTCTGACATGTCTAAAACAAACTAATATCTTTAAAGCAGCTGAGGGTCCAAGGGAAGTTCTACCAAAAAAAGACAGTCACTGTTGTTATACCTAAAACAACCAAAGCAAATATCTCTAGTAACCAAATAGTGAGCCCAAATTTCCTCCTTTGGTGCTATTTGGTTATATATTCACTAACATGCTTACTGATAAACACATGTTTTTCTATTTATTATTAATTATATTAACCTGGCAAATATAAATACATAGTGAATATGTGTTTAATGTTCTTGCTTTGTTCATTTTTGCAAATCTCTTAAATTTCACAATAGAAATAAAAACAGTATCTAATAAATAATATAAACTTATTTCTTTAAAGTCTCTGAAGCATGTGCGTAAGTTATCACTGAAGAGAAGGTAGCAACTCTTCCACAAAAACAAACAGTAATAGCACCAGCTGAAGGTGTACTGTTAATTTTTCTTCTCAAGTTCTTACCATTCTAACATGGGAAATTTCCCTGGATTTTTGTTATTATATATTTTTTAAATTCAATGCATTTGAAATACTGTAATGTATTTGATAAAGTGTTGTCTGCATTTTATATTGTTGCTGTGTTCTGTTCTGTGTTTATATCTCTCATGCTCTGCTTGTTAAAAAATTGTATATTTAAAAATAAAAGAAATTATTACTATTATCTTTAAAGTACCGGAGGTGCCTAAGAAAATTGTGGTAGAAGAAAAAGTACGTGTTCCTGAAGAGCCCAGAGTTCCACCAACTAAAGGTAACTGGCTTTTCTCATTCATCATTAATATAAAATCCTTTTTTATTCACTTACTATGTAAGAGAGACCTTTCTCTTCTCAATGCCACAAGATGGCTATGAATGACATAAACTTCAATTTATGTTCTATAACATAATCCTGCCTTTTGAGGCAATGTTTTAGGCGTAAAGACATAAGCCCAAAGTTATCATTTGTATTGATCCTCTTATTTAATAACTAAATAATATTGATCCCTCAACTTCTCTTTCAAAAATAATTCATTTTGGAAGCTCTTCTGAAGTAGCTCTGGAAAAAAAAAAGTGTGCTCTAAATGGCAATAGAAAATGATACTATCTCCAAAGAGCAAAGTGTTTCTGATATAATGAATCAAGAACTCATCGACAAAGCAATTCAGAGAAATGCAATGACTACATTTGACTTATAGTTGACTTATAATTGAGGGGTTTTTGGCGTTCATCTTGTTAGATGCCCCTTCTAGGCTTGCTATGTTTACACCCAACTATAATGTTCTGAAAAAATAAGATAAATAAATATCTTTAAAGCACCCGAAGTACCCAAGAAAATTGTCCCAGAAGAAAAAGTTCGTGAAGCTGTTCTGAAAAAGCCTGAAGTTCCACCAGCTAAAGGTATACAGTGATGCTAATCAGAACATGAAATAATTCTTGGTTTAGTTTTTCATGGTTTAAAGTGAATGTGTGTGACATTAAATCCTTGTATTTCGTATCTTATATTTGTTATCTGTAACAATTAATATACTAATATCTTTAAAGTTCCTGGGATGCCTAAGAAAAGTGTTCAAGAAGAAAAATCACCTATTGTTATTTCTGAAGACACAGAGATGTACAGTGAGTGTAGAAAAATTAGTGGTTCTTTTTCGTTTCATTTATGTCCTTAAATTCACTATGTTTGTCTTTTTAGCTTTGAAAAGTAAATATACTAAACTCTTATAAAAGCCTAACATGCCACAAATATATGACTCAAATAATCTTAGTGTCTATTATCCTCAGACAAGTTATATTTCCTCACCAATTTAAAAAAGAAATACTCTACTTATCAGAGTGTATGATTTCAGAAAAGTCAGTTGTCTTGTTAAATTTTCCTAACCTATTCTGTATACAAGTGTCTTTTGCTTTGAAGCAATTTATTTTCTCAGATCATGAAGTAACTTAACTCCATAATATTTTAATTGGATTTTATAAAATCAAAATGTTTCACCATTATTTTTTTTTTTACTCTTGATAACCATAATTGGAAACATTTTGGCAAAACTGCTCAAAGGACCCTAGGTTTACAAGGCCACTCAAACCTCAAAAGAATTCTCACGACCTTTTTTTTTGGGGGGGGGTTTCATACAAAATTAGGTTTAAATAATTTGAATTATGAAATAATCCAAATAGTAAAATATTGTGAATAGAATACTGTTCAACAACCTGAATAGTAAAAGTGACAGTAGTCAAAATATTCTTCCTTTTTTTTTTTTTTTTGAGATGGAATCTCACTCTGCTGCACCCAGGCTGCAGTGCAGTGGCACGATCTTGGCTCACTGCAACCTCCGTCTCCTGGGTTCAAGCTATTCTCCTGCCCCAGCCTCCCGAGTGGCTGGGATTACAGGTGCCTACCACCAGGCCCGGCTAATTTTGTGTATTTTTAGTAGAGACAGGGTTTTACCATGTTGGTCAGGCTGGTCTCAAACTCCTGACCTCAGGTGACCCGCCCACCTCAGCCTCCCAAAGTGCTGGGATTACAGGCATGAGCCACTACACCAGACCCGCTTCCATTTTTTTTAATCTAAAAAATTTCCTGTTGAAACTCAACTTTCTTGTTGTTCATCCTGTTATACTAAGTTGGGATAAAATAATATAATCACTTCCTCCTTTGAATATCCTTTCTATTCTTGACTTTAGTTATTGTTTTCAGACAGTTTTTCTTTCTAAAGGCTGGAGAAATTTTTGTTGTCTTTATTTGCCTTATTTTCTAAGTATTTAATTTTTTTAATTTTCTGCCTCCAAACCCTAAATGGCTTTTACATTCATATTAAACTGTGAAACCATATATTAGATGTGATTTGAAAATATAGATAATGAGGCTTCTAGAAAGGGAAAAGACTTACATGAATTTCTAGTAGGTCAAATATCGGAGAATTCTCAATGTGCAATTCAGCATCTTCCCTGTTCTTTATAGACAAATCCATTAAAAATAAGACCAATAGGACAATTTTACCAATAACTTTCTTAAGGCAAAATGAAGAATTATATAGTCCTTGCCTGAACAATTCCTCCATTTTATTATCATCATCATAGAGAAATGCTTAGAGTCTTACATCATGAAACTGGGAGTGAGGCTATCCCCAGCCAATGCATTCTAGCCACTAATTTGCCTCTATGTGCTACTATTAATTTTGGTGATGAATGTGGTATTATATATTATATTTTTCTTAATACACTTCTTTATCCACCTTGAAACATCCTAATTATTTAAATACTAATATCTTTAAAGTTTATGAAGCATCTGAAGAAGCAGTCCTAGAAGAAAAAGTACTTGTGACTCAACCTCAAAAGACAAAACCCAAACTAGCAAAAGGTATATAACACCAATGATCCACTCTGAAGAAAAATTATTTTTTGGCCCCTTTTAAAAAGCTCAATATTTTTCTTCACCATTTATAAATATAACTATACTCATATCTTTTAAGTGCCTGAGCCACCCAAGAAAGTTGTTCCAGAAGACAAAATATATGTGACTATTCCTAAAAAGAGAGAAACACCAGCAACTAAAGGTATATTTCAAATACATCAAACCCAGATGAGTATCTTTAGCTTTATGACTCAAACATTGCATGCTTTTTATAATTTACTGTTTTTACAACTTTTAAATGTAAACCTACTAATATCTTTAAAGAACCTGATACAACCAGAGGCATTTTTCCAGAGGTGGAGCCACCTGAGGCTATTCCTGAAATTCCAGAACATCCTCCAACTGAAGGTATAATTCTCTAGTTAGGAAAATCTAAAGAAGAAAATATACTGTCTTCAGTCTGCAAAATATTTAATGTTTAATATACATTCTCACAACCTCTAATGTTAAAATACTGTGTTTAAAGGATCTGATATACCCACAACAAAGAATGACCTATGACTTGCCCCCAAGAAAGTCAAGTCCCACACATATAATATACAAAGATAAAATATTAGAACAAAAATAACATTTCTAACATAAAGATATCTGAAATGATATTAACATATCTAACTTTCTTAGTATGTCATGTCTTTATGCCTTTGCCTTTTCTCAATTAAAAAAAATACTAATATCTTTAAAGAGTTTGAAGTCTTCAAGGAAGTCATTCCAGAGGGAGAAACTCCTATTGTTAAAAGAAGAAAAACACCATCACCAACAGGTACAAGTTGGAAGAAAGTCACCTTTTTAATCTCATGTTTGCAGTTGTACTTAACACATGTAAAAATACTAATATCTTTTAAGCCAAAGTGGCTACAGTGGAAATCATTTCAGAGATGGATCCCCCAAGTAGAAGCTCAACCAAATGTATTCATGTCCCAGTGAGTCACTCAAGAGACAACAGAGGGAAAAAATACCTTTAGCTTATACACATGAAAGATAGTTGAGTCAGTGTATTTTTATGAGGACTCCAAAGAAAATATATATACACATATTATGATCAAAACATGTCTTAAAGAAAATATTAATTCAGTGTGAAGCTGATCTGTAATATCTCTACAAGATTAGAGCACCTGAGACCCTCCCAGAATATCCTCCAACCTAGGGAAAAATAATTCCAGTTAAAGCTGGAAATCTCCCCTCCATGTTCATTTGCTCCTCTCATAGCCTATCTTTTATTTTTCAAGCATCATTTTTTTTCATTTTGAATATCTTTAGATAAGTCAAAACATGAAAAAGCTTTAAAACCTCCAGAACAATAATTTCATCATAACACCCATGGTATTCTGTAATTTGAAGAATATCTGAATATTTTGATATTTTTTCTCAGTCTGGAATCTTTTGGTTGTTCTCCTCTCTCCTAAACTTGAAAAACACTCACCTTTTTAAGGTGCCTGAGGTGTGAATACAAAAAAATGCCGACCTAGATTTTTCGAAGTGGCTGTAATTTGTTTTTCTCAACATAATAGCTAGAGGTATAGCATTAATTATAATCAATGTTTCCACTTTCCATGATCTAGTTTTCTATGCATCTACCATTCCAAGAAATAAAATTACTAATACTGATAGTGCCTGAGGTGACCAAGAAAACAGCCGCTTATAACCAAATACTCACACTGCTACAAAAGATCCGATTCTGGGGGCGGGGAGTGGGAGAAGGTTCCCATCTGGAATGTTCTGTATGTGCAGTTAAGATGGGAACTCTTTACTCCTCTTCATAACTCCAAAGTACAATGCATTCATATCTTTAAAGTGCCTGAATCACCTCGAGAAATTGTCCCTGTAAAGGAAACACCCATGGCTGCTCCCCTTGAAATTGAAATACCTCCCACTAAAGGTATCGTTCATCCTGCCATTCCTTCCTTCATTTATTAGAGTGCTTAGCATGTACAGGGTGCTAGGGAACTGGAGAATAATAAACAAAGACAATTAATATGTGGTTCCTCTCCTCAAGATTGTATACCTCCTCAGATTCTTTAAAGGAATCATCTTTTTAGCCATAAATATCACTTTGGTTCAGCTCATTTAATTAATGTCTCCACTGATCCTTTTAACCTCTAACCATAATACTAATATCTTCAAAGCACCAGAAGCTATGAAAGAAGTTGTCCCTGAAATGAAAATATTTGAGGATGTACCTGAAGAGCCAGAAACTCCACGTATGAAAAGTACGTTACCTCTGAACAAATGTGGAAGAAGAAATTATCTGTCCTCTGCTCTTAAAACTATGGTTTCTTCCTAATACTCTTCATAAATTCTAAATATAAACATACTAATATCTTTTAAGTGTCTGAGGTTCCACAGGAAGTTTCCTCTAAAAAGAAATTATTTATGGCTGTTTCTGCCAAAACAGAAAACACTCCTGCTGGAAGTATTCATTCAACAAATCCTTTATAATGAGAGTGTAGAGTGTCGCGAGAGCTCTGTGAGGTTCTGGAGGAGGGGGAGCACCTCCTCTCAAGGATCCACTAACCCCTTAAAAGACTTAGCCTATTGGTGGAACAAAGGGAGGATGGAGGAAAGAGAAGAAAATGTGGTTATATTTCCTAACTTATTGTGGTTACTGTTTTCCATTAATCATTTTAACTCTTAAATGTGAATTGCTAATATCTTTCAAGCGCCCGAAGCTCCTCAAGAAATTATTCCTGCCAAGACAGTTCCTTCCAAAAAAAGAGAACCCCCATCAGTTAAAGGTACAAGTCACCATGCTCTCAGGGTCAAGAACTAGCTCTTGTAGTTTTGAGAATATTTTTGCTATTCCTAGTTATCTGCATAACACTAAACATAAAACTACTAATTTCTTAAAGTGCCTGAAGCTCTCCAAGAAATTGTCCCTGAAAAGAAAACGCTTGTGGTTCCTCTCAGAAAGCCTGAAGTCCTTCCTGATGAAGGTATATCTTGCTGGAAGCTTAGAGGGGTGGGAACATGTCTTTTCTTGTATAAATGTTTTTCCTGATTGTGTTGATTCTTGTAACTTCTAAATGTAAAATTATTAATATCTTCAAAGTGCCGGAGGCTCTCAGAGAAGTTGTCCCGGAAAAGAAAGTGCATCCTCCCCAAAGGGCTGAAGTTGTACCTGTCAAAGGTACATTCTTAACTGTCTTTTTATGGTGGGATAGTGGGTGGGGCGATAGAAAGGACCACCTTTCTAGTTTTGAAAATTATTTTGATGTGTACATGTGAATCATGTCTGTGTTGACTCTTGCAACTCAAGTGTAAATGTATTAATATCTTCAAACTGCCTGAAGCTCCCAAAGAAATGGCTACCAAAAAGAAAATACCGGAAGTTCCTCCTCTAAAACCTGAAACACCACCTATTATGGGAACTTGTTACCACTGATCTCAGCTCAGGAGAAAAAAATAGCTCTTTTGTTCTTGAAAATGTCTTTGTATCTATCTAGTAATCTCTGTATTTTCTGAGTGTAAAAATACTAATATCTTTCAAGTGCACGAAGCTCCCAAAGAGATTATCCCTGAAAAGAAAGTGTCGGTGGTGCCTCCTAAAAAGCCTGAAGTCCCACCTGTTAAAGGTATTTGTCACTGACTTTAGGCTTCAGAAGACCTAATTCTTCTGCTCTTGACAATATTTTTTTCTAGCGGTCTTCATAACACCTAAATGTAATTTCACTAATATCTTTCAAGTGCCAGAAGCTTCCAAAGAGGTTATCCGCGAAGAGAAAGTGCCCTTGGCTCCTCCTAAAGAGCCTGAAGTCCCACCTGTTAAAGGTAGTTGCCACTGACCTTAGGCTTCAGATCTCATTCTTTTGCTCTTGAAGATATTTTTTCCAGTGGTCTTCATAACTTCTGAATGTAATTTTGCTAATATCTTTTAAGTACCAGAGCCTCCCAAAGAAGTAGTTCCTGAAAAGAAAGCGCCAGTGGCTCCTCCTAAAGAGCCTGAAGTCCCACCTGTTAAAGGTATTTGTCACTGATTTTAGGCTTCAGATGATGTATCTCTTCTGCTCTGGAAAATATTTTTCTAGTGGTCTTCATAATGCCTAAATGTAATTTCACTAATATCTTTCAAGTGCCTGAGGCTCCCAAAGAAGTTGTTCCTGAAAAGAAAGTGCCAGTGCCTCCTCCTAAAAAGCCTGAAGTGCCACCCACAAAAGGTAGACACCCTCTTGTTGCTGTGTTTGATATTGTTTGTTTGTCTTTACTTTGTCTAATAATGAAAATACTAATATCTTTAAAGTCCCAGAGGTGCCAAAGGCAGCTGTCCCAGAAAAGAAGTTGCCTGAAGCTATTCCTCCCAAACCGGAAAGTCCTCCCCCTGAAGGTAATGCCAAAGCTATACAAACTATAGGAGAAAAATAACTGTTATTTTAACTAGGAAATTACATGTTAAAAATCCTACTACATAAAGATGATATAATTCTAAAGAAAACAAATGTCAATCGCTATCCAAAATATCTTGGTGGGTGTTTATATGCAAAAGGCATCCATCATTTTCACCTTTTCTAAACACAAATTACAAATATCTTTGAAGTGCCTGAAGTGCTGCCACCGAAGGAAGTGGTCCCAGAAAAGAAAGTACCGGTGCCTCCTGCCAAAAAGCCAGAAGCTCCACCTCCTAAAGGTAGGTATCATTACACATTGTCAGTCGGGGGGCCCTGGGGAAAGACTGCATAGAAGTGTCCGCCGATCTCACAAGTTGTATTTGCTTGGGTAAATGTGGAGTCGATATTCCCCCTTTATAGCTTCTAACTAAAAGATACTAATATCTTCAAAGTTCCTGAAGCTCCTAAAGAAGTTGTACTTGAAAAGAAAGCATCTGTGGCTGTGCCCAAAAAACCGGAAGCCCCACGTGCAAAAGGTATTTATTCCCTCTCCTCTGCTAAGAAAAACTTATCGTCTGTACCCCTCACAATCACTGTAATATATACCTTCACCATTCATAAATTATAAAAATACTAATATCTTTCAAGTGCCTGAAGCTGCTCAAGAAGTTGTCCCAGAAAAGAAAATTCCCAAGGCACCAATCAAAAAACCAGAAGCCCCCGCAGTTACAGGTACATGTCAGCTCAACCTTATCCTGCAGAAGAAATCTCTCTTCCATTCCTGAAAACAATTTTAGTCCATTCCTCTTCATTAACCTAAGTATAAAACTACTAATATCTTTCAAGTGCCAGAAGTTCCTCAAGAAGCCACAGAAAAAGAAATTCCCGTGGCTCCACCCAAAAAACCAGAAGCTCCAATTGTCCCAGGTACACTTTAGCCCTGACTTCATTCTGCAGAAGAGATATCTCCTCTCCTACTGTAAACAATTTTAGCCCATTTCTCTTCATTAACTTAAGTCTAAAACTACTAATATCTTTCAAGTGCCTGAAGCTCAAGAAGTTGTCCCAGAAAAGAAAGTTCCTAAGGCTCCTCCCACAAAACCAGAAGCCCCACCTGCCACAGGTATTTTTTACCCCTGTCCTTTTTCTGCAGAAGAAATATCTCTTCTGATCTTAGAAATATTTTACTCCATTTGTCTCATTAACCTAAGTGAAAAACTACTAATATCTTTCAAGTGCCTGAAGTCCCACAAGAAATTGTGCCAGAAAAGAAAACACTGGTGCTTCCTAAAAAGCCAGAAGTTCCACCTGTTACAGGTACTTGTCATTTGACCTTAAGCTTCAGAAGATCCAATTCCTCTGCTGTATATTTTGCTAGTAGTCTCCATAGCTCCACATGTAACTTTACTAATATCTTTTAAGTGCCAGAGGCTCCCAAAGAAGTTGTCCTTGAAAAGAAAGTGCCCTCGGCTCCTCCTAAAAAGCCTGAAGTCCCACCTGTTAAAGGTATTTGTCACTGATTTTAGGCTTCAGATGATCTATCTCTTGTGCTCTGGAAAATATTTTTCTTTTTATATATATATATATTTTTATTATACTTTAAGTTCTAGGGTACATGTGCACAACGTGCAGGTTGTTACGTATGTATACATGTGCCATGTTGGTGTGCTGCACCCACTAACTCGTCATTTACATTAGGTATGTCTCCTAATGCTATCCCTCCCCCATCCCCCCACCTCACAACACACTCCGGTGTGTGGTGTCCCCCTTCCTGTATCCATGTGTTCTCATTGTTCAATTCCCACCTATGAATGAGAACATGCAATGTTTGGTTTTTTATCCTTGTGATAGTTTGCCAAGAATGATGGTTTCCAGTTTCATCCATGTCCCTACAAAGGACATGAACTCATCATTTTTTATGGCTGCATAGTATTCCATGGAGTATATGTGGAACATTTTCTTAATCCAGTCTATCATTGATGGACATTTGGGTTGGTTCCAAGTCTTTGCTAATATGAATAGTGCCGCAATAAACATACGTGTGCACGTGTCTTTATAGCAGCATGATTTATAATCCTTTGGGTATATACCCAGTAATGGGATGGCTGGGTCAAATGGTATTTCTAGTTCTAGATCCCTGAGGAATCGCCACACTGACTTCCACAATGGTTGAACTAGTTTACAGTCCCAGCAACATTGTAAAAGTGTTCCTATTGCTCCACATCCTCTCCAGCGCCTGTCGTTTCCTGACTTTTTAATGATCACCATTCTAACTGGTGTGAGATGGTATCTCATTGTGGTTTTGATTTGCATTTCTCTGATGGCCAGTGATGATGAGCATTTTTTCTTGTGTATTTTGGCTGCATAAATGTCTTTTTTTGAGAAGTGTCTGTTTGTATCCTTCGCCCACTTGTTGATGGGGTTGTTTTTTTCTTACACGTTTGTTTGAGTTCATTGTAGATTCTGGATATTAGCCCTTCGTCAGATGAGTAGATTGCAAAAATTTTCTCCCATTCTGTGGGTTGCCTGTTCATTCTGATGGTAGTTTCCTTTGCTGTGCAGAAGCTCTTTAGTTTAATTCGATCCTATCTGTCAATTTTGGCTTTTGTTACCATTGCTTTTGGTATTTTAGACATGAAGTCCTTGCCCATGCCTATGTCCTGAATGGTATTGCCTAGGTTTTCTTCTAGGGTTTTTATGGTTTTAGGTCTAACATTTAAGTCTTTACTCCATCTTGAATTAATTTTTGTGTAAGGTGTAAGGAAGGGATCCAATTTCAGCTTTCTACATATGGCTAGCCAGTTTTCCCAGCACCATTTGCTAAATAGGGAACCCTTTCCCCATTTCTTGTTTTTGTCAGGTTTGTCAAAGATCAGATGGTTGCAGATGTGTGGTATTATTCTGAGGGCTCTGTTCTGTTCCATTGGTCTATATCTCTGTTTTGGTACCAGTACCATGCTGTTTTGGTTACTGTAGCCTTGTAATACAGTAGCGTGACGCCTCCAGCTTTGTTCTTTTGGCTTAGGATTGACTTGGCAATGTGGGCTCTTTTTTGGTTCCATATGAACTTTAAAGTAGTTTTTTCCAATTCTGTGAAGAGAGTCATTGATAGCTTGACGGAGATGGCATTGAATCTATAAATTACCTTGGGCAGTATGGCCATTTTCACGGTATTAGTTCTTCCTATCCATGAGCATGGAATGTTCTTCCATTTGTGTCCTCTTTTATTTCGTTGAGCAGTGGTTTGTAGTTCTCCTTGAAGAGGTCCTTCACATCCCTTGTAAGTTGGATTCCTAGGTATTTTATTCTCTTTGAAGCAACTGTGAATGGGAGGTCACTCACGATTTGGCTCTCTGTTTGTCTGTTATTGGTGCATAAGAATGCTTGTGATCTTTGCACATTGATTTTGTATCCTGAGACTTTGCTGAAGTTGCTTATCAGCTTAAGGAGATTTTGGGCTGAGACGATGGGGTTTTCTAGATATACAATCATGCCATCTGCAAACAGGGACAATTTGACTTCCTCTTTTCCTTATTGAATACCCTTTATTTCTTTCTCCTGCCTGATTGCCCTGGCCAGAACTTCCAACACTATGTTGAATAGGAGTGGTGAGAGAGGGCATCCCTGTCTTGTGCCAGTTTTCAAAGGGAATGCTTCCAGTTTTTGCCCATTCAGTATGATACTGGCTGTGGGTTTGTCATAAATAGCTCTTATTATTTTGAGATACGTCCCATCAATACCTAATTTATTGAGAGTCTTTAGCATGAAGGGCTGTTGAATTTTGTCAAAGGCCCTTTCTGCATCTATTGAGATAATCATGTGGTTTTTGTCGTTGGTTCTGTTTATATGATGGATTACGTTTATTGATTTTTGTATGTTGAATCAGCCTTCCATCCCAGGGATGAAGCCCACTTGATCATGGTGGATAAGCTTTTTGATGTGCTGCTGGAAAATATTTTTCTAGTGGTCTTCATAATGCCTAAATGTAATTTCACTAATATCTTTCAAGTGCCTGAGGCTCCCAAAGAAGTTGTTCCTGAAAAGAAAGTGCCAGTGCCTCCTCCTAAAAAGCCTGAAGTGCCACCCACAAAAGGTAGACACCCTCTTGTTGCTGTGTTTGATATTGTTTGTTTGTCTTTACTTTGTCTAATAATGAAAATACTAATATCTTTAAAGTCCCAGAGGTGCCAAAGGCAGCTGTCCCAGAAAAGAAGGTGCCTGAAGCTATTCCTCCCAAACCGGAAAGTCCTCCCCCTGAAGGTAATGCCAAAGCTATACAAACTATAGGAGAAAAATAACTGTTATTTTAACTAGGAAATTACATGTTAAAAATCCTACTACATAAAGATGATATAATTCTAAAGAAAACAAATGTCAATCACTATCCAAAATATCTTGGTGGGTGTTTATATGCAAAAGGCATCCATCGTTTTCACCTTTTCTAAACACAAATTACAAATATCTTTGAAGTGCCTGAAGTGCTGCCACCGAAGGAAGTGGTCCCAGAAAAGAAAGTACCGGTGCCTCCTGCCAAAAAGCCAGAAGCTCCACCTCCTAAAGGTAGGTATCATTACACATTGTCAGTCGGGGGGCCCTGGGGAAAGACTGTATAGAAGTGTCCGCCGATCTCACAAGTTGTATTTGCTTGGGTAAATGTGGAGTCGATATTCCCCCTTTATAGCTTCTAACTAAAAGATACTAATATCTTCAAAGTTCCTGAAGCTCCTAAAGAAGTTGTACTTGAAAAGAAAGCATCTGTGGCTGTGCCCAAAAAACCGGAAGCCCCACGTGCAAAAGGTATTTATTCCCTCTCCTCTGCTAAGAAAAACTTATCGTCTGTACCCCTCACAATCACTGTAATATATACCTTCACCATTCATAAATTATAAAAATACTAATATCTTTCAAGTGCCTGAAGCTGCTCAAGAAGTTGTCCCAGAAAAGAAAATTCCCAAGGCACCAATCAAAAAACCAGAAGCCCCCGCAGTTACAGGTACATGTCAGCTCAACCTTATCCTGCAGAAGAAATCTCTCTTCCATTCCTGAAAACAATTTTAGTCCATTCCTCTTCATTAACCTAAGTATAAAACTACTAATATCTTTCAAGTGCCAGAAGTTCCTCAAGAAGCCGCAGAAAAAGAAATTCCCGTGGCTCCACCCAAAAAACCAGAAGCTCCGATTGTCCCAGGTACACTTTAGCCCTGACTTCATTCTGCAGAAGAGATATCTCCTCTCCTACTGTAAACAATTTTAGCCCATTTCTCTTCATTAACTTAAGTCTAAAACTACTAATATCTTTCAAGTGCCTGAAGCTCAAGAAGTTGTCCCAGAAAAGAAAGTTCCTAAGGCTCCTCCCACAAAACCAGAAGCCCCACCTGCCACAGGTATTTTTTACCCCTGTCCTTTTTCTGCAGAAGAAATATCTCTTCTGATCTTAGAAATATTTTACTCCATTTGTCTCATTAACCTAAGTGAAAAACTACTAATATCTTTCAAGTGCCTGAAGTCCCACAAGAAATTGTGCCAGAAAAGAAAACACTGGTGCTTCCTAAAAAGCCAGAAGTTCCACCTGTTACAGGTACTTGTCATTTGACCTTAAGCTTCAGAAGATCCAATTCCTCTGCTGTATATTTTGCTAGTAGTCTCCATAGCTCCACATGTAACTTTACTAATATCTTTTAAGTGCCAGAGGCTCCCAAAGAAGTTGTCCTTGAAAAGAAAGTGCCCTCGACTCCTCCTAAAAAGCCTGAAGTCCCACCTGTTAAAGGTATTTGTCACTGATTTTAGGCTTCAGATGATCTATCTCTTGTGCTCTGGAAAATATTTTTCTTTTTATATATATATATATTTTTATTATACTTTAAGTTCTAGGGTACATGTGCACAACGTGCAGGTTGTTACGTATGTATACATGTGCCATGTTGGTGTGCTGCACCCACTAACTCGTCATTTACATTAGGTATGTCTCCTAATGCTATCCCTCCCCCATCCCCCCACCTCACAACACACTCCGGTGTGTGGTGTCCCCCTTCCTGTATCCATGTGTTCTCATTGTTCAATTCCCACCTATGAATGAGAACATGCAATGTTTGGTTTTTTATCCTTGTGATAGTTTGCCAAGAATGATGGTTTCCAGTTTCATCCATGTCCCTACAAAGGACATGAACTCATCATTTTTTATGGCTGCATAGTATTCCATGGAGTATATGTGGAACATTTTCTTAATCCAGTCTATCATTGATGGACATTTGGGTTGGTTCCAAGTCTTTGCTAATATGAATAGTGCCGCAATAAACATACGTGTGCACGTGTCTTTATAGCAGCATGATTTATAATCCTTTGGGTATATACCCAGTAATGGGATGGCTGGGTCAAATGGTATTTCTAGTTCTAGATCCCTGAGGAATCGCCACACTGACTTCCACAATGGTTGAACTAGTTTACAGTCCCAGCAACATTGTAAAAGTGTTCCTATTGCTCCACATCCTCTCCAGCGCCTGTCGTTTCCTGACTTTTTAATGATCACCATTCTAACTGGTGTGAGATGGTATCTCATTGTGGTTTTGATTTGCATTTCTCTGATGGCCAGTGATGATGAGCATTTTTTCTTGTGTATTTTGGCTGCATAAATGTCTTTTTTTGAGAAGTGTCTGTTTGTATCCTTCGCCCACTTGTTGATGGGGTTGTTTTTTTCTTACACGTTTGTTTGAGTTCATTGTAGATTCTGGATATTAGCCCTTCGTCAGATGAGTAGATTGCAAAAATTTTCTCCCATTCTGTGGGTTGCCTGTTCATTCTGATGGTAGTACCTTTGCTGTGCAGAAGCTCTTTAGTTTAATTCGATCCTATCTGTCAATTTTGGCTTTTGTTACCATTGCTTTTGGTATTTTAGACATGAAGTCCTTGCCCATGCCTATGTCCTGAATGGTATTGCCTAGGTTTTCTTCTAGGGTTTTTATGGTTTTAGGTCTAACATTTAAGTCTTTACTCCATCTTGAATTAATTTTTGTGTAAGGTGTAAGGAAGGGATCCAATTTCAGCTTTCTACATATGGCTAGCCAGTTTTCCCAGCACCATTTGCTAAATAGGGAACCCTTTCCCCATTTCTTGTTTTTGTCAGGTTTGTCAAAGATCAGATGGTTGCAGATGTGTGGTATTATTCTGAGGGCTCTGTTCTGTTCCATTGGTCTATATCTCTGTTTTGGTACCAGTACCATGCTGTTTTGGTTACTGTAGCCTTGTAATACAGTAGCGTGACGCCTCCAGCTTTGTTCTTTTGGCTTAGGATTGACTTGGCAATGTGGGCTCTTTTTTGGTTCCATATGAACTTTAAAGTAGTTTTTTCCAATTCTGTGAAGAGAGTCATTGATAGCTTGACGGAGATGGCATTGAATCTATAAATTACCTTGGGCAGTATGGCCATTTTCACGGTATTAGTTCTTCCTATCCATGAGCATGGAATGTTCTTCCATTTGTGTCCTCTTTTATTTCGTTGAGCAGTGGTTTGTAGTTCTCCTTGAAGAGGTCCTTCACATCCCTTGTAAGTTGGATTCCTAGGTATTTTATTCTCTTTGAAGCAACTGTGAATGGGAGGTCACTCACGATTTGGCTCTCTGTTTGTCTGTTATTGGTGCATAAGAATGCTTGTGATCTTTGCACATTGATTTTGTATCCTGAGACTTTGCTGAAGTTGCTTATCAGCTTAAGGAGATTTTGGGCTGAGACGATGGGGTTTTCTAGATATACAATCATGCCATCTGCAAACAGGGACAATTTGACTTCCTCTTTTCCTTATTGAATACCCTTTATTTCTTTCTCCTGCCTGATTGCCCTGGCCAGAACTTCCAACACTATGTTGAATAGGAGTGGTGAGAGAGGGCATCCCTGTCTTGTGCCAGTTTTCAAAGGGAATGCTTCCAGTTTTTGCCCATTCAGTATGATACTGGCTGTGGGTTTGTCATAAATAGCTCTTATTATTTTGAGATATGTCCCATCAATACCTAATTTATTGAGAGTCTTTAGCATGAAGGGCTGTTGAATTTTGTCAAAGGCCCTTTCTGCATCTATTGAGATAATCACGTGGTTTTTGTCGTTGGTTCTGTTTATATGATGGATTACGTTTATTGATTTTTGTATGTTGAATCAGCCTTCCATCCCAGGGATGAAGCCCACTTGATCATGGTGGATAAGCTTTTTGATGTGCTGCTGGAAAATATTTTTCTAGTGGTCTTCATAATGCCTAAATGTAATTTCACTAATATCTTTCAAGTGCCTGAGGCTCCCAAAGAAGTTGTTCCTGAAAAGAAAGTGCCAGTGCCTCCTCCTAAAAAGCCTGAAGTGCCACCCACAAAAGGTAGACACCCTCTTGTTGCTGTGTTTGATATTGTTTGTTTGTCTTTACTTTGTCTAATAATGAAAATACTAATATCTTTAAAGTCCCAGAGGTGCCAAAGGCAGCTGTCCCAGAAAAGAAGGTGCCTGAAGCTATTCCTCCCAAACCGGAAAGTCCTCCCCCTGAAGGTAATGCCAAAGCTATACAAACTATAGGAGAAAAATAACTGTTATTTTAACTAGGAAATTACATGTTAAAAATCCTACTACATAAAGATGATATAATTCTAAAGAAAACAAATGTCAATCACTATCCAAAATATCTTGGTGGGTGTTTATATGCAAAAGGCATCCATCATTTTCACCTTTTCTAAACACAAATTACAAATATCTTTGAAGTGCCTGAAGTGCTGCCACCGAAGGAAGTGGTCCCAGAAAAGAAAGTACCGGTGCCTCCTGCCAAAAAGCCAGAAGCTCCACCTCCTAAAGGTAGGTATCATTACACATTGTCAGTCGGGGGGCCCTGGGGAAAGACTGTATAGAAGTGTCCGCCGATCTCACAAGTTGTATTTGCTTGGGTAAATGTGGAGTCGATATTCCCCCTTTATAGCTTCTAACTAAAAGATACTAATATCTTCAAAGTTCCTGAAGCTCCTAAAGAAGTTGTACTTGAAAAGAAAGTATCTGTGGCTGTGCCCAAAAAACCGGAAGCCCCACGTGCAAAAGGTATTTATTCCCTCTCCTCTGCTAAGAATAACTTACTGTCTGTACCCCTCACAATCACTGTAATATATACCTTCGCCATTCATAAATTATAAAAATACTAATATCTTTCAAGTGCCTGAAGCTGCTCAAGAAGTTGTCCCAGAAAAGAAAATTCCCAAGGCACCAATCAAAAAACCAGAAGCCCCCGCAGTTACAGGTACATGTCAGCTCAACCTTATCCTGCAGAAGAAATCTCTCTTCCATTCCTGAAAACAATTTTAGTCCATTCCTCTTCATTAACCTAAGTATAAAACTACTAATATCTTTCAAGTGCCAGAAGTTCCTCAAGAAGCCGCAGAAAAAGAAATTCCCGTGGCTCCACCCAAAAAACCAGAAGCTCCAATTGTCCCAGGTACACTTTAGCCCTGACTTCATTCTGCAGAAGAGATATCTCCTCTCCTACTGTAAACAATTTTAGCCCATTTCTCTTCATTAACTTAAGTCTAAAACTACTAATATCTTTCAAGTGCCTGAAGCTCAAGAAGTTGTCCCAGAAAAGAAAGTTCCTAAGGCTCCTCCCACAAAACCAGAAGCCCCACCTGCCACAGGTATTTTTTACCCCTGTCCTTTTTCTGCAGAAGAAATATCTCTTCTGATCTTAGAAATATTTTACTCCATTTGTCTCATTAACCTAAGTGAAAAACTACTAATATCTTTCAAGTGCCTGAAGTCCCACAAGAAATTGTGCCAGAAAAGAAAACACTGGTGCTTCCTAAAAAGCCAGAAGTTCCACCTGTTACAGGTACTTGTCATTTGACCTTAAGCTTCAGAAGATCCAATTCCTCTGCTGTATATTTTGCTAGTAGTCTCCATAGCTCTACATGTAACTTTACTAATATCTTTTAAGTGCCAGAGGCTCCCAAAGAAGTTGTCCTTGAAAAGAAAGTGCCCTTGGCTCCTCCTAAAAAGCCTGAAGTCCCACCTGTTAAAGGTATTTGTCACTGACCTTAGGCTTCAGATGATCTAATTCTTTTGCAGTTGAAGACATTTTGTTCCAGTGGTCTTCATAACCCCTAAATGTAATTTTACCTAATATCTTTTAAGTGCCAGAGGCTCCCAAAGAAGTTGTTCCTGAAAAGAAAGTGCCAGTGACTCCTCCTAAAAAACCTGAAGTCCCACCTGTTAAAGGTATTTGTCACTGGCTTTAGGCTTCAGAAGACTGAACTCTTCATTTCTTGAAAATACTTTTCTAGTGGTCTTCAAACTTCTAAATGTAATTTCACTAATATCTTTTAAGTGCCAGAGGCTCCCATAGAGGTTGTTCCTGAAAAGAAAATGCCCTTGGCTCCTCCTAAAAAGCCTGAAGTCCCTCCTGTTAAAGGTATTTGTCACTGGCTTTAGGCTTCAGAAGATCAAACTCCTCTATTCTTGAAAATATTTTTTCTAGTGGTCTTCATAACCCCTAAATGTAATTTCACTAATATCTTTTAAGTACCAGAGGCTCCCAAAGAGGTTGTTCCTGAAAAGAAAGTGCCCTCGGCTCCTCCTAAAAAGCCTGAAGTCCCACCTGTTAAAGGTATTTGTCATTGAGTTTAAGCGTCAGAAGATCTATCTCTTCTACTCTTGAAAATATTTTTCCTAATGGTCTTCATAACTTCTAAATGTAATTTCACTAATATCTTTTAAGTGCCAGAGGCTCCGAAAGAAGTTGTTCCTGAAAAGAAAGTGCCAGCGGCTCCTCCTAAAAAGCCTGAAGTCACACCTGTTAAAGGTATTTGTCACTGATTTTAGGCTTCAGATGATCAAACTCTTCTGCTCTGGAAAGTATTTTTCTAGTGGTCTTCATAATGCCTAAATGTAATTTCACTATTATCTTTCAAGTGCCTGAGGCTCCCAAAGAAGTTGTTCCTGAAAAGAAAGTGCCAGTGCCTCCTCCTAAAAAGCCTGAAGTGCCACCCACAAAAGGTAGACACCCTCATGGTGCTGTGTTTGATATTGTTTGTTTGTCTTTACTTTGTCTAACAATGAAAATAATAATATCTTTTAAAGTCCCAGAGGTGCCAAAGGTAGCTGTCCCAGAAAAGAAGGTGCCTGAAGCTATTCCTCCCAAACCGGAAAGTCCTCCCCCTGAAGGTAATAATGAAACTATTCAAATTAGTGTTTTTTAAAAAAATCTTTCCTTAGTGTTGTAAAAACATTTTTTTGCAAACTATCTCAGTTTTAGTCAATTCTGGCATTAAAATGAGCTCATGTCTTTAAAGTGTTCGAGGAGCCTGAGGAAGTTGCCCTAGAAGAGCCTCCTGCTGAAGTTGTGGAAGAGCCAGAGCCAGCGGCGCCTCCACAAGGTACATGGCAAGAAAGCTGCTAGGACACCTCGGCCACTCTTTCCCCTTCCTGCCCTGATAATTCTGGGTGCTCTGAGCTTTTGTCTTGTTTCTCAATCTTCGTTCTTTCTAAAACATACCTTCTAATTCTTTAGTGACCGTACCACCTAAGAAACCTGTCCCAGAAAAGAAAGCACCTGCTGTCGTTGCCAAAAAACCTGAACTACCACCAGTGAAAGGTATTCCTCACTGCCACTAACTCCCTAACAAAAAACTTTCTTTGAAGTGTCATATTCTACTGTTCTGCTTCATGATTTTCACATTTCATTGAAACCATGAGCTTAAACAACTACTAATATCTTTTATAGTGCCCGAGGTGCCCAAGGAGGTTGTTCCTGAAAAGAAGGTGCCTCTGGTGGTTCCCAAAAAGCCAGAAGCCCCACCTGCTAAAGGTATATGTGGCTGTCCACTGTTTGATGGGGGCGGATGGAGCCCCCAGCTTCTAAAAGGGTTTTGTTCTGTGTAAATGTGATGAATGTTTACTGGTGATTGTTTCTAATGTTAAAATACTAATATATTTGAAGTGCCTGAAGTTCCAAAAGAAGTTGTTCCAGAAAAGAAAGTAGCTGTTCCCAAAAAGCCAGAAGTCCCACCAGCAAAAGGTACATGTCACTAATGAGATTCTGCAGAAAAGCACTCACCCTTGTCTAATAAGTCACCTATTATCAAACCTTTTGTTTGCGAGTCCTCTTAAATTTGCAACTACAAAACTGTCATTCTGGATTTTTAGGGTCTGAATACTTTTTAATAATTTTTTCATTGACTTTAAAAAGTGATATATTTACTTATTACAAGCATTGGAAAAGTTTACTAACTTGGTTCTTTTATTCTTAATAGGCCATATTTTCCTCCCCACTATATGAGGGTCCAAAGACAGATCACTGACCTTATTGTGAAATTTGTTCTTGGATCTGTCCCTGGGTTATTTGAGCAAAATGTGAAGTCGATGTGGTATAAATTTAATATACTTCTCAACTACTCATAAGAAAAATGAATTAATATCTTTAAAGTGCCAGAAGTGCCAAAGAAACCTGTCTTGGAAGAGAAACCAGCTGTTCCTGTTCCAGAAAGAGCGGAGTCTCCTCCCCCAGAAGGTACACGTGAGACCGGTGATTAATGACCTTGCCACTTGCGACTATTTCTAATTTAAGCTTTGTTCTTCTTCCTTCCTAACTCATTATTTCTTGGTCATTTTCTAACCTTTAATTATTTGTCTTAATTCATCATTCTAAATTAGCTCCAATCTCAAATCTATTTTGGGTTATTGGTCCACAGTATCTACATAAGTCATAGTAAGCTATATTAAACAAAGCTTCTCCAATGTACATAGAAAGTAAGGCAGGAGAACTAATGATTATAAATGACATTAAACACTAAAAGGGCTTTGCAAGCATTTGAATCAATAGACAAAGAAGTCAGTGCAAATGAGATAGATTTTATCTAAACAAAAATAAGAGAAGGTATCAATTGAAACAAAGGAAGAAATCAAGATTACTATTTATCGTGTTTAGTGTTTGTCCATCTTAGAATATTGTTCCATACATTGAAATAAAATTAACTAATATCTTTAAAGTATATGAAGAACCTGAGGAAATTGCTCCTGAAGAGGAAATTGCTCCTGAAGAGGAAAAGCCAGTTCCTGTTGCAGAAGAGGAGGAACCAGAGGTTCCACCTCCAGCAGGTACAAAGCAGAATCCACTGTATGGGAAAATACAGTCATTTCATTTTTCATGTCTATATATCTTCCTTAAGGCAAAATATCAGTCTTGTATCTTGTTGCCTGAAATCTGACTACATTAAGAACAAAAGTTATTTCTACACATAAAACTTTGGACCCACAGAATTTGGTCCCACATATACCAAGAAATATGTGTGGTTTTTAATTCATTCATTAGCATTAAATTTTTCATTGTAATCACCTAATTCTAAAAGAAATTCCTATTATTCAAGTGCCTGAAGAGCCCAAGAAGATCATCCCAGAGAAGAAAGTTCCTGTCATCAAAAAACCAGAAGCACCGCCTCCTAAAGGTACTCATGTTAAAATGAATACTTCATTTTTGTGGTGTCTACAATTTTACACTCTTCTTATTGTGTGTTGTGTTGTATTATATGTTTGTTAACTCTTACCTATATGTTACAGTGTTGAATAAACTTGTATGTATATCTTACATCTCACAACTTTGTATTATTAAATGCTACTGATATCTTTAAAGAACCTGAGATGCCAAAGAAAGTTGTTCCAGTGAAGAAGGTCCCAACTGTTAAGAAGCCAGAAACACCAGCAGCTAAAGGTATTCACTTCATCGTTGGCATCATAAAAAAGAAAGTATTCTGATATCTTAAAGTGGAATCCAATAAGTTGTCCTCATTGTTGTTGCATAACTAAGGACAAAAATTTCCTTATTTTGCTTTCATTAATTTTAATGCTGCTCCAATAAATACAGGTTTTTTATTCTTAATATTTTAAAATGTTTTTAAATACTATTTTTAAAACAAAACTAATATCTTCAAAGTGCCTGAGGTGCCCAAGAAACTTGTTCCAGTAAAGAAAGAACCTGTGCCTGTTACCAAAAAACCAGAAGTTCTTCCAGAAAAAGGTACCTACCATGAAGAAAAAATAGATTTCTCTAACTGCTATTTAAGCATGTTAATAATAGGTCTTAGAGAAAAACATACTGAATGTGAATTTATGTTAAAACCATATTGCACAGAAAAAAGGGAAATAATGAAGGGAAAAAAATGAAACAGACAAGCAGGAGTGAAAAAATGAGTGGGATTCAGTTGTGCTGTGATATATCACATGGCTACAACTAGTAGAAAAGAACCTTCTCTCATTCAATGTGTAAAACAGCTCAATTCAACATATTTTGTTGAATGTTGACCATTAACAAGACATCATATTAGAAAAATTAAGGCCTGATTCTGTCTTCAAATAAGTTAAATCTGGTGAGAGGATAGAAAGATAACAGGACTCTAATACAGACAGGAAGTGATTACACATAGCAAGTGAATACAAAAGGGCTGCAGAAACACACGGCAAGAAAAGATTAAGTTCAGGCAGAGGCATCATGGGAAGCTGTGTTAAACTGAATTTAAATTTTGATGGACTTTTACATGTAGAAATTGAGGAAATAAGGCCGGATGTGGTGGCTCACGCCTGTCATCCCAACACTTGGGGAGGCCAAGGTGGGTGGATCACTTGAGGTCAGGAGTTCAAGACCAGCCTGGCCAACATGGTGAAACCCCGTCTCTACTAAAAATACAAAAATTAGCTGGGGGTGGTGATATGTGCCTGTAATCCCAGCTACTTGGGAGGCTGAGGCAGGAGAATTGCTTGAACCCAGGAGGCAGAGGTTGCAGTGAGCTGAGATAATGCCACTGCACTCCAGCTTGGGTGACAGAGTGAGCCTCTGTCTCAAAAAAATTAAAAAAAAGAAATTGAGGACATGATATCCCATGGAAAGGGAAGAGCATATTGAAAGGCACAGAGATAGAAGGGTCTAGAATGTTCAAGGATTGTCAAGTAAACTTATGTCAAGTAAACTCAATTTGAGTATGGATTGGCTGTGGAATGTCTTGAAAGATAATACCAGATATAAAGATGGGGTCATATTTTGGAGTACTTCAAATGCCAGTAAAAGGCTTGTACTTTTTTCTGTAGGCAATAGGAAGCTTCAAAGATTTTGAAGCAGGCTTACATATTAATAGGATTTGGGCTTTAGAAAGATAACTGGCAGCAATTTCAGCTACTAAATAGTAAAGACCCATTGCAATTATTTAAGGTCTTTAAGAGTTGGACAAGATCCGTGGCGGCAGAAATGGAAAGGGGGACTGGGTTTGAAAGAGATGGAGACTTAGTGGCCTCTGACCATTATCAAAACCATTAGGGAAATTGAGGAGCCCAAGATCATTGTAAGGTTTAAAGCTAGATGGCCAAAAGAATGGTTCATTGGGTCTCTGAACTAACGTTAGAGGAAAATGGTAGATGTGCTTTTCACCTTTAAAGCATAAAAGTTGGGAGTGTGTATCAGGAGCTTAAGAAAGAGATCAGGCCTAGAGATGTAGATCTTAAAGTCATTCACATGTAAATAAGAATTGAGTGTGCAGGAACAATTACTCAGAAAATGTAGAGCAAATTTTTTTAAGTGTCAAAGTTAGACCACCTTCATTTAAGTGTACACAGAGGACTAGAAGCAAATGAAGAAAGCTGAGAAGATTCATATATAAAATTAGGATGTCCAAAATGGTGCCATGTCTCAGAAGCCATTTTCCCCATGAAATCTAAGATGAAGCTCTTGCCCCTGCATTCTTTGCCTGCTCTTTAGACAATCTTGCATGTCTTCTAAATTCTTAATAGTAAACAAAATCATATCTTTAAAGTGCCCAAAGTGCCTGAGAAAATCATCCCAGAAAAGGAAGTGTCTGTGCCTATCCCTGCAGAGCCAGAAGTTCCACCTGCTGAAGGTACACGGCTTCTCCATAAATCTTGGAAAGATGACAATTGTCTTCATCCTCTTGCTTTGATTGTAGATGAATCTTACGTATTTGTCTGTCTGTATTGAAGTTATTGATATTTGGGGGGTCATCTGAATAATCTGTTATAGAGTGTTACTTAATGTAACTAGGTTGATATGTTAGAATAGTAGTTGCAGTATTCTGTTCTAAATATAGTCTAAAATAAAATACTATGTTTTTTAAAGTTGAAGAGACTCCTGAGGAAATAATATATGAAGAAAAAGCATCTATAACCATTGGTAGAAAAGAGACTCCCCCTGTTGAAGGTATATATATATATATATATATACATTTTTTTAATCTCCTGAAGATTCCTGTTAGAATTACAAAAGCATTTACAGGACAATATTCCTTCTTGAAATTATATACAAGAGCAGTCTAGCATGTTTGACTGCTTTATTTTTGAAATAGTTACACTTCTTTTAAGTTAGAATCTTTAATTTAGTTACTGTTGTTGGTAATTACAATTTCCAAAAGGTACAGTTTACTGAAGCAAAATGGAATAATTGCCTTGGATCCTCAAATGATAACACGGTATCAAATTTTAAAAGTCATCTCATTTGCCATCAATATACATTGAATAATCTAATTAATAGGCAGTTCAAGTAAAAGAACTTTTTCTTATACGTGAATTTTTCTATACATGAATTTGTATGAATTGTATATTTTTATTTTGTGACTGTAATCTTTGCATCAATGTGAAATTTGTATGAGTCTTTTTGAAGAACTTTACATTGCAACCTCATCTCCTTTGTCAACATTCTTTAAAGAACGTGAAATTGAAAAGTATATTAAACCTGAAGAGCCCGAACCTGAACCACAGCCTGAAGAAATACCAGTAAAAGGTATTCAATCCAGTGGACTTAAATCTTCTTTATCATATTCTTTCTCTTGAAATGTATATGGTTTATGTTGTTGTACATATGTAGTATGTCTGTTCCCATTTGTATGTAAAGTATTCTTTGTTGTAAATGTGAGCCTCATTCTTAGGTTTCCATGTAACTTGTACTGTTTCTCTCATGTCAACTGTGGCTTGTCTGGATGCTTTGTTTGTTGTTGTTATTGGTGCCTTTGCTGTATTTCTCATCATCTTTGTAAAGGGTTGATATTTTTATGTTTTATGTTCTGTGTTTTATGTTGGATACTGGTATTACGTACCTTAAAAAGTAAACTTTGTACTTCATATATATATATATATATATATATATATATATATATATATATAATTTCTATTAAATATACTACATATCCACATGCTAACATATACATATACTAACACCTCTGAAATACTCTTTCAAGAACCTGAACCTGAAAAGGTTATTGAGAAGCCAAAACTCAAACCAAGACCCCCACCTCCTCCACCTGCTCCACCTAAGGAAGATGTGAAGGAGAAAATATTCCAACTTAAAGGTAAAAAATGCCACTTCCAAAGTTTTATTAGCCTGCTTCAAACTTCTATCCAGCCATCTGAAATGATGCTTGCAAGAAATGTATGACTTTTAGAAGTGTGTACTTTCAGACATGATTGTACTGTGAGATTGCATAGAGCTGTCTCTTCTGCTGCCCCATGGTTCCTGGGTTGCTTGTCATGCCATGCCTGCTGCTGCAAAAGTCAGAAAGTACATTGATAGCGTCATCCGGGATATCTGAATGCAGGCACTGTCCAATTAACTTTCTTTTGTGGAGTGGGGAGAAAGAGTTTTCTGATTTCAAAGCCTGATTGCTATACATATCATTGCGATCTTATGCTTAAGGAATGTATAAGAAATCCTTGCAAGATATTTTTAATATTGCAGTAACACATTTACATAAAAGCCAAAACTTTGTTCTTAAAGAATTGCATGTGCTTTTAAATATATTACAAGTAATATAGTTATGATTTCCAGTAGCTGATATGTGCCTATATATCATGAAAGGAAAGCATATGAATGACTTGTTACAGTTCCCCCATCTCTTTTTTTTTCTTGCAACTTAAAGAAGTGTTCTGTGTGGTTCTCAGGGGAGCTGGAAAGAGTGGTTATGAAGACATTTGGTATCCAGCATTTATTATTAAACTTCCCTTCCCCCTTCTTATATTTTGATTTTTCTATGAATTGACACAATGTTACTTAATTTTAAAAATATCAGTTTCTTTAAAAGCTGAAATAAACTGGCAGAAACATATTATTCTTATTTTAATAAAAAGTTGTCTTGTGACGTCATATGATTCCCCAATCTAAAATTATCTAGATATAATCTTAGATATGCACTTTCCCTATACAGACCTATGTATCTTCAAACCACAGTCTTCCAGCATAAGACATTGCTGCTGGTGATTCTTGCCCTCTACAACCCTCATAGCCATTAGGGGGACCTTCTGGCACCTCTTGAAAGGCCACCCATCTGTTAATTGACACTCCATGAAGACACACACATAAATACATTTCCCTTAATGTAAAATATATGCTTAAAGGAAAATTTCTTCCTCCTGCCAATAACAAAAATTGTCTTCTTTTTCTGCTGGTCTTTAATTAACTACTGAACTTTGGAGTAAAACTGCAGTCTGTTTTCATGGTTCGAATGCTGCTTGTATGTTCTTTGAAGGCTGTTCTTGGCTGTTATTAATGCTTTCTGGTTATAAGCAAAGCTTGGTTTTGATTCTTGGAGTAGAAAGTTAATCACTTGCTTCAGATTAAATATACAAATAACAAAAGTAAAATCATATTCTTTAAAGCTATTCCAAAGAAGAAAGTTCCTGAAAAACCTCAGGTTCCAGAAAAAGTGGAGCTTACACCTCTGAAAGGTATTTCACAGGCTGAAAAATACATACTTATGTAGTACCCCTTTACCTGACTCCTTGCTCTTTCTGCCTCCATCGAATGTTCTGTCTCTCTTTTTCAATGATCAGAGAGTAGTCCCATTCATTTCTTATATTTCTGTGGCTTTTATGGTCCTGGCTCATGAGTGTTGCTTCCTTTGTCTCCCATCCATTTCATACATGTATAGACATGGTCTATCTTTGTCTCATCTACATATGTCTTCTTGCATTTTCCTAAACTTAAAAATAACAAATTTTACTGGTTAGCCAAAATTGATATCAAGAGACATATGAGATTAAAATGCTGAGAGCTAGTAGTAAACTGTTTTGACATTTCACCTGACATAAAAATTTTAGCCAATGTAATAAGCACTAAAAATAAGTCCTATCTTCCTTTTATATTATTAAGGTTATTTGTAGGGATTTCCTTAGGACTTTCATGTCACTCTCTTCTCACTGGCTCTAAGTCATTCTCTGAGGGGTACGGAACTCACATTTCAGAAAAATTTCCTTATTACTGTAGGTAATTTTTCAAAATGTATTTTTCTGTAAACAATATTTTCCCTAATAAGGTCTCATCTAAAATTAGACCCTAAAGAAAACTAAATGAATTATAAGAGTCTAGAAAACATCTATCAAAAATAAACATAATTTTTCTAATGGGTAGTAGTGTTCTGTTCAAGTAATCAACACATTCAGACCTAGAAATTAAGACTGTTTCTGGTCACTCTGAAATTTTGGGGAAAAAAGTCACCCATATAAATATACATTTCCTGATTTCATAAAGAGGCAATTACAAAATAATGTTATCATGGATATTGATCATAAACATTAAAATAGCATATAATCACATATAATGACTTTAAAAATAATAGCTACAATGTTGGGTTCTCAAACATCAATAAGATTTTTAAAATCAAATAATAATATAAAAAATGCACAGATATATTTTCACTATGTTCATTATATCAGTAAAGAAAATCTATATTATGCCTCCTCACTTTACATTAATTAGATGCATGTGCTTCCTTCTGGGTTTGAGCAATAAAAATAGTTATTAAGAAGATTGGTACCTCTAAAATAGTATTGAAGGCCAACACAATTTATCCTGGATAAAATACGTAATGTTTAACTTTAAAATTTTTACTTAAAATATTTGACATTAAAAAAATGATTATTCAAAACGAAATACATATTTGCCTATTGTAGGTTTAAATTTTTGAAATAAGAGTTAAGCAGTTATCTTTATCACATAAAAAACCATTTAATGAATTGCAAATATCTTGTTTAAAGCCCTAAATAGGAAGTTTTATAGAAATATCTAAAAATTCAGATTCCTAATAGCAAATAGTTACACAATACAAATAAATACTGTTTTAAATTAGATTTTAATTGACATTAGTAGAGAGGAAAATGGTTTAATAATCACCACGTGTTCCTTTCTTTCACCATTCAAATCTATGAGGGCCATAATAGCAAAAGAGGCTGCTCTATAAAATAGCATCATCCACCATGCTCAGTATTCACTGTAGACGCAACAGGAAATTTTGAATTCCTTGCGTTCCTTAATTTGAATGAATTTAAGAACATTTTCTTATTCATGAAAAACGAGCTTCCAACACCAGCTTTGAAATTTTATAATTCTATAATTTTAAATATTTTATCCAGCATTATTTCAAAAAGGAAATCTTAAGAAAGGCTACTCTTCTTCTGTTCAGAAAGTGAGATATGGCCCTTCCCCAGCATCAAAGTCACAAACCGGAACTCTTGGCCACCTTCTTCCCTCAGTGGAGAAGACTGAATGATGGCACTAACACTTGCCAGTATCATTTTCATACATTTAGTGGTTGGGTAGATAACATCGTAGATTTGGACAATCTACAATTGCAGTTTGGGACAAAGATGCTGTCAAGAACCCTGTAATTTGATGAAAGATTCATAAAGTCAGTATGGAGCAACATCCTCTACATGCATTTAAAATGAATACATTTGCCTGCAGTTAATGGAGTTGAATTTCATCACAAGGCTGTATAGATATTTGCAGAGGAGATAACTTGAAATGTATCATTTAAACTTAAATTCTGTGGTATTTATATGCAGCGAAAATTGTTACTTAATGCACTACAGTTAACTAGTTTTAGGAGAGACATTTTTCTTGTTGAAATTCCGTTTTTATATAAATTCACTTCAAAATTTGAAATCATATTCTTTTAAG
>TTN-211,,0,921,2479546,2480466,GTATAGTATTTTTCAACCATTCTGTCAGCGTTAAGTATATTTTAAAAATGAACTTGAAAGCTTACAAAATGTTTCTGTCCTTTGGTTTTCTTTGAATTGGTTCGCTATTTATCAAAATTTGTTTGTAGTTTCATTGAAAATTAAGAAAAATGTCATTTCCAGATCTTTTTTTTTAAAAAAAAAAGACAGAAATTTTGTGAGCATTCACAGTATTTTGAAATTTAAAATGTTAATAGACATAACTAAGTTGATAATATTCTAAACTAACAACAACTATGACTGCCATTTTCATAACCAAATTATGTAGTAAAGTACACTAAACCTATTAAATACCTTACATGAAACTACTTTAGCTTAAATTCAATATTCAGTTTTAAAGTGTGACACAGGATCACCACAACTAATAAATAACATTTTTAAAAAACTGAACATTTCTTTCTGACTAATAAAATATTAAAGAATGAGAAACAAGATAGTCAAATGAAGAATTAAGTTCTAACATTGTCTTCACATAGAATTACTGATTTTTAGGCTACATTTCTTCAGATATCTCTGCTTAAGTAAACTTTCTACTTATTTACATACTCATTAAATCATTAACATTTAATTATTATTATAATTCGTTGCTATTCAAATTATTCATTTTGTGTTGGAGCTGTTTCTCCCACAGACTTGTCTCAGAATAGACCCTCTATCTAGATAGAAACAAAGTAACTTTGAGTGCTATTATAATTGACAACCTTTGATTTTAAAAAAAACAAAACAAAAAACACTTTCGGTGTAAATGCTTACTTTCCAGAGTGCTAGGTAGCATGCTTTTTTTCATTTTCCTTGCTTTGTACATTATTTGCATTTGTCAAGCTTATTCAACATCTTCATTAGTTTGTCTTGGTTTACATATAAACCTTTTTGTCTTTAAAG
>TTN-211,,0,610,2480467,2481076,GTAGGAATCTCAGTGACAATTTGTAAGATTATCTTTTAACAAAATGGACATTTAACAAAAGGTTTATCTTGTAAACATAAATGAAGTTAGATGTAAACATGGCTTCATATTTCATCTGTGATGTAGTCTCTGTTTTCCATTGTCTGCTTTCTGTTTAAATATTTTTATAGTAATTCCCAAATCCATTCATGTATTTCCCTGCACTTCATTCTTATCATTACTTTGCAACTTAAGTTCTTCCAGTAGAAATGACTGAAATAATCAAGTGGCTATTCATGGGAGGGTGTCAGCAAAGGTTTCATAATCTGGGGGCTTTTAAATGGGTTGGTTTTTATCATTAGCCTATTCTCAAAGGGCAAAATTATTGGGAACTATTATAGAAGTGATTTAGAAGGAGAGAGCTAAGGGGAGTGGAAGATAAGTGGATGGAATAAAAGGAAGAAAAATAAATGGAAGCAGAGTCAAGAAAATAAAATAGAAATTACTTGATAAACTATAAGGTTTTTTAAAAAACCATCCATAGAGTTTTTGAAAAATAAATTGATATTTCAGATGAGGTGCTTCCTAAATATTCAAATATTAACACTGAAAAAATAATCTTATCTTAAAG
>TTN-211,,0,430,2481077,2481506,GTACAAATCTACTGTCATTCTTAGTTGTCTCTAAAAATGCAAATATGTATCATTTAAAATATCATTACACTGACATCAAGATTTGAACACATGACCTTAATCTGTTAATCACATATGGCTTAATTTTCTTTACCATCTCACTCTCCTATGCAATTGGCTAATGATTACTCAGTTGCTAAATAAGTTACCTGAAAAAAAATTGTATTTATGGGCAATGAGATAAATAACAACATTAAAACCAAGAACATTGCCTTACTATATTTTCCAAATATTTTGTTTAAAATGAAAACTAATCAAATACTTGATTTGATAATTATATGTATATAAATTCTAATATCTTCCAAGATACGTGGGCTTAATTTTAGTTTTGACTTTGTGAAAAACTTCAAAAATCCTGTAATAATCTGCCCTCTACTCTAAATTATTTCAG
>TTN-211,,0,259,2481507,2481765,GTGAGCAAGCTTATCCTCAATGTCAACAGCATATTCTTTCTGTATTCACACACATAACATGTACTTAATAAAAGATAGTAGGTGAAAGTCAGTATGTATCAAATGATTTCTAACGTCTCAAAATGCTTAATATACTATTCTCTTAAAAACTAGTTATTTGAAGATTTCAAAATTATATCAGAAGAGGCAAATAAGCTACCAAATAAGTTTTTAGGAAGTGACAAATTGATACACTAATGCAATGGACTTCTCTCTACAG
>TTN-211,,0,2279,2481766,2484044,GTATTTATCCTGTAGCTTTCTTTTTGCTAGTTTGTTTTGGTGACTTAATAAAAGTATTCACACTTGATTAAAATTCAAGCCCTGTTTATGCTGCAACATAGGTATCATTTCAACTTCGGAGGTTTATGGTAAGTTTCTACCTTTTCTTCATGTGATATCCTTTATCCACCTTGTCTCTTGCCCAGTGGGTGAATATTGTGCCTTAACTGGAATGTACGTTCCTGGGTTGCACCATTTCTTTCATATGCTTTGGAGATTAAGTAATGAATATGTTTGGGGCTGATAAAAACTAAGGAGACAGGCAGAGACCCTGTAAGGGTATACATATAAGAATCCCATGAAGCTTCAAATTTCCCTTATACCCTATTGGAACAATTTCTCTTTTTTAAAAAAGTGTGTATATTGGGATAATGTAAAAGTTCTGGAAATGGATAGTGTTGATGGTTGTACAATATTGTGAATGTATTTCATGCAACTGAATTGAATACTTAAAAATGGCTAAAATGGTAAATTTTATGTTAGGTATATTTTACCACAATAAGAAAGAAAAAGAAAAAAGAGACTCCATATTTCAGTCTTTTAATCTGTATAAGGAATTAGATCAATAATAATTTTCTTAAATGTTCTAACTTAATGATATAGGTATCTCAAGTCCAAACTTAAAGCACCTATTAATTGTATATGAACTATTTAGTATAGTTCATCATTTAAGTGATAATTTGAGATATAATTGATCAAAACTGATTTGATGTGTAATTGATAGTCATTGATAAACATACACATCCTGACTATTTGCCCTTTGGCTCACTATCTGGGTGATGAGATCACTCATATCCCAGACCTCAGCATCATGAAATATATCCACATAACAAAACTGCACATGCATCCCATGAGTTTAAAATAAAAGTTGAAATTATTTTTTTAAAAAAGAAACAACAAAACCAAAAATAAAACAAAGTAAATTTAAAGCGGGGGCGGTGGTGGTGGGGTGGGGAGAAGGCATGTATTGATAATTTTCTAAGATGTGAAGAATCTAAGATATTCAATATAATGCCTTGACAATTTGTTCCTATGGAAAAATGATCATCTCCACTGATAAAGCACAAAATAAAAAATTCAGGGTGAATTTAAAAAAAAAAAAAGAGAACTATTTGTTACATTCCACAGTGAGATGTGCATAGGCCCCGGGAATAACATTTAGAAATGTCCATAATAGTTTGACAGAGAAATTTTTTAATTTAATTTTCTGAACCTAATAATAAAAATTGGCTTATATCTTTAATAAATCAATAAATAAAACTATTTGGAAAAATTATATTATTTTAGATTATTAATTCAATAATTAGTCATTTTATATTTGTTTATATATTTTTATATAAATTATTTAGAAATTTTTTTATTTAAAATTATCTCAAAATATTTGGACATTACCATGTTTAATGACATAAAAAAATACACTATATTCTTTTGACTGTAGTTTAATTTTTAATATTTGTGTTATATTTTGTTGCTGATGTTTATGATTTGGGCATATTCTTTTAAACTTTTATAATGTCAACGTAGTACTTTTATTATTCAGAAAAAGGTGATGAACTGCTCTTGTCTAATTAAGTATGTATAAAAATAAAGCTATTCTCAGTTATCCTGGGGGCTGAAGCTAGAGAACTCATTCCACAGTTTATACTGTCCCTGTATTAATAATGGAATCAAACTCTAAATGTCAGAACTCTCTTGCTTCTGCCTTACTTCATTGTCTAAAGGAAATCTTCAAAGAAACTCATGCATGTGTGGTACATGGACTCTTTTTCCTTAGTCTTCCCTGGATTTGTTTGTCTGCCCAATTTAGACATAAAAAGAAAGGCTTTTGGTAACCTCTCAGCCATTTCCCTTTTCCCTACACTGATTTATTGACAAAACCTTATTTCCTTGGTTCACATAATCAGGACTTACATAAACATATAAAATATTTTGCACAGCTAGGCAGGAGCAAAACTTTTCCTCACAAGGCAACAGTAAGCCTTCCAAAAATGGGAAGATAATAAGGCACTTGCTGAAAGAAGTTGTTAATCCTAAATATGTTGGCAGTTTAGCTTGAGCTCTTCAGTCTCAGAATATGCCTTCCTGGAAATGTGATTATCCATAGAAGTCATATAAATGAAACCAATTTCTCTTTATGCGTTAATATTTATAATGGAGCATGACTCACCCTCCATGGTTTACTATTAAACATGAAATAAGTCCGAAAAGTGTTTAAATGCTGAGTTTTATTTTTATTTCAG
>TTN-211,,0,569,2484045,2484613,GTGAAATTCATTTTTCTAGTACTTGCATTGTAACCTTCCACTCTGAATTTCCAAAGTTCATATTCAAGGGGAAAAAAATTTCAAAATTCATAACAATTTTTATTTTTTCTAATTGATTCTACTAAAACTAGCATGTTTTCTGATATTTCAAATAATACTTTTAGTATTATGCAAGGAGATATATATATATATATATATATATATATATATATATATATATATCCAACTATATTTTAGCATAGTGAATCCCATAAGTTCTTAGCTTCATTTTTCATATGCATGGTATTTATACATGGCAGATAAAATAATTAGACATTAATCTGGCTATTTTATACTTCAGATTAAAACTTGAGAAAAGGGACATTTATTATTCATGGATTCCTTATACCATCTCATTTTCCTGCCTGAAACAAGGCAGTATAAACTCAATTGGCCTTTCAATTGCCTGGTCTTTAGTTTTCTCGTCTTCTAATTGCTTTACGGCTGGTTTTATCCAGCAGGCAGCCAAGTATGAACTTTCTGACTCCTAAGGAGATGCCAAATCAACTTTTTATTTTACTTTGAATTAG
>TTN-211,,0,156,2484614,2484769,GTAATTTCTAGTCTTCTGAACATAATCTATATTAAACTTTAATGTAACAAACCTTAGTAGCAACTTGCATTGTAGTTTTACAAAACCTCTTATTTCCAAGTTTTATTTCATTGAAAATATTGTATTTATTGAAATATATACTGAAATTCTCCATAG
>TTN-211,,0,247,2484770,2485016,GTTAGTACTTTCCTGGGAGATTTCGTTCTGCTTATTGTTACACTAAGAAAATGGAAGAAAGGACCTCGTTTCCCAGTATTACAATATCAGAAATCTTGTACCTAAGAGGGGAATAACAATATATCCTACAGTGGATTAATTATGCCCAGTATTGTGAAATTTTTCCTATTCCTGAAATTTACTAAGGAAGCTATGTATATTACTTGTTCAGACCTTAATCATTTTTTCTGATCTTATTTTCATATAG
>TTN-211,,0,135,2485017,2485151,GTATAAAATCTTACCTTTTATTCAAATTATAAGTTTTGCGTATGTGTAAAGCCAAATAACACACCAAAACACATAAAAGCAAAGCATCGTTGGGTTGTCTAAAGCATTATGTTACTTCATCCCTGACCAATACAG
>TTN-211,,0,315,2485152,2485466,GTGAGTAATTTCACATTTTAAATTGTTAGTCATATAAAATAACCACATCCAATATTCAGGATCTATATCCTAGATTCGGGTTGCTTTAATAATAATGGAGTTAATGGAGTCTTCTAAAGTCTCCAAGAAGGAAAGAAATTTTACGTATCATTTGGGGACAACTTGAACAATTTGTGTAAAATGTTATGACAGGGAATTCTCTGCTTACTTTTATTAGTAGTAATTTTTAAAACTCTATAGAAATTTGTATCTGAAACACTTCTCCTATAGGGAATTTATCTCTTTCAAATGGTTACTAAAACTATTGTTTTTCAG
>TTN-211,,0,93,2485467,2485559,GTATGGGGCTTTTAGAATTTGGGGAGGGGTCTCAACTTTATTTCACTTCCCTGTGCATTCTGAAAAGCCTCATTCTTAATGTCTGATTTTCAG
>TTN-211,,0,282,2485560,2485841,GTAAGCGAGCTAATGAGATCTGTGACATCCCATAAAGGCATGCAAATATATGACTTTAAAGATAGGACGCCAAGTTCTAAAAGCTGTGATAATGCATCACTAATTAACTTTCACAGTGTTACCAAAACAACCCCCCTTAATTTGTTTTTAGTGGAGCTCTATTTGGAAAGATGAATAAATAAGTGCCATGTGAAATGGGTCCCTTTTACTCAGGCAGATTAGAATGGAATCTTTCTGAAGGTGAATTGTGTTTCTGAGGCATTATCTATGCTTGCATTTCAG
>TTN-211,,0,140,2485842,2485981,GTAAATGTAACCAAGTATAACCAGATAGCCAGTTTCTGAATCATGGGAGTGGGGAGTAATAAAATATTTTGCAACCTTTTACTCTTTAATAAACTTTAATTTTCACATTCTTCTAATTTTATGCTAAATGTCTTTTACAG
>TTN-211,,0,86,2485982,2486067,GTGAGTTGCTCAACAATGTAAAATTTACCCTATCTGAATCTGCAGTTTATTAGTTCAGTCATGCTAACAAAACTGTATCATTTCAG
>TTN-211,,0,142,2486068,2486209,GTAAGTCAAGATTAGCTAATTATATAGGAGAGGGGTTGCTTGGTTGTGTAGGGTGAAAAAAGGCATAAAATATCTTGATGATTTGTAGGAATAACTATATAAATGATGTTCTTTCTTTCCTTCTAACCCTCACTCCAAACAG
>TTN-211,,0,125,2486210,2486334,GTATGCTCTACTTGTCAGCCACGTTTTTGTATTTTCTCTGCAAGACTTCCTGATACACCCCTGCATTGATCAAGGGTCATCAATGGAAACGTATTCTGACTTCATCCACTGTCCACTTCTTTCAG
>TTN-211,,0,112,2486335,2486446,GTAAATAGTTTTATCAAATAGTCCACCCCAAAATCATTTTTTTTGCCTTTAGTTTTATATTTCTTCTTTAAAGTGCTTCAATTAATAAGTTCTTTCTTTTTTTTCTTGATAG
>TTN-211,,0,846,2486447,2487292,GTAAGTGCTTTTTAAATTTTAATTTTACTGCATTAAATTCAACAGAAATTTGTGGAGTATCTATTCTATAAAATAGTCTTCTAAGTGTTATATTGCATGAAAGCAGCCCAACTCCTTAAGAAGCTATCACATATGTAATCAGGCTTATTTCTAAAACACTTTACCTTCATTACTATAAGTTAATGAAGATTCTAGCTTACACCCACAAAATAGCCAATTAAAAGCCAACTTAAAATTCTTCATTAATTATTGAGCCCTGTCATGTTTAAAATAGGAGTATATAAATACTTTCTATCTCTTCATTTTATCAAAATTATTTCAGAGGAATGTTTTTCAAGTTTCCCATAAGAGAAGATATTACATAATTTACATTAATAAGCCTCATTGTTTTTCTTGGCCACCTAATATCAACAAGATTAAACATGAAGGCTAACATATATAGACATGATTAAAGGCAAACTATTAATTGATTAAGAAAAACTAACAATGTGAACCTGAAAGCTTAAAAGTAAACTAGACATAATAGAGTTGCTAAGAATTAGAAATTTACCCAAATAATGGAGGAACACAAAATTGTATTTGAAGCTAAATTTCAGTCTTTTTAGCTACTGTTAATAAAATGTTTCAAAATTCAATATGAATGGATTAGATCTTGATAAATCCCACACACTGATTCCCTTCCTAATATTTAGAGAACTTTTGAACATAAACAGGTTAAATGATTGAACACTTGACACAATTTTAAAAGATACTCAGAACTCTGTGAGTTGTGTCTTAAACTTTCCAAGAGATTGTCATTTCCCTAAGGTGATTAATAAAAGCTTTTCACTTATACTTTACTTGCAG
>TTN-211,,0,90,2487293,2487382,GTAAGGAAATTTCCATGAGTTTCACTCTTGAAGCATTGGGGTTATTTGTGCCAGAGGCTAATGACCCATGCTGGCCCTTCACTTTTCTAG
>TTN-211,,0,436,2487383,2487818,GTAAGGCTATTTCTGAACTTGTCAACACCTAAAGGAGCTGTGTGAATTAGAAAAGAACAGGTGAAAGTCAGAGTGGATGCAGGACATTTAAAACATGATAGCAGTTTCTCTATCAGACCCTAAGCCAAAGAGAGATGTCAGGGTCTATGAATGGGCTCAGACTGGCACACTTGCATTACTTTTGATCCAGCAGAGTGAGTATAAGGTTGTAGATACTCTGTGATGCTGCTAGTTGGCTCAGAATTATACAGCTAAAATAAATGTGGCTTTCCTCTTAGTACTTGTAAGCTTTACTTCCTAAAAAAAGAGCTCAAAGTTATATAAAGTTTCATCACCATTTATTTGTTGCATTCCTTTAATTAAGATAATCTATCCTTAGAACAAAATTTCAAAGAAAATTATTTTCTATGAAAGTTTTTCTGTTTTGTTGGTACAG
>TTN-211,,0,797,2487819,2488615,GTAAGTATTGTATATTTTTCAGGGAAATTAAATAAACACTTTTTCAGAAAATGAATGTGAGTGAAATTAATTGGACCTATTTTATTAGTTAGAAAATATTATTAAAACACAAAAACTGGCTCTCTTGTATTTGCCACTTTGACATTCCAATACAGAAGTGGTTCAAATCGTAAAGTTTTGGAAATTTTGTTGACCTTGCCATTTGAACAAAAGAAAATTTAGCAAATCAGATTTTCCTGCTCTGTAGTCCTCTCATTGAAAGTAGATACACATACAATGAGAATCTAACTCAGAACCCTTAAAGACCACTTCCCTCAAGTGGCTGTGCAACTAGAGCACCAGAAAGACAAGCTTTGCTGTGTGGGCATTTTAGATTCAAGAAAGAAGGTGGGAAGCATTAGGCTAACGTTTCTGGAAGGTGCAAAGTGTTTGATGGATAGGGACAGCCTCTGATTGAGGGCCCCTTGTCCTCTCCCAATCAGAGTCTTAGTTATTTTGGAAGTCACATACCTTATGTAGCAAGAAGAACTTGACGCCTGGCAGAGAGACAGATGCAGCACAGATTTCTCGCTGACCTTGTACGTCAGAACGAAAGGGCCCCTACATATACTCGCTCTCTGGCTACCAGCTCTCCCCTTCTCAGCGCCGTGGGGCCACGTTCACGTGGGAGTTAAAATAGTGGCCAGTCCTGTGGCTTCTTGAAGAAAGCAACCATGAAGATTCATATCTAAGTCTCTATTTATTCTTTTGGGATTACAAAATGAGTAACGCAAAGCTGTTTCTTCCCTCTCGAAAAG
>TTN-211,,0,3904,2488616,2492519,GTAAAAAGCAGGCATGCCTTGTCTTTCCCGTTCTTTTTCTGGAGTTCTTCCACCTTCACTTGTATGTTCCTTATTCTTTGCTCTTTCTAATGTCTCTTCCTCTGTCTTTGCCTTTCTCTTTCCGCCTTTAGCCTGATTTCTGCTGAAACTGTAAAGCCAATTTTTTGCATTTTTTCTTAGGTTTAACCTGATGATTTTTTTATTGAAATTGAAATAAATTTAAAGTATGATCATGTTTTAGTTTTTTGAAGAAAAGACAAGACTCATTGACTATGAATGATAGTTTGATTAACCAGAAGGCAGGAAGGATCAAAAAGGCTTTCTGATTGCACGCTCTGCAGCCATGGTGCACATTAAGTTTTAAGACTAACGCTCTCCATCCTATTTAGTGTTCTGCATATAAGGGGATTAAGAGGAGAAGACTGAAATTCCATTTCGGGCAGTTGATCAAGTAGTTGAGATAACTTCTGGGCAGATTTGCTCTTCAAGCATTTCTCCAAAGCTATTTTTAACCTTCAAGTGCTCTGGGCTGTGCGATATCTGGAATGCAAGTGGACTATTTAAAGTGCAACTGATGGTACTGACAAGAAAGAAGGGCTCTGTGGTTATCCACATATGTGGATGAAATATTTTTTTTAAGCTTTGGTAAATAACTAGCTCCTGCTTTTAGCTTTTACTAACATTCTTTATGCCCAAGATTTTACCCATAAGTAAAAACTAAGGGATTATTCAGATAGGCCCACAATACAATTTGCCTAAATTGATCTATATGTTTTGTCCCCAGAAACAACATATGTCTTTAAATTATCTTGACAATCCATCATTAATTTTGAATTCTTAAAATAAAATATATGGAATATGTCCAGCCTGGGTTGGAAATAAAGCACAGGACAGTACATTGTTCTGTGACATATTCCCCCAATATTTCAGAAATACTATTAAATGTGCTATAAAGATCTCAACAAAAATCAAACTTTGAAGACTTAAAGGAATATAATTAAAAAGTGATTCAGTTTAACAAAAAGCCACAGCATTGACTGAAGTATTTGAAAGCAATGCCTTCAAGTAACTGCTTTGAAACAAACAAACAAACAACAACAACAACAACAAAACTAGTATTCCACTAAAGTGATTACAGGGTAATTCACCAGCAGTCATCTGATAGGTAACGCCTGCCTGTTATACAGATAATAAGATCTTCTTGGTCTCCTTTTCCAGTGACCAGAAAAAGCAGCAGTACATTCCATTTGTAGCATGGGAATTAAGTTACATATCACAAAACCTTCCTTACAATGAGGTCTTCTAAATATTGAACTGAGGGAGGCACCTCTACCTTCAAGCTTATTGTTTGAAAAAATATATTTTGCCTATCATGCATGATTTAATTAACTTCATGTCTAAAGGCAGAGAATTGGTTGCTTTTTCAAGATTCTTTCTAGATCTGCAAATTCATGATTTATATATAGGAACACTGCTTAAAGACAAATGATATTATTTTTTCATTACCAAATATCTTTTTGTCATAGTAAGAGCTTCTTATTAAAAGATCAGTCTCAGTTCTAATACAAAAACTGCACTATTTTAATTCAAATGTAGACTCCTAAAAATCTTATTCACATTTTATTTTTAAAAAATTCTCATTGTAACTAAAATTTTTTCTAGGGTTAGAAAGGATCAGTTTACTATAATTCTATAGGGCCCCTTTACATCTCTTTTGGCATAGGAATTTTAATCCTTTACTCTAGGCACCCGAAATACCTTAGCCTTTTGTGAACTTGCTCTTGCATTACTTAAATGTCTCTTTTCAAAAAGAACTTAAATATAAACTTTGAAGTAATAAAATCATTTTGTTACATGTGGCAGATTTTGTTTAAATTAAGTCTGTCAGAACAAACTTGCTCTTGTCAATGTAATTCCGAACTTTAATACTCATTTTATGTAAAAATTTTCGCCTTCAAAACTACAATAACCAAACAAGCAAAAACAAGCTGTAGGAATAGGAAATATGAAGAGAAACTTGTAGACATGAGTTGTTTGCATTTTTTCTTTGTTGTTGTAGTTGTTTTTGGCTGTCAGTTTAAGAAAGGACTGCCAAGTTCCAAATGGCATTTGATAATTTTAAAGTTAAATTTTAAATTTGATAAAATTAAAGTTTAAATACAAAACTTTAATAGTTTTGTCATGGTCATAAGCCTACCGTATTATATTAATATGCTTCCACTATAAATAAATATTTTTAAAATCTCTAACATTATTCTTACAATCTACTGCAAAATCTTCAACATTCATTTCATTGGTTTATTTTTATAAGGCACCTACCAGTTTTCCTTTTTTTTCTTTTAACATAGTGGAGGTAGATTGTATACAAGCTGTTTATTGAGACATACTGCATTCTGAGCAGTGTCCTAGAGTAGCTACAGAGGAACTCAGATGATAAAGCAACATAATATTAATAGATAAAATATATCTGTGGGTGGGTTAGAAACTGAGACACCTTTTCAAATAGCCAAAAGTTGCATGCCAAAATTTATACTGAAATGTTATTAAAAAAACAAATTTTTCCCATTTCAGCACCATGCCCTCGGATAAGTAGCTCTGTTCCAAGGGCATATTTAACTACCCCCTCCTAGCTGTTATTTTTCCTTATTATGTTTTTTGGCCACTCTCAATTATTAAGATAATTATGTGACTAACCATGCCCAGTTCTTAATTAAAGAAAACACTTTTAGATGAAACCTTATTTCTGATTCTTTTCTTTACACTAGCATAACAAATAGTTCCACTGGTGAAAAACTTTACATTATTTTTAACGCTAAGTAAACTCTTAAGCAGTGCAAAATCAGTCTGGATGACAGGGCACAGCTTCTTAGGAATTTTATATCATAGAACTGGAAGAACCCCCAAGTCTCTTATCTTTGCTGTCAGAATGACCCCTATCTGTCGCACCATTGACATCTGATTTTCCCATTCCTGATGCTTAGACACATGAAAAAGGAAGAAGAGTCCAACTTTCATTTGCAGTTTTGAACAAAATTAATAGGTTGTACAAATTATTTAATCACAGGTTTAATTGGTTTGCAAAATAAGTTTAATTGCTAAAATAAATGGGAAGAAGAGTTATAGCTTGTTGTTGCATGGCAAACACCTTACATACAGAACATAAGGTTTACTTTTAGCTTGCCATAGCTGATATTTTCTTTCATCCTTTCATGAATTCGCTTTTCTAAGTTCTTCCTTTATATGTATATAAGCCCAGGGGCAGAATGGGGGCACACATATATATACACATATACGTATATACTATATGTGCTGTATATCTACGCATATGCAAAAAAGACCACAAATGTAAACAGAAACTGGCCTGGGCAATTTCAATGTGAAAGGCCACCTAGTAATTATATAAAGGTAACTATGAAACCCTAAAATTTTCTTGAAAGATCCCAAACTGCATAGTATTCCATGGTGTATATGTGCCACATTTTCTTAATCCGGTCTATCATTGTTGGACATTTGGGTTGGTTCCAAGTCTTTGCTATTGTGAATAATGCCACAATAAACATACGTGTGCATGTGTCTTTACAGCAGCATGATTTATAGTCCTTATACCCAATGCTAGATGATGAGTTAGTGGGTGCAGGGCACCAGCATGGCACATGTATACATATGTAACTAACCTGCACATTGTGCACATGTACCCTAAAACTTAAAGTATAATAATAATAAATAAATTTAAAAAAAAGATCCCAAACTATTGGTTGAAATGATTTTTGAATGCATACGTGCTAAATAGATGATTATAAAACAACTTGGAAAGCTCTATTTCCATTTATTTTTATCTAAATGAATTAAATGCACCCATATACTAGATTGCTGTTTCATGTATTCTTTTTTTAAAAACAACTAG
>TTN-211,,0,541,2492520,2493060,GTAATTACAAGGCTTATTTTAAAAACATGTATAAGGCAGAGGCTCATGAACAATGCCAACTCTCAATTATCTTTATATGATGAGTACTATAGATGTTTAAAATCAACCAAATAATCAAAAGTCTGATTTTACTTTTTAGCATAACAAAATAATTCACAGACTATCTTTTTAAAGAGCCAAAATTGACTAGCATAGGTTTTACTTCCTCCTTCCATCTCTATTGTTTTTATTGCACATCCTAGATTTTCAAAAGCCAGCTGGAGGAAGAATTATTATCAAGCTAGGTATCCATCACTTTATTAACCAAGAGTTGGCTGTTATTTCCTTAATGTTTCCTAGTTTTTAAAAATGATTTTCCTCTTGTCTGTACAAATAATGATAAAATATCATTTTTAGAGGAAAATGTCTGAGTGTAATCAAAACTTGAAAATAAAACTTAGGACAGAACAAAGCCCTGGAGATGGCAGGGGAAAGTTGAGAAGGTACCAAAACTCTTGGAGAAGGAAAGGAGTACCTTGGCTAATGAGTATGATTCTTTCAG
>TTN-211,,0,1697,2493061,2494757,GTAAGTATTCTTCTTACAAAGGACTTTTCATTTGCAATTCTTTAATAACTACAACAACAAAACAACACAACACTTTTTGCATGCCCTTCTTGGCCTAACTGCATTTCTTGGCAACTTCTAGTATTGACACTGACCTAACCTGATCCTTTATGTGTTTAAAGAAAAAAAGAAAAGAAAAGTCTTATTCTATGTCTGGTCTGATTAATGATGGAGCAATCACTTTTCCCTATGCTTCTTTTCTCTCACTGAGTAGTGAGTAGATGTGCTCTTTGTCTACATGGGGTCAGCCTACTGTATGGATATCCTGATATGGATGAGGAGAAACTGAATTTTAAAGATAAGTAGGGAGTCCTAATTTTAAAAACAAAGTAAAAGTGATTTCCATGTGGAAGGAAAATGAATTTTCAGGTGTGGGGAACAACTAGAAAATGAGCATGAAATTTCAGTCTGAATAGGAGCATACTAGAGATCTGCTGTAATATGACAAAGCACATTCACATGATTCAATCTCTGAGAATAAGAATGGATAAGAAGATGGAGTGAGGCCCTGGATCTTTTGAGTCCTGGACTCTTTGAATGAAGAGAACTCTAATGGTTTTTAACATTACTTCTTCCTCTGGTGAAAAATGTAATGTCTTTTTTCAAAATGCCACATACTAGCTTATTTGTTTCATTCATTCCTTTGTCCAGTGATGACATTTTTCTGCAAATTTTTTGTGCAATATTTGTTTGTTTGGTTTGGTTGCTTCCCATCTGTCAACAGCTACAACCTAGTGACTCTGTGCTTCATGCATCTTGTACCATGTTTTTCTTACCACTTTGTGGTTGCTCTGCTCAAGCTTATGTCAAAGTAGCTTCTTGGGTCTCCTTCTTCACCTTGACATCTACCTTCACTCCAAGAAGGCTCAGCTGCAAGGAGCATATTTTCAAACCTATTAGACAGCATTTGTCTCAGAATCTTATTGCTCAAGAATGGTCATCTTGGGAAGGACTCACAGGGAGCTCTGAAAGAAGGAAGGGCAAGGGGGCAGCTCCCTAATCCTATACACCAGCTGAATTAATTCTACAGATGAATGAAATAACAGATGTAAAATCCTAATCACCCTCCCATACAAAACACATTGCTTTATTGCACTAATAGATGTTATGCCTGACTTATATGTGACGTCTTCAAAGCTGATTTTTTTAAAAAGCTAAATGTATGTTTCAATTACAGCCTCATGCCTCTTAGCCATACACAAGGCTGGCCATAGTGCTTCACGTGTTCTATCTTTGAATTCTGCTAATTTCTCAAAGATTGTGCTAAGTGCCTTAAATAAGACAATGTTTCTTTGCCACTGGTGTCTGAAGTTTCCTTTGACATTATCTTTCAAGTCTGGTGCAGTGCAAATGAAGATTTTTCCTCCAGCTATTATTCAAAAGAACTGAGATGGCTCCCTAGTATATATACTGTACACACACACATGCACACTAGTTGAACATATAGAATGCCACATAATTTTATGTAAACTAAAGAGATATCTAAAAAGCAAAGCATCATACCTGATGGGCAGCTTCAAGTGATTTCAAAGTCAGTTGTAGTCTATTAAGATGGAAAATCCCTAAAAAAGAGTCACTTTTTCTTAATGTATACTATGGTAATGTCAGAGTAAATTTCCAGAAACCTCATTTTGAATTCTGATGACATTCTCTTACAG
>TTN-211,,0,661,2494758,2495418,GTCTGTGACTGTATACCTGTCATCTTGTACTGTCAAATAACTTTATATTTACTTTTGGTCTAGCCAAAATGGAAAAAAAAAAGTTAGTCACAACTTCTCTGGTCACCACTTTACTTTTAAAGATAATTGTAGTATAAAATGTATTCTTGACTTTAATTGCTCTCTTTTTAGTATTATTAATTTACTATTACTTGAAAAACACTGGACTCACAATCAGGAGATTTAGATATTAGTTTGAACCATATGAAAGTGCTGTTTTCTTAGATCAGAAAGTCAAATATCAGCAATTATATTTCTTTCAACTAAGTACCTCCTGTTGCTATTAACTACCATTGGCAAGTTTCTTCAAGTCTGAGCCTTAGTTTACACATCCAAGAAGTTAGTCTGCATAATGTCTAAGGCTCACTATAGCTCTAAACTTATATGATCCCATTGTTTTTAATAACTGATAATAGTATCACAGCAGCTAACTTAACAGTAATTGGTAAGATTGTTCTTGCTTTTGGGGTTTGTTTATATTTGTGTCTGCCACCTTGGTTCTTCTTCACACTATGAAGTCTTGTTGGTTGCTTTCAGAAAAACTCAGGATCATAGTTTTTCTTAAGGACACCTGTGTGAAGGAACAACAAGAAAACTGATAATCTATTTATCTTAAATATAG
>TTN-211,,0,98,2495419,2495516,GTAAGAGTAAAGTCATTCTTTGTGAAGTATATGTGTTGGGAAAAAATAATAATTTCCAGCTTAACTCAATGTGGTTTTTGTTTTTTCAATGCTTGCAG
>TTN-211,,0,106,2495517,2495622,GTATGAAAACTACAGTGAATAATCTTTTATTTCTAACAATTCACACTTGCTAGATTTAAAGTACAAAGACATATGTTTCTAATATCTTGTAACTTTTTCTTCCCAG
>TTN-211,,0,108,2495623,2495730,GTAAGTTTGTTCTTGCTTTTAGGGTTTTTTGTTTGTTTGTTTGTTTTGTATTTGTATTTACCACTTTGATCATTATTCATACTATAAAGTCTTGTCGGTTGCTTTCAG
>TTN-211,,0,89,2495731,2495819,GTAAGTAATTTATATACCACTAGAGATTTTTTCATCAGTTTCTGTTATAAAAATAATTAAAATCAACATATTTTTCTCCTTTACAACAG
>TTN-211,,0,104,2495820,2495923,GTAAGCAAGATCTTTTTATTCTCTATTTCTGTAGCTATATATACACTTTTGACAATTTAGTGGCCATCATTGCAAGCTAACTGATAATCCAATGTCTCCTTTAG
>TTN-211,,0,100,2495924,2496023,GTACATATTAAGTGAAAAAACAATTCTAATGTTACCAATTTTTTAAAATTGTTAATCAAAATGTAAACATATTTGTATTTATTTCACATTTTCTTTCCAG
>TTN-211,,0,767,2496024,2496790,GTCAGTCCCTTTATTTTAAAATATCCTTCCAATATCACAGAGTTTAGATTTCAGATTTCACAGTTATTTAATGAGGTAATCCTTGTGAGGGTCTTTCATTTCTAGCAAGCCCTACCCACATGTTAACAACTCTAATTTTGCTCACTACAAAGTAAGTGTCTTGAGTAAGAGGAAATTAATAGCAATAATCTTTACATGCCAGAGCCTTGGACAGTTGCTAGTACATGATGACTATTTATGAACTTAGGCTACAACTAAGCTATCACCCTGAGAGTCTTGGCAAATCTAAAGACGGTCTTATACTCTCCTACTTTACAAACCCCTGTGTGCCTTTTAGGTATGTTCTCATCCTGACCCAGGACATCCTTATACACTGTCCTTATGAAAAAGCCATTAGTGTACCTCTCATTCATAAGAAAAAAGTTTCTCTGATTTATTGAACTAAGTATGCAGTGCCTACTCTATCAAAAAACAAAACAAAACATGTTTTGCACTACACTGAGTCCTATGTTACTATTTTTGGCAAGGAATGCATGTCTTATGATTTTATGCCATTCTCAATCCTCTACTCTCCAATCTAATTTGCACGCACAACAACAACAAAAAGCTATGAGAACTCTAAGCCACTTAGTTTTCTCTGCTATAAAGTTACTGTAGCTTACTTCCAAGGTTATGTAACCAATATTTTCTAATAAATGCATAATAACATGATGTAGCTTGGCTACGTTTAATAGTCGAAAGCGTTCACATGTTATCTTTCTCACTAG
>TTN-211,,0,92,2496791,2496882,GTAAGCCCTTGGGTCTCTCAGACTTAATTGGCAAAGCACAATTTAAAAGCAAGACAGCACACTAAAAAAATTCCTCTATATGTGAATTTCAG
>TTN-211,,0,107,2496883,2496989,GTAAGAAGTTTTAAGTAAATTCAAGTTAGCTTTTAAGTAAATTGCAGTCTTTGCCTTCATCATCGTTACCCCAAACTCATATTTTCTTCTTCTGTGGTGAAATCCAG
>TTN-211,,0,266,2496990,2497255,GTAAGCCCATCAAAAAAGGGAAATAATTACTGCATGAAATCCAGATATTAGGCCTATCAATTAAAATAAATCAAGTTAAATGAAAGTTAATAAAAAGGTAGAATATCATAAAAATTTGGATAAAGTTTTAGAAACCCAGACTGTGCCTACTTTACTTAGTGAATTTGATAAACCTGTTAATGAGGATGATATAATTGATTACAACACTGTTTTCATAAATTGTCACTAACGTAAATGGTATGCTCCAACTCCTTCTTTTATTCCAG
>TTN-211,,0,90,2497256,2497345,GTAGGTCATTTGCATATAAAAAAGAATATTCAATGTGGATCATGGACATAACTGTATGTGTTTTTTACAAATATTAATTCATAATCGTAG
>TTN-211,,0,106,2497346,2497451,GTAAATAGATATTTTATTTTTAGATCGGGGAATAGCACATAGCTACTTTGGGGCAACAGGGACTTAAATATGGCACTGCAAACTCATTAACTTTTCTTCTTTGTAG
>TTN-211,,0,98,2497452,2497549,GTAAGGAACAAAACATTTATCATCTAAGGTGATTTGGCAGTATTAACAAATATTAGTTCAGACTATTAACAGTGACTCGTGAGTGCATTTTTTTTCAG
>TTN-211,,0,690,2497550,2498239,GTGAGTTTTGAGCAGCACTGCATCAATGCCAAAAATGAGAGTAGGGGAAATCCCAGAAGGTTGGGATGCCATACAAAAGTCTTATGTGCTACAACTTCTTACCTTTACCTCACTGAAAATGTACAAAAACTTTTTAAGAATGCATCGGTGCTAATGCTTCCTGAGGTAGCTCAACCAAGGATTGTATAATTGTAATTGTCTTGTCTTGTGAGCCTTACCAAATTTGTAATAAAAAAAAAAATTCCCTACTGACTTGGTACCTGCTAAGTACCCAATATGTACCCATTAAGCTAGAAGTGGAAAGTAAATATTTATTTCCCTGGTGGTCACACTTCTTATTCCACTAGAATACCTTAGTTGACCTAATCAGCCATTATTTCCTTGTGTTTATATTAGTTACTATTCTTTACCCTGAATTAAAATCATATTTCTGATAAGCAAACTGGTAGAATCAACACCTCATTTGCCATCTTTTTTCATGTGTACAAACTATGAAGCAGTTTTTCTTATATTGAGTCAAATATTATCATGTATCCTACTTTGCAATTTTCCCTAATATGAAATTAATGTAAGAATAATCCCTAGCATTCAAAACAACTGCAGTTTGTATCCCTGGTCATGGTAAAAATCTTTTGGGTTGGCGAAAGGGTTTTTTGGAAATAACTGATTAACTGTATTTCTTTGTCCCAG
>TTN-211,,0,156,2498240,2498395,GTGAGTACATTCTTGATGATTTCTTACCTAATCTTGTTGCCTGTTTTTGCTTTTAGACCTAGAGTTGAAGTTATGGGGCAAGGCAGGGGTTGGCAATGTGAAGAGAACTGCATAGGTGGCCTGTGTAAGACTGACTCTCTCTTCCAAATGTTGTAG
>TTN-211,,0,338,2498396,2498733,GTAGGTTTTTAATTTGGCATGAGAGTAAATGTGTACTCCTAGTCACTAAAATGGGCTTTGTTGGGGAAAATTTAAATGTTTGTCTTTTTTCATTGAGAATCCTATGCTGCCGGTGTATCTGTCTGATTTTTAAAGGTGCTGCTGAATGTACTGCCTGCTCAGGGTTTTCATGACAGTATTGAAATGAAAATGTATTCAGTTATAGTGTTGAAGTAATCCAGGTTTAATTTAAAGACTAGTATTATACCAGGGGTTTGAATTTTTGAAAGATTATGAGTACTACACAATGAAACGATTATCGACATCACAGTAAAACATCCTATTCTGTTTTCTGACAG
>TTN-211,,0,93,2498734,2498826,GTATCTATTTTTGATTTTTGTCTTATCAAATAGGCCTCTGACCTTAAATCTGCTTGAACTTGATAACATCATAAATAATCTTTTCCAATTCAG
>TTN-211,,0,117,2498827,2498943,GTAAGGAAGGTTCTCATTTTAAAAGGGGATAAACTCTTTGCAGTTACTTTCTTGAAAGAAAAAAATAAAAAAAATGGTGAACAATTTTTTTTTCTGCATCTGTAATGCCATACACAG
>TTN-211,,0,114,2498944,2499057,GTAAGTTTCTCAATCAGCTGATAAAAAAAAAAGGATGCTTATGTCAAACTTGCATTTTGGTGTCATATTTATATACAGGACATATAACATTTTACACCATTATCCTGTCTATAG
>TTN-211,,0,474,2499058,2499531,GTATGCTCAGAATCCCCATCAAGATGTTAAGACAGCAGTATATTCAAATGTTTACTCTTTAGTATTCCTTGGGATTACAGATGATTATATATTACTAAAAAAATTTTAAACTACTTTTACTCATATTTTCTATTACCTCATAATTTGAAAAATTATATAAATTCCATTCAAGGGCACATTTCTTAGTTTACTCTAAAATATTAACCTTCAGGAAGTTTCAAAGTGTTTGATCCCCCAGTATATTATGATAATGACCACTGTCATAGATATTATAATTAGATTGGTATGTTTGGCCCAGTCTAAAGTGTGTGGCAGTTAAAAAGCAATTTTTAATTTATATTGAAGTGCTTTTCAGTTAAATTTCCAAATCACCTTTTCACAATTTAAATAAATTAGTCTCTTCTGTGTAAAATAAACATAGGCTTCTTCTGCTTCTTACCATGATGATACACATGCACTTTGTTCCTAATTCAG
>TTN-211,,0,88,2499532,2499619,GTATTATTTATATAATTTTTGTGGTTATTTCGAAGTTCATATGAACTCCTTTTTGACAAACCTAAACAATGATTTCATTGGCTTGCAG
>TTN-211,,0,196,2499620,2499815,GTAAGTCACTCTTGATGTCTGGGATATATAAATTCTTCTAATATCTGCCTGTGAGCTACGATATGAGAAAATATGAAAAATTCATTACTATTATTTCCTCCTGGCTACATTACTTCTTAATGACTGCCTGCACTTTCAGACTGACTATTGGGTAATAAAAAAAAAAATGAATTTGTTTTCCTTCCTTCTTTTTCAG
>TTN-211,,0,114,2499816,2499929,GTATGCTCTTGCACTTAATCTTTGTGACAATAAGTGCTCTCGCACTTAATTTTTGTGACAGGAGATTATCACCTTTCCTCTGGTTTTCCTAATCATTGTTTATTTTATTTTCAG
>TTN-211,,0,102,2499930,2500031,GTAGAATTTGAATTAATTCATAAAGAATAACTTACACTTGGCTGCAAATTCTTAACTGTGTTTTTTCATTAATGCTAATGAAATGCTTTGTTGTTTCAATAG
>TTN-211,,0,80,2500032,2500111,GTAAGTAGTGCTGATTATACACAAGATATTGTCTAGAACTTGATGAGACTGTGGATATGAATATTTCACTCTTTTCTCAG
>TTN-211,,0,100,2500112,2500211,GTAAGAGCACAAGGTCTTTTATAGTTAATAAAATACCCTTTATTCATGCATTGCATTTTGACATACTCTGTTTTTTGCTCTTTTGAATGATATCTTACAG
>TTN-211,,0,603,2500212,2500814,GTAATCATTCTTTGAAGAAAAACCAGACATTCTTCACATGTAGAGGAAATTAGTTAACTTTGCAGTGCTATTAATAATATAATTGGCTTCATGAACTGGCCACTTGTAAACTAAATGTCACTTCTGATTATGTCTTTCCATAGGAGAAGTAAAACAATTCTAAAGAGATGAAATCGCTAAACGCTTATTAGACTAATTTATACTAGTTTTAGTTAATTGCATGTGAAATACTAATTTAAATAACAGATATTAGCATACCCAAAGAGCATTGAAATGACCACAATTTTTTAATTGCACAGCTTCACATTTTCCCATAGTGTTCTTAACCAGGGATAGTAACATTTTCTGCATTCCCCCCAGCCCTGCAAATAATGTCTGGAAATTTGTGGGGCCATTTTTGCTTGGCACACAGACTTGAGGTAGATACCACTGACATTTAGTAGTTGGGAGCCAAGGATGCTAAATGCTCTGCAGTGTGAATGACACTCCAGCACATCAAAGATTATCCTACCCAAAATACAGATAGCCCCACTTAGAGACAAGTGCATTATTAAAATGCTGATTTTTCAGGATTACTAGAATAATTATCCATTTTTGTAATAG
>TTN-211,,0,103,2500815,2500917,GTAAGTTTGGACATGGATGCACTATGGCTAAGAACTAATAAACCATAGTTTTGTTTTAAGAAGGTGGTTTTCCTGATACTAACATTTTTTTCTTGTTCTTCAG
>TTN-211,,0,113,2500918,2501030,GTAAGTTTTGTTTCATGGAGTTGCCACTTTCCCATTTTGAAATAAATGAAAATAATGTTTTGTCAGTTATTTTCATCAGAATTGAAAACATTTATTGGTTATGATCACTATAG
>TTN-211,,0,299,2501031,2501329,GTGAGTCATTAAAACTACACTTTCCAATGGAAAAAGGTTTTAGTAAAACATAAAAATAAAAAGTTTGGGAGAGAGTTAAAAGAAATGGGACATAGCTTCAGCAAGTTATCCTCAATCATATTTTATCTGCTGGCCATGTAAAAGAAATCACCTGATCTTGTTATTTATTAGCTAATGGAATACAAAGATAGATGTGGGAAAACCACAAATCATGTCAGAGGAGCATGCTCACATTTATATTTTCCATAGCAACCCTTCCCACACAAATTTTTGATTACTGTTCTCTTCTGAAATATTAG
>TTN-211,,0,128,2501330,2501457,GTAAGTTTCCTTTGGCATCTAAAGTTTGCCTTTTTACCATGTACTTTGGTATATAATTACTACAGCTTTTAAAATTGCATTTTTATGTCATACTGGGAAATTTACTTCAAATGTTATTTTTTTATCAG
>TTN-211,,0,96,2501458,2501553,GTAAGTAGTTCCTTAAGAAGAAGGTGGAGTAGAACAAGCTATTGTACATTTTAAAACCATCAGGGAGTTTGATTTGTCTATCTTCATTCATTCTAG
>TTN-211,,0,99,2501554,2501652,GTACTTAACGTTATTGGAATAAAATTATGGATATTTTCTCTATATGGGACTATTTTTTAATCTTTCATGGGCTAATGCATGACTGTTCTCTTTCAACAG
>TTN-211,,0,86,2501653,2501738,GTAAGGAATGTTGCACTGATTTTCACAGGATTTTCCCAAGTGATACTATCTTATTACATTGATTTTTGGCTTTGTTTTGTTTTCAG
>TTN-211,,0,1307,2501739,2503045,GTAAAAGAGAAGGTTTCATTGTGTTTATAGAGTAATGTTTTGCTTCTAGTTATATTATTTACTGAGCTTTATGGCTTCAAACTCCCAACAGTCTCAAAATCTATAGCTAAAGAGTAATAAGAAAAGTAAATCAAAAAACTATTAGCAACATTAAAGATATCATATTTCCTATAATTTCAATGTAATTTGTGGCTGTAAGTATATTAATCATGCATGGTTTCTTGTACTGAAAAACTTGGATCTACAGGGGCTTAATAATAACCTAGAAGTAGTTTAGACATATTATATCTCTCCAGTAGAACACATTGGAAGTCGGGTTTTTAAAACTTACTAGCGTAGTAGTTAAAGAGAATTCAATGTTCTTCTAAAAGATTAGACAATTCCTGAGAATAAATGCCTTAGTCTTCCTCTATATTCAAAAAGTCCCCATACTGGAAGGATAGAGAGGCCCAAAACCAGAAACAGCCTCCAAAGAATAGAAAACCAACCAGAGGGAATCTCCCAGAAATCAATACGAAACACTAAAATTGCACACACAGTAATGCACACTGACATCCCATCTAAGAAAGCAAAGGCTTTGAGGAAGACCCATTCCTCAAGAGACAGAAGAACTTATTCCTTCACCATCACCCCCTGAAAAAAAAAAATACATCCTATATCACTGCTGCAGCTCATCTATGAACGTCCAATATACCACAGGCTGTGCCAGAGGCACCAGAACAGAGCTGAGCTTCCACTCCTTCTGGTTGCAATAACAGTCAACAAGTATGGATTGGGTCTAGTTTTACCACTGAAAGCTTAACTCTTAGTTTGGTCCTTCAGGAAAGAAAACTTCAGCAGCATTACATACATCCTCTTTCCACCATATTTTGAACCCACATGTGAGGCAACATGACTCAAAGTATGTTCATAGACATATCCACTATCTGTTAATAAAAGAAAAAACACTTTGCTCTCAGCTGGTCATTCAAAGCAAAGCTTCACAGACTTACTTTCCTAGTTCAGTAGAATTAGAAGCATCCCCAGTTACAAAGGTAAACAATCTAAAATGTTAAATTAAAAAAGCATACGTGCCCTTGATTTATTTTTCACTGATAATCTTGATGAAAAGTTTGCTAAGAAAAATTCTGTCTACATGAATGTCTATAATTTTGGCAACTGACAAGTTTTAGGAATGATTTTAAATAAGGATGTAAGGTTATGCCAAACAGAAGGCTATTTTTTACATAATTAAGTTGAAGTGAAATATTATTTCTTACATGAATATTTATCTCATGCTAATCATTTTCACTTGCCTCTGGCTAAAG
>TTN-211,,0,118,2503046,2503163,GTGCGGAATCTGAATATAATAATAATTTTAATGCATTTTACAGTGTGCCTTTATCCCATAAGTTGAAAAAAACATCCTTATGACTTTGTTACTGTTTTTCTTTCTCTTCTCTTTGCAG
>TTN-211,,0,88,2503164,2503251,GTAAGTGACTTGCTTTCTTACATCAAAAAGGCATCCAGTGTCTGTTTAAGAATTGCCTTCTCAATATTCTCTGTTGATTCCTTTCCAG
>TTN-211,,0,402,2503252,2503653,GTAAACTCTTCTGAATATTTTCTTATACACATTAAAAGTACATGACTCTGGTTTGATGCCATTTTAATATAACCTTGGAATTTGATAATTAAACTCAAAACCACACACGATAAGCTGTTATTTTGTTATTGTAGTGTTTAGCCCCACACACATAAGGCTCCTTAGTACATAGCGTTTGATACACAGATACTCTTTTAATTGAGATCCACTATCAGGTACAATACATCTACATATTTTTATTTTAAAAAAAGCTTTCTCCTTTTCTCTGTCTTCCCATGTTTTGAGTCTATATATTTATTTCTTCTTACAGTCATCCCTCCCAAAATAAGTTGAATTTTTAAATGAGTGAAAACCAACATAAGTATATTCTCTTCAATAAATTTCTGTTTTTCTAATTTCTAG
>TTN-211,,0,1285,2503654,2504938,GTAAGTATGCTTCCGTTTCTGGGGACTAATTTCTAAAGCACAAAGTCACTAAATGGATAATTCTGCCTTAAATTTCTTATATTTTTCTATGCCAAATTATTTTATTTATTAAAATAAAAAAGGTTCATGTTCACATAGACTATCGGAAGTATATATTTATGTGTGTATACATACATGCACAGATATATACATACACACATACATAAAATCATACAGTTTGTAAACTCTTGGATTAAACCAAATATTTTATGAGGAATCACAATAATAAAGACCTGGACTATAAACTCCTATGTCTTCTGATACTTTAAATAAATTTCTATCTCATTAGATACTGGGGAAATCATCTCTCCCACTAAACAGTCAGACCTTCCAGTAGGAATTCAACAAAAAACAGAATGTTGTTAGCTTTTCTATAATATTATTGAACAAAGATTTAGGATTCTCAGGCATAGTCTGTGAGGTCAAATAAGAGAGAAAAATTCTTCTAAAAGATCTGTGAGCAGATTCGTTCAAAAATTAAAAAATACTGTGGCCATAATAATTCATCCTATTTGCTACATATCTGATTAGATTCTCTATAGAAGAAAAATTCAATTATTTGTTAAAAAGAAAATTTTAAATACTCAAGTGCTATGTGGAGCATATATACCTATATAATGAGGTAGTTATTCATTCATTTGCAAACTAGTATTGAACATGTGCTTTGTGCAAGGATCTATATTAACCACTGGAGGGGGAAAAGTTAAGATTAAAAAGACAAGTACAGTAAAAGAATTTCTGTAATTGTAAAGCACTTTCAGAAAGGTAAAGGATTGTTATGGGATTATTGTAGACACTGATCCTGTCCCTAAAGGGCATTAAGATTAGTTTGTGTTCAAAGGTTTACTAGCTATTGATGGAATCCTTTTTAAATTTTCATATTGTGGCAAATTAAATTTAAATCATGTTTTCAGTAAAGGCTATTGTAGAATTTCTTCAAAGGGATCTCAAAAGTAAAGTAGTTTTTTACCAATCATGTATAAATAGAATGTAAATCTAACAAGATAGGAAGTAGTCTTTCTATTCCCAGTTAGTTGTTTGCTTTCTCTGTTTTTGCATTAATGCTAAAGGAAAATAGACCATTTCCTTTATTTCTCTTCTCTAGAAGGCAACTGTATTTCCTTTTAGCATTTCTATTTTAATATTTTAATAGATTAAAATAATATATGATCATGTGTAGTAAAAGACTCCAGCACTTCATCAGCTTCAAAATCTGATGAAGCTTTTTTTTTTCTTTTGTTATTAG
>TTN-211,,0,131,2504939,2505069,GTACTAGTACTTACTCAGTTTATGTATTCCTCTTTTGATCTTATTATGAAATTGATTAATTTACTGAAGATATTTCAATTACTTTTGACAAATATGAGCTAAATCCTGTTAAATTGTATGTGGTATTACAG
>TTN-211,,0,87,2505070,2505156,GTAGGAAAATAACCATTCTCCTCTTTTTTCCACTGAATCACTATAAGGAGTATTTATACTACAACTGACTGTCTCCTTTTCTAATAG
>TTN-211,,0,94,2505157,2505250,GTAAAAAAATAATAATTAAAATAATTCAGAATATGGTTGACTTCAATATTGCTATGATTTCATTCAATGTATGACTACTATTTTCTTTGTACAG
>TTN-211,,0,93,2505251,2505343,GTAAGAAAGACTTTGAAAGTTGCTACAGAATAAAAACAAATTATTTTTAAGCATTTAAGGAACGTTGCTTATATTGTGATTTACATCCAACAG
>TTN-211,,0,93,2505344,2505436,GTAAGCTTTAAAATCTAAATTTAAAATATCTTCTCAAAATTGAAGTATATTATTATAAACAACGCTTAATACTTCCTTTAATTATTTTTACAG
>TTN-211,,0,1003,2505437,2506439,GTAAGTACCAATGTACTGACAAAGAATGTCCTCCTTACAGCTGCCTTCCTAGGTGTTCAATAATAGTTCACAATTAAAAGAGCTATATCTGTACCTTAGGAAGCTACTATGGCTTGAATGTAGACATGGGCACATTACTTAATTACTCATTCCTTCAATTTCCACAGAATTTTCACATTCCCTTACCTGTTACCTTTTCCCTGTTCAAAGGAGATGATGTCTGTAATTTCCTCGCTGTAATTTTCCTCGCAGTCTGTTTTATTTATCAGAGGCTAAAGCAATTTCTCTGCATGCTCCTCAAAAGGGACAGAAAGTAACCAGTCATTTTCTTAGCAACTGCTGAGACCCATTTATCTTCACAATCAAGTTTTTATTTCTCTATATGAGAAAAGATATATCCATTTTAATGAAGTATATATATATATATATATATATATATATATGGTAATAATTCTTCCTCTGATAATTACCATCACTACTGTTGTGTATTTGTTTATTCTCTCATCTAAGTGTGAAGAAACTGTAGTCACTACCCTCTTTGAATATTTCTGTCCTAAATTTGTGCAAAATGGAAAATTGCTTTCCTTTTATTAACAGTTATATTTCTTAAAAGGGGAATTCACCTTCTTGTGTATCCCTTCATAATTCTGTGTAAATATTAAAGAGAGTATCCCATGATACTCTCCTACTACAATCTCCTCTCTTCCCTTTTGTCAGGATATGAGAATATAATAATACACATCATTACATGCATAATGATGCCAAATAAAGTGAGGCAAGCACAGATACATAGCCACATGTAGATCCAATAAAAGATGCTGACCCCGTGTACCTGCTCCCCAAACTAGCGTAATAGTGTTAAAGACAGAACCATTCTTTATATTGGGCTGAGCTACAAAGTCTGCCTACAGTGGATCCAAACAACTTTATAGTAACTGTGAATTCTACTTTCTATCCCTCAATGCTTTTTGCTCCTAATGACAACTTTTTTTAAATAATCTAG
>TTN-211,,0,108,2506440,2506547,GTAAAGACTGCATGGTTTGGTTAAAATTACTTGTTTTTCTGTTCATAAATAACATTTGGCTTTAAAATCATCTGAGTGATAAAGGGTTCCTTCTTTAAACCATTTTAG
>TTN-211,,0,83,2506548,2506630,GTAAGTAGGAGAACATTTTCACATACAAAGCCATTTTTACTTTTTTTTTAAATTTCTTATAATCAATATGATCTTTTTCACAG
>TTN-211,,0,93,2506631,2506723,GTAAGCCTGGAAACCATTCCTTTTTTTTAAATCTTATTTTCCAAAAGTGCCTTGGAAAAGTCAAGAATACTAACGTATACTGGCTCTTTGCAG
>TTN-211,,0,447,2506724,2507170,GTAGGAAAACTTGGCACTAAGGAAATGCACTATGAATAAACTAAAAAATGTCATAGTTATTCTCAATCCCATTAACTTCTGTCTATACTTTTTGGATTAAGAAATCAGGAAAATAGCATAATTTTAACTCACATTCCAAACATCTGTTAATGTCAGAAATCGAATCAAAAGTTAAGTCATGTTATTACTAATCTTTTGGTTATAAACCCTGGAATGTGGAATAAATAAATCAAGGTTTAATCATTTGACAATAATTTTAAAGCATAACTCCTGCCAAGTTATTCCATTCAGTGTTGCCTGTAATATCTGATCCCTAAAACCTAAACCAGCAACAATTTTCCCAGAGTAAACAGTTAAATAGGCTGCTGGTGATGCTTTAGGAAGCCATTAAAGCAAGAAGCTACAAAGAACTATTCTAATTATAAAATGTCTATGATTTCTCCCCAG
>TTN-211,,0,88,2507171,2507258,GTAATTATCAATCCTTCCTTATGCCATCAGTATTTATGTTTCAGATTGAAGGGGAAAAATCACATTTGTAATTTTCAATTGCTTCCAG
>TTN-211,,0,1728,2507259,2508986,GTAAATACTTTCAATTTGTCTGTGCAACTTTTTAAACCAACATTCTTATTATATTTACACAAAGCTATGCTGTATGCTGTGTAACAAACATTTTGGAAAATAAGAAAAATCACCCATAATCATGTTGAACATTATTAGAATTTTTAAAAATTTCCTCCTTACTTTTTTATTCTATGTGTATTCTGTATGGTGGGTGTAAGTTTACAAATTATATAATTGAGAAAACAGATGCTAACAAGAAGACATGCATCCATGTTTCCAGTGAACCTAAAGAGTGCATGTACACAATTCTCAAATTGCTAGAAGGCCATGAATATGTATTCTGAATCATGGCCCAGAATAAATATGGCTTTTTTATAGAACTTGCCCCCATAGTGTCTATTATGTTGTTATATAGTTTTCATAGAAGCAACTTTCCTTAAACTGTACATGAATGTTTAACAATCTGCAACTTTCCTTAAACTGTACATGAATGTTTAACAATTTGCCAGTGCTGACCATTTCACATCATGAGACTCTACCCCTATCGCTAAATTATCATAATAATGCAAAAACCTGTTTGAAGGGTTTCAGTATTCTAATTGAAGAGAAGCATCATAGTTGGTTATCAATATTGCATTTCTAGTCACTGAATATAGAGTTGAACTCTATGAGGCTTTTTCATGGCTCTCACTGGAGGCTTTAGTCCAGTGATTTGCTCAGAACACGAAGCCTTTCCACTCAGGGCTCTTTCTAAGCATGTCTCTAGGCACAACAATACTCCAGCCACAGTTTTTATGTGAAAATTGCCAGTTCTATGTTGAATATAATTAATATAAGAATGGCATAAGGAAAAATATTTCATTAAGCAGTAGCCCCACAAACTTTCAGGTTAGTTTCAAGCACCTAAAGCTCTTTTGCCTAATGGTTATTACTTTAATTTGAGAACTGGTACATTTCCACGTTAATTATTTGCAACCTCCTCAAAGTCATTCTGAAATTTGGGGCCTCCTATGCTGCTTGTTGATCCACTGGTCATCCAGAAATAAACCATCTCTCTCTCCGTTTCCCCTGCAGAGGAAACTGGACATAGAAACTGACTATGCCACTCTTACCCATCTCTTGTATCCCTCTGCATGCTTGCCTCCCAGCTCCCTCCTGTCCAACTCACAAATTGCTTTTAAAAAGCATTTTTATTTTCCCTTCAGCCTCTACTAAAACCATGGTAACCAATAACTGTTGCAAACCTACTTCATTAACAAATATGGGGCTTGATGCTATGGCTCACACCTGTAATCCCCTGACTTTGGGAGGCCAAGGCAGGTGGATCACTTGAGGTCAGGAGTTCGAGACCAGCCTGACCAACATGGTGAAACCCTGTCTCTACTAAAAATGCAAAAATTAGCCTGGTATGGTGGCACATGCCTGTAGTCCCAGCTACTTGGGAGGCTGAGGCAGGAGAATTGCTTGAACCTGGGAAGCGGAGGTTGCAGTGAGCTGAGATTGTGCCACTGAACTCCAGCCTGGGTGACAGAGCGAGACTCCCATCTCAAAAAAAAAAAAAAAAAAAAAAAGTGGTTGACTGTTTTTGTATTGACTAGATAGCAGAAGGAAAAACTAACTCAATTAGTAGACACAAAACCTTACTTTCTTCAAAACAACATTTTTGTCTCCTTTTAAAAAAACAAGTGTTGAGCATTATCTTTCATTGAAGGCAAACAGCTTGAATTATTTTCTTCTTATTTCCAG
>TTN-211,,0,860,2508987,2509846,GTAAGTAAAAAAAAAAAAATGTATACTTAATCACTTCTTTACTCATTTAGTACAAGACTATGGTGAAAAAATATGTGTATAAATGCCGTACATTTCATTCACTTGACAAGCAGTTATCACACAACTACTCAGTATCTGATTTGGTAGTATTTGGACAGTGATTGTGAAAGAGATTTTACAAATATGTATAATTCATTGAATTTCTTTTTGTTTTTTTTTTTCTTTTTGGTTTTGTTTTGACACATAGTCTTACTGTTACCGAGGCTGGAGTATAGTGTCATGATCTTGGCTCACTGCAACCTCCACCTCTGAGGTTCAAGTGATTCTTGTGTCTCAGTCTCCCGAGTAGCTGGGATTACAGACATGCACCACCATGCCCAGCTAATTTTTCTATTTCTAGTAGAGGCAGGGTTTTGCCATGTTGGCCAGGCTGGTCTCAAACTCCTGGCCTCAAGTGATCCACCTGCCTCGGCCTCCGAAAGTGCTGGCATTACCACTCCTAGTTCATTTATCAAATTTCTTCCATCTATACCTCACAGATTTTTTTTTAATTTCCCACTTAATGGCATTAATAGAAACTGAATTATTTTCCTACTTCTAAAACTACCAATTCTGAAGACCTTTCCTAAATTATTTTGCCTCAACAAACCTCTATTTCCTCATCTGTCAAGTGAAGAAATTCAATTGTATTGGGTCCTTTTTAACTCTAATAGTTTTATGATGAGATCTCTTTTGCTATTTATGGGAGCAGAGAGTTTAATGTTTAAATGCAATCTTCAGAAAAGGAATATTCACTACATCCTACTACATTCTTAATGTGACATTTTTTTCTACCACAATTCCTATACTTATATTCGCAG
>TTN-211,,0,101,2509847,2509947,GTATGTGTCTACTACAATTTATACTTCTGAAACTTGCACATTTGTAGATTTGTAATAAGACATCAATAAAAATGACTTGCCTTTATAATTACAAATTTTAG
>TTN-211,,0,93,2509948,2510040,GTAAGTCTTATTTAGTGGAAAGAATAGATCTTCTGTTCTTTCAAAAGCAGAAATGGCAATAACATTTTGTGCCATGATTTTTTTTTTCTGCAG
>TTN-211,,0,92,2510041,2510132,GTATGCATTATGTTTCTTTTTAGTGATTCAATGCTTGATAAAACTAATATAAAGAAATAAATTTCTAACGCATTTTCCAACATTTGTTACAG
>TTN-211,,0,89,2510133,2510221,GTATAGTATTAATGGATTTATTCAGTTTTCATGTTATCTAACTTTGTTTTCAGCTATATGCTAATTCGTTTTTTACTTTTATTTTTTAG
>TTN-211,,0,114,2510222,2510335,GTGAGTAAAATGCTCTCACTTGTGTTTGCAAGGAAAATAGATGTCTGATTGTATGTGTTTAATTGTAATCTGCATTATGGATCAAATCTGAGTGTTCTGTTCTCTTTATTCTAG
>TTN-211,,0,101,2510336,2510436,GTAAGAATTTTACTACTTAGGCCATTAAAAATAAATTTTGATAATTTTGAGCTCTTATATGGATAAAATTACTTATCAAACTGTTATTTAACACTTTTTAG
>TTN-211,,0,85,2510437,2510521,GTAAGTTGCTTTCTCTGAATACAAAACTATTGTTTGACTGTCTTTAAGAATATTACTTTTTCATCATAACTTCTTCTTTGAAAAG
>TTN-211,,0,94,2510522,2510615,GTAATTTTTGGACTAGCAGTATTACCTTATTTCTTTTTAAAATTATTCATATAGGTGAAAATCAAAATCTAATTTTTTCATGTTTACTTTTCAG
>TTN-211,,0,318,2510616,2510933,GTAGGATGTCCTTGTTTTTTCTGATATTACAGCAACTCTTAATCTCAAGCACAGAAGTATTCGATAAATAAGTTAATGTAACATCTAAATCTGTAACATCCAAACTGTATTTAGCAAATATTTTTCCAAATAGACCTTTTACCAAAATACCTAAAAGGTACAAACAATAGTAGATTCTCATTTTTATGAAGGAAAATAAAGAGGACACTAATTGAAAAATTGGATGACCTATATTTGATTAACTGAGAATAGGCTATATAAAATTACACATTGAAGTATCACTAGTAGTAGTTAACTATATGTATATTTTACTTTCAG
>TTN-211,,0,98,2510934,2511031,GTAAGTCCTTCCCTTAGCATGTGATTCATTCACACTTAATTTCTTATGATTTCCCCACATTCTGAAAAATCAATTAATGACCTTAATGTCATTTGCAG
>TTN-211,,0,98,2511032,2511129,GTGGGTTACTAAAATGCTTCTCCCTCCCACTTCAAAAATGAATTTGTTAATAGGGATGCTGAGGAGACATGTATATCTGATTTTATGATTCTTTACAG
>TTN-211,,0,310,2511130,2511439,GTAAGTATTATGCTTTCTTCCTCCTTTTAACCCCAGTCTCCTATTTTAGCAAGGTCAAGATACTAATACCATTTTAATCCACTTCTGAAAGAGATTTCATTTGTAGAGACCGAAATAGTGTAATAAATATCTATCTCACTCATGAAACACTTTTTTGATCTGTCTCATCTTATATGTTTTGCTTTTAATGTACTGAACTACAGGTTCTATGTACATTGGAGCAAATCCATACTAAAACTCTTATGTACATTAACAAAGGGGATTTGATTAGGTTACCTAGGTAATCTTCTAAATTATGTTTTTCTTCTAG
>TTN-211,,0,1157,2511440,2512596,GTAAGTAGTCTTTGCTTCATTTATGTCATGTGGTAAGTTTATTAGAATTTCTTCTTTTATATGTAGACATTTCTCCCTGAGGAATCTAGCTCTAGAAATTCTTGAAAAACAGTAGAGAACAGTGGCTTTCAAACACATGAGTGGGCCAAAAACACACAGTAAATAAACTTATACAAACACATATATAACTAAAAAACATTTCCTGAAACAATACCCATTTATTATCATGTGCATTCTTATGTTTTCTACCCTATTCTGTGTTTTTAAAAATATTGGCTGTACAACAAACATATGAAGAAAAGCTCATCACCACTGGTCACTAGAGAAATGCAAATCAAAACCACAATGAGATACCATCTCACACCAGTTAGAATGGTGATCACTAAAAAGTCAGGAAACAACAGGTGCTAGAGAGGATGTGGAGAAATAGGAAAGCTTTTACACTGTTGGTGGGAGTGTAAATTAGTTCAACCATTATGGAAGACAGTGTGGCGATTCCTCAAGGATCTAGAACCAGAAATACCATTTGACCCAGCAATCTCATTACTGGGTATATACCCAAAGGATTATAAATCATTCTACTATAAAGACACATGCACATGTATGTTTATTGTGGCACTGTTCACAATAGCAAAGACTTGGAACCAACCCAAATGCCCATCAATGACAGACTGGATAAAGAAAATGTGGCACCACATTTACACCACAGGATACTACGCAGCCATAAAAAAGGATGAGTTCATGTCCTTTGCAGGGACATGGATGAAGCTGGAAACCATCATTCTCAGCAAACACAAGAACAGAAAACCAAACACCACATGTTCTCACTCATAAGTGGGAGCTGAACAATGAAAACACATGGACACAGGGAGGGGAGCATCACACACTGGGGCCTGTCAGGGGTTGGGAGGCTAGGGGAAGGATAGCATTAGGAGAATACCTAATGTAGACGATGTGTTGATGGGTGCAGCAAATCACCATGGCACATGTATACCTATGTAACAAGCCTGCACATTCTGCATATGTATCCCAGAACTTAAAGTATATATTAAAAAAAATTGGTGGTAATACAAGCATTAATTTGCACCAGTATAGCTCTCCACCAGAAGAAACTTATCCACCTTCCCAAAATTAATATCTTTTCATTTTACTTTCAG
>TTN-211,,0,103,2512597,2512699,GTAAGTTAAGTATTAGACAAATGGCCATCTAAATATGAAGCTCAGAAATATTTTTACGTATCAAATCCTTGTTCTTACATTTCTTTCCTCTTGGTTCATGTAG
>TTN-211,,0,90,2512700,2512789,GTATGTTTTTGTGAAGGAGAAAAAAAGTTGTTTTCTTTCTAGTTTGTTACTTAATGTAGAAACTGACATCTTCCTTGTCTTCATCTCCAG
>TTN-211,,0,369,2512790,2513158,GTAAGTTTTGGGGTTTTTTTATTGTTGTTGTTGTTTTAGTATTATGGAGGCACATTTAAATCTCGGAGTCTAAGATTTGGACTCCAAGACACAGAGAGTAGTAGAGATCTGAAGATTACAACTCCCATTTAAGAATATGTTCTATCTCTTACAATGAAGATGACATATTAAAAAAAGAAAAGGACATATAATTTCCTTTAAAGCATACAGCAAGGACTCAAAAGTGCATACTAGTTGGACGGTTATTAAAATGGGATAATTGTCTTCCTGTTGAGCTTGTTACTTAGCAGCAGGGATGATAATGTGAAATATGGAAGTTTAAACTTCTGCTGGTAAGATAAATGGTGAGTGTACCTCTTTTTGTTTTAG
>TTN-211,,0,379,2513159,2513537,GTAAGATTCTGCTGAGTATTATAGGCAAAGATGTAACAGCATTCATGATGGTCATTTTTCCTAATAAAAAACTAAATATACACCTAAGGAAAAAAGGAAAATTAAAATGATGTTTTGTATATAGACACAAACATTATGATTATGGAGAATCATAATAACATGCTAAATTAAAAAGCAAGATACACAACTGTGGCAACTATATAATTTCAATAGTTATTCAATAGTGCAGTTATTATTTGTCTATTAAAAATAAACAAAATGAAATAACACTAAAATTCCATTCTTGAAAGAAGCAGCATATGAATTTCCCACTATTATTAATAAGGATTACATAATATAGCTTTGCATACATTAAGTCCTTTATCTTATTTCTTTCCAG
>TTN-211,,0,347,2513538,2513884,GTAACTAATAAACTTCATTGGAATCCCATATTTTACTTTGGATAATGGGATGTAAATAGGATTTACAGAATAATGTGGGAGAAGACATTCATATTCTAATGTGTATTTCCTATGCACAGAATTATTCTTATGACAGAACCACGTTTTAGAGTTAAAAAGAGCTTTAGAAATCACATATTTCAATTACCTAATTTTACAAGTGAAGAAACTAAGATTCTAAAAAATTAACTAACCTCCTAGGTCATATAGGAAATTGACAATAGAAAGACTGCAGCCCAGGTCTCCAGACCTCTACTCTATACTCATTCCCCATTCCACATATTCACTCTTCTTCCTTATTCCTTCAG
>TTN-211,,0,87,2513885,2513971,GTAGGAACATTTCCCGGTGGTTTTTCATTTTATTTTTTAAAATTATCTTTTAGCCTGGGAAATTAACTTTTCAATCAATTTCTGCAG
>TTN-211,,0,101,2513972,2514072,GTAAGTGTTCATGAACGAGTTCCATATCCTGTGTTAAAAGCAGCATTAAACACCCAGGAAGGAAGTTTTCATGAAAATTTCCTATCATTATTTATTCTCAG
>TTN-211,,0,889,2514073,2514961,GTAAGTATTACCAGGGGGAGTACATAAGGCTTTTCCTATTAATCATATTCTAAGAGGGAGACTAGAACTCCCTTAGGTAGATTAATTTATTAACAAGGTGTAGAGCTGGTAACTCCAAGAGTACTTTTTAGGAGAGCTGGGTGGGTACTTTACGGTATTGTGGAACAGGCAAATCAAATGCACATGATTTGTGGTTTTGAAAAGCTTTTCATATATATAAGAATTTCCTGTCTTCAAAAGACATGAAATGAGAGAATTTTATTGGAATGTAAGAATTTTATTTTAGGAATAAAGAGGCCTTTTAACTAAGTAGTGAGCTATTTACTATTCTTAGGGTTTCTGTTTTCCAATCCACCATCTCCCTAAGTATGTGACTGGTGGGCTCTCCATCTTAATTTCCCTTCTTCTTATTTCTTCTATTTGCTTATCCTCCATGATAATTTCCCCTTTATTTGAATTACTTGATATTATATGTCACCCTCCAGGTACTTTTCTTCCTACTATGAAATAATAAAGAGAGCTAGAATATGTGGCAGAATACCTTCATGGAATATAGAAAGGAAAAAACAAGAATGAAAGGGAGCCAAAAATCAATCGTCTACTTTCCTTTTAATATATGTAGCATTTCAGAGTACATAAGGCTCATGAAAGAGGAGGTACAGATCCTCCGGGGGGAAAACCTGGTTAAGCCTAAAGCATAGTGGAAAATGGAAAGATCAACAATTAGTACAGAACAGAAAAATGATTTTGAGGATTGTATTAAGGAAGTTTTAAAGAACAAGAAATCAGCTCTAGAAAATAAATGTATTTTAGGAGTGACAAGGCCAGTCCCTGGAAATACATTTGACTATTAAATTTTTATTTAACTTCTTCACCCAAAATTAAACAG
>TTN-211,,0,92,2514962,2515053,GTAAGTCTATTTCAAAAAAGAATCATATATATTTTAAAATAGCTTATGTATTTTTTACACATTCATTTCTTATTTACCTACTATTTATCCAG
>TTN-211,,0,90,2515054,2515143,GTAAGCAAATGAACCATCATCCCATCATTTTGAGTTATATCCTTCCTTTGTTATATGGGGCTTACACTTATCATTTCTCCTTTGCTTTAG
>TTN-211,,0,167,2515144,2515310,GTAAGGCTCTATGCACACATCTTCATTTTTCCTTTATTGTCATCGAAAGTGCACTCTTGTGTCCCACTCACTAGCTTATCTAAAAATCCGTTAAAAGCTAGAACTATTTGAAAAAGTTAATCGCCTGGCCTTAAAAATAACAGTAATTTATCTCTGCTATTTTACAG
>TTN-211,,0,90,2515311,2515400,GTAAGTGTCTTAAATTCAGAAGACGTAAAGCAAAACACGGTTTTGAGGAGGCTTCTTATTATAAATCTTGCATTATCTACTTTTTTCTAG
>TTN-211,,0,425,2515401,2515825,GTATTTTGTTTGTTCTTATCCTACAGCTTTTACATCAAGATTCCTCACAAATATTTCCCTGAGAACAGTTGAACATGTGCTTATCGATAACATTATCTGCTTATACAGAAATGTGTTTTTATTTCAGTACATATGGTTAATGTTTAATTTTATTGAAAATATCCTAATGTAATAGTTAATAAAGTATTTCTTAATTATAATATCTATTTTTGTAAGTTAAAATTGTTCACCAAAAAAGACAACAACTATGCATATTCCAAGAGGAAAAAAAAAATGGCACTATGCTTGGGTAATAAAAGTATAGATACTAGCAAGAATGACTACTTGTTCAATATATATGGATATGTATAAATAATTTGGGCAACACATATATATTGTAAAATCAAGCTGCATTTATACTTGATACATCCCTGGGTCTTTTGTAG
>TTN-211,,0,89,2515826,2515914,GTAAGTCATTATATGAAGAAAAACCCAGGTGCATGTTTTACATGAAGAAAACTGGTATTTGTTTGACTGGTTTTGCTTTTATGTTTTAG
>TTN-211,,0,91,2515915,2516005,GTAGGTCCATTTTACTTTTTATGTACTTTTTTTTTTAAAGCAAATTAAGCCTCCTTCCTTTTCTGATTAAAATGTATTTTTTTCTTTGCAG
>TTN-211,,0,91,2516006,2516096,GTATGTAGAGCATGTGAGGGAATTGACATGGAAACATTTATAGCAGAGTTTAGGAAATCATGGATTTCTAATAAATTTGCTTCCTTTTCAG
>TTN-211,,0,112,2516097,2516208,GTTAGTATTTGTCTTTTTCAACACCGTTCATTCCAGAGTGCCAATATTTTATCTAAATTACCCAAAAGCCAAACTCTGAATATATACTTTTGTGTCTTTGTTTCTTTCTCAG
>TTN-211,,0,673,2516209,2516881,GTATGTTTTAAGAATAAGGAAATTCTACATATCCACGTTAATTTTGCTAGAATAGTGTGAGTCATTCTAATTAGTCGTTATTTCATCTTAAATGCTTTTGGGTTCACACCCTTCACACCCCAAACTATTCATACTATGGCACAAAATGGAATCTCTAGTGAAGAGTCTTTCATTGATTAAAAAAACAGAAATTTACGTAGCTAAAATTGGATAATATATGTTGAATTTAAGTATTATTGAATCTAACTGTATATATATGTAGGTATACATGTTTATATATATATATACACAGATTATATATATATAGTATGTGTGTATGACATATATCATATGTGTGTATGTGCGTGTGTACAGAAATTGTATATAAAGTTTTTTAAAAGATTGTTCATCTTGTTCCTCTTTTTTATCCCCATGGTGAATTTGGAGTAAATTTTATCATTTAATCTGGTCATTTTACCCTTAATTTGGATTTGAATGCTATAGCATGTAATGACATAGCTTGTGGGAGCCTTGGTTGGTTCAGAAGCAAAATGGGTTATGTAAAAAGGAAGACTAAAATCAACATAAAAATATGGCCTTCATTTAAAAGTTTTCTTTTGACAATACATGAAGAGTGCACATTTAAAAGTGCTGTAATAATTATTCACTTTCTTTTGATGCTTTGTTTTCTTAG
>TTN-211,,0,105,2516882,2516986,GTATGTCTAATTTTGTGTAGAAGCAAAATTTGAAATTATTTGCATTGATTTATGTTAATTTTCAGAAACACTTTTTCACTTTCACTTTCTATACTCATTTTTCAG
>TTN-211,,0,92,2516987,2517078,GTAAGTTGTCCAACTTTTCAAAGATCCAGGTTTTCTTTTACCATAAATGTGTTATTGTCTGTACTAATCTATAGGATTTCTCTCTTTTGTAG
>TTN-211,,0,108,2517079,2517186,GTACGTATTTGTCATGGGAAGGGCAGTTCTGATAACAAAAATGCAAATCTTACTTCTGCGAAGCAAAATATTATAAGTGCCGCTAATCTGCTTCTCTTATTACCACAG
>TTN-211,,0,1695,2517187,2518881,GTAAGCATGCTTAGCACTTTGAATCAAAATTGCTATTTAACTCAGTATTTCCGCATACCTTTTCCTGGTTCTAATCCTATAGAATAACTTTTACTCTGTGCCTTAATGGGGTTTTTGGAAGAAATTATGGACTAGCTGGGAGTCTGAGGAAAATTCCTTAAATACCTTTCCAGCCCTCTTGACTTGACTGTAAAGTGAGAGATTTAGACCTCAGGATATCTATGGGCCTTTCCAACTTCAACCTTTTATGATTGATTGTATGAGTTGGTGCTTTCATTCTGTTTTAAATTATCAGAGTCAATAATTAAACCATGGTTGAGTTCCTAGAGAATATTGCTCTTAAATAAGCCACAGACTAAACAGAGACTTCATTTTTTGGTTTTTTTTTTTTTGTTTGTTTGTTTGTTTGTTTGTTTTGAGACAGAGTCTCACTCTGTCGCCCAGGCTGTAGTGCAGTGGCACGGTCTTGGTTCACTGCAACTTCCGCCTCCTGGGCTCAAACGATTCTCGTGCCTCAGTCACCTGAGTAGCTGGGATTACAGGCATGCCCCACCACACCCAGCTAATTTTTTGTATTTTTAGTAGGGACGGAGTTTCACCATGTTGGCCAGGCAGGTCTCAACCTCCTGACCTCAGGTGATCCACCCACCTCGGCCTCCCAAAGTGTTGGGATTACAGGTGTGAGCCACCATGCCTGGTCTAAACACAGACTTTGATGATGATAGTATTAGCAGCAGCTAACATTTATTGAGGAATTTTCATGAATTCTTTCCCTTAGTTCTCACAGCCCTCATATTAGCCATCTTATAGAAGGGAAACTGAGGCTGAGAGTGCTTTTGTAACTTCCCCGTTAGGGATGGAGTGGGAATTCAGACAGACAGACTTCAGAGCCCTCTCTATCATGGTTAGTCCAAAATGCGTATTCTTCACCATTCTGGAAAATAAGTGGCACATTCAACTCAACAATGTTTTGAAAATTAAAACGTCATGAGAGTCAGGTATCCTGTGACACTTTACCTAAAAGATCTCCATTTGCTAAGAGAAAATTGAGCCACTGTAGTGTCTGGGCAAAAGTATCCACTTCCATCTTCATGCTGAGAATCTCAGGGCTGTTCATTATTTATGAATCAGGCTTTGTGGATACTGAATCAGTGTTTATGAGAGTATAAAGCAAGTCGAATTTAGTTATCTTTCTTGATAATTCCAAACAGCATGGCAGAAAATCTGTCCAGTAATTATGTAGCTCTGTGGGTAGAGAATTCAGACTTTAAGTGTCTGACATGAACCATCCACACTTGGATATCAGTGAACTGGGATGGGAAAAGAAAAAGAATAGGAGGTGCGTAGAAGAAAAGGAAAGAAAAGCTAAAGTGAAAGGAAATGTTTTAACAGCTTCTTCCATGATGTTCTCACTACCATATCCCATTTCTTCACTGGAATAAAGCAACTAATGGACTTTAAAACACATGTAAAAGGTGCTTAAGTCCCTGCACAACTCACAGTCTTTCTACCCCATCTGAGATAGAAGAGTGGCCTATAAATTTTTAATTTTTAAATAATAATTGCATAGAATTATAATGATGGTGTGTGTGTATAATTTAATAATGGCCAATGACCTTACTTTAAGGTTGGTGCAACTATTTTTTTTTCCATCCTTATAATATTTTAAATATTTCTCATCTGTTTTTCTTGCAG
>TTN-211,,0,112,2518882,2518993,GTAGGTGCTGAATACAGACCACTGTCATATTACATTTGCCTAAAGCTTAGTAATTTTGAACAAGTAGGCTTTAAAGAAGTACTAACATCGTGTTTTGTCCTTTCACTGATAG
>TTN-211,,0,236,2518994,2519229,GTGAGACATGATTTCATTAGAAAACTGAAACGTGAAAAATTTAAAAATAAACTACGCTAACCTGTGCATATGCTTTAATTTTCTTTTATATAACACCTGTCTCATTACCATCCTTTTCACAAGGTGAAAAATATAAAAAATAAAACCAATGTTCTTGGAAAGAATGCGAACATCAAAGGTATAATTTATCAGTAATGTGGATTCTTGTACCTTGTTTTCCCTTCCTTTCTAAATAG
>TTN-211,,0,106,2519230,2519335,GTAAGTGCTCATACCTGCAGCATCTTCACCTGTGTCTTCTATATTCACCTGTGTGACTAAATTGTACATGATTGTGTAATTATTTTATTGTGAATGGCCATTCCAG
>TTN-211,,0,105,2519336,2519440,GTATGTACCTACTGGTTTGATTATGTTTTTTAATAAGCATACTTCCAGGAAATCACTCTTTTTTGCTTTTAAAATTCACTGTATGTATCCATTTTATGTCTACAG
>TTN-211,,0,369,2519441,2519809,GTAAGTGATTATTATTCAAATACATTTAGTTTAGCAATTGAACATATTAGAAACAAATATATCAAGGAATGCTTTTCTTCTCTGCATCACCTTCTTACATATCTTCTTGTCACTAGAGAACTGGTCATGTAAAGCAAGAGGAATTATTTTAAGTCAGTCTAATAAACTAATTTGAAGTTCATTTTAAAGACTATGAAATGGAAAGTTGAAATTAATGACCAATATGAGTTTGGGAGATTGAATAAATTACTTATTATAAAAATTTTACTTATTTATTAAAATTATAGAATAATTGTATTGTTCTTCCATGGATGATTAAGACCTGGTTACAAATGTAATGATGCATTTACCTTCCTTATAATTTTTTAG
>TTN-211,,0,693,2519810,2520502,GTAAGCATTTACAACTTATTTCCAATGAGACTAAGAGCATTCACATTTTTAAAAAACACATTTGGCCCCTGGCCTGTAAAATGGTAACAGAAACAAATTACCCAAGGTTGCTAAGTGGATGAATTATGTCTTTCTACCTTTCAGATGAAAAGAAGAAAAAAATAATTGGCATCAATTATTTTTTCTATTATTTCACTCCATTCCCATATAAAGAGCATGCAGCAAGTGGGAATGAGTTTTTAGCTTTGTAATTTTCGCCACTTAACAGTACATAAAGAAAAGGTTCTCGAGAATAAGTGTCCATCTTTACTGAAGTTATTAAAATACAACATACATCCAACAACACAATCATCCCCTTGCTTGAATGCAGCTGATGGCCTCTTAAAAGAACTTGTGTGACTGTGCAGCAGTATTAGGAAGTACATGATCTGTAAATGTTTCACTTTCCTTTTTACAAAGAGCAATGCAAAATTAAAAACATGACAGGCATTACAAAGGGAATAATAATAGGCAAATATTTAACCCCATAGTCCAAATTCTCAATTATCAATCCTACTTTCAAAATAGGCTTTGGTAGCACAGTAGAAGTCACTACTCTTCCTGGCCTTGTGATATGGCACTACTGAAAAATATATATTTATGTATGTCTTTATTAAGCCAAACTAATACATAGTATTTCTCTTTCTTTTATAG
>TTN-211,,0,116,2520503,2520618,GTACTTTTAAAATAGCTTCTTAATGCTACAATTTATGAACTTGGATTAGAGACATGCCTAGTTGTATTTTAATGGACAAGGAAAAAGAAACTAACTCTAGAAACTTTTTCTTATAG
>TTN-211,,0,96,2520619,2520714,GTAAGTTTGCGTTTTTACTAAGCGGTACTATGTCAAAAGTTTAACCTTCCAAGCAAATGCATCTAATTGATTTGGGGTTTTGTTTTTGTTTTACAG
>TTN-211,,0,101,2520715,2520815,GTAAGAAAAATAAAAATCCTATTTCAAAGTCTCTATTATTAAATGTTTCCCCTGAATTTTATAAAATTGTATTCATACTTAATACCTTTGTTTATATTTAG
>TTN-211,,0,97,2520816,2520912,GTATGTATCACAATTTAAGGGCATATTTGTTTATTATTACTGATTCTAGTAGAACTCAGAGTGGTATATTTTAACCTTATTTTTGCATCCCTTCCAG
>TTN-211,,0,97,2520913,2521009,GTAGGAAATAGTCAACATTCTCCTTTTTAAAATTATCTCAATTTATGTGAAAATAAACTCTCAGATATTCATTCATATCTGTTTTGCCTACTGACAG
>TTN-211,,0,95,2521010,2521104,GTAAGCATGTCAAATGTTCTCACATTTATATAGCATTTTCCAGTGTGGGCAGAAAGAATGATCTTCATCATGGCTTGTCATTACACCTGTTTCAG
>TTN-211,,0,126,2521105,2521230,GTAAGTATTAACACTTTTAAATAATTTGACAGTTGAAATGTAATAGAATCAGGGGGAGAAGGGAGAAGGGCAGTCTTATCAATAGTAATTTTGTGCAATTCTCATCATCCTTATTTTCATAAACAG
>TTN-211,,0,881,2521231,2522111,GTGAGCTCCAAGAATCATACATAAATACAATGCTCCTCAAAACTATATGACAGATAATTTTCCAACACACAATCTCTAAGAATTTTTAGAATTTATGAATGGTCTAGAAAAGCACATGCTTATTTGCATGATCATAAATATAGCTTAAGTCAGAGAACATTTTAACTATTACATCTGTTAAGTTAGCAATTAGAATTGCTAAAAGTTGTACAGCATTTTCCAATTAATGAAAAAATATTCTATCAATATGAAAAGAATCTATTTTATAAATTTTCCTTAGAGAAAAATGCATTGTACTGTAATAACTGAAAAGAAAAATGGCAAAACTCCTTTTAAGAAGAGGTTTAGCAGGAACATACAGTTTCTAGTGGTTTCATAAGTTACTGACAAAGTAATTGTGACAAGAGCTTCAAAAATAAGTGGCAAATCCTTTTACAGAGTCTGAGCCCAAGAACTATAAAGGAATAGTCACTGGGACTGAATTGGGGAAGCTAAGGAAACCAATTCTTGTATTCATTAGAAATGTATTGGTGGCAAGTGATACTAACCCAGTGAAAGATAAGCAACTAAAGAAAAGTCCCTAAGAATGGGTACTTTAAGTAATGAGCTTAGCTAATAGAGAACACACAGTAAAGCTGGCCAAAGAAGTAGGGAAGAAATATCTACTTTCCTAAAGCAATTTAATTCTTAAGATAATAATATTAAATTATAATGTGGCACTCTGTGCTGTCCTATAATATCAGGAGCCCAGTTAATAAAGATTATCTTGGTGAGTGTGGACAAGAGCAATAATGCCTTTGTGAGTCTTGAAAACAAAAAATACAAATCTCAACATTTCCTTATTTGCCTAATATCTGCATCTCACTTTTTAAATTCCACAG
>TTN-211,,0,85,2522112,2522196,GTATTTATCACAGAAGCTTTTAGGTGAATTATTTTCTTCTCACACCTGTCCATGAATTAATTAAATTTTGTCATTAACTTTCCAG
>TTN-211,,0,171,2522197,2522367,GTAAGCATTTTACTTAAAATTGGCTATACAATGAGTAGATCCTCTAAAACAATATAGCTTGACCTATGATTGATCACCTCTCTAGAAAGGAACTATGTTGATTATATTTCCCCAAGAAAAAAAAAGCTATCAGGCAAATAGGAAATATGAATCTTTCATTCTGTTTTTCAG
>TTN-211,,0,119,2522368,2522486,GTATGTACCAAATAGCCAAAAAAAAAAAAAAAGTAAAGTAAAATGAAAACATTCAGAATTCGTAACAATTTACCATAAAAATAATGCTTAAGAATAAATGCCTGATTTCTTTCCCATAG
>TTN-211,,0,98,2522487,2522584,GTAAGGATGTGTGACAAAGATACAAGCAAGTTGATGTTCAGTCACCCAATTTTGATTTGAAGTAAAAATTAATTTCCTGTATTTCTTCTCTTTCATAG
>TTN-211,,0,679,2522585,2523263,GTAAGTCCACAGGCCCTTCCACCACTCTCCCCACCTCTGATTCTGAATGTTAACAAAAAAGAATTTGTTTTTAATATGCCCTAATGTAAATAAAAATAGGTCACAAAATTAACCCTGTGGTCTTTCTAAGGTTTCTAAACCTCCTTTTCTCAGGTTTCTAAACCTCCTTTTCTCAGAGGTTTTCAACACACTTAGGCTTGATTTTTTTTTTAATATCTTCACTCTTATGAAAGAGAAGAGGAGGGAGTTAGGAAGAAAGGAATGGAAGGAAGAAAAGAGAGAAGGGAAGGAGGAAGAGAGGAAAGGAAGGAGGACTGGCAATGTTATAGTGAGAAAAAAATACAGAGTGCATGCTTAATAAATGTAGAATTGAAGAAAATGAGGAACAGCAAGGAAAGTACAAAATTAAACCTCAGCATCATGCAATATACCCATGTAACAAACTGCACATGTACCCCTGAAGCTAAAAGTCAAAAATTTTTAATAAAAATAATTAAATAATTAAATGATTTAAATTAAAATTTACAAATAGTACAAAAGTGAAACTATTGGAAAAATAGTCATGTGCCTTATGTACCTTTTAAAATACCAACCAAAACCTAAGGAAAACACAAATATATGAGTCATTGTTTTAACGTATTCATATTGCCATATCGTGTTAACCTCTGTCTTGCTGCAG
>TTN-211,,0,911,2523264,2524174,GTAAGGACATTTTGTATCAGTCAAATTGATTGAGTTACAATTTATATGTGGGAAAATTCACCTTTTTGAAATATATAGTTCTATGACTTTTGAAAAATGTACTGTTTTGTAATCACCACCACAATCAAAATGTGGAATATTTTTATTACCCCGTAAAGTTCCCTTGTGTCCGTTTGTAATCAGTCCCTTCCCCACCCCAGCTGCTAGCGATTTCTGGCAAATAATTTTTAATATTCTTCTCTGGAGTCAATTTCCACTTCTTTAAGATGAGATTCATAATATATGCTTTCTATCACACTTAAAATTTTAAAACAAGTTAATATTTCTGGAAGCACTTTAAAAACTGCTGATAAATGTAAGATAATAATAGTGATTACAAATGAAGCACATTTAAGAGAAAGGAAAGTGAAAAAATGTTAAGTATTTTTAGCTGATAAAATGAATAAAATTTTCTTTTTTCTTTCTTTTGTTTTTTTGTGTTTTTTTGAGACAGAGTCTCACTCTGTCACCCAGGCTGGAGTGCAGTGGCATGATCTTGGCTCACTGCAACCTCTGTCTCCCAGGTTCAAGCAATTCTTCTGCCTCAGCCTCCTGAGTAGCTGGGATTACAGGTGCCTGCCACCACGCATGGCTAATTTTTATGTTTTTAGTAGAGACGCGGTTTCACCATGTTGGCCAGGCTGGTCTTGAACTAACTCCTGACCTCAAGTATCTGCCCACCTTGGCCTCCCAACTTGCTGTGATTACAGGCATGAGCCACCACACCCAGCCATGAATAAAATTTTCACAAGACAAAAAAACAGGCTAATGTTAACAGTCCGTTTCAACAACTCATTGAATTTGTTAGGTGGCACAGCTAATTTTCAACTTTGCAGCAACTTTAACCAGTATATTCTTATTCTTATTCTCAG
>TTN-211,,0,101,2524175,2524275,GTGAGACATATGATCATTTGCTTTCTGCAATAATTGCCATAGACTTATTTCTTAGTCCCCCTACCCCAAATGCTAAATTGAAACCCTACCTTTTTTTCCAG
>TTN-211,,0,130,2524276,2524405,GTAAGTGCCCTTTCAACCACAAAATTATAAACATTATTTCAGCACTTTTCTGTTTTTAAATGAAAGTCATTGGCTTATAATACTTGGGACTGTATTCTAATACATGTGTGCTTTCCACTTATATTTACAG
>TTN-211,,0,106,2524406,2524511,GTAAGGAATTCAGAAGAAGGGGTTAAATTAAAGAAGCAAGCCATGTTTGGTCCTTTTATTTCACCAGTAAAGCTGACTCCCTTTTCATTATTTTAAAATATTTCAG
>TTN-211,,0,622,2524512,2525133,GTAAGTAGCCTTTGGTTCTCTACTTATGATTTACAAACTAAACAAGTTAAGGCTAATTCCCCCTCTATACTAAGTAGAACCCTGGAAAGCTTTATTGGAGAGCAAGTGTTAAGAAAGAAAAGCAAGTACACACACAGGAAATATGACAAGTTCTACAGGAAACCATTCCAAGCACACAACCTCAGCAGATGTTAGATGGAGTGAACTGAGCACTTTCCTTGAGTAATTCCCTCTAATGCAATGGTTTCTTTTTAAAAATATTTCCCAACAAGATTTGAAAGGTCAACAATTGTATGCCACTTCAATGAACCTAAGTAAGGGCAAGAATACTACAGAATTATAGAGAGAATTTACAGTCCCTTAAAAGCCTATACATTATTAATCCCCTTCCAATCATAAAGAGAAAAAAACACTCTACATAAAATGTGACGATGTGCTCATTGAATCCCTATTTACCATATGATCCTAGGAAAATCACTTCAAAGAGTTTTTAAGAATTAGGCTAATATGTAAATCATGGTATGTGTCAGTAAATAAGGTAAATTCATTCCTGATATACAAGGACAAAGGATTACAGATTGAGTATTAACAGTCACTTAATATTATCTTTCATATTGTTCAG
>TTN-211,,0,98,2525134,2525231,GTATTTTATTTTTATTTTCAGTGCTTTTTATTTTTAAAGAAAAAAAAATCTCAAAAACACACTATGAAAACCACCACAATTGTATTTTCCCCCAACAG
>TTN-211,,0,362,2525232,2525593,GTGAGTACAACTTGATTTCTGTATCTTCCTATGGTAAAGTTCCATCTTTGCATAAAATTCTTTTAAACAGAAAGAAATTTTGAAAGGAAATAGCAAAGATTCAGATAAAGTACAAGTGCCTTTTCTTTCACTTTAATTGAATGTTTGCATATCTAAAAGGAGAAATATATATCCTAACCCCATTGTAAAAATAGAACTTTGGTTTTTGATATGTCTTAGTATAAAGTAACCAATTTCATCTTTCTGGAATAGCTATTTTTTAACAAAATTTTGGACTCATATAACATTCTTTTTTAAAAAAATAAGCTTTAATAAAGCTGCCTGTTTCATCTCATGACTCAAATCTTTTTTTTGTTTAATAG
>TTN-211,,0,132,2525594,2525725,GTAAAAATAAATAAATTATCATCAAGTTGAGGCTAAATGAGTTATTAACTTGGGGGTGGAGGCTATTGCACTTAAACACATACTGTTAGATGTTGCTAAATTATATTCTTTTTTTTTTTTTTTCTGATACAG
>TTN-211,,0,124,2525726,2525849,GTAACCAGTTCTTAAATGTCTCTTTCTTTTATCTTCTAAAATATTTTATCTTCTAAATTCAGCTTCCCAAAAAAAGCTTAAAATGAAATCACTTTTTAAAACACAAATCATTTGCATTCTACAG
>TTN-211,,0,740,2525850,2526589,GTAGGTTGGCTTTTGTTTTTACCCACATTTCTTCAGAAGATAATATTAGGGAAATATTTTCAAACATCCCCCCTTATATACACATACAAGAAAGTATTAAAATAAAATTATTTTCCTAATTCCAGAATACAATTTGTACACCAAAGCAGAAACACACATTTGAAGTTAGCATATGCTTTTCTATGAGCATAAAAAGCAGTTATTAAGTACCTAGTTATATGTGGTATTATATAAGATTCCATAGTGTCAGCCCCTGCTCCCAGGAATATTTAAGAATAAAGTCAGTGAATATACAAAATGGCACTACTTGCCTAAACCTTCACAGTTGCTAATTTTCCAAAGCAGTGCAAAGTTAATTAAAGAACTATTTCTATTTTACCAATTAAAATTAGTTTGCTTTCATTTCAATCTTCTGAAAGATAATTTAATGTTTTGGTTACTCAAAATCTCCCAAATCCACTTATCTCCTAAATCCGTTGACTATTCTTTTCAAGACTTTTTTCCTTAAGTCATATGAATCATCTTTGGCTCAGTTTAGTTTAAGGAATCATTACAGTGATCTCAAAAGTCACACATGATAATTTTCCAAAAGTGGAACTGAGAAAGTATTAGGTATTACCTACATTGCATGAAGAAGTTGACTTTTTTTCTTTTTATGTTTTTCACACGCAGAATCTAGAAGAGTAAAAGGTGGGGGTCTCTTTCTAATTAAGTTTGCCTTACAGAGGTTTCTTTTTTAG
>TTN-211,,0,100,2526590,2526689,GTAAGTTTAATTATGAATATATTATTGAAGAAAAACTAAAATACCATGTCTTCCACATCTGAAGAACTTCAACATTTCTTTTCTTTTTCCTTTGTCTTAG
>TTN-211,,0,525,2526690,2527214,GTAAGTATCTCCTCACCCTTCTTCCTTACATGTTTAAGGCCTTTAGATCGTTTTTTTGCCTCTCTTTCAAGCACAGAAAACTCTAAGAAGCCTTATTAAATTCCATGTGAAAGAGGGACAGCCAACTGATGTGAATTCATTCTTGTAGTCAAACTTTCTTTATAGCTACACAGAAACTTGGATAGATTACATTTCAAAGTAAAGCTACCAACTGCCGTGTAACATTTATTTGCAGGATGCACAATATGTCAATTACTTTCTATATGACTAATCATTTTTCTCCTAGTGATTCCTAGCACCTGCATGTAATGTAATGATAGAAATATAAGGATTCATGTTTTGGAGACATTGAGCTAGCTCTTGACAAATGTATGTATATATGTATTTGCTTATGCTTCAACAGCAAATTGTTTGGGTTATGCTGCTGTGTGTGTGTTGAAGTTTCCATTTCTGTAAGTCAGCGTCATATGTCATCAATTAACCAGATGTCATTGATGTTCACTGTGTATCTGCTATGCTCCACAG
>TTN-211,,0,138,2527215,2527352,GTGAGCAATAAAATTACTGGTAGAGGTAGACAAGCCAAGTAACATGGTGTAGTCTTTAGTACACACAATTCAGTAGAAAGCAAATCTTTATTTTTTTCAGTGATTCTAAGACCTTTTTTTTGTCATTGTTCCATAAAG
>TTN-213,ENSE00001465556,1,212,2527353,2527564,GAGCAGTCGTGCATTCCCAGCCTCGCCTCGGGTGTAGGGATTGCATAGAAAAGCAAAACTACACAGTCTTGACTGTGTAGTTTTGTTTTTAGGATTAGAGGCTCACCGATTCATGTCGGAGATGGTCAGAAAAACCAACTCTCCATAGGACGTCGTTTCAGAAGCAACCTTGGGCTTAGTCCCACCCTTTTTAGGCACTCTTGAGAAATCAG
>TTN-213,ENSE00003502146,1,104,2527565,2527668,AGTGCCTAGAAAGATGACAACTCAAGCACCGACGTTTACGCAGCCGTTACAAAGCGTTGTGGTACTGGAGGGTAGTACCGCAACCTTTGAGGCTCACATTAGTG
>TTN-213,ENSE00003807606,1,204,2527669,2527872,GTTTTCCAGTTCCTGAGGTGAGCTGGTTTAGGGATGGCCAGGTGATTTCCACTTCCACTCTGCCCGGCGTGCAGATCTCCTTTAGCGATGGCCGCGCTAAACTGACGATCCCCGCCGTGACTAAAGCCAACAGTGGACGATATTCCCTGAAAGCCACCAATGGATCTGGACAAGCGACTAGTACTGCTGAGCTTCTCGTGAAAG
>TTN-213,ENSE00003810976,1,288,2527873,2528160,CTGAGACAGCACCACCCAACTTCGTTCAACGACTGCAGAGCATGACCGTGAGACAAGGAAGCCAAGTGAGACTCCAAGTGAGAGTGACTGGAATCCCTACACCTGTGGTGAAGTTCTACCGGGATGGAGCCGAAATCCAGAGCTCCCTTGATTTCCAAATTTCACAAGAAGGCGACCTCTACAGCTTACTGATTGCAGAAGCATACCCTGAGGACTCAGGGACCTATTCAGTAAATGCCACCAATAGCGTTGGAAGAGCTACTTCGACTGCTGAATTACTGGTTCAAG
>TTN-213,ENSE00003809662,1,86,2528161,2528246,GTGAAGAAGAAGTACCTGCTAAAAAGACAAAGACAATTGTTTCGACTGCTCAGATCTCAGAATCAAGACAAACCCGAATTGAAAAG
>TTN-213,ENSE00003809782,1,245,2528247,2528491,AAGATTGAAGCCCACTTTGATGCCAGATCAATTGCAACAGTTGAGATGGTCATAGATGGTGCCGCTGGGCAACAGCTGCCACATAAAACACCTCCCAGGATTCCTCCGAAGCCAAAGTCAAGATCCCCAACACCACCGTCTATTGCTGCCAAAGCACAGCTGGCTCGGCAGCAGTCCCCATCGCCCATAAGACACTCCCCTTCCCCGGTCAGACACGTGCGGGCACCGACCCCATCTCCGGTCAG
>TTN-213,ENSE00003805863,1,331,2528492,2528822,GTCCGTGTCTCCAGCAGCAAGAATCTCCACATCCCCCATCAGGTCTGTTAGGTCTCCATTGCTCATGCGTAAGACTCAGGCATCCACCGTGGCCACAGGTCCTGAAGTGCCTCCCCCTTGGAAGCAAGAGGGCTACGTGGCCTCCTCATCTGAGGCTGAGATGAGAGAGACAACGCTGACAACCTCTACTCAGATCAGGACAGAAGAGAGATGGGAAGGGAGATACGGTGTCCAGGAGCAAGTGACCATCAGTGGTGCTGCGGGTGCTGCCGCCAGTGTGTCGGCCAGTGCTAGCTACGCAGCAGAGGCTGTTGCCACTGGTGCTAAAGAG
>TTN-213,ENSE00003803639,1,153,2528823,2528975,GTGAAACAAGATGCTGACAAAAGTGCAGCTGTTGCGACTGTTGTTGCTGCCGTTGATATGGCCAGAGTGAGAGAACCAGTGATCAGCGCTGTAGAGCAGACTGCTCAGAGGACAACCACGACTGCTGTGCACATCCAACCTGCTCAAGAACAG
>TTN-213,ENSE00003810843,1,138,2528976,2529113,GTAAGAAAGGAAGCGGAGAAGACTGCTGTAACTAAGGTAGTAGTGGCCGCCGATAAAGCCAAGGAACAAGAATTAAAATCAAGAACCAAAGAAGTAATTACCACAAAGCAAGAGCAGATGCACGTAACTCATGAGCAG
>TTN-213,ENSE00003803899,1,126,2529114,2529239,ATAAGAAAAGAAACTGAAAAAACATTTGTACCAAAGGTAGTAATTTCCGCAGCTAAAGCCAAAGAACAAGAAACTAGAATTTCTGAAGAAATTACTAAGAAACAGAAACAAGTAACTCAAGAAGCA
>TTN-213,ENSE00003808716,1,138,2529240,2529377,ATAAGACAGGAAACTGAGATAACTGCTGCATCCATGGTGGTAGTTGCCACTGCAAAGTCCACAAAACTAGAAACAGTCCCGGGAGCTCAAGAAGAAACTACCACACAACAAGATCAAATGCACCTAAGTTATGAAAAG
>TTN-213,ENSE00003809802,1,138,2529378,2529515,ATAATGAAGGAAACTAGGAAAACAGTTGTACCTAAAGTCATAGTTGCCACACCCAAAGTCAAAGAACAAGATTTAGTATCAAGAGGTAGAGAAGGCATTACTACCAAAAGAGAACAAGTGCAAATAACTCAGGAGAAG
>TTN-213,ENSE00003805623,1,138,2529516,2529653,ATGAGAAAGGAAGCCGAGAAAACTGCCTTGTCTACAATAGCAGTTGCTACTGCTAAAGCCAAAGAACAAGAAACAATACTGAGAACTAGAGAAACTATGGCTACTAGACAAGAACAAATCCAAGTTACCCATGGAAAG
>TTN-213,ENSE00003801659,1,294,2529654,2529947,GTGGACGTTGGAAAAAAGGCTGAAGCTGTAGCAACAGTTGTTGCTGCAGTAGACCAGGCCCGAGTCAGAGAGCCCAGAGAGCCTGGGCATCTTGAAGAATCCTATGCTCAGCAGACCACTTTGGAGTACGGATATAAGGAACGCATTTCCGCCGCAAAGGTAGCTGAGCCTCCCCAACGTCCAGCCTCAGAACCCCACGTTGTCCCTAAAGCAGTCAAGCCTAGAGTAATCCAGGCTCCTTCTGAGACTCATATCAAAACTACTGATCAAAAGGGAATGCACATATCATCACAG
>TTN-213,ENSE00003804455,1,123,2529948,2530070,ATCAAGAAAACTACAGATCTAACAACGGAAAGATTAGTCCATGTGGATAAACGCCCCCGCACAGCTAGCCCTCACTTTACTGTTTCAAAAATTTCTGTTCCTAAGACAGAACATGGATATGAG
>TTN-213,ENSE00003810306,1,282,2530071,2530352,GCATCAATAGCCGGTAGTGCTATTGCCACATTACAAAAAGAGTTGTCAGCCACATCTTCTGCTCAGAAGATCACCAAATCGGTGAAGGCTCCTACTGTGAAGCCCAGTGAGACTAGAGTAAGGGCAGAGCCCACACCCTTGCCACAGTTCCCCTTCGCTGACACACCAGATACTTACAAGAGTGAAGCTGGCGTTGAGGTGAAAAAGGAAGTAGGGGTGAGCATCACTGGCACCACCGTCCGTGAAGAGCGCTTTGAAGTACTGCACGGACGCGAAGCCAAG
>TTN-213,ENSE00003805296,1,66,2530353,2530418,GTAACAGAAACAGCAAGAGTACCAGCACCTGTTGAAATTCCTGTTACTCCACCAACTTTGGTCTCG
>TTN-213,ENSE00003806123,1,259,2530419,2530677,GGCTTAAAAAATGTGACTGTCATAGAAGGTGAATCTGTCACCTTGGAGTGCCACATCTCTGGATACCCATCCCCGACAGTGACATGGTACAGGGAAGACTACCAAATCGAAAGTTCCATTGACTTCCAGATAACCTTCCAGAGTGGAATTGCTCGTCTTATGATTCGCGAAGCATTTGCGGAAGACAGCGGGCGATTTACTTGCAGTGCTGTAAATGAGGCTGGAACCGTCAGCACATCCTGCTATCTGGCTGTGCAGG
>TTN-213,ENSE00003808554,1,64,2530678,2530741,TGTCAGAAGAATTTGAAAAGGAAACCACAGCCGTGACTGAGAAATTTACTACAGAAGAGAAACG
>TTN-213,ENSE00003804962,1,216,2530742,2530957,CTTTGTTGAGTCAAGAGATGTGGTTATGACTGATACTAGCCTCACAGAGGAACAAGCAGGGCCTGGAGAACCTGCCGCGCCTTACTTTATTACAAAACCAGTGGTCCAGAAACTGGTGGAAGGTGGGAGCGTGGTGTTTGGATGCCAAGTTGGCGGCAACCCAAAGCCCCATGTATACTGGAAAAAATCTGGTGTTCCTCTAACCACTGGATACAG
>TTN-213,ENSE00003804165,1,143,2530958,2531100,ATACAAAGTGAGTTACAACAAACAAACCGGTGAATGCAAGCTGGTGATTTCTATGACTTTTGCTGATGATGCTGGAGAATACACTATTGTTGTTCGCAATAAGCATGGAGAAACTTCTGCATCTGCTTCCTTGCTTGAAGAAG
>TTN-213,ENSE00003802603,1,206,2531101,2531306,CTGATTATGAGTTACTGATGAAGTCCCAGCAAGAAATGCTTTATCAGACACAAGTGACTGCATTTGTTCAAGAACCTAAAGTTGGAGAAACAGCACCTGGATTTGTATACTCTGAGTATGAAAAAGAGTATGAAAAAGAACAAGCCTTAATTAGGAAGAAAATGGCCAAAGATACTGTAGTGGTCAGAACTTATGTAGAAGATCAG
>TTN-213,ENSE00003807963,1,234,2531307,2531540,GAATTCCATATTTCTTCCTTTGAAGAGAGACTTATTAAAGAAATTGAATATAGAATAATAAAGACTACATTAGAAGAACTTCTTGAAGAAGATGGAGAAGAAAAGATGGCAGTTGACATTTCTGAATCTGAAGCTGTTGAATCAGGATTTGATTCAAGAATCAAGAATTATAGAATTCTTGAGGGGATGGGTGTCACTTTTCATTGCAAGATGTCTGGATATCCATTACCAAAG
>TTN-213,ENSE00003808968,1,245,2531541,2531785,ATTGCTTGGTACAAAGATGGCAAGCGCATCAAACATGGAGAAAGATACCAAATGGACTTTCTACAAGATGGCAGAGCTAGTCTGCGTATACCTGTTGTTCTTCCAGAAGATGAAGGAATCTACACTGCATTTGCCAGCAATATTAAAGGAAATGCAATTTGCTCAGGGAAATTGTATGTGGAGCCTGCTGCACCACTTGGAGCTCCGACTTACATTCCCACACTAGAGCCAGTGAGCAGAATCAG
>TTN-213,ENSE00003802614,1,272,2531786,2532057,ATCTCTCTCTCCACGTTCAGTGAGCAGGTCTCCTATACGCATGTCTCCTGCACGGATGTCACCTGCAAGGATGTCTCCTGCACGGATGTCCCCTGCAAGAATGTCCCCTGGACGTAGGCTGGAGGAGACAGATGAGTCACAACTTGAGAGACTATATAAACCAGTCTTTGTGTTAAAACCTGTTTCTTTCAAATGTTTAGAAGGGCAAACTGCCAGATTTGACTTAAAGGTTGTTGGTAGACCTATGCCAGAGACGTTCTGGTTTCATGATG
>TTN-213,ENSE00003811446,1,165,2532058,2532222,GCCAGCAAATTGTCAATGACTATACCCATAAAGTAGTCATTAAAGAAGATGGTACTCAATCACTAATTATTGTCCCTGCCACACCCAGTGATTCTGGGGAATGGACTGTGGTTGCCCAAAACAGGGCAGGCAGATCTTCAATTTCAGTGATTTTAACTGTGGAAG
>TTN-213,ENSE00003805710,1,169,2532223,2532391,CTGTGGAACATCAGGTAAAACCGATGTTTGTAGAAAAACTGAAAAATGTCAATATAAAGGAAGGTTCCCGACTTGAAATGAAAGTCAGAGCTACGGGTAACCCCAACCCTGACATTGTATGGTTGAAAAACAGTGACATCATTGTGCCTCATAAATATCCCAAAATCAG
>TTN-213,ENSE00003809358,1,1694,2532392,2534085,AATTGAAGGAACCAAGGGAGAAGCTGCCCTTAAAATCGATTCCACTGTCAGCCAAGATTCTGCCTGGTATACTGCGACTGCTATTAATAAAGCTGGCAGAGACACTACAAGATGCAAAGTAAATGTTGAAGTTGAGTTTGCAGAGCCTGAGCCAGAGAGAAAGTTAATCATCCCACGGGGGACATATAGAGCAAAGGAGATTGCAGCCCCAGAACTGGAGCCCCTCCATTTGCGATATGGCCAAGAGCAATGGGAAGAAGGTGATCTCTATGACAAAGAGAAACAACAGAAACCATTTTTCAAGAAAAAACTCACTTCCTTAAGACTTAAGCGCTTTGGGCCTGCCCACTTTGAATGCAGGCTAACACCCATTGGTGACCCAACGATGGTGGTGGAGTGGCTCCATGATGGAAAGCCACTTGAAGCAGCCAACAGGCTCCGTATGATCAATGAATTTGGGTACTGCAGCCTTGATTATGGCGTTGCATATTCTAGAGACAGTGGTATCATTACTTGCAGAGCCACTAACAAATATGGAACAGATCACACATCTGCTACCCTTATTGTTAAAGATGAGAAAAGTCTTGTGGAAGAATCCCAATTGCCTGAGGGGAGGAAAGGCTTACAGAGAATTGAAGAATTAGAGAGAATGGCTCATGAAGGTGCACTTACAGGTGTAACAACAGATCAGAAAGAAAAGCAAAAGCCAGACATTGTCTTGTACCCAGAGCCAGTTAGAGTACTTGAAGGGGAGACTGCAAGGTTCCGCTGCAGGGTAACAGGCTACCCTCAGCCCAAAGTCAACTGGTACCTCAATGGACAGCTCATCCGCAAAAGCAAAAGGTTCAGAGTTCGCTATGATGGTATCCATTACCTGGACATCGTGGACTGCAAATCATATGACACAGGTGAAGTGAAGGTCACCGCGGAAAATCCTGAAGGTGTGATAGAGCATAAAGTGAAGCTTGAGATTCAACAGAGGGAAGATTTTAGGTCTGTCCTTAGGAGAGCTCCTGAACCAAGGCCTGAGTTTCACGTACATGAACCAGGAAAGCTTCAGTTTGAAGTACAAAAAGTGGATAGACCTGTTGACACCACTGAAACCAAAGAAGTTGTGAAGTTGAAAAGGGCTGAAAGAATTACCCATGAAAAAGTGCCTGAAGAGTCGGAAGAGCTGCGCAGTAAATTCAAGCGCAGAACAGAAGAGGGCTATTATGAAGCCATTACCGCTGTGGAGCTCAAGTCTCGAAAGAAGGATGAATCCTATGAGGAACTCCTCAGGAAGACAAAAGATGAACTTCTCCACTGGACCAAAGAGTTAACTGAAGAGGAAAAGAAAGCTCTTGCCGAAGAAGGCAAAATCACGATTCCAACTTTTAAACCTGACAAGATTGAACTAAGTCCTAGTATGGAGGCTCCAAAAATCTTCGAAAGAATCCAGAGCCAAACAGTGGGCCAAGGATCTGATGCACACTTCCGGGTCAGAGTCGTGGGGAAACCAGACCCCGAATGTGAATGGTACAAAAATGGTGTCAAAATTGAACGGTCTGACCGGATCTACTGGTACTGGCCCGAAGACAATGTTTGTGAATTGGTCATAAGAGATGTGACTGCTGAGGACTCTGCCAGCATCATGGTAAAAGCCATCAACATAGCTGGAGAAACCTCCAGTCACGCATTCTTACTTGTCCAAG
>TTN-213,ENSE00003809440,1,282,2534086,2534367,CCAAGCAATTGATCACTTTCACACAGGAATTACAAGATGTTGTTGCTAAGGAAAAAGACACTATGGCAACCTTTGAATGTGAAACTTCAGAACCATTTGTCAAAGTGAAATGGTATAAAGATGGTATGGAGGTTCATGAGGGAGATAAATACAGGATGCACTCTGACAGAAAGGTTCACTTCCTCTCCATACTGACCATTGATACGTCTGATGCTGAAGATTACAGCTGTGTACTTGTGGAAGATGAAAATGTCAAAACGACTGCTAAACTTATTGTTGAAG
>TTN-213,ENSE00003802960,1,267,2534368,2534634,GTGCAGTTGTTGAGTTTGTGAAAGAACTTCAGGACATAGAAGTTCCAGAATCATATTCAGGAGAATTAGAGTGCATTGTATCCCCAGAAAATATAGAAGGAAAATGGTATCATAATGATGTGGAGCTTAAATCCAATGGCAAATATACAATTACATCTCGTCGTGGACGTCAGAACCTCACGGTCAAGGATGTAACCAAGGAGGACCAGGGAGAATACAGCTTTGTCATCGACGGGAAAAAGACAACCTGTAAATTAAAGATGAAAC
>TTN-213,ENSE00003804241,1,273,2534635,2534907,CCCGCCCCATTGCTATCCTACAAGGACTTAGTGACCAAAAAGTCTGTGAGGGTGACATTGTTCAGCTTGAAGTTAAAGTCTCCTTGGAAAGTGTGGAAGGCGTCTGGATGAAAGACGGCCAAGAAGTGCAGCCCAGTGACAGGGTTCACATTGTGATAGACAAACAATCTCATATGCTGCTCATTGAAGACATGACTAAGGAAGATGCTGGAAATTACTCTTTCACCATTCCAGCCCTTGGCCTCTCCACCAGTGGGCGTGTCTCTGTCTATA
>TTN-213,ENSE00003806988,1,264,2534908,2535171,GTGTGGACGTGATAACACCTCTAAAAGATGTTAATGTGATTGAAGGCACCAAGGCTGTGCTTGAATGTAAGGTGTCAGTCCCTGATGTGACTTCTGTTAAGTGGTACTTAAATGATGAACAAATCAAGCCTGATGACCGTGTACAGGCCATTGTGAAAGGTACTAAACAGCGACTAGTCATTAACCGAACTCATGCTTCAGACGAAGGACCTTACAAGCTGATAGTTGGCAGAGTTGAAACCAACTGTAATCTCTCTGTAGAAA
>TTN-213,ENSE00003804968,1,261,2535172,2535432,AAATTAAAATTATCAGAGGTCTTCGTGACCTTACCTGTACAGAAACTCAAAATGTGGTGTTTGAGGTTGAGCTGTCCCACTCTGGAATTGATGTCCTGTGGAATTTTAAGGACAAGGAAATCAAGCCCAGTTCTAAATATAAAATTGAAGCACATGGAAAAATATATAAATTGACAGTTCTAAATATGATGAAAGATGATGAAGGAAAATACACATTTTACGCGGGAGAAAATATGACATCTGGAAAACTTACTGTGGCAG
>TTN-213,ENSE00003809850,1,261,2535433,2535693,GTGGGGCCATCTCCAAGCCACTCACAGATCAGACCGTAGCTGAATCCCAGGAAGCTGTGTTTGAATGTGAAGTTGCCAACCCAGATTCCAAAGGCGAATGGTTGAGGGATGGCAAACACCTACCACTGACTAACAACATCAGAAGTGAGTCTGATGGCCACAAAAGGAGACTTATCATTGCTGCCACCAAATTAGATGACATTGGAGAATATACCTACAAGGTGGCCACCTCCAAAACATCTGCCAAACTCAAAGTTGAAG
>TTN-213,ENSE00003806479,1,264,2535694,2535957,CTGTCAAAATTAAGAAGACTCTGAAGAACCTCACAGTGACAGAAACACAGGATGCTGTTTTCACTGTCGAGCTTACACACCCTAATGTCAAAGGTGTCCAGTGGATCAAAAATGGAGTTGTGCTGGAATCCAATGAAAAGTATGCTATCTCTGTCAAAGGAACAATTTACTCTCTGAGGATTAAAAACTGTGCCATCGTGGATGAGTCTGTTTATGGCTTCAGGCTTGGAAGGCTTGGAGCCAGTGCCAGACTGCACGTGGAGA
>TTN-213,ENSE00003804523,1,261,2535958,2536218,CTGTCAAGATCATTAAAAAGCCAAAGGATGTGACAGCCTTGGAAAATGCCACTGTTGCCTTTGAAGTTAGTGTTTCCCATGACACTGTTCCAGTAAAATGGTTCCATAAGAGTGTGGAAATTAAGCCAAGTGACAAACACAGACTGGTCTCAGAAAGGAAAGTCCACAAGCTGATGCTGCAGAACATCTCCCCCTCAGATGCTGGGGAATACACAGCTGTGGTCGGGCAATTGGAATGCAAAGCAAAACTGTTTGTGGAGA
>TTN-213,ENSE00003807378,1,261,2536219,2536479,CATTACATATTACAAAAACCATGAAAAATATCGAGGTGCCTGAGACCAAAACTGCCTCTTTTGAGTGTGAGGTGTCCCACTTCAATGTCCCTTCCATGTGGCTGAAGAATGGTGTGGAAATTGAGATGAGTGAAAAGTTCAAGATAGTTGTGCAGGGAAAACTCCATCAGCTGATCATCATGAACACCAGCACAGAGGACTCGGCAGAATACACATTTGTCTGTGGCAATGACCAAGTCAGTGCCACCCTGACAGTCACCC
>TTN-213,ENSE00003807271,1,261,2536480,2536740,CAATCATGATTACTTCCATGCTGAAAGACATCAACGCTGAAGAAAAAGACACTATTACTTTTGAGGTGACAGTGAACTATGAAGGCATCTCTTACAAATGGTTAAAGAATGGTGTGGAAATCAAATCAACTGACAAGTGCCAGATGAGAACCAAAAAGCTCACACACTCACTGAACATCAGGAATGTTCACTTTGGGGATGCTGCTGACTACACCTTTGTGGCTGGAAAAGCAACATCAACAGCCACACTTTATGTGGAAG
>TTN-213,ENSE00003808172,1,142,2536741,2536882,CTCGTCATATAGAATTTAGGAAACACATTAAGGACATTAAGGTACTGGAGAAGAAGCGAGCCATGTTTGAATGTGAAGTTTCTGAACCTGACATCACTGTACAGTGGATGAAAGATGACCAGGAACTGCAGATCACAGACAG
>TTN-213,ENSE00003808223,1,166,2536883,2537048,AATAAAGATTCAGAAGGAGAAATATGTCCACCGCCTTCTGATCCCATCCACCCGGATGTCTGATGCTGGGAAGTACACAGTGGTGGCAGGAGGCAACGTGTCAACTGCAAAACTCTTTGTAGAAGGCAGAGATGTTCGCATCCGAAGTATTAAAAAGGAGGTTCAG
>TTN-213,ENSE00003810851,1,232,2537049,2537280,GTCATTGAGAAACAGCGTGCTGTTGTTGAATTTGAGGTCAATGAAGACGATGTTGATGCCCACTGGTATAAAGATGGCATTGAAATCAATTTCCAAGTTCAAGAACGACACAAATATGTAGTGGAAAGAAGAATCCACCGAATGTTTATCTCTGAGACCAGACAGAGCGATGCAGGAGAATACACCTTTGTGGCAGGAAGGAACAGGAGTTCTGTCACTCTCTATGTCAATG
>TTN-213,ENSE00003802092,1,285,2537281,2537565,CTCCTGAACCGCCCCAAGTTCTGCAGGAGCTCCAGCCTGTCACTGTGCAGTCTGGCAAGCCTGCCCGCTTCTGTGCCGTGATATCCGGAAGACCACAGCCCAAAATTTCCTGGTACAAGGAAGAGCAGCTGCTTTCCACTGGCTTCAAGTGCAAATTTCTTCATGATGGGCAAGAATACACGCTTTTGCTAATTGAAGCCTTCCCAGAGGATGCGGCAGTCTATACCTGTGAAGCCAAGAATGACTATGGTGTTGCCACAACATCAGCTTCACTCTCAGTGGAAG
>TTN-213,ENSE00003807103,1,126,2537566,2537691,TTCCAGAAGTTGTGTCTCCTGATCAGGAAATGCCTGTTTATCCACCTGCCATCATCACCCCGCTTCAGGACACTGTCACTTCTGAAGGGCAGCCAGCCCGTTTTCAATGCCGGGTTTCTGGAACAG
>TTN-213,ENSE00003801355,1,189,2537692,2537880,ATCTAAAAGTGTCGTGGTACAGCAAAGACAAGAAAATCAAGCCATCTCGGTTCTTTAGAATGACTCAATTTGAAGACACTTATCAACTGGAAATTGCCGAAGCTTATCCAGAAGATGAAGGAACTTACACGTTTGTTGCTAGTAATGCTGTAGGCCAAGTATCAAGCACAGCCAACCTGAGTCTGGAAG
>TTN-213,ENSE00004024281,1,375,2537881,2538255,GATTTAGCAAATTTGAAGAAAATACATCAAACTCCCAATGGCATGTCTCTTTATCAGTTTCATTTAAGAAGGAGCCCCTTGGCCAAAAGCCCAGCTTCATCCAGCCTCTGTCAAGCCTCAGGGTGCACAACGGGGAGACAGTCAGATTTCATGCGAGGGTTTCTGGCATTCCCAAGCCAGAAATCCAATGGTTTCATAACCAGCAGCTAATTCTACCAACAAAAGATGTAGTTTTCCATTTTGAGGAGTCCACAGGCATGGCTTTAATGCTTATAGTTGATGCTTACTCAGAGCATGCTGGGCAGTACTCTTGCAAAGCAGCCAATAGTGCTGGGGAAGCCACTTGTGCAGCTACACTCACAGTGACTCCAAAAG
>TTN-213,ENSE00004024285,1,576,2538256,2538831,TGCAAGCCCTAGATAGGCAAAGTTCTGGGAAAGATGTAAGAGAGTCCACCAAGTCCCAGGCAGTGGCAGATTCCTCTTTCACAAAGGAGGAGAGCAAAATATCTCAAAAGGAAATTAAGTCATTTCAAGGATCATCATATGAATATGAAGTGCAGGTTTTTGAAAGTGTATCTCAAAGTTCCATCCACACAGCTGCATCTGTTCAAGATACACAGTTGTGCCATACTGCATCCCTTTCACAAATTGCAGAAAGCACTGAGCTATCTAAGGAATGTGCTAAAGAGTCCACGGGTGAGGCGCCCAAGATTTTCCTGCATCTTCAGGACGTCACTGTAAAGTGCGGTGACACGGCTCAATTCCTCTGTGTTTTAAAAGATGATTCTTTCATTGATGTAACCTGGACTCACGAAGGTGCAAAGATAGAGGAATCCGAGAGACTGAAACAATCACAAAATGGAAATATTCAGTTTCTTACCATATGTAATGTTCAGCTGGTAGACCAAGGACTATACAGCTGCATTGTACACAATGACTGTGGAGAGAGGACAACGTCAGCAGTACTAAGTGTAGAAGGTG
>TTN-213,ENSE00003810791,1,57,2538832,2538888,CTCCTGAATCAATTTTGCATGAGAGGATTGAACAAGAGATTGAGATGGAAATGAAAG
>TTN-213,ENSE00004024265,1,2781,2538889,2541669,AGTTTTCTAGTTCTTTTCTGTCTGCCGAGGAAGAAGGACTTCATAGCGCCGAACTTCAATTATCTAAAATAAATGAAACACTTGAACTTTTGTCTGAATCTCCAGTTTACCCAACTAAATTTGATTCCGAAAAGGAAGGCACTGGCCCAATTTTCATCAAAGAAGTGTCAAATGCTGATATAAGCATGGGGGATGTGGCTACACTGTCTGTAACTGTCATTGGCATCCCCAAACCTAAAATTCAGTGGTTCTTTAATGGAGTGCTATTAACCCCTTCTGCTGACTACAAATTTGTTTTTGACGGTGATGATCATAGCCTGATCATTCTGTTCACCAAATTGGAGGATGAGGGAGAGTATACATGTATGGCCAGTAATGACTATGGAAAGACAATATGTAGTGCCTATCTAAAAATTAATTCCAAAGGAGAGGGTCACAAAGACACTGAAACAGAATCAGCAGTGGCAAAATCTCTGGAAAAGCTGGGAGGTCCTTGTCCTCCTCACTTCCTTAAGGAGTTAAAACCAATTCGCTGTGCTCAAGGGCTTCCTGCCATCTTTGAGTACACAGTGGTTGGAGAGCCTGCCCCTACTGTTACATGGTTCAAAGAAAACAAGCAGCTTTGCACCAGTGTTTATTACACTATCATTCATAACCCTAATGGCTCTGGAACTTTCATTGTCAATGACCCTCAGAGGGAAGACAGTGGCCTCTATATCTGTAAAGCAGAGAATATGTTGGGTGAGTCCACCTGTGCAGCAGAGCTGCTTGTGCTTCTGGAAGACACAGACATGACTGATACCCCCTGCAAAGCAAAGTCCACACCAGAGGCTCCTGAGGATTTTCCACAGACACCCTTAAAGGGTCCCGCAGTTGAAGCACTTGACTCAGAGCAGGAAATTGCAACGTTTGTAAAAGACACCATTTTGAAAGCTGCTTTAATTACAGAAGAAAACCAGCAACTATCTTATGAGCATATTGCTAAAGCCAATGAATTGAGCAGTCAGCTTCCTTTGGGAGCTCAGGAATTGCAATCCATTTTGGAGCAAGACAAGCTCACTCCTGAAAGCACCAGGGAATTTCTTTGCATCAATGGCAGTATTCACTTTCAGCCTCTCAAGGAACCATCTCCCAACCTACAGCTGCAGATTGTACAGTCCCAGAAAACCTTCTCCAAAGAAGGTATTCTAATGCCTGAAGAGCCTGAGACACAGGCAGTTCTATCAGATACCGAGAAAATCTTCCCAAGTGCCATGTCCATAGAACAAATTAATTCATTAACAGTTGAGCCTCTGAAAACTTTATTAGCTGAACCTGAAGGGAATTATCCACAGTCTTCAATAGAACCTCCAATGCATTCTTATCTAACCTCTGTGGCTGAGGAAGTACTTTCACCAAAAGAAAAGACAGTATCTGACACCAACAGAGAGCAAAGAGTGACTCTTCAAAAGCAAGAGGCACAAAGTGCGCTCATCTTGAGTCAGAGCTTAGCTGAGGGACACGTGGAGAGTCTCCAGAGTCCTGATGTCATGATCTCTCAGGTAAACTATGAGCCCCTAGTCCCTTCAGAACACTCATGCACAGAAGGAGGTAAAATTTTGATAGAAAGTGCAAATCCACTGGAAAATGCAGGGCAAGATTCTGCGGTCAGAATTGAGGAAGGCAAGTCCTTAAGATTTCCACTAGCACTTGAAGAAAAGCAGGTACTGCTCAAAGAAGAGCATTCTGACAACGTGGTGATGCCCCCAGACCAAATCATTGAGTCTAAAAGAGAGCCCGTGGCAATAAAGAAAGTGCAGGAGGTACAGGGAAGGGACCTTCTTTCTAAGGAAAGCTTGCTTTCTGGTATTCCAGAAGAGCAGAGATTAAACCTGAAAATTCAAATCTGCCGGGCTTTGCAAGCAGCCGTGGCCAGCGAGCAGCCAGGTCTTTTCTCTGAGTGGCTAAGAAATATTGAAAAGGTGGAGGTCGAGGCTGTAAACATCACCCAAGAGCCCAGACACATCATGTGCATGTACCTTGTTACTTCGGCAAAGTCTGTAACAGAAGAAGTAACCATCATTATTGAAGATGTTGATCCTCAAATGGCTAACCTGAAAATGGAACTTAGGGATGCTTTGTGTGCTATTATATATGAGGAAATAGACATCCTAACAGCTGAGGGTCCTAGAATTCAGCAAGGAGCCAAAACAAGTTTGCAAGAAGAAATGGATTCTTTTTCAGGTTCACAGAAGGTTGAACCCATTACTGAACCAGAAGTTGAATCTAAATATCTGATCTCAACTGAAGAGGTCAGTTATTTTAACGTGCAAAGTAGGGTTAAATATTTGGATGCCACACCTGTCACTAAAGGGGTTGCTTCAGCTGTTGTCTCTGACGAAAAACAAGATGAGAGTCTGAAACCATCAGAGGAAAAAGAGGAGTCTTCCTCTGAAAGTGGTACTGAGGAGGTTGCTACAGTAAAGATACAGGAAGCTGAGGGTGGCTTAATCAAAGAGGATGGCCCCATGATACATACACCTTTAGTGGACACTGTTTCTGAGGAAGGTGATATTGTACACCTCACAACATCCATAACAAATGCTAAAGAGGTGAATTGGTATTTTGAGAATAAACTGGTGCCTTCAGATGAAAAGTTCAAGTGTTTACAAGATCAAAATACATATACGCTAGTCATCGACAAAGTAAATACCGAAGACCATCAAGGAGAGTATGTCTGTGAGGCCTTGAATGACAGCGGAAAAACAGCAACTTCAGCCAAACTCACTGTAGTAAAAAGAG
>TTN-213,ENSE00003805227,1,279,2541670,2541948,CTGCCCCAGTGATCAAGAGGAAAATCGAACCCCTGGAAGTAGCACTGGGCCACCTAGCCAAATTCACCTGTGAGATCCAAAGTGCTCCCAATGTCCGGTTCCAGTGGTTTAAAGCTGGCCGAGAAATTTATGAGAGTGACAAGTGTTCTATTCGATCTTCAAAGTATATCTCCAGCCTTGAAATCCTGAGAACCCAGGTGGTTGACTGCGGCGAGTATACATGCAAAGCTTCCAATGAGTATGGCAGTGTCAGCTGTACAGCCACACTAACTGTGACAG
>TTN-213,ENSE00003808619,1,564,2541949,2542512,AGGCATATCCACCAACCTTTCTCTCCAGACCTAAGTCCCTTACAACTTTTGTGGGTAAGGCAGCCAAGTTCATCTGCACAGTGACAGGGACTCCTGTGATAGAAACCATTTGGCAGAAAGATGGTGCTGCACTCTCACCTTCACCTAACTGGAGGATTTCCGACGCAGAAAACAAACACATTTTAGAACTCTCAAACCTTACCATTCAAGATAGAGGAGTTTATTCTTGTAAGGCTTCCAACAAGTTTGGAGCAGACATCTGCCAAGCAGAGTTGATCATCATTGATAAGCCACATTTCATTAAAGAATTAGAGCCTGTGCAGTCCGCTATCAATAAGAAGGTCCACCTTGAGTGCCAAGTAGATGAAGACAGAAAAGTCACAGTTACGTGGAGCAAAGATGGGCAAAAACTCCCCCCAGGGAAAGATTATAAGATCTGTTTTGAAGATAAAATAGCAACACTTGAGATTCCTTTGGCCAAACTGAAAGATTCAGGAACCTATGTCTGTACAGCTTCAAATGAGGCTGGAAGCAGCTCCTGCTCAGCCACAGTCACTGTCAGAG
>TTN-213,ENSE00003811334,1,282,2542513,2542794,AGCCACCATCCTTCGTGAAGAAGGTGGATCCCTCTTATTTAATGCTCCCAGGTGAATCAGCACGCCTCCATTGCAAGCTGAAAGGCTCACCTGTGATCCAGGTTACTTGGTTTAAAAATAACAAAGAACTCAGTGAAAGTAACACAGTCCGAATGTATTTTGTCAATTCTGAGGCTATACTTGATATTACGGATGTAAAAGTTGAAGACAGTGGGAGTTACTCATGTGAAGCAGTGAATGACGTCGGCAGTGATAGCTGCAGTACTGAAATAGTTATCAAAG
>TTN-213,ENSE00003807496,1,279,2542795,2543073,AACCTCCTTCTTTCATCAAAACTCTTGAGCCTGCAGACATAGTGAGAGGAACAAATGCTCTACTTCAGTGTGAAGTCTCAGGCACTGGACCATTTGAAATTAGCTGGTTCAAAGACAAGAAACAAATTCGAAGTAGTAAAAAATACAGATTGTTTTCTCAGAAGTCTCTTGTGTGTCTGGAGATCTTTTCGTTTAATAGTGCAGATGTTGGTGAATATGAATGTGTTGTTGCTAATGAAGTCGGCAAGTGTGGCTGCATGGCAACCCACTTACTCAAAG
>TTN-213,ENSE00003806831,1,279,2543074,2543352,AACCTCCAACCTTTGTAAAGAAAGTAGATGATTTGATTGCACTAGGAGGACAAACCGTTACCCTGCAAGCTGCTGTGAGAGGGTCAGAGCCCATTTCTGTCACATGGATGAAAGGTCAAGAGGTCATCAGAGAAGACGGAAAAATCAAAATGAGCTTTTCCAATGGTGTTGCAGTCTTGATAATCCCTGATGTTCAGATTAGTTTTGGAGGCAAATACACGTGCCTGGCTGAAAATGAAGCTGGAAGCCAAACATCTGTTGGGGAATTAATAGTTAAAG
>TTN-213,ENSE00003801788,1,279,2543353,2543631,AACCTGCCAAAATCATTGAGCGAGCAGAACTGATCCAGGTGACAGCAGGAGATCCCGCCACACTGGAGTACACAGTGGCAGGCACGCCAGAACTGAAGCCCAAATGGTACAAAGATGGGAGACCCTTGGTCGCCAGTAAAAAATACCGAATAAGTTTTAAAAACAATGTTGCCCAGCTCAAATTTTATTCAGCTGAGCTGCACGACAGTGGCCAATACACATTTGAGATTTCCAATGAAGTGGGCAGCAGCTCCTGTGAGACTACATTCACTGTATTAG
>TTN-213,ENSE00003804186,1,288,2543632,2543919,ATCGAGACATTGCTCCATTTTTTACCAAACCCTTGCGCAACGTGGATAGTGTTGTTAATGGTACCTGCAGACTGGACTGCAAAATTGCAGGCTCCCTCCCCATGAGGGTGTCCTGGTTTAAGGATGGCAAAGAAATAGCTGCTTCTGACAGATACAGGATAGCATTTGTGGAAGGCACAGCCTCTTTGGAGATCATCAGAGTAGACATGAATGATGCAGGGAATTTCACTTGTCGAGCCACAAATTCCGTGGGAAGCAAAGACAGCAGTGGAGCCCTGATTGTGCAAG
>TTN-213,ENSE00003805178,1,279,2543920,2544198,AACCACCCAGTTTTGTAACTAAACCCGGCTCAAAGGATGTTCTGCCTGGCTCAGCAGTCTGCCTGAAGAGCACTTTCCAAGGATCTACTCCTCTCACAATCAGATGGTTTAAGGGCAACAAAGAGCTGGTTTCTGGTGGAAGCTGCTATATTACCAAAGAAGCTTTAGAGAGTTCCCTGGAACTCTATTTAGTAAAAACCTCTGATTCGGGCACGTACACATGTAAAGTCAGCAATGTCGCTGGAGGGGTGGAATGCAGTGCAAACTTGTTTGTAAAAG
>TTN-213,ENSE00003806856,1,282,2544199,2544480,AACCTGCCACATTTGTTGAAAAGTTAGAGCCATCACAGCTGTTAAAGAAGGGAGATGCCACCCAGCTAGCCTGCAAAGTAACTGGTACCCCTCCAATTAAAATAACATGGTTTGCAAATGATAGAGAAATTAAGGAGAGCAGCAAACACAGAATGTCTTTTGTGGAGTCTACTGCAGTTCTAAGACTGACAGATGTTGGCATCGAAGACAGTGGTGAATATATGTGTGAGGCCCAAAATGAGGCTGGCAGTGACCACTGCAGTAGCATTGTAATAGTCAAAG
>TTN-213,ENSE00003804074,1,279,2544481,2544759,AGTCACCTTATTTTACCAAGGAATTTAAGCCAATTGAAGTCTTAAAGGAGTACGATGTCATGTTGCTGGCTGAGGTGGCAGGCACTCCTCCCTTTGAGATCACTTGGTTCAAAGATAACACAATCCTGCGAAGTGGTAGAAAGTATAAGACTTTCATTCAGGATCATCTGGTTAGCCTGCAGATCCTCAAGTTTGTAGCTGCAGATGCTGGCGAATACCAGTGTCGGGTGACCAATGAGGTGGGCAGCAGCATCTGCAGTGCCAGGGTGACTTTAAGAG
>TTN-213,ENSE00003807057,1,279,2544760,2545038,AACCCCCATCCTTCATAAAGAAGATCGAGAGTACCAGCTCCCTCCGGGGAGGCACAGCTGCCTTCCAGGCCACTCTGAAGGGCTCCTTGCCAATTACGGTGACTTGGCTAAAAGACAGCGATGAAATCACTGAAGACGATAATATAAGAATGACCTTTGAGAACAATGTGGCCAGTTTGTACCTCAGTGGCATTGAAGTCAAGCATGATGGGAAATATGTCTGTCAGGCCAAAAATGATGCAGGAATACAAAGATGTTCTGCATTACTCTCAGTAAAAG
>TTN-213,ENSE00003807032,1,279,2545039,2545317,AACCTGCAACAATCACCGAGGAAGCTGTGTCTATAGATGTCACCCAAGGAGACCCAGCCACTTTGCAGGTTAAATTTTCAGGGACTAAGGAGATTACAGCCAAATGGTTTAAAGATGGCCAAGAACTGACCCTGGGCTCAAAATATAAAATCAGTGTCACTGATACAGTCTCAATACTGAAGATTATTTCTACAGAAAAGAAAGATAGTGGAGAATATACTTTCGAGGTCCAAAATGATGTTGGGAGGAGCAGCTGCAAGGCTAGAATTAATGTATTAG
>TTN-213,ENSE00003810010,1,288,2545318,2545605,ATCTTATCATACCTCCTTCATTCACCAAAAAGCTGAAGAAAATGGACAGCATTAAAGGTTCTTTCATTGATTTAGAATGTATAGTGGCTGGGTCACATCCCATAAGCATCCAGTGGTTCAAAGATGACCAAGAAATATCAGCTAGTGAAAAGTACAAATTCTCTTTTCATGACAATACTGCCTTCTTGGAAATCAGCCAGCTGGAAGGTACAGACAGTGGGACATACACTTGTTCTGCCACAAATAAGGCAGGGCACAACCAATGCAGTGGGCATCTGACAGTCAAAG
>TTN-213,ENSE00003805733,1,279,2545606,2545884,AACCCCCTTACTTTGTGGAAAAGCCACAGTCACAAGATGTCAATCCCAACACAAGGGTACAGTTAAAGGCTCTTGTGGGTGGCACTGCACCCATGACAATAAAGTGGTTTAAAGATAACAAAGAGTTACACTCAGGAGCAGCCCGCTCAGTTTGGAAGGATGACACCTCTACCAGTCTAGAGCTCTTTGCAGCCAAAGCTACCGATTCTGGAACCTACATTTGCCAACTAAGCAATGATGTTGGCACAGCAACCAGCAAAGCCACTCTCTTTGTAAAAG
>TTN-213,ENSE00003805836,1,282,2545885,2546166,AACCTCCTCAATTCATTAAGAAGCCCAGTCCAGTCTTAGTGCTGAGGAATGGACAGTCAACAACATTTGAATGCCAAATAACAGGCACTCCTAAAATCCGAGTGTCTTGGTATCTAGACGGGAATGAAATAACAGCCATTCAGAAACATGGCATTTCCTTCATTGATGGTTTAGCCACTTTCCAGATTTCTGGTGCCAGGGTAGAAAATAGTGGGACTTATGTGTGTGAAGCTCGAAATGACGCAGGCACGGCGAGCTGCAGCATTGAACTCAAAGTGAAAG
>TTN-213,ENSE00003802637,1,279,2546167,2546445,AACCCCCCACCTTTATCAGAGAGCTGAAGCCTGTGGAGGTAGTAAAATATAGTGACGTGGAGCTGGAGTGTGAAGTTACGGGAACACCTCCGTTTGAAGTCACTTGGCTGAAGAATAACAGGGAAATTCGAAGCAGCAAAAAATACACATTGACCGACAGAGTGTCTGTGTTTAACCTCCATATAACCAAGTGTGACCCTTCAGACACTGGGGAATACCAGTGCATTGTATCCAATGAAGGCGGCAGCTGCTCATGCAGTACTAGAGTTGCCCTGAAAG
>TTN-213,ENSE00003809504,1,279,2546446,2546724,AACCACCATCATTCATTAAGAAGATAGAAAATACCACTACTGTTTTGAAAAGTTCTGCCACCTTTCAGAGTACCGTGGCAGGTTCTCCTCCTATTTCTATAACCTGGCTAAAGGATGATCAGATTCTTGATGAAGATGATAATGTCTATATTTCATTTGTGGACAGTGTGGCCACACTTCAAATCAGAAGTGTGGATAATGGACACAGTGGGAGATATACCTGTCAAGCCAAGAATGAGTCAGGAGTTGAGAGGTGTTATGCTTTCCTTTTAGTACAAG
>TTN-213,ENSE00003802968,1,279,2546725,2547003,AACCAGCTCAAATCGTAGAGAAAGCTAAATCAGTTGATGTTACGGAGAAAGATCCCATGACCTTGGAATGTGTTGTGGCTGGAACACCAGAACTCAAAGTGAAATGGCTTAAAGACGGGAAACAAATAGTTCCCAGTAGATACTTTTCAATGAGTTTTGAAAATAACGTGGCCAGTTTTAGAATTCAGTCAGTAATGAAGCAGGACAGCGGTCAGTACACTTTCAAGGTGGAAAATGACTTCGGAAGCAGTAGCTGTGATGCCTACTTAAGAGTGCTAG
>TTN-213,ENSE00003810612,1,288,2547004,2547291,ATCAAAATATTCCTCCATCATTCACCAAAAAATTAACCAAAATGGATAAAGTTCTGGGCTCTTCTATTCATATGGAGTGCAAGGTGTCTGGTTCACTTCCCATTAGTGCTCAGTGGTTTAAGGATGGAAAAGAAATATCTACAAGTGCAAAATACAGACTTGTGTGCCATGAGAGATCTGTGTCTCTGGAAGTTAATAATCTGGAATTAGAAGATACTGCAAATTACACATGCAAAGTGTCAAATGTAGCAGGAGATGATGCATGCAGTGGCATCTTAACTGTGAAAG
>TTN-213,ENSE00003806423,1,279,2547292,2547570,AACCACCAAGCTTCCTAGTGAAACCTGGGCGACAGCAAGCCATACCTGATTCTACAGTGGAATTTAAGGCAATACTAAAAGGAACACCACCATTTAAAATAAAATGGTTTAAGGATGATGTGGAACTTGTCTCAGGTCCTAAATGTTTCATTGGCTTGGAAGGGTCGACTAGCTTCTTAAATCTCTACTCAGTGGATGCTTCTAAGACTGGACAGTATACTTGCCATGTTACCAATGATGTTGGTAGCGACTCTTGTACTACGATGTTGCTTGTGACAG
>TTN-213,ENSE00003805536,1,282,2547571,2547852,AACCACCAAAGTTTGTAAAGAAATTAGAAGCCTCCAAAATTGTGAAAGCAGGTGACTCTTCACGACTTGAATGCAAGATAGCTGGATCCCCAGAAATCAGAGTTGTGTGGTTCCGAAATGAACATGAACTTCCAGCCAGTGATAAGTACAGAATGACTTTCATTGACTCAGTGGCCGTCATACAGATGAACAATCTCAGTACTGAGGACAGTGGAGATTTCATTTGTGAGGCTCAGAATCCCGCTGGCAGCACAAGCTGCAGTACCAAGGTTATAGTAAAAG
>TTN-213,ENSE00003807762,1,279,2547853,2548131,AGCCACCTGTTTTTAGCAGCTTCCCTCCTATAGTAGAAACCCTTAAAAATGCTGAAGTCAGTCTTGAATGTGAACTTTCGGGAACACCACCGTTTGAGGTGGTATGGTACAAAGACAAGCGGCAACTCAGAAGCAGCAAGAAATACAAGATTGCATCCAAAAACTTCCACACAAGTATTCACATTCTCAATGTGGACACTTCAGACATCGGTGAATACCACTGCAAAGCACAGAATGAAGTGGGAAGTGATACTTGTGTTTGTACTGTAAAATTGAAAG
>TTN-213,ENSE00003809887,1,282,2548132,2548413,AACCACCAAGATTTGTCTCCAAACTGAACAGCCTCACTGTTGTAGCCGGAGAGCCTGCTGAATTACAAGCATCCATAGAAGGCGCCCAGCCTATTTTTGTCCAGTGGCTTAAAGAGAAGGAAGAAGTGATTAGAGAAAGTGAAAACATCAGGATTACATTTGTGGAAAATGTTGCAACTCTACAGTTTGCAAAAGCAGAGCCAGCTAATGCTGGAAAGTATATCTGCCAAATCAAGAATGATGGTGGAATGAGGGAGAACATGGCCACACTGATGGTCTTAG
>TTN-213,ENSE00003811356,1,279,2548414,2548692,AGCCCGCAGTCATTGTTGAGAAGGCAGGACCGATGACGGTGACTGTAGGAGAAACGTGCACTCTGGAGTGTAAGGTGGCTGGCACTCCGGAACTCTCTGTTGAATGGTACAAGGATGGAAAGCTGTTGACCAGCAGCCAAAAACACAAATTTAGCTTCTACAACAAAATCTCTTCCTTAAGGATTCTCTCAGTTGAAAGGCAAGATGCAGGCACATACACTTTCCAGGTTCAAAATAATGTTGGGAAAAGCAGCTGCACAGCTGTGGTTGATGTTTCAG
>TTN-213,ENSE00003804298,1,288,2548693,2548980,ACCGAGCAGTTCCTCCCTCTTTCACACGAAGACTGAAAAATACTGGTGGGGTGTTAGGTGCTTCTTGCATCTTGGAATGCAAAGTAGCTGGATCATCACCTATTTCAGTTGCCTGGTTTCATGAGAAAACCAAGATTGTCAGTGGAGCAAAGTACCAAACCACATTTTCAGATAATGTCTGCACATTGCAGTTGAATTCTCTGGATTCCTCAGATATGGGCAATTACACATGCGTGGCTGCTAATGTCGCTGGGTCTGATGAATGTCGTGCAGTGCTAACTGTACAAG
>TTN-213,ENSE00003807700,1,279,2548981,2549259,AACCACCCTCTTTTGTGAAAGAACCTGAACCTTTGGAAGTACTACCAGGCAAAAATGTAACCTTCACAAGCGTTATTAGAGGAACCCCTCCATTCAAAGTCAACTGGTTCAGAGGTGCCAGAGAACTAGTGAAAGGAGACCGGTGCAACATCTATTTTGAAGACACTGTGGCAGAACTGGAATTATTTAATATTGACATATCTCAGAGTGGGGAATACACCTGTGTGGTTTCTAACAACGCTGGCCAAGCATCTTGCACTACCCGTCTCTTTGTGAAAG
>TTN-213,ENSE00003803086,1,279,2549260,2549538,AACCAGCTGCATTTTTGAAGAGATTAAGTGATCATTCTGTAGAACCAGGGAAGTCCATAATTCTGGAGAGCACCTACACTGGAACACTTCCAATTTCTGTCACTTGGAAAAAGGATGGTTTTAACATAACTACCTCTGAAAAATGTAACATAGTCACAACAGAGAAAACTTGTATCCTGGAAATTCTGAATAGCACAAAAAGAGATGCAGGGCAGTATTCCTGCGAGATTGAAAATGAGGCAGGAAGGGATGTTTGTGGAGCTCTGGTATCTACATTAG
>TTN-213,ENSE00003806655,1,279,2549539,2549817,AACCGCCTTATTTTGTTACGGAACTGGAACCTCTGGAGGCAGCAGTTGGAGATTCGGTTTCTTTACAATGCCAAGTTGCTGGGACACCAGAAATTACAGTGTCTTGGTACAAAGGAGATACCAAATTACGGCCAACTCCTGAATACAGGACCTACTTTACAAACAATGTGGCCACACTTGTTTTTAATAAAGTGAACATCAATGACAGTGGAGAGTACACATGCAAAGCAGAAAATAGTATAGGAACTGCTTCTTCTAAGACTGTGTTCAGAATTCAAG
>TTN-213,ENSE00003805355,1,288,2549818,2550105,AGCGCCAACTCCCACCTTCTTTTGCAAGACAATTAAAGGACATTGAACAAACTGTGGGGTTACCTGTTACACTCACTTGTCGATTAAATGGCTCTGCACCCATCCAAGTGTGCTGGTATAGAGATGGAGTACTTTTAAGAGACGATGAAAATCTACAGACTTCATTTGTAGATAATGTGGCAACTTTAAAAATTTTGCAAACTGACTTGAGTCACTCTGGCCAGTACTCTTGCTCAGCTTCCAACCCACTTGGAACAGCATCTTCTAGTGCTAGACTCACAGCAAGAG
>TTN-213,ENSE00003804884,1,288,2550106,2550393,AACCCAAGAAATCTCCCTTCTTTGACATCAAGCCTGTATCTATAGATGTTATTGCTGGAGAAAGTGCTGATTTTGAGTGTCATGTTACTGGTGCTCAACCGATGCGAATCACTTGGTCAAAAGATAACAAGGAGATCCGTCCTGGAGGAAACTATACAATCACATGTGTGGGAAACACTCCTCATTTGAGAATTCTTAAAGTAGGCAAAGGAGACTCTGGTCAATATACTTGCCAAGCAACCAATGATGTTGGCAAAGACATGTGCTCAGCTCAGCTCAGTGTAAAAG
>TTN-213,ENSE00003805805,1,282,2550394,2550675,AACCTCCAAAGTTTGTTAAGAAATTAGAAGCTTCAAAAGTTGCAAAGCAGGGAGAATCCATTCAACTGGAATGTAAAATAAGTGGCTCCCCAGAAATCAAAGTTTCATGGTTCCGAAATGACAGCGAACTTCATGAAAGTTGGAAATACAACATGTCATTCATTAATTCTGTGGCATTGCTTACGATCAATGAAGCTAGTGCTGAAGACAGCGGGGACTACATTTGTGAGGCTCATAATGGTGTTGGTGACGCCAGCTGCAGCACAGCGTTGACAGTGAAAG
>TTN-213,ENSE00003803146,1,279,2550676,2550954,CACCTCCTGTTTTCACCCAGAAGCCTTCTCCAGTAGGAGCTCTTAAAGGTTCTGATGTGATTCTCCAATGTGAAATTTCGGGAACTCCCCCATTTGAAGTAGTATGGGTTAAAGATCGAAAGCAGGTTAGAAACAGCAAGAAATTTAAAATCACTTCAAAACATTTTGATACAAGTCTTCATATCCTTAATCTTGAAGCCTCCGATGTCGGGGAATATCACTGCAAAGCTACTAATGAGGTGGGAAGTGACACGTGTTCTTGCTCTGTCAAGTTCAAAG
>TTN-213,ENSE00003806016,1,282,2550955,2551236,AACCTCCACGATTCGTGAAAAAGCTAAGTGACACCTCAACCCTTATTGGGGATGCTGTTGAGTTACGGGCCATAGTGGAGGGCTTCCAGCCAATTTCTGTTGTCTGGCTGAAAGATAGAGGTGAAGTCATCAGAGAGAGTGAAAATACCAGGATTTCATTCATTGATAACATTGCAACCCTCCAGCTGGGGAGTCCAGAAGCATCTAATTCTGGAAAATATATATGCCAAATCAAAAACGATGCTGGAATGAGAGAATGCTCTGCAGTCTTGACTGTACTAG
>TTN-213,ENSE00003808302,1,279,2551237,2551515,AACCAGCAAGAATCATAGAGAAGCCCGAACCCATGACTGTCACTACTGGAAATCCTTTTGCATTAGAGTGTGTAGTGACTGGAACACCAGAACTCTCAGCCAAGTGGTTCAAAGATGGAAGAGAATTGTCTGCAGACAGCAAACATCACATTACATTCATCAATAAAGTGGCTTCCCTTAAAATCCCCTGTGCCGAAATGAGTGACAAAGGATTATATAGCTTTGAAGTGAAAAACAGTGTTGGCAAAAGTAACTGCACTGTATCCGTCCATGTTTCTG
>TTN-213,ENSE00003802442,1,288,2551516,2551803,ATCGGATTGTGCCTCCTTCCTTCATCCGCAAGCTGAAAGACGTGAATGCCATCCTGGGGGCCTCAGTTGTTTTGGAGTGCCGAGTCTCTGGCTCAGCCCCGATTTCAGTTGGCTGGTTTCAGGATGGAAATGAGATTGTTAGTGGGCCCAAATGTCAGTCCAGCTTTTCGGAAAACGTCTGTACTTTGAATCTGAGCTTGTTGGAGCCCTCCGACACAGGCATATACACGTGTGTGGCTGCCAATGTAGCTGGTTCCGATGAGTGCTCAGCAGTCCTGACTGTGCAAG
>TTN-213,ENSE00003809965,1,279,2551804,2552082,AACCACCATCTTTTGAACAAACCCCTGATTCTGTGGAAGTTTTGCCTGGAATGAGCCTCACATTCACCAGTGTCATCAGAGGCACCCCTCCTTTCAAGGTCAAGTGGTTTAAAGGCAGCAGGGAACTGGTGCCTGGGGAGTCATGCAACATCTCTCTGGAAGATTTTGTCACAGAACTGGAGTTGTTTGAGGTGCAGCCATTAGAAAGTGGAGACTATTCTTGCCTCGTTACAAATGATGCTGGCAGTGCTTCCTGTACCACACATCTTTTTGTGAAAG
>TTN-213,ENSE00003809650,1,279,2552083,2552361,AACCAGCCACCTTTGTGAAAAGATTGGCTGATTTCAGTGTTGAGACAGGAAGCCCCATAGTTCTCGAGGCCACATACACTGGCACACCTCCAATCTCAGTGAGCTGGATAAAGGACGAGTATCTTATTTCACAATCTGAGAGATGCAGTATTACTATGACAGAAAAATCTACCATACTGGAAATTCTTGAGAGCACAATAGAGGATTATGCACAGTACAGCTGCCTGATAGAAAATGAGGCTGGTCAAGATATCTGTGAAGCTCTGGTGTCTGTCTTAG
>TTN-213,ENSE00003810498,1,279,2552362,2552640,AACCACCGTACTTTATTGAACCTCTGGAACATGTGGAAGCAGTCATTGGAGAACCTGCAACTTTACAGTGTAAAGTGGATGGAACTCCAGAAATTAGAATTTCTTGGTATAAAGAACACACAAAGCTACGATCAGCTCCTGCATATAAAATGCAATTCAAAAATAACGTTGCTTCCTTAGTAATCAACAAAGTGGATCACAGTGATGTGGGAGAGTATTCATGCAAGGCAGACAACAGTGTGGGGGCAGTCGCTTCTTCAGCTGTGCTTGTTATCAAAG
>TTN-213,ENSE00003807178,1,288,2552641,2552928,CGCGCAAACTTCCACCTTTCTTTGCAAGAAAACTGAAAGACGTTCATGAGACTCTAGGCTTCCCAGTTGCATTTGAATGCCGCATCAATGGCTCAGAACCTCTTCAAGTGTCTTGGTACAAGGATGGGGTTCTTTTGAAAGATGATGCTAATTTGCAGACATCTTTTGTTCATAATGTAGCAACTCTTCAGATTTTACAAACTGACCAGAGCCACATAGGGCAGTATAATTGCTCTGCTTCTAATCCTCTTGGGACTGCTTCATCCAGTGCCAAGCTCATTCTCTCAG
>TTN-213,ENSE00003808579,1,288,2552929,2553216,AGCATGAAGTGCCTCCTTTCTTTGATCTAAAGCCTGTATCAGTAGATCTTGCTCTTGGAGAAAGTGGTACTTTTAAATGTCATGTAACTGGGACTGCACCAATCAAAATCACTTGGGCCAAAGATAACCGAGAGATTCGCCCTGGAGGCAACTACAAGATGACTTTGGTAGAAAATACTGCCACTCTGACAGTTCTCAAAGTAGGCAAAGGCGATGCCGGGCAGTACACCTGCTATGCAAGCAACATCGCTGGAAAAGACTCTTGTTCTGCTCAGCTGGGTGTACAAG
>TTN-213,ENSE00003801249,1,282,2553217,2553498,AACCACCCAGGTTCATTAAGAAGCTAGAACCTTCAAGAATTGTGAAACAGGATGAATTCACAAGGTATGAATGCAAAATCGGTGGGTCTCCAGAAATCAAAGTTTTATGGTATAAGGACGAGACTGAAATTCAAGAGAGCAGTAAATTCAGAATGTCATTCGTTGACTCGGTGGCTGTGCTGGAAATGCACAATCTCAGTGTTGAAGACAGTGGAGACTACACCTGTGAGGCCCACAATGCAGCAGGCAGTGCCAGCAGCAGCACATCCTTAAAAGTTAAAG
>TTN-213,ENSE00003810208,1,279,2553499,2553777,AACCACCCATTTTCCGCAAAAAGCCTCATCCTATAGAGACACTGAAAGGAGCTGATGTTCACCTTGAATGTGAGCTTCAGGGCACTCCCCCATTTCACGTTTCTTGGTATAAAGACAAGAGAGAACTTAGGAGCGGCAAGAAGTACAAGATAATGTCTGAGAACTTCCTAACCAGTATCCACATCCTGAATGTCGATGCTGCAGACATTGGGGAATATCAGTGTAAAGCCACAAATGATGTGGGAAGCGACACTTGCGTTGGTTCCATCGCTCTCAAAG
>TTN-213,ENSE00003802440,1,282,2553778,2554059,CACCACCAAGATTTGTGAAGAAGCTCAGTGACATATCTACTGTCGTTGGTAAAGAAGTTCAGCTGCAGACTACCATTGAAGGCGCTGAACCCATTTCAGTGGTGTGGTTCAAAGATAAGGGAGAAATCGTTAGAGAAAGTGACAACATATGGATTTCTTATTCAGAAAACATTGCAACCTTACAGTTTTCAAGAGTGGAACCAGCCAATGCTGGAAAATACACTTGTCAGATCAAAAACGATGCTGGGATGCAAGAGTGCTTCGCCACGCTATCCGTTCTCG
>TTN-213,ENSE00003802351,1,279,2554060,2554338,AGCCTGCAACAATTGTAGAAAAGCCAGAATCCATAAAAGTTACCACGGGAGACACCTGTACCTTGGAGTGTACAGTAGCTGGCACCCCTGAACTCAGTACTAAGTGGTTTAAGGATGGAAAAGAGCTAACAAGTGACAACAAATACAAAATAAGCTTCTTCAACAAAGTATCCGGCCTTAAGATCATCAATGTAGCACCGAGTGACAGTGGGGTATACAGTTTTGAGGTGCAGAACCCTGTTGGCAAAGACAGCTGCACAGCTTCATTGCAGGTTTCAG
>TTN-213,ENSE00003807933,1,288,2554339,2554626,ACCGAACCGTTCCTCCTTCATTCACAAGAAAATTGAAAGAGACAAATGGTCTATCCGGCTCCTCAGTTGTAATGGAGTGTAAAGTCTATGGGTCACCTCCAATCTCTGTCTCCTGGTTCCATGAAGGAAATGAGATCAGTAGTGGAAGGAAATACCAGACCACCCTGACAGATAATACTTGTGCTTTAACTGTGAACATGCTGGAAGAATCAGACAGTGGTGACTACACATGTATAGCTACTAATATGGCTGGTTCTGATGAATGTAGTGCTCCTTTGACTGTGAGAG
>TTN-213,ENSE00003804939,1,279,2554627,2554905,AACCACCATCTTTTGTTCAGAAACCTGATCCCATGGATGTTTTAACTGGGACCAATGTAACTTTCACAAGTATCGTAAAAGGAACACCTCCTTTCAGTGTTAGCTGGTTCAAAGGTAGCAGTGAACTAGTACCAGGTGACAGATGCAACGTGTCTTTGGAGGATTCAGTTGCTGAACTGGAGTTGTTCGATGTAGATACATCACAAAGTGGAGAATATACTTGCATAGTTAGCAATGAAGCTGGCAAGGCTTCTTGTACAACACATCTCTACATAAAAG
>TTN-213,ENSE00003810094,1,279,2554906,2555184,CCCCAGCCAAATTTGTGAAGAGGCTGAATGATTACAGCATAGAGAAAGGAAAACCCCTGATCCTAGAGGGTACATTCACTGGAACTCCTCCCATTTCGGTTACCTGGAAGAAAAATGGCATAAATGTAACTCCTTCTCAGAGGTGTAATATAACTACGACTGAAAAATCGGCAATCCTGGAAATTCCAAGTAGCACAGTAGAGGATGCAGGACAATACAACTGCTACATTGAAAATGCCTCTGGAAAAGATTCCTGTTCAGCACAAATACTCATACTAG
>TTN-213,ENSE00003811103,1,279,2555185,2555463,AACCACCGTATTTTGTCAAGCAGTTGGAGCCGGTTAAGGTGTCTGTTGGAGATTCTGCCTCTCTACAATGCCAGCTTGCTGGAACCCCTGAAATTGGGGTATCCTGGTATAAAGGAGATACAAAATTGAGACCCACTACGACTTACAAAATGCATTTTAGGAATAATGTTGCTACACTGGTTTTCAACCAGGTTGATATTAATGATAGTGGAGAATATATCTGCAAAGCTGAAAACAGCGTGGGAGAAGTTTCTGCATCAACTTTCCTTACCGTTCAAG
>TTN-213,ENSE00003801476,1,288,2555464,2555751,AGCAAAAACTTCCACCATCATTTTCTCGACAATTGAGAGATGTTCAAGAAACAGTTGGACTGCCAGTTGTTTTTGATTGTGCCATAAGTGGATCAGAACCTATCTCCGTGTCTTGGTATAAAGACGGCAAGCCATTGAAAGACAGCCCAAATGTACAAACATCATTTTTAGACAATACAGCCACACTCAATATTTTTAAAACTGACCGGAGCCTTGCAGGCCAGTATTCCTGCACAGCTACAAACCCTATAGGCTCTGCTTCTTCCAGTGCCAGGCTCATTCTCACAG
>TTN-213,ENSE00003808430,1,288,2555752,2556039,AGGGGAAGAACCCACCCTTCTTTGACATCCGTCTTGCCCCTGTGGATGCTGTGGTGGGAGAAAGTGCTGACTTTGAGTGCCACGTCACGGGCACACAACCGATAAAGGTCAGCTGGGCCAAAGACAGCAGAGAAATACGAAGTGGCGGAAAGTACCAGATTAGTTATCTGGAAAACAGCGCCCACCTGACAGTCCTCAAAGTAGACAAAGGAGATTCTGGACAATATACCTGCTATGCTGTGAATGAAGTGGGAAAAGACTCTTGCACAGCTCAGCTGAATATAAAAG
>TTN-213,ENSE00003809007,1,291,2556040,2556330,AGCGGCTCATCCCACCAAGTTTCACTAAAAGACTCTCAGAGACAGTAGAAGAAACAGAAGGGAATTCTTTCAAACTTGAGGGACGTGTGGCTGGTTCCCAACCTATAACTGTTGCCTGGTACAAAAATAATATAGAGATACAACCAACTTCTAACTGTGAAATAACATTCAAGAACAACACGTTAGTGCTGCAAGTCAGGAAAGCAGGCATGAACGACGCTGGTTTGTACACATGCAAAGTGTCCAATGATGCAGGCTCTGCTCTGTGCACGTCTTCAATCGTCATCAAAG
>TTN-213,ENSE00003803910,1,288,2556331,2556618,AACCTAAGAAGCCACCTGTATTTGATCAGCACCTTACTCCAGTAACAGTGAGTGAAGGAGAATACGTGCAGCTCAGCTGCCATGTCCAGGGATCTGAGCCAATTAGGATCCAGTGGTTGAAGGCTGGCAGGGAAATAAAGCCTTCAGACAGATGCAGCTTCAGCTTTGCTAGTGGGACAGCTGTACTGGAACTCAGAGATGTGGCTAAAGCAGATTCGGGAGATTATGTGTGTAAAGCTTCAAATGTGGCTGGAAGTGACACTACCAAATCAAAAGTGACCATTAAAG
>TTN-213,ENSE00003804245,1,93,2556619,2556711,ACAAACCAGCTGTGGCCCCAGCAACCAAGAAAGCTGCGGTAGATGGAAGACTCTTTTTTGTGTCAGAACCTCAGAGTATCAGAGTCGTAGAAA
>TTN-213,ENSE00003801649,1,286,2556712,2556997,AAACCACTGCGACCTTCATTGCAAAAGTTGGAGGTGACCCAATCCCAAATGTTAAATGGACAAAAGGGAAGTGGAGACAGCTGAACCAAGGAGGTCGTGTTTTCATCCACCAAAAAGGCGATGAAGCAAAACTGGAGATTAGGGACACCACAAAAACTGATTCTGGGTTATACCGATGCGTGGCATTTAACGAACATGGTGAAATTGAAAGTAATGTTAACTTACAGGTGGATGAAAGGAAGAAACAAGAGAAAATTGAAGGCGATCTTAGAGCAATGCTGAAAAA
>TTN-213,ENSE00003805371,1,184,2556998,2557181,GACTCCAATCTTAAAGAAAGGAGCTGGAGAAGAAGAGGAAATTGATATCATGGAACTTCTCAAAAATGTTGATCCTAAAGAATATGAAAAATATGCCCGCATGTATGGAATCACTGACTTCCGAGGTCTTCTTCAAGCATTTGAACTGCTCAAGCAAAGCCAAGAAGAAGAGACACATAGACTG
>TTN-213,ENSE00003802112,1,90,2557182,2557271,GAAATTGAGGAAATAGAGAGGTCAGAGAGGGACGAAAAGGAATTTGAGGAACTTGTATCATTTATTCAGCAAAGACTGTCACAGACAGAG
>TTN-213,ENSE00003810323,1,268,2557272,2557539,CCTGTCACTCTGATCAAGGACATTGAAAATCAGACAGTTTTGAAAGATAATGATGCTGTCTTTGAAATTGACATTAAAATTAATTATCCAGAAATCAAGCTTTCGTGGTACAAAGGAACTGAAAAACTGGAACCCAGTGATAAATTTGAAATAAGCATTGATGGTGACCGACATACACTCAGAGTCAAAAACTGTCAACTTAAAGACCAGGGCAATTATCGATTGGTTTGTGGTCCACACATCGCTAGCGCTAAACTAACTGTAATTG
>TTN-213,ENSE00003810781,1,261,2557540,2557800,AGCCTGCATGGGAACGGCATCTTCAGGATGTGACTCTGAAAGAAGGCCAGACTTGCACCATGACATGCCAATTTTCTGTACCAAATGTAAAATCTGAATGGTTCAGAAATGGCAGAATCCTTAAACCCCAAGGTAGACATAAAACAGAAGTGGAACACAAAGTCCATAAATTGACCATTGCAGATGTTCGAGCAGAAGACCAGGGTCAGTACACCTGCAAATATGAAGACCTTGAAACTTCAGCAGAACTCAGAATCGAAG
>TTN-213,ENSE00003805599,1,210,2557801,2558010,CTGAACCAATTCAGTTTACAAAGCGCATACAGAACATCGTGGTGAGTGAGCATCAGTCTGCCACCTTTGAGTGTGAAGTGTCCTTTGATGATGCCATTGTAACATGGTACAAAGGACCAACAGAACTGACAGAGAGCCAGAAATACAACTTCAGGAATGATGGCCGCTGCCATTATATGACCATCCACAATGTGACCCCAGACGATGAAG
>TTN-213,ENSE00003809461,1,78,2558011,2558088,GTGTCTACTCGGTCATCGCTCGGCTGGAGCCAAGAGGTGAAGCAAGAAGCACGGCAGAGCTGTACCTAACGACGAAAG
>TTN-213,ENSE00003805821,1,27,2558089,2558115,AAATCAAACTTGAGCTGAAGCCTCCTG
>TTN-213,ENSE00003803485,1,60,2558116,2558175,ATATTCCTGACTCCAGAGTTCCAATCCCAACCATGCCTATCAGAGCAGTGCCACCAGAAG
>TTN-213,ENSE00003803812,1,84,2558176,2558259,AAATCCCTCCTGTGGTTGCTCCTCCTATCCCCCTTTTGCTACCAACACCCGAAGAAAAGAAACCACCACCAAAACGTATTGAAG
>TTN-213,ENSE00003804844,1,72,2558260,2558331,TTACCAAAAAGGCTGTGAAGAAAGATGCCAAAAAAGTTGTTGCAAAGCCCAAAGAGATGACACCACGTGAAG
>TTN-213,ENSE00003810688,1,48,2558332,2558379,AGATTGTCAAGAAGCCTCCACCTCCTACTACCTTAATTCCAGCAAAAG
>TTN-213,ENSE00003806388,1,405,2558380,2558784,CTCCTGAAATCATTGATGTATCCTCTAAAGCTGAAGAAGTAAAAATAATGACTATAACCAGAAAGAAAGAGGTTCAGAAAGAAAAAGAAGCTGTGTATGAGAAAAAGCAAGCAGTCCACAAGGAGAAGAGAGTCTTCATTGAATCTTTCGAAGAACCTTATGACGAACTGGAGGTAGAACCATACACAGAGCCATTTGAACAACCTTATTATGAAGAACCAGATGAAGACTATGAAGAGATTAAGGTAGAAGCTAAAAAAGAAGTTCACGAGGAATGGGAAGAAGATTTTGAAGAAGGGCAAGAATACTATGAAAGGGAAGAAGGCTATGACGAAGGGGAGGAAGAGTGGGAAGAGGCTTACCAAGAAAGGGAAGTAATTCAAGTTCAAAAGGAGGTCTATGAAG
>TTN-213,ENSE00003803093,1,63,2558785,2558847,AATCACATGAGAGAAAAGTTCCAGCCAAAGTACCTGAAAAGAAAGCACCACCACCTCCTAAAG
>TTN-213,ENSE00003802009,1,78,2558848,2558925,TTATAAAGAAGCCAGTAATTGAAAAAATTGAAAAGACTTCTCGAAGAATGGAGGAAGAAAAAGTTCAAGTCACCAAAG
>TTN-213,ENSE00003806356,1,78,2558926,2559003,TACCTGAAGTTTCAAAGAAGATTGTTCCACAAAAACCTTCCCGGACTCCAGTACAGGAAGAAGTTATTGAAGTGAAAG
>TTN-213,ENSE00003803112,1,87,2559004,2559090,TACCAGCTGTGCATACAAAGAAGATGGTTATTTCAGAAGAAAAGATGTTCTTTGCTTCTCACACAGAGGAGGAGGTGTCAGTCACAG
>TTN-213,ENSE00003811115,1,81,2559091,2559171,TCCCCGAGGTACAAAAGGAAATTGTTACTGAAGAGAAAATTCACGTTGCCATTTCCAAAAGGGTTGAACCACCACCTAAAG
>TTN-213,ENSE00003810048,1,84,2559172,2559255,TCCCTGAGCTACCTGAGAAACCAGCTCCAGAAGAAGTGGCCCCTGTTCCTATCCCTAAAAAAGTGGAGCCCCCAGCACCAAAAG
>TTN-213,ENSE00003809302,1,84,2559256,2559339,TTCCTGAGGTTCCCAAGAAACCCGTGCCAGAGGAGAAAAAGCCAGTTCCTGTGCCTAAGAAGGAACCTGCTGCTCCCCCAAAAG
>TTN-213,ENSE00003811271,1,84,2559340,2559423,TCCCAGAGGTGCCAAAGAAACCTGTCCCTGAAGAAAAGATTCCCGTTCCTGTTGCAAAGAAAAAGGAAGCTCCCCCAGCTAAAG
>TTN-213,ENSE00003811169,1,81,2559424,2559504,TTCCTGAAGTACAGAAGGGAGTTGTGACAGAAGAAAAAATAACCATTGTAACTCAAAGAGAGGAATCTCCACCACCAGCAG
>TTN-213,ENSE00003802187,1,84,2559505,2559588,TGCCAGAAATACCAAAGAAGAAAGTTCCTGAAGAAAGGAAACCTGTTCCTCGGAAGGAGGAAGAAGTTCCACCACCACCAAAAG
>TTN-213,ENSE00003810484,1,84,2559589,2559672,TGCCAGCTCTGCCTAAGAAACCCGTCCCAGAGGAGAAAGTTGCAGTGCCAGTTCCTGTCGCTAAGAAAGCTCCTCCTCCCCGAG
>TTN-213,ENSE00003810121,1,102,2559673,2559774,CTGAAGTCTCTAAGAAAACTGTTGTAGAAGAAAAGAGATTTGTTGCTGAAGAAAAACTATCCTTCGCAGTTCCTCAAAGAGTGGAAGTCACGCGGCACGAAG
>TTN-213,ENSE00003805410,1,114,2559775,2559888,TATCTGCAGAGGAGGAATGGAGTTACTCAGAAGAGGAGGAAGGTGTGTCCATTTCAGTTTATAGAGAAGAAGAAAGAGAGGAGGAGGAAGAAGCAGAGGTTACAGAATATGAAG
>TTN-213,ENSE00003801264,1,81,2559889,2559969,TGATGGAAGAGCCTGAGGAATATGTTGTGGAAGAAAAGCTGCACATTATTTCTAAGAGAGTGGAAGCTGAGCCAGCTGAAG
>TTN-213,ENSE00003805756,1,78,2559970,2560047,TGACAGAGAGGCAGGAGAAGAAAATTGTACTGAAACCAAAAATTCCTGCTAAAATAGAGGAGCCTCCACCGGCTAAAG
>TTN-213,ENSE00003808334,1,84,2560048,2560131,TTCCTGAAGCACCTAAGAAAATTGTGCCAGAAAAGAAAGTTCCTGCTCCAGTTCCTAAAAAGGAAAAGGTGCCCCCACCTAAAG
>TTN-213,ENSE00003808052,1,84,2560132,2560215,TGCCAGAAGAGCCAAAGAAACCAGTTCCAGAAAAAAAGGTTCCTCCAAAAGTCATTAAGATGGAAGAACCTCTCCCAGCCAAAG
>TTN-213,ENSE00003803067,1,84,2560216,2560299,TGACTGAGAGGCACATGCAAATTACCCAGGAAGAAAAAGTTCTTGTTGCTGTAACTAAAAAAGAGGCGCCTCCAAAAGCAAGAG
>TTN-213,ENSE00003808806,1,84,2560300,2560383,TGCCAGAGGAACCGAAGAGAGCTGTCCCAGAAGAAAAAGTTCTGAAACTCAAACCTAAAAGAGAGGAGGAACCACCAGCTAAAG
>TTN-213,ENSE00003805330,1,81,2560384,2560464,TGACTGAATTCAGAAAAAGAGTGGTTAAAGAAGAAAAAGTATCAATTGAAGCTCCAAAAAGAGAACCTCAACCCATCAAAG
>TTN-213,ENSE00003807878,1,207,2560465,2560671,AAGTAACTATAATGGAAGAGAAAGAAAGGGCTTATACCCTAGAAGAAGAAGCTGTTTCAGTACAACGGGAAGAAGAATATGAGGAATATGAAGAATATGATTATAAAGAATTTGAGGAGTATGAACCAACAGAAGAATATGACCAATATGAAGAATACGAGGAGCGGGAGTATGAACGATATGAAGAGCATGAAGAATACATCACAG
>TTN-213,ENSE00003806244,1,78,2560672,2560749,AACCAGAGAAGCCTATCCCTGTAAAGCCTGTCCCAGAAGAACCAGTTCCCACAAAACCAAAGGCCCCACCGGCTAAAG
>TTN-213,ENSE00003810594,1,75,2560750,2560824,TGCTGAAGAAAGCTGTCCCTGAAGAAAAAGTACCAGTGCCCATTCCTAAGAAACTCAAACCTCCACCACCCAAAG
>TTN-213,ENSE00003809388,1,93,2560825,2560917,TGCCTGAAGAACCAAAGAAAGTTTTTGAGGAAAAAATACGTATTTCAATTACCAAACGTGAAAAAGAGCAGGTGACTGAACCCGCTGCTAAAG
>TTN-213,ENSE00003807405,1,78,2560918,2560995,TGCCCATGAAGCCCAAGAGGGTTGTCGCAGAAGAAAAAGTACCTGTCCCTAGAAAAGAAGTAGCACCACCTGTTAGAG
>TTN-213,ENSE00003810081,1,162,2560996,2561157,TGCCAGAAGTGCCTAAAGAACTTGAACCAGAAGAGGTTGCCTTTGAAGAGGAAGTTGTAACCCATGTAGAAGAATATCTTGTAGAAGAAGAAGAAGAGTACATTCATGAAGAAGAGGAGTTCATAACTGAGGAAGAAGTGGTGCCAGTGATACCAGTCAAAG
>TTN-213,ENSE00003806496,1,84,2561158,2561241,TGCCTGAGGTACCCAGGAAACCTGTTCCAGAAGAGAAGAAACCTGTTCCTGTTCCCAAGAAGAAGGAAGCTCCACCGGCAAAAG
>TTN-213,ENSE00003802498,1,78,2561242,2561319,TGCCTGAGGTTCCTAAGAAGCCAGAGGAGAAAGTTCCTGTGCTTATTCCTAAAAAGGAGAAGCCTCCGCCAGCAAAAG
>TTN-213,ENSE00003809653,1,84,2561320,2561403,TTCCTGAAGTGCCCAAGAAACCTGTGCCAGAGGAGAAAGTACCAGTACCAGTTCCTAAAAAGGTGGAAGCTCCACCTGCCAAAG
>TTN-213,ENSE00003810862,1,84,2561404,2561487,TGCCAGAGGTACCCAAGAAGCCTGTGCCTGAGAAGAAGGTGCCAGTTCCTGCTCCTAAGAAAGTGGAGGCTCCACCTGCAAAAG
>TTN-213,ENSE00003805059,1,84,2561488,2561571,TGCCAGAGGTGCCCAAGAAGCTCATCCCAGAAGAAAAGAAACCAACACCTGTTCCGAAAAAAGTGGAAGCACCACCACCCAAAG
>TTN-213,ENSE00003801382,1,297,2561572,2561868,TGCCAAAGAAACGTGAACCAGTTCCAGTTCCTGTAGCTCTACCTCAGGAAGAGGAAGTTCTATTTGAAGAAGAAATTGTTCCTGAAGAGGAAGTTCTACCTGAGGAAGAGGAAGTTCTACCTGAGGAAGAGGAAGTTCTACCTGAAGAAGAGGAAGTTCTACCTGAAGAAGAGGAAATTCCACCTGAGGAAGAGGAAGTTCCTCCCGAAGAAGAATATGTACCTGAGGAAGAAGAATTTGTACCTGAAGAAGAAGTCCTTCCAGAAGTTAAACCTAAGGTGCCAGTACCTGCACCAG
>TTN-213,ENSE00004025982,1,87,2561869,2561955,TGCCTGAAGTGCCAAAGAAACCTGTACCAGAGAAGAAAGTCCCTGTTCCCGCCCCTAAAAAAGTGGAACCTCCACCACCACCCAAAG
>TTN-213,ENSE00003805240,1,75,2561956,2562030,TGCCTGAAATTAAGAAGAAAGTGACAGAGAAGAAAGTGGTCATTCCCAAGAAAGAGGAGGCTCCCCCTGCCAAAG
>TTN-213,ENSE00004025997,1,84,2562031,2562114,TGTCTGTGGTACCTAAGAAACCTGAGCCAGAAAAGAAGGTCCCTCCTCCTGGTCTTAAGAAAGCAGTGGCCCCTCCTGCCAAAG
>TTN-213,ENSE00003804875,1,75,2562115,2562189,TTCCTGAGGTGCCTAAGAAGGTGGAAGAAAAACGAATCATTCTCCCTAAAGAAGAGGAAGTTCTACCAGTTGAAG
>TTN-213,ENSE00003801552,1,96,2562190,2562285,TGACTGAGGAGCCTGAAGAAGAGCCTATTTCAGAAGAAGAAATCCCAGAAGAACCACCTAGCATAGAGGAAGTTGAAGAGGTGGCACCACCTAGAG
>TTN-213,ENSE00003804385,1,78,2562286,2562363,TGCCTGAAGTGATTAAGAAAGCAGTACCTGAAGCACCTACTCCTGTTCCTAAAAAAGTGGAGGCACCACCAGCTAAAG
>TTN-213,ENSE00003805135,1,69,2562364,2562432,TGTCAAAGAAAATTCCTGAGGAAAAAGTACCTGTTCCTGTTCAGAAAAAAGAGGCACCCCCAGCCAAAG
>TTN-213,ENSE00003808243,1,75,2562433,2562507,TGCCTGAAGTACCAAAGAAAGTCCCAGAAAAGAAAGTCCTTGTGCCTAAAAAGGAAGCTGTTCCCCCAGCTAAAG
>TTN-213,ENSE00003808353,1,297,2562508,2562804,GGAGAACTGTCCTTGAAGAAAAAGTATCAGTTGCCTTCCGCCAAGAAGTAGTAGTAAAAGAAAGACTAGAATTAGAAGTAGTAGAAGCAGAAGTGGAAGAAATTCCGGAAGAAGAAGAGTTCCATGAAGTTGAAGAATATTTTGAAGAAGGCGAGTTTCATGAAGTAGAAGAATTCATCAAATTAGAACAACATAGAGTTGAAGAAGAACACAGAGTTGAAAAAGTTCATAGGGTAATAGAAGTTTTTGAGGCTGAAGAAGTGGAAGTATTTGAAAAACCAAAAGCTCCACCTAAAG
>TTN-213,ENSE00003807571,1,81,2562805,2562885,GGCCTGAGATATCTGAGAAAATCATCCCTCCAAAAAAACCGCCCACTAAAGTTGTTCCTCGAAAAGAGCCACCAGCTAAAG
>TTN-213,ENSE00003808118,1,78,2562886,2562963,TACCGGAGGTGCCTAAGAAAATTGTGGTAGAAGAAAAAGTACGTGTTCCTGAAGAGCCCAGAGTTCCACCAACTAAAG
>TTN-213,ENSE00004025978,1,84,2562964,2563047,CACCCGAAGTACCCAAGAAAATTGTCCCAGAAGAAAAAGTTCGTGAAGCTGTTCTGAAAAAGCCTGAAGTTCCACCAGCTAAAG
>TTN-213,ENSE00004026002,1,75,2563048,2563122,TTCCTGGGATGCCTAAGAAAAGTGTTCAAGAAGAAAAATCACCTATTGTTATTTCTGAAGACACAGAGATGTACA
>TTN-213,ENSE00004025998,1,84,2563123,2563206,TTTATGAAGCATCTGAAGAAGCAGTCCTAGAAGAAAAAGTACTTGTGACTCAACCTCAAAAGACAAAACCCAAACTAGCAAAAG
>TTN-213,ENSE00004025971,1,84,2563207,2563290,TGCCTGAGCCACCCAAGAAAGTTGTTCCAGAAGACAAAATATATGTGACTATTCCTAAAAAGAGAGAAACACCAGCAACTAAAG
>TTN-213,ENSE00001725280,1,84,2563291,2563374,AACCTGATACAACCAGAGGCATTTTTCCAGAGGTGGAGCCACCTGAGGCTATTCCTGAAATTCCAGAACATCCTCCAACTGAAG
>TTN-213,ENSE00004024308,1,78,2563375,2563452,AGTTTGAAGTCTTCAAGGAAGTCATTCCAGAGGGAGAAACTCCTATTGTTAAAAGAAGAAAAACACCATCACCAACAG
>TTN-213,ENSE00004025995,1,84,2563453,2563536,TGCCTGAATCACCTCGAGAAATTGTCCCTGTAAAGGAAACACCCATGGCTGCTCCCCTTGAAATTGAAATACCTCCCACTAAAG
>TTN-213,ENSE00004024272,1,84,2563537,2563620,CACCAGAAGCTATGAAAGAAGTTGTCCCTGAAATGAAAATATTTGAGGATGTACCTGAAGAGCCAGAAACTCCACGTATGAAAA
>TTN-213,ENSE00004024280,1,75,2563621,2563695,CGCCCGAAGCTCCTCAAGAAATTATTCCTGCCAAGACAGTTCCTTCCAAAAAAAGAGAACCCCCATCAGTTAAAG
>TTN-213,ENSE00004024279,1,84,2563696,2563779,TGCCTGAAGCTCTCCAAGAAATTGTCCCTGAAAAGAAAACGCTTGTGGTTCCTCTCAGAAAGCCTGAAGTCCTTCCTGATGAAG
>TTN-213,ENSE00004024286,1,78,2563780,2563857,TGCCGGAGGCTCTCAGAGAAGTTGTCCCGGAAAAGAAAGTGCATCCTCCCCAAAGGGCTGAAGTTGTACCTGTCAAAG
>TTN-213,ENSE00004024310,1,84,2563858,2563941,TGCACGAAGCTCCCAAAGAGATTATCCCTGAAAAGAAAGTGTCGGTGGTGCCTCCTAAAAAGCCTGAAGTCCCACCTGTTAAAG
>TTN-213,ENSE00004024305,1,84,2563942,2564025,TGCCAGAAGCTTCCAAAGAGGTTATCCGCGAAGAGAAAGTGCCCTTGGCTCCTCCTAAAGAGCCTGAAGTCCCACCTGTTAAAG
>TTN-213,ENSE00004024294,1,84,2564026,2564109,TACCAGAGCCTCCCAAAGAAGTAGTTCCTGAAAAGAAAGCGCCAGTGGCTCCTCCTAAAGAGCCTGAAGTCCCACCTGTTAAAG
>TTN-213,ENSE00004025974,1,84,2564110,2564193,TGCCTGAGGCTCCCAAAGAAGTTGTTCCTGAAAAGAAAGTGCCAGTGCCTCCTCCTAAAAAGCCTGAAGTGCCACCCACAAAAG
>TTN-213,ENSE00004025967,1,84,2564194,2564277,TCCCAGAGGTGCCAAAGGCAGCTGTCCCAGAAAAGAAGTTGCCTGAAGCTATTCCTCCCAAACCGGAAAGTCCTCCCCCTGAAG
>TTN-213,ENSE00003807304,1,90,2564278,2564367,TGCCTGAAGTGCTGCCACCGAAGGAAGTGGTCCCAGAAAAGAAAGTACCGGTGCCTCCTGCCAAAAAGCCAGAAGCTCCACCTCCTAAAG
>TTN-213,ENSE00004026001,1,84,2564368,2564451,TTCCTGAAGCTCCTAAAGAAGTTGTACTTGAAAAGAAAGCATCTGTGGCTGTGCCCAAAAAACCGGAAGCCCCACGTGCAAAAG
>TTN-213,ENSE00004025988,1,84,2564452,2564535,TGCCTGAAGCTGCTCAAGAAGTTGTCCCAGAAAAGAAAATTCCCAAGGCACCAATCAAAAAACCAGAAGCCCCCGCAGTTACAG
>TTN-213,ENSE00004025983,1,81,2564536,2564616,TGCCAGAAGTTCCTCAAGAAGCCACAGAAAAAGAAATTCCCGTGGCTCCACCCAAAAAACCAGAAGCTCCAATTGTCCCAG
>TTN-213,ENSE00004025976,1,81,2564617,2564697,TGCCTGAAGCTCAAGAAGTTGTCCCAGAAAAGAAAGTTCCTAAGGCTCCTCCCACAAAACCAGAAGCCCCACCTGCCACAG
>TTN-213,ENSE00004025986,1,81,2564698,2564778,TGCCTGAAGTCCCACAAGAAATTGTGCCAGAAAAGAAAACACTGGTGCTTCCTAAAAAGCCAGAAGTTCCACCTGTTACAG
>TTN-213,ENSE00004025969,1,84,2564779,2564862,TGCCAGAGGCTCCCAAAGAAGTTGTCCTTGAAAAGAAAGTGCCCTCGGCTCCTCCTAAAAAGCCTGAAGTCCCACCTGTTAAAG
>TTN-213,ENSE00003802745,1,84,2564863,2564946,TGCCTGAGGCTCCCAAAGAAGTTGTTCCTGAAAAGAAAGTGCCAGTGCCTCCTCCTAAAAAGCCTGAAGTGCCACCCACAAAAG
>TTN-213,ENSE00003809569,1,84,2564947,2565030,TCCCAGAGGTGCCAAAGGCAGCTGTCCCAGAAAAGAAGGTGCCTGAAGCTATTCCTCCCAAACCGGAAAGTCCTCCCCCTGAAG
>TTN-213,ENSE00004025984,1,90,2565031,2565120,TGCCTGAAGTGCTGCCACCGAAGGAAGTGGTCCCAGAAAAGAAAGTACCGGTGCCTCCTGCCAAAAAGCCAGAAGCTCCACCTCCTAAAG
>TTN-213,ENSE00004026000,1,84,2565121,2565204,TTCCTGAAGCTCCTAAAGAAGTTGTACTTGAAAAGAAAGCATCTGTGGCTGTGCCCAAAAAACCGGAAGCCCCACGTGCAAAAG
>TTN-213,ENSE00004025966,1,84,2565205,2565288,TGCCTGAAGCTGCTCAAGAAGTTGTCCCAGAAAAGAAAATTCCCAAGGCACCAATCAAAAAACCAGAAGCCCCCGCAGTTACAG
>TTN-213,ENSE00004025973,1,81,2565289,2565369,TGCCAGAAGTTCCTCAAGAAGCCGCAGAAAAAGAAATTCCCGTGGCTCCACCCAAAAAACCAGAAGCTCCGATTGTCCCAG
>TTN-213,ENSE00004025979,1,81,2565370,2565450,TGCCTGAAGCTCAAGAAGTTGTCCCAGAAAAGAAAGTTCCTAAGGCTCCTCCCACAAAACCAGAAGCCCCACCTGCCACAG
>TTN-213,ENSE00004025981,1,81,2565451,2565531,TGCCTGAAGTCCCACAAGAAATTGTGCCAGAAAAGAAAACACTGGTGCTTCCTAAAAAGCCAGAAGTTCCACCTGTTACAG
>TTN-213,ENSE00004025970,1,84,2565532,2565615,TGCCAGAGGCTCCCAAAGAAGTTGTCCTTGAAAAGAAAGTGCCCTCGACTCCTCCTAAAAAGCCTGAAGTCCCACCTGTTAAAG
>TTN-213,ENSE00004025993,1,84,2565616,2565699,TGCCTGAGGCTCCCAAAGAAGTTGTTCCTGAAAAGAAAGTGCCAGTGCCTCCTCCTAAAAAGCCTGAAGTGCCACCCACAAAAG
>TTN-213,ENSE00004025989,1,84,2565700,2565783,TCCCAGAGGTGCCAAAGGCAGCTGTCCCAGAAAAGAAGGTGCCTGAAGCTATTCCTCCCAAACCGGAAAGTCCTCCCCCTGAAG
>TTN-213,ENSE00004025987,1,90,2565784,2565873,TGCCTGAAGTGCTGCCACCGAAGGAAGTGGTCCCAGAAAAGAAAGTACCGGTGCCTCCTGCCAAAAAGCCAGAAGCTCCACCTCCTAAAG
>TTN-213,ENSE00004025975,1,84,2565874,2565957,TTCCTGAAGCTCCTAAAGAAGTTGTACTTGAAAAGAAAGTATCTGTGGCTGTGCCCAAAAAACCGGAAGCCCCACGTGCAAAAG
>TTN-213,ENSE00004026003,1,84,2565958,2566041,TGCCTGAAGCTGCTCAAGAAGTTGTCCCAGAAAAGAAAATTCCCAAGGCACCAATCAAAAAACCAGAAGCCCCCGCAGTTACAG
>TTN-213,ENSE00004025980,1,81,2566042,2566122,TGCCAGAAGTTCCTCAAGAAGCCGCAGAAAAAGAAATTCCCGTGGCTCCACCCAAAAAACCAGAAGCTCCAATTGTCCCAG
>TTN-213,ENSE00004025994,1,81,2566123,2566203,TGCCTGAAGCTCAAGAAGTTGTCCCAGAAAAGAAAGTTCCTAAGGCTCCTCCCACAAAACCAGAAGCCCCACCTGCCACAG
>TTN-213,ENSE00004025996,1,81,2566204,2566284,TGCCTGAAGTCCCACAAGAAATTGTGCCAGAAAAGAAAACACTGGTGCTTCCTAAAAAGCCAGAAGTTCCACCTGTTACAG
>TTN-213,ENSE00004025990,1,84,2566285,2566368,TGCCAGAGGCTCCCAAAGAAGTTGTCCTTGAAAAGAAAGTGCCCTTGGCTCCTCCTAAAAAGCCTGAAGTCCCACCTGTTAAAG
>TTN-213,ENSE00004026004,1,84,2566369,2566452,TGCCAGAGGCTCCCAAAGAAGTTGTTCCTGAAAAGAAAGTGCCAGTGACTCCTCCTAAAAAACCTGAAGTCCCACCTGTTAAAG
>TTN-213,ENSE00004025977,1,84,2566453,2566536,TGCCAGAGGCTCCCATAGAGGTTGTTCCTGAAAAGAAAATGCCCTTGGCTCCTCCTAAAAAGCCTGAAGTCCCTCCTGTTAAAG
>TTN-213,ENSE00004025991,1,84,2566537,2566620,TACCAGAGGCTCCCAAAGAGGTTGTTCCTGAAAAGAAAGTGCCCTCGGCTCCTCCTAAAAAGCCTGAAGTCCCACCTGTTAAAG
>TTN-213,ENSE00003806373,1,84,2566621,2566704,TGCCAGAGGCTCCGAAAGAAGTTGTTCCTGAAAAGAAAGTGCCAGCGGCTCCTCCTAAAAAGCCTGAAGTCACACCTGTTAAAG
>TTN-213,ENSE00003807489,1,84,2566705,2566788,TGCCTGAGGCTCCCAAAGAAGTTGTTCCTGAAAAGAAAGTGCCAGTGCCTCCTCCTAAAAAGCCTGAAGTGCCACCCACAAAAG
>TTN-213,ENSE00003805050,1,84,2566789,2566872,TCCCAGAGGTGCCAAAGGTAGCTGTCCCAGAAAAGAAGGTGCCTGAAGCTATTCCTCCCAAACCGGAAAGTCCTCCCCCTGAAG
>TTN-213,ENSE00003808824,1,84,2566873,2566956,TGTTCGAGGAGCCTGAGGAAGTTGCCCTAGAAGAGCCTCCTGCTGAAGTTGTGGAAGAGCCAGAGCCAGCGGCGCCTCCACAAG
>TTN-213,ENSE00003807203,1,84,2566957,2567040,TGACCGTACCACCTAAGAAACCTGTCCCAGAAAAGAAAGCACCTGCTGTCGTTGCCAAAAAACCTGAACTACCACCAGTGAAAG
>TTN-213,ENSE00003811260,1,84,2567041,2567124,TGCCCGAGGTGCCCAAGGAGGTTGTTCCTGAAAAGAAGGTGCCTCTGGTGGTTCCCAAAAAGCCAGAAGCCCCACCTGCTAAAG
>TTN-213,ENSE00003806229,1,78,2567125,2567202,TGCCTGAAGTTCCAAAAGAAGTTGTTCCAGAAAAGAAAGTAGCTGTTCCCAAAAAGCCAGAAGTCCCACCAGCAAAAG
>TTN-213,ENSE00003807893,1,84,2567203,2567286,TGCCAGAAGTGCCAAAGAAACCTGTCTTGGAAGAGAAACCAGCTGTTCCTGTTCCAGAAAGAGCGGAGTCTCCTCCCCCAGAAG
>TTN-213,ENSE00003809515,1,108,2567287,2567394,TATATGAAGAACCTGAGGAAATTGCTCCTGAAGAGGAAATTGCTCCTGAAGAGGAAAAGCCAGTTCCTGTTGCAGAAGAGGAGGAACCAGAGGTTCCACCTCCAGCAG
>TTN-213,ENSE00003804845,1,78,2567395,2567472,TGCCTGAAGAGCCCAAGAAGATCATCCCAGAGAAGAAAGTTCCTGTCATCAAAAAACCAGAAGCACCGCCTCCTAAAG
>TTN-213,ENSE00004025992,1,78,2567473,2567550,AACCTGAGATGCCAAAGAAAGTTGTTCCAGTGAAGAAGGTCCCAACTGTTAAGAAGCCAGAAACACCAGCAGCTAAAG
>TTN-213,ENSE00004025972,1,84,2567551,2567634,TGCCTGAGGTGCCCAAGAAACTTGTTCCAGTAAAGAAAGAACCTGTGCCTGTTACCAAAAAACCAGAAGTTCTTCCAGAAAAAG
>TTN-213,ENSE00004025968,1,84,2567635,2567718,TGCCCAAAGTGCCTGAGAAAATCATCCCAGAAAAGGAAGTGTCTGTGCCTATCCCTGCAGAGCCAGAAGTTCCACCTGCTGAAG
>TTN-213,ENSE00004025985,1,81,2567719,2567799,TTGAAGAGACTCCTGAGGAAATAATATATGAAGAAAAAGCATCTATAACCATTGGTAGAAAAGAGACTCCCCCTGTTGAAG
>TTN-213,ENSE00004025999,1,75,2567800,2567874,AACGTGAAATTGAAAAGTATATTAAACCTGAAGAGCCCGAACCTGAACCACAGCCTGAAGAAATACCAGTAAAAG
>TTN-213,ENSE00003806702,1,111,2567875,2567985,AACCTGAACCTGAAAAGGTTATTGAGAAGCCAAAACTCAAACCAAGACCCCCACCTCCTCCACCTGCTCCACCTAAGGAAGATGTGAAGGAGAAAATATTCCAACTTAAAG
>TTN-213,ENSE00003809179,1,69,2567986,2568054,CTATTCCAAAGAAGAAAGTTCCTGAAAAACCTCAGGTTCCAGAAAAAGTGGAGCTTACACCTCTGAAAG
>TTN-213,ENSE00003804802,1,81,2568055,2568135,TGCCTGGAGGTGAAAAGAAAGTTCGCAAATTACTTCCGGAACGTAAACCTGAACCAAAGGAAGAAGTTGTTCTGAAAAGCG
>TTN-213,ENSE00003811452,1,75,2568136,2568210,TTCTAAGAAAAAGACCTGAAGAAGAAGAACCTAAAGTAGAACCTAAAAAACTAGAAAAAGTTAAAAAACCTGCAG
>TTN-213,ENSE00003807205,1,90,2568211,2568300,TACCAGAACCACCACCTCCAAAACCTGTTGAAGAGGTTGAAGTACCTACTGTTACAAAAAGGGAAAGGAAGATTCCTGAACCAACAAAAG
>TTN-213,ENSE00003806747,1,63,2568301,2568363,TGCCTGAAATCAAGCCAGCAATACCTCTCCCTGCACCTGAACCGAAACCAAAGCCCGAAGCAG
>TTN-213,ENSE00003810755,1,90,2568364,2568453,AAGTGAAAACAATCAAACCACCTCCTGTGGAACCTGAACCAACCCCCATCGCTGCCCCAGTAACAGTGCCAGTGGTTGGAAAGAAAGCAG
>TTN-213,ENSE00003806122,1,51,2568454,2568504,AAGCCAAAGCACCTAAGGAAGAGGCTGCCAAGCCAAAAGGTCCTATCAAAG
>TTN-213,ENSE00003804858,1,402,2568505,2568906,GTGTACCCAAAAAGACTCCTTCACCAATAGAAGCCGAAAGGAGAAAGTTAAGGCCAGGAAGTGGTGGAGAGAAACCTCCTGATGAAGCCCCGTTCACCTACCAGCTAAAGGCTGTGCCACTGAAGTTTGTGAAAGAAATCAAAGACATCATCTTGACAGAATCAGAGTTCGTTGGCTCTTCAGCAATCTTTGAATGTTTGGTCTCCCCTTCCACTGCAATTACAACCTGGATGAAAGACGGTAGCAATATCCGTGAGAGTCCCAAGCACAGGTTTATTGCAGATGGTAAAGACAGAAAGCTGCACATCATTGATGTTCAACTTTCCGATGCTGGTGAATACACCTGTGTTTTACGTTTGGGAAACAAAGAAAAGACCTCCACGGCTAAACTTGTTGTAGAAG
>TTN-213,ENSE00003803996,1,279,2568907,2569185,AACTTCCTGTGCGTTTTGTAAAAACACTGGAAGAGGAAGTCACAGTGGTCAAAGGACAGCCATTGTACTTGAGCTGCGAGTTAAACAAAGAGCGTGACGTGGTCTGGAGGAAGGATGGCAAGATTGTGGTGGAGAAACCTGGCCGAATTGTGCCAGGCGTCATTGGCTTGATGCGGGCTCTGACCATCAACGATGCAGATGACACAGATGCTGGAACATACACAGTTACTGTGGAAAACGCCAACAACCTGGAGTGTTCATCTTGCGTAAAAGTAGTAG
>TTN-213,ENSE00003807976,1,276,2569186,2569461,AAGTCATTAGAGATTGGCTGGTGAAACCTATACGAGACCAGCATGTGAAACCCAAGGGGACAGCTATTTTTGCCTGTGATATAGCAAAAGATACTCCAAACATTAAGTGGTTCAAAGGATATGATGAAATCCCTGCGGAACCAAATGATAAGACTGAAATACTGAGAGATGGAAATCATCTGTACCTCAAAATTAAGAATGCTATGCCAGAAGATATTGCTGAGTATGCAGTGGAAATTGAAGGAAAAAGATACCCTGCAAAGCTGACACTTGGAG
>TTN-213,ENSE00003804328,1,140,2569462,2569601,AGCGTGAAGTTGAACTGCTTAAACCAATAGAGGACGTTACCATTTATGAGAAAGAAAGTGCAAGCTTTGATGCAGAAATCTCAGAGGCAGACATTCCTGGACAATGGAAACTGAAAGGAGAACTTCTAAGGCCCTCACCT
>TTN-213,ENSE00003802254,1,127,2569602,2569728,ACTTGTGAAATCAAAGCAGAAGGTGGAAAACGCTTCTTAACTTTGCACAAAGTCAAACTGGACCAAGCTGGTGAAGTCCTCTACCAGGCCCTTAATGCAATTACAACTGCCATTTTGACAGTAAAAG
>TTN-213,ENSE00003811410,1,264,2569729,2569992,AAATCGAACTTGACTTTGCTGTGCCCCTGAAGGATGTCACTGTTCCAGAAAGGCGACAGGCTCGATTCGAATGTGTCCTCACCCGAGAGGCAAATGTTATATGGTCCAAAGGACCTGATATAATTAAGTCATCTGACAAATTTGATATCATCGCTGATGGAAAGAAACATATTCTTGTTATTAATGATTCTCAATTTGATGATGAAGGGGTCTATACTGCTGAGGTGGAGGGCAAGAAGACCTCAGCTCGGTTGTTTGTCACAG
>TTN-213,ENSE00003805150,1,267,2569993,2570259,GTATAAGACTGAAATTCATGTCACCTCTTGAAGATCAAACAGTAAAAGAAGGTGAAACAGCAACTTTTGTTTGTGAACTTTCTCATGAAAAAATGCATGTAGTCTGGTTCAAAAATGATGCCAAACTCCATACAAGCAGAACAGTACTCATCTCTTCTGAGGGCAAGACTCACAAATTGGAAATGAAAGAAGTGACATTGGATGATATATCTCAGATAAAAGCTCAAGTCAAGGAGCTGAGCTCCACAGCACAGCTGAAGGTCTTAG
>TTN-213,ENSE00003801907,1,264,2570260,2570523,AGGCCGATCCCTACTTCACTGTGAAATTACATGACAAAACTGCAGTGGAGAAGGATGAGATTACTTTGAAGTGTGAAGTGAGCAAAGATGTACCAGTGAAATGGTTCAAAGATGGTGAAGAGATTGTCCCTTCACCCAAATATTCTATCAAGGCAGATGGCCTGCGCCGCATCTTAAAAATCAAAAAGGCGGACCTTAAAGATAAAGGCGAATATGTGTGTGACTGTGGCACAGACAAGACCAAGGCAAATGTTACTGTTGAGG
>TTN-213,ENSE00003802031,1,140,2570524,2570663,CTCGACTAATAAAAGTGGAAAAGCCTCTGTACGGAGTAGAGGTGTTTGTTGGTGAAACAGCCCACTTTGAAATTGAACTTTCTGAACCTGATGTTCACGGCCAGTGGAAGCTGAAAGGACAGCCTTTGACAGCTTCCCCT
>TTN-213,ENSE00003811443,1,127,2570664,2570790,GACTGTGAAATCATTGAGGATGGAAAGAAGCATATTCTGATCCTTCATAACTGTCAGCTGGGTATGACAGGAGAGGTTTCCTTCCAGGCTGCTAATGCCAAATCTGCAGCCAATCTGAAAGTGAAAG
>TTN-213,ENSE00003811384,1,267,2570791,2571057,AATTGCCTCTTATCTTCATCACACCTCTCAGTGATGTTAAAGTCTTCGAGAAAGATGAGGCTAAGTTTGAGTGTGAAGTATCCAGGGAGCCCAAAACATTCCGTTGGCTAAAAGGAACCCAGGAAATCACAGGTGATGACAGATTTGAGCTTATAAAGGATGGCACTAAGCATTCAATGGTGATCAAGTCAGCTGCTTTTGAAGATGAAGCAAAATACATGTTTGAAGCTGAAGATAAGCACACAAGTGGCAAACTGATCATTGAAG
>TTN-213,ENSE00003801954,1,267,2571058,2571324,GAATCCGGCTCAAATTCCTCACCCCTCTCAAAGATGTAACTGCCAAAGAGAAGGAAAGTGCTGTATTTACTGTGGAGTTATCTCATGATAACATCCGAGTTAAATGGTTCAAGAATGACCAGCGCCTACACACCACCAGGTCGGTCTCAATGCAAGACGAAGGGAAAACTCATTCGATCACATTCAAAGACCTGTCTATTGATGACACCTCCCAAATTAGAGTAGAAGCTATGGGGATGAGTTCAGAAGCTAAACTCACTGTGCTTG
>TTN-213,ENSE00003809996,1,267,2571325,2571591,AGGGAGACCCATATTTTACAGGAAAACTTCAAGATTATACTGGTGTAGAGAAAGATGAAGTTATTCTACAGTGTGAAATTAGCAAAGCAGATGCACCAGTGAAATGGTTTAAGGATGGGAAGGAAATAAAGCCATCCAAAAATGCTGTTATTAAGGCAGATGGCAAGAAACGCATGCTAATCCTAAAGAAAGCCTTGAAATCAGATATTGGACAGTACACCTGTGACTGTGGGACAGATAAGACCTCAGGAAAACTTGACATTGAGG
>TTN-213,ENSE00003804589,1,140,2571592,2571731,ATCGGGAAATTAAACTGGTGCGACCCCTGCACAGTGTGGAGGTGATGGAGACTGAGACAGCACGCTTTGAAACCGAAATCTCTGAAGATGATATCCACGCCAACTGGAAACTCAAGGGAGAGGCCCTACTCCAAACACCT
>TTN-213,ENSE00003805931,1,127,2571732,2571858,GATTGTGAAATTAAGGAAGAAGGCAAAATACACTCCCTTGTTTTGCACAACTGTCGCCTGGACCAGACGGGTGGGGTGGATTTCCAAGCTGCCAATGTTAAATCTAGTGCCCACCTCCGAGTTAAGC
>TTN-213,ENSE00003811344,1,143,2571859,2572001,CACGAGTAATTGGTCTTCTGAGGCCTTTAAAGGATGTCACCGTGACTGCAGGGGAAACAGCCACCTTCGACTGCGAGCTCTCCTACGAAGATATCCCAGTGGAATGGTATCTCAAAGGGAAGAAACTAGAGCCCAGCGATAAG
>TTN-213,ENSE00003802375,1,124,2572002,2572125,GTGGTCCCACGTTCAGAAGGAAAAGTTCATACACTTACTCTGAGGGATGTAAAGTTAGAAGATGCTGGGGAAGTCCAACTAACAGCAAAAGATTTCAAAACTCACGCCAACCTCTTTGTGAAAG
>TTN-213,ENSE00003806733,1,267,2572126,2572392,AACCCCCAGTTGAATTCACTAAGCCTCTTGAGGACCAGACGGTCGAAGAGGGAGCCACTGCAGTGCTGGAGTGTGAAGTCTCCAGAGAAAATGCTAAGGTGAAATGGTTCAAAAATGGGACAGAAATCCTCAAAAGCAAGAAGTATGAAATTGTTGCTGATGGCAGGGTCAGAAAACTTGTTATACATGACTGTACCCCAGAGGATATTAAAACATACACTTGTGATGCTAAGGATTTTAAGACTTCCTGTAACCTGAATGTCGTGC
>TTN-213,ENSE00003807497,1,98,2572393,2572490,CTCCTCATGTGGAATTCTTAAGACCACTCACCGACCTTCAAGTTAGAGAAAAAGAAATGGCTCGATTTGAGTGTGAACTTTCCCGAGAAAATGCTAAG
>TTN-213,ENSE00003802530,1,169,2572491,2572659,GTTAAGTGGTTTAAAGATGGTGCTGAAATTAAAAAGGGCAAAAAATATGACATCATATCCAAGGGAGCAGTGCGCATTCTTGTCATCAACAAATGTCTACTGGATGATGAAGCTGAATATTCCTGTGAAGTAAGGACAGCGAGAACTTCTGGCATGCTGACAGTTCTGG
>TTN-213,ENSE00003811387,1,267,2572660,2572926,AAGAAGAAGCTGTCTTTACCAAAAATCTTGCCAACATTGAAGTTAGTGAAACAGACACTATAAAACTGGTTTGTGAAGTCTCCAAACCTGGCGCAGAAGTGATTTGGTATAAAGGGGATGAGGAGATCATTGAAACAGGAAGATATGAAATACTGACTGAAGGACGGAAGAGAATCCTGGTCATTCAGAACGCTCACCTTGAGGATGCTGGCAACTACAACTGTCGACTCCCAAGCTCTCGAACCGATGGCAAAGTCAAAGTACATG
>TTN-213,ENSE00003802653,1,267,2572927,2573193,AACTGGCTGCTGAATTTATCTCAAAGCCTCAAAACCTTGAAATACTTGAAGGAGAAAAGGCTGAATTTGTCTGCTCTATATCAAAAGAAAGCTTTCCAGTCCAGTGGAAGAGGGATGATAAGACACTTGAATCTGGAGATAAATATGACGTTATTGCTGATGGTAAAAAGAGGGTCCTAGTTGTGAAAGATGCCACATTACAAGATATGGGCACTTACGTTGTCATGGTAGGGGCCGCCAGAGCAGCAGCTCACTTGACAGTCATTG
>TTN-213,ENSE00003802540,1,279,2573194,2573472,AAAAACTCAGGATCGTAGTTCCTCTTAAGGACACCCGGGTGAAGGAACAACAGGAAGTTGTCTTCAACTGTGAAGTCAATACTGAAGGTGCCAAAGCCAAATGGTTCAGAAATGAAGAAGCTATATTTGATAGTTCAAAATACATCATTCTCCAAAAAGACCTAGTCTACACCCTCAGAATTAGAGATGCACACTTAGATGACCAAGCCAACTATAATGTGTCTTTGACCAATCACAGAGGTGAAAATGTTAAAAGTGCAGCCAATCTAATAGTAGAAG
>TTN-213,ENSE00003802874,1,409,2573473,2573881,AGGAAGACCTTAGGATTGTTGAGCCTCTTAAAGATATTGAAACAATGGAGAAGAAATCTGTCACATTCTGGTGCAAGGTGAATCGTCTCAATGTAACACTGAAGTGGACCAAAAATGGTGAAGAAGTGCCTTTTGACAACCGTGTCTCATACAGAGTTGATAAGTACAAGCACATGTTAACCATTAAAGACTGTGGCTTCCCAGATGAAGGTGAATACATTGTCACTGCTGGACAAGATAAATCTGTTGCTGAGCTTCTCATCATAGAAGCCCCGACAGAATTTGTGGAACACTTGGAAGATCAGACAGTCACTGAGTTCGATGACGCTGTCTTCTCCTGCCAGCTCTCCAGAGAGAAAGCCAATGTAAAATGGTACAGAAATGGGAGAGAAATCAAAGAAGGCAAAAA
>TTN-213,ENSE00003804130,1,125,2573882,2574006,ATACAAATTTGAAAAAGATGGAAGTATACACAGACTCATTATAAAAGATTGCAGGCTGGATGATGAGTGTGAATATGCTTGCGGGGTAGAAGACAGGAAGTCTCGTGCTAGACTTTTTGTGGAAG
>TTN-213,ENSE00003807647,1,267,2574007,2574273,AAATTCCTGTTGAGATCATCAGGCCTCCACAAGATATTCTTGAAGCCCCTGGTGCTGATGTTGTCTTTTTAGCAGAACTCAATAAAGATAAGGTGGAAGTCCAATGGCTAAGAAATAACATGGTTGTTGTCCAGGGTGATAAACACCAGATGATGAGTGAAGGAAAGATACATCGACTACAGATTTGTGATATTAAGCCCCGTGACCAGGGTGAATACAGATTTATTGCCAAAGACAAAGAAGCCAGAGCTAAGCTTGAACTGGCAG
>TTN-213,ENSE00003802353,1,270,2574274,2574543,CTGCACCAAAAATCAAGACAGCTGACCAAGACCTTGTGGTTGATGTTGGCAAGCCTCTGACAATGGTGGTGCCATATGATGCCTACCCCAAAGCAGAAGCTGAATGGTTTAAAGAAAATGAACCTTTATCTACAAAAACCATTGATACTACGGCTGAACAAACTTCTTTCAGAATTTTAGAAGCCAAGAAAGGAGACAAAGGGAGGTATAAAATTGTGCTTCAGAACAAACATGGAAAAGCAGAAGGATTCATCAATTTAAAAGTTATTG
>TTN-213,ENSE00003809195,1,303,2574544,2574846,ATGTTCCTGGGCCAGTACGTAACTTAGAAGTGACAGAAACATTTGATGGTGAAGTGAGCCTTGCTTGGGAAGAACCTTTAACTGATGGTGGAAGCAAAATCATAGGTTACGTTGTTGAAAGACGTGACATTAAGAGAAAGACCTGGGTTCTGGCCACAGACCGTGCAGAGAGTTGTGAGTTTACTGTCACTGGTCTACAGAAAGGAGGAGTTGAGTACCTATTCCGTGTGAGTGCAAGAAACAGAGTTGGCACTGGTGAGCCAGTAGAAACTGACAATCCTGTAGAAGCAAGGAGTAAATATG
>TTN-213,ENSE00003803170,1,303,2574847,2575149,ATGTTCCAGGCCCTCCTTTGAATGTAACCATCACTGATGTGAATCGATTTGGTGTCTCACTGACATGGGAACCACCAGAGTATGATGGAGGTGCTGAGATCACAAACTACGTCATTGAATTAAGAGACAAGACTTCTATCAGGTGGGATACTGCCATGACTGTGAGAGCTGAAGACCTGTCTGCAACTGTTACTGATGTGGTAGAAGGACAGGAGTACAGTTTCCGAGTGAGAGCCCAAAATCGAATTGGAGTTGGAAAACCAAGTGCAGCCACACCCTTCGTCAAAGTTGCTGATCCAATTG
>TTN-213,ENSE00003806295,1,188,2575150,2575337,AGAGACCAAGTCCTCCTGTAAACCTAACTTCCTCAGATCAGACTCAGTCATCAGTTCAGCTCAAATGGGAACCTCCTCTGAAAGATGGAGGAAGCCCAATATTAGGCTATATAATTGAGCGATGCGAAGAAGGAAAAGATAATTGGATTCGTTGCAATATGAAACTTGTCCCTGAACTGACTTACAAG
>TTN-213,ENSE00003810732,1,115,2575338,2575452,GTTACCGGATTGGAAAAAGGAAATAAATATTTATATAGAGTATCTGCAGAAAATAAAGCTGGTGTTTCAGATCCATCTGAAATTCTTGGTCCTCTCACCGCTGACGATGCATTTG
>TTN-213,ENSE00003809985,1,285,2575453,2575737,TTGAACCAACAATGGATTTAAGTGCATTTAAAGATGGTCTGGAAGTTATTGTCCCAAATCCTATCACGATCCTGGTTCCAAGTACAGGCTATCCAAGGCCAACTGCAACCTGGTGTTTTGGAGATAAAGTACTAGAAACAGGGGACCGGGTGAAAATGAAGACCTTGTCTGCCTATGCCGAACTTGTCATTTCTCCAAGTGAACGTTCAGACAAGGGCATTTATACACTGAAATTAGAAAACCGTGTGAAAACAATTTCTGGGGAAATTGATGTCAATGTAATTG
>TTN-213,ENSE00003808828,1,152,2575738,2575889,CTCGCCCAAGTGCACCCAAAGAATTGAAATTTGGTGATATAACCAAGGACTCAGTACATTTGACTTGGGAACCACCTGATGATGATGGAGGAAGTCCGTTAACTGGATACGTTGTTGAAAAACGAGAAGTCAGCCGGAAAACATGGACTAAA
>TTN-213,ENSE00003803811,1,148,2575890,2576037,GTTATGGACTTTGTGACTGATCTAGAATTCACAGTTCCTGATCTTGTTCAAGGAAAAGAGTACTTATTTAAAGTTTGTGCTCGTAACAAATGTGGCCCTGGAGAACCTGCATATGTTGATGAACCTGTAAATATGTCAACTCCTGCAA
>TTN-213,ENSE00003803944,1,178,2576038,2576215,CGGTACCTGACCCACCAGAGAATGTTAAATGGAGAGATCGAACAGCCAATAGCATCTTCTTAACATGGGATCCACCTAAAAATGATGGTGGTTCACGCATCAAAGGATATATAGTTGAAAGATGTCCACGTGGTTCTGATAAATGGGTTGCCTGTGGAGAACCTGTTGCAGAAACAAA
>TTN-213,ENSE00003802090,1,122,2576216,2576337,AATGGAAGTGACAGGTCTTGAGGAAGGCAAATGGTATGCCTACCGCGTGAAGGCCTTAAACAGGCAGGGTGCTAGCAAACCAAGCAGACCCACAGAGGAAATCCAGGCTGTGGACACACAAG
>TTN-213,ENSE00003809522,1,288,2576338,2576625,AGGCCCCAGAAATCTTCCTCGATGTGAAGCTCCTTGCTGGTCTCACTGTAAAAGCTGGGACCAAGATTGAACTTCCTGCCACCGTAACCGGAAAACCTGAACCTAAAATAACTTGGACAAAGGCTGATATGATTCTGAAGCAGGACAAAAGAATTACCATTGAAAATGTCCCTAAGAAATCCACAGTGACTATTGTTGATAGTAAGAGAAGTGACACTGGCACATATATCATTGAGGCTGTGAATGTGTGTGGCCGGGCCACTGCTGTGGTGGAAGTGAACGTCTTAG
>TTN-213,ENSE00003804879,1,297,2576626,2576922,ATAAACCCGGACCACCAGCTGCCTTTGACATCACAGATGTAACCAATGAGTCATGTCTTCTAACATGGAACCCACCACGCGATGATGGTGGATCTAAGATCACAAACTATGTTGTGGAGAGACGAGCAACTGATAGTGAAGTGTGGCACAAGCTCTCATCCACCGTCAAGGATACAAACTTCAAGGCCACCAAATTAATCCCCAATAAAGAGTACATCTTCAGAGTTGCTGCAGAAAACATGTATGGTGTTGGTGAACCAGTTCAGGCCTCTCCAATAACAGCCAAATATCAGTTTG
>TTN-213,ENSE00003809410,1,187,2576923,2577109,ATCCACCTGGTCCTCCAACTCGCCTAGAACCTTCTGATATCACTAAAGACGCAGTGACTCTCACATGGTGTGAGCCAGATGATGATGGTGGCAGCCCAATCACAGGATACTGGGTTGAAAGACTGGATCCTGATACAGATAAATGGGTTAGATGCAATAAGATGCCAGTAAAGGACACAACATACAG
>TTN-213,ENSE00003808827,1,116,2577110,2577225,AGTGAAAGGTCTCACTAATAAGAAAAAATACAGATTCCGTGTGTTGGCTGAAAATCTTGCTGGACCTGGAAAACCAAGCAAATCAACTGAACCAATCTTAATAAAGGATCCCATAG
>TTN-213,ENSE00003806136,1,300,2577226,2577525,ATCCTCCATGGCCCCCTGGAAAACCAACTGTAAAAGATGTAGGCAAAACATCAGTAAGGTTGAATTGGACAAAACCAGAACATGATGGAGGTGCAAAGATTGAGTCTTATGTCATTGAAATGCTGAAGACTGGAACAGATGAGTGGGTCAGAGTGGCGGAAGGGGTTCCCACCACTCAGCACTTGCTCCCAGGGCTCATGGAAGGACAGGAATACTCATTCCGAGTTAGAGCTGTGAATAAGGCTGGGGAAAGTGAACCCAGTGAACCCAGTGACCCTGTGCTTTGCCGGGAGAAGCTAT
>TTN-213,ENSE00003804290,1,300,2577526,2577825,ATCCTCCATCACCACCACGCTGGCTTGAAGTTATTAATATCACAAAAAATACAGCAGACCTAAAATGGACAGTTCCTGAGAAAGATGGAGGGTCCCCCATCACCAACTACATTGTGGAAAAGAGAGACGTCAGGCGAAAAGGCTGGCAAACAGTGGATACCACTGTCAAGGACACCAAGTGCACAGTCACCCCACTGACTGAGGGCTCTTTATATGTGTTCCGAGTTGCTGCAGAAAATGCTATAGGACAAAGCGACTACACCGAAATTGAGGACTCTGTGCTGGCCAAAGACACCTTTA
>TTN-213,ENSE00003803723,1,106,2577826,2577931,CCACTCCTGGACCACCCTACGCCCTGGCAGTGGTTGATGTGACAAAACGACATGTTGACCTAAAGTGGGAGCCACCTAAAAATGATGGTGGAAGACCAATACAGAG
>TTN-213,ENSE00003805819,1,197,2577932,2578128,ATATGTCATTGAGAAGAAAGAAAGGTTAGGTACCCGTTGGGTGAAAGCTGGAAAGACTGCAGGACCTGACTGTAACTTCAGAGTAACTGATGTCATCGAAGGAACAGAGGTCCAGTTTCAGGTTCGGGCTGAAAATGAAGCTGGAGTTGGCCACCCAAGTGAACCCACAGAAATCCTATCCATTGAAGATCCAACAA
>TTN-213,ENSE00003806467,1,306,2578129,2578434,GTCCTCCCTCACCACCCCTTGACCTACATGTGACTGATGCTGGGAGAAAACACATTGCCATTGCTTGGAAGCCTCCAGAGAAAAATGGTGGAAGTCCTATCATAGGATACCATGTTGAAATGTGTCCAGTAGGCACTGAGAAATGGATGAGAGTTAATTCTCGCCCAATAAAGGACTTGAAATTCAAGGTTGAAGAAGGTGTTGTTCCTGACAAAGAATATGTCCTGAGAGTGAGAGCAGTCAATGCTATTGGTGTCAGCGAGCCATCTGAAATCTCTGAAAATGTGGTTGCCAAAGACCCAGACT
>TTN-213,ENSE00003808061,1,279,2578435,2578713,GCAAGCCAACAATTGACCTGGAGACTCATGACATTATTGTTATTGAAGGTGAAAAGTTAAGCATTCCTGTTCCCTTCAGAGCTGTCCCAGTTCCAACTGTTAGTTGGCATAAAGATGGCAAAGAAGTTAAAGCAAGTGATAGATTAACAATGAAGAATGATCACATCTCTGCACACCTTGAAGTTCCCAAGAGTGTCCGTGCAGATGCCGGAATTTATACCATTACACTGGAGAATAAGCTCGGCTCAGCAACAGCCTCAATCAATGTCAAAGTCATAG
>TTN-213,ENSE00003811164,1,300,2578714,2579013,GCCTACCTGGACCATGCAAAGATATTAAAGCAAGTGACATTACCAAGAGTTCTTGTAAGTTAACTTGGGAACCTCCAGAATTTGATGGTGGAACCCCAATTCTTCATTATGTCCTGGAGCGCAGAGAAGCTGGGAGGAGAACATATATACCAGTCATGTCTGGTGAGAACAAACTGTCATGGACTGTGAAGGATCTCATACCAAATGGTGAATACTTCTTCCGTGTTAAAGCAGTCAACAAGGTTGGTGGAGGAGAATATATTGAACTGAAAAATCCAGTCATTGCTCAAGATCCAAAGC
>TTN-213,ENSE00003805132,1,303,2579014,2579316,AACCCCCTGATCCACCTGTAGATGTAGAGGTTCATAATCCTACAGCGGAGGCAATGACTATTACATGGAAGCCACCTTTGTATGATGGAGGGAGCAAGATAATGGGCTACATCATAGAGAAGATTGCTAAGGGTGAAGAAAGGTGGAAGAGATGCAATGAACACCTGGTACCAATCCTGACCTATACAGCAAAAGGACTTGAAGAGGGGAAAGAGTACCAATTCCGTGTGCGAGCAGAGAACGCCGCGGGTATTAGTGAACCTTCTCGGGCTACTCCTCCAACCAAAGCTGTAGATCCCATTG
>TTN-213,ENSE00003805056,1,363,2579317,2579679,ATGCCCCCAAAGTCATTCTGAGAACAAGCCTAGAAGTGAAACGAGGTGATGAAATAGCACTTGATGCAAGTATTTCTGGATCACCTTACCCAACTATTACATGGATAAAGGATGAAAATGTTATTGTACCAGAGGAAATTAAGAAGCGTGCAGCACCCTTGGTTAGGAGAAGGAAGGGTGAAGTTCAAGAAGAAGAACCATTTGTCCTGCCTCTGACACAGCGTTTGAGTATTGACAACAGCAAAAAGGGAGAATCTCAGCTACGCGTCCGAGATTCTCTCCGACCTGACCATGGTCTGTATATGATCAAAGTTGAAAATGACCACGGTATTGCAAAAGCTCCTTGTACTGTCAGTGTGTTAG
>TTN-213,ENSE00003811138,1,303,2579680,2579982,ATACACCGGGACCACCAATCAACTTTGTATTTGAAGATATCAGAAAGACCTCAGTCCTTTGTAAATGGGAACCACCCCTTGATGATGGTGGCAGTGAAATCATAAACTACACTTTGGAAAAGAAAGACAAGACAAAACCCGACTCAGAATGGATTGTTGTCACTTCAACACTTAGACATTGCAAATATTCAGTAACAAAACTGATTGAAGGAAAAGAGTACCTCTTCCGTGTAAGAGCTGAAAACAGATTTGGGCCAGGTCCACCATGTGTTTCAAAGCCACTTGTGGCTAAAGATCCATTTG
>TTN-213,ENSE00003809346,1,300,2579983,2580282,GACCACCTGATGCACCAGATAAGCCCATTGTGGAAGATGTTACCAGCAACAGTATGCTAGTGAAATGGAATGAACCAAAAGATAATGGAAGCCCCATTTTGGGTTACTGGCTTGAAAAACGTGAAGTTAACAGTACACATTGGTCTCGTGTCAACAAAAGCCTTCTGAATGCCTTGAAAGCCAATGTAGATGGCTTATTAGAAGGACTCACCTATGTCTTCAGAGTATGTGCTGAAAATGCAGCTGGACCTGGAAAGTTCAGTCCACCTTCAGATCCCAAAACAGCACATGATCCAATCT
>TTN-213,ENSE00003806782,1,297,2580283,2580579,CTCCTCCTGGGCCACCTATCCCAAGAGTCACTGACACAAGCTCTACAACTATTGAACTAGAATGGGAACCCCCAGCTTTCAATGGTGGTGGGGAAATTGTTGGCTATTTTGTTGATAAGCAGTTGGTTGGCACAAATGAATGGTCACGCTGCACAGAGAAGATGATCAAGGTCCGTCAGTACACCGTCAAAGAAATCCGAGAGGGTGCTGATTACAAACTTCGGGTGAGTGCTGTCAATGCCGCAGGGGAAGGACCGCCTGGAGAAACACAACCTGTTACTGTGGCTGAACCACAAG
>TTN-213,ENSE00003804121,1,285,2580580,2580864,AGCCTCCAGCTGTGGAACTGGATGTTTCTGTCAAGGGTGGAATACAAATAATGGCTGGGAAGACTCTTAGAATTCCAGCTGTGGTGACTGGTCGCCCTGTACCTACAAAAGTATGGACCAAAGAAGAAGGGGAGCTGGATAAAGACCGTGTTGTAATAGACAACGTTGGAACCAAATCTGAACTAATTATCAAGGATGCACTGCGAAAAGACCATGGCAGATATGTGATTACAGCTACAAATAGCTGTGGTTCCAAATTTGCAGCAGCCAGGGTAGAAGTTTTTG
>TTN-213,ENSE00003804454,1,294,2580865,2581158,ATGTCCCTGGTCCAGTTCTTGACTTAAAACCTGTTGTAACAAACAGAAAAATGTGTCTACTTAACTGGTCTGATCCAGAAGATGATGGAGGAAGTGAAATAACAGGCTTTATCATTGAAAGAAAAGATGCCAAGATGCATACTTGGAGACAACCAATAGAGACTGAGAGATCTAAATGTGACATCACAGGTCTGCTTGAGGGACAAGAATATAAGTTCCGTGTTATTGCCAAGAACAAGTTTGGCTGTGGCCCTCCTGTTGAAATAGGACCAATTCTTGCAGTTGATCCACTAG
>TTN-213,ENSE00003803420,1,300,2581159,2581458,GTCCTCCAACATCTCCAGAGAGGCTCACATACACTGAAAGGACAAAGTCCACTATCACACTTGACTGGAAAGAGCCCCGCAGTAATGGTGGCAGTCCCATCCAAGGATATATCATTGAAAAACGGCGTCATGACAAACCTGACTTTGAAAGAGTTAACAAGCGACTCTGCCCAACCACATCTTTTCTGGTTGAAAATCTTGATGAACACCAAATGTATGAGTTCCGTGTCAAAGCTGTCAATGAAATTGGTGAAAGTGAACCATCCCTACCTCTTAATGTAGTCATACAAGATGATGAAG
>TTN-213,ENSE00003809028,1,309,2581459,2581767,TGCCTCCAACTATTAAGTTGCGTCTGAGTGTTCGAGGAGACACTATCAAAGTTAAGGCAGGAGAGCCTGTCCACATCCCTGCAGATGTGACAGGCCTTCCAATGCCTAAGATTGAATGGTCCAAAAATGAAACTGTAATTGAAAAACCCACTGATGCACTTCAGATAACCAAGGAAGAGGTATCCCGAAGTGAGGCAAAAACTGAGCTTAGCATTCCCAAAGCGGTCCGGGAGGACAAAGGCACTTACACAGTTACTGCTTCCAATCGCCTTGGCTCAGTGTTCCGAAATGTTCACGTTGAAGTATATG
>TTN-213,ENSE00003801894,1,191,2581768,2581958,ACCGCCCATCCCCACCAAGAAATCTTGCTGTTACTGACATTAAAGCTGAATCTTGCTACTTGACATGGGATGCCCCTCTTGATAATGGTGGCAGTGAAATCACCCATTATGTTATTGACAAACGTGATGCAAGTAGGAAGAAAGCAGAATGGGAGGAAGTCACCAACACTGCTGTAGAGAAAAGATATGGG
>TTN-213,ENSE00003809851,1,430,2581959,2582388,ATCTGGAAACTTATCCCCAATGGTCAGTATGAGTTCCGAGTCAGGGCAGTGAATAAATATGGAATCAGTGATGAGTGCAAATCAGATAAAGTAGTCATTCAAGATCCTTATCGCCTTCCTGGACCTCCAGGAAAACCAAAAGTTTTGGCACGCACCAAAGGATCAATGCTAGTGAGCTGGACTCCTCCTTTGGACAATGGTGGCTCTCCAATTACTGGCTACTGGCTGGAGAAAAGAGAAGAGGGAAGTCCTTATTGGTCACGTGTTAGCCGAGCACCAATAACCAAAGTGGGATTGAAAGGCGTGGAATTTAATGTTCCTCGTTTGCTTGAAGGCGTTAAATACCAGTTCAGAGCCATGGCAATAAATGCTGCAGGAATTGGTCCTCCCAGTGAACCATCAGATCCAGAGGTTGCAGGAGATCCCATAT
>TTN-213,ENSE00003808594,1,309,2582389,2582697,TTCCACCGGGGCCACCTTCTTGCCCAGAAGTTAAAGATAAAACGAAGTCAAGCATCTCACTAGGATGGAAACCTCCAGCCAAAGATGGTGGCAGCCCAATCAAAGGATACATTGTAGAAATGCAAGAAGAAGGTACTACTGACTGGAAAAGAGTAAATGAACCAGACAAACTTATAACTACCTGTGAATGTGTGGTGCCTAATCTGAAAGAGCTCAGGAAGTACAGATTCAGAGTGAAAGCTGTCAATGAAGCTGGTGAATCTGAACCAAGTGATACAACTGGGGAGATCCCTGCCACTGATATTCAAG
>TTN-213,ENSE00003810473,1,149,2582698,2582846,AGGAACCAGAAGTTTTCATTGACATTGGAGCACAGGACTGTCTGGTTTGTAAAGCTGGCTCACAGATTAGGATTCCTGCTGTCATCAAGGGACGCCCAACACCAAAATCATCTTGGGAATTTGATGGAAAGGCAAAGAAAGCAATGAAG
>TTN-213,ENSE00003801625,1,33,2582847,2582879,GATGGAGTTCATGACATACCCGAAGATGCACAG
>TTN-213,ENSE00003802643,1,130,2582880,2583009,CTGGAGACTGCTGAAAACTCCTCAGTAATTATTATTCCGGAGTGTAAACGATCTCATACAGGCAAATACAGCATCACAGCCAAGAATAAAGCAGGACAAAAGACTGCAAATTGCAGAGTTAAAGTCATGG
>TTN-213,ENSE00003804239,1,300,2583010,2583309,ATGTACCAGGCCCACCCAAAGATCTGAAAGTCAGTGATATCACAAGGGGTAGTTGCAGACTTTCATGGAAGATGCCAGACGACGATGGAGGAGACAGGATCAAAGGCTATGTTATTGAGAAGAGGACTATTGATGGAAAAGCCTGGACCAAAGTCAATCCAGACTGTGGAAGCACCACATTTGTAGTGCCTGATCTCCTCTCTGAACAGCAATATTTCTTCCGTGTGCGAGCAGAAAACCGTTTTGGTATTGGCCCACCTGTGGAAACCATTCAGAGGACCACTGCCAGAGATCCGATAT
>TTN-213,ENSE00003806278,1,318,2583310,2583627,ATCCTCCTGATCCTCCTATTAAACTCAAGATTGGCCTCATCACAAAGAACACAGTGCATCTGTCATGGAAACCCCCGAAGAATGATGGGGGCTCCCCTGTTACCCACTATATTGTTGAGTGCCTTGCATGGGACCCTACTGGGACAAAGAAAGAAGCCTGGAGGCAGTGCAATAAGCGTGATGTGGAAGAACTGCAATTTACTGTTGAAGACCTAGTAGAGGGTGGGGAATATGAATTCCGAGTCAAAGCTGTCAATGCTGCAGGAGTCAGCAAGCCTTCAGCCACTGTTGGCCCTGTGACTGTCAAAGACCAGACAT
>TTN-213,ENSE00003801391,1,297,2583628,2583924,GCCCACCATCAATTGATCTAAAAGAATTCATGGAGGTTGAAGAAGGAACCAATGTTAACATTGTGGCCAAAATTAAAGGTGTGCCATTCCCGACACTAACCTGGTTTAAAGCTCCTCCAAAGAAGCCTGATAACAAAGAACCTGTTCTCTATGACACCCATGTCAACAAACTGGTGGTAGATGATACTTGCACTTTAGTTATTCCGCAGTCTCGCAGGAGTGACACTGGCTTATATACCATCACAGCTGTAAATAATCTGGGAACAGCATCAAAGGAGATGAGACTGAATGTCCTGG
>TTN-213,ENSE00003806021,1,300,2583925,2584224,GTCGTCCTGGCCCTCCAGTGGGACCCATAAAATTTGAATCTGTTTCAGCAGATCAAATGACACTATCTTGGTTTCCACCTAAAGATGATGGTGGGTCTAAGATTACAAACTATGTAATTGAGAAAAGAGAAGCTAACAGGAAGACATGGGTCCATGTCTCCAGTGAACCTAAGGAGTGCACGTACACGATTCCCAAATTGCTAGAAGGCCATGAATATGTATTCCGAATCATGGCCCAGAATAAATATGGCATTGGAGAACCTCTTGACAGTGAACCTGAAACAGCAAGAAACCTCTTCT
>TTN-213,ENSE00003803442,1,315,2584225,2584539,CTGTCCCTGGAGCACCAGATAAACCAACAGTTAGCAGCGTGACTCGTAACTCCATGACTGTCAACTGGGAAGAGCCAGAATATGATGGAGGCTCTCCTGTGACAGGGTACTGGCTGGAAATGAAAGACACCACTTCAAAGAGATGGAAGAGAGTTAACCGAGATCCTATCAAAGCCATGACTTTGGGTGTTTCTTATAAAGTGACTGGTCTTATTGAAGGTTCCGACTATCAATTCCGGGTATATGCAATCAATGCTGCTGGCGTGGGTCCAGCAAGTCTGCCATCAGACCCAGCGACTGCTAGAGATCCAATTG
>TTN-213,ENSE00003801787,1,149,2584540,2584688,CCCCTCCTGGTCCTCCATTTCCCAAAGTGACAGATTGGACTAAATCATCTGCAGATCTGGAGTGGTCTCCCCCACTAAAAGATGGTGGATCCAAAGTAACTGGATACATCGTTGAATATAAAGAAGAAGGAAAAGAAGAATGGGAAAAG
>TTN-213,ENSE00003802004,1,151,2584689,2584839,GGTAAAGATAAAGAAGTGAGAGGAACAAAGCTTGTTGTGACAGGATTAAAGGAAGGAGCATTCTACAAATTTAGAGTTAGAGCAGTCAACATTGCTGGCATTGGAGAACCTGGAGAGGTCACAGATGTCATTGAAATGAAGGACAGACTTG
>TTN-213,ENSE00003808790,1,282,2584840,2585121,TTTCACCTGACCTTCAGCTAGATGCCAGTGTCAGAGATAGAATTGTTGTCCATGCTGGAGGGGTGATCCGAATCATTGCCTATGTGTCTGGAAAGCCTCCTCCAACCGTCACCTGGAACATGAATGAAAGAACCTTACCTCAAGAAGCCACCATTGAGACCACAGCCATTAGCTCATCCATGGTCATCAAGAACTGCCAGAGGAGCCATCAAGGCGTCTATTCTCTTCTTGCCAAAAATGAAGCCGGAGAAAGAAAGAAGACAATTATTGTTGATGTATTAG
>TTN-213,ENSE00003807896,1,303,2585122,2585424,ATGTTCCAGGTCCCGTTGGAACACCATTCCTAGCTCACAACCTAACCAATGAGTCCTGCAAACTGACATGGTTTTCTCCAGAAGATGATGGAGGCTCTCCAATCACCAATTATGTCATTGAAAAGCGTGAATCTGACCGCAGAGCATGGACCCCAGTGACATATACAGTTACCCGACAAAATGCTACTGTCCAGGGTCTCATTCAAGGAAAAGCCTACTTTTTCCGAATTGCGGCTGAAAATAGTATTGGCATGGGTCCATTTGTTGAGACATCAGAGGCACTTGTTATCAGAGAGCCAATAA
>TTN-213,ENSE00003801753,1,303,2585425,2585727,CTGTACCAGAGCGTCCTGAAGACCTGGAAGTCAAAGAAGTTACTAAAAATACTGTAACTTTGACTTGGAATCCTCCTAAGTATGATGGTGGGTCAGAAATTATTAACTATGTCCTAGAAAGTCGGCTCATTGGGACTGAGAAGTTCCACAAAGTTACAAATGACAACTTGCTTAGCAGAAAATACACTGTTAAAGGCTTAAAAGAAGGTGATACCTATGAGTACCGTGTCAGTGCTGTCAACATTGTTGGACAAGGCAAACCATCATTTTGCACCAAACCAATTACTTGCAAGGATGAGCTGG
>TTN-213,ENSE00003807039,1,282,2585728,2586009,CACCCCCAACGCTTCACCTCGACTTCAGAGATAAGCTCACGATTCGAGTTGGTGAAGCTTTTGCCCTCACTGGCCGTTACTCAGGCAAACCAAAGCCTAAGGTTTCCTGGTTCAAAGATGAAGCTGATGTGCTGGAAGATGATCGCACTCATATAAAGACTACACCAGCAACACTTGCTTTAGAGAAGATCAAGGCCAAACGTTCAGATTCCGGCAAATACTGTGTGGTTGTGGAGAACAGTACAGGCTCTAGGAAAGGTTTCTGTCAAGTTAATGTTGTTG
>TTN-213,ENSE00003804106,1,300,2586010,2586309,ACCGTCCTGGACCACCAGTAGGACCAGTTAGTTTTGATGAGGTGACCAAAGATTACATGGTTATCTCTTGGAAGCCTCCTTTAGATGATGGAGGCAGTAAAATCACCAATTATATTATTGAGAAGAAGGAAGTGGGTAAAGACGTCTGGATGCCAGTGACATCTGCAAGTGCTAAAACAACATGCAAAGTTTCTAAACTACTTGAAGGAAAAGATTATATTTTCCGGATACATGCTGAAAATCTGTATGGAATAAGTGATCCTCTGGTGTCTGATTCAATGAAAGCCAAAGATCGTTTCA
>TTN-213,ENSE00003801817,1,303,2586310,2586612,GGGTTCCTGATGCACCTGATCAGCCAATTGTTACAGAAGTTACCAAAGACTCTGCATTAGTAACCTGGAATAAGCCACATGATGGAGGAAAACCCATCACAAACTACATCCTGGAAAAGAGAGAAACTATGTCTAAACGATGGGCTAGAGTTACCAAAGATCCTATTCATCCATACACTAAATTTAGGGTTCCTGATCTTCTAGAAGGATGTCAGTATGAATTCCGGGTTTCTGCAGAAAATGAAATTGGTATTGGAGATCCAAGCCCACCATCCAAACCAGTCTTTGCTAAAGATCCAATTG
>TTN-213,ENSE00003810564,1,309,2586613,2586921,CTAAACCAAGTCCACCTGTTAATCCTGAAGCAATAGATACAACATGCAATTCAGTCGATCTAACTTGGCAGCCACCACGTCATGATGGTGGGAGCAAGATTCTGGGTTATATTGTTGAGTACCAGAAAGTTGGAGATGAAGAGTGGAGAAGAGCCAATCACACCCCTGAGTCATGTCCTGAAACTAAATATAAAGTCACCGGTCTTCGGGACGGTCAAACCTATAAGTTTAGAGTGTTAGCAGTCAATGCAGCTGGTGAATCAGATCCAGCTCATGTTCCGGAGCCAGTCCTAGTAAAAGACAGGCTTG
>TTN-213,ENSE00003807476,1,282,2586922,2587203,AACCCCCTGAGTTGATTCTTGATGCCAACATGGCAAGAGAACAACACATTAAAGTTGGTGATACTCTAAGACTTAGTGCCATCATCAAAGGAGTGCCATTCCCAAAAGTAACTTGGAAAAAAGAAGACAGAGATGCTCCAACTAAAGCAAGAATTGATGTGACTCCAGTTGGTAGCAAGCTTGAAATTCGTAATGCTGCCCATGAAGATGGTGGAATTTATTCTTTAACAGTGGAGAATCCAGCTGGTTCAAAAACTGTCTCAGTAAAAGTACTTGTATTAG
>TTN-213,ENSE00003807363,1,300,2587204,2587503,ATAAACCTGGGCCACCTAGAGATCTGGAAGTCAGTGAAATTAGGAAAGATTCATGTTACCTTACTTGGAAAGAACCACTGGATGATGGTGGTTCTGTTATTACCAATTATGTGGTTGAGAGGAGAGATGTTGCCAGCGCCCAGTGGTCACCTCTCTCAGCTACATCAAAGAAAAAGAGTCACTTCGCTAAGCATCTGAATGAAGGCAACCAGTACCTCTTCCGAGTAGCTGCGGAGAACCAGTATGGACGTGGTCCTTTTGTTGAAACACCAAAACCAATCAAGGCTTTGGATCCTCTCC
>TTN-213,ENSE00003808994,1,294,2587504,2587797,ATCCCCCAGGGCCACCCAAGGACCTGCACCATGTAGATGTTGACAAGACTGAAGTCTCCCTAGTCTGGAATAAGCCGGATCGTGATGGTGGTTCTCCAATCACTGGATATTTGGTAGAATATCAAGAAGAAGGCACCCAGGACTGGATTAAATTTAAGACTGTGACAAACTTAGAGTGTGTGGTTACTGGACTACAACAAGGAAAGACCTATAGATTCCGTGTAAAAGCTGAAAACATTGTGGGTCTTGGTCTCCCTGACACAACTATCCCGATAGAATGTCAAGAAAAACTAG
>TTN-213,ENSE00003810188,1,2967,2587798,2590764,TGCCTCCATCCGTGGAGCTAGATGTGAAATTAATTGAAGGTCTTGTGGTAAAGGCTGGAACCACAGTCAGATTCCCTGCTATTATAAGAGGTGTGCCTGTTCCTACTGCAAAGTGGACAACCGATGGGAGTGAGATTAAAACCGATGAGCACTACACAGTTGAAACAGACAACTTCTCATCAGTACTTACCATTAAGAACTGCTTAAGGAGAGACACTGGGGAATATCAAATCACAGTTTCCAATGCAGCCGGTAGCAAAACAGTAGCCGTACATCTTACTGTTCTTGATGTTCCTGGGCCACCAACAGGTCCTATTAATATTCTGGATGTTACTCCTGAACACATGACTATCTCATGGCAGCCACCTAAGGATGATGGAGGAAGCCCTGTGATAAATTATATTGTTGAGAAACAAGATACAAGGAAAGACACGTGGGGTGTTGTCTCTTCCGGAAGCAGTAAGACAAAGCTGAAAATCCCACATCTGCAGAAGGGCTGTGAATATGTTTTCCGAGTTAGAGCAGAGAATAAGATAGGTGTTGGTCCTCCCCTTGACTCCACACCTACTGTTGCTAAGCATAAATTTAGTCCTCCGTCTCCTCCTGGTAAACCAGTGGTTACTGACATTACTGAAAATGCAGCAACAGTGTCTTGGACCCTGCCAAAATCTGATGGTGGCAGTCCAATAACTGGCTACTATATGGAACGTCGAGAAGTAACTGGCAAATGGGTGAGGGTCAACAAAACACCTATCGCTGACCTGAAGTTCAGAGTGACTGGACTCTATGAAGGAAATACATATGAGTTTAGAGTTTTTGCTGAAAATCTTGCAGGACTAAGCAAACCATCCCCAAGTTCTGATCCAATAAAAGCTTGCCGGCCCATCAAACCACCTGGACCACCTATTAATCCTAAACTGAAAGACAAGAGCAGAGAAACAGCTGATTTGGTGTGGACAAAGCCTCTCAGTGATGGTGGTAGCCCCATTCTAGGATATGTAGTGGAATGTCAGAAACCTGGCACAGCACAATGGAACAGGATTAATAAAGATGAACTCATTAGGCAATGTGCCTTTAGGGTACCTGGACTAATTGAAGGAAATGAGTACAGATTCCGTATAAAGGCAGCTAATATTGTAGGAGAGGGTGAGCCAAGAGAACTAGCAGAATCTGTGATTGCAAAAGATATCCTTCATCCTCCAGAAGTAGAACTTGATGTTACTTGTCGTGATGTTATTACCGTGAGAGTAGGCCAAACTATCCGCATTCTAGCTCGAGTCAAAGGCAGACCTGAACCAGACATAACTTGGACTAAGGAAGGCAAAGTATTGGTCCGAGAAAAGAGGGTGGACCTTATTCAGGATCTACCTCGTGTTGAGTTACAAATTAAAGAAGCTGTTAGAGCTGATCATGGCAAGTATATCATCTCAGCTAAGAACAGCAGTGGACATGCCCAAGGTTCAGCCATCGTTAACGTCCTTGACAGACCTGGGCCTTGCCAGAATTTGAAGGTTACCAATGTAACCAAAGAGAACTGTACAATTTCTTGGGAAAACCCACTAGATAATGGTGGCTCAGAAATAACAAACTTCATAGTAGAATATCGCAAACCAAACCAGAAAGGCTGGTCAATTGTTGCATCAGATGTCACTAAACGATTAATCAAGGCCAACCTTTTAGCCAACAATGAATACTATTTCCGAGTTTGTGCAGAGAATAAAGTAGGTGTTGGGCCAACCATCGAAACAAAAACTCCCATTCTGGCTATTAACCCTATTGACAGACCAGGTGAGCCTGAAAACCTTCACATTGCAGATAAAGGAAAGACATTTGTCTATCTAAAGTGGCGGAGGCCTGACTATGATGGTGGCAGTCCAAATCTGTCATATCATGTTGAGAGAAGGCTTAAGGGCTCCGATGACTGGGAAAGAGTGCATAAAGGAAGCATTAAAGAAACTCACTACATGGTTGACAGATGTGTTGAAAACCAGATTTATGAGTTCAGAGTGCAAACAAAGAATGAAGGTGGGGAAAGTGACTGGGTGAAGACAGAGGAAGTTGTTGTGAAAGAAGACTTACAAAAACCAGTACTTGATCTGAAATTAAGTGGGGTCCTAACTGTCAAAGCAGGGGACACCATTAGGCTTGAGGCAGGGGTTAGAGGCAAACCATTCCCAGAAGTTGCATGGACCAAGGACAAAGACGCTACAGACTTAACAAGATCACCAAGGGTCAAGATTGATACCCGTGCTGATTCATCTAAATTTTCTCTTACTAAAGCAAAGCGAAGTGATGGGGGTAAATATGTAGTTACGGCAACTAACACGGCTGGCAGTTTTGTGGCCTATGCCACTGTCAATGTTTTAGATAAGCCTGGTCCTGTGAGAAATCTGAAAATTGTTGATGTGTCCAGTGATAGGTGTACTGTTTGCTGGGATCCACCAGAAGATGATGGTGGCTGTGAAATCCAAAATTATATTCTAGAAAAATGTGAGACAAAGCGAATGGTTTGGTCTACCTATTCTGCTACTGTCTTGACACCTGGTACTACAGTAACACGTCTCATAGAAGGAAATGAATATATTTTCAGAGTCCGTGCAGAAAATAAAATAGGCACAGGGCCTCCAACAGAAAGTAAACCAGTCATAGCCAAAACCAAGTATGATAAACCTGGTCGCCCTGATCCCCCAGAAGTCACTAAAGTAAGCAAAGAAGAGATGACTGTGGTTTGGAATCCACCTGAATATGATGGTGGAAAGTCTATAACTGGATACTTTTTGGAGAAAAAGGAAAAGCATTCAACACGATGGGTCCCTGTCAACAAGAGTGCAATCCCTGAGAGACGTATGAAAGTACAGAATCTCCTCCCAGACCATGAATATCAGTTCCGTGTCAAGGCAGAAAATGAAATTGGAATTGGAGAACCAAGCTTGCCTTCAAGACCGGTGGTGGCAAAAGACCCCATAG
>TTN-213,ENSE00003811401,1,321,2590765,2591085,AGCCACCTGGTCCACCAACCAATTTCAGAGTGGTTGATACAACCAAACATTCCATAACTCTTGGGTGGGGAAAACCAGTCTATGATGGTGGTGCACCGATCATTGGATATGTTGTGGAAATGAGACCAAAAATAGCAGATGCGTCTCCTGATGAAGGCTGGAAACGGTGTAATGCTGCAGCACAGCTTGTACGCAAGGAATTCACTGTTACCAGCTTGGATGAAAACCAGGAATATGAGTTCAGGGTGTGTGCCCAAAACCAAGTTGGTATTGGGCGCCCTGCAGAGCTAAAGGAAGCTATCAAACCTAAAGAAATACTAG
>TTN-213,ENSE00003805661,1,285,2591086,2591370,AACCTCCGGAGATTGATTTGGATGCCAGCATGAGGAAACTGGTCATAGTGAGAGCAGGATGCCCTATTCGTCTCTTTGCTATAGTGAGAGGACGACCAGCCCCTAAAGTCACTTGGCGAAAAGTTGGCATTGATAATGTGGTCAGAAAAGGACAAGTTGATCTGGTTGACACTATGGCCTTCCTTGTCATCCCCAATTCTACCCGTGATGACTCAGGAAAATATTCCTTAACACTTGTGAACCCAGCAGGAGAAAAGGCTGTATTCGTAAATGTCAGAGTATTAG
>TTN-213,ENSE00003804742,1,300,2591371,2591670,ACACTCCTGGGCCTGTGTCTGATTTAAAAGTTTCAGATGTCACTAAAACATCATGCCATGTGTCCTGGGCCCCTCCTGAAAACGACGGTGGGAGCCAAGTGACACATTATATCGTGGAGAAACGTGAGGCAGACAGAAAGACATGGTCGACCGTTACCCCAGAAGTTAAGAAAACAAGCTTCCATGTAACCAATCTTGTCCCTGGGAATGAGTATTACTTCAGAGTAACTGCTGTCAACGAATATGGCCCTGGCGTCCCAACAGATGTCCCAAAACCAGTGCTTGCATCAGATCCTCTAA
>TTN-213,ENSE00003810357,1,303,2591671,2591973,GTGAGCCGGATCCCCCAAGGAAATTAGAAGTGACTGAAATGACCAAGAACAGTGCCACCTTAGCCTGGTTACCTCCCCTACGTGATGGAGGTGCTAAAATCGATGGCTACATCACTAGTTACAGAGAAGAAGAGCAGCCTGCAGATCGCTGGACAGAGTACTCAGTGGTAAAAGATCTGAGCCTTGTTGTCACTGGCCTAAAGGAAGGAAAGAAATACAAATTTAGAGTAGCGGCCAGAAATGCTGTTGGAGTCAGTTTGCCAAGAGAAGCTGAAGGAGTGTATGAAGCCAAAGAACAACTGT
>TTN-213,ENSE00003801707,1,276,2591974,2592249,TGCCACCAAAGATCCTTATGCCAGAGCAAATAACTATCAAAGCTGGGAAAAAACTCCGAATTGAAGCCCATGTGTATGGAAAGCCTCATCCCACCTGTAAATGGAAAAAAGGAGAAGATGAAGTTGTCACATCCAGCCACCTGGCAGTGCATAAAGCAGACAGCTCTTCAATTCTGATCATAAAAGATGTGACTAGGAAAGACAGTGGTTACTACAGCCTCACAGCAGAGAACAGTTCTGGGACAGACACTCAGAAAATCAAAGTTGTAGTCATGG
>TTN-213,ENSE00003810399,1,300,2592250,2592549,ATGCCCCCGGCCCCCCTCAGCCTCCATTTGACATTTCTGATATAGACGCTGATGCTTGCTCCCTGTCATGGCACATCCCTCTGGAGGACGGAGGCAGTAACATCACCAATTATATAGTGGAGAAGTGTGATGTAAGCCGAGGTGACTGGGTCACGGCTCTAGCTTCAGTCACAAAAACTTCCTGCAGGGTTGGAAAGCTGATCCCAGGCCAGGAGTACATCTTCCGGGTCCGTGCTGAAAACCGATTTGGCATTTCAGAGCCTCTCACATCTCCAAAGATGGTTGCGCAGTTCCCATTTG
>TTN-213,ENSE00003810448,1,303,2592550,2592852,GTGTTCCTAGTGAACCAAAGAATGCACGAGTCACCAAAGTCAACAAGGACTGTATTTTTGTTGCTTGGGACAGACCAGATAGTGATGGAGGGAGCCCCATTATTGGTTATCTGATTGAACGCAAGGAAAGAAACAGTTTGCTGTGGGTGAAAGCCAATGATACTCTTGTCCGGTCAACTGAATATCCTTGTGCTGGCCTTGTAGAAGGTCTTGAGTATTCATTCAGAATCTATGCCCTAAACAAAGCTGGATCCAGCCCACCCAGCAAACCCACAGAATATGTAACTGCAAGAATGCCAGTTG
>TTN-213,ENSE00003802505,1,300,2592853,2593152,ATCCTCCTGGGAAACCTGAGGTTATTGATGTCACCAAGAGTACTGTATCTCTGATCTGGGCTCGTCCAAAGCATGATGGAGGCAGTAAAATTATTGGCTATTTCGTAGAAGCTTGCAAACTTCCTGGTGATAAATGGGTACGGTGCAATACTGCACCTCACCAGATTCCCCAGGAAGAGTACACAGCTACTGGCCTAGAAGAGAAAGCTCAGTATCAATTTAGAGCTATTGCCAGGACCGCGGTAAACATTAGCCCACCTTCTGAACCTTCTGATCCAGTGACTATCCTCGCAGAAAATG
>TTN-213,ENSE00003806397,1,288,2593153,2593440,TCCCTCCCAGGATAGACCTGAGTGTGGCTATGAAATCTTTGCTTACTGTGAAAGCTGGAACTAATGTCTGCTTGGATGCTACTGTTTTTGGTAAACCGATGCCAACAGTTTCTTGGAAAAAAGATGGCACACTGCTAAAACCAGCAGAAGGCATAAAGATGGCCATGCAGCGGAATCTGTGCACCTTGGAGCTATTCAGCGTGAACCGGAAGGACTCAGGAGACTATACCATTACTGCTGAAAATTCAAGTGGTTCTAAATCAGCCACCATTAAGCTTAAAGTGTTAG
>TTN-213,ENSE00003807889,1,297,2593441,2593737,ATAAACCGGGTCCTCCAGCATCTGTTAAAATCAACAAAATGTATTCAGATCGTGCTATGCTTTCTTGGGAACCGCCTCTTGAAGATGGAGGCTCAGAAATCACCAACTATATTGTTGACAAACGTGAAACAAGCAGGCCCAACTGGGCTCAAGTCTCTGCAACTGTGCCTATCACCAGCTGCAGCGTGGAGAAACTTATAGAGGGCCATGAGTATCAGTTCCGTATTTGTGCTGAAAATAAATATGGAGTAGGCGATCCAGTCTTCACTGAACCAGCAATTGCCAAAAACCCATATG
>TTN-213,ENSE00003811290,1,303,2593738,2594040,ACCCACCAGGACGCTGTGATCCTCCTGTTATTAGCAACATAACCAAAGATCACATGACAGTCAGCTGGAAGCCACCAGCAGATGATGGGGGCTCACCCATCACTGGCTATTTGCTTGAAAAGCGGGAAACCCAGGCTGTTAACTGGACTAAGGTCAACAGAAAACCTATTATAGAAAGAACATTAAAAGCAACAGGTCTTCAAGAAGGTACCGAATATGAGTTCCGTGTTACAGCTATAAATAAAGCTGGACCAGGCAAACCCAGTGACGCATCCAAGGCCGCTTATGCTCGGGACCCTCAGT
>TTN-213,ENSE00003808853,1,306,2594041,2594346,ATCCTCCTGGCCCACCGGCTTTCCCTAAAGTATATGATACAACTCGCAGCTCTGTGAGTCTATCTTGGGGCAAGCCAGCCTATGACGGCGGCAGCCCTATCATTGGTTATCTCGTTGAAGTAAAACGGGCTGACTCCGATAACTGGGTGAGGTGCAACTTACCACAGAATCTACAGAAAACCCGCTTTGAGGTTACTGGCCTGATGGAAGACACACAATATCAATTCCGTGTGTATGCCGTTAATAAGATTGGATACAGTGACCCCAGTGATGTGCCAGATAAACACTATCCCAAGGACATCTTAA
>TTN-213,ENSE00003807542,1,288,2594347,2594634,TTCCACCTGAGGGAGAACTTGATGCGGACTTAAGGAAGACACTCATATTACGTGCTGGAGTTACTATGAGACTATATGTACCAGTAAAAGGACGCCCACCTCCAAAGATTACTTGGTCTAAACCAAATGTCAATCTAAGAGACAGGATTGGACTGGACATAAAGTCAACTGACTTTGACACTTTCTTGCGCTGTGAAAATGTGAACAAATATGATGCAGGAAAATATATCTTAACCCTGGAGAACAGCTGTGGTAAAAAGGAATATACCATTGTTGTGAAAGTGCTTG
>TTN-213,ENSE00003810775,1,291,2594635,2594925,ATACTCCTGGGCCACCTGTCAATGTGACTGTTAAGGAAATATCCAAAGACTCTGCTTATGTTACCTGGGAGCCTCCCATTATTGATGGCGGAAGCCCCATCATAAACTATGTGGTACAAAAACGTGATGCAGAGAGGAAATCCTGGTCTACAGTGACAACTGAGTGCTCCAAAACAAGCTTCAGAGTAGCTAATTTGGAGGAGGGAAAATCCTACTTCTTCCGAGTGTTTGCTGAAAATGAGTATGGCATTGGTGATCCCGGTGAAACTCGTGATGCTGTCAAAGCTTCCC
>TTN-213,ENSE00003811210,1,288,2594926,2595213,AAACTCCTGGACCAGTTGTGGACCTGAAAGTGAGGTCTGTATCTAAGTCATCCTGTAGCATTGGCTGGAAAAAGCCTCACAGTGATGGTGGAAGTCGGATTATTGGATATGTAGTTGATTTCCTGACTGAAGAAAATAAGTGGCAACGAGTTATGAAATCCTTAAGCCTACAGTACTCTGCAAAAGATTTGACTGAAGGGAAGGAATATACCTTCAGAGTGAGTGCTGAGAATGAAAATGGAGAAGGAACCCCAAGCGAAATCACTGTTGTGGCAAGGGATGATGTTG
>TTN-213,ENSE00003805436,1,588,2595214,2595801,TGGCTCCTGATCTTGACTTAAAGGGTCTACCTGATTTGTGCTACTTGGCTAAAGAAAACAGCAACTTCCGGCTTAAGATCCCCATAAAAGGCAAGCCAGCTCCATCAGTCTCCTGGAAGAAAGGGGAAGATCCTCTAGCAACTGACACTAGAGTCAGTGTTGAGTCATCTGCGGTTAACACAACTCTTATAGTGTACGATTGCCAAAAATCTGATGCTGGAAAATACACAATCACACTTAAGAATGTTGCTGGCACCAAGGAAGGAACTATCTCCATAAAGGTTGTTGGCAAGCCTGGCATCCCCACTGGACCAATCAAATTTGATGAAGTCACAGCAGAAGCCATGACCTTAAAGTGGGCTCCTCCAAAGGATGATGGAGGTTCTGAAATCACCAACTATATCCTAGAGAAGAGGGATTCTGTGAACAACAAGTGGGTGACGTGCGCCTCAGCTGTCCAGAAAACCACCTTTAGAGTAACCAGACTTCATGAGGGCATGGAATATACCTTCAGGGTCAGTGCCGAAAATAAATATGGTGTAGGGGAAGGCCTGAAATCGGAGCCAATTGTTGCGAGACATCCATTTG
>TTN-213,ENSE00003808777,1,105,2595802,2595906,ATGTGCCTGATGCTCCCCCACCTCCCAATATTGTGGATGTCAGACACGATTCAGTATCTCTAACTTGGACTGACCCCAAGAAAACTGGTGGTTCTCCAATTACAG
>TTN-213,ENSE00003806939,1,198,2595907,2596104,GGTATCATCTCGAGTTCAAGGAAAGAAACAGCCTTTTGTGGAAGAGAGCTAACAAGACTCCGATAAGGATGAGAGACTTTAAAGTGACAGGATTAACTGAAGGTCTTGAATATGAATTCCGAGTTATGGCAATCAATTTAGCAGGTGTGGGCAAGCCAAGCCTACCATCAGAGCCTGTTGTGGCACTGGACCCAATTG
>TTN-213,ENSE00003811024,1,297,2596105,2596401,ATCCTCCTGGAAAACCTGAGGTTATTAACATAACAAGGAATTCAGTGACTCTCATTTGGACTGAACCTAAATATGACGGTGGTCATAAGTTAACTGGATATATAGTGGAGAAGCGAGATCTACCTTCGAAGTCTTGGATGAAAGCCAACCATGTTAATGTCCCAGAATGTGCCTTTACTGTAACTGACCTTGTTGAGGGTGGAAAATATGAATTCAGAATTAGAGCAAAGAATACAGCAGGTGCTATCAGTGCTCCATCAGAAAGTACAGAAACCATTATTTGCAAGGATGAATACG
>TTN-213,ENSE00003803896,1,588,2596402,2596989,AGGCACCAACAATTGTCCTTGATCCCACAATAAAAGATGGGCTAACAATTAAAGCAGGGGATACCATTGTTTTGAATGCCATTAGCATTCTTGGCAAACCCCTTCCAAAATCAAGTTGGTCCAAGGCAGGAAAAGACATTAGACCATCAGATATCACTCAGATAACTTCAACCCCAACATCTTCCATGCTTACTATCAAGTATGCCACTAGAAAAGATGCGGGTGAATATACCATCACTGCTACCAATCCTTTTGGCACGAAGGTGGAACATGTGAAGGTAACAGTCCTTGATGTACCTGGTCCCCCAGGTCCTGTTGAAATCAGTAATGTTTCTGCTGAAAAAGCAACACTTACATGGACACCTCCCTTGGAAGATGGCGGCTCACCAATTAAGTCCTATATACTTGAAAAGAGAGAAACCAGCCGACTTTTGTGGACAGTGGTTTCTGAAGATATTCAGTCTTGCAGGCATGTGGCAACCAAACTTATCCAAGGAAATGAGTACATCTTCCGGGTCTCAGCTGTAAACCACTATGGCAAAGGAGAACCTGTACAGTCTGAACCTGTCAAAATGGTAGACAGATTTG
>TTN-213,ENSE00003807419,1,303,2596990,2597292,GTCCCCCTGGCCCTCCTGAAAAACCAGAGGTATCAAATGTCACTAAGAACACTGCCACTGTCAGCTGGAAAAGGCCAGTGGATGATGGTGGCAGCGAAATTACAGGATATCATGTAGAAAGGAGAGAAAAGAAAAGCCTGCGATGGGTGAGAGCAATAAAAACACCAGTTTCCGATCTCAGGTGCAAAGTAACAGGACTGCAAGAAGGAAGCACCTACGAATTCCGTGTCAGTGCAGAAAACAGAGCAGGAATTGGTCCACCCAGTGAGGCTTCAGATTCTGTTCTGATGAAAGATGCAGCAT
>TTN-213,ENSE00003811193,1,17106,2597293,2614398,ATCCTCCAGGACCACCTTCAAATCCGCATGTCACTGATACTACCAAGAAATCTGCTTCTTTGGCATGGGGCAAGCCTCATTATGATGGTGGACTTGAAATCACTGGCTATGTCGTGGAGCATCAAAAAGTAGGAGACGAGGCCTGGATAAAAGATACCACAGGAACCGCCCTCAGAATCACTCAGTTCGTTGTTCCTGATCTTCAGACTAAAGAAAAATACAACTTCAGAATCAGTGCCATCAACGATGCAGGTGTTGGGGAGCCAGCGGTGATTCCAGATGTTGAAATCGTAGAACGGGAGATGGCTCCTGATTTTGAACTAGATGCCGAGCTTCGAAGAACACTTGTTGTTAGAGCAGGACTCAGTATTAGGATATTTGTGCCAATTAAAGGTCGTCCTGCTCCTGAAGTGACATGGACCAAAGATAACATCAACCTGAAAAACCGAGCCAACATTGAAAATACGGAATCATTTACTCTTCTGATTATCCCAGAATGTAACAGATATGATACCGGTAAATTTGTCATGACCATTGAAAACCCGGCTGGGAAGAAAAGTGGCTTTGTGAACGTCAGAGTCTTGGACACGCCAGGCCCAGTCCTCAACCTGCGGCCTACAGACATCACAAAGGACAGTGTCACCCTGCACTGGGACCTCCCTCTGATAGATGGAGGCTCACGTATAACAAACTACATTGTAGAGAAACGTGAAGCAACACGGAAATCTTATTCCACAGCCACCACTAAGTGCCATAAATGCACATATAAAGTTACCGGCTTGTCTGAAGGGTGTGAATATTTCTTCAGAGTGATGGCAGAGAATGAATATGGAATTGGTGAGCCAACAGAAACTACAGAGCCCGTAAAAGCCTCTGAAGCACCATCTCCACCAGACAGCCTTAACATCATGGACATAACTAAGAGCACCGTCAGCCTGGCATGGCCTAAGCCCAAACACGATGGTGGCAGCAAGATCACTGGCTATGTGATTGAAGCCCAAAGAAAAGGCTCTGACCAGTGGACCCACATCACAACCGTGAAAGGGTTAGAATGTGTTGTGAGGAATCTAACTGAAGGAGAGGAATATACCTTCCAAGTGATGGCAGTGAACAGCGCGGGGAGAAGTGCCCCTAGAGAAAGCAGACCCGTCATTGTCAAGGAGCAGACAATGCTTCCAGAGCTGGATCTCCGTGGCATCTATCAGAAACTGGTCATTGCCAAAGCTGGTGACAACATCAAAGTTGAAATTCCAGTGCTCGGTCGACCGAAGCCCACAGTGACATGGAAAAAAGGAGACCAAATTCTTAAACAGACACAGAGAGTTAATTTTGAAACCACAGCGACTTCAACCATTTTAAATATCAATGAGTGTGTCAGAAGTGATAGTGGGCCCTATCCATTAACAGCAAGGAACATTGTAGGAGAGGTTGGTGATGTCATCACCATTCAAGTCCATGATATCCCAGGGCCACCTACTGGACCAATCAAATTTGATGAAGTTTCATCTGATTTTGTAACCTTCTCTTGGGACCCACCTGAGAACGATGGTGGTGTACCAATAAGCAACTATGTAGTGGAAATGCGGCAGACTGACAGTACTACCTGGGTTGAGTTAGCAACCACCGTTATACGTACTACCTATAAAGCCACCCGCCTTACTACTGGATTAGAGTATCAGTTCCGTGTAAAAGCTCAGAATAGATATGGAGTTGGACCAGGCATCACATCAGCATGCATAGTTGCCAACTATCCATTTAAGGTTCCTGGACCTCCTGGTACCCCTCAGGTAACTGCAGTTACCAAGGATTCAATGACAATTAGCTGGCATGAGCCACTTTCTGATGGTGGAAGCCCCATTTTAGGATATCATGTTGAAAGAAAAGAACGAAATGGTATTCTCTGGCAGACTGTGAGCAAAGCTTTAGTACCAGGCAACATTTTCAAATCAAGTGGACTTACAGATGGTATTGCTTATGAGTTCCGGGTGATTGCAGAAAACATGGCAGGCAAAAGTAAGCCAAGCAAGCCATCAGAACCTATGTTGGCTCTGGATCCCATTGACCCACCTGGAAAACCAGTACCTCTAAATATTACAAGACACACAGTAACACTTAAATGGGCTAAGCCTGAATATACTGGGGGCTTTAAAATTACCAGTTATATCGTTGAAAAGAGAGACCTTCCTAATGGACGGTGGCTGAAGGCCAACTTCAGCAACATTTTGGAGAATGAATTTACAGTCAGTGGCCTAACAGAAGATGCTGCATATGAATTCCGTGTGATCGCCAAAAATGCTGCAGGTGCCATCAGTCCACCATCTGAGCCATCTGATGCTATCACTTGCAGGGATGATGTTGAGGCACCAAAGATAAAGGTGGATGTTAAATTTAAGGACACGGTTATATTAAAAGCAGGTGAAGCATTCAGACTGGAAGCTGATGTTTCAGGCCGCCCACCTCCAACAATGGAATGGAGCAAAGATGGAAAAGAGCTGGAAGGCACAGCAAAGTTAGAAATAAAAATTGCAGATTTCTCTACTAATCTGGTAAACAAAGATTCAACAAGAAGGGATAGTGGTGCCTATACCCTTACAGCGACTAATCCTGGTGGCTTTGCTAAACACATTTTCAATGTCAAAGTTCTTGACAGACCAGGCCCACCTGAAGGACCTTTGGCTGTAACTGAAGTGACATCAGAAAAGTGTGTACTATCATGGTTCCCTCCACTGGATGATGGAGGTGCCAAAATTGATCATTACATAGTACAGAAACGTGAAACCAGCAGATTGGCATGGACAAATGTAGCCTCAGAAGTCCAAGTAACAAAGCTAAAGGTCACTAAACTCTTGAAAGGCAATGAATACATATTCCGTGTCATGGCTGTAAATAAATATGGAGTGGGAGAGCCACTGGAATCAGAGCCTGTGCTTGCAGTGAATCCTTATGGACCCCCTGATCCGCCCAAAAACCCTGAAGTGACAACTATTACTAAAGATTCGATGGTTGTCTGCTGGGGACATCCTGATTCTGATGGTGGAAGTGAAATCATCAATTATATTGTGGAACGGCGTGATAAAGCTGGCCAACGCTGGATTAAATGCAACAAAAAAACTCTTACTGATTTAAGATATAAAGTGTCTGGACTGACAGAAGGACATGAATATGAGTTCAGGATTATGGCTGAAAATGCTGCTGGAATTAGTGCACCAAGTCCTACCAGTCCATTTTACAAGGCTTGTGACACTGTGTTTAAACCTGGACCACCAGGTAACCCACGTGTTCTGGATACAAGCAGATCATCCATTTCAATCGCTTGGAATAAACCTATCTATGATGGTGGTTCAGAAATCACTGGGTATATGGTTGAGATTGCCCTGCCAGAGGAAGATGAATGGCAGATTGTCACTCCACCAGCAGGACTCAAGGCAACTTCGTATACTATCACTGGCCTCACAGAGAATCAGGAATATAAGATCCGCATCTATGCCATGAATTCCGAAGGACTTGGGGAACCTGCCCTTGTTCCTGGAACTCCAAAGGCTGAAGACAGAATGCTGCCTCCAGAAATTGAACTGGATGCTGACCTGCGCAAAGTTGTTACTATAAGGGCCTGCTGCACCCTGAGACTTTTTGTTCCCATCAAAGGAAGGCCTGCACCTGAGGTGAAGTGGGCCCGGGACCATGGAGAATCTTTAGATAAAGCTAGCATCGAATCCACAAGCTCTTACACCCTGCTTATTGTTGGAAATGTAAACAGATTTGACAGTGGCAAATATATACTAACTGTAGAAAATAGTTCAGGCAGCAAGTCTGCATTTGTCAATGTTAGAGTTCTCGATACACCAGGCCCCCCACAGGATCTGAAGGTAAAAGAGGTCACTAAGACATCTGTCACACTCACATGGGACCCACCTCTCCTTGATGGAGGTTCAAAAATCAAGAACTATATTGTTGAAAAGCGGGAATCAACAAGAAAAGCATATTCAACTGTTGCAACAAACTGCCACAAGACTTCCTGGAAGGTAGACCAGCTTCAAGAAGGCTGTAGCTACTATTTCAGGGTTCTCGCAGAAAATGAATATGGCATTGGGCTGCCTGCTGAAACCGCAGAATCTGTGAAAGCATCAGAACGACCTCTTCCTCCAGGAAAAATAACTTTGATGGATGTCACAAGAAATAGTGTGTCACTCTCTTGGGAGAAACCAGAGCATGATGGAGGCAGCCGAATTCTAGGCTACATTGTGGAGATGCAGACCAAAGGCAGTGACAAATGGGCCACGTGTGCCACAGTCAAGGTCACTGAAGCCACTATCACTGGATTAATTCAGGGTGAAGAATACTCTTTCCGTGTTTCAGCTCAGAATGAAAAGGGCATCAGTGATCCTAGACAACTGAGTGTGCCAGTGATCGCCAAAGATCTTGTCATTCCACCAGCCTTCAAACTCCTGTTCAATACTTTCACTGTACTGGCAGGTGAAGACCTAAAAGTTGATGTTCCATTCATTGGCCGCCCTACCCCAGCTGTAACCTGGCATAAAGATAATGTACCACTGAAGCAGACAACTAGAGTAAATGCAGAGAGCACAGAAAATAATTCACTACTGACAATAAAGGACGCCTGCCGAGAAGATGTTGGCCATTATGTGGTTAAACTGACTAACTCAGCTGGTGAAGCTATTGAAACCCTTAATGTTATCGTTCTTGACAAACCAGGGCCTCCAACTGGACCAGTTAAAATGGATGAAGTGACAGCTGATAGTATTACTCTTTCCTGGGGCCCACCCAAGTATGATGGTGGAAGTTCTATCAATAATTACATTGTTGAGAAACGGGACACTTCCACAACCACCTGGCAAATTGTATCAGCTACAGTTGCAAGGACAACAATAAAGGCTTGCAGACTGAAGACTGGATGTGAATATCAGTTTAGAATTGCAGCTGAAAACAGATATGGGAAGAGTACCTACCTCAATTCAGAGCCTACTGTAGCCCAATATCCATTCAAAGTTCCTGGTCCTCCTGGCACTCCAGTTGTCACACTGTCCTCCAGGGACAGCATGGAAGTACAATGGAATGAGCCAATCAGTGATGGAGGAAGTAGAGTCATTGGCTATCATCTAGAACGCAAGGAAAGAAATAGCATCCTCTGGGTTAAGTTGAATAAAACACCTATTCCTCAAACCAAGTTTAAGACAACTGGCCTTGAAGAAGGTGTTGAATATGAATTTAGAGTCTCTGCAGAGAACATCGTGGGCATTGGCAAGCCGAGTAAAGTATCAGAATGTTATGTGGCTCGTGACCCATGTGATCCACCAGGACGGCCAGAGGCAATCATTGTCACAAGGAATTCTGTGACTCTTCAGTGGAAGAAACCCACCTATGACGGTGGAAGCAAGATCACTGGTTATATTGTTGAGAAGAAAGAATTACCTGAGGGCCGTTGGATGAAAGCCAGTTTTACAAATATTATTGACACTCATTTTGAAGTAACTGGCCTAGTTGAAGATCACAGATATGAGTTCCGGGTTATAGCCCGAAATGCCGCAGGAGTGTTTAGTGAGCCTTCAGAAAGCACAGGAGCAATAACAGCTAGAGATGAGGTAGATCCACCACGAATAAGTATGGATCCAAAATACAAAGACACAATCGTGGTTCATGCTGGTGAATCATTCAAGGTTGATGCAGATATTTATGGCAAACCAATACCAACCATTCAGTGGATAAAAGGTGATCAGGAGCTTTCAAACACAGCTCGATTAGAAATAAAGAGCACCGACTTTGCCACCAGTCTCAGTGTAAAAGATGCAGTACGTGTCGACAGTGGAAATTACATACTGAAGGCCAAAAATGTTGCAGGAGAAAGATCAGTTACTGTGAATGTCAAGGTTCTTGACAGACCAGGGCCACCTGAAGGACCTGTTGTTATCTCAGGAGTTACAGCAGAAAAATGCACACTAGCTTGGAAACCCCCACTTCAGGATGGTGGGAGTGACATCATAAATTATATTGTGGAAAGGAGAGAAACCAGCCGCTTAGTTTGGACTGTGGTTGATGCCAATGTGCAGACTCTCAGCTGCAAGGTTACTAAGCTTCTTGAAGGCAATGAATATACTTTCCGTATAATGGCAGTAAACAAATATGGTGTTGGTGAACCTCTTGAATCTGAGCCAGTAGTTGCCAAGAATCCATTTGTAGTACCAGATGCACCAAAAGCTCCAGAAGTCACAACAGTGACCAAGGACTCAATGATTGTTGTATGGGAAAGACCAGCATCTGATGGTGGTAGTGAAATTCTTGGATATGTTCTTGAGAAACGGGATAAAGAAGGCATTAGATGGACAAGATGCCATAAGCGTCTGATTGGAGAGTTGCGCCTGAGAGTAACTGGACTCATAGAAAATCACGATTATGAGTTCAGAGTTTCTGCTGAGAATGCTGCTGGACTTAGTGAACCAAGCCCTCCTTCTGCTTACCAAAAGGCTTGTGATCCTATTTATAAACCAGGACCCCCAAACAACCCCAAAGTCATAGACATAACCAGATCTTCAGTATTCCTTTCTTGGAGCAAACCAATATATGATGGTGGCTGTGAAATTCAAGGATACATTGTTGAAAAATGTGATGTGAGTGTTGGTGAATGGACAATGTGCACTCCACCAACAGGAATTAATAAAACAAACATAGAAGTAGAGAAGCTGTTGGAAAAGCATGAATACAACTTCCGTATCTGTGCTATTAATAAAGCTGGAGTTGGAGAACATGCTGACGTCCCTGGACCTATTATAGTTGAAGAAAAATTAGAAGCACCAGACATTGATCTTGACCTAGAACTAAGGAAAATCATAAATATAAGGGCAGGTGGCTCCTTAAGGTTATTTGTTCCTATAAAAGGTCGTCCTACACCAGAAGTTAAATGGGGAAAGGTGGATGGTGAAATCCGAGATGCAGCTATAATTGATGTCACTAGCAGTTTCACCTCTCTTGTTCTTGACAATGTCAACCGATATGATAGTGGAAAATATACGCTTACATTAGAAAACAGCAGTGGAACAAAGTCTGCCTTTGTTACTGTGAGAGTTCTGGACACGCCAAGTCCACCTGTTAACCTGAAAGTCACAGAAATCACCAAAGACTCAGTATCAATTACATGGGAACCTCCTTTGTTGGATGGGGGATCCAAAATAAAAAATTACATTGTTGAGAAACGTGAAGCCACAAGAAAATCATATGCTGCTGTTGTAACTAACTGCCATAAGAATTCTTGGAAAATCGATCAGCTCCAAGAAGGTTGCAGTTATTACTTTAGAGTCACAGCTGAGAATGAGTATGGTATTGGCCTTCCTGCCCAGACTGCTGATCCAATTAAGGTTGCAGAAGTGCCACAACCTCCTGGAAAAATAACTGTGGATGATGTCACCAGAAACAGTGTCTCTCTGAGTTGGACAAAACCTGAACATGATGGTGGCAGTAAAATCATTCAGTATATTGTGGAAATGCAAGCTAAACACAGTGAGAAATGGTCAGAGTGTGCTCGAGTAAAGTCTCTTCAGGCAGTAATTACCAACCTAACTCAAGGGGAAGAATATCTTTTTAGAGTTGTTGCTGTAAATGAAAAGGGGAGAAGTGATCCTCGGTCCCTTGCAGTTCCAATAGTTGCCAAAGATCTGGTAATTGAGCCAGATGTAAAACCTGCATTCAGTAGTTACAGTGTACAGGTTGGCCAAGATTTGAAAATAGAAGTGCCAATTTCTGGACGTCCTAAGCCAACCATTACCTGGACTAAAGATGGTCTCCCACTGAAGCAGACCACAAGAATCAATGTTACCGATTCACTGGATCTCACCACACTCAGTATTAAAGAAACTCATAAGGATGATGGTGGACAATATGGAATCACAGTTGCCAATGTTGTTGGTCAGAAGACAGCATCCATCGAAATTGTAACTCTAGATAAACCTGATCCTCCAAAAGGACCTGTTAAATTTGATGACGTCAGTGCTGAAAGTATTACATTATCTTGGAACCCTCCATTATATACAGGGGGCTGCCAAATCACCAACTACATTGTTCAGAAAAGAGATACAACCACCACAGTATGGGATGTTGTTTCTGCTACTGTTGCTAGAACTACACTCAAAGTGACCAAACTGAAAACTGGTACAGAATACCAATTTAGAATATTTGCCGAAAACAGATATGGACAAAGCTTTGCCTTAGAGTCTGATCCAATTGTAGCTCAATATCCCTACAAAGAACCAGGCCCTCCAGGTACACCATTTGCCACAGCCATTTCCAAAGACTCCATGGTCATACAGTGGCATGAACCAGTCAACAATGGTGGAAGCCCCGTCATAGGTTACCACCTGGAGAGAAAAGAAAGAAACAGTATTTTGTGGACAAAGGTCAACAAAACTATTATTCATGACACCCAATTCAAAGCACAGAATCTTGAAGAAGGCATTGAATATGAATTCAGAGTGTATGCTGAAAATATTGTTGGTGTAGGCAAAGCAAGCAAGAATTCTGAATGCTATGTAGCCAGAGATCCCTGTGACCCACCAGGAACCCCAGAACCAATAATGGTTAAAAGAAATGAAATCACTTTACAGTGGACCAAACCTGTGTATGATGGTGGAAGTATGATTACAGGCTACATTGTAGAGAAACGTGATTTGCCTGATGGTCGTTGGATGAAAGCTAGCTTTACAAATGTCATTGAAACTCAATTTACTGTGTCAGGTCTTACTGAAGATCAAAGATATGAATTCAGAGTCATTGCAAAGAATGCAGCTGGTGCAATAAGTAAACCCTCTGACAGTACTGGACCAATAACTGCCAAGGATGAGGTTGAACTCCCAAGAATTTCAATGGATCCAAAATTCAGAGACACAATTGTGGTAAATGCTGGAGAAACATTCAGACTTGAGGCTGATGTCCATGGAAAGCCCCTACCTACCATTGAGTGGTTAAGAGGAGATAAGGAAATTGAAGAATCTGCTAGATGTGAAATAAAGAACACAGATTTCAAGGCTTTACTTATTGTAAAAGATGCAATTAGAATTGATGGTGGGCAGTATATTTTAAGAGCTTCCAATGTTGCAGGTTCTAAGTCATTCCCAGTAAATGTAAAAGTATTAGATAGACCAGGACCTCCAGAAGGGCCAGTCCAGGTTACTGGAGTCACTTCTGAAAAATGCTCTTTAACATGGTCTCCACCACTTCAAGATGGTGGCAGTGACATTTCTCACTATGTTGTTGAAAAGCGAGAAACCAGTCGACTTGCCTGGACTGTTGTTGCTTCAGAAGTTGTGACCAATTCTCTGAAAGTTACCAAACTCTTAGAAGGTAATGAATATGTTTTCCGTATAATGGCTGTCAACAAATATGGTGTTGGAGAGCCTTTGGAATCTGCACCAGTACTAATGAAAAATCCATTTGTGCTTCCTGGACCACCAAAAAGCTTGGAAGTCACAAATATTGCCAAAGACTCCATGACCGTCTGTTGGAACCGTCCAGATAGTGATGGTGGAAGTGAGATTATTGGTTACATTGTAGAGAAAAGAGACAGAAGTGGCATTCGATGGATAAAATGTAATAAACGCCGCATTACAGATTTGCGTCTAAGAGTGACAGGATTAACAGAAGATCATGAGTATGAATTCAGGGTCTCTGCAGAAAATGCTGCTGGAGTTGGGGAACCAAGTCCAGCTACAGTTTATTATAAAGCCTGTGATCCTGTGTTCAAACCTGGCCCACCTACCAATGCACACATTGTAGACACCACTAAAAATTCAATCACACTTGCCTGGGGTAAACCCATCTATGATGGCGGCAGTGAGATCTTGGGATATGTAGTAGAAATCTGTAAAGCAGATGAAGAAGAATGGCAAATAGTTACTCCACAGACTGGCCTGAGAGTCACTCGATTTGAAATTTCAAAACTCACTGAACACCAAGAGTATAAAATACGAGTCTGTGCCCTCAACAAAGTTGGTTTAGGTGAGGCTACATCAGTTCCTGGTACTGTGAAACCAGAAGATAAACTTGAAGCACCTGAACTTGACCTTGACTCCGAATTAAGAAAAGGAATTGTTGTAAGAGCTGGTGGATCTGCCAGAATTCACATTCCATTCAAAGGTCGTCCAACGCCTGAGATCACTTGGTCTCGAGAGGAAGGTGAATTCACAGATAAGGTCCAAATTGAAAAGGGAGTAAACTATACCCAACTATCAATAGATAACTGTGATAGAAATGATGCTGGAAAATACATTCTTAAGTTGGAAAACAGCAGTGGATCAAAGTCTGCTTTTGTAACTGTGAAAGTTCTTGACACTCCAGGACCACCACAGAATTTGGCAGTCAAAGAAGTGAGAAAAGATTCTGCCTTCCTGGTATGGGAGCCACCCATCATTGATGGAGGGGCAAAGGTCAAGAACTATGTGATTGACAAACGTGAGTCAACCAGAAAAGCGTATGCTAATGTGAGTAGTAAATGCAGCAAAACAAGTTTTAAAGTGGAAAACCTTACAGAAGGAGCCATTTATTACTTCAGAGTCATGGCTGAAAATGAATTTGGAGTTGGTGTTCCAGTGGAAACTGTTGATGCCGTGAAAGCTGCTGAACCTCCTTCCCCACCAGGAAAGGTTACACTCACTGATGTGTCCCAGACCAGTGCATCACTTATGTGGGAGAAACCTGAACATGATGGCGGTAGCAGAGTCCTGGGGTACGTTGTTGAAATGCAGCCCAAAGGAACTGAAAAATGGAGCATTGTGGCTGAATCCAAAGTCTGTAATGCAGTTGTTACTGGTTTGAGTTCTGGACAAGAATATCAGTTCCGTGTCAAGGCTTATAATGAGAAAGGAAAAAGCGATCCAAGAGTGTTGGGTGTTCCTGTCATAGCCAAGGACTTGACTATACAGCCTAGTTTAAAGTTACCATTTAACACATATAGTATCCAAGCTGGAGAAGATCTTAAAATAGAAATTCCAGTTATAGGCCGACCAAGACCTAACATTTCTTGGGTCAAAGATGGTGAGCCTCTTAAACAGACAACAAGAGTAAACGTTGAAGAAACAGCTACCTCAACTGTTTTGCACATTAAAGAAGGTAACAAAGATGACTTTGGAAAATACACCGTAACGGCAACAAATAGTGCAGGCACAGCAACAGAAAATCTCAGTGTTATCGTTTTAGAAAAGCCTGGACCTCCAGTTGGCCCAGTTCGGTTTGATGAAGTTAGTGCAGACTTTGTAGTCATATCTTGGGAACCTCCAGCCTATACTGGTGGCTGCCAAATAAGCAACTACATTGTAGAGAAGCGAGATACAACCACCACCACTTGGCACATGGTATCAGCAACAGTTGCAAGAACAACAATTAAAATAACCAAACTGAAAACAGGCACGGAGTACCAGTTTAGAATTTTTGCTGAAAACAGGTATGGAAAAAGTGCCCCACTGGATTCTAAGGCAGTTATTGTACAATATCCATTTAAAGAACCTGGACCACCTGGAACTCCTTTTGTGACATCAATCTCAAAAGATCAGATGCTTGTGCAATGGCATGAGCCAGTGAATGATGGAGGCACCAAAATTATTGGCTACCATCTTGAACAGAAAGAAAAGAACAGTATTTTATGGGTCAAGTTAAATAAGACCCCCATTCAGGACACCAAATTCAAAACAACTGGGCTTGATGAGGGCCTTGAGTATGAGTTCAAAGTTTCTGCTGAAAATATTGTTGGCATTGGCAAGCCTAGCAAAGTGTCAGAATGCTTTGTTGCTCGTGATCCATGTGACCCACCTGGTCGCCCTGAAGCCATTGTTATTACAAGAAACAATGTCACACTGAAATGGAAGAAACCTGCCTATGATGGTGGTAGCAAAATAACAGGTTATATTGTAGAAAAGAAAGATCTACCTGATGGCCGCTGGATGAAAGCCAGCTTTACCAACGTATTAGAAACTGAATTTACAGTGAGTGGACTTGTAGAAGACCAAAGATATGAATTTAGAGTAATTGCAAGAAATGCAGCTGGAAACTTTAGTGAACCATCTGATAGTAGTGGTGCCATTACTGCAAGAGATGAAATTGATGCACCAAATGCCTCTCTGGATCCAAAATATAAAGATGTCATCGTTGTTCATGCAGGAGAGACTTTTGTTCTTGAAGCCGACATCCGTGGCAAACCTATACCTGATGTTGTTTGGTCAAAAGATGGAAAAGAACTTGAAGAAACAGCTGCTAGAATGGAAATTAAATCTACTATTCAGAAAACAACTCTTGTTGTCAAAGACTGTATACGGACTGATGGAGGACAATATATTCTGAAACTCAGCAATGTTGGTGGTACAAAGTCTATACCCATCACTGTAAAGGTACTTGACAGGCCAGGGCCTCCTGAAGGGCCTCTGAAAGTTACTGGAGTTACTGCGGAAAAATGTTACCTGGCATGGAACCCACCTTTGCAAGATGGTGGTGCTAATATTTCACATTACATCATTGAAAAGAGGGAGACAAGCCGACTCTCTTGGACCCAGGTTTCAACTGAGGTACAGGCCCTTAACTACAAAGTTACTAAACTTCTTCCTGGTAATGAGTACATTTTCCGTGTCATGGCTGTGAATAAATATGGAATTGGAGAGCCCTTGGAATCTGGGCCTGTTACGGCCTGTAATCCTTATAAGCCACCAGGTCCTCCCTCAACACCTGAAGTCTCAGCAATCACCAAAGATTCTATGGTAGTAACATGGGCACGCCCAGTAGACGACGGAGGTACCGAAATTGAGGGCTACATTCTTGAAAAACGAGATAAGGAAGGCGTTAGATGGACCAAGTGCAACAAGAAAACATTAACGGATCTGCGGCTCAGGGTAACTGGTCTTACCGAAGGCCATTCCTATGAATTCAGAGTTGCTGCTGAAAATGCAGCTGGTGTGGGAGAACCTAGTGAGCCATCTGTTTTCTACCGTGCGTGTGATGCCTTGTATCCACCAGGTCCCCCAAGCAATCCAAAAGTGACGGACACTTCCAGATCTTCTGTCTCCCTGGCATGGAGTAAGCCAATTTATGATGGTGGCGCACCTGTTAAAGGCTATGTTGTAGAGGTCAAAGAAGCTGCTGCGGATGAATGGACAACCTGCACTCCACCAACAGGATTACAAGGAAAGCAGTTCACAGTGACCAAGCTTAAAGAAAACACTGAATATAACTTCCGTATTTGTGCCATCAATTCTGAAGGTGTAGGTGAACCTGCAACTCTACCTGGCTCAGTGGTTGCTCAGGAGAGGATAGAGCCACCAGAAATAGAACTCGATGCTGATCTCAGAAAGGTGGTCGTTCTGCGTGCAAGTGCTACTTTACGCTTATTTGTCACTATCAAAGGTCGACCAGAACCCGAAGTTAAATGGGAAAAGGCAGAAGGCATTCTCACTGACAGGGCTCAGATAGAGGTGACCAGCTCATTTACAATGTTGGTGATTGATAATGTTACCAGATTTGACAGTGGTCGGTATAATCTGACATTAGAAAATAATAGTGGCTCCAAAACAGCTTTTGTTAACGTCAGAGTTCTTGACTCACCAAGTGCCCCTGTGAATTTGACCATAAGAGAAGTGAAGAAAGACTCAGTGACGTTGTCCTGGGAACCACCACTTATTGATGGTGGAGCTAAGATTACAAACTACATTGTCGAAAAACGAGAAACTACAAGAAAAGCCTATGCTACCATTACAAATAATTGCACTAAAACTACTTTCAGAATTGAAAATCTACAAGAAGGATGTTCTTACTACTTCCGAGTCTTGGCTTCCAATGAATATGGGATTGGTTTGCCAGCTGAAACAACAGAACCCGTTAAAGTGTCTGAACCACCCCTCCCACCTGGAAGAGTAACTCTTGTTGATGTGACCCGTAATACAGCTACAATTAAGTGGGAGAAACCAGAAAGTGATGGTGGCAGCAAAATTACTGGTTATGTGGTTGAAATGCAGACTAAAGGGAGTGAAAAGTGGAGCACCTGCACACAAGTTAAGACTCTAGAAGCAACTATATCTGGCTTAACTGCAGGAGAAGAGTATGTCTTCAGGGTAGCTGCAGTTAACGAAAAGGGAAGAAGTGATCCAAGACAACTTGGAGTGCCAGTAATTGCAAGGGATATTGAAATAAAGCCTTCAGTTGAGCTTCCTTTCCATACTTTCAATGTAAAGGCTAGAGAACAACTTAAGATTGATGTGCCATTCAAAGGAAGACCTCAAGCTACTGTGAACTGGAGAAAAGATGGTCAGACTCTTAAAGAGACAACTAGAGTCAATGTTTCTTCTTCAAAGACTGTAACATCACTATCTATTAAGGAAGCTTCAAAGGAAGATGTTGGAACTTATGAATTATGTGTTTCAAACAGTGCTGGATCCATAACAGTTCCTATTACTATAATTGTCCTTGACAGACCAGGACCTCCAGGTCCTATACGTATTGATGAGGTTAGTTGTGACAGCATAACCATTTCTTGGAATCCTCCAGAATATGATGGTGGCTGCCAAATTAGCAATTACATTGTTGAAAAGAAAGAAACCACCTCTACAACATGGCACATAGTTTCACAAGCAGTTGCAAGAACATCCATTAAAATAGTTCGCCTGACAACAGGAAGTGAGTATCAGTTCCGTGTTTGTGCAGAAAACCGCTATGGAAAGAGCTCCTACAGTGAATCTTCAGCTGTTGTTGCAGAGTATCCATTCAGTCCCCCAGGTCCTCCTGGTACTCCTAAAGTTGTGCATGCCACAAAATCTACCATGCTTGTAACCTGGCAAGTGCCAGTTAATGATGGAGGAAGTCGAGTAATTGGCTATCATCTTGAGTATAAAGAAAGAAGCAGCATTCTTTGGTCAAAAGCAAATAAAATCCTCATTGCTGATACTCAAATGAAAGTCTCCGGCCTTGATGAAGGACTGATGTATGAGTATCGTGTATATGCTGAAAATATTGCTGGAATTGGTAAATGCAGTAAATCTTGTGAACCAGTCCCTGCAAGAGATCCTTGTGACCCTCCTGGACAACCTGAAGTCACAAATATCACAAGAAAATCAGTGTCACTTAAATGGTCTAAACCACATTATGATGGTGGAGCTAAGATCACAGGATACATTGTTGAACGCAGAGAACTACCAGATGGCCGGTGGCTGAAGTGCAATTATACTAATATACAAGAAACATACTTTGAAGTAACTGAACTTACTGAAGATCAGCGTTATGAATTCCGGGTTTTTGCAAGGAATGCTGCTGACTCAGTTAGTGAGCCATCTGAATCCACTGGGCCTATTATAGTTAAAGATGATGTTGAGCCTCCAAGAGTTATGATGGATGTCAAGTTCCGAGACGTTATTGTTGTCAAAGCTGGAGAGGTCCTTAAGATAAATGCAGACATTGCAGGGCGACCTCTGCCAGTAATTTCCTGGGCCAAGGATGGTATAGAAATTGAAGAAAGAGCAAGAACAGAAATCATCTCAACAGACAATCATACTTTGTTAACAGTTAAAGACTGTATAAGACGAGACACTGGGCAATATGTACTAACACTGAAGAATGTTGCCGGCACTCGGTCTGTGGCCGTTAATTGCAAAGTACTTGATAAGCCTGGTCCACCAGCAGGACCACTTGAAATAAATGGCCTCACTGCTGAGAAATGCTCTCTTTCCTGGGGACGTCCCCAAGAAGATGGTGGTGCAGATATCGACTATTACATCGTAGAAAAACGTGAAACAAGCCACCTTGCATGGACAATATGTGAAGGAGAGTTACAGATGACATCCTGTAAAGTAACCAAGTTACTCAAAGGCAATGAATATATATTTAGAGTAACTGGTGTTAATAAATATGGTGTTGGTGAGCCCCTAGAGAGTGTAGCTATAAAGGCACTAGATCCATTTACAGTTCCAAGTCCACCCACGTCTTTGGAAATTACTTCTGTGACCAAAGAATCTATGACACTTTGCTGGTCAAGACCCGAGAGTGATGGAGGTAGTGAAATATCTGGATATATAATTGAAAGGCGAGAGAAAAATAGCCTAAGATGGGTGCGTGTAAACAAAAAACCAGTTTATGATCTAAGAGTGAAATCAACAGGACTTCGGGAAGGATGTGAATATGAATATCGTGTTTATGCAGAAAATGCTGCTGGCCTAAGTCTTCCAAGTGAAACCTCTCCCTTAATTAGGGCAGAAGATCCAGTGTTCCTACCATCTCCTCCATCCAAACCCAAAATTGTGGACTCAGGCAAGACAACTATAACTATTGCCTGGGTTAAGCCGCTGTTTGATGGTGGGGCCCCGATAACTGGATATACTGTAGAATACAAAAAATCTGATGACACTGACTGGAAAACTTCCATTCAGAGCTTACGAGGGACAGAATATACAATAAGCGGACTAACAACAGGAGCTGAATATGTTTTCAGAGTAAAATCTGTCAATAAGGTTGGTGCTAGTGACCCCAGTGATAGCTCTGACCCTCAGATAGCAAAGGAAAGAGAAGAAGAACCTTTATTTGATATTGACAGTGAAATGAGGAAGACCTTGATTGTCAAGGCTGGTGCCTCATTTACCATGACTGTGCCTTTCCGAGGAAGACCAGTACCCAATGTCTTGTGGAGTAAGCCAGACACTGACCTCCGTACTAGAGCTTATGTTGATACCACAGACTCTCGTACATCACTGACCATTGAAAATGCCAACAGAAATGACTCTGGAAAGTACACATTAACAATTCAGAATGTTTTGAGTGCTGCTTCACTGACCTTAGTTGTCAAAGTTTTAGATACCCCAGGTCCTCCAACCAACATTACTGTGCAAGATGTAACCAAAGAGTCTGCAGTGTTATCCTGGGATGTTCCTGAAAACGATGGTGGAGCACCAGTGAAGAATTACCACATAGAAAAACGTGAGGCCAGCAAGAAAGCATGGGTCTCTGTGACCAACAACTGTAACCGCCTCTCCTACAAAGTTACCAATTTACAAGAAGGAGCTATCTATTACTTCAGAGTCTCTGGAGAAAATGAGTTTGGTGTTGGTATACCAGCTGAAACAAAGGAAGGAGTAAAAATAACAG
>TTN-213,ENSE00003802597,1,297,2614399,2614695,AAAAACCAAGCCCACCTGAAAAACTTGGAGTAACAAGTATATCCAAAGACAGTGTTTCCCTGACCTGGCTGAAGCCTGAACATGATGGCGGAAGCAGAATTGTACACTATGTCGTTGAAGCACTAGAAAAAGGACAGAAAAACTGGGTTAAATGTGCAGTGGCAAAGTCAACCCATCACGTTGTTTCCGGTCTGAGAGAGAATTCTGAATACTTTTTCCGAGTGTTTGCTGAAAATCAAGCTGGCCTGAGTGACCCGAGAGAGCTTCTGCTTCCTGTTCTTATTAAGGAGCAACTAG
>TTN-213,ENSE00003802941,1,588,2614696,2615283,AACCACCTGAAATTGATATGAAGAATTTCCCAAGTCACACTGTATATGTTAGAGCTGGTTCAAACCTTAAAGTTGACATTCCAATCTCTGGAAAACCACTTCCCAAAGTGACCTTATCAAGAGATGGTGTCCCCCTTAAGGCAACCATGAGATTTAATACCGAAATTACTGCTGAGAACCTGACCATCAATCTCAAAGAAAGTGTTACAGCTGACGCTGGGAGATATGAAATCACTGCTGCCAACTCCAGTGGTACAACCAAAGCTTTCATTAACATTGTTGTGCTAGACAGGCCTGGTCCTCCAACTGGCCCTGTTGTTATTAGTGATATAACTGAAGAAAGTGTGACTCTCAAATGGGAGCCACCTAAGTATGACGGTGGAAGTCAAGTTACCAACTACATTCTACTCAAAAGAGAAACAAGTACTGCAGTGTGGACTGAAGTGTCTGCAACAGTTGCAAGAACCATGATGAAAGTCATGAAACTGACCACAGGAGAAGAATACCAATTCCGCATCAAGGCAGAAAACCGCTTTGGCATCAGTGATCATATAGATTCAGCTTGTGTGACTGTCAAACTACCATACA
>TTN-213,ENSE00003808789,1,303,2615284,2615586,CAACACCTGGACCACCATCTACACCATGGGTCACTAATGTTACTCGAGAAAGCATCACTGTGGGCTGGCATGAACCAGTGTCAAATGGAGGCAGTGCAGTCGTAGGCTATCACCTGGAAATGAAAGACAGAAACAGTATTTTATGGCAAAAAGCCAACAAACTGGTCATCCGCACAACTCACTTCAAAGTCACAACAATCAGTGCTGGACTTATTTATGAATTCAGGGTGTATGCAGAAAATGCTGCTGGAGTTGGAAAACCTAGCCATCCTTCTGAACCAGTCTTGGCAATTGATGCTTGTG
>TTN-213,ENSE00003806587,1,297,2615587,2615883,AACCCCCAAGAAATGTTCGTATCACTGATATTTCAAAGAACTCTGTCAGCCTTTCATGGCAACAACCAGCTTTCGATGGAGGTAGCAAGATTACAGGCTACATTGTTGAGAGACGTGACCTTCCAGATGGCAGATGGACCAAGGCCAGCTTCACCAATGTTACTGAAACTCAATTCATCATCTCTGGCTTGACTCAGAATTCCCAGTATGAATTCCGTGTCTTTGCTAGGAATGCTGTTGGTTCCATTAGCAATCCATCTGAGGTTGTAGGGCCCATTACTTGCATCGATTCTTATG
>TTN-213,ENSE00003807681,1,288,2615884,2616171,GTGGTCCTGTAATTGATTTGCCTCTAGAATATACAGAAGTTGTCAAATACAGAGCAGGTACATCTGTGAAGCTCAGAGCTGGCATTTCTGGCAAACCTGCGCCTACTATTGAGTGGTATAAAGATGATAAAGAATTACAAACCAATGCACTGGTGTGTGTTGAAAATACCACGGACCTCGCATCTATACTCATCAAAGATGCCGATCGCCTTAATAGTGGATGCTATGAATTAAAACTAAGGAATGCCATGGGCTCAGCCTCAGCCACCATCAGAGTACAGATCCTTG
>TTN-213,ENSE00003811102,1,300,2616172,2616471,ACAAACCAGGCCCACCTGGTGGACCAATTGAATTTAAGACTGTAACTGCTGAGAAGATCACCCTTCTCTGGCGGCCTCCAGCTGATGATGGTGGTGCAAAAATCACTCACTACATTGTGGAAAAGCGTGAGACAAGCCGCGTTGTGTGGTCTATGGTGTCTGAACATTTGGAAGAGTGCATCATTACAACCACCAAAATTATCAAAGGAAATGAATACATCTTCCGGGTCCGAGCCGTGAACAAATATGGAATTGGCGAGCCACTGGAATCTGATTCCGTTGTAGCCAAGAACGCATTTG
>TTN-213,ENSE00003802386,1,303,2616472,2616774,TTACACCTGGGCCACCAGGCATACCAGAAGTGACAAAGATTACCAAGAATTCGATGACTGTTGTATGGAGCAGGCCAATTGCAGATGGCGGTAGTGATATAAGTGGCTATTTCCTTGAAAAACGAGACAAGAAGAGCCTAGGATGGTTTAAAGTACTAAAAGAGACTATCCGTGACACCAGACAAAAAGTAACAGGACTCACAGAAAACAGTGACTATCAATACAGAGTTTGTGCTGTAAACGCTGCTGGACAGGGTCCATTTTCTGAACCATCTGAATTCTACAAAGCTGCTGATCCTATTG
>TTN-213,ENSE00003809908,1,306,2616775,2617080,ATCCTCCAGGTCCACCTGCTAAGATAAGAATCGCAGATTCAACCAAGTCATCCATCACCCTTGGCTGGAGTAAGCCTGTCTATGATGGGGGCAGTGCTGTTACTGGGTATGTTGTCGAGATAAGACAAGGAGAGGAAGAGGAATGGACTACTGTCTCTACCAAAGGAGAGGTCAGAACTACAGAATATGTGGTATCCAACCTGAAACCTGGAGTCAATTACTACTTCCGGGTATCTGCTGTAAACTGTGCTGGACAAGGAGAACCTATAGAAATGAATGAACCTGTACAAGCTAAAGATATACTTG
>TTN-213,ENSE00003808993,1,1767,2617081,2618847,AGGCACCAGAGATTGACCTGGATGTGGCTCTCAGAACTTCTGTTATTGCCAAAGCTGGTGAAGATGTACAAGTGTTGATTCCCTTTAAAGGCAGACCTCCACCTACTGTCACATGGAGAAAAGATGAGAAGAATCTTGGCAGTGATGCCAGATACAGCATTGAAAACACTGATTCATCCTCATTACTCACCATTCCTCAAGTTACTCGCAATGATACAGGAAAATATATTCTCACAATAGAAAATGGAGTTGGTGAACCTAAGTCTTCAACTGTGAGTGTTAAAGTGCTTGACACACCAGCTGCCTGCCAGAAACTACAGGTTAAACATGTTTCTCGAGGCACAGTCACTTTGCTCTGGGATCCTCCTCTCATTGATGGAGGATCTCCAATAATTAATTATGTCATTGAAAAGAGAGATGCCACCAAGAGAACATGGTCTGTCGTGTCACACAAATGTTCTAGCACATCCTTCAAGCTAATAGATTTGTCGGAGAAGACTCCATTCTTCTTCAGAGTTCTTGCAGAAAATGAAATTGGAATTGGGGAACCCTGTGAAACTACAGAGCCAGTGAAGGCTGCTGAAGTACCAGCTCCTATACGTGATCTCTCAATGAAAGACTCAACAAAGACATCTGTCATCCTCAGCTGGACCAAACCTGACTTTGATGGTGGTAGCGTCATCACAGAATATGTTGTAGAAAGGAAAGGTAAAGGTGAACAGACGTGGTCCCACGCTGGCATAAGTAAGACATGTGAAATTGAGGTTAGCCAACTTAAGGAGCAGTCAGTCCTGGAGTTCAGAGTGTTTGCCAAAAATGAGAAAGGACTGAGTGATCCTGTCACTATTGGGCCAATTACAGTGAAAGAACTTATTATTACACCTGAAGTTGACCTGTCAGATATCCCTGGGGCACAAGTCACTGTGAGAATTGGGCACAATGTGCACCTTGAATTACCTTATAAGGGAAAACCCAAACCATCCATCAGTTGGCTGAAAGATGGCTTGCCACTGAAAGAAAGTGAATTTGTTCGCTTCAGTAAAACTGAAAACAAAATTACTTTGAGTATTAAGAATGCCAAGAAGGAGCATGGAGGAAAATACACTGTTATTCTTGATAATGCAGTGTGTAGAATTGCAGTCCCCATTACAGTCATCACCCTTGGCCCACCATCAAAGCCCAAAGGACCCATTCGATTTGATGAAATCAAGGCTGATAGTGTCATCCTGTCATGGGATGTACCTGAAGATAATGGAGGAGGAGAAATTACTTGTTACAGCATCGAGAAGCGGGAAACTTCACAAACTAACTGGAAGATGGTGTGTTCAAGTGTTGCCAGAACGACTTTCAAAGTTCCTAATCTAGTCAAAGATGCTGAGTACCAGTTTAGAGTGAGAGCAGAAAACAGATACGGAGTCAGCCAACCACTTGTCTCAAGCATTATTGTGGCAAAACACCAGTTCAGGATTCCTGGTCCCCCAGGAAAGCCAGTTATATACAATGTGACTTCTGATGGCATGTCACTAACTTGGGATGCTCCAGTTTATGATGGTGGTTCAGAAGTTACTGGATTCCATGTTGAAAAGAAAGAAAGAAATAGCATCCTCTGGCAAAAAGTTAATACATCACCAATCTCTGGAAGAGAATATAGAGCCACTGGACTGGTAGAAGGTCTGGATTACCAATTCCGTGTATATGCTGAAAATTCTGCTGGCCTAAGCTCACCTAGTGACCCAAGCAAATTTACCTTAGCTGTTTCTCCAGTAG
>TTN-213,ENSE00003811205,1,294,2618848,2619141,ACCCACCTGGCACTCCTGACTACATTGATGTCACCCGGGAAACCATCACACTTAAATGGAACCCACCATTGCGTGATGGAGGCAGTAAGATTGTGGGCTATAGCATTGAGAAACGGCAAGGAAATGAACGCTGGGTGAGATGCAACTTTACTGACGTCAGTGAATGTCAGTACACAGTTACAGGACTCAGTCCTGGGGATCGCTATGAGTTCAGAATAATTGCAAGAAATGCTGTTGGAACTATAAGCCCGCCCTCACAGTCTTCTGGCATTATTATGACAAGAGATGAAAATG
>TTN-213,ENSE00003808021,1,288,2619142,2619429,TTCCACCAATAGTAGAGTTTGGCCCTGAATACTTTGATGGTCTCATTATTAAGTCCGGAGAGAGCCTTAGAATTAAAGCTTTGGTACAAGGAAGACCAGTGCCTCGAGTAACTTGGTTCAAAGATGGAGTGGAAATCGAAAAGAGGATGAATATGGAAATAACCGACGTACTTGGATCCACCAGCCTATTTGTTAGAGATGCTACTCGGGACCATCGTGGTGTATACACAGTGGAAGCCAAAAATGCATCTGGTTCTGCAAAAGCAGAAATTAAAGTGAAAGTACAAG
>TTN-213,ENSE00003804355,1,300,2619430,2619729,ATACACCAGGAAAAGTAGTTGGGCCAATAAGATTCACCAATATTACTGGGGAGAAGATGACTCTGTGGTGGGATGCCCCACTCAATGACGGTTGTGCTCCCATAACCCACTACATCATTGAAAAACGGGAAACCAGCAGACTTGCCTGGGCACTAATTGAGGATAAATGTGAAGCCCAAAGTTACACTGCCATTAAACTAATAAACGGCAATGAATACCAATTCCGTGTTTCTGCAGTTAACAAGTTTGGTGTTGGCAGGCCACTTGATTCTGATCCAGTGGTTGCTCAAATACAATATA
>TTN-213,ENSE00003807046,1,2067,2619730,2621796,CTGTTCCTGATGCCCCTGGCATTCCAGAACCTAGCAACATAACAGGCAACAGCATTACCCTGACATGGGCAAGGCCAGAATCAGATGGTGGCAGTGAAATTCAACAGTATATCCTTGAAAGAAGAGAAAAGAAAAGCACAAGATGGGTAAAAGTGATCAGCAAACGACCAATCTCTGAAACAAGATTCAAAGTCACTGGTCTGACAGAAGGCAATGAGTATGAATTCCATGTCATGGCTGAAAATGCTGCAGGAGTTGGACCTGCAAGTGGCATCTCAAGACTCATTAAATGTAGAGAGCCCGTCAACCCACCAGGTCCTCCCACAGTGGTCAAAGTAACAGACACATCAAAGACAACTGTGAGCTTAGAATGGTCCAAACCAGTGTTTGATGGTGGCATGGAAATAATTGGGTATATTATTGAAATGTGTAAGGCCGACTTAGGAGACTGGCACAAGGTGAATGCAGAGGCATGTGTGAAAACAAGATATACAGTCACTGATCTACAAGCAGGTGAAGAATACAAATTCCGAGTTAGTGCTATCAATGGTGCTGGAAAAGGCGACAGCTGTGAAGTGACTGGCACAATTAAAGCAGTTGACCGGTTAACAGCTCCTGAGTTAGACATAGATGCAAACTTCAAACAGACTCATGTTGTTAGAGCTGGGGCCAGTATTCGCCTCTTCATTGCCTACCAAGGTAGACCTACTCCTACAGCTGTGTGGAGCAAACCAGACTCTAACCTTAGCCTTCGGGCTGATATCCATACAACAGATTCCTTCAGCACCCTCACTGTGGAAAACTGCAACAGAAATGATGCAGGGAAATATACCCTTACTGTGGAAAACAACAGTGGTAGTAAGTCAATCACATTCACCGTGAAAGTGCTAGACACTCCAGGCCCACCTGGCCCAATTACCTTCAAAGATGTGACCCGGGGATCTGCTACATTGATGTGGGATGCCCCTCTTCTTGACGGTGGTGCCCGAATCCATCATTATGTGGTAGAGAAACGAGAGGCAAGTCGCCGTAGTTGGCAGGTTATCAGTGAAAAATGCACTCGTCAGATCTTCAAGGTCAATGACCTGGCCGAAGGTGTTCCGTACTATTTCCGTGTTTCTGCAGTAAATGAGTATGGTGTTGGTGAGCCCTATGAAATGCCAGAACCAATTGTAGCCACAGAACAGCCTGCTCCACCTAGGAGACTTGATGTTGTTGATACTAGCAAATCCTCCGCAGTCTTAGCTTGGCTTAAACCTGACCACGATGGAGGCAGCCGGATCACTGGCTACCTGCTTGAAATGAGACAAAAGGGATCTGACTTCTGGGTTGAAGCTGGTCACACCAAACAGCTAACTTTCACAGTAGAGCGTCTTGTTGAGAAAACTGAATATGAATTCCGTGTGAAGGCCAAGAATGATGCTGGCTATAGTGAACCCAGAGAAGCCTTCTCTTCTGTCATCATTAAGGAGCCTCAAATCGAGCCCACTGCTGACCTCACTGGAATTACCAATCAGCTTATAACTTGCAAAGCAGGAAGCCCATTTACCATTGACGTACCAATCAGTGGTCGTCCTGCCCCCAAAGTAACATGGAAACTGGAAGAAATGAGACTTAAAGAGACAGATCGAGTGAGCATTACAACAACAAAAGACAGAACCACACTGACTGTAAAGGACAGCATGAGAGGTGACTCTGGAAGATACTTCTTGACCCTGGAAAATACAGCTGGTGTTAAAACATTTAGCGTCACAGTTGTGGTCATTGGAAGGCCAGGTCCAGTAACCGGCCCCATTGAGGTCTCATCTGTCTCAGCTGAATCGTGTGTCCTGTCATGGGGAGAACCTAAAGATGGAGGAGGCACTGAAATTACTAATTACATAGTTGAAAAGCGTGAATCGGGTACAACAGCTTGGCAGCTTGTCAATTCCAGTGTCAAGCGCACTCAAATTAAAGTCACTCATCTCACAAAATACATGGAATATTCTTTCCGTGTCAGTTCAGAGAACAGATTTGGTGTCAGCAAACCTCTAGAATCAGCACCAATAATTGCTGAACATCCATTTG
>TTN-213,ENSE00003810611,1,303,2621797,2622099,TCCCACCAAGCGCTCCTACCAGACCTGAGGTCTACCATGTGTCTGCCAATGCCATGTCTATTCGTTGGGAAGAACCCTACCACGATGGTGGCAGTAAAATCATTGGCTACTGGGTTGAGAAGAAAGAACGTAATACAATTCTTTGGGTGAAAGAAAACAAAGTGCCATGCTTAGAGTGCAACTACAAAGTAACTGGTTTAGTAGAAGGACTGGAATATCAGTTCAGAACTTATGCACTCAATGCTGCAGGTGTTAGCAAGGCCAGCGAAGCTTCAAGACCTATAATGGCTCAAAATCCAGTTG
>TTN-213,ENSE00003803222,1,306,2622100,2622405,ATGCACCAGGCAGACCAGAGGTGACAGATGTCACAAGATCAACAGTATCACTGATTTGGTCTGCCCCAGCGTATGATGGAGGCAGCAAGGTTGTGGGCTACATCATAGAGCGTAAGCCAGTCAGTGAGGTAGGAGATGGTCGCTGGCTGAAGTGCAACTACACCATTGTATCTGACAATTTCTTCACCGTGACTGCTCTCAGTGAAGGAGACACTTATGAGTTCCGTGTGTTAGCCAAGAATGCAGCAGGCGTAATTAGCAAAGGGTCTGAATCTACAGGCCCTGTCACTTGCCGAGATGAATACG
>TTN-213,ENSE00003801213,1,291,2622406,2622696,CTCCACCCAAAGCCGAACTGGATGCCCGATTACACGGTGATCTGGTTACCATCAGAGCAGGTTCTGATCTTGTTCTGGATGCTGCAGTTGGTGGCAAACCTGAACCCAAAATTATCTGGACCAAAGGAGACAAGGAGCTAGATCTCTGTGAAAAAGTCTCTTTGCAGTATACTGGCAAACGAGCAACTGCTGTGATCAAGTTCTGTGACAGAAGTGACAGTGGAAAATACACTTTAACAGTGAAAAATGCCAGCGGGACCAAGGCCGTGTCTGTCATGGTCAAAGTGCTTG
>TTN-213,ENSE00003809128,1,297,2622697,2622993,ATTCCCCTGGCCCATGTGGAAAGCTCACCGTCAGCAGAGTAACACAGGAGAAGTGCACTTTAGCCTGGAGCCTTCCGCAGGAAGACGGAGGAGCAGAAATCACTCACTACATCGTGGAAAGACGCGAGACTAGCAGGCTCAACTGGGTGATTGTTGAAGGCGAATGCCCAACCCTATCCTATGTCGTTACCAGGCTCATCAAGAACAATGAGTACATATTCCGAGTGAGGGCAGTAAACAAATATGGCCCTGGTGTGCCTGTTGAATCAGAGCCAATTGTAGCCAGAAACTCATTCA
>TTN-213,ENSE00003803385,1,306,2622994,2623299,CTATTCCATCACCACCCGGCATACCTGAAGAAGTTGGGACTGGCAAAGAGCATATCATCATTCAGTGGACAAAACCTGAATCTGATGGTGGCAATGAAATCAGCAACTACCTAGTAGACAAACGTGAGAAGAAGAGCCTGCGCTGGACACGTGTCAACAAAGACTATGTGGTGTATGATACCAGGCTGAAGGTGACCAGCCTGATGGAGGGTTGTGATTACCAGTTCCGGGTGACCGCAGTGAATGCAGCTGGTAACAGTGAGCCCAGCGAAGCTTCCAACTTCATCTCATGCAGAGAACCATCAT
>TTN-213,ENSE00003807140,1,306,2623300,2623605,ATACCCCTGGACCACCTTCTGCTCCAAGAGTTGTGGATACCACCAAACACAGCATTAGTTTGGCATGGACCAAACCCATGTACGATGGTGGTACTGACATTGTAGGATATGTTCTGGAAATGCAAGAGAAGGACACTGATCAGTGGTACCGAGTGCATACCAATGCCACAATAAGAAATACTGAATTCACTGTGCCAGACCTTAAAATGGGCCAGAAATATTCCTTCAGAGTTGCTGCCGTGAACGTGAAGGGTATGAGCGAATACAGCGAATCAATTGCTGAAATTGAGCCCGTGGAAAGAATAG
>TTN-213,ENSE00003809946,1,282,2623606,2623887,AAATACCAGATCTTGAGCTTGCAGATGATCTAAAGAAGACTGTGACCATCAGGGCTGGGGCCTCCTTGCGCTTGATGGTGTCTGTATCTGGAAGACCACCTCCTGTCATAACGTGGAGCAAGCAGGGCATTGACCTTGCAAGCCGGGCAATTATTGACACCACTGAGAGCTACTCATTGCTAATAGTGGACAAAGTTAATCGGTACGATGCTGGAAAATACACAATTGAAGCTGAAAACCAATCTGGCAAGAAATCAGCAACAGTCCTTGTTAAAGTCTATG
>TTN-213,ENSE00003810384,1,594,2623888,2624481,ATACTCCTGGTCCCTGTCCTTCAGTGAAAGTTAAGGAAGTATCAAGAGATTCTGTGACTATAACTTGGGAAATTCCCACGATTGATGGTGGAGCTCCAGTCAACAATTACATCGTTGAGAAGCGTGAAGCTGCTATGAGAGCATTCAAAACAGTAACTACCAAATGCAGCAAGACACTTTACAGAATTTCTGGACTTGTAGAAGGAACCATGTACTATTTCAGAGTGCTGCCAGAAAATATTTATGGCATTGGAGAACCTTGTGAAACATCTGATGCAGTACTGGTCTCAGAAGTGCCTTTGGTGCCTGCAAAGCTAGAAGTGGTCGATGTCACCAAATCCACTGTTACCCTTGCCTGGGAAAAACCACTCTACGATGGTGGTAGCCGACTCACTGGATATGTTCTCGAGGCCTGCAAAGCTGGCACAGAGAGATGGATGAAGGTTGTCACCTTAAAACCCACAGTCCTAGAGCACACTGTTACTTCCTTAAATGAAGGTGAACAATACTTATTTAGAATAAGGGCACAAAATGAGAAAGGTGTGTCAGAACCAAGAGAGACTGTCACAGCCGTGACTGTACAAGACCTCAGAG
>TTN-213,ENSE00003802641,1,288,2624482,2624769,TGTTGCCAACAATCGATCTTTCTACAATGCCTCAGAAGACCATCCATGTCCCAGCTGGCAGACCAGTAGAGCTGGTGATACCTATTGCTGGCCGTCCACCTCCTGCTGCTTCCTGGTTCTTTGCTGGTTCTAAACTGAGAGAATCAGAGCGTGTCACAGTTGAAACTCACACTAAAGTAGCTAAATTAACCATCCGTGAAACCACTATCAGAGATACTGGAGAATACACACTTGAATTGAAGAATGTTACCGGAACTACTTCAGAAACCATTAAAGTTATCATTCTTG
>TTN-213,ENSE00003806194,1,300,2624770,2625069,ACAAGCCTGGTCCACCAACAGGACCTATTAAGATTGATGAAATTGATGCTACATCAATTACCATTTCCTGGGAACCACCTGAATTGGACGGTGGTGCTCCACTGAGTGGTTATGTGGTAGAACAACGTGACGCTCATCGTCCAGGATGGCTGCCCGTTTCTGAATCAGTGACTAGGTCCACGTTTAAGTTTACCAGACTCACCGAAGGAAATGAGTATGTGTTCCGTGTGGCTGCAACAAACCGCTTCGGGATTGGCTCTTACTTGCAGTCTGAGGTCATAGAGTGTCGCAGCAGCATCC
>TTN-213,ENSE00003805894,1,303,2625070,2625372,GTATTCCTGGACCCCCAGAAACATTACAGATATTTGATGTTTCCCGTGATGGCATGACACTTACTTGGTACCCACCAGAGGATGACGGTGGCTCCCAAGTGACTGGATATATTGTGGAGCGCAAAGAAGTGAGAGCAGATCGATGGGTCCGTGTAAATAAAGTACCTGTGACAATGACACGGTACCGCTCCACTGGCCTTACTGAAGGCTTAGAATATGAACACCGTGTCACAGCCATTAATGCAAGAGGGTCTGGGAAACCAAGTCGTCCTTCCAAACCCATCGTTGCCATGGATCCAATTG
>TTN-213,ENSE00003808643,1,303,2625373,2625675,CTCCTCCAGGAAAGCCACAAAACCCAAGAGTTACTGATACAACAAGGACATCAGTCTCCCTGGCCTGGAGTGTTCCAGAAGATGAAGGAGGATCTAAAGTCACAGGCTACTTGATTGAAATGCAAAAAGTAGATCAACATGAATGGACCAAGTGTAACACCACTCCAACCAAGATTCGAGAGTATACTCTAACACACCTACCTCAGGGTGCAGAATACAGGTTCCGCGTCCTAGCTTGTAATGCTGGTGGACCTGGTGAGCCTGCTGAGGTACCAGGAACAGTCAAAGTCACTGAAATGCTTG
>TTN-213,ENSE00003805779,1,585,2625676,2626260,AATATCCTGATTATGAACTTGATGAAAGATACCAAGAAGGTATCTTTGTAAGGCAAGGTGGCGTCATCAGACTTACCATACCAATCAAAGGAAAACCATTCCCAATATGTAAATGGACCAAGGAAGGCCAGGATATTAGTAAGCGTGCCATGATTGCAACATCTGAAACACACACTGAGCTTGTGATCAAAGAAGCAGACAGGGGTGATTCTGGCACTTATGACCTGGTTCTGGAAAATAAATGTGGCAAGAAGGCTGTCTACATCAAGGTCAGGGTGATAGGAAGTCCCAACAGTCCAGAAGGGCCACTGGAATATGATGACATCCAAGTCCGCTCTGTGAGGGTCAGCTGGAGACCTCCTGCTGATGATGGTGGTGCTGACATCTTAGGCTACATCCTCGAGAGACGAGAAGTGCCTAAAGCCGCCTGGTATACCATTGATTCCAGAGTCCGAGGTACATCTCTGGTGGTAAAAGGCCTCAAAGAGAATGTAGAATACCATTTCCGTGTTTCAGCAGAAAACCAGTTTGGCATAAGCAAACCCTTGAAATCTGAGGAACCAGTCACACCAAAAACACCATTGA
>TTN-213,ENSE00003806836,1,306,2626261,2626566,ATCCTCCAGAACCTCCAAGCAATCCTCCAGAAGTACTCGATGTAACCAAGAGTTCTGTTAGCTTGTCCTGGTCCCGGCCCAAAGATGATGGTGGTTCTAGAGTCACAGGCTACTACATCGAACGCAAAGAGACATCCACTGACAAGTGGGTCAGACACAACAAGACTCAGATCACCACCACAATGTACACTGTCACAGGGCTTGTTCCCGATGCTGAGTATCAGTTCCGCATCATCGCACAGAATGATGTTGGCCTGAGTGAGACCAGCCCTGCTTCTGAACCAGTTGTTTGCAAAGATCCATTTG
>TTN-213,ENSE00003810204,1,300,2626567,2626866,ATAAACCAAGCCAACCAGGAGAACTTGAGATTCTTTCAATATCCAAAGATAGTGTCACTCTACAGTGGGAGAAACCTGAATGTGATGGTGGTAAAGAAATTCTTGGATACTGGGTTGAATATAGACAGTCTGGAGACAGTGCCTGGAAGAAGAGCAATAAGGAACGTATTAAGGACAAGCAATTCACAATAGGAGGTTTGCTGGAAGCTACTGAGTATGAATTCAGGGTTTTTGCTGAGAATGAGACTGGGCTGAGCAGACCTCGCAGAACTGCTATGTCTATAAAGACTAAACTCACAT
>TTN-213,ENSE00003805486,1,576,2626867,2627442,CTGGAGAGGCCCCAGGAATACGCAAAGAAATGAAGGATGTTACCACAAAATTGGGTGAAGCTGCTCAACTCTCATGCCAGATTGTTGGAAGGCCTCTTCCTGACATTAAATGGTACAGATTTGGTAAAGAGCTCATACAAAGCCGGAAATACAAAATGTCTTCAGATGGACGCACACACACTCTTACAGTAATGACAGAGGAACAGGAAGATGAAGGTGTTTATACCTGCATAGCCACCAATGAGGTTGGAGAAGTAGAAACCAGTAGTAAGCTTCTCCTGCAAGCAACACCGCAGTTCCATCCTGGTTACCCACTGAAAGAGAAATATTATGGAGCTGTGGGTTCCACACTTCGGCTTCATGTTATGTACATTGGTCGTCCAGTACCTGCCATGACTTGGTTCCATGGTCAGAAACTTTTGCAAAACTCAGAAAACATTACTATTGAAAACACTGAGCACTATACTCATCTTGTCATGAAGAATGTCCAACGTAAGACTCATGCTGGGAAATACAAAGTCCAGCTCAGCAATGTTTTTGGAACAGTTGATGCCATCCTTGATGTGGAAATACAAG
>TTN-213,ENSE00003801306,1,306,2627443,2627748,ATAAACCAGACAAACCTACAGGACCAATTGTGATCGAAGCTCTATTGAAGAACTCCGCAGTGATCAGCTGGAAACCACCCGCAGATGACGGAGGCTCCTGGATCACCAACTATGTGGTGGAAAAATGTGAGGCCAAGGAGGGGGCTGAATGGCAATTGGTGTCTTCAGCCATCTCAGTGACAACCTGTAGAATTGTGAACCTCACAGAAAATGCTGGCTATTACTTCCGGGTTTCAGCTCAGAACACTTTCGGCATCAGTGACCCTCTAGAAGTGTCCTCAGTTGTGATCATTAAGAGTCCATTTG
>TTN-213,ENSE00003808123,1,594,2627749,2628342,AAAAGCCAGGTGCTCCTGGCAAACCAACTATTACTGCTGTCACAAAAGATTCTTGTGTTGTGGCCTGGAAGCCACCTGCCAGTGATGGAGGTGCAAAGATTAGAAATTACTACCTTGAGAAGCGTGAGAAGAAGCAGAATAAATGGATTTCTGTGACAACAGAAGAAATTCGAGAAACTGTCTTTTCAGTGAAAAACCTTATTGAAGGTCTTGAATACGAGTTTCGTGTGAAATGTGAAAATCTAGGTGGGGAAAGTGAATGGAGTGAAATATCAGAACCCATCACTCCCAAATCTGATGTCCCAATTCAGGCACCACACTTTAAAGAGGAACTGAGAAATCTAAATGTCAGATATCAGAGCAATGCTACCTTGGTCTGCAAAGTGACTGGTCATCCAAAACCTATCGTCAAATGGTACAGACAAGGCAAAGAAATCATTGCAGATGGATTAAAATATAGGATTCAAGAATTTAAGGGTGGCTACCACCAGCTCATCATTGCAAGTGTCACAGATGATGATGCCACAGTTTACCAAGTCAGAGCTACCAACCAAGGGGGATCTGTGTCTGGCACTGCCTCCTTGGAAGTGGAAG
>TTN-213,ENSE00003808212,1,5609,2628343,2633951,TTCCAGCTAAGATACACTTACCTAAAACTCTTGAAGGCATGGGAGCAGTTCATGCTCTCCGAGGTGAAGTGGTCAGCATCAAGATTCCTTTCAGTGGCAAACCAGATCCTGTGATCACCTGGCAGAAAGGACAAGATCTCATTGACAATAATGGCCACTACCAAGTTATTGTCACAAGATCCTTCACATCACTTGTTTTCCCCAATGGGGTAGAGAGAAAAGATGCTGGTTTCTATGTGGTCTGTGCTAAAAACAGATTTGGAATTGATCAGAAGACAGTTGAACTGGATGTGGCTGATGTTCCTGACCCACCCAGAGGAGTCAAAGTTAGTGATGTCTCACGAGATTCTGTCAACTTAACATGGACTGAGCCAGCCTCTGATGGTGGCAGCAAAATCACCAACTACATTGTTGAAAAATGTGCAACTACTGCAGAAAGATGGCTCCGTGTAGGACAGGCCCGAGAAACACGTTATACCGTGATCAACTTATTTGGAAAAACAAGTTACCAGTTCCGGGTAATAGCTGAAAATAAATTTGGTCTGAGCAAGCCTTCAGAGCCTTCAGAACCAACCATAACCAAAGAAGATAAGACCAGAGCTATGAACTATGATGAAGAGGTAGATGAAACCAGGGAAGTCTCCATGACTAAAGCATCTCACTCTTCAACCAAGGAACTCTATGAGAAATATATGATTGCTGAAGATCTTGGGCGTGGTGAGTTTGGAATTGTCCATCGTTGTGTTGAAACATCCTCAAAGAAGACATACATGGCCAAATTTGTTAAAGTCAAAGGGACTGATCAGGTTTTGGTAAAGAAGGAAATTTCCATTCTGAATATTGCTAGGCATAGAAACATCTTACACCTCCATGAATCATTTGAAAGCATGGAAGAATTAGTTATGATCTTTGAGTTTATATCAGGACTTGACATATTTGAGCGCATTAACACAAGTGCTTTTGAACTTAATGAAAGAGAAATTGTAAGTTATGTTCACCAGGTCTGTGAAGCACTTCAGTTTTTACACAGTCATAATATTGGACACTTTGACATTAGACCAGAAAATATCATTTACCAAACCAGAAGAAGCTCTACCATTAAAATCATAGAATTTGGTCAAGCCCGTCAGCTGAAACCAGGGGACAACTTCAGGCTTCTATTCACTGCCCCAGAATACTATGCACCTGAAGTCCACCAGCATGATGTTGTCAGCACAGCCACAGACATGTGGTCACTTGGAACACTGGTATATGTGCTATTGAGTGGTATCAACCCATTCCTGGCTGAAACTAACCAACAGATCATTGAGAATATCATGAATGCTGAATATACTTTCGATGAGGAAGCATTCAAAGAGATTAGCATTGAAGCCATGGATTTTGTTGACCGGTTGTTAGTGAAAGAGAGGAAATCTCGCATGACAGCATCGGAGGCTCTCCAGCACCCATGGTTGAAGCAGAAGATAGAAAGAGTCAGTACTAAAGTTATCAGAACATTAAAACACCGGCGTTATTACCACACCCTGATCAAGAAAGACCTCAACATGGTTGTGTCAGCAGCCCGGATCTCCTGTGGTGGTGCAATTCGATCTCAGAAGGGAGTGAGTGTTGCTAAAGTTAAAGTGGCATCCATTGAAATTGGCCCAGTTTCTGGGCAGATAATGCATGCAGTTGGTGAAGAAGGAGGACATGTCAAATATGTATGCAAAATTGAAAATTATGATCAGTCTACCCAAGTGACTTGGTACTTTGGCGTCCGACAGCTGGAGAACAGTGAGAAATACGAAATCACCTACGAAGATGGAGTGGCCATCCTCTATGTCAAAGACATTACCAAATTAGATGATGGTACCTACAGATGCAAAGTAGTCAATGACTATGGTGAAGACAGTTCTTATGCAGAGCTATTTGTTAAAGGTGTGAGAGAAGTCTATGACTATTACTGCCGTAGAACCATGAAGAAAATTAAGCGCAGAACAGACACAATGAGACTCCTGGAAAGGCCACCAGAATTTACCCTGCCTCTCTATAATAAGACAGCTTATGTAGGTGAAAATGTCCGGTTTGGAGTAACTATAACTGTCCACCCAGAGCCTCATGTAACATGGTATAAATCAGGTCAGAAAATCAAACCAGGTGACAATGACAAGAAGTACACATTTGAGTCAGACAAGGGTCTTTACCAATTAACAATCAACAGTGTCACTACAGATGATGACGCTGAATATACTGTTGTGGCAAGGAACAAATATGGTGAAGACAGCTGTAAAGCAAAGCTGACAGTAACCCTACACCCACCTCCAACAGATAGTACCTTAAGACCCATGTTCAAAAGGTTACTGGCAAATGCAGAATGCCAAGAAGGCCAAAGTGTCTGCTTTGAGATCAGAGTGTCTGGCATCCCCCCACCAACATTAAAATGGGAGAAAGATGGTCAGCCACTGTCCCTCGGGCCTAACATTGAAATTATCCATGAAGGCTTGGATTATTATGCTCTGCACATCAGGGACACTTTGCCTGAAGACACGGGTTATTATAGAGTCACAGCCACTAACACAGCTGGGTCCACCAGCTGCCAGGCTCACCTACAAGTGGAACGCCTGAGGTACAAGAAACAGGAATTCAAGAGTAAGGAGGAGCATGAGCGACACGTACAAAAACAAATTGACAAAACCCTCAGAATGGCTGAAATTCTTTCTGGAACTGAAAGTGTACCACTGACACAGGTAGCTAAAGAGGCTCTGAGAGAAGCTGCTGTCCTTTATAAACCGGCTGTAAGCACCAAGACTGTAAAAGGGGAATTCAGACTTGAGATAGAAGAAAAGAAGGAGGAGAGAAAACTCCGGATGCCTTATGATGTACCAGAGCCACGCAAGTATAAGCAGACTACCATAGAAGAAGACCAACGCATCAAGCAGTTCGTGCCCATGTCTGACATGAAGTGGTATAAAAAGATACGTGATCAGTATGAAATGCCTGGGAAACTTGACAGAGTTGTACAGAAACGACCCAAGCGCATCCGCCTTTCAAGATGGGAACAGTTCTATGTGATGCCTCTTCCACGCATTACAGATCAATACAGACCTAAATGGCGTATTCCTAAACTGTCCCAAGATGATCTTGAGATAGTGAGACCAGCCCGCCGGCGTACACCTTCTCCTGATTATGACTTTTACTACCGACCTAGAAGACGTTCTCTTGGGGACATCTCTGATGAAGAATTACTCCTCCCCATTGATGACTACTTAGCAATGAAAAGAACAGAGGAAGAGAGGCTGCGTCTTGAAGAAGAGCTTGAGTTAGGTTTTTCAGCTTCACCCCCAAGTCGAAGCCCTCCACACTTTGAGCTTTCTAGCCTACGTTACTCTTCACCACAAGCTCATGTCAAGGTGGAGGAAACAAGAAAAGACTTCAGGTATTCAACCTATCACATCCCAACGAAGGCTGAAGCTAGTACAAGTTATGCAGAACTGAGGGAACGGCATGCCCAGGCTGCGTACAGACAGCCAAAGCAACGGCAAAGAATCATGGCTGAGAGGGAGGATGAAGAGTTGCTTCGCCCAGTTACGACCACCCAGCATCTCTCAGAATACAAAAGCGAACTTGACTTCATGTCAAAGGAGGAAAAGTCTAGAAAGAAATCAAGGCGACAAAGAGAAGTGACAGAAATAACAGAAATTGAGGAAGAATACGAAATCTCAAAACATGCTCAAAGAGAATCATCCTCATCTGCGTCTAGACTACTGAGACGACGGCGCTCCCTGTCTCCAACTTATATTGAGTTAATGAGGCCAGTGTCTGAGCTGATCCGGTCACGTCCACAACCGGCTGAGGAATACGAAGATGACACAGAAAGAAGGTCACCTACTCCAGAGAGAACTCGCCCACGATCCCCCAGCCCTGTGTCTAGTGAGAGATCACTCTCGAGATTTGAGAGGTCTGCAAGATTTGATATCTTTTCCAGGTATGAGTCCATGAAAGCTGCTTTAAAAACTCAGAAGACATCAGAAAGGAAGTATGAAGTTTTGAGTCAGCAGCCTTTCACACTGGACCATGCCCCTCGAATCACACTGAGAATGCGCTCGCACAGGGTACCATGTGGCCAAAATACACGTTTTATTTTAAATGTTCAGTCTAAGCCAACTGCCGAGGTTAAATGGTACCACAATGGTGTGGAACTCCAAGAAAGCAGTAAGATTCATTACACCAACACGAGTGGAGTCCTCACCCTGGAAATTCTGGACTGTCATACTGATGACAGTGGAACCTACCGTGCTGTGTGCACCAACTACAAGGGCGAAGCTTCTGACTATGCAACGTTGGACGTGACAGGAGGGGATTATACCACCTATGCTTCCCAACGCAGAGATGAAGAGGTCCCCAGATCTGTTTTCCCTGAGCTGACAAGAACAGAGGCGTATGCTGTTTCATCATTTAAGAAAACATCTGAGATGGAAGCTTCGTCTTCTGTCAGGGAAGTGAAATCACAGATGACGGAGACAAGGGAAAGTCTCTCCTCATATGAACACTCTGCATCTGCAGAAATGAAAAGTGCTGCATTAGAAGAAAAGTCACTGGAAGAAAAATCCACAACCAGAAAGATCAAGACGACTTTGGCAGCAAGAATTCTAACAAAGCCACGGTCCATGACCGTCTACGAGGGCGAGTCTGCAAGGTTTTCTTGTGACACCGATGGTGAGCCGGTACCAACTGTGACCTGGCTGCGTAAAGGACAAGTGCTAAGTACTTCTGCCCGCCACCAAGTGACCACCACAAAGTACAAATCAACCTTTGAGATCTCTTCAGTCCAGGCTTCCGATGAGGGCAATTACAGCGTGGTGGTAGAAAACAGTGAAGGGAAACAAGAAGCAGAGTTCACTCTGACTATTCAAAAGGCCAGGGTAACTGAAAAGGCTGTGACATCACCACCAAGAGTCAAATCCCCAGAGCCTCGGGTGAAATCCCCAGAAGCAGTTAAGTCTCCAAAACGAGTGAAATCTCCAGAACCTTCTCACCCGAAAGCCGTATCACCCACAGAGACAAAACCAACACCAACAGAGAAAGTTCAGCACCTCCCAGTCTCTGCCCCACCAAAGATTACTCAGTTCCTGAAAGCAGAAGCTTCTAAAGAGATTGCAAAACTGACCTGTGTGGTTGAAAGCAGTGTATTAAGGGCAAAAGAGGTCACCTGGTATAAAGATGGCAAGAAACTGAAGGAAAATGGGCATTTCCAGTTTCATTATTCAGCAGATGGTACCTATGAGCTCAAAATCAATAACCTCACTGAATCTGATCAAGGAGAATATGTTTGTGAGATTTCTGGTGAAGGTGGAACGTCTAAAACCAACTTACAATTTATGGGGCAAGCCTTTAAGAGTATCCATGAGAAGGTATCAAAAATATCAGAAACTAAGAAATCAGATCAGAAAACCACTGAGTCAACAGTAACCAGAAAAACTGAACCAAAAGCTCCTGAACCAATTTCCTCAAAACCAGTAATTGTTACTGGGTTGCAGGATACAACTGTTTCTTCAGACAGTGTTGCTAAATTTGCAGTTAAGGCTACTGGAGAACCCCGGCCAACTGCCATCTGGACAAAAGATGGAAAG
>TTN-213,ENSE00003811220,1,157,2633952,2634108,GCCATTACACAAGGAGGTAAATATAAACTCTCTGAAGACAAGGGAGGGTTCTTCTTAGAAATTCATAAGACTGATACTTCTGACAGTGGACTTTATACTTGTACAGTAAAAAATTCAGCTGGATCTGTGTCCTCTAGCTGCAAATTAACAATAAAAG
>TTN-213,ENSE00003801641,1,692,2634109,2634800,CTATAAAAGATACTGAGGCACAGAAAGTCTCTACACAAAAGACTTCTGAAATTACACCTCAGAAGAAAGCTGTTGTCCAAGAGGAAATTTCCCAAAAAGCCCTAAGGTCTGAAGAAATTAAGATGTCAGAGGCAAAATCTCAAGAAAAGTTAGCCCTCAAAGAGGAAGCTTCAAAGGTTCTGATTTCTGAAGAAGTCAAGAAATCAGCAGCAACCTCCCTGGAAAAATCCATTGTCCATGAGGAAATCACTAAAACATCACAGGCATCAGAAGAAGTCAGAACTCATGCTGAGATTAAAGCATTTTCTACTCAGATGAGCATAAACGAAGGTCAAAGACTGGTTTTAAAAGCCAACATTGCTGGTGCCACTGATGTGAAATGGGTACTGAATGGCGTAGAGCTTACCAACTCTGAGGAGTACCGATATGGTGTCTCAGGCAGCGATCAGACCCTAACCATCAAGCAAGCCAGTCACAGAGATGAAGGAATCCTCACCTGCATAAGCAAAACCAAGGAAGGAATCGTCAAGTGTCAGTATGATTTGACACTGAGCAAAGAACTCTCAGATGCTCCAGCCTTCATCTCACAGCCTAGATCTCAAAATATTAATGAAGGACAAAATGTTCTCTTTACTTGTGAAATCAGTGGCGAGCCATCCCCTGAAATCGAATGGTTTAAAAACAACCTGCCA
>TTN-213,ENSE00003801638,1,154,2634801,2634954,ATTTCTATTTCTTCAAATGTCAGCATAAGCCGCTCCAGAAATGTATACTCCCTTGAAATCCGAAATGCATCAGTCAGCGACAGTGGAAAGTACACAATTAAGGCCAAAAATTTCCGTGGCCAGTGTTCAGCTACAGCTTCCTTAATGGTCCTTC
>TTN-213,ENSE00003805382,1,303,2634955,2635257,CTCTAGTTGAAGAACCTTCCAGAGAGGTAGTATTGAGAACAAGTGGTGACACAAGCTTGCAAGGAAGCTTCTCGTCTCAGTCAGTCCAAATGTCTGCCTCCAAGCAGGAGGCCTCCTTCAGCAGTTTCAGCAGCAGCAGTGCTAGCAGCATGACTGAGATGAAATTTGCAAGCATGTCTGCCCAAAGCATGTCCTCCATGCAAGAGTCCTTTGTAGAAATGAGTTCCAGCAGCTTTATGGGAATATCTAATATGACACAACTGGAAAGCTCAACTAGTAAAATGCTTAAAGCAGGCATAAGAG
>TTN-213,ENSE00003809884,1,1319,2635258,2636576,GAATTCCGCCTAAAATTGAAGCTCTTCCATCTGATATCAGCATTGATGAAGGCAAAGTTCTAACAGTAGCCTGTGCTTTCACGGGTGAGCCTACCCCAGAAGTAACATGGTCCTGTGGTGGAAGAAAAATCCACAGTCAAGAACAGGGGAGGTTCCACATTGAAAACACAGATGACCTGACAACCCTGATCATCATGGACGTACAGAAACAAGATGGTGGACTTTATACCCTGAGTTTAGGGAATGAATTTGGATCTGACTCTGCCACTGTGAATATACATATTCGATCCATTTAAGAGGGCCTGTGCCCTTATACTCTACACTCATTCTTAACTTTTCGCAAACGTTTCACACGGACTAATCTTTCTGAACTGTAAATATTTAAAGAAAAAAAAGTAGTTTTGTATCAACCTAAATGAGTCAAAGTTCAAAAATATTCATTTCAATCTTTTCATAATTGTTGACCTAAGAATATAATACATTTGCTAGTGACATGTACATACTGTATATAGCCGGATTAACGGTTATAAAGTTTTGTACCATTTATTTTATGACATTTTACAATGTAAGTTTTGAAACTAACTGTTGGTAGGAGAAAGTTTCTTATGGAACGAATACCCTGCTCAACATTTAATCAATCTTTGTGCCTCAACATACTGTTGATGTCTAAGTATGCCTCAGTGGGTTGAGAAAATCCCCATTGAAGATGTCCTGTCCACCTAAAAGAGAATGATGCTGTGCATATCACTTGATATGTGCACCAATACCTACTGAATCAGAAATGTAAGGCATTGGTGATGTTTGCATTTACCCTCCTGTAAGCAACACTTTAACGTCTTACATTTTCTCTGATGATGTCACACAAAATTATCATGACAAATATTACCAGAGCAAAGTGTAACGGCCAACACTTTGTTCGCTCATTTTACGCTGTCTCTGACATAAGGAGTGCCTGAATAGCTTGGAAAAGTAACATCTCCTGGCCATCCCTTCATTTAACCAAGCTATTCAAGTATTCCTATGCCAGAGCAGTGCCAACTCTTGGAGGTCCCAGAGTGCAGCCAATGCCTTTGTGTGGTAGTTCTAAATTTTAATTGCACCTGAAAAACCTGGGCACCTAAGCAATGAGCCACAGCAAAAAGTAAAGAACAACAACAAAATAAAGCTGTTGTTAAATTTTAAACAATATTACTAATTGCCCAAAATGTCAATTTGATGTAGTTCTTTTCATGCAAGTATAAATTCAATTGTTAGTTATAATTGTTGGACCTCCTTGAGATAGTAACAACAAAATAAAGCAAGCTATCTGCACCTCAAAA
>TTN-213,,0,2556,2636577,2639132,GTGAGCAGCAACTTTTCTTATTTTAATAGTAGAGTCACTTTCTTATTGATCTCTGGCTCTGGATTATTTGTGTGTGCTAAATGCCTATGTACAAGTGTTTGTATGACTATTTCTTGCCAGTGCTGACCCATTATTTAAATCTGCTTGTTAAATTCTATTTTAAAATGTCTGAACATTTTTCCTTAAAAAGTTGAAAGCTTTATTATATCAGCTAAATGATTCCATGATTCAAATTGTTTAAGTTCACTTAATATTCTAAAAGTTGAGGTCTGAAATGTTGAGAGAAATGTTTACTTCTTTTCTAGACTCTCTTTGCCTGTTGAGAATGTTCAAGGTTATATTACTCAATGATAAAGTTAAGCACACCAAGAATAGCTCTGATAAAATGCATGTGGTATCAGCTACACCCTGATGACTTTTTAAGGGAATCAACTGCTGAGGTATCAGTTGCAGGACAGTGACAGAACACTTGCCTGCTGTCAGTCAACCTTGGAGAGTTTAGGAGAGTTTATTTTAAGAGCATGACATTTTAGACGCATACCTTCAGCCCCAGTTAGACAAAGGCCTGTGAAGAGCAAGTGCTAAGGCAATAAAATTTACCTAGACAATAGGAATGTAAGATCAATTTAAGCTGGTTAATTGCAACATAGTTGGAGATTTGGAATAAAATGATATAATTGTTTTCTAAAATATTCAGAATCTCTTCATGCATTTTAACTCAGCACACAGTCCAATTATATATTTTGAGATAAATGTTGACACTAAGAAGGGTAAGAAATAATGTTTAAAGGAAAGGTTTCTTACTTCTAAATACACTTTGATTTCTCATCTTCCTAGAATTTGATTACTAATTGTCAATGCCTGTAAATACATAGATATATAATTAGGTATTCTATGTCTAAGAGGACAGCTATTTTTAGATATACTAACTTATAAACAGACAAAGTTAGACACAGAAAGTTGTTCATCCCAAAGATAATATGCTACAAAAAGGAGTTTCTGACAAAAAAAATTTATGAAAGCTTTTGGATATTATCTGATTTTTCCAAATATAAATTTTATTGTCTCAGAGAATGCTGGTTTCATTTTTTTAACTAAGTAGAAGGTTACAGTAAGGAACAGAATTATCACTAAGAAGATTATTGCTCCATGAAGTTTTAGTAAACAAAGAATTTAATGAAAAATAGTAATGAAGTGATTGACAATTCAGAAATGTTCTATTTCAGAACAGAATAGTCATGTTGAATAATTAGGTATTTATGCATCAGAAAATTCTTCACATAATGTCTCTGAAACTGATAGGCAAAGTACTTTCTTGCACTTAACAAAATGACTTAACTGCAAATTTTATATTCGTTTCTTTGATGTTGAATATTTTACTTTATGAAAGCATAGGCCTTTTCACTTCATCTACATTTTACACCAGCCTTCCATTATTCAAAGTTTGCAAATTGTTCCATATTAAGAACTCAAGCCAGCATTTTTCTTTCAGAACTATAATAAACTTTGGCCTGTTCACTAAAATTTAAATTTTTCTGAATATTTACTTCAGCAGTAACAACATTTACTGCACAGTTACAGTATGAAGAAATGTTAAGAAATAGAAAGCACCGTATGCCGTCTACAAAAAGCTTGCATATTTGATAAGGCTTGCCAAAGCTTCTCCAGTCAGGAAAGAGATTACAAAGTTCAGATTTTTACTTCTGGCAACTATTTTAAGTAATCAGATAATGTCTGAATCAATGTCAACTTTATAAATATAGAGTGAACGAAAAATATTGGGGAGAAGGAAAATTTTTAAAATAATTTTCACTTACTAAGCTGATGCAGAGGTTTATTTATTTTAATTTTTTTTTTTTTTTTTTTTTGAGACAGAGTCTCATTCTGTCACCCAGGCTGGAGTGTGGTGGCACCATCTTTGCTCACTGCAACCTCCACCTCCTGGGTTTAAGCAATTCTCATGCCTCAGCCTCCCAAGTAGCTGGGACTACAGACATGGGCCACCACGCCTGGCTAATTTTTGTATTTGTAGTAGAGACAGGGGTTTCACCATGTTAGCCAAACTGGTCTCAAACTCCTGACCTCAAGTAATCCTCCCGCCTCGGCCTCCTAAAGTGCTGGGATTACCAGCATGAGCCACCACGCCAGGCCCAGAGGTTTATTTTACATTTATCACATGTCTTGTCTCTCTAATTACACTTCACTAACCCTGCATTGCTGTGGTTTTCTTCTTCAACTCTGAACCTGGTTTTCCACCATTGGTAAGACTGTATATTCCCTCTTTGACCACTAGGGTTCATTCCTTGTTCTGTTTGGCTAATACTTTTTTCCATTTCCCCTTACACTTGCTACTTTGGGTTAGGCTTTAAGTCAACTCAATGATGAACTATGCAAAACTGTTCAAGCCACAAAAGAGAAGACCTGCCCATCACTCTAGGCCCACAGATGACCTATGGAGCAATCCATTTGGAGAAACGTGTGTCTCTGCTATCTGCAAAGCAGCTCCAGAGTGACCCTTAGCTGGGACACCCTAATTTATTTTCTCTTCTTTTTCAG
>TTN-213,,0,2210,2639133,2641342,GTAAGCTCACACATTCACACTTTTGTTTTTTTTTCCTTTGCCTCCTCTCCAGTAAGTTAACGTTGCTGCAGGACTTGACGCCAAGTTTAAGCCCTGCTTTCACTTCGGAAAATTAGTCCAACACTATGGAAAGGTCATTTTAAGGGTATACCATTCACAGAGTACTGACAAAATCTGACAATATAATGGCTTGAAATGTTTTATTCATATTTATTATTCCACAAAGCAAAAATAATTAGTGTTGGATTAAAATTGCCGTTAGAATCCAGCAACTAAATAGGACCAAATTTAGTCATTCTATATTTGGGCTCAGCTGCAGAGCCAGACTGGAAGCCAAGAACTCAAGCCCAATAGAAGCCAGCCACAGAGCCATGGGGTAGGCAGTCTGGGCTGCCTGCTCTGGACACCTGAACTTCAGTTGGTTCACACGCAAAATAACAGTGCATCTAATTTTCCTCAGAGGCAGAGCTGTTCAGTAATTAACCAACTCCTCATTATTTTATTATTTTATTTTCAATCTTTATTGAGTGATTCTAATGAATTAAAAGACTTTCCAATCGTTTTGAAATGACAGAAAATAATATGCTTCTCGGGTGTCTCTATTTAAAAGGAAGCAAACACTAACCCTAGAATTTTATCTGAAAGGAAGTTCATCTCTTTTTTGCCTTCTTTTTCTTCCTCATAACTCAGTTTATGGATGGTTCAAAAAAATGCATGGTATCATCTTATGAAAAAATGGAGAGTAGTGTATGAACTATATTGTAAATAATTTTAAAATTAATCAATATTTTCTCTTTCTGTAGTATTGTAACGAGCCATGTAAGATGGATACGGATTAAAAAAAATCATGCTTAATTCTTAATTTAGTGCACTTCCATGGTTCATTGCCCACTTCTTTTTTAAAATTTTATGGCTTATAATAAAGATATAAAATAAAATTTCTTTTTTTCTCTTTTTTTCTATTATATGCACCAATCTTATTCATAACTGGATAATACTTTCTTTTACATTGTACAAATATCATATAATCATTGCTTATTTTCTATTGTACATATATAGACCAATGAAATTCCCTTTTCATTGGTCTATATATGTACAATAGAAAATAAGTCTTACCGACTTCCAAATAATTTACCTATTTATCTGGTAACACTCAGTAACTTCTGAACTGAGCAGAACACATATGACTTCAGTGGGAATTTGCCTCCTTGAGAAGTAGTGGAATCTGGCTACTTCATATCTTCTTGTTCCTTCAAACTATATGCAAATAAATTATTACAAAGACACTACTGAAAATATCCAATACCCATAAATCAGTCCAATAAACTATTTAATTGGCCATAGTGGGAGATGGGCTAATGTATAAACAACAAAATAGACTTTCTCTAGATTATCTTTACCTACCAGCGTAAGTAGATAGAGCATCAACCTTTATGCCAAGTGTGAAATAAATCATGCCCTGAATGTGCCTCGTACATTCTCAATGTACAGAGTTTTAATATATTTAAAACATCAAACCATGGACATGTAGTTCTTGGCTCTACAATTTATGGCAGATAAAGAGAATTTGGCTTTCTACCTGCAATTCCAATGATCCATGTTGTTCTGGAAGACTAGGTTTGGATTAGTCTCTTATGAGAAATTGCTTGTCCATGTTACAATGTTTTTACTGATTGCACTTGTGAAAGCAGAAGAGTCCAAGAAGACAGTGTCCCTGTAACCACAGAGGAGGGAGGAGGGCATGCCTCCTGGGCTTGTCAGGCAGAAACTGGAGATCAGTTTGCTGCTTTTGTTCTTCACTTGCTCTCAAAGAGGACAACAATCACTCTTTATTTCAAATTTTCCTTGGTTCTTCATTTTTATAAGTCCCTTTCATGATTTTAATGTTGTCTATTAAATTGCATCAGATAGAGCCCTAGGCAGGCAGGCAGGAGATGGAAATTCTAGTCCCCTCTGTGTCACTGCTAGCTGAAGGACCTTGGAAAAATCATTAGGCCTCTTTTGGTCTCAGTTTCCTCCCTTCCTGCCTTCCTAATGGTCTGCAGGTTTACACACTGATCATGCAACTGTAGGGTTTTCCCTATCATTAAGTGGCATTCCATGCTGGAAAGCTTTTACAGATTCGGACAAGGCAGTGAACATGATGGGACAGAGCAGAGGACTTTGTGGTGCCCATTCAAACATAAAGGTGAATTGTTCTTGCTCTTCAG
>TTN-213,,0,1455,2641343,2642797,GTAGGCTGCTGGGGACCTGCCAATCCTCTGCTCCCCCAGAGGACATCTCCAGCAAATTGGGAAAGGAGTCCAGAAAAAGCTATGGGCAGAGGTAGATGCAGCTCTTAAACTACAGAAGGGTCTACTGGAGGCTGAATTATTTATAACCAAGTTGTTTGCCTTTTGGAATTTAATTTTCCTCTAGAGTACATCGTAAAAGTGACTGAGAATCAGTTTCTCAATACACATATTAAACACTCAAAAGTATGTTAAGGAAATATTAAAAATCATGTTTCTCAGCAAGTAGAAAAGCTTGGAGCCTTGTTTATAAGTCCTTTAAGGAATAAGACATATTCTCCAGGGAAGTGTGAATCTCCAGGAATTCACACTTTAACAAGCATCCAGATAATTCTGATGCCGGTAGTCTACAGACCACCCATTTAAGAGGCATGTAAACATACCCAGAAGAAAATAAATGCTTGTTTATTATTCAAATGCATGACACTGTTTCCCCAGAAAACTTATCACCAATCTTAGTGGCCTCTGTTGTTTTTCTCTATCCTTTACTACCTAGTGAGACATTAGTATACAGAATATTGCATGCCTTTACATGTTTTATAACAATATCTTACATGAGCTACGTAAAGTTACATATGCTTATCCAATAAACTTTACCTTCAATGATGTTCAATTATAGGGCTATAATTGACCTAAGCAGAAACCACATCAAGTAACATCAGGTAGAACTTTAGCATGCACCCAGAAAATTCACAAATGGAAAATGCACAGGGTTGGCAGCACCTGCTGTTGTTTATTACTCAAAATCATGTCAAAGTTAATTCCACTCACTCCTCACACTTATAAAAAATTTCCTTCAACATAACCAAAAAAATCCCCTTTCTGTAACACAATTAAAATGAAGTAATGTTATTATTGGGATTAACGTTTTAAATGCAAGTAAATATTTGGGTTATTTGAATACCTATCAAGTTGGAGAAGGTTTAGAATTTTAAAAATTAAATTAAAAATGTAATGATTCTTTAAGTAACAGGTACACCCATCGTAGCAACCACTGGAATTCATTTTAATGCAACTTACTGGAATATGCAACATGGCTTTCACATATTAATAGAGCGCTAGATGTGAGGTAGAGGGGGAAGTACCAGAAAGATTCTCAAGAAATGTTATAACAAAATCTAGAGCTTTTATTTAAAACAAAGAAACAAAAGGTGGTGGCCTAAACTGCTCAGCAAAACAAAGCAAATAAAATAAAATATGGTGGTGAGAAAGCCTTCTGTAATCTCCTGGCTCCCATTCTTGCTGTCATTGCTGGGTGAGCTGGGTTCAAGGACATTCAAGGATGTTTAGATTGGCGAGTCATCACCTGGTTTTGGAATTGGAGCTGTGATTATTTAAAAATACCTTGTAGGGAGCACCCTGGCTCTCACTCTTGACTTTGTTCTCTTGTCCCCGCAG
>TTN-213,,0,484,2642798,2643281,GTACGTGCTGGAGGTTGAGGAACAGAGAGAAGGGGAGAGAGCTGGTTTGTGTCTAAATGGGGCCAAGCGTCCACTTGCCACCTCTCACAGCCCTGGGAAGAATGCTGTGAGCTGATATAAAAGCTGGCTTTTCGACACCCATGAAAAGTCCCTGAGATTCTAGTCAGGAGCGCAGAATAGAAGCAATCTGTGCTTATGAATCTCATTATAAACTGGAAAGGGTTTCAATTAAGTGATCTACATTTCCAAATTATTGGCAAATAATGAAATTTTAAAAAATCATTCTAAGTAAATTTTTATCTTGTAATGAACATTTTCTATTTTTAAACCTAATTTATATTCATGCAAAATCCAAAACTTTCTGCAATTTTCTCCATTGGGATATCCAGAAAATCTTTTTGACTTTGTAGTCAGAATTAACAGAATCTCTTTTAAAATGGGTCATTGTGCCCCCTCCCAAACATTCATCTTTCCCTTCCCACAG
>TTN-213,,0,93,2643282,2643374,GTATTTTTCTATACTGTTGGTTTTCAAGCCTTTCAGGCTGTTGCGTCCCCAGCTATTCCTCCTCAACGTGGGCTTTGTTTTAATCTTTTACAG
>TTN-213,,0,4234,2643375,2647608,GTAAAGCTGCCATAGAGAGAGCAGATTATTGCACATTTTGGAACTAGGTTTTGAAACGAGAAAGATTCCCTTGTCCCCCTCGCAGGGCATGCGACGCGGAGAGTGGTTCGCTTCTTCAGTGTCCCGCTGCTCAAACCTCTAGGGGAGCATACAAACGGGCAGGTTGTGGGGCTCCGTGTTCCTCTGGACATCCAGCCGCTTGTGTGTCTGCCTACTAGGGTCTCAGGGGTTTTTATAGGCATAGGGTGTGGGCGTGGCAGGTCAGGGTGATCTTGGGAAATGCAACATTTGGGCGGGAAGGCAGGAGTGTTTGTCCTCACCTAGGTCCATGGGCACAGGCCTCGCTAGGGACCACGCACTTCTCTTCCCAGCACTTCCCTGCCCTCCTCCCGTGTAAGTTTCATGCACTCAAAAATGTAGCAGGTGACAAAGGAGGTAAACCAAGAAGTTACTGAATATGATTTTCACAAATCCTCACTGTCCACAGGTAAATTGAAGACCCTTATAAACTTCTGAATTCTTATTTATATTTCATGTAATAAATATCTACTTTAGGGGCCAAAATATGGCACAGTGAAAGGAGAAGAGCACAGAAGTTAGAGTTCAAAGCCCTAAGGACAAATCAGCCTGATCACTTAACAGTTTGATTTAGGGCAATAAGTATAAATAATAAAATAATTGTTATTATATATGGATCACTTCCTCTATCAGATTGGAACTATACATACATTATCTCATTAAATGTTCACAACCTGTAAGAATTATTATCCTCAATGTTATTGATAGGTAACTGGAATTAAAGAAGTTAAGCAGTTTATTTAAGGTTTCAGTTGTGTCATCTGTAAATTAAAGAGAGTCACAATAAGAATGATCTCAAGCTGCATTTTGGGGCTTCAATGAGATAATTAGTTGAAAGTGCCTTGTAAATAGAAAATAATTATGCCAATATTCTTATATTCAGATGGTAAGTAAAACCTTTTAAATATTTTGCATATGCTTGTGTTATTTTATCTAGAAAATAAAATGGACTTCTATGCTTACTTAATATGGAAGTATTTTAGAAGGTGATCATGTATCATGATCAGGGCTCAGAAATTATATAATCAAGTGTAAATTGTCCACAACAGTTTTGAAAGTTTGGGATTTAGTTTATCATGATGAAACTTTTAATATGATGAAATGAAAAATGTACAAAATTTGAGCAAAGAAGTGTTTATTGATCAATTTAAATGAAATAAAAAACACATGGATGTTCCCTGCCAAGAAAATTTTTTATAAAAGAATAATAAGGAGATAGTTGACCTAAATAATATTCAAACATACTGTAAAGTTACTATAATCAGAACAGTATGGTATTGGTAAATGAATAGAAAAATACACCAGGGGAACAAAACAGAGAGTCCAGAAAGAGATCCAAGTATAATAGATCCAAGTATATAGGGAATTCAAAAAGCAAAGTGGCCTTTCAATTCAGGGGAGGGAGAGGTATTTTAATAAAGAATGCTGGTCCAATTAGCTATCCATCTGGAAGCAAACAAACATAAACCTCTGCCTCTCACTATTTACAGAATAAATTTCAGCTTGATTAAATAGTTAAAAAATGAAAAAAAAAGAGAAGACAATCTGCAAAAGCATTTATGGGTGAAAGCTTTTAAAAAGACAGTTACAGATTCAACTACATAAAAATCAACATGTATGTATGGCAAAAGCAAAAAGTCATTTCTAAACCAAACAGCACTTGTGAAAAAATTTTAAGACCTTTCTCCTCCTCAAGGTACTTCATTGCCTCTGCCATAAAAGTATCACAATAAACATAAAATGGCTACAAGGTAGACAACACCAGCCTAGAAACAGTATATAACATACAAAATTACGTAAGCTTATGCTGGATAAGACCCATAAACAAGCAAAATATTGAAATGGATTAAAAGAAATGGATCTGGGGGAATGTTTGCAACACTTACGACAAATAACCAATAAATGCACTAAATGCATTAAAAATCATCCACAAATTAATTTTTAAAGGAAAAAAATGCAACACAAAAAAAGACAAAAGATACAAAAAAGTATTTAACATAAGAGGCAATGTAAAAGTCCAATAAACATGTGAAAAAAAATGCTAGATGTTTTCCAATTTTTATTGTTTTAGCCACAAAAATGTAAAGATATTGGCAAACACTAACATGAAACCTTGAACAAAAAGCTTACTTTAAAAAACATGTCTAGCAGTCGAATAAAAAAAAATGTTCAGTCTCAGGCTAAATCCAAGTTTGCACACCATGAAATCACAACACAAGCCAAATGCAATTTCTTGAGGAGATAACAACCTAACTATATTTTAAAACCCAAGCCTAAGGGTCATTTAGAATCATGGAGTGTCCCTGATCCCATGGAGCATTTTGACCATCTTAGCAGTTTTGAAAGTTCATTAATAACCATCCAAATTGCCCCAAAATTTTGCTTTCCAATAATTAAGAAATAAAATGCCAATTTGCAGAGAAAATAATGGTTATCAAAGATAGACTGCTTCCTAAATATCTCATAGTTTAATCTTGATTTTTGTTGTAGAGTAAGGCAAACATATTTCATTGAATAAGGTGCATTGTATCTCGCTGTGACCAGGTGATTATTTTTTGTTGTAAGTACAGAAATAAGCACTCTCCTATAATGACCAAAATTACAATGATTTTCACAGTTATGGGCTTACCTGTGTCCTGCTGTTAATCAGTCATGTCATGCTAATCATGTCTTTAACTCTTTTTGAATTAAACCCATTTACTAAGTACAGCAAGAACAAGGCACAGGGTGAAACTTAAAAGCACATGTCTCTTTGCTTTTCTTCAGTTAGTGGAAACCACACATTATTCTAACTTGGTTTTTGTTATATTTCAAAGGCAGTCATGTTCAGAAAAGAGGCTTATTCCCTAGATTTCCCTTTAGTTTGATTACAACTTCATTTACAAAATGTAAATGGATTTTCACACAAAAAAAGCCATTCTTCGAGAAAATAAACATTTCTTCGTGAAACTGGTTAATGTTGTAATGTACTGTTAGGGTACTCTGTAAGTTAGAGAAAATATCAACTGTACCTTGAGCTTAATTAGAATAATCATTTCATGTATGATCAGTGTAAGCTAAATATCCTAGATAGTGACAAGATGCATTTATAAACATTTTCTTATATGCAGAATTAATAAAATGCAATGATAGGGCAATACTGCCACCTAGAGAGGAAAATGTAATAAGCCTTATTAAGAATTAAATCAGTTCTGAAAAAAATTTTACCTTACAATAGTTGGCCAATCCCCAGAATTATTGCTATAGATCAGAAATAGTCTTTTTTGGCCATCAGTGCTGGGATTTAGCACCCAAATTCTTCAACTGATGCTACTTGCACTTTGGATACACCTAAAAAGCAAACAATGAAAACTATTCTGGAAGAAGCAACTTTATCAATTTACCCAAAAATCACAGAATCATTAGTTTTTAAGTTAGTCAATTCCCACAATAACTCTAAAGATATTTAAAATAAGTCCAGAGTGCAATACAAGGGGGGCGAGTGTAAACAAATATGGAGGAAATTAAAAGTAGCTGTCCACAAACACTTCGGCTAAAGCAGCAATTTGCAAAGTGCACTGCACAACCTGTACCCAGCAACATGCTGCAGAAAGCTTCCTGAGGATGTGTCCCCCTGTCCTGGAAATTCACAAGGCATACTGACATAGTAAAGGCTGTGGGAAGTCCTGCAGGGGAAAAAAAAAAATGGCTTAAGCTGCTTAGTCAAGAGTGGCACAAGCATTTTGATTACAGAAACCTTTCTTCTTATAACACCTATTTGACATCCTCTAACCCCCCCAGAATTGGAATACAGAGATGAATTTGGAATACAGAGGTTGCTGGATTTGACATGTCTTTCCTTTGGCTGCATATTAAAGAAGTAGCTTTTTCTGTTGTGATTTTTTTTTTTTTTTAATGTGAGAAGGTGCAAGGCACAAAATCTCCAGCTTATTTGGAATTAAAGCTGATTCTCTTACAGGGTTACAGCAGATAAGAATAGGTTTATTGAGATTTAAAACAAATTACTTCCAAGTACATTATTTACCCTCTGAATGGGTTATGGAGGCACACATTTTAAAACTCTGCCTTAAAGCACTTCCAGCTTTTCATCTCATGATTCACATCCAGTTACCCCTCCTTGCTTTGACATTCTTGACCTCTGCCTTTTGGTTTTCAG
>TTN-213,,0,370,2647609,2647978,GTACTGTCAGAATGGTTTTGTTTTTCCTTATTTCACATTCTAGTTTCTCCAACTGGATTTCTGCCATGAAACTCAGTCTGTATAAATTGGAGGAAAAATGCATATGAACATAAAAATATAGCAGCAACTGAAGACCAAATTCAGTAGTCATGCTTTGTAAAACCATTTTTAATTAGGACAAAAGCTCCAATCTGTGAAGTTTCCATAATATACAGGTTTTAATGATACAGTCTCTGTATTTCTTGGCAATAATAAATGCTTATGTATGAGTGTATTTTGCTCTAGGTGGCTCAGTTTTCCAGTATGCTTTTTTATTTTCTACTGGGCATGTCATTTAAAAAAGTAATCTACTTGGTCATTTCTAATCTAG
>TTN-213,,0,857,2647979,2648835,GTACGTGCGAGGCTGCCATGGGGCACCCGCAGAGCCACGTCCTTCAGTGCACATTAACTCAACCACCATCCACTGAGCTTGGCATGCAGCTGTGCTCAATTCATTCTGAAGACAGCCTTGAGCCCAGCAGGGCCCAGACTTTTAGAACTTTCTGAGCAAAAGGTGGTCGGAGATGTCAAAGGTGTTGACAATGTGAGTATCACAAGAGCAGAGTAGGCCAGAAATACCTGGGCTATATGAGCAGGCAAAAGTCAACTATGGTATTCAAGGTAGGAAGGCAAAGAGTGGCCAGAGAAACAGAGACCAGTCAATTCCAGAGCTCAGTCACTGCACACACTGGATGTGGAAACTACTATTTCAGGGAAGGCATTACATTTCTCTAAGTTTCCCCAAAGGACTTTTGTTTTTACTTTTCTCAAAACAAACATGACACTTGATTCATAGCTGGAACAGTGTCATAAATCCAGGATAATGTCCCACCTCGCATTTGAATAGATTTTCTGTTACAGTTTAAAATCATTCCAGCTTTCCTCCTTATCCTCTTGTGTGACATTTATGTCTAAATCCTGACAGATTATTGTAACTTTTTTTTCTTTTCTGAGACAGAGTCTCGCTCTGTCACCCAGGCTAGAGTGCAGTGGCATGACCTCCGCTCACTGCAGCCTCCGCCTCCTGGGTTTAAGTGATTCTTGTGCCTCAGTCTCGTGAGTAGCTGGGATTACAGGTGTGCGCCACCACACCCAGCTAATTTTTGTATTTTTTAGTAGAGGATTTCACCATGTTGGCGAGGCTGGTCTTGAACTAATTTTTATGTAAGATGCATTAAGGTGTTTTCTTCCTTTCTCTATGAAAAGCAG
>TTN-213,,0,1206,2648836,2650041,GTGAAAATGGGTTTGTATTTTAAATTCACTGAGGTTCTTACAGGGGTCAACACAGATAATCACCTTTACCATGAAGAGTGTTGTTCCTTGGGCCACATGGTTGTTAGCATACTAATAAGATCCCCTTGTTGTATGTGTAAATTTCTGGGTACTGGATACCAAAGTTTGGTAGTGTCCCTGAATGCTCCCCTTGTGAGTATGAAAAAGAACTCTGTGAACATACACCAGGAGTAGAAACAGGGGTCTCATCACATTGATCTGGGGATGCACTAAGTATAAGACTATAGGGAGAGGACAGATGGCTAAAACCAGGAGGAAGAAATAGATGCTGAGGCAGGAATGGGGAAAAGTGGAGGAGACACTGAACTCACTTTGCTTTAGAAATCTTAGCAACTGCTTCCTGGCTCCTTCGGAAGACATTTGCACATGAGTTTGAAGTGGAATGGACAGCATGGCTTTAACAAGCCAAATGACCAGAAAAGGTGAAAAGGACAGCCCCATGGTTGGCGGCATTTGGGGACAGATTGGAAAATGCCAGTTAGTAGAGCTCTTGGCCAGTGGAACCAGTTGGCAGTTGGGTGGTTTGAGAAGATGAATTTCAAGTCCCTTTCAGCCTTGAGATCCTGTGTTTCAGTGATGAGATATTTGAGAATGGCAAAGAGGCAAATAGAGAAAACTGTCCCCCTACATACGCATATACCTTAGGTGCCCAGATGGAAACAGCATTCTTCACAGTATTTAGGAAAACTGACAAAACAAAAATATTGTATAAATGCAGATTATAAATTATCCATGCTTGATTTCTCACATGTAAAATAAAAAGATCAGACAAAATTACTTCTAAAGTCTTCCATTCTGATATATATTCTAAGATTACCTTTAGATGACAGAATTAGTACAGAATAATATTGCCATAGATCTATTTGTAAACATTGGAAGTCATTTTAAAGAAGACTACAATTCTGCTGTTCAAAACAAAGTGTTGAATTCAACTTTGTTTTCTCTAAGCAGCCTACATAATTTACAGTTTAAGGAGAGAAAGAGCATGATCTTATTTATGAACATGGGATTATTTATTTTATTTAGTGACATCTGCAGAAAAGGGATTTTACATCTTCAAATTCCTATGTTGTTATATTTAATAAACACCATATTATTTCATTGGGCATCAGGAAATAAAGTTTTTTCTTAAATCATTCTTTGCAG
>TTN-213,,0,1226,2650042,2651267,GTAAGTCTGATTTTCTAAATATTTTGTAGTTTGTTGACAATATCACATTACAGCCAGCTGCAGGTAGCTTATAGTCAAAACCCTTAAATGGAGAAGTCTTTGGTTGTATATTTTTTGTTATTGTTCCTCTATGTCTAGTATTGAAACTCAGGATGGAAATTATGTTCACATTGCACTATTTTCCACTCACTTGATCAGTTTTCAGGAGATTGTCTACAGAACAGTTTAGGGCACATCTATGAACTTTCTAGAACATACATAAATGGATGATAGATATCATGCCAGTCCAGTTACCCACCGGGACAGTTGGTTTCTTCGTGCATAGCCTAAGCCCTCAGTCACTTAGATTGTAATGCACAAACTTTACATGCACACACACATGCACACACACACACACACACACACACATATACACATACATCAGCCATAAACACCCCGAATAAATAGCAAGGGAAAGTGAGGATATGCCAGACATCGGAGAAAGCAAATACTTCCTCAAAAAAAAAAATTCCTTCAATTCACGGTTGATAAACAGTGACCTAGAAGCATTTGCTGCTGTTGTGCCGTAGAGCTGTGTGAGGACAATCTCAGTGTCACTAAAATCCACATCTCTCCCGTATGTGAAATCAAACCTTTAAGTGTCAGGAGAGAGGCATTTATCTTGAATTCTTCCATGTCAAAGAGGGCGCCTGTGCTCATCCTCCTTGAACTCAAGCTCTTTGCTGATCTTAGAGCTACTTTCTTTAAAGGTCCAGTTGAGAACCTTGTACACTTAAAAGGCTGACCAGAGGCTGCTGACTGAATTTCCCTCTCCTTACTGTGAGTGAGACATTTTGAAAGCAGCAAGAACCCTACTTAGGATAATCAAAGGCATAGAAATCCCCATTGCCATTGCAATGCTGGTGACTGGCAAGTTCAGCTGGCCTATGGTTTTCCAGCCACTTGTCAGCAGCCACCCACCGGGTTCCCTAACACGTTGACATGTCTCAAGATGAGATATGTTCAGTTCTAGGACAATTTGCTAAGGCGCATGTGGGCAGAAAAGAAGCCCATTCCTCAGGAAAGCAGTCTATGTATTAAGCACAAGTGTAGGCCCCTGAAATGGAAATCTGACATTTTATCGTTCACCACTAAGCATCCTGTATTTTCCTGAGTGTTTCAAGGATGTCTTCCCATTGCTTTTGTATCTTTTGAAACTCAAATCTTTATTTTACTCTAAACATCAG
>TTN-213,,0,592,2651268,2651859,GTGATGACTTCCTGCCAATGTGAAAGTCACTCTTGCACCATTTCATTTGCAAATCACCTACATTTTCATCATGGATCTTAATCATCACTTCTTCACTTCCACCTCTTCTTATAATGCAAATAGAAAATTTCTTTTCCCACACAGCTACCTTTCACTGTCAATTCATTCCTAACTTTCAGACTTTCTTTGGCTTGTTACTAATATAATATAATAATTCACTTTAATATCTTCCTATTGAAGCAGATGTCCGTAAACAAGTCAATTCATAATACAAAAAATTATGTGCTATTTACAGTGCTACTGAAATGTCTCAGAGATTGCAGTTTTAAAAAATGTGAAAAGTACAAAATAGCACTCATTAGTCTTTTATTGCTAATCACATTTTTTTCTTTTAAACTGGACTTATTGTTTTGATATTTTTGCCAGTGAAACAGTATGGATGATCAAAGTAACTCAAATGATATATTTTAGTGCAATTAAAATTTCCTTGAATAGGAAGAAATTTTGCCTCCTTTCTTTTTGACTTACGTTTCTTTTATTAAAGATTTATGGAATTTAATGACTATTTTCTTACTTTCTTTTGTATGATCAG
>TTN-213,,0,480,2651860,2652339,GTGAATACAGATATTTGAGCTGTGAAAAGTTCATCTTTAAACTAATTTCTAGTAAACTATTAACTACAATATGGTATGAATTATTAATCTGTATTTGCCTTTTAAAATCCCTAACTAAAAACAAAATGGTAAATATGAGACTGATTATCATTAATTTTATCTGCACATTTGATTTTCATCCATCTGTAACATTTATAATTCATTTTATTCACCATTATTCTTTGCATGAAGATTAGCATTTTTTAGCTTAATTTTTAAAAAGTGACACAGGGACTCATCTAGAGGTTTTTTAATAGCTAACATTTCTAAGTTTTGTGATTCTCAGTCAGTATATGTAGACATTGCCGGTGAAAGTTTATTTCTCTTGTGTATTTAACCCTGAATAACCATCTTGCATCCCCATGAGGAAGGGGGAAGGGTCATACTATGTGTGTTTGAAGCCCTGTTCAACTTAAATCTTGATTTTACTGTAATAATCAG
>TTN-213,,0,3218,2652340,2655557,GTGACTATTGTTGTTCCAAGTGTGAAATCCCCTATTATAATACATTAATACCACATATCATGTGAAATTCCTTATTGTAATACATTAATATCAAGTCTCTGAATTTCTTATGTATGAGTCACTATTAACCAAATTTATTTTTTAGACAATTAAATAATTGGAAACTAAAAAAATTTATTATTGTTAATATTACTACATATCCCTTTCTCCACTTATCTCTTCACCATTATTGTCAACATTTTATTAACATCTGGGAATCTTCCAGAAGTTGATTAAAATTGCATGCAGGCTAATTTTAAGAGGCCCATGAACATTTTTTAAAAACACGGAAGATGTATAAGTAAATGATGACTCTTACTCACTGTCAAGAAGATGTGTGTTTTGAAGGGTCATAAATTCAGTATATTATGTTATGGAGTATGACTTATTTCAGTAAATTACCCATAATTTTCTTTGTATGAAACTTTATCTTTTTTCCCTCCTGTAAATATCAGAGGAGAAGATAAGCTGAAAAAATTATAATGCATGCTGTAGCAGCTCCCACTAAAGCTAAACAAGATGCATATTAAAATCTAGAGAAGGAAGTATCCAAACAGAACAATTACACATAAGCCATGAAAAGATTACCGTATCTATTTGTAGCTATGAAATATCCATGAATTAAACTGTTTCCCATGACTCTGTCATTTACTCCAAATGAGCCATTTACCTAATTGTATTCTTTATTGCTAATATACCACTTGAAAATTAGCAACTAAAGTTTTTCCATTTCATTAGCAGGATGGCCTGAATCCTATTTGTATTTCCCTCAGTGTCATTTTCTGACTCTACATCTTTTTTTTCTAAGATATGATTTAAGATAAACTTTTTAAACCTTTACTCAAATCTAACATTTAATGGCATATCAGCCTTTCAGAAGTCTCATAAATGACAGAAATTCCACTATGCAACATACTTCATGAGTGATTAACTTTTTACTTTTGTTTCCATTCAAATTTTGTCATGAATTGACTATCTTGTTTTTGTTAAAAATTAGCTAAGGATGGAAGCTGAGAAAATGTTTATACCTGAAGTAGTAGTTACCACTGCAAAATCTGCTGAACCAGCCACACCGCCAATGACTAGAGAAGGATTCACTATTAAACAAAAACAAATACATCTTTTTCGAGAAGAGATGAAAACTGATGCTATGGAGGTGAAAAGTATTGTTTCATCCCATTTCATCATCAACTCTCATAACTTTTCATCCGTCGTGAATTGTGCTTCTAGTGTTCCATCTAATTGTTTAACTGATCAATAAAACAATAGAGATGGTTAGATTCAGTCCATCCTCCAGTTGAACAGTGAGCATTTCTAGTAGTGAAAAGTCAGACCAAATAATACTCTTCTTTATGTCTCCTAAATTTATTCTCAGCATTTAACTCGTATGAATTGGAGTATTCTAGTCCAATTTGTCTTCCTGCTTCTCTAGGTTACAAACATGTGAGAGATATCAAAGTCCACTAAGAAATAAAAGCGGTTACCAGCATACTCATTTGTAGTCCACCAATAAGTGTGTGTATATAAATCTGATATACAATAATTCAAGGAAAAAACAGACAGATGCTTCCTCAATTTAAAATATTTTACCATGATTAAGATTTTTCCATATGTTTAAAATCAAGAACAAAATTTAAATATTTCAGTTGTGTGATATTTAGTCATATGACAGTTTCTTTGACAGTTTCTTTTATCATTGTTAAAATAAAATTAAGACTTAAGCTGACTACTTCATAGCAGACTGGCTAAAAGGTTCAAATGAGATATAGTGGAAATGTGATCACACTACAATCAAAATAATATTTATTTATTTAGTGTTATCTGTCGAAGATGTTAACATTTTAAAATGTCTATACAATTAAAGTCAGCTCATTGCCAATATAGTTTTTAAAAAAGAAAAAAATAAATGGACAAACTTAACTCACCTAAGCCTCATGTGTATTTTATGTTTTTTTCTGAGATGATGCAATCTAAAGTGAAGATGGTATTTGCAGTCCTTCGAGGCAGATGAAATTGTTTGTGTCTTCCTAAAAGGAAGCCCTGGATAAAGCCCATGATCACTAAAGACCCAATTCCATCTCAGAAAAATCTCATTTATATCTTGAATGGTTCAGAGAATAATTTTTAAAGATATGCAGGTAGCATAGTTGAAGAATGTTTCTGATGCATTCTAGATTCTATTCACAGGTATAGAAAACTGAATATTAATAAAATTTTCCAATCTTACTTTTAAAATGCACTTTTAAAATGTACTTTTAAAATGAACATGGCTATGTGATTTTTGAGGTATGCTGTTTCCAAGTATCACATAGAATCATAATATCTAAGCCACATCAGCTAGTTTGCCTTCTTTAAAAGAGAACCTCCTCTGCAAATTGTATTTCCATTAATGTTCATCAGACTCAGAAACGAGAAAATAATATTTGTTTCATTCTTTGCTTTAACTCTCCATAATAATGAAAGTAAATTAAACTTCAATGTGAAAGGTTGTTCTCTTGAATCCAAACATGATAACACTTTCATTTTAATCACAATATTTTTATTTGCACGGGGTTCTCTTTGTCATCTGTGTGTTTTAAGAAAGGTATTTTCTGATAGATTAAACAATCTTACCCTTAGGGAATCATAAGTAAATTCATATGCTCACTCTGTGTTTGTGAGCTTTCATGTTATGTCCGATTTGCATGCAACCATATAACTCTGTAGTCACTGATTTTTCTGGACAGGATGATGACGGTATTTGAGTGCACTTATATCATCACTGTCACTGCATTAATACCAGACTAAATGGTCAACAAGATAATAAAAATAATCAGTGAAAAGAACCAGCTCCAAAATTCTGATTTTCCAATTGCTGATTGATTGTCTGCCTGGAAAAATTCTAGAAAATTTCAAAATCTTCTTGTGATTTTATGTTCATATTGTGATTGTCCTATGTTGTGTATATGTGATTTAATGTCTAGTATAATTAAGTAGGTGTACAGAGAGTATATCTAAATAGATGTCTGTACAATATAATAATCAATGAAATAGTCCCTAAAAGTGTTTCTGAGATACATTTCTAGACACGTTAACACTGCTGTATAATGTGGACGCCATCTGCCTGTCCTGATGCCCAGGAGATATTCCAGCCTGATCTCGATATTCCTATGTATTAATTCTGGAAACCTTGTCTCCAG
>TTN-213,,0,105,2655558,2655662,GTGAGTCTATACCTGCTGATTTTTCACCTTGTTCATGGTAAAGCAAGCCTCACTGCTGTGGTCATCTGGTGATCAATGGTATCACTGAGTTTCATTTCAATGCAG
>TTN-213,,0,1268,2655663,2656930,GTAAGAAGTTACAGAGCATGATACAGAAATGTTTAAAGGAAATAAGTATCTAACCTGTGAAACAGAGCATCTCTGGGGTAGGCCAATGGAGGATTCTTTTTTGGTGATGTGTGTGTGCGTGTGTTTGCATTCACAGTGGGCCCAGACACCCTAAAGATTTGGTTTCTGAAACTCGCCCAGGGGAGTGAGCCTAGAGTCACAAGTGGTTATCTTATACCTCTGAGGAGAGACAAATCCACACAGGCTTCTCTCTAGTTCACATTTCAGGGACAGCTCAAACTCAATTGTTTTGATTACTATTGTTCTAATGATTTTGTGAAAGGTAGTGTGTTACACAGCATAGTTTTACTTATGCTGTGAGACATTTCAGAGTAACTTAACTGTGAATGTGTTTCAATAATAAAGACAGACATTGAGAAATCATATATTTATATACTCAATATAGCAAGATGGAGAGGTGGTACTGTATGGTGGTCGGGTTGGATTGTGGAATCAAATAGCTCTGGATTAGTGCCCTATCTTCTCCCTTATAATCTCTGTCATCAGGAGAAAGTAAGCATACATGTAAAATGCAAGTAAAAAGGACATAAAAACCTGCAGTTGTCAGCATGTAATAAATCCTTGATATTAGTCACTATTGTTATTATACACATCCAAGAAATAGAACCCAAACCTTCTATGCCTTCAAAGAACTGTAAGTTACATATAATGCCTATATTTGATTTAGTCCCAAATTACAAAACAAATAACCATAGACCACAACAGAATAAAAGCAGTAAGGAAACCTTTAAAATATTTTTTCTGAATGTCTTCATGTTTACCTTTCACATAGATTTGTGGCTAAAACCCAAATGTACTATTGCAAAGTAGTTCTTAGGCATTTACCAACAATTTCAATAATTTCTTAATTTTGAATCTCCCACTGTGGTATTTTCAAAAGTGGCATTCATCGGAATGGTTAAGTGAAAATTCGTGACTAAGCTTTAGAAGATCCTGTCCTTTTATGATAAAAGCTGTAAAATAAGGAGTTCTGAATACAACTCTTTAAAAAAGATATTTTAAAATTTGTTTTACAAACTAACAGGCATGACAAGGAGCTTTATAATTGGCTTATCTCTAAATGACTTTTCATTAACTGTGTGATAATGAGTGCTAATGAGAACATTAAAGAACAGACCTTATAGAAAATAGGCTCAGACTCAGTCCAAGAGGGCTAGCCATCGGAGGATGGTTAAATGACTTTATTTTCTGACTCTGTTTCCATGTAG
>TTN-213,,0,284,2656931,2657214,GTTGGTCACTGGTTACCCGCTGTTACATGGTCCACTCCCATTGAGCAGGGCCAGGTGGTTGGCTAGTTTGTACTGAAAAGTAGCCAGTGGAGTCTTGCCTTTCTCCTTTGCCATACTAAGACTTGATTTTTATGGAGCATAGTATGGGTCAGAGATCATTTTCTCAAATTATTTTTATAATTATTTTTATATTTTTATAATTATATAATGTTGCATGAGCTAAGAGTTTATGAGATTTCCCTTAATTTCATGAGCATTTTGTAATATAATTTGTAAAAATCTAG
>TTN-213,,0,655,2657215,2657869,GTGAGTAAAGAAGTTGATAATGCTGGACCCTATTCATATCTCCTCAAATCATTTTAATACACGTTTGCAAAGATCAGTTTCTCAAATTAATACAAAAATGACATTAGTGAGCTTACAGATGCTCATTTTAAGACCGTATTTGGTCTGGAAGACCATATTTGACCATATTTGGCAAGGAAGAAGGGAATTCTATGTGGTACATCATTCATGGATTCAAAAGATTTAATGAGCTTCTAATATGCAGAAGGCATTATTGCAGGAGCTGTGCAGACATAAAGACCAATCCATCCCTCTTTGAAATATTTTCTTTGCCATCAGAGAAAATGTACACAAACAAGCATAATAAAATATATAAGGTGATAAACATCACAACAGAAGGAGAATCCATGGGAGGCATAGATTCATTCCAGTTGGTGATACCATGGCAAAGCTTTGTTGAATAGGTAGCATTTGCTATTGAGCCTTACAGCTCTTTACTAATATATTAGTATATTATATAAATATTAGTTTCTCTACTACTATTTCTGGAGTCCTGATTAAAAGGCCATTTTGTGGCAGTTGAAATGCATAAGTTCAAACTCTACATTTGTTACAAAACAGAAGTGATTAATGAATATGCACACGTATCATTATTTATTTTTTCTCCTCTCTTCAG
>TTN-213,,0,203,2657870,2658072,GTTAGTGGCCACCCTCCCACAGTCCTAATGCACATGCCATCACTTTCATCTGACACTCTTTTCCACAATATGGTTTCTGTGCACCTTGAAATGATGTCCCTTTTTGGAACTTGGGGGGAGATTATATGGTCAATTTAACTGTCAGTGCTAAGCAGGGGTCACTAAACATCTCATCTCAATGAGAAACTTTTGTCTTCTTTTAG
>TTN-213,,0,111,2658073,2658183,GTAAAATATTTTGCTAATTAGTAGCTGTTCTAGTACCATTTTGACTTTCAGCCCCACCAGTATTGGCAAATTGCAACCCGGAAGCTAATATGAGGGGAATTCTCTTTCCAG
>TTN-213,,0,948,2658184,2659131,GTATTTTGATGGCTGAATATAGAGTTCTCTGTGACTTGTATAATACGTGCATGAAGCCTAGAGTAGAATTTACTCACCCCACCGACCCTGAGCATAGGCTCTTTCATTGTGGAGCCTTCTTAGTTTGTTTTGAGGTATTTTTACATTTTTTTTGTGCAAAGTCTTCCTAAGAAATAAAGCTATGTGACAAAAGTGGATGGAAGATATATTTCTTTACATTATAGTTTAATTCATTGAGTTTGTGAAAGTAGAGAAAATATGGATTTTCACACAAACACACCCACACACACACACACACACACACACTTCCAGAAAAGATTTGAGACAATTTTCAATAAAAACATGTAATAACTAAGTGACTAAAAGATAGAAGAATAGCCATGTAATGAAGAAGAAAGCTAGTTATGCACAAAAATCTATGCTAGTAATTTTTCTTCAATTCAATATAAAATTTAGCTCTGAATATTTTGCAATTTAAGATAAAAAGAGCAACCTGGTAATCTAAAAATGTAGGTGCCGTACCTTCATAATAATAAATATAATGTACCAGAGAGTTAATACTGAAATATTTGAAGGAATTTATTGTTTTAATTATTCATTTGATCTCTGAATGAAATAATGAGAAAAATAACGAACAAAGAGAAAATACCTGTTGTTTAAGTGACCTGATCATTTGCTAACATAAACACTGAAAACCACTTAATTTCATGACTGATTCTAGCAATAAATATTCTTTAAAATGAATATTTTAACTTATTTGGCCCTAATTACTCATGTTCTTGCATTTTTCTCAATTTTCAGCAATCTTATAATCTATTGTGGAGCTTAGTCATATGTTTAGGGTCATTGAATTTTATACCACAGATCCACTCACAGATAAGTCCAATTATTTTACCCACAGAAGAGTTGTTGATAACTGATTTTTAAATTTTGTACATTTACATAAAG
>TTN-213,,0,915,2659132,2660046,GTAAGTGCAACTCCAGTTTCTATGTGCATGATAAGAACTGAAATACAAGGAGATAGCAGTGCTGTCCGTTTGCTGAAAAACCTGTTGCCACTTACTGGTTCTGATACTTTGCCCCAGTGTCTTTGCCTCAGTTGTATGGAAAATGTTTTAGACCACATGGCCTCAAAAACTATACTGTCATTAAACTTCTGAGGTTCTAGCAATAGTTTCTTTTTGTTGTATTTGTTTCTAGGCATATCATGCCTCTGAAAATGCAGAGATTCTAAATCCGGTTGCCTTCCAGGCCCAGGCAGGTAACAGTGAGCTCAATGAAAACAGTAGCAAACTGGAGAGTAGGTGCCCTGCCTCAAAGAGACAGTAGCTGTGTTGTTGCCAGGCATGCACCAGGCTGTTACCAGGCTCAGTGTTGCTAGAGCTCCTGATATCTTAAAGAAAACCTGGAAGTCAGGATTTTCAATGTTTATAACTTGAAAACAAATGTAACAGCTTTCATGCTAGACTGTTCACATTTACAGTGAACTGGCTCACACTCTGTTTCACTTGACCTACACAGTATCCCTTAGAGGAAATTACAATATTATCTTCATTTAGCAGATAAAGCACTCAATATTCAGGAAGGTAAATGAATTGTTAAAAGACACACAGCAAATTAGGAAGTCCTCCGTGGTAGATCCCCCCAAAACTGACTGCTAATATAAAATTCTTTCTACAATTGTAATGGCTGGTTGGATTTGTTAGTGTTAGTTTGGTTTCCAAATTCCATCTAGAAAATATTGAGCACTTCAATAGTAGATATTTGGAAAATTTGGTTTTTGGTTATCAACTTTCCCCAGTGTAGAGTTTACCTGAATGCATAGTGGTATGACTGTTTTCTAATAAGAGCATTAAAAATTAACTGATGTTCTTAACTCTTAG
>TTN-213,,0,537,2660047,2660583,GTGAGTATAAAAGTAATGACCAACCAAACAATTTCATAAATTATACTTTCCTTTTTTTATTTGATATTTTCATTTTCAAGTGATGAGCTCGGGGTTAGACAGCTATTAGAAGGTCCAAGTTCACTGTTGCTAAGTTTCCTTAATCTTCATGGTATGTTGCACCTGTGAGTTTAGAAATAGAGATTACATATAGGCCATAAATGTGACTTTAAAAATAGGGCTTATAATATATTAAGGAAAACACCAATATTAGCACAGCTGAGTTCATTCATGCCAAGATCTCTTCATCTGTGTGATAAGCTAATGTAACCTCTAACCCAAATCTAACTCCTGCTTTTGGAATACCTTTCTACCCAAGATGCCACAACATTCACTGGGAAAGATGACCATAATGCAGATTAAAACAAACAAACCAAAAAGTCCTCTAGATTCTTCTCCCAGCTAAAAACTTCAACAGTCTAGCTCAGATACATCTCCTTAAATAATTTATATCAGTAAGGATATGTATTTTTAACAGACCATAATCTTTTTGCATAG
>TTN-213,,0,110,2660584,2660693,GTAAAATATAAACATTTATCATAGCTCCTTGCCACAGTAAAGATACAAATTGGTTAAAATATAACTATTTGATGTAAATTTTATTCATACATGCATGGTATTCTTTGCAG
>TTN-213,,0,898,2660694,2661591,GTAAGACTTGTAATAATTTGGGTTATTTAGTATGTAAATTGTTTTCAAAACATCAAATAGTAGCAAATTGCTATTGTGTAAGAAGAAAATCGAGGGCTAAAATGGCACAGAAACTTACCATTGGCAACACCAACAATTGCCAGAAGTTTTTATTTCTTGCCCCTGTGTAAGATGAGCAAAGAATTTTCATCAGTGTAACATACTGTTTATTTTCCTAGTGCTATAGCTAATATCACAATAGCTCTTATTTGACACCTGATTTTTACATATGTAAATTTATACAACAGCCCTGCAATAAAAAGATGACTATTATTGGTTTGGAAATAGGAACACTGAGGCCCTGGGAATCTATGAAAATTGTCTTAATTCATCCAGCCTGTAAGCGGTGGTGCCAGCATTCAAACTCCAAGTCAGTCTGGCTGCAATGTGTAGATGGAGTCTTGTTTTGCTTTGTTTTGTTTCCAAATTCATTTCTATGTTTTCCTCCTCTGAGATAAAGAATGTGTATTTTTTATTTTTCCATAAATGTATTCATTGGTTTACTTATCCAACCAACATTTATTAGGATGTTTTAGTAGTTAAATCAAAAAAGTCTAGTGACTGATTAAATCCAAGTGGTAAGGAAAAGAGAGTATTGAGGATTATTCCAAGATTTTTGAGCCTGGGTACCTGGATATACTGAATGACTACCAGCTAAAATTGAGAATATAGGAAAAACATAGTTGTGGGGGCAACAATAATATATTCTATTTTAGATCTGAATGAGTTTGAGGTGCCTTCTAATACGTGCAAGAAGTAAATTCTAAAATAACATGAATAATGAATAAGACAAAATGAAGTTTGTTTTGCTGAGTTTTCTTTATGCCTCACGAAAGTATTGTGTGTCTTTGTTTTGCAG
>TTN-213,,0,119,2661592,2661710,GTAAGCGTGATAAGTTTTTGCTCATGAATCATAAAAACACAAAAACAAGCTTATGTATGCATCTAACAATTTTTAAAAACTATTTTAAAATCTACTTTCTTTTAAACATATTTTCACAG
>TTN-213,,0,102,2661711,2661812,GTAAAATGAGATAAAATAAAAATAAATGAATTTTCTTATCACTTGGGTTATAAACAGGTATTTCAGCCTTACTCCCTCTAAATCATGACCTTTCTCTTTCAG
>TTN-213,,0,99,2661813,2661911,GTAAGTATGGAAATAATAAAGCTAAGCTCATTATACAAATCCAATAACCAGGGAAGCTATACCACTATATTGATTATTCCCTCCCCCAACTTTTTATAG
>TTN-213,,0,153,2661912,2662064,GTAATTTGCATGTCTTTCCTTTGATGGACCTGTCTTTGTATTCAAGAATATCCATGAGTGTGTTTACTTTTATTTTCTTTCCCCATTCCTCAGGTTGAGAATTTAATTTAATATAATGTGCTCTCCCCTTTTTCCCCCACCTTTTTCTTGTAG
>TTN-213,,0,447,2662065,2662511,GTATTCAACAACGAAGGATTTCATTGTTTACCTAAGCTCTAAAGTCACCCTTAGCATGTGGTAAAATTAGCTATGCAATTTTTCTTTCATGAAACAATTATTTGGAAATTGACTATAAGTTTCATAGCCAGAATCATAAATTTATGTTCGTAATTAAGAATGTTAACAATTTGACCATTTGGATTTTTTAAAGTAGTATTATCTTGATTTTTAGCTTTTAAGTTTTTTATTGAAGCATAATTCTTTACTTTCAAAAATATTTAAAAATTAAAATAAAATAACTGCTTCTTATTGAAAATTTATCTCTCAGCCCATCAGCGGGTAGATATTAAGAATACACCTGATAGTATGGGGGAGATAAAAGACATACAAGACATCATCTCTATCCTAAGTCTAGATGCATACCTCTCCAAAAAAATTGATTTATCTTTCTGTTATACACTTCAG
>TTN-213,,0,96,2662512,2662607,GTAAGTCCTCCCATTCCTGTCAGCCTGCAGTGAGCATCATTATGGTTTATTGATAAAAAATGATCATAACATTCTTTTTCTCCCCATATTTCACAG
>TTN-213,,0,112,2662608,2662719,GTGAGTCCTAATTATAAAATTTTATGTTTACACTATTAAGCAACATAAAGAACTTCAAGGAGCAGACAATTTCAACAAAATTCATTCATCTTGTGTGTGTATGATTTTGCAG
>TTN-213,,0,92,2662720,2662811,GTAAGGATTATTCTACCTATCTAATAATTACTTTAAGCATTCTACTTTCCCAGTGTAACAATAACCAAGAGATTATTTTATTTTTTCCCCAG
>TTN-213,,0,1637,2662812,2664448,GTTGGTATATTTATTAACCTAAATTCTTACGAGGAGTGATTGTTATTTTAAGAAATTATTATTCATTTCCCCCAAAATTCCTTTCAGTTTCCCACTTCCATGCCTCTGCTTATGCTGTTCCCAAAGCCAATAGTACTTGCAACACCATTCCCACCAGCCTAAATTACAAATGTTCTTCTAGGCCTACCTCAAACGTCACCTTCTCCATTAAACCTTCCTTAATCTCTCCATTTGTATATGATCTCTTCCTCATCCAACCCCAGGATCACTTTATATGTGCCTCTTTCCTAGTGTTTATTATGCACTTGTCTTATTCCCCATTTCCTCTTTCAATATCAGTGTATAAACTCCTGAAATCTGGAATTCTATTTGTATATTCCAATATATTGCAAATGACAGATAATCAATTGGTGTTTGCTGTATTGAGCTTTATTTAAACTTCCTTACTCTAAAGAATTATTTCCTTTTTTAGCCATTCTTGCTTCTTTAGCCTTTGTGCCTTTTATTTTCTTCCTACTTTTTAATGAAATCAATAAATATTTTCAAAATACAGCTTAATGTAACTGTATTTCTTATGATATCATGTAGAAATAAGACCATCATTCAGTAGAATTTCTTAGCTTTACAATGAAGAATAAAAAATGTAAATCAATTGCCAGAAAAAACTAGAAGTCATCATTAATTTGTTTGGTTCATTACAGTTTAAATTTTGAGGAGTTGAGATGTTACATTCAGATCGTGTTGTCCATTACATCTAGTATTGAAGCAAGTCATATGGTAATGATTTGTCTTATTTGGTATGAAAGTTTCATGGTTTATACTTACTTACGTTATAAGATTTCTTCAGAGATCGGACCATGAAAAGACTTGTAAAACAAAATTTCAGATTCAGCATTTTTATACATTTAATATAAATTACATGTTTTAAATGTGTGGAAACAGGAATAAACTATGAACTCCTCTGTGATTTCACCCAGTGTTTTTAAAGTACCTACCATTGGTCAGACACTTGTAGAAACTCAGGACACAAAACTAAATAAGAAATGATTTTTTTCTTGAGAAATTCATAATTTAGAGAGGACAGATACATAAGCAACTAGCTTGTTAAAGCAGTAATTATTTCTGCTAATGGATGATAAGAGTGGAGGCAATGGGGTGAAACTTCATAGAATGGGCGACATTTGCCAACACAGTGATTTTTAATATATAGAAATCCTCAATGTAGTAGAAACATTGATGACTCGTACATTTTGTTTAGCAAATTTTTATGTAGTCAAAATATCAGATTCCCAGGAAATAATCATTAAAAGACCAAGTAAAATGCTTTTGAAGAAGAAGGAATTGGGTTAGAGACTATCCTGGTGGTATACTGTTCTAAGAATTTCCTATTAATTCAACAGTTATTTTTTCTTCACAAAACTTTTCTGATTCCAGTATTTCTCCTAATTATCAGTTATGCATACTTAGAATAAGGGATTTCTTTGGTACCTTCTCAATATGGGTAAAAACAATCATAGACATTTCATGATTTCAAAATCATGTTCTTAAATTTGATATTTTATATTTACTTCTGCAAAGATTTTCCCATTGTGTGAATATGTTTAAAGGACTCATACTGTACATCTCTTGTTCCAAAG
>TTN-213,,0,535,2664449,2664983,GCAAGTAACATAGGATTTGTCCTTTTCAAATCATATTACAATCTTGATCGTTATCGTTTTAAAAGACAAACGATATGGCCATTTTGGATACCATAAATTTTCATTTCATAAAGTCATTCTAGATCCTCTAAACCTTCCTGAGACACATTCCACAAGGTACAAAATTGCTTATCAAATGCGTTTATGCAAAAAAGCCATTTCTTAGGTTAAAGCTCTGTGAAACAGCTAAATCAGACACTGATTCTCCATTCGTCTTTCACCCTTCTCCAATCAGTCTATTATGCTGCTAATACATAGCTATGCAAACTTCATACTACTAAAGCATAGAAAAATCATTTCACGATGTACATGTCCAGTTGGATCCCAGGTTCCCCTAAATAATCTCAGGTGTTTTTTAAAACAGAGGTGCTGCATAACTGTAAAATGTTTGGTAGCCATTCTTTTGCAGGGTGAGTAAGCAATGATCTTGTTCAGGACTTCTTTTCCTTGATGATGTCATCTATATTTTCTAACCCAATCATAAATTTGTCTTTAG
>TTN-213,,0,91,2664984,2665074,GTAAGTTGATTTAGAAACACTTTTCAAGCAGTCAGCCCATGGTTACCATTAAGTTAACCCTATCACTGAATTGCTCCAATTTTCCTCTTAG
>TTN-213,,0,120,2665075,2665194,GTAAGTATCAGGCAGCCCCCTACAGCCCTTTCCTTAATGAACCCCATGTATCTATTTGTTTGGTTTCATCTACTTTTTAAACAAATTGTATTAACTGAAGTGCTCTTTGATTTTACCAAG
>TTN-213,,0,745,2665195,2665939,GTAAGTTAAAAAATATATATATATATATACACATATATATAAAATATCAAATATTCAGTAGATTCATTGATATTCTATATCCTACACTTTGCTGACCACTCAAAAATCCTTGATTGGGTGGGCAGGGTGGCTCAAGCCTGTAATCCCAGCACTTTGGGAGGCCAAGGCAGGAGAATCACTTGAGATCAAGATTTTGAGACCAGGCTGGGAAATACAATGAGATCCTGCCTCTAGCAAAGACAAAAGGAAAAAAAAAAATTAGCTGGGCATGGTGGCACACACTTGTAGTCCCAGCTACTCAGGAGGCTGAGGTGGGAAGATCGCTTGGGCCCAGAAGGCCAAGGCTGCAGTGAGCCACAATCACGGCACTGCACTGCAGCCTGGGCGACAAAGTGAGAACCTGCCTCAAAAAATAAAGAAAAAAAATTGTTAATTGAAACATCTAGTATGTGGTTACACTGAGTAAAGCACTAGTATCTCCACCTGGATAAAATGTTCCAGTTAGAGTAGCATTGAAAGGCTACCTGGAAAGATGCCTCAGTGTCTATCACTTGATCTTTCTGTTCCTCTGTGAGTTGGCACTGTCCTGTATAGTACATGGAAGGTATCAAAGCTTATATCTCTAAACTGTAATCTCCTCAACAGACGCACTAAAAACATTCCAAATTTTTATTCTGCACCTGTTATAACCCACATCATATTTACGTAAAGTCTCCTTGGGTGTTTTTTCTTTTCTCCTTTGCAG
>TTN-213,,0,517,2665940,2666456,GTATGGTTTCATACATATTAGATCCATAGAAAAAATGTCATACATGCTTTATAAAATTTAGTGTATCAATTAATGAATGGATAAATAAAATGTGGGATAGCCATACGATGGGATATCATTCAGCAATAAAAAGGAAGCACTACGATATGCTACAACATGGATGAACCTTTAAAACTTTATGCTAAGTGAAAGAAGCCAGAGACCATACAAAGACCACATATTGTATGATTCCATTTATATGAAATGTCCAAGATACACAAATCTATAGAGATGTAGATTGGTGGTTGCTTAGGTCTACAGGGGAGACAATAGAAAAGTCCTTGGGGTGATGGCTAAGGGTTACATGATTTCTTCTTGGGGAATGAGAATGTTCTAAAATTATGGTGATGGCTACACAATGATGAATACATGGAAATTCATTGAATTGTATACTTTAAATTGGTGGATTGTACAGTATGTGAATTATATCTCAATAAAGCTGTTAAAAATGTTAATTTTTCTACATGCTATTTTCCAG
>TTN-213,,0,89,2666457,2666545,GTCAGTTGTTTTGTCTTGCTACATTCCAGTAATTCCCAGTTTCCTCTGAATCACCATACGGTAAACTCGAATTTCCATTTCATCCATAG
>TTN-213,,0,1146,2666546,2667691,GTATTGTCTACATACTAAATGTTTTGAAAAATCATCAGTAGTCCATAATCTATCATTTTATATTTTAATGTTTCCCTTTTACATTTTCTAACCACCATCCTTTAAAGAATTAAATCAGCTCATTCTTACTTGGCTTAGACTCTCTTATGCTGACCTCAATTTAGTCACAGTTTCCACTCAGGGAATAAGGGTGTCCCTAGCAGCTGTCTAAATACGTTAATTAAAGCAGCTGTAGAAATTTCACTGTCTAATAAATGGCTGCTTGCCAAGCAGCACCAACCAGAAAAGAATTAAAATGTAAATCGTGAGGTTCACACATCAATTAGAATTAAGGAAATTTAGAACAAGGTGATATTTTCTCAGAAGGTTTCTATCTGTGGAGAGGCAAGTGTCAAGGAACTTAGTGGCTAGAAATACTTTCTGTGAAGTCTAAGAGAAAGCCCTGTCCAAGCCGTGCTGGGTTCCTGGCAAGGATGCTGGGCACTCTTGCTGTCGGCTGCATTTACAGAGCTTGTCCTCATAAGTGTCCACCATCCCAAATGATATAATGGAGGAAACATGTCTAGAGAAATACCAGTTGAGTTCAGCTTTATCATATTGCTCATCCAAAGAAAACCAGGCTTTACAGACTGTGGACTATAATGAAAAAGGCTTCAATGAGGACTCAGATAACCTGGAGATGTCTTCCATCATTTATTTGCCAATTCTGAACCTCAGTGTTCTCACTCTTAAAATGAGGATAATAATTCCTACCTAGCCCACAAAGTTATTATTCATATAAAATGAAATCAAATTAAGTAATAACTTTTTAGACAATAAAAAGCCCCCAAAGGTAAAGCATCATTATATCCCTTATTAGTAAATAAGAAGCAAACATTTAAGGATGAAATAATTGTCTCTTTGGGGCAGCTCCTTTCCTCCATGCAGCTGTAAACACAATTCTCTACAAGAGAAGTTTATGTACCATTTGTCCAATACTAGGCAGGAAAAATTAGAGAGTGCTATAATCAGCCAACTTATTACATTATAATATATTGGTTTCACATGCCATTCATTGACCAGTTTTAGAAATTGATTAACTGGGAGGAAACCAGAGCTTCAAGTTTTTGTTGTTGTTGTTGTTTTTTTATGTTGTTCCATCAACAG
>TTN-213,,0,1569,2667692,2669260,GTATGTAGGGACAGATTTCAGCATATTTTGTGGATCCATCAGAAATAATCCTCCTGTTTAAGTCACTAAATTCTTGTAACTTGAAGGAAATTTCTAAAGAACCTATGGTATTCATGTGGTTCCAGCTACATTTTTTTTCACATTATATCTATGGAAAAGGGAGGGCAGCTGTTAAAAGACCTATTGAGAAGTTATTTTCAGAAAGCACCTGATGGCCAGATCCTCATCTGGTTGCTCAAAACTATTGAACACCCATTGGGTGTCCATTTTCATATACCCCAGATGAGCTTCTAGATTCGCTGTTAAACTATTTTAGTTCTCTGCCCTCTGCCTGAACTGCTCAAGTCCTAGCAGCACTACCAAGTGAAAGGGGTGTTTCCAGCCTCTGATATGGAGTGCCTGGGAGAACTCAAAAGTCCTCTTTGAGACCCTGGAAGGCCTAGAGAGCCTCAGGCAATGTGGAACTCGATCCTCTCTACCCCAAGCTCTAAGAACAGGGGCTCTTACTTTGGACAGGGAATTCCACATGCTACCAAGCACTCCTGAGGAGCCTCTGAGCAGTCCCCAGGGAAGTGCTGTTAAACCTCTGCTCTCCTCATTAGAAATCTTAAGGCTGAATCTCAAGCTGACCTTGTTTTGAGTCTAACCTAGATGCAAGAGAAAAATGGAACCTCCCTTCCTATTCTCATCCTAGGCCATATCTCTTTGAATAAAATACCCCTGAGGCAGATGCAGGAACTCCAGGGGTAATCTCAAGATTCACAAAGATGAACCATATCGCCAGCATTCCCTAGGTTCCTAGAAGACCAAATGGTCATGGCATCCAGTTCTTATTATCTCTGTATTAGTAGTGGAGAAACTGAGGCACAGAAAAGTAAAGATCTTTTCTATGATAGTGTCAGAAACCAGCCTCACAGAAGTCATTTCTTCTAATTTCTGGGTTCCATGAACTAACCAGGTCCCCTCACTCATCACAGCACTGAGAATATGCTTTAGTTAGCAAAACAGGAAAGCTGAATTTGTTAAGTCTACCTAATGGCATTTAACTAGATCTGAAATAGTGTTAATTCAGTCATTCATTCAATACTTACTGATTGCATTTTACTGGCACTGGTACATAACAAAATGACTATGACATAAACACAAATACTTGCAAAACAAACAAACTGGAATGATATGAGCCTCTTCACCACATGATTTGTCCAAATGAATTTTAAAAATAGGTAGCACACGGAAGTTATTGTATAATTCATTCAGGTGTCCATCGCTAAGCCCCCACCACAAACAGAAACTGGGATAATCAGGTTAACTCGGCACTCTCAGCATGCCCCCCAAATATCAAAAATATCTTTCTGAAGCTATTCCCTCTGCATGTGGACAAATTCCAAGTGCTTTCTTCATTCTTAGCACAAAGAATGTTCTAATATTCTGAGGCAAGTAAAAATACCACAATTCCAAAATTTTGTCTCTGGATGTATAACTAGCCAGCAACAAATTAATGTAGAGTTTTGCATGCTCTCTTGTGTTTTTACACTTTTTCATGGGCTATTTGTCAACATTTACTCCTAG
>TTN-213,,0,224,2669261,2669484,GTAGGAATGCCTCGCTACTTCCAGCTGAAAATAAAACCTAAGAAGCAGGCTTTTGTCCTTTCCCAGTGCATTTAAAAATACAATTTGGAGCTCATAAAAGTAGATTGCTACCCAACTTTGAAAGCACTCTGCAGTGAAATAAATTAAGATAAACCTACATGCTCCCTTCTGTGAGGTCTCTATGGTGACTTAATCATGACAAATCTTGTGGTTTCTTTCTTTAG
>TTN-213,,0,5004,2669485,2674488,GTAGGTTTAAGAACAAAAGGTGTCATTGCCAATACTTACAAATAATTACATGGGAAAAACATTCTGTCAGCTTCTCCTCCATCACAAACATCTCTCATGCATAATTTGAAGCTTAATGGAAATCTAACAGAAAACTTATTTCAATTATTAAATTAAGAATTAGATAAGTGTTTTTCACTATTTTGTGCCCTTAATAATGGTTGTTTATGTTATGTTATGTGTTCTTTATCACAATAAAAAAATTAGTGTTTTTCACTAATATTAAAAAAGGTCATGTTCCCTTTATGATTGTAGCTGCACTTTAATTTCTTCATTGATAAAATACAATGACAAAACTAAAATTATTAGATTATAATAGCATCTACATATAATTCAAAAGAATAATACATTTATATAAGACATTATTCAGTCTATGGACAATGCTTGTGTGAAAGGTATCCTTTGGAAGACAATATCCTATAGTGGTCAAAAGTCGGGGCTTCATTGTCAAAGATGCTGAATTTGAATCTTGCCTTCAATATATATCATGTCTCTCGTTCTCCTTCTGTCATGAATACATTGAGTATATGATTGCATTCAATCCTAGAAAATATATTTTATGAGGCTAGGAATTCCGTTTTAGTGCCTAGAATTTGGCATCTGAAAAATAGTACCTGCTAGAAGGTAAGCTCTATGAAAACAAGAGTGGATGGTTGCCCCAGAATATCACCTGATACATAGTAGATACTCCATAAGTAATTGTTGACTGGACTAATTAATGATGGTTAAATGACTGTTACCAAACACTTAAGATTATTATCAAGATTAAGTTAGGTAACTCAAGTCAGCACATAGCACAGTGCTCATCATACAGTAATCAATCAGAGTTAGCTGCTACCATTTTTAATTGGGGCATGCTTCTCAAGTACCACCAGCCAATTTCCTCATCCCAGGAATCTGATCTTGGTAGAATGAGACAATATATGTGGAACCACTTCAAGTCATAACTGATTGTCTATAATCACAATTATTTGAGAGTTTCCCAGCCAAAGGGAAACTCTCAAAGCTTGGGCATCTCCCAGCCCTCTTATTAGGCTGATGCAAAAGTAATTGCAAAGTTGTATTGTTTTGTTTATTATGCTTCTCCCATTAGTTTATAATCCAATCTCTACCTTGTCAAGATTTATTTTTCTCAACAGGTTAGTACTTCAGTTGGTCTTCTGACCCAATTATTTCCTCCTCAGGAATGGAGATGGTGATCTAGAAATCTAATAGACCTATTTGATTTTATGAGCATAATTAAAAGATATAATGTATGTAAAGCACCTATAGGCATGGCTGCCAGGTAACTGGGGCTCAATACATTCATTTTATTATAGCCATAGAGAGGAATTATATAAACATCAATGTTTAGTATTGTATGGCCAGTATGGACAAATACCATAGACTGTATATTTGAGGGATAGTGTTCAAGAAATGCTAAATATTAATAAATGAGGACTGATTTGATAATATCCTACTAACACAATAATACAAAATATATTTTAAAAGCAAGTTCATTAAAGCTACACTAAATAATTTATCCATTTATTTAATTTTTAGAGGAATTTTTTAATATAAACATATATGTACATCATTCAAAGTAGTAATATTTGTCTTAACTATATTGGTATAGTGCTTTTAAGTCTATAACATATTAACATATGGTAGTATTGCCTTTAAAGTGTTGTAGAAATACACCTGAAGCACTCTACAAGACACCAATTGGGGTAGAAAGAGAAAAATTTCACTATCTTTTCTGCATAACCAATGTCTTTAAAAAGGTTTGAATAGGCTTTGTAAACTGAGAAGATCATTAACTTCCTATGTGTGGTAATATCTGTACACATATAGTGGTTTTAGCATCCTCTTATAAATTTGTTTTCTATATGAAAGAAATTAAATTCATTAAATAGAATGACCCTTCAAAAACTTGCCAACTCACATAGTTTCATACCACTGGGACTAAAAATATTTACAGAACTTCCTCTGGCCAGGTATTGCCTTAAGTAAGTGTAGCCCTGCTTTCCACAAATTGGAAAGAAATTGGGAGTCTTCAGAAGCTCCCATGTTCTTGGGGGTTGTAATACTTTCTGAAGCATGAAACGTGGCCCTGAGCAACCAGGTGCTGTTTCTAACAGCGAAAATGTTACCTATTGAAGGTCTCCAGTGCCACCTACTGGTAGAGGAGTAATTTGGAAAAGCAGAATCTTAAAATGTAAAAAAGCTATTTTTTTGCTGTTTATTCTACAGATGATGAGTCAGTGTCATTTGGAGGCTTACAGAGTGACAGCTAGCTAAACAGAAATGATGAATAATTAGTTTAACAATGATATTGTCTGTTATTCATTTAAGCATCTGTGCAATTTTAATTCTACCATTTATTGTTTCCCTGCTATTGAGATATTACCCTAGGTGCTGGGGTGCAGATCTTGCTCTTGCCTTTAAGGAGCTTGACATGTAGGTGAGGAGATGCATGCACACAACTATATCCCAAGGTTGTAAGTGCTATTAACAGGCCCACGTACTCATCATTCTCTGTCTGGGAGAGAGCCAGAGAAAGATGTGTGAACTGAGCATTGAAAAATATGTAGGATCATTGAACACAGTGGCATCCTATGATGAGAAAACAACATCTCCAAGTCATCAAAACTTGCAATAATGCTTCATGTGCTAGAAGCAAGTGGTTTAAGTACAGTTGGAAAGTGATATCATGAGTGGGTAAGAAGGCTGGATAATACAGCAAAGGCCGTGCTAAAGTTTTTGGTATTCTATGCTGAAGATTTTGGAATTGATCTTGTTTACATTTAGGAGACACTGCAGGATTTTTAAGCCCCTGGGTACCATGATCAGGTTTACTTTTTAGAAGTGATACTGTGATAGGGAAAGAAGGGATGGACAGATGTGGGAGGCAAGACTGGCAGTCAGGAACTGGAGAGAGATTATTACAATAGGCCTGGAGAGCGTGGATGAGGCCCTCAGCCAGGGCAGTCAGGAGAGACAAGTGGGGTATTGCAGAAGTAGTAATATGGGAGAAGAATGGCCTCAAAGAAGACACGAGAGGCTAATGAGTAACGCAGATCATGGCATCACAGCCACAAGCACCAAGTCCACTACCAAGAAAAGTTTTACCTGTTAACTCACTTATTGTGTGCAGTTCATGTCCAGTGGCAGTTCATGTGTATCCTGGTGCCTCATTCAGTTCACCAAAGGAAGAAGCTGTCAGTAGAAATAAGCAGAGAACCTTGTAAGAGGATGTACCATTGATGATCTCACACACACACACACACACACACACACACACACACACCCCTTCACACAAACTAAATAGGGGTGGTGTTTCATGTTATATCACATGGCACTGTCTTTTGGCGTGTTATTGAAGACAACGTTGCTTCCATCTGTGATGTTAGATATTCTTGCTATAATGACTGACTTGTGCCAGTGGCTTATAAAGCCCTTCCATGTGTGTTATATCATTTAATTCTCACAGCAATTATATGCAACGAATAGCCCATAAATTATTACGCATGCCATTTTACAAATGAAAAGACTAATCCAGAAAGCTTAAATGACATTTCCAAGGCCACACAGCTGACAAGTTGTAGTGTCAAGATTTCATTTTCTTTATATGTATATATTTTGATGGAGTCTTGCTCTGTCACCAGGCTGGAGATCTCGGCTCACTGCAACCTCCCCCTCCCGGGTTCAAGCTATTCTCCTGCCTGAGCCTCCTGAATAGCTGGGATTATAGGTGTGTGCCACCACACCTGGCTAATTTTTGTATTTTCAGGAGAGACTAGGTTTCACCACGTTCGTCAGGCTGTTCTCGAACTCCTGACCTCGTGATCTGCCCGCCTCAGCCTCCCAAAGTGCTGGGATTACAGGTGTGAAGCACCGCGCCTGGCCAGGATTTCATCTTCTACTTTACCTTACTATCTAAGGAACTGAACAGATTTGTTACTCTAAGAGGAGAACCTGCCATTTATACACATCTACCATCATGGGCAGGAGAGTAACTTTTATAGACAAGTATTGGCATTAAAATGCAGACAAATGCTAGATGATTGGACTATTAGAAGATCATCTTGGATGGTTTTGAGACCAAGAAGTGGTATAGTGACTGTGCTCCAAAAACAAGATGGCTTTGATTTTGGCTATTCAAACAGTTAACTAAAATTAAAGTGCATATCACCTACAATTATTACAACACAATAACCTGCTACTTTACTGTAATTTGGGTTTTTACTTTCTATTATTTTAAGATGGTTCAAATCCTTATATAGAAATAGCTAGCTTTATTATAATGTCTTATAACTGCCACTCTGAAAAGAGTCAAATGTATCTAAGATGCTCAAATACCATAATAAATCACCCTCTTTATTTAAAAAATTATTTTCTCTACAATTATTTGTGCCATATATACTGCGTACTGAAACCTTTTGCTCATTAGTAACAAAGATAGAGATTTTTTTTCTACAGCCTTCAAAGGTATCTATTTTAGACTTTTCATATCTTGATCTTCTCAGCTCTCTTTTTGATTGATTTTTCTGCAAACCAAAAGTGGAGATTTTTCTCATTTCCTGTCCCAGAAGGCAACTACAAGCCCAGATCAAACCTTTCCTGATGACTCTTCTTAGGACTGTCTTTTTCTCAAAGTCACTGAATATGTCAAAATCTTGTCTCTGCTTCCACTGCATGACATGCAAATGTCTAAAGAGAATGTAACTGAAGTTCTATCATTTTAAACATTACAACCAGTTCAACCTTAGGACAAGCTATATTTTTCTATCATTACATTTCCTTCTTGAAGATGAAAGGAAATCATTTAACAATAGTAGATATGGCATGCCCAGAGAAAAGTATCATGTTATTAAGTCAAATATGAAATGTAGGCACTAGTATTATTAACATTGTGTTTGCAGGTAAATTGTAAAAATCCACTCATTTTTGTGGTTGAAGTATCTCTTTTCTTTTGTGTCGCAG
>TTN-213,,0,1067,2674489,2675555,GTAAAGTAAAACAACTTTCAGAACCCCATTTAAATATAGATCGAATCTTAACAATGTCTGTAACAATTACTCAAGAGTTCATGTAAATCATTGTTGTTCCTACCATTCTCTTCTAATTCAACTAATTATTTCCCTGTTATATGCCATGGTCTCGCCTCTCCTTTACCACTTTTCATTGTGAATCATAGACCATCACGTTTCATTTGGCCCCGCTTTTTCTCTGTAACAATTTGTAATGTATTGCTGCTGTCACCAGCTGTCATGCTTCCTAATCAGCATGAATCAGAAGGGGGCGAAATATGCTGCATAAATAGGTAGATTTGTTTTCTCAATTGGCTAAGATAAAAATTAAATTTTAAAAACATCTAAGAGTGTTATCATCCTCCTATCATGCTGACACAATTTTGATTTCACAAAAGCTAGACCGTTTCAGGTCTGTACACCAGCGAGCTATATTCATCCTCCTCTCAAGAATGTCTTAGTGTTAAGAAGTCCAGTCCTAAAGTGGTTTAACATTTCTGTTAGTTGGGGCTCTTAAATTGTAATCAGAAACACTTCCTCAGTAACATGGGGAATTTGATTCAAACAAGGATAGCATTTTTATATAGTGGTACTATTTTTCCTGAGCAAATATAGTCTATGTAGTATTAAGTACATACAAATACATAAGGATTTAGAGAAACTATTTTTTTCTTAACCTTATGCATTAACTGTAACTAGATGTTTTTTTAAATAATGAATTTAAAGTGGTTTAAAATTAAAAAGTTGACTTTACAACAAGAGGAAGAAAGAAAAGAATATCCAAAACCCTGTTGGGTACTCCACTATTGCCTTCATGAACAATGTAGTGAAGTTCCTTAGCCCATTCATGTCTCAGCTTGCTTCTCTGGGAAATGGAAGTGAACTTGTGTGACTTCGAGTCAATAGTGACATACAAGGACAAGGCAGTAGGAGTGGACTGAATTCTAGTCCATTATTGAAATTTGTGACAAATCTGTAGACAACTCCAAATGAGTTCTGGTTTCAGTGCAAGGTAAGACATTAAAAATTGGTATGCTTCTTTTCAG
>TTN-213,,0,744,2675556,2676299,GTAAAGCCCATCTTGCTTCAAGGACTTTGATTTGCTGTATACCTCTCAGTCCCACTGTTACTAATGAGAGTCTCTGCTGTTTGTTTTATTGCATACTGTGGTCAGTCCATAACTTACTAATAAAATAACATGCAATAACTCCCGCTAGGTCCTCAATTATGGGTTAACCTACATACTTTAAATTTCACTGAAGTATGTGTTCTATGCACTAGAGAACCAATAATTATTTTATTAGGCACCACCTTTGCTTGGCTTCTTTACTCTTCTAAGCAATATTGTATCATTGCATCATTAAATGATCTATTTGCTGATTATTACTTACTGTACTTAAAGTAAGTACAGTATTACTTACTGTACTTAAAGTAAGTACAGTATTACTTACTGTACTTAAAGCATACAGTGGACGGAGAGCAAATGCTAACCCAAATACAGTCAGCTAGAGGGAGAGAGAGAAAGACAGACTGGGTCACTTTGGATAGCTGAAATGACAACAGAAAGAAGGAACCAGATACTGCATGGCATCTGCATGAGTCTTCATCAACCACTCAGCACTGAATCACCAGGAATGAATTTTCTTTTGTGTGATCCTGACATCTAGATCATATTGCATCTGGCATGCTGCTTTCAAGTGACAACTACGTCTTTCATCTTCATCTTCCATGCCATTTTGTGTTACTAACATGGGCAAGTGACAAAGCTTAGATCTTAATATTCTTTTCTTTTTCTTGTCACTTGATTATACAG
>TTN-213,,0,3041,2676300,2679340,GTTAATTGATTTTTAGCTATGACTTGCTTCATTTCATCCTCATCGCTTTATGCAGCTTTTCTGCCATGCAAATTCAATCGACGAATATATTAATTAGAATATCTCTAAATTAGCACCCTATTCATAAGTGACTTCTGAAAGTCAGCCAAGTCATTGGCCATGATTATCCTGAAAATTTAACTTACCAGTCTAGATTCAGAAAGTTTAATTTTTAAACGTAGGTTCGGGAAGCAAAGGTTTATTTCCTATGTGCTGCATTTTCTAATATTTACCAACGCACTACCAAGAAAGTGTAGCAAAGTTAAAATGTTGTATTCTGAGAAGTACTTATTGGGTATTTATTATTGTGCCAGATACTGTGGTAAATTTCAGTTTAATTGTTTTAATAGCAAGAGGTTCAACAATTCTTATCTCCTCTTTATTTTCACATCTGGAGGTTCTAGTTGTTTACAAAGGGGCCATGAAAATAGAAAATTGGGACCAAGTACAGTGACTCATGCCTGTAATCCCAGCACTTTGGGAGGCCGAGGCAGCCAGATCACTTGAGGTCAGGAGTTTGAGACCAGCCTGGCTAATATGGTGAAACCCCATCTCTACTAAAAATACAAAAATTAGCCAGGCATGTTGGATGTTGGTGCATGCCTGTAATCCCAACTACTCAGGAGGCTGAGGCCAGGAGAATCGCTTGAACCCAGGAGGCAGAGGTTGCAGTGAGCCGAAATAGGGTCACTGTACTCCAGCCTGGGCAACAGAACTAGACTCCATCTCCAAAAAAGAAAAATAGAAAATTGAAAATTGGGCACTGAAAATAACAAAGCTCTCTCTGGACCAAAATTAGAAGTCTCTAGATATTTCTCCATAAATGATGCTGCTTTTACAGGCTTAAAATCCTCCTGGAATTGTATAATTTTCTCATGGCAAGATCACAATTTTTGTCGTTATTGGGCTTGATTCTCCATTATGTCTGGAAGAGCAGGAATAAACTTGTCTGGGCAAGTAATAACTTCTTCCTCTTATCCATGGACTTTCCTTTTGGATATTAATGAAATGAGAAAAATATTTTTCAGGTGCCATAAGCCTGTGTTGTGTGCCCGTAGTCAAAACAGCTTCACTGAGTCTCATGGAAGGAAGCTGGTGGAATAAATTCAGGCATCTCCAGGGGTCTGTGGAAAGCTCTGGCCTCAAGTTCCTCCCTGATCCTGGCCATAGTGGTGTTAGGGATGAAAAGGGGGCAATGCAGTGCTATGTAGGTGCACAGCCATCTCTGCACAGAATTTTGAAACAGTGGCCTTTCTTCCTACCCAGTACAGAGAATACAGTTTATTGATTCATATAATGTATCCGCAACACCTACTCACCAAAAAGAGGTCTTATTCTTTCTTAATGAGATTTTGTTCTATAGCTATCTCTCATTCTGTCACCGTAGCCTACAAAGGCAATATCTCAAGAACTGAGGTCTAGTTATGTAAATTAGATAGAAAATTCCACCAGCCAGAGAGTTGACCCTCAATTTCACTACAGCTGCTGGCTAGCACAGTAATCACACAGAGTCACTATTTATTTGGAGGTGTTGTCTACAAGTCCTGTAGGTGACAGTGTGACAATTTTTTCAGTAATGTAATTGGGAGTTGGCTGTGTTGTGAAGGTGGGAGAAATGTAGATCTCTTAACTCACTTCCTAAAGAATCTAGTGCTATAGTGCGGTGTTTGACTGTCATATTCCCAGAATTGATTTGAACTCGGCTCTTTTGCCCTAGGATCTCCAGTTCATTCAGTTCCAATTGATAATATTATTAAAGTGTTCTTGAAGCAAAAGAATTTTTTTGAACATCCAACTGCCTTACTTGTACCTAAGAAAGTTGAAAGATAAGACATTTTTAGATGTTTGAAGAGTGAAAGATCAGGCACAGTTGTCTAATTATTTGACATAGGCCAGTCTTTATATGTTCCTTTTTTATTTTGGCTTAATAAGTTCATATAGGCTACAGAGTTATCCACCAAGATCAAGTAGGAATGTCAAACCCCTGGAAGTCTTTTTGAATACAGTTATTATGTGCATAATAAACATAAACATATCATATATAAGTTTCATGACTAACATGCTGCCTTTCCTTCTCATCCTAATGACATTCCATCTTCTCCACATTCAGCATGTTTTTCATTCTTACAAACACAGCTAATTTATGCCTTTCCCTAACTTTATTCTTACCTAGCAAAAGAATCGCAAGCCAGAGCACTTACAAAAATTACTCTGGGTTCTGACACTAAAAGTATTAAAACACTCAGAGAGTCACAAATTAAAACAACCCGTGAAGTAAAAAGAGAATCGTCAAAGAAAACATCAAGTTTGTCATTAACTTCATGCCAAAAACCGTAAGAAACTGAGAACAAGGGAATAAAGTCTACTGACAGGATACCACGTGGACTGAAGACTGAGAGTGATACGAGAGCCCCAGCCTTTCCCAAGGAGCTGCCCTAGATATGACTGTGTCTAAAAGCTGTGCATATTCCTTGTGGAATAAAAACAGTTTTGATAAGTCTTTGTTTTGTTTCTTAATATGTAATTTGGACTTCATGTAGTTCAAAGTTTGAAAGGTGATTCAAATCAAAGGAGTGTTTACTAGCAGGAAAAACTGAGAATAGCCCTCTGCTAAAGTAGCAATTTAGAAAATGCATGTTCTTTCTAAATGTGATTTCATCTCTTAGCAAGTGTTTAGTCAATAGGACATTTTTTAGAAAATAATATTCCTTCGGTTTGTAGATTGCTTTCTGCATGCATGTAAAGGCATGGGGAATTATAGAACTAAAAGTGGAAATTTCATGAAGAACCTAAAATAAAAATGTTTTAAATCTTTCTGTCAACATTGTCATGTGTTTTATCAGCTCAATAGTTTGTTTGGCATGGACTTTTTGGTAAATTTGGGGAATGTAGTTTTCTGTTGTTATAATAAAAAGAAAACTTTAATCATACAAGTCATGAATTGATGCAGAAAATATATGCAATTAATCACTAAAATCTCTTTATATGTTTTTCTATTTTAG
>TTN-213,,0,11202,2679341,2690542,GTATTGTTATAATGGATGTGAGATTTAAGTAGAAATTCTAAAGGATTAATAGGATCCTTGAGTTGCCTTCTTTCTCTTAGTATTATTGAGAAAAAAATGACATAGATATACAAATATATCTCTTAGAGTATATATTACTATGTCGCATGCTTGGTTTAGAATTTTGATGGTTACATGCATTTCACAGTAATTTATTGTAAGTTAATTTAAAATTTTGTATTTAAAATTTATCAGCCAAATTCAACTTTATGTTTGCAGTCATTTCCAAAAGTGTATATTAGGAGAAGTTGTCATCTTAATGCATGAAATCATGAAGTAGAAGTTTGTTTTCAAAATCACGGTGAATTACATTGAAAATAGACAATAACCTAGCTGTCATTCTCAGAATGCAATGTCATGAATGAATTATGATTGAAATGCTACTTTACTGAGGTTGTGTGAAAACATTACATTCCCATCTGGTTTACACTTCATTCACATATATCATTTTAACATTGATATGTCTCTTACACTGGCTTGCAGATAGCTGCCTTATGTGATCCTTATTGCCTGCTTTTCTTTGCATAACATTGTGACTTTATGGCTGTATTAGTTCGAATAAACGCCTTCTCATTTTATTTTAGCTAATTATTTATGGTTATAGTTCTTGTATATACTCTTTAAATAGTTGATTCTCAAAAATATAATAATTTAATCTACAATCAAAAGAATCAGAAAGGGCGTTTATTCCACTCTCTGCAAGTCAGGTAAGATTTTCCACTTAGCCATCAAAAGAACAAAGTTTTCCTGCTCTCAAAACAAATATGCACAGGAACATGTTATTTTGAAATGCATTTTTGCTTGTTCAAGAAGAAATTTCAACAGTTTGAAGAAAAGACCAGACAACGAACGATTTTCGTGTCAGAATCTTTTAAACAGAGCATGGTGTTGCGTTTATTCGAACAAATATGGTGAGTGAATTTTTCTATGGATTTGTGAGATCTGTAGCATGCAATTTATTTCATTTCCTATTTTGCAATTTTATTTACTTTCAACTTTTTCAAGTTCTATGGAAAATAGTAAAGGTTTTTTTTTTTTTTTCCAGAATTATTCTCTGAGGGGGAATCTGAACATTCAGAAAGGGATACACGTGACGCCTTTTCAGATTCTGAAGACATAGACCACAAATCCATGGCTGCTAAAAGATATGCAAGTAGAATATCATCTACAAGCTCCTGGCCTGAATATTTTAAGCCTTCTTTTACCCAGAAACTTACATTTAAATATGTTTTAGAGGGTGAACCGGTTGTTTTTACATGTAGATTAATTGCCTGTCCAACTCCAGAAATGACTTGGTTTCATAACAATCGGCCCATCCCAACAGGTCTTCGTCGGATTATAAAAGCTGAGAGTGATTTACACCATCACTCTTCCAGCTTAGAGATTAAAAGGGTCCAAGACAGAGATTCTGGAAGTTATAGGTTACTAGCAATTAATAGTGAAGGGTCTGCAGAATCAACTGCATCATTGCTTGTTATCCAAAAAGGGCAAGATGAGAAATATTTAGAATTTCTGAAAAGAGCAGAACGGACACATGAAAATGTGGAGGCTTTAGTTGAAAGGGGAGAAGATAGGATAAAGGTTGACCTGAGGTTTACTGGCTCTCCCTTTAACAAAAAACAAGATGTGGAACAAAAGGGAATGATGAGAACTATACATTTTAAGACAATGAGTTCTGCCAAGAAAACAGATTACATGTATGATGAAGAATATTTAGAAAGTAAATCTGACATAAGAGGTTGGCTTAATGTAGGTGAAAGTTTCCTGGACAAGGAGACCAAAGTGAAGTTGCAACGTTTAAGGGAGGCTAGAAAAACATTAATGGAGAAAAAGAAATTATCTCTTTTAGATACGTCTTCTGAAATAAGCTCAAGAACTTTGAGAAGTGAAGCTAGTGATAAAGATATTCTGTTCTCTAGAGAGGACATGAAAATCAGATCTATGTCTGATCTAGCTGAAAGTTATAAGGTAGATCATTCAGCTGAGAGTATTGTGCAAAATCCACATGCCCTTTCTAATCAAATGGATCAAAATATAGAATCTGAGGAACTTCCCACAAGCTTTCAAACTATTGTTGATGAAGAAATTTTCCAGACTGAAATAAGAATGAGCCAAGAAGCACTGGTAAAGGAAAGTCTACCAAAAGACCATTTATATGGTGAAATTCTAGTAAATGAAAATACCCAAGCAAGAGGACAGCTGGAAGAAATTATGGCCAATACTACAATTGGAGAGTCATCCACATATATCACTAATGTATGTGAGAAGGAGGAAGTATATGAGACTCCTGAAAATGTGTCTCAAGCTATTACACCACATGCCAGCGAATCTTTTGGTACACTTGTAAATGTTGAAGAAAGTGAAGAAATAGCTAGTGAAAGAATAAAAAAGGATGATTTGAGAGAATTACAACTCTCTGCTTCTACACGAATTGATGAATTCAAAACCGAACAGAAGGAAGAAAACATGAGATTTTTTGAAAATTCTTTTCGAAAACGCCCACAACGTTGCCCACCTTCATTTCTTCAAGAAATTGAATCTCAAGAAGTTTATGAAGGTGACAGTTGTAATTTTGTGTGTCATTTTCAAGGATATCCTCAACCTATAGTGACGTGGTATAACAATGACATGCCAATCCCACGTAATCAAAACTTTATCATTCATTCGTTGGAAAACTATTCAATATTAACTCTTTCATCTGTTCATCATCAGAATGAAGGTTCTATTACTTGTGTGCTATTTAACCAATATGGAACAGTAAAAACAACCAGTATGCTTAAAGTGAAAGCAAAACAAAAACATGATGTCAAAGCACATAAAGTCCCAGTGTTCCATGACTACTTGGATGAGGAAGAAGAGTTAGCATTGGTGTTTGACCAAGCAAAAGGCGCCCATCCATCTATGAGTCAAGAGGGCCAAACAAATCTTCATTTGTTAAAAACTAACCCACCAGTTCCTCCCTCTGGAGACACAGAATTGCTTTCCTTTCCTGTAGAAATTCAGGTAACAGCAGCTACTCCTATCCCAGAACAGGATAAAGAGTCTAAAGAAGTGTTTCAAACTGAGGAGCTGGAACCTAAAGCAATGCCTCAAGATCAAGTTACTCAATCACCAAAACACAGATTTGTATTTTTGTCTGATATTACTAATGAACCACCAAAAATGTTACAAGAAATGCCAAAGCATGCCAGGTGTAGAGAAGGGGATTCCATCATTCTTGAATGTTTAATATCTGGTGAGCCCCAGCCAGTTGTAACATGGTTTCAAAATGGAGTCCTTTTAAAGCAGAACCAGAAGTTTCAGTTTGAAGAAGTTAATTGTAGCCACCAATTATATATTAAGGATGTTAATTCTCAAGATTCTGGAAAATATAAATGTGTTGCTGAAAACAATTCAGGGGCAGTTGAAAGTGTTTCAGATCTAACAGTGGAGCCTGTCACTTATAGAGAAAATAGTCAATTCGAAAATATTGGTGAAATTTATGGAAAATATTCCAGAGATCAGCAACTGCAAGACCAGGGAGAATCTGTAAGGGCACATTTTTATGATTATCCAGCTGGTCCCTTTACTCCCTGGACAAATGTAAAAGAATATTCAGTAAGGGACTATTTTCAAAGCCTTGAGACTATTGAGCAAATAGACCAGAAAGAGCAGGTGCGTTGCATACCTTCTAGAGAAAAAATTCCCAGATTTGTGCATGGTGCTTCAAGAACCATAAAAATCAGCAAGCCCATCAGGGCTGAATTCATACAATGTCAGGCTGAAGGGAAAGAGAGACATGTAAGTGAAAAATCAAAGCTGCACCAAGCAGAGGGTACTGTTTATCCATTTGTTGATGATTTCAGTGATGTCACTATTAAGAAAGAAATAAGAAATAATTTTGGAAAACTTGGTAGATCAGAAAAGGAAAATGTACAAGAATGTGCCCAAAGTGACTATTTACCAAATATTCACTCTGAGAGAATTTCTGACAGTTACAATACAAAAGATTCATCTGCCATTGTATATGAAGAATCCCTTGGTGAAGAGATACACTACCCGGGGAAAAAGGTGAAGCATAGAATTATCGAATTTGAAAAATTACATGTAGAAAAAGGAGTTCTAGAAAAAAGACCTACCAGAACATCAATTGTTAATCCTCCTCAAAAGAAGATTGATGACAAAGCCTTTTCATTAAAGCAAAGAGAATCAAGATCAAGCAATCTAAATGCAAATATGTATCAGGCAGAGAAAATGTCTCCAAATACTGAATCAGATTCATCTAACATTGCAATAAATTTAAAGCTGCTTTCCTCTCAAACTCATAAAGAATTTGACGCACAAGAAAGGGAACAACAGGAAAAAATAAGTCTTATAGATAAACCTGCAATTTCTAAAAGAGCTGAACATGAATCACCTATTACATTTGACTTAAAGCAGTTTCACACTCAAATAAAACACACAGATGTGAAATTCCAAGAATTAGATAGTGGTCAACCAGAAGAAGCTTATTTTAAAATCCAACATCCTGCTGACACTGAGAACATTGTATTTGATCTAAAACAAATGTATTCTCATATAGGAGATCCAGCTCTGGAGTTCCAAGGGCAAGAAACTAGGGAACAGCAGGAAATACATTATAAAGAAAAAATTCCTAGCCCTGAAACGTTACAACCTGACACACACAATATCTCTAAAAGTGTGCAAAATAATGTATTTGCCAGTCAAGAAATTTCTTCCAGTCAAGAGCTTTCAAATAGAACTATGGTGGAGAAAAGTAGTATTGATGAAAATTCCATTTCTTTAGAAAAAGAAGTCCGACATGTACAGGAACAAAACTTAGACATTTTAAAAACTGATCTTTCTCTTAAATCCTTTTCTGAAGAAATCTATAGTGAATCATGTGCCCTACTTCCAACCTCATCTGCAGATATAGAAGAAACTGATCTTTCTGAGAAAAGTTGTCCTCTAGAAAATGGAGGCAGAAGTTCCATCTCACATTTGAAAAAAGCAGCAAGTGAGGAAAAGCCTTTAGGGGTTGGTGAAATGGAAGAAGAATGCACTCTAGAACCAGAGTTGGCAGCATTTCCAAAGCAGGATGGTGGGACACAGGAATATACAGATGCCACTTTGGAAGACCACAGAGGTGATGTTCAGGAAGCTGACACACTCCATAGACAGCTCTCCCTGAGTCAGTGCTTCCCACTCTTGATGACTGAAGAACAACAGAATCCAGGTGAACAAATAAGTACAAACATTCATGCCTCTGGAGAAGAAAAATGTTATGAAGAAGTTCAAGTTCAGAATGAAGCTTCTTTCTCCACTTTAGAAGGAGAAATGATAGAAACTAGTTTTTCTCAAAATATTCCTAAATTAGATGAGGCACATACCACTGAGGCAGCAGAATCTGAGACCTCCCTAACACAATATTTACTTGCTGCTGGAAAGCGTGAGGTTCCTGAAACTAAAGACACCAGAGACCAGGCAAAGCTTGTCCAGAGTGAATCAATCACTTCAATGGAGGTGGAAGAAGTAACTTTCAACACTGTGTATGAATACTACAACCAGAAACAGGAATCACTAGGTCGTCCACTTTCTCCTGAGTCTGACATTTCCATTGGTGTGGGAAGTACAACCAGTGAAGAAATATCTGAGTTAGATCAGTTTTATACCCCACCATCATCTGTTGAATATTTTGAATCTCCAAAGTCCCCTGACTTATATTTTAATCCTTCAGATATAACTAAACAATCCTCAATACATTCAGGAGGTGAGACAGTTGAAAGATATTCCACACCTTTAGGGGAAGTTGCTGAAAGATATTCAACACCTTCCGAAGGTGAGGTAGGAGAAAGATACTCCACACCCCCAGGGGAGACACTAGAGAGATACTCCACACCTCCAGGAGAGACTCTAGAGAGATACTCCACACCCCCAGGAGAGACTCTAGAGAGATATTCCACACCCCCAGGAGAGACTCTGGAGAGATACTCCACACCCCCAGGAGAGACTCTAGAGCGATATTCCACACCCCCAGGGGAGGCACTAGAGAGATATTCTATTCCTACTGGAGGACCAAACCCCACTGGTACTTTTAAAACATATCCATCAAAAATAGAAAGGGAAGACGGTACACCAAATGAGCATTTCTACACACCTACAGAAGAGAGGGGTTCAGCTTATGAAATATGGCGTTCCGATTCATTTGGTACACCCAATGAAGCCATTGAGCCAAAAGACAATGAAATGCCTCCATCTTTTATTGAACCTCTGACCAAAAGGAAGGTATATGAAAACACAACACTAGGCTTCATTGTTGAAGTTGAAGGTCTTCCAGTTCCTGGTGTGAAATGGTATCGAAATAAATCTTTACTAGAGCCAGATGAAAGAATCAAAATGGAAAGAGTGGGTAATGTGTGTTCACTGGAAATTTCTAACATTCAAAAAGGAGAAGGGGGAGAGTACATGTGTCATGCTGTAAACATCATAGGGGAAGCAAAGAGCTTTGCAAATGTAGACATAATGCCCCAGGAAGAAAGAGTGGTGGCACTACCACCTCCAGTAACACATCAGCATGTCATGGAGTTTGATTTGGAACACACCACATCATCAAGAACACCTTCTCCTCAAGAAATTGTCCTGGAAGTTGAATTAAGTGAAAAAGACGTTAAAGAATTTGAGAAGCAGGTGAAAATAGTGACAGTTCCCGAATTTACTCCTGACCATAAAAGTATGATTGTGAGTCTAGATGTTCTTCCATTTAATTTTGTAGATCCAAATATGGATTCAAGGGAGGGAGAAGACAAAGAACTAAAAATTGATTTAGAAGTATTTGAAATGCCTCCTCGCTTTATAATGCCTATTTGTGATTTTAAAATTCCAGAAAATTCAGATGCTGTATTCAAATGTTCAGTCATAGGGATCCCGACTCCCGAAGTTAAGTGGTATAAAGAATATATGTGTATTGAGCCAGATAATATTAAATACGTGATTAGCGAGGAGAAGGGAAGTCACACTCTTAAAATTCGAAATGTCTGTCTTTCTGATAGTGCAACATACAGGTGCAGAGCTGTGAATTGTGTAGGAGAGGCTATCTGTCGGGGATTCCTCACCATGGGAGATTCTGAAATATTTGCTGTGATAGCAAAGAAAAGCAAAGTGACTTTAAGCAGTTTAATGGAAGAATTGGTCTTAAAGAGCAACTACACAGACAGTTTTTTTGAATTTCAGGTGGTGGAAGGGCCTCCCAGGTTTATCAAAGGTATTTCTGACTGTTATGCACCAATAGGTACAGCAGCATATTTTCAGTGCTTAGTTCGTGGCTCTCCAAGACCCACGGTTTACTGGTACAAAGATGGAAAATTAGTCCAAGGAAGAAGGTTCACTGTTGAGGAAAGTGGCACAGGGTTCCATAACCTGTTTATAACAAGCTTAGTAAAGAGTGATGAAGGAGAGTATAGGTGTGTAGCTACAAACAAATCAGGAATGGCTGAGAGCTTTGCAGCACTCACCTTAACTTAAAATGTAATGTTTTAGTGCCTCAGTAATTATTAGCATTGATCTGAGTGCTTTCATATTTTCCAAATTATGTGGATCTAATAAACTTCCAAACAGGTCCACCATATTTGAATTCATTACCTTGGAGACCCCTAAAGAAATAATCTCTATGTAGAAATCTCATCTTTGTAATACATGTAAATATTTTGTTATCTGAACTGTGGAATCATCACTTGTGTCAATCATGCTGTGTAATATCAAACACAATTAAATCTCTCCTTGGCTACCTAATTGTTTGTACTTCTATTTACCCTCATGCCTCCTCCACAAAGTGTTTCAGTGGAATGGACTCTCTTTTAGCAGATAAACCATATATGCAAAAGTACAATGTAAAAGTGGAGACCATATCAGATGACCACGCAGACAAATTGGTAAGGGCAAATCTCTCTGCTCCCATTCTAAGTTATTTTTGGAATTTTAACCCCTTTGCATCCAAACTCATGTTTATTTACTTTGACTTAGAATAGGCAAAACAAACAACAAAAACCAGCTTCTCCCAATTGGCAACTAACTCTATAATCTGTTTGACATTTCAATCTTAATATATTAACTTCATCTCTTTTAAAAATGTTTTCGTTATTAATATTCCTCTTCATAAGTGCTTTAATTCTCACTGGCTTCAAGGGACCAATTGTGCTCTTTGTGGGCAGGGTTCACCTAGACATTTGCAAAATAAGCAAATAGATCTTTCCACTTTTGGAGATACCTTATTTTTCTCCATTTTTGAGATGACATCAAGTGTAAAATGCAGCAATAATTTAGTATTGGCCTGGGGAAAAAAGGGAAACTATCATATTGTGTTTACATATAGATTTTAAAACTGTATTCTGATTTCAGAATCTTTAAAATTTAAAAAAAGGTGGGATATTTTTAGAATTGAGACAATATGGTAATTTGTATTTCAGATTATATATAAATAACAAGATAACAAGCTTTCCTATCAGTTTCACTGAATTTCATCTTTAAAACGAATATAGCTTAATAAGCATTCAATTTTTATTGTGATGTTTATGTTTCTAAAGTAACTCTTTAATTTTGTCTTTTAAAATTAAAATAACAGTAAATTAACATACTCCTTAATATCTTACCTATATACTAATGTGGACCCAAGTCTTCTCATATAAGACTCGACAAATATAAAAAATTCTGAAAATGAAGGGTAGGACCAAAAGACCTTAGAGGTGATCATTCAACAATACAATTCTGTGTTAAGCTAATAGTAATTATTCTTAATACAATTTAGAATAAACTTTAATTTTGTAACAAAGGACGAGAGAAATAATATTACAATGAAAGATAAATTTTATCTCCCTCCACCTCTTAAATTACTTATTGTTACTTAATGGCTACATTTGTCACCTGCATTTAGCAATATTTAAGTACCATTATCATATTTAAAATGCTAATTTTAATTAGAAATGTAAACAATTTAAATTTAATTTTCAAAAGAATTCATATCCAATTATGTTTATTATGTTTCTTTCATCTATCAGTCTTTATTCTCAACATGGGAATTCTCTAACAGCTATCCAAATTAAAGAAGCAATAGAGACAATGTACAGAAAATAGGCAGAGCAGCCAGGCCTCCCCTGCCTCCCTCACAAAAAAAATTTTGAATTATCTGTTTGAGCCACCATAACTCATCAGCATAGATACACTATTGTAGAACAATCATTCCTGTTCCAACCAGTGAGCACACAATATCTGTGATAATAATTATAGACATAATGTAATATATCACATCACAAATTCCTGAAATAAAACTAATTCTATAGATTAGGAACTTAGAGATTTATTCTGCACTTAGTCACATAATGGATGTTAAAATTAACGAGAAACTCAGATTGAGGCAAACATGACAAGCATGCTTTACTCAAACATCATACAGCACAGCAACAGTTCAAACCTTGTTTCTTAAAAAAAGAGAAAGAGAGAAATAGAAAAATGTTTTTATGTCCTACTGGATTTCAGGAAGAGCTGAAAAACACTCTTATTCATATAGTAAAGAGGGCTTTGTTTGGTTTTGCTCATTAGAATTCTGTAATTCTGTTAGTTTCAAGTATGGTGAGCTTGAGTATACGCAGAATAACAGTGACTGAATAAAGAAAAGTAAGCCTTGGCTTACTTTAATTGTCATAGATAATGAAATGGAATTTTTTATTTTCTGACTCAATGGCACGTAACATAAAACCCCAAAATATTAATTTCTCTGATTCTGGATAAAGAATTTATTGTATTGCACATAGTTGAGTTTAGACAATTAATAGCTGCTACCACAACATGTAATTTTTTAAACTATGCCTTTCAAGTTTCAGCACATTTGAATTTCATTTACTATCCTTTTTATGGCTAATAATACCATGGCTTGAAGTAAAATATTTGCAAATAGTTCAACATAGTAGTGAGTAAGGGTATTTTAACTGTATTCACATTCACTCCCTTTACAGATATTTTGTGAGTTCAAGTGAAGGGAAAGGTAACGCGAATTATGTATTGTAGATTAAATGCGAAGTTAAGTGATCACCATTAATATGTAAAATTATCAATGGTTTTATGGTTTACTTAAAATAATAAATACCTGAATATGTATTCTGCATGCTATAGATGAGTTTCTCCAGTATTTTTACAGCCAGCAGACACTTGAGTCCTGTCTTCTAATGCTTATATGCTAGAACAGAAAGGAATTAAGGTGTAAGTCTATTTCATGTGATGCAAGTGAAGTCACCAAATAAAATCATAAAACTGCCTTTTGCTAAGGCAATAAAACTACTAATAACAGGCCTGTTCTACATAGCTAAGAGGTTTAATAAAAAATCGAATTCCTTGTTTAAAATTACATGTCTTTCATCCTGTCATCCAGGATACTGTTTAAAGAGTCTCTGTTATGCACTGCTTTGTTTCTTGCTCAGTGGTTCTGTATAGGTTTTCTTATACAATAAAATACAATGAACTTTTAATATTGGAGTTGTTTTCTCTTATTTTTGATTATCTTATTTTCTTGGCTAATGCCTTATTACAAAGGCTTTGTTCAAGTAATATGGTGATTTACATAGATGAAAGAAGGCCTGCATTTCTAGAAACTGAAAACAGTGGTTCTCTTACAAATCCAAATTAAACATTTCCTGTAGCCTCTTATTTTTAATAATGACTTTAGAGGCAGTAATTAGAACATCAATGGTTTATTTTGGAAATAATCAGTCTTTAACAAAGAAGATTATTCTTAACCTCAAGAAAACTCTAAATATAAATAACAATTCTGGATCTTTTTAGAAGTTGATTTAAATAATGCTGGATTATTATAACTATTTAATTAGCAGTTTTTCAAACTTTAAAATTGGAATTATATCTCAAGAAAAACTCATGAGAGCATTTTTAAAACATGAACTCTATCACAGATGAAGTGGATCAAAAATTGCTTTTGTACAGTATCTATAATTTTGCATAATTTTATATGTTAAGCTAAGAAAAATTTAGAAATGTGCTTTTTGATACATTAATCTTGGAATAATCTAATCATTCCAGGAATAAAGCAGAAGAAGGCCATCAACTGGTGTCTAATTCTTTGATTTCTATTTTTATATTAAATAAAATTTTATAGTAAAATAATAATCATTTTTCCCCATACAG
>TTN-213,,0,780,2690543,2691322,GTTGGATTTTAAGGATAAAATAGATCAAATGCTAACATTCACTGGATTGTAATGATTTAGCTTGCATCACTTAAATTTTCACTTATCTGCCACTTCCAGAATGTAATTTATTTAGAGTAAGAATGAAATCACAGACATAATCATGGTTATGAACTCACCTTTTCCCTTACTGCCCTGTTGGGTGCTATGCTATCATATCCATGGTACTATTTATTTTAAAAATAAAACATATTTTCATATGTTTCATAATACCAATAGATAAGCTTTTAGTTAATTTTCATATGAAGATAACTTTCATAATATGTAATAAAAAGTATCAGTGAACACCTAGCCACTCTGAAATCACTGGTCTCACCCTTAGATTTAAAATAACCATGATTAGTTGTCTGTTTCTTTTTTCTGTTTATTTTTTGTTGTTGTTTCACTTCATCACTTTATTTAGTATATCATGTTTCTTCACATTATTTTCAGTGTTCCCATTCAGCATGGTATATTTAAAGAATATATCATGTTGTTATGCATATAATCCAATAGCATCACATTTTTTCACAATTCACTGCAAAGCAATGATTGAATAGGTTTTTTTTAAAAAAAGCTTATTGTCTTCTTTTGCCTTCAATGATCTTTCTCATTTTCCAGTCACTTGCCTTAAACTGCTGTAATCCATCTCACCAATTTCAACTGTTTTACTCCATTAACAGCAACAAAAGTTAGAAGAAAAACAAAAATGTCATATGCCTGATAAGGAGGCATGTTAATGGACTCTACTTCCCTTTGCAG
>TTN-213,,0,2007,2691323,2693329,GTAAATGCCATACATTGGCACAGATGTTGTCACTTCATTTCATATTGTTGTCCTTTTTGCTTTCTGTACATGTGTGGGAAATGCTTGTATTACCAACTGGAGAGACCAACAACCAAGACAGTAACATGGTAGGTAGGTACTGCAGAGCCTATATGGGATAAGAAATCATTATTTACAGTCACATTTCTACTACTGACCAAAGAAAAAATAATTTATTATTTGAGAACAAAGTTAAGTAATCAAATGAGCTCAGCTTGGCCCTTCATATAAAACATATCAGGACAGTTTGGTGCCACTAAAAAAAAATAATGTCTCAATGTATTTAAAAATTTTAAATCAAATAACCAATTAAGAACAGAATTACAAACTTAAAAAAGTCAGTGTCTAAGTCTAAAATTAAATCCTAATGTAAGACAGGGAGCTAGTATAGGACTGAAAACTAGGATTCTCTCTAGGCATTTTTACTAATTTAAAAATAAGACGGCTGGGCACGGTGGCTCACGCTTGTAATCCCAGCACTTTGGGAGGCCAAGGCAGGCGGATCACAAGGTCAGGAGATCGAGACCATCCTGGCTAACACAGTGAAACCCGATCTCTACTAAAAATATAAAAAATTAGCCAGGCGTGGTGTCACGCACCTGTAGTCCCAGCTACTTGGGAGGCTGAGGCAGGAGAATTGCTTGAAGCCAGGAGGCAGAGGTTGCAGTAAGCCAGGATTGCACCACTGCTCTCCAGCCTGGGCAACATAGCGAGACTCCACCTAAAAAAAAAAAAAGAAAGAAAGAAAATAAGACAACTACACAAATATCCTATTCCCAATTTTCTAATTGATATGTAGGGTGACTTTCAAATAGTTAACACTCATCAAATACTTGAATGCCTTCATTAACCAAAATATTAGTAGCAAGCTTTTCTTCCTTTCTTCCTACCTTCTTTCCTTCCTTCCTTCCTTCCCTCCTTCCCTCCCTCCTCTCTATCTTTCTTTCTTTCTTTTCTTTCTTTCCCTCTTCCCAAGAGAAAGTGTGAGTATGAACTGTGGTTTGAGGACAGGGGTAGAGGTACAGTCAAGCCATACTTGGACTGTTGGGGAAGGCTGTCCCTTGGTCTTCTTTGTCAATGAGAATATCAAGGGGAAGGGCAAATGCAGCACATCTCTTGAATGTGAAAACGATGAGGTTCCCTATAGCTTCCTCTTCTCTACAATCCTTTTACGTGATCCTAAGAAAAACCCAGGCCCATGATGACCCAACCAGTGCTTTTCACTCTGGTCAAAATGTCTCCATAAAACCAAGTACATGATATTATTCATACTGACGCGTTTGGAAGTTTCTTTACTCAAATTAGGTCAATTTAGGAATGCGACTAATATTGAAGCTTCAGATAATAAGAGGAAAGGATAAGGAGGATGACTTAAAAAAATTAAAAAGAGAGGTTCTGAAAGTCTGGCTTCAAGATGCAGAATGGAAAGGGGAAGTTGCTGCTATTAAATATTTTTACAAGTTTGAGTTGGCCTAGAGGATGCATTCATAGTTAAGCCATATAAGAATTTCCAGGCAGTTGACATGAGGGTTAGAAAGACATTACAAAACTACTTCAATCTTCTTATCACTTAATATCCCTACTCTTCAGAAGAGTCAAATACATTTTCTTTATCTTCCTTACATAATCTTCTAATTTGCAGAATTAAAGTATCAGCTCAATAGCTTATCAAATAATTAAACAAGCAGCCACTAAAATGGACAAATCTTTAGTAATGTTACTTAATAAAGGAACGCTTGTCTTTTCTTTGATAGAGACAAGTAAAGTGATGTCTTGCTCCCTTATAAAGAACACTCTCATCCCTTTCCTTTGACAATCTTTTGTTCTTATTAACACATTACTCCATTTTAAATTATGGCTCATGTCTATCTAAAGACTTAACTCATCTTTTCTCTGTCTTGGAATATATAATTACAGCAAGTGCTTTGGTGGGGACTAAATGTAATGCTGGAAAAATTTCTTTTGCAG
>TTN-213,,0,522,2693330,2693851,GTAAGAAACGTGTGAATGTATTTTCTAGTCCCTTCTCTGCAAGGAATCCTCAGTAGAAAAACTGTTGGCAAACAATTCAGTCAGTACACTTTGTTATTAAAATAATGTCATTCAGCAAACATTATGGTTTGGGAAAGTCCTGGCATTGTTTGATTTTATTTTTTTAATCCTCTTCAAAGTTCACTTAACTTTTGTTCTTTTAAATTGTCTGCTATTAACAAAGCTTGCTTAAAATTTCTTCTAAGAAAAAACTCCAAGTGTCTGAGCAATTCTTAACTATCTTCTTTTATAAAATTCTTCTTTGTGTAGGTAGTCTGTTTATTGTTGTTTTATTTTAAATCAAGAGACTGGGAAAGTGTCTTAGAATGATAGGAACCTATTAAATGCACCACAGCTTTTACAGAAATTTTGTGGAGATATTTTATGTGTGTTGGGTCTCTTTGTTGTATATGTCTACTTTTCTTTTGCGGAGTTTATGTTTCAGATATCTTCTCCTTTTTCTTTTTTGTAAACTTCATGTAG
>TTN-213,,0,100,2693852,2693951,GTTTGTTTACTGAGTTTCCATCCAGTATTTTTCTGAGAAAAGATTTCCCTTTTAATTACTTATTACCCATTACTTACACAATGCTTTCATGCTTTTGTAG
>TTN-213,,0,435,2693952,2694386,GTTAGTGCTTGAAAAACTAATGTCTCTTTAATAAATTGTCAAACTAGCTTTCTTACCCCATGGAAGAAAAACTGGTACTTTCTTCTCTTGTCCTATCCTTTAAATTTGTTTTGTCTTGGTTTGACCTGGGACCTTGGGAACAAAGTCAGTAACTTTCACCTGGTCTTTTTCCCGAGACTAGTGTAAATATCTATTATCTGATAACAAAAGGGAATAATAAGCCATTTTGTCAGCTGACAAACATGTATCATCTATGCCTCTGTCTCTTGGATGGAATTATAATTATTCTTAACTTTTATTTCTTCTTCTAATTAACACTATGAAATAGTAGTATTGGGACAAGATAAATATAATCTTGAAAAAACTCTTAAATATAGATGGTGTTGAAAGTGTTTGGGAATTGATATGTTTTATATGCTCTCTTTCCTTAACTAG
>TTN-213,,0,96,2694387,2694482,GTTTGTGTAGGAACATTTAAACCTCAAATTGCTATTTAGAATTAAAGTGAAACCCTAACAAGCATTTAGGGTGCTAACTATTTCATACCATTGTAG
>TTN-213,,0,117,2694483,2694599,GTTAGTATTTTTAGAAAATGATGCTACATATGCATTTGAAACCCAACAAATGGCCTAAAGTCAATCACTGAGCACTCTTCTATATTGACCTTTTCTCCCTTCTTGTGCAACACACAG
>TTN-213,,0,115,2694600,2694714,GTTGGCTGGAGACTTTGCATTTTATCCTTATTAAAGATTATGTTCAAATTAAGTCATCTTCCCTTAGATCAACCCTCTTAACTCTTTGAAATTCTTTCTTATACCCCTTCTTCAG
>TTN-213,,0,92,2694715,2694806,GTTTGCATTGTTTTCTTGACATCTTTGTGCTAACCTTGTTATAAATTCTTTCCTCTTTCTCACATTTCTTAATAACTTCCTTCCTTCCACAG
>TTN-213,,0,94,2694807,2694900,GTTTGTGTTCACTTTGCCTCTTGTGTTGCCAAAGTTATGGCCCATGGCACAGACCCCTCCTCCCTTAATGCAAATCATTCCTTTTTTACTGTAG
>TTN-213,,0,109,2694901,2695009,GTTAGTGTTGGTTCCAGTGAGGGACTGGCTTTTCTGAAGAGTCAATTCTTTTTTTTAAGCCACTTTTGCTATAGGGATAATATTGATTGAGAATTCATTCTTCTGTTAG
>TTN-213,,0,101,2695010,2695110,GTTGGTTCAGAACGTTTGCCTTGGGTTTGAGGAAGAAATGCAGATGTAAGCCTTTCAGCAGGGTAATGCACAACCCACATCTATCCCTTTGTTTTCTACAG
>TTN-213,,0,132,2695111,2695242,GTTGGTATTGTTCTTCTACAGAGAGGATTGGGCATTTCCATGCTCCTTCTTCCCTTAAAATTTAAAAAAAAAAACAAAAACAAATTAGTAGATTGACCTTTTTTTGTTGTTGTTTGCTTTTTCATTGAATAG
>TTN-213,,0,133,2695243,2695375,GTTGGCAAATTTTATTTCCACTTATCAAGAACTTACAAAATATTTTTGTTTCATTTCTAAATTTTCACCTTTATTGCTAAGTTATAAAATAAAACTTCCTATTTTCTTTTGCTTGTTTTTTCTTTCACCTCAG
>TTN-213,,0,147,2695376,2695522,GTCTGGTCTCTACATCTCCTCACTTTCTTGCTTGTCTAGATTTTCTTGCCTGGGGTGGGCCGGGGCGGGGGACGCTTAAGACAGCAGTTTTGCCCAGTGACCTGTTTTTAAAAATATTCAACATCACAATTCTTTTTCCATCTTTAG
>TTN-213,,0,97,2695523,2695619,GTTCGTGAATGGAATCTATTCTCCATTTTGGCTGTGCTGCCTGATAAGTTTGGGGTCTTCCCTTGAGTAAGCTACTGTCTTCCTTTTGAATCTTTAG
>TTN-213,,0,118,2695620,2695737,GTCAGTTATACAAGAAGCAGCCTATCAAATAAAAATTCTGTAACGCTTTTAAATCTTATCATTATGGGTAGGAGTTACAATATGTTTCTTCTTTTCACACTCTCTTATTTAATCACAG
>TTN-213,,0,112,2695738,2695849,GTTTGTAAGCTATTCTCTTTCAAAGATAGTCTATAGCGACAGTTTCATTAGCAGACATTATTTCTAGTGGAGTTACCAATGTAACTCATCCACATTTTCATTTTTACTACAG
>TTN-213,,0,102,2695850,2695951,GTTTGTATCTTCACCCCAGTCAGCTTCCCTTATTTATAGTATGTCCTTTGTAAACAAATAGCAAGAGATTAATGGATGTGTTTTGCTGTTTGCATTGGACAG
>TTN-213,,0,246,2695952,2696197,GTTAGAATTTCTTTACCTCTTCTTGATTCTTCCTTGCGAATGCTTCTTAAATGTATCACTCTTGCCTTTGTATCCTTTAGAGCTAAAATCTCTATGATTCTGGTTCTTTAGATACATATTCATTGTGTTCAAGAAATATTCAGCCATTGCCTCTTTCCAAGAGTGTTTTCTTAAATGTCCATAAAACTGTCACAATAATTCAACTGCAAGCAATTTAATTAAATATATCTCTCTTAAAATCTATAG
>TTN-213,,0,213,2696198,2696410,GTGTGCAAATTTGATTCCTTTATGTTTCTGTCTGACTGTGTCTTTGGTTCTCTGTATTCAGTTACAATGTCTCTAAACAATCAAGAAAGTAGTATTCTTTCTAACATAGTAAACAGTATTTGCTCATGTTTTTCTCTTGCCTGTATACTATCTAATTTAACTATTGTTATTTATTTCTGTTCCCTGATACTCTCCTCTTTCCTGACTCTTTAG
>TTN-213,,0,1043,2696411,2697453,GTAGACATCTTGTTCTTGTGTTTCTCATTAAATGAAAACCACCTTCTCCCCTGGGTATTATAGCTCTTTATTCATTTACTATCATTTTAGTTTCCATTTGAGATCATAGAATATTTTTCTGAGCTAGTATTATTTCCCTTTTTAGATGGTTTCCTTCTTGAATTTTGCTTACATGTAACTAGTCATTATGAAATATTTTTGTTATTCCAGTGTCATAATTCTGATTACCTCAACACATTTGCCAAACATCAAACGTGATGTTTCAAAACTGCACAAAAAAATGAAGTAGGCATTTTAAAATTAGTCTTTTGCTTTCAATCAACTTACAGATATATCATTCTCACTATAATCTATATCATTAATAACAAGCACTTTTACTATATCTATGCAAAGTGAAAGCAATACAGGTTTTAAACTTATGTTTAAAACAGGACAATAATATTTTTTCCTTCTCTCTCAAGGATCACTTCCTATCCTTTAAAAATTATATGACTATACCTTGGTACAAATAGTATCTGTGTTTTTTTGCTGCAATTTTCCAGTGCTTTTTTTTTTTGTCACAAAGGCCAAGTTTGTCTTGTTTTAAGACAATTATTGCAGTAATCATTTGCTGAAATGGAAGACTTAGATCACGGATGTTGTGATGACTTCCAAGTGTCTGTTATAGAACATATACAAAAAAAATCATCCTTGAAATTAGAATTCCATACTTCATGCAAATCATTATTTATTGCTATACTTGCTTGTTTGCAATTTTTGTATCAATCTTTGTAGCCTAAGATACATCAGTAAGGTGTAGTAGATAGAATGTTGAACTGTTCAGTAACGACATCTAGGATCTATCTGGGTTCTCTGCCCATCTAGCTGGTTATCTTGTGAAGGCAAATGGCTTCTGAGGCTGTTATCCCATGAGAGTGTTAGTGCTGGACTCTACTTACCCATTAGAATATCTTAAACCTTTCTTCCAATTTAAAGACAAATAAAAAATTTTCATTTTGTGAAATTCAGTAGCCCAATTCATGAGAAATTCTTGTTTTTTGCAG
>TTN-213,,0,118,2697454,2697571,GTAAATATAGTTCATCCACATGGCAGAAATGTCATAAATGTGCAAAATCCTACTTTTTTCACTCTCGCATGATCTGGACAATCTTTTCAACAATTTCCATCCATCTTTTCCTGTTCAG
>TTN-213,,0,829,2697572,2698400,GTTGGTACAATAGCCCACGATAGAAACTGGTGCCAAATGCTGGAATGAATTACTAAGAGTTACTGGCAGATTCTTTTTCTGAGTTTCTTCTAGAACTATATTTATCCTCATCTATTTGAAAGGTCTAGAGGAAAGACATAGTTGATCTTTCAAACACTCTTTTCTGTTTCTGTGATTCTAACAAAAATTAGACATCTGTTTTATTGTTTAATAACTACCTGTCTATATCAATTAGCAGATACAATCATGACTCTCTTTGATTAAGCATGAAAGAATACAGAGCCCAGCATGTGCTACAAGAGTAATTGTTAAAACTAACAAGAACTCCAAAGGTTGGCATTTGATAGCAAAGCTTCCACATAAAATTAATGACAATTAAACAATTGTTTGAATAACAACTTTCAAAGAATTGTCTTTAGCACCTTAAGGTAGAGCAAAAATACCAAGTAATTCACAATAACCTGTAGACTTTGATCTACAGAGGGTCAAGTGGAAATCAATATATACTATCTAATGCACATTGTTTAAATTGTTTTGAAGTTGAGTCATGCACGAACATATATTTCTTAAGAATAATTGCTACATAAGACGACAGCAAGAGTGGTGGGAAAAACAAAAAATAAAGAAAAAACTGAAAAGAAAAAATATTAAAATAAAAAATAGCTATAATTCTATGACTGCATGTAATTATGGAATCACACTTTAAAGTCGAGAGAGAGAGCACCCTAACATAACCATCTCACTGGGAGAAACAATCTTAGTGAATGTGATAGTAGAGACAGAGTAAAGATCCCAGACTTTGACAGATGGATATCACGTTTTATTTCAG
>TTN-213,,0,116,2698401,2698516,GTTAGTTCTGCTGTTTTCTTCTGGTTGCTTATGCAAATTCCTTTTACAAGTTTCCTTCTTTCAAGTCTCTTCTATTCTTTCAAATCATGATGAGTCTCTTACCTTTCCTCACACAG
>TTN-213,,0,159,2698517,2698675,GTCAGTAGACAGTCAAACTTGTAAGGAATTTCTTACAAATTCCTCTTCAGGTGCACATCTATGTTGACAAACATTTGAAAGTGCTCTAATGTTTTATTCAAAATTGCAACTCCATCTGAAGCTTACAGGATCTTTTAATTGTTCTCCATGTCTATATAG
>TTN-213,,0,93,2698676,2698768,GTTTGCTCAAGTGGATTCACTTTTTCTGTTTTCTGTATACCGACATCCTTGTGTTTTTCTTGTGTTTAACTGCTGTGCTTTGTCACTTACTAG
>TTN-213,,0,108,2698769,2698876,GTGTGTTGTCTTATTGTCTCTTAAATCATTTGCATTCTTCTAACATGTAGCATAGTTTCTTTGATATTCATTAATTCCAGTTGCTAACTGTGAGCCTTTCTTCCTTAG
>TTN-213,,0,112,2698877,2698988,GTGATGATATTTTACAAATTAAAAAAATTCTTTTTTCCTTAACTCTTGTATCTTTATGGTGAACTTCTCATTTCATCTCCTAACACCTTAAGTATTACATGTCTCCCTACAG
>TTN-213,,0,124,2698989,2699112,GTTTGTTCACACGTCACTCTTTTTCTTTGCAAACTGTGGCTTCATATTTCATTGTCAAAGTAGAAACGACCAATGGCAAAAAAACAAACAAAAAATACACATTGCCTTTCTTCTCATCCTCCAG
>TTN-213,,0,644,2699113,2699756,GTATCATTCCATGACTTTTGACAATATTTGTTCCTTACCATATTTGCATAATTGTCTTATAAAAGTTTCTTTGGTTTTTAAATGTTTGAGAGAAACTAACTGGACATGTTAGAATTTGTGTATTAGTGTTGGAGGCAACATTAATCAAAGTTGTGTTTTCTCTTTATATTGTTCTTTACATTAGTGTAACTCTAAGTGTAATCTTATCAAAAAGTATTGTTTAATTGAAATTTGTTAAATGTTGTTTTAACTATCTAGTCCATTTTTTAATGCTTTCTTGTTATATGGCATTCTGATTTATCATTACTAAATGTTGATCAAATACATCTATAATACATTAACTTTTATGTTTTAACTTACATAGTCAAACTAAAAAAAAGAATCAACTAAATTCTCTATTAAAAATGCACATGTACCCTAAAACTTAAAGTATAATAATAATAAATTTTAAAAAACTAAAAAAAAAATGTTATGAGATTATTTAACTTAAAAGATAACTTATTTTACTGTAAAATCCTCAGAAAGTATATTCTTAATAACAAACCAGTTTAAATATAAATTTATGGGATCTTCAGCTACAAAAACAAGCTCTTTTAACATGTATAATAAATATCCCTTACTGACTGTTTTGTTTGGTTTACTAG
>TTN-213,,0,257,2699757,2700013,GTTAGACACACTAAGCTTCTTTGTTTCTTTATTCTCCTCTGATTTGGGCTCTTAGCAAAGTTATGAGTTCCAAAATAAAAGGATAATTAAGGTTATTTGGTTGCAATTCTTCAACAAGTTTTAATGAATTGTCATTTCTTGTGTCAGCATGTATTGTCATATGATCACACCAGTCACTCTTCAAGGTTCTAGATTTAATTTTTTTTTCCTTTATAGTAAGCAAGTGTTCTCATTGTTTATCTCCTTTTTTCTGGTAG
>TTN-213,,0,120,2700014,2700133,GTTTGTATACATGGACACAAAAATATATGCCCCTTCCTCCTATCTGTTCTTGCCTAACTAATAACTTGTGTGGCCATGATTCTCACATTTTTTCCTCTAACCACAAATTTCTTTCATCAG
>TTN-213,,0,150,2700134,2700283,GTTAGTAGCAAAGCACAGCCAGAGAAAAAATCAATTTACTTGATCCATGATCATTTTCCTCAAATATTCCTCTTATCCAGTAATTCAGTGATTGCACTCTTGAGTTTGAAAGGTTACTTTGTTTTCAATGCAAAATACTTCTTCTTTTAG
>TTN-213,,0,102,2700284,2700385,GTGAGTAGAATGAGATTTTTATGAATATACAATATTTCCAGGGGGTGGAGGGGCACAGAATAAAACTTCTCTTTAAACGCAAAACTACCCTTCCCCACATAG
>TTN-213,,0,190,2700386,2700575,GTCAGTGTGCAAGGATAAAGCTGCTGCTTCTCTAACACCTCTTTCATGTGGACGTGGTGCCTGCCTTCCCTGGAGTTTCTTTATTTTGTCTTCATGTTTAGTCTTAGCTCCCTTTTTTTAAGGAGCAAAAGCACTTCTCACTTGGATTTCTTTCTTCTCTTTATCTCCCCTTCCGCCTTGCAATATCTAG
>TTN-213,,0,94,2700576,2700669,GTTTGCTCTTTCCCCCAATATATACATCTTTTAAAATTTCTCTTAAGTCTTCATTAGAAGGCAAGAATTTTACCCACATGTTTTCTCCTTATAG
>TTN-213,,0,100,2700670,2700769,GTGTGTTGACAGCTACCTCTTTTTATTGCTCTCTTTCTTTTCAAACATCCTCTTTTACATGGCATGACTGACTTGCTGACTACCATCCTTTGTACCATAG
>TTN-213,,0,132,2700770,2700901,GTGATGGTGTTGTTTAACCTAGTGTGTGTGAACAGATTCATTTTCTTAAAAACGTTAAAACTTTTATGAATTGAAATATGTTGTGGATGCCTTCTCACCTGTAAATAAGGATTATCTGTAACTTCTTTACAG
>TTN-213,,0,140,2700902,2701041,GTGAGTAACTCACAGTACCCTCTTCATTGTAAAGCAGCTTCACTGCTCCAGGCCACCAAAAGGCTGGTGCCATTTAGTTTCTGCTCTGTATGTGAGAGCATGGAAATAAAAATCACCATGTTGGTCTTCATTCTTTTCAG
>TTN-213,,0,1320,2701042,2702361,GTACTTGTTAGAGTGAAGGAGCAAGATCTCTTTTACATTTTCAGTATCTTAAAATATAGGAGGGTGGGTGTGCTTGAGAGAGAGCTATGTTTAGGACCAGGGTCTAGTGATGAAAATGGATCAAGTGGATCAAGGACCTTCCAAATGGAGACAAGTATTTTTTAATTACTTTAAAAAAAAAATTTAAAACTAGGAAAACATGGACCAAAAGTCCATTTTAAGAGACTAAAAATAGAGACTAGAGAGAGATAACCGAAACTCTACAAAATTGCAAGAAAATCCTAGTTTGAAAGACGGTATCATAGGACAAAAGCGAAGTTATTGCAAATGACTTTTTTCCCACAGTACTTAGTAAATGAATGGATTTTGTCCCTCTAAGGCATAGCAAAGAGCCAAACTATCAAGCCCTTCAAGGAGAATTCAGATGAGAATGATAAGTTCAACTTACTTTCCTCCACTAGCCCCACTTAAATAATAGTGGAGGTCAGGGGCTGGGGAGTAAGTAGATCAGTATCTGCTATTATGGAAGGCAGTCATGTGTTTCTGCCACATGTTTATCGCTGCTACTGTCAGAAATTAAATAGTTCACTCAATGGACTGCTAGTCTAGTCCATTAGAGTATTTTTAAGGGTTTTTGTAGTGGTGGTTTATAAATATCTTGAAATTAAAATATAATTAGATTTAGCAGCCCATTTGCTCTATGACATATAGCTAATCACTTTTACTTCCCTATGCCTGAATTTTTTGCTTCAGTTAATGAGGAAATCATTACTCTCACACACTTCAAAGGAAAATTATGAAGGTTGAGGAAATACCCATTTAACACCTAAAAGAGGAAAATGGCATTTTAAAAATATTAAGATATCTGACCCACTTTGCCATTCCGGCTCTTCATGCTATGTAACTGATAGCATTGCAGCCTTAGGAAATAGTTCTCCACTGGTTCATATACAAGACAGTAATCAAATTCTCATTCCCCGTGGACCTCAGAGGGCTTCCACTGACAGATACATGCTATTATCTCTGATCTTGGCACTAGAGAAGGGACTCTTTTGCTGGGGAGAGGATGGCACAATAAAGAGTAATGTCTTTTTCTCCTTCTTTTAGTAATAATACTTGATGTGGATGCTTACAAAAACAAGCATATTTTATTTTAGAAATTTTCTATTTAGGTTTCATTTAACTCTTCTTCCTTGAACTGCATAAATTTGTTTTCCAGAGCTAAAGACCTCTCTAGCAAAGATTATTTTTTCCACCTCATCTTGAATTATATGCATCTGTTCCATCCCTTACCCTGTGTTTTTCCTCTTGGTTCCATAG
>TTN-213,,0,228,2702362,2702589,GTCAGCGCTCTCCCCACCTGTGTGTTTTTCACATTAGCCTCCTCTTTAATTGTCCTCTTAACTTCCTGTTTGACTCTTCAACGATGTTTTAAAATAGGGAAAGGACACAACAAAGAATTGAAAGTGTTTTTTTCACTCTCTATCTCTCTGATGGAGTGGAAGATTGATTCTTACTTTTAACTATATACTTACAGAATACATCCGTATTTTCCTTTTTTCCAATTTTAG
>TTN-213,,0,412,2702590,2703001,GTTAGATGGACTGCATTCACTTCTGCTCACTACTTCCCTTCTAATTGTAATACTCTGTTGCCCCCTCCACCCCAGCCCAGTCTTATCACTAGCAGCCTATTCCACTTTCCCTTTGTTTCCTCTCCAAGTCCTTTTCTGTTTAGTCTGCTTCCCTTTTCCAAATCCTACTGAATATCCTTTTAGATAATGTTGTAATTAGGTTTTGATTGGATTAAGAAAGCTGGAGTAGATGAGATATTCAACTTTCCTACTGAATACAAACTTTAATGTGTCCCTGCTCGCATCCACCAAAAATGCCTCTTAAATGGAAATAACACATTATCACTAGTTTGATTCCCGGCATTCACGATTTGAGCAAAATGCTGTCAGTCTCACAAATTTTAAAACCCAGGCTTTCCTCCTTTTTCATCAG
>TTN-213,,0,116,2703002,2703117,GTTAGTAAAAAGATGATGTTATCACAGATACAAGGCACACACTCACCAGGATCTGTATTTTCTTTAGTTTTTCAATTTGAGTTTAAAATATGGATATCTTTTACATTTCATTCCAG
>TTN-213,,0,524,2703118,2703641,GTTGGTTGATTTCTTGGGCTTTTCCTTCATCATTATAATAATGTAGTTCCTGATTTTCATAAATGTATATGGGTTGTTACATCTTCTATAGGATAACATGAGTCCGACATCTTCTGAATCAGCAAATTCAGAGGCAATACCATCTGTAGAATTAGAAGAAAACCATGTTCAAAAGTTATATCCCTTTCTTTTTGAGGAATTTCCAAAATGATGATAGGAATGAAAAATAGTCCCTGGATAAGGTTAAAGCAGTCTTCATTTATGCTGAAATAATTCACCACATAATTCTTCACGGCAAAGAGAGAACAAAATCCCTAGCAAGTCAACCATCACATTCTGCCCACTGATTCTCCAAGCTTTTGATAGTGTGAACCCATAGAGGAGTTTTTAATACCGTCACAAAAGAGCCAAATGGATCTAGGGATAGTCCATCAAAAAGACAGTTCTCTCTTCAAGTCATTTTATAATTGTTGTCCTTTGTTTTTTTTGTTTTGTTTTGTTTTGTTTTGTTTTGTATCATTCAG
>TTN-213,,0,109,2703642,2703750,GTCAGTTTACAAAACAGTAAAATGAATTGCATTTCATAGTTTATTAAGCATGTTTGTCATAACAATTCACAAATACTAAACCTTTTCTGATATGTGCTTTTGTGTTTAG
>TTN-213,,0,103,2703751,2703853,GTTTGTCAGACTGCTCTTCTAGATTTATACGATTAGTAATTAGATGTGTCTTTGTCTGTATGTATATGTGTTTGATTTTATATTTTCAATTTGGTCACTTTAG
>TTN-213,,0,92,2703854,2703945,GTTTGTCATGATTGCACATTTTTATCTTTGTATACAATCGATGATCTGGCATGTCTCCTTCATGACTGATTGATTATCTCTCTTGGCTGCAG
>TTN-213,,0,594,2703946,2704539,GTGATTGCAATATTTTTAAAGTGAACGAATTTGTGTTTCTTTTGAACAAGATTTAAAATGTCTGGGGAGGCCTATTTTTTAGGAAAATCTTTCCAAAGGCTTAAAATTCTGCTTAAGTAATCCTATTTACAGTTAGTGGCTTATCTTTTTCTATGGATTCTACAGAGAGATAATATGACTAAATCTTTAATTGGAAGGATTATGCAATCATTTGCTTCTATAATTAAATCTTTTTTAAAAAGTGACCATATATTTTTAAATTCCACCCCGTAAGTATCTCATGCAAATTGCTAGAAGGCAGTCTTTAAAATTACAGGAATCTGCTGCTTGCCCAGAGACATGCCTTCAGCCAACCAATTGCTTTATTGGTTTTCATACTGTTTTGCACCTACTGTGCATTAGGGTTGGTCTCAGAGTGATACTTTTGCTCCAGAAATCTATATGCTTTTCTTTATCTCCAAGTTAATTCAAGAGACATTAATAATTCCTGATTTTTAATAGAAATTGCATATATACGTGCGTTTGTATATATATAATTGTGAGAAGAGCATTTAGTAAATTAAAGTATTTGTTACTTTTATTCTGTTCCTACAG
>TTN-213,,0,139,2704540,2704678,GTTTGTGGATTCTTAAACTTTCATTTCTAGAATTAAAGTATTATAATCAAATATGAACTTAGGGAGAAATTTCTATTTCAGTAAACTGACATGGTCCAGATATTGAGCCTGAAACCTTGTCTTTCTGCTCTACTATTAG
>TTN-213,,0,778,2704679,2705456,GTATCGTTTATTTTGCAAGTGGTCCAACAAAAGTGTAATCATTTTGTAGTATAGCCTGAAGGTGTCGTTTTTATGATGATGAATGCAATTTAGGACATTTTTAAACAAATGAAAAGAAAATGTTTAAGAGGAAATAAGTTTATCTAGAGAAGAAGTCATTTTTTAAATCTGTATTTCTTTCTTTCCTCGAGACAGGATCTCATTCTGTCGCACAGGCTGGAGTACAGTGGCGTGATCTCAGTTCACTGCAACCTCTGCCTCCTGGGTTCAAGTGATTCTTGTGCCTCAGCCTCCTGAGTAGCTGGGATTACAGGCGCCTGCCACCATGACCAACTAATTTTTGTATTTTTTGGTAGAAACGGGGTTTCACCATGTTGGCCAGGTTGGTCTGGAGCTCCTGACCTCAAGTGATCCACCCGCCTTGGCCTCCCAAAGTGCTGGGATTACAGGCATGAGCCACCACACCCAGCTTATAATCTATATTTCTAAAACTTTATATATTCCCTATGATACTGAGACTACCCCTTCTTTTTACAAATTTGTGATTCTCTAAATGGCCATGAGTTACTTCTTATCATCCACCTTGTAAGTCAAAGAACAGTTTAGAATAAGCTCGTAGAAGGAGGCTGAAATGTTTAGGAACATATTCTGATATAGTGTATTTAGTTGGTTAGCCTTGATTTTTAACTAAAAATATGAGGGTTTTTTTTCTTGAAAAGCTTCATATTAGTAATCTGCTTCTAGCTTCTACTTCATATATCCTTGCAATTTCTTATAG
>TTN-213,,0,1752,2705457,2707208,GTGAGTTATCCTCACAGCCCCAACCTGTTGTGTTTTTCTTCACTGCCTGTTATATATCCATGAGCATTTCTTATGATATCTTGACCAAGTAAGTTATAACAAATATAAATACACATTATTTAACTGTGTATTTATCACTCCATATGTTTACTAAAAATATAAATTATTGTAATTTAATTATGTGGCTTCCCGAAGGAGGTGTCATTTAACGGACTAATATCTTAGGTTTCTAAATCATATCCTAAAATTCCTTTAGGTAGTTAGAAGTTTCAGCGTACTCTGAAATGTGTGCATATGTGACATATATTTTTATGAAGCACATTTGTTTTGAAATTTTTTTAATGTTCATCACCAAATATCACATTAACTTGACTATTATTGAGTTATATATTATATCACAGTCTGAAACTTTCTCCTTTCCAAGTGTATTTCTAAAGGATTATTGTTTAATGTATATTGCCCAAAGCGTTTGACCTGCAAACAAATATTAATCCCAGACAAAAGGGTAACATTTGCCCAAAAAGAAAAATAATGGGTAGAAAACATTGCATATCATTATGGAAGACATATTTAAATACACAATCATCGCTTGAGAAAATGAAATAGACCATGTTGTTTAAGGATATCTTTATCTGTTTCTCTTCACTGTAATGGCTTCCAGTAATTACAACATAGCTTCATCAAAATCACATTAAAAACTAACCTCCTAGAGCAGCCTGGAATTAATTACCAACTCTTATGATCTGGTTAGTTATCTCACAGTGCACAGGTAGTAAGTTATTATTAATAGGCTGATATCACTAATAAGTAAATATCACTGAGTTGTCTTAAAATTCCAGTTTCACCACTCATTTTGTGGAATTTAGATGCATTTAGTTTTAAAACACATTTTATAAAATGAAAAATATATACTTAGCAGTGGCTTATCTTCATGATTTACACTCATGATGGTTTTACCATGGGCAGATAAATGCTTTCTATAGAATTCTGAAGCTATTTATAAAATGTTTTTAAAGGATAGACATCAGAAGTTTTAATCTTTGCAATAACAAAAAAAATGGCCTTATTCTTTCTAGGTACAGGTCTCAGAACCATTGAACAAAATCATTACATAATACTGAGTTGTACATTGCCTTCCTATCATGTTACTCATCAATGTCTTCATCATTGGTCTTCAGTTAAACACTGAGCCTCAACTCCTAATTCCCTTGGGCTAAGATTGGATTTTAAATGCTACTGTGGCTGCATTTAATAGCTAAAGATGAACATCAGAGAAAATCACATATAAATATGTGGGCTCATGTATTACTCAAATGCTAGCTTTCTTTCCTAGAGGGTAGCAATCATTGCCGCTGGAGATAAGCAGAATTCCCAAATAAGCCCTTCATTTTCAGGGTTCAGCAAAAACACCGCTGTACACAGGTTTGAGAGAATTAATAGTGTGCTATATGGCAAAGAAGTTCATAGTAACTGCCAATGTCTGCAGTGCTTAGTAAGGACACAGAGGCTGGGGCAATTTGTGGGCAGCATGTGATGTGTTCTTTGCTTGTTTTTAAACCTTTATCTTTTTAAAAAATCCAACAAATTTAAACTATTGTCTTTAGAGAGGAATAAACCAGGCACATAATTCTGTCCTACTACAGCAACAGTGTTACCTGTTAGAGGCCAGTTTTTCTCTTTATTTGTTTCTCTTGTGGAATTTAATACTTTTTTGCCTTTATGTTCCTCATGAAAATACCTTTTCAATTCCAG
>TTN-213,,0,571,2707209,2707779,GTACAGACACCTCAAAAGTATTATGCAGCTCAAGCCAGCAACCACTCATGTTTATTTGCTTATTATGATTTCCCTAGAAATGGAATTAGATTTTTAGAAATATCAGTTGTTGCTCATCTGCAATTTGTAGGCTCCTTATTATAATTGAAATATTAGGTAATTTAACAGAAATAATGTCAATACAAAGTATCTGAAATTACTACAAGTTTACCACCCTATTTCTTGAACTTCTTTTCACCATATCCATTAAGATGTAATTAACGCAGTTCCAAAAATGATGCTATAATAATGCGATAGAAAGTAGGCTGTTGTGATACACCTGGAAAAAATAAAACCAAGTCTAAAAATATTGACACTACTAATATGATTATAGTTCAACCTTTGATAGCTATCATTAGCATAAATGTCTGAGAAGCTGCTTTATCTTCTGTAACCCACCCTTACATAGAAAGAGAATTCTGCAGTACTTACTTATCAAACTGCCAACCTCCTAAGGCTTATTTTACAAAGGGGGATATGTATTGTAATTCTGAGGTGATTGTAGTAACAAAACATGTAAATGTTTTTTCAG
>TTN-213,,0,122,2707780,2707901,GTAAGTGCACTTCATGAGAAGTACATCTTCATCTATCTTATACCTTTTACTTATGATTTAATTTTGGAAGAACTGATTTTAGAAAATTAAATTTTTATTCACTTGTTTTCATTATTCCTTAG
>TTN-213,,0,1096,2707902,2708997,GTGAGTTCAATAAAAACCACAAATCGTACAATCAGCCCTCCATATAAGTGGGTTCCGCATCCACAGTCAACCAGCCCCAGTGGAAAGTATTAAAGAACAAAAAATTTAAAAATACAAATAAACAATACAGCATAACAACCATTTACACAGCACTTACATTGTATTAGATATTATAAGTAATCTAGAGATGAAGCATATGGGAGGATGTGCATAGGTTACATGCAAATACTATGCCATTTTGCATCAGGGACTTGAGCATCTGGCCACAGGCCTCCTGAAGCCAATCTCCCAGGCATAGAGAGGGATGACTGTAATGTCCCATTCACAAAAAGAATCTCTCAAGAGTCATGGGCCATCCATCTCAAGATTCAGATTGTTAAAGAACATAGGCATATAGACATTTTCACAGAAGCAGATAAGCAAATACACAACATCTGGGTGTTCTTGTTTCATTAGAATCAATTTCCGAATTTAAGAGAAAGTTTTAAGAATGAGGTGAATGTCTATTAAGATTTTTAAACAAAAAGAAATGGCCTATAAAGAAACCCCAGTATTGTCTGTGCCTAGGTATGAAACTTTTTTTCTATATATGATTTCTTATGTTATGAATGGTTCTCTAAAACAACTGTTTTAAACATTTTCCATAATTATCATTCATTTCAATATGGTTCATTTTTCAACATAATTATTAAATTAAATCCACACTCAATTTCCACACATCGTTTCCGTGATATGTATACTATTCTATTATTAAAGTTTTCCATTGCTATTATTATTTTTTCTGATATTATAATTCATTAGCTAGGCTCTTTGGTTATAAAGTTTACAGAAATACTTCTATTATCCTTTCCCTTCTTAAAATTTTCATTCCTACATCTATATTTTATTACAATGGTCCTAATCCATCTGATCTTAATCGACTCCATCTCCAAACCCACATTTTTAAATTGTTTCACAGCTAACATGGTAAAATTAATATTTATTGAATAAAGAACATAGAAAACCTTAATGAAGTATATAATCTTTGAATGATGATAGACAATTAAAAATAAGTAGAAGACAGGTGTTTTATCCTTACTTTTTAAATTTTATTTAG
>TTN-213,,0,207,2708998,2709204,GTATGCTCCTTCATATATAGCATCATGCTAAAAAAGTCACATTTAAAACATCTCACATATTCCCTTTGAATTACCAGAATCCTATAGTTATATGACGTCATTTAATATGACCTAACCAGCATCCAGAATGGAAGCTGAATATAGTCATGCGTCCTCTAAATCAAATTTTGTTTCATCTGTAATGCCTATCATTTTTGTTCTTCTCAG
>TTN-213,,0,99,2709205,2709303,GTAAAAAGAATTATGTTGATAATAAAATGAACAAGTTATTATTGAGTATTATTATAAGGGAAGGAGTAACAAATGTGTTTTAATTCTTTATTCTCCTAG
>TTN-213,,0,102,2709304,2709405,GTAAGTTAGAAAAGGCTTATGAAATACTTGTGAGATTTAAATTACTGTTGAGCACATCTGCGTGTGATATTGAACAAAATGCGTGTTGTATCACATGAACAG
>TTN-213,,0,1483,2709406,2710888,GTGCGTGAAACACTATGGAGTCCTTGTGGGTACAGCATAGGTCAATGGCAAATGTTGTGCAGGACCCCTGCAACCCTACCTGTAGACACACACCAAAGTGGTCATGTGTTCTTATTTCCCAACACACGTTCTCATAGTATTCATCTCAAAGTTCATACAAAAGCACAAGGGAAATATTCAAATGAGTGTCAGTTCTTTTGCATCGTTCTTTTAGATTTTAATCTAGTCTAAGACATAATCTTTAACAGTTATTTCTGTCTAAAGTCTAAATTTCATGATTCTCATATCTAGGATTGTAGAAAGAAAGCTAGGAAAGGACAAGATCTCATAGATGTAAATCTGGAGGATCTTGGCTAGGAATTGATATTTTGTTTATAGGACTTAGTCTGACTTTCTCTGTACAAAATTATATAGATAACATAAACATGTCATGTGCAATTAGCAACTATTTTTCAAAAATATTTATTTCATTTTCAGATCATGTTTCAACCTTCTGAATCTCTGAAATTAAGTGAAATCTCAGAATTTAGGAGTAACAACATTCATTTCCTAATTGATTATACACATTTTCCAAAGACACCCTCAAACTGTATTGAGAAAAATTTTGGCTATGATAATAGCATCTGCTTTCAGCTATTGGTGCCCATTCGTAGTTGCTGAAACACAAATATATGACATTGGATTTACATAAGCATGTCAACTTTTCTGACTTACCTTACAATGAATATCAGTGACTGGTTGTATTTTAAATGGTTTTCAAATTAAAGGGCCAGCTGCAAGTACTAATTATTTTTTAAATAATTGATATTTTTAATATAATTCTTTAGTAAATAGAGCTCACCAGAGTACTGTGATTTCTAAGACTTTATGGTACTGTTATACATATAAGACCCTCCCCTCCAGCCTCTTCTAGAAAGCACTCCTGCCATCCACACACATACTTTGTTTGTGCCCATATGTACTTAGCAGATTTCTGAACTCTAAAATTTTTCTTTTTGAAATTTAGAAGTGCAGATTTCCGATTGCGTTTGAAATTATTTTACAGGAAAAGTTATACATATTAGATAAACAATTATAGATCCTGAATAGCAAAAATTATTTTACTGAGGCAAGAAAGAATTTCACAGAGGAATAAGTTGTAGAGTACAATCAAGTTTGTGTTCCCTAACACTTTTAAAATTTAATTTGACTTTGGGTCATTAGCTCTCTTTAGTATGTTCTTTATATAAATATTTTAAGAACTCACAATAATTTCTTTACACTTTGCTACATTCGACCAGCATGAATACACTTAAGAATTGGGATACTTTTTTGTTAGTGATGCAAAGAAGAGTGCATTTCTTCTCATTTTGGATTTTTGAACTTTTCTTGCTATTTTATAACTGGGTACAAAGATGGAGATTTTAAGTATCTGAGGTAAAAGCAAGTAAAAGAAATTCCTCTCTATATAATCTAACTTTGAACCCTCTTTGTACTTAAACAG
>TTN-213,,0,208,2710889,2711096,GTGATTTCATTGACAGTTTTCCAGTGAATGTATAATTTAAGCCTCGTCTGTTTTCTGTATTTCTACCCTGTATGCGCTCATGCTCTCATTCTATCTAGAATGCTTTTTTAGAAAAGACAAGTGTAAATAAACACATACGTATATTGAAGTAAAGAAGTGTTATTTGCAACATATCAGAAAACAAAAGTTGGATGATTTTTCACCCTAG
>TTN-213,,0,101,2711097,2711197,GTGAGGTAGCGCCATCAGAAAGCCACCCTGCCATCTTCGAAACACGTAGCCTACCTATACCATTCTGAACACAAAAATATCATTTTTTTTTTATTTTGCAG
>TTN-213,,0,452,2711198,2711649,GTAAGTTGTTTTGTAAAAATCAATCCTTGCTTACAATAAATTTGGCATAATTTTGTAAATCACAGAAGCCAAACTAAAATGTATAAGATATCTTTCTCTTTTGGGTAAAATATTTTTCAATAAAACTGTTATGCAGTAGAATTACTTTCAGTCAAATAATAAAATGTTAAACCTTGTGAGTCTGGCAAATTAGAGATAATAAGGTCTCACTCAGCTGATGCTAGAATCATGTTAAATAGAATAGCCACAGAATGAAACAAATTTTGACAGTGAACAAAACTTACCTGCGTGGTTGCATACAAAAGAATACTAATATTATTTTGTCTGTATATTAGATTCTGCCATTAGATATGCCTGACATATCTCAGGATCTAATAAATCAAACACACCTTAGTTTTCTAATAAATAGCTTGTTCTCAGTCTCTCTATGCTTATTACATGTCCCTTTCCAG
>TTN-213,,0,324,2711650,2711973,GTAAGACCCAGAACCTCAACATCTGAGCTTGGAGCAGCAATATTCTAGCACTAGGAATCTGTACGAAATTTTATACCAGCGACCAAACTGCAGCAGAGTCAGAACAAAACCTTCCATGTCATATTCTTCAGTGAGCAATTAGAAATTAAAGTAAAAAAAAAAAGTAGTTCCAGTTATAAATAAATGCTACTTTTATTTGTTCCGACTGATGAATTCGTACTATAATACCTATGAAGTACTGAAAGAAATGCATGAGACTTTTCATTATATTTTACGCAAAATAAGAAACTAAAACATGTTACTAACGGCATTTATTTTCTTCAG
>TTN-213,,0,2205,2711974,2714178,GTATTATACCTCATCTACCTAGATGTCGAAATAAGAATTTCACTCTGCTGACCCGAAAAATGTTGCTTAATACAACGCATTGGCCCTCTAGTGGTCAAGAGGTGGAATTGCCTTTCAAAATGTAAATTACTTTCTCAAAGTATTAGCTAACTAAATGTGTAAGTTATGTGCTTAAAACTCTGAAAATCATCAAACAAAATACTATTTTGGTATTAAAATATTTTATTTTAATGAAATTACTGAAACATTAATAGAGAACTAATTTAATGTTTCATATTTTCCTAACTACTATGTATAACAAAAAGAATAATGGAACCAATTTCTAGTGCAGCTTATAGAAATAAACCATAGTAGTTTACAGCCAAATTGCAAATTATAGCTTGTGGCTTTTCTCAATTTATAGTATTAACTACTCTTAAAAATTTACTATTTTGTCACATAAAATATGATTTAGAATACTTATGAAATATTTGACTTCTTTTGTACCTAAGGCATGATCTCACCAATAAAGAGATCTTAAGTGTTCCAAGGAATTGCTCCTCTCAAATACTCAGTAGAGAAGTTGTAGTATTTGTGTCCCAAAGCTTCTCAACTAAATTAGACAACAGATTTCCTGGGACTTTCTGGAGTTATAGGGAGTTCAGAAATGCTGTCAGAATTCTCCCAGCATGGTCAGAAAAAATTCTGTATGTCAAAATCACATTTTTCTATAGCTAAGTCACTACTACTGTATTAGATTCAAGGGGTGGAAATGGTAGGCCCTTAACACCCGCTATAATTGGCATTAAACGCTTGACCTATTTTTCAGCCAGCCTTAGAGGAAATTCAATTAGAAACTTCCAATTTTGTGACTAATGCAACCTCATTAACAAAGAGAAGCATTTTTATGATTCATACGAACATAAGCATTTTATCTAGCTGTGAGAACAGAGAGGAACAAGAATCAACAATCATAAATTGGATTTCCATTTCTATTTCTGTTGTCAAAAATAATAACTTATGTTAATGAATGATTTGTTCTTTGACTGGTAGTATCAACATGGCTAAGTTTGGTACTCACTGTGAAACTTGAGAAGTTAAATAATGTTTTAAAAATTAAAAAAGAGGCCTGGCGCGGTGGCTCACGCTTGTAATCCCAGCACTTTGGGAGGCCGAGGTGGGCGGATCACGAGGTCAGGAGATCGAGACCACGATGAAACCGCGTCTCTACTAAAAATACAAAAAATTAGCCGGGCGTGGTGGTGGGCACCTGTAGTCCCAGCTACTCAGAGAGGCTGAGGCAGGAGAATGGCGTGAACCCGGGAGGCGGAGCTTGCAATGAGCCGAGATCGAGCCACTGCACTCCAGCCTGGGTGACAGAGTGAGACTCCGTCTCAAAAAAAAAAAAAAAAAAAAATTAAAAAAGAGTGGGCTGGGCGCGGTGGCTCACGCCTGTAATCCCAGCACTTTGGGAGGCCGAGGCGGGCGGATCACAAGGTCAGGAGATCGAGACCATCTTGGCTAACACGGTGAAACCCCGTCTCTACTAAAAATACAAAAAATTAGCCGGGCGCGGTGGCGGGCGCCTGTAGTCCCAGCTACTCGGGAGGCTGAGGCAGGAGAATGGTGTGGACCTGGGAGGCGGAGCTTGCAGTGAGCCGAGATTGCGCCACTGCAATCCGGCCTGGGCTAAACAGCGGGACTCCGTCTCAAAAAAAAAAAAAAAAAAAAAAAAAAAAAAAAAAAAAAAAAAAAAAGAGTGTTATTTATTCATGAATACAAAAGGCCATAATCAAGTATGATTAGGAACCGTGGTTAAGGTATAACAGCTGCACAACAAAGGACTTTAAACCCACTTGTTACTCTTCCTCCTAACATATTTGTGTTCGTCCCTAAGGATGAAGCAAAGATGAAAATGTGTACTTTACTATTTATGATATCACTTAGATTCACACTCCATGTTCTGAAAACTTTAACTCTCAGCAGACATAAAATCAGTGAAGATGTAAGATCACAGTACATTTTCTATATCCCTCCAAAACAATTTTTTTGCATCTAGTCCTAGATCTTTCCAAAACAAATATCTTGTAGTAATATGCAGAATCTCGCTACTATCAACATATGGAAAAATAAAATATTTCAATAAAATTCCTAGTTTCCTGAAAGCATTTTAGTTACTTACACCAGAAATATTTTTTCTTTTTTTTTCTTTTTTTTTTTTTTTAG
>TTN-213,,0,1674,2714179,2715852,GTATTATAATTAATCAAAAAGCAGTCTTAACACTTTTTTCTTGGCCAAAACTTTTAAATTCTAAACAGTGGAGGGTGAAGGAAGGGTAAGAGTTTGCAATCACAAAATGGTACCTCTCCCTTCACTCACTTTCGCCCTCGTCTTTGACTCAGTCCTCACTCTCTCAACTCCTTTTTTCCCCCTTTTCTCTTTCCTGTCCTCCTGAGCCCCTGGGAACCAATGACAACACCAGTGTATTCTGGTTATTTCTGGATGAAAATTTAAAGAAGGTCTTGCCCAGAAATCCAACAGCTATTCTTTTTTTTTCTTTTTTATTTTATTGTAAATTGACTATTTACTATTGTGTATATATTTATGGGGTACAAAGTGATGTTATGATCTGTGAATACAATATGGAATAATTAAATCAAGCCAATTAACATATCCATCACCTCAAATACTTAACATTTTTGTGGTGAGAATATTTGAAATTTACTCTTAGCGATTTTGAAATGTACAGTACACTATTATTAACTATATTCACCACTCTGTGCAACAGATCTCAAGAAAAGCCATGTTTCTTCTGTCTAAGATTTTGTACCCTTTGACCAACATTTCCCCATTCCCTCAAATCCCCAGCCTCTGTAACCATCATTCTACTCTTTATGAATTCAACTTTTTTAGTTCCACATCTAAGTGAGAACTTACAGTCTTTGTCTTTCTGTGCCTGGCTTATTTCACTTAGCATAATCTCCAGTTCTATCCATGTTGTCACAAATGACAAAATTCCCTTTTTTTATAAGGCTGAATAGTATTCCATTGTGTATTTATATACCACCTTTTCCTTATGTATTCATCCATTGATGGACACTTAGGGTGTTTCCATAACTTGGTCTTTGTGAATAATGCTGCAATGAACATGGAAGTACCCAACAGCTGGTCTTGATAAAGTCACATCAATGTAAGATCAAGGGTTGCTGCTAATTTTAAGAGGTTGCTGCAACCCACCTCAGTATCTTTCCTGATTTAGGTGATCTAAATATCAATATTTGAAGAAAAAATACTTTATGAAGGAGGATCAATTCAAATCACTTTAACTTTCAATATATCCTCGAAGATTTTTAGGAAAACAGTTGGATAACTAAATTTAAACAAATAGTTTTAACTCATTTGACTAAGATTAGAGTACAGCAACCTCCATAAAGAAGGAAAATATGGAAACACAAGGCATCATTCATCATTCAGACTTTTCTGAGTGGTCATTTGTGAAACATCATGGAATAAGAGGACACTCAAAAAGCATGGATATTTCATGAACTTCATAGTTAATAATTGAAAAAGTCTAATGTGTTATTTTTAGCATTGGACATATTAAACATTCTCTTCATGCTTAATGTTAACTTATTAGAAATCAATCTAAACTAGAACCAATTTAAATGATCTTAAATCAATCTAAACTAGAATCAAACTTTGGCCTTTTGCATGTTTGATTTTTGTTAATATGGCCTTGCATAGCATTTCTAATGAGCTAGATTTGGAAATTATAGAAGCATTATTATGATTCCTGGAAGGGCTGGTGTATGAGTAGTAGTCATAGCTCCTACAAACAACTAACAATGATGTGGAGGATTAGTAAACATTAATAATAATGTAATCTAAAAATAAACACACATTTTTATGTTTTTAAACTCCCAG
>TTN-213,,0,851,2715853,2716703,GTAAATAAAGATAAATTATTTTTATTCTGTTTATTCCTGAGATTTGCACTTCTGCTAACTATTCTTATTTTAAATATTAGGCTTCCAACTTATTGAAAGTTGTGGAGTCTCCTCTGCTGTGTTAAATTTAGCATTAGAAATGATGGCTATTTCATATTGCCCCTTTCCCAGGAAAACAAACCCAGGCAGATGTTTATGCTGCCTCTGTGCAATGGTCTCAGAGAAAGAAGAAGTGAGGGCTAGAAAGGAAGGGCCATTCCTTATTTTTTTATTGTAGTTAACACAAATGTTAAGAGTCATATAAATAATGAGAGCCCTTAAGAACTTTAAAAATCTGTTATCTAAAAGTACCTAATTAACTTGGTTACATAATTTTAAATGTTGTTTTTATGAAACTGACTAAGGGATCATATGCAATAGTCAAAAACCTAGGTTTAAAATTAGAAATGTTTTTGAAATAATAATCAGAACTTTTTAAAAAGGTTAACTGTATAAATATGAAATATAAATTCCATGAACTTATCGAATATTAAAACTATTCCACTGGAAGAAACTAGGGGTTCTGCAAACTGGAGCTCTCATGGAATAATAGAAGGTGTGTCCATTTGATAATATTTATTGAATCCATTTTTTCATACTGGAAAAATCCTCAAATCAAGAGTAGAATGCATCTTGATACTCTACTATGTTCCATAGTCAAAAATTTAAATGGAACCAATACAAAAAAAAAAAACAAATTATCAATAAAATAGATCTGAAATACTGATGTTGTTTAACTAGGTAGATTTTTGTTTAGTGAAGCAGTTGGATGGATAGAATTAATATGCTAATAGTATCTTTATCTATTTTAG
>TTN-213,,0,454,2716704,2717157,GTATGTATAAACTGAATGACTTGTTTCCCTCTTTTCTTCATTTTTGCTCAGTTCATTAAATTTTCAATGCTATGAACCTGATTTGCAGTTTATGTGAAATAGTTAAAATGATCTTAGATTTTTTTAAGGTTAGAAATCTTTTAAAAGTTATTTTCCTCAGAGTTACTTTCATGCTTTGACATTACAAGCTAAATCATTTAGTCTTATTACTAACACTAAATTCCAAGTGCTAATTTCTAATGCAGAAGTTCAAGTTTTACTTTTACTGCCTTGTTGCATCTCTGCTTGATCCTGCTTCAAATCCTAGCACTAAGAATTGTGTTGGTAATAACGATCCCAAATATAATACTTCACACGATTATATATTATCCTTACCTTATCTCATTTGCAATTAACAACCTAAGAGAACTTACCTATTTAAGCATCCCTTCTTATTCCTGTGTTTTTATTTCAG
>TTN-213,,0,441,2717158,2717598,GTAAGTAATTAGAAATATTTAAATAGACTAGAGCATCAACATCATTATCATGGCTTGTTTGGCAGCAATGTATAAATCAGCAGTTCAATCCAATAGGCACAACTTCTTCTCTAAGCTTTATTGTGAATGATTTTTTTTTCTTAAAATTTCTATCTAATTGATTTCATTAAAAAATCAAAAGATGATAAAAATTGTAATGGTAAACTTAAATATAACCAAAATATGTTAAGTACAGAAACTTGTACCCAGAGTTCAAAGTTGTGCGTAAAGGTCAAAGAAAAAAAAACCGAACTCATCTCTCTCTTTAAAAAATGATACATGTATCTGCATATACACTTATAGGTGTGTATAAACACATATACACAGAGAGAGAGAGATAGAGAGAGAGAGAATTTTAATAGGAATTCTAAAAGTACTGCAATTTCTCTAAAATGCTTGCAG
>TTN-213,,0,152,2717599,2717750,GTATTATTTAAAACATTCCTAGCACCCATGTACACAAGTAATATGTTTACTGATCTATACTCACATTAGTTATTTATATAATCAAATACTTTTAAATTTTGTGCAAAGCAATATTCTTCAAAATACAAATATATTTGTACATATTTTTAAAG
>TTN-213,,0,590,2717751,2718340,GTATACATCTTTGTGTTTCAGCTACAAGTTCAAAATTTTTTTATTTATGTGTATGGACATGTGTACATATATTGCTAAGTAACTCACAAATCTGAAACGACCAAAAACAGCACATTTTTACATAATACAAATTTTATGTTGAGTTGCACATATGTTTAATTTAAATAGTAACATTATCTACTTTGTTTCTAGTTCTGCTTAAAAATTACATTTTTTTATTATAAAGAAGGTTTGTGTTTAATTAGTAGTTTGCTAACTTCACTATGCAATGCATTCCATTGCATATAATATTCCCTGTCCTCTTATTTATAGAAATAGACCCTAACAGATTTGGAAAAGCACAACATTGTGTGTGAAGAAGTTGTGTCTATTTGATTCTCATTTAAGAATGTTTGATGAAGGCTGCATGCATTGTTTGTCCCTATAGATCAAAACATGATTTGTTTTCTTGTCAATACTGAATTTGTTCTCAAGCTACCATATTAACCCACTCATTCTGTGTCTAAATACTTGAGTATAAAATCCATGTGTTTGATCTGATGTCTTGTACTAAAAAAAAGGAATACTAATGTGAAATACTCTCTTTAAAG
>TTN-213,,0,232,2718341,2718572,GTATAAGGCAAACTGGAATGTGGGGGCTCAAATGGAAGGGTTTTAGGCAGATTTTTATCCCTCTTGTTGTCTAATTTGTGATCGTGTAGACATTTCTGTCTCCTTGTAAATTCTGTCATCTTTTTCATTTCATGTTTGTCTCTGTTTTCATTTTTATTTTAATGTTCTTTGTAAATTACAATTACCACCCACAACATGGCATATCAGTAATTAAAATGTACATTTTTTTAAG
>TTN-213,,0,1028,2718573,2719600,GTATTAGTAATTCATTCTAAGTTTAAACTCTTTTAATAAAAATTAGTACAAATACCATAGTAAAACATTTATGTTAGTATTAAATAATAGATTTAGTCACAGTGTGCATACCTATAGCCACTATGTACAAAGGATGTGATGGGGGACGGGAAGAACCATGAGGAAGGCACAGGGGGAAAAAAGTGAAAATTATGGGAGGCTCCATTCCCTGCTTCAGAGAGTTTGCAATCTCGTAACCTGTTACTTGGAAATACAGTGTCCTGGAGCCAGTTCATGCTAGCTCACCAGAGCCTATGGTTACATTTTCAGGAATTTTGCCAGTCAGTAGTTTAACACCACCATTATTAAAAATTAGATTATGTAAATTTACAGTCCAATAAAGTATATTTTTAAATATTAATAAATACTCAAAACTCCTATTTTACTGCATTTTGTTCTTATCTGTGTTTCTGAGATTGTTTCCATCTTTGTGTCTGTGTGGTGGAAATGCCATATAATGTACTACTGCACATCTCTTTCCAACTCCAGGACAATGACATCACCTTGACAGCCAGGGTGGGAGGGAGTGTTTATACCACCTTGGAAATCGGAAATCTGCAAGCACTATAGATCAAGGCTCCACCCCCTCCATCCCACCCAAATTGTTAAACATTTAAGACACAAAAAAATCTAATGCAATTGTATTTATGAAACTGCTTTATAAAAGTAAAGGTTACAAAAAAAAAAACTAACTTCATAGTTATCGATGTTCATAAAAAGCTGGTTTCTGAGGAACTGACACAGGCACCTCCGAGGGAGGATTGCTCCTACCTGTTCCTGACAAAGTAGAGGCTTCTGCAGTTAAAGGTGACAGCAGTCACATTTTCTAATTAGCCATTCAGCCATCTTCATTTACTCTCATTTCTAAAGCATAATTTTCTTGCATTCAGTTGGTATAAAAAGGGAATCTCTATTTAATTCTAAGTCTTACAACAACATATGCCTTGTCAAATGCACACTTTCTCAAAAATGGCACTTTTCTTTTAAAG
>TTN-213,,0,397,2719601,2719997,GTAGAATAATATTTGTGAAAAAAATAATTCTTAGCATCCATCTTGTATCTTTTTCTATAAGATCTGTGTATTAACAAAATAGCATCTGTAAACCATCTATAATATATTTAATTCTGTGTATATTGATTTCATTTATTTGTGGTGATGTGTTATACAAGTATTGGTAACATTTCTAAACTCCAGATCACGCTAACTGGGTCTTTGTCTGCTTGTGTAATGTATGTAATGTCTATATGGTGTTGAGGTATTTAGCTTTCATTTCTACCACAAGTAGGCATATTTAAATTACTTCCTAATTCTCACACTGTTAGTGAAGATTTATGCTTTAATGTAATCTTAGATGTCTCAGAAGGTGACTAGAATATTCCACATTATTTCAACAATTGTATCTTTAAAG
>TTN-213,,0,2119,2719998,2722116,GTACGCCAGAGCCAATGATGGGGAGACTCTTTGCTCCAAGTGCCAGCCTTTTGCTTTCTACGATCTTCATATGTACTATGCTGCCTTTGTCTTTTGTCTCTTTTACATTCTTCTTGTGTTTTTACTGTTTGTCAGCTTCCGTGCCATGCTCTTGACATACTTTATTTATTATACTGAATATTCCTAAGACATCACCAAAAAGTATTGTTAAAGGAAGTAACTATGTCAAACTGCTATCTTACATTTTTAATATCTTCCCTCTTTTAGAGAAAGAGGAAATGTTTGTGAAACTTGTTTTCTACTGACATGTTTCTAGGAAAAAACCTTTCATCCTTCATAAATGTAACTTTTTCTTAATAAAAGCAGTTTCATGCATTATGAAGAGGTGGAGACAGGCAATGACAACTGGAGAGTGTCTGGCAGAACTGAATGTTAATTACATAAAGACGTACATAGTACCACGCTTCTTAAAAGTCAATAGTGGCGAGTCTTCAATAGTGGGGAACATACAGATTTTTTGAAGTTTACTTTCACCATTTTCTTGAGACCTTAACTGAGCTTCAGTATTTGCCATAAATGTTTCCGTTATCTAATTAGCTAGTCAAAGTACCTTTCACAGAGGTATGTTTGAATGAAAATGTGCTGCTGTGGTATATCACAAATCCCTTGCTTTGGTTTGTTTGGGATTTTTTTGGCGATAAAAGGCACTATCTTATTGAAGCACTGAAGCTACAATTGCACGCATCCATTCAGTTATAGAGAGACTCAGCAAGAATTCAACATTATCCAATTTAGGAGAAACCAGACCTAACTAAAATAGTACATTTTGAATAGTGTTCCCTTGGCCTGACTTTGCAATGTTTCTATTTTCTTCCTGAATCAAATATGCTTCTCTCTTTCTCAAACTCTTGGCTCTTTCAAAATTCTTTTGATTATCTAACCATTAAATACAAAGGTCATGTTAGTAAAACCAATACTAATACTAAAGCTACTTGAGACAGATCGTCTTAGATAAATTAAATCCATTGTTATTATGTACTACATTTCCCCATACAAAGCATAAAGAACCTTTTCTATATACTATCTGAACATTCTTGACTGTTTGTGTAATCACTAATTCGTTTTCAGCAAAGTCATATATGTCTTCTAAAGGAGACACAGAGGCATCTCTCATTTACTCATAAAAACAAATACACATAGTATAATAGCACGTATATATATATAAATACTGCATGTATATATAGCATAACATATACATATATAAATTAACAGCTATATAATTGCACCAAAATATTACAAATGCACGTGCAGAGGTGCAGGGATTCACAAAAGCTGCCAATATTGTATTTAAAATGAGAACAATTATTGCCAATAATGCATGCTGTTAAAATTCATCTTCCAATTAAAAAGTCAACATTATCCATTCTTAGAATAGATAAATCAAATACACTGTAAACATTTTTTAGGTTGAAAACCCTGTTCAAAACTCTAGAGCCCCTTAGAAAAAAAAAGCACAAATACACATACCCACAAAATTCTGCACACAAAGCTCTGTAAAGTCATTAACACATGGGTATCAGATTGAGAGACCTACTCTAGAGTGTTTCCTGAGTTTTGAATTCACTACAGGCACACCCCCCAAAAATGAGAGGAGAAATGTGGGGAAGAGAAGTAAGTTACACATATTCAACTATTCTAAGACTTCTTAGTCTTAGTCTAAAATAGTCTTAGATAAACTAAAGCCATTGTTATTAAGTACTCCATTTCTCAATACAAAGCGTAAAGAAGTTTTCTATATACCATATCCACATTCTTGATTGTTTGTGTCATCACTAATTTGTTTTTAGCAAGGTCATACAATATATAAAGGATGAATTCTGTGCACAACTTTGTTACATAACTCATTTTTGCCTAAATGCCTCTAAAACATTATTTGTGATATTTATCACATTGTGATCCTTGGAATAGTATAGTTAGTTTAATTTTCTGGATAATTTTGCTGATGCATAGATAATCCATAACAACATTAATGTACTACATAAAGATTTGTGCATGTGCCTATGTTCTTTCATAAAAGTGATATATGTCTGAACTAACATTGTGTTTCAAAAACTTTAAG
>TTN-213,,0,217,2722117,2722333,GTACAGTGGCTTTCGACGTAAAGCCCTATCTTTTATCTTTGATACAAAATATGTTGTGTTTAATTATCTGTTCATTGAGTTAGTTTAATTCTAAATGAATGTTTTGTGGTGAGAACTGAACAAAAGTGTCTGTCCACCCGTCTGCTTTCTTAAAAAAAATAACTGTGCATAGCTACTTTAGAAAATATAAAGTCAATTCTAAAAATGTCTCTTCAAG
>TTN-213,,0,141,2722334,2722474,GTACTTAATCCCATCTCCATGAAATAACCTTGTCTTTCCTTCAAGCCTCTTTAATTGCATGTCTTCTTTAATTGCCACTTCTATGTTGCTCATTTATTTGGCCTTTTTGACAAATTTTAAAATTCAATACTATCCTTTAAG
>TTN-213,,0,153,2722475,2722627,GTATTGTTTCTCCATCTTCCCAAGAACTGTCTTTATGTTCCAGTGATTTTGTTAGTTTTGTGATATGAGTGCACTGTGGGTGTATTTCTTTGTTTTGCACTGGGCTTCAATGAGATCACATTAAATTTCTAAAAGTGCATAATGTCTCTAAAG
>TTN-213,,0,274,2722628,2722901,GTAGGATTTGCCTCAATCCTCTGACAAAAAAAAAAAAAAAAAAAAAAAATCTTCGAGTGTGTTAAATTCTTGCTTTTTCCATCTGGTCTGTGCTTATACTGATCCATTGTCTCACTTGCAGTGAAACTTTTGTGTTTATGTCCTTGTGATATGTAACTTGTTTTCCCATTTTGCTAGTCAAAGTGGTGTACTGTGCAACTCTTCCCCAAATTCTAGAAAGTGAGAATTGTTAAAATTCTTGATTTTAAACTTCAACTTTAACACTTTCTTAAAG
>TTN-213,,0,452,2722902,2723353,GTATATAATCGGAAGTCAGGGGATAAATGAGTTTGTGTGTGTTTCCTCAAAGTCTCTTCTTCTTCCACATGTGATTGTTTACTTTAGAACATGTCCTCATCAGTTATTTCTCCTTATGTTGGTATTAGAATGTGTCTACCTTTTGTAGCCTTCTGGGACTGAGTCTTTTGTGTCTATGTTGGCCTTGAATCATTCGAAGGAAGTGGATGAGTCCCGAAAATGTTATAATTTTGAAAGTGGCCACACTTGGACATAACTCAAGTATCATTCTCAGTCTTGGGCTGTACTTGCCCTCATCTTAAATTAGCTTCCTCCTTCTTATAGTGAGGAAGTACCATGAAGCTATGTCCTAAGCAGATAGAAGAACAGTTATCCATCTGTAGTGACCACATGGCTGTATATACATCTGTATCTCAGCAGGCTGAATTTAAATGAAACCTTATCTTTTAAAG
>TTN-213,,0,2512,2723354,2725865,GTAAACAATGCAAATAAGCTAGAGATGATCTGGGGTTTTGATGAGGTGTTTTCTTTCACAAATTGTCTACAGACCAATGAAAAGAGACAGAAAAAAGTGACACAAATTCAGTGAACATCTACCAGTCTCATTAAATGAATATTTTGATCAAAACACAAGATTCAGGAGGATTATACTAGATTAGAGAAATCCAGTGTATTTCTTCTGCATCCCTTCTTACTTGCCTACATAGAATAAAAGAGGCTTCATATTTATATATAATTAATCAGGGCAGGTATCTCCATATACATATATCCTTTCATTAAACAGGACTTGGCTTCAGCATGGTGGGCTGGCATAAGCTTTACCTTAGTAGCCTAATGCCTAATTGGTGTTTCTCAAACATTGCTTGTACCACAATCCACAGACAGAAATATATTTTATATTATAATCCTTTAATTTTTTTATTCTAGGCATTTAAAAAATACAAGTTATAATCCATTAAGTCAATTGCAGAAGTCACTATAATGTCTTAAAATGTTTTAAAATGAGCAAGAAAATATATTACCTCATTACATTCCAGGAGTCAATGCCATATTTGTGAGTCTGAAGCCCTGAACACATAAGGCTTTCCTGTATTTTACATATGGAGAAAACCATTGTGTTATATATGGGATCAGACTGACTTGTTACTCAGATCTTTTCATACCTATAATGCTAATTATCTATAGTTTCTTAAGGACAGAACCAACAAACTATTCCATTGGGATATTTTTTCAATGAATTAAGGCAGCACCAGGTTTCCAACTAAAATCCAGCATTCTGGCTAGAGCCATGTGGCCAAAAGAACTTTCCTAAGAAAGTTCCTAAGGTCTGCTTTTAAAGAGAAATCAATAAGCTCCTTAACCAAACTAACTCTCTCCCCAGTGAGAAGATGAGTAGAATTGAAGTACATTTAGATGTCCCAAGTATCTGTTTTTATCTGTCTAATAAAAGATGGCACACCATGCCCCTTTTTTCACTTGGAACAAAAGCCCATGTAAAAATCCAAGGTGCCATAGTCTTAGTGGAATGCCTTGGAATAGGCCAAGATGGGACATGACTCCCAGGAGGAAATCCATTAACTCTGTTGTGCTTCCTGGAAGAGGCCATGATGGTGGACATAAGTCAGGAAGCTGGTAGATTTGAAGACGACTCCATCTTTTCTAAAAGTGTTTGTAAAACCAAACATAGTCTGATTTCAACTTTTGACACTATAAACTTCCTGTAGTACTCCAGACTCTAGTTAAAAGGAGAAACACTGTGATTATTTTTATGTTCTCATTATGCCCCAAAGATGGGTGGCTTGTTAGGTTTACTTTCAGCGTAAGGAGCAGATATGTTTTTAACCAGACACTTCTATTCCTTATTTAACTTTGACCAGGCATGGTGGCTCATGCCTATAATCCCAGTGCTTTGGGAGGCTGAGAAGGGAGGATTGCTTGAGCACAGGAGTTCAAGACCAGCCTATGCAACATAGCAAGCCCCATTCTACAAAAATTAAAAAAACAGCTAGGCATGGTGGCATGCACCTCTAGTCCCAGCTACTCAGGAGGCTGATGCAGGAGGATCATTTGAACCCAGGAGTTCGAGGTTACAGTGAGCTGTGATTACACCACTGCATTTTAGCCTGGGCAACAAAGCAAGACATTGTCTTAAAAAAAATTAAAACTGGCCGGGCGCGGTGGCTCACGCCTGTAATCCCAGCACTTTGGGAGGCCGAGGCGGGTGGATCACGAGGTCAGGAGATCGAGACCATCCCGGCTAAAACGGTGAAACCCCGTCTCTACTAAAAATACAAAAAATTAGCCGGGCGTAGTGGCGGGCGCCTGTAGTCCCAGCTACTTGGGAGGCTGAGGCAGGAGAATGGCGTGAACCCGGGAGGCGGAGCTTGCAGTGAGCCGAGATCCCGCCACTGCACTCCAGCCTGGGCGACAGAGCGAGACTCCGTCTCAAAAAAAAAAAAAAAAAAAAAAAAATTAAAACTGTATACACTTAGGCTCAAAAATCATGTGAAGCCTCCTGCCTCTTCTACCATACCTGCCCCACAAAACTGGCGGGGAAAACAATATGGAATATTATCTTACAATTCACTTAAATCCTCAAGTATGTTTCTGCCCTGTGGCCTTCAAATCTACAGTGCTCTGCTATTTGTGAAACTCATCTTCAAATTCTTCTGTTCTTATTAACTCAGCTATTATAATCGTTTCTTGTCCCGTACTTGTCCTGTCGTTGCTGTGGATATAAGCATTATTATCTGTATGACACATTTGAAAATTAAGTTAATGAAACCTATTTCCCATTTCCCATACTCTTCATTAACGCATGTGCTTTGATTAAAATGCTCTTTGAGTATTTTAAATAGGAACAAGCAGGGGTTTGGCAAGGGTTAAACTTTTGCTATTTTGATTACTCTTTGAAGTGATAAATTAAAGCTAAAAATAAACATGAAAAACACTGTAATTTATCTTCTTTAAAACTGCTGTCTTTAAAG
>TTN-213,,0,187,2725866,2726052,GTATGCTGACTCTTTAATTAGTTTTATCCCTATGTTAGCTTGTCTCCTTCTTTATGTTTCCTTATAGCTAATTTGTCATCCATATTGCAAATATTGATAAATATCATGTCTAATAAAAAGATCCCTTACACTTTTATCGAAAAGAAATCTAGACATTTCTACAAACATATTTTATAATCTTTTCAAG
>TTN-213,,0,263,2726053,2726315,GTATGATTTCTTTCAAAGAAATGCAACACTATTTATTTTAATGTATATAATAATACCTTCACATTTGCATAACTGTCTTATGCATAACAATTTGCATAACTGTCTACGTTTTGTCAGAACACATGTATGAACGTATTTACTGAGTATAGTCATTAACGTTTGTATATATGTGCAATCTTTTCAAAAAGTGAATGCTAAGCCCCACAACTGTGTCACTTCATATGTAAGGCAAACTCATATTCTTAAACCTAATCTTTCTAAAG
>TTN-213,,0,156,2726316,2726471,GTATATTGGATTTTATTTTATTCTCAAGACTGTCTTTTTTTAATCTTAAATTGATACATTCTTCAGATTTTTTAAACATTAACCAGAAAATAAGTGTGCCTGTGTTTAGTGTTTTCCATATCGTATGTTTGATGGTATTGCCTGGTATCTTTTAAG
>TTN-213,,0,252,2726472,2726723,GTAAACAAACCTCCCCAGCAGAAAAACTAGGAACATATGGCTTGTCTTTCTTTCTCTCTGCTGCTGTTCTTTGGGTCATACTGTTTATATGTTGGTGGGTGACAATGGTGTCTTTGGGTAGAGTATTACTTGTGATGTTTTTGTGTGTGTGCCTTGTAAATTCTTCTATTCTAAAATCACAGTACTTTCTGGCTAGTATATTTTTTACGTCCACTTTGATATAACTCCCTAATCCTAAAATTATCTTTTAAG
>TTN-213,,0,247,2726724,2726970,GTACATCCGCCCTTCCATTATGCACAATATTGTACTTGCCCTACTCTCTTTACCAAATACACTGGTTATGGGGGCTGGTTTTTGTTGTTGTTGTTGTTGTTGATGTTGTTGTTGTTGTTACAGTTGTTGTTTTATGTTTGAAATAATGAAAATGTCAAGTGTTTATGTTTGGGCTACTACTTTATGGCTGCCTTTTTGTGGTTTGAAAGAGGGAAACAATACTTTAAAGTGAAATCTCTCTTTAAAG
>TTN-213,,0,707,2726971,2727677,GTATACTGACTCTTAAAAAAAAAAAAAAAATCAAAATAAGCATCCAGACACTAAAACTAATCTAGTGGAATAGGTTCCATTAGAAAAAAAAAGACATAGTATAAAGTAAGCAATATAAGTTTGTTAATGCATATCACTTCAAAACTAAACATTTTTGATAACAGAAAGTACTTTTTTCTTAAAAAAAAGTGAGGCTTCTTCTAAACGTATGTGAATAATTTTCCTTAATCTGTATTTGTCTTCTAATGTCTTTTCCATATACTAAACTCATCTGCCTAGATGCTTGCTTTATGTGGCAATCTCTGATGAAATTTTTAATTTTTTCAATTCTGAATTTTCTACATTGTACCAATAGAGCTAAGGAAAATGTCTTAGAAGTGAGGTGAAGAAACTATTCATGTAACATAGGTTTCTGTCTAATGCTTCTACTTAGTTTGATAGTCATTATTTATGCTGTTTAGTTGTCTTTTTAAACTTTTATAAATACTACTTGATTTTCCTAAAATTATTCAATGTCTTTGACGTACTTCATATGTATATTAGAGTAAGTTTATTTCCAAGTCTATTGATTTTCTTGCTTTTTAAATGAAAGTTTAATCAGGCACTGTTATGGTTGTCTTTGTCCTTGAATTGTTTGAACAAAATTTCTCTTCACACACACATTTTCAGAATCTTGCAATTCACTTTTAATAATTACTCCTTTAAAG
>TTN-213,,0,307,2727678,2727984,GTATATTGAACTTTGATTAAGTAATGTGAGGCATGAAACTATCTGGCTCTTTGCCTTCTAGTTCCCAATCTGACTCCTATACTTTATTAGCTTATTGTTGATTAAGGGCAGGGTATATAACATTTGAAATCACAATTGCTAAATATACTCTATGATACCTTGACTGGCCAAAAAAGAACAGTCAGGGTCTCCCATAATCAGTGCATGAAACAAACGCAAAAGAATAAAATCAAAGCACATTGTTACTATCAGTCATCCTTAAAAGTGCTTTAAAGTAAAGTGCTGCCTGTTGTTAATATTGTTTCAG
>TTN-213,,0,958,2727985,2728942,GTATGAGCAAAACTGCAAACTCAAAACCACACTAAATATGTGCACACTCAAACAAGATAAAACAAGATAAATCATAACAAGATAAAAATTTGGATACCCAAAGAAATTTGGAAAGAACTTTGTTTCATTTCGCAAATGCGGAATTTTCTTCTTTGATAACTTCTAGAAAAAATTTTAAAAACCCTCTATAAATCTTAAGGTTATTGTTAGACTTTTGTTCCGGGAATAATCTAATACCCCCCTCATTTTTGCTCGTATGCAAAATAGCAAATGTCCCTAAGTTTCTTTTTCAAAAAGGTTACAAGTTTATCTTCAAGTGCCCGTGATCATTCTAGTACATGGTTAAAAATTTCTGAACATCCTTTATTCTAAAACTTGCTATTACGGAGTATGATAGGCTATTGAGAAAATGTATTTACCCACAGGGTTCCCATTATCAAAACTTGACAATGACTGCTTCAAAAGTTAAGATAGAGATGTAAGCTAACACAAGCTGTTGTGTTTTACCTAATGAAGGTCAAATTTGTTGGCATATAGTTTGGGCTTCAAATTGTTTATTTTACTCAAAGAATAAATCTCTATTGAAATTTTGAAATGAATCAATCTTATTTCACTTATTCAGTCTCTGATGTTTCATAGCCCAACTTTGAGAACATTCTACATAGTCTTACTGATAGCTTTAAAAAAACCATATTATAGGGGAGTTTCAGCCAGGAATTTATCTACCTGAAATGAAATGAGAATTTTAATATGTAAGAATTACCTAATTAAAGAAAATAGCAAGAAGGAAAGGGCAATATGAGCTTGTTCTGCTTGGATCTCTGATTCTTGCCTACTTCAATAGGCTATGGCTATACTGTAGATAAAAGATATTATTTCAATTATTTGATTCCTTTTAAGAAATGTTTAAACTTATATTCTAAGTCTAACATGAAATACCTTGTATGTACTTTTAAAG
>TTN-213,,0,210,2728943,2729152,GTAGAGTGAAAAAAACATTATTACCTGTAAGAGATCTTTGTTTCCTCCATGTCTGTCCTACTATAAAAATATATGTAAAAGTGGCAGTGTACAAATTATGTGTGTGTTTGGGAATATTATGTTGTATTTGTCTTTCTTAACTTTTTGTTCTTGCTAGCCTTGAGAAACCTGTTTCAATTTTTAAAATCTCTTAATATTGATATTTTGAAG
>TTN-213,,0,204,2729153,2729356,GTACATTACTGAGTAATAATCACCAAAAACAACTTTGTTATGTATGTTCTAAAATCATGTCTTCCTAGCCCGTCTGATGGTCTGTGTTTTTGCTGAGTAGGATGTTCTTGTCCTGATTCTTACATTTCAGTTTTTTATGTGTATTTATTACATAGTATTCAAGGAGTTGGTTTTAATGCTCTTTAATAATTAATATCTTTAAAG
>TTN-213,,0,747,2729357,2730103,GTATAATGATTTCCTTCCTCGATTGTGATCTTTTCTGATGCCTCTTTTGAAATTAATGTAACTATGATTCATTTCATTTTGTTGTTTCATGTCTTTTAAATTAGTTGTCAGCAGAATGTTGGATGTAAAAATGTGTAAATACAGGATAAGAAGATAATGCCTTTAAAAGGAAAAATTATTTCTAAATACATCCATAGCCTGTTAGCCAGTGGCTGTGTCCTGCCACATGGCTACAATACATATAAAATAGAATGTTTGGGTTTAAAATCAGTGACCGTTTGGCATATTCCTGATTTACCTAAATGATGTAATGATACCATAATATTCACCAAGCTTTGGTAACTGTTTATTCATTCTAAATTCATTTTGAAGATTTTTTTTAAAGCTAACCAGTTTCCAGTCATTTTCCCCCTGATTCATACTAAGTATGAAGTATACTAATTGAGAAGTAAATTTCACTTTTCAGGAAGGATATTTCTTTCAAGCAGAGATATTTGAACACTAAACCTCATTTCACATTTGGGCTCTGCTACTTCATGTTTACTTGGGTACTTCTGTGTACTTGTATTTATATGAAGCTCAGAATCCTTTCCACAGAGAGTATATAGTTTCTTAAAGATGAACAATCGCATATGTATCTCATTAAAGGAAGATACATTATTCTATCTGCTTAAAGTACAGCAAAACAAGCATTGGCTGGGTGGCCTTTTACTGACAATAAAATTTCCTTATACTTCATATTTCAAG
>TTN-213,,0,198,2730104,2730301,GTACCTAATGGCACTCATTTTAATGTTTTGTTCGTCTTTTGCTGTTGAATTCCTCTTCAGTTCTGTGTGTGAAAACTTCTTTTGTGGGAAAAGTAAATCTTGTCCTTTCTTCTGTTATAAATGGGCCTGTGTTTCTAAGGTGTCTTAATTTTGTTGAGTCATTGGCAAATGTCCAACTTAAAGATAATATCTTTAAAG
>TTN-213,,0,211,2730302,2730512,GTAGATGATGCCTCCTGCAAAGGGCTGTGCAACAGCATCTTTGGAGTTTGGGGGTCTGATTTGGTCAGATTCTGGGGGTTATTGGCAGCACCAATGATTGCTTACTTTAAAGCAGATATTTTTAGATGCTGAAATATGATTTCTACAGGTGCTTTTCACATTTTATTTCTTTCCTGCAAAATTTCCAACATTCTTAATAATATCTTTAAAG
>TTN-213,,0,182,2730513,2730694,GTACACCACCATTCATTGACGGGTATCTAAGAGACTTCATCTGCCTAGAAATAGTTAACTTTCTTCTGAGTTCAAAACCTTGTGTGTGTGTCACTGTCCGTTGTTAAAAAACATTAGCTGTGTTTTATATGGATGTGTTGTTACTAGTAGTTAGAACTTAACAATAAACAATATCTTTAAAG
>TTN-213,,0,508,2730695,2731202,GTACATCCTTATAATCCATCAGTGGAATAGCATGATAATTCACCCATGCAGCATAACTTGGTGAGCCATAGCAGATCTTTCCCCATGACAATATTAACAACATTAATGCCATGACAAGCGCCTCTCAACTGGCCACAGGAGCAGTTTACCCGGTATTCATCTCTGAATTTTACCATCAAATTATGCTTATGCTCAATGGTTGGCTCCTCCTCTTTAGTGGAAAGTTCTTCAAGTAAAATACATTCCTTTTGCATATCAAAATGGACAAAACCATCATTTACCAGGCATTGTGTCTTGTCTTTATCACCAGTCCACGTTTTTTTCGGTGTTTTTTATTTTAATTTTTGTGTATTTTCTGGCCTTTGTTTTGTGGCTATTATAATTTTCAGTCTTAAAGTGAAATTGATAGAATATCTATGCTGCTTCAGTTAAGGCCTTACATTGCCAGCCTTAAAATCTTAGCTATGGGTAAAAAATGTGACACTAACTCTATTTGATATCTTTGAAG
>TTN-213,,0,249,2731203,2731451,GTACATGAACTTGCAATGTTGCAATATTTTTATTTCACATTTGCATATGGGTAAAAATTAATTGGTTTAATTCTGTACTCTTTGGGATGCAACTCTTTAGAGAAAATTAAATATTTTATTTTAAAAATAAAATGCTTCTTGGAATACCTTTGTCATACTTTTATTACCTTATCTTAATCTTTTGAAACTATGCTTGGAATCAGTATTTTTATGTCGTATAAAATTTTTCTCTAAATCATTTCGTTAAAG
>TTN-213,,0,205,2731452,2731656,GTACATAATTTCATCACTTAGAGTACTTGGGGGAAAAAACTCACATCTATGTATACTCACATACAAATTTCCCCATTACATTGTACATTTTTAAAGTGTCTATCTGGTTAGAAATATGTCAGATATTTTGTGATTCTTTTTCATATCTATTGCTCTAAGACATTTTAAAAGAACATATTCCTAAATATAAATAATATCTTTAAAG
>TTN-213,,0,207,2731657,2731863,GTACATTAATCTGTAACAGAGCCATGGTAAAAGACAAAACTAACTGGTGTTATACAGCCTTACTAATTATAATTAATGCTTAGTATTTATGTTGATAATAATTGATGCTTTGTGATCACAGAATATTTGCCTTTCATAAGCTTCTTCATTGTTGTGAATATTTTACATAAAAGTGATGTTTGTACCCTTGAATAAATATCTTTAAAG
>TTN-213,,0,333,2731864,2732196,GTATAGCAGCTCTTCTTGGAATCATCAAGGCCTCTTTTGTGTTGAATTCTGCTTTCCCATCCTTTTGTTCATCTCCAGTTTTATCTATAATCCTTTACCCTCTGTGATTGACCACCTAAATCTTAGAAAACATTCCAGACATGTGTGTTCTTATTGTGTATCTGCCTTGTGTATCTGTCTATTGTAAATTATCTAAATGTCTTTTCAAATCACATATTATGTTTACATGTTTGTGGTCTTATCCTCACGTGTCTCTTTCATATATATATATATATATATATATATGACCATGTATATGTGGTTTTTAATGCCTTCAAATGAAATGTTTTTAAG
>TTN-213,,0,1205,2732197,2733401,GTACACCTCCCCAAAGTGAATACACATTGTTCACCCATAGCTTGGTCACATAAATTATGATGAAACTGGGTTTTAGGAAAATTATATTTACAAAATGGATAATCACACAGTTACATATTTACTTCTAACGATGTTCAGGAACACTGATATCTACTTTTTTCACTGATACAAAGCAGTATTCAAGAACAAAGATGAAAGGAAGCATTGTCCCAGAACTGATACAAAAGTTCTGATTTCATATCATTTGATTAAACATCATAGTTTTCATGGAGATATATTTAAATATATATGAATAAGTATACTATATATTTAAATGTATTGAAAACTATTATGAATAAATATTCTTAAATTTCTTCCTTCAACCATTTATATTAAATGCCTTTTTAACACCAGGCTAAAAAGAAAAAAAGATGAATGTATTTATCAAAACACAGAATAATAGTTATGTCTTCTAATACATATATATAAAGGGCAGCCCAACAGGTTTTGATTTTAGCGTTGACTTTACACCTTGTTGTATTACTCTCAGCGAGTCCTTTAACCAACCTGAGCCTGAAGTTATTTTCCTGTAAATTGGGGATGCTAATATCAGTCTTAATGGGCTCAGCTATTATGGTGAGAATTAAATAAAGTAAGGTATTAAAGTAGTCTATCATTGAATGAATAGTATCCAGATTTAACATATTCAATCAGCTCATAGTACAGGACAGAATTAATATATTTGTGCTTTAAAGCTCAATAATATTTTCTACAAAAGATGCTGGCATGGCTGCTTAAAATCAGCATAACCCTCGCATCAGGCCATATAGTTATATAATCAAATGAAATAGTAAAGCTGATCTTTTATTGGATATCAACGATTCAGAAATACTTTCTAGACAATAAATTACTAGTGAAATTTAAATGTATGAAATGATATTAGGTTGGTGCAAAAGTAATTGCGGTTTTTAGCATTAAAAGTAATGTCAAAACCGCAATTATTTTTGCACCACCCTAATAGCATCTGTCCTCTGATAATGACATATGCTGCTGGTCCCTTGCTTTACAAATCCCAATTACATTATAATATCTGGGCTCCCAACTAACATGACAGACCTGTCTTGAGCGACTGTTAACACATTGGTCTTTCTGGGTGTGGGGTCTTCTTGGTTTCTCTTTTTTTGTCCTTCAAAATAAATCCTTATCATGAAATGATGTCTTTAAAG
>TTN-213,,0,166,2733402,2733567,GTATTGCTATTCCGAAGTAAATTAGACTATGCCATTTCCTTCCTTCTCCTATAAAAGTCAAAATGTCCTGTTTCCGTATTTGTTAATACAACTTATATTACTGCTGTGTCTACTTGTCTTTGTGTGTGTGAAACTGAACTTATAAAATAAAATAATATTTTTAAAG
>TTN-213,,0,557,2733568,2734124,GTACATCATCCCATAACAGGGATATGTTTGCTGCACCGATGTTGAACTGTGGTTCTATCCACACAGGACACTCAACATAAATGTGTGCATTGTATGGTCTGTCATTCACATTCGTCATTTCTGACTCTTTTGCACCCAAGTTTGTGTTGTGTCCATTTTTTCACTTGGTGTTGGTGTGCTTTACATCGTTTCTCTATGTATGTTGTTTCTAAAAAATAAAAATATATCTTTAAAGAGCCAAAAATAACTAAGGAACTAGTCCCTGAAATACCCATTTCTTCATACCCATTTCTTCCTACAAAAAAAAAAAAGACAAAAGAAAAAAGAAATAGAGGCTCCAGCAGTAAAAAGTAGAATTTCTCTTTAATAAACCCTAAATCTTAAACCACAAACCTTTTTATTCTTTTCTCATTAACCGATTCTGTGAAATGTCAATGTTTCATCTTGTGTATGTGCCTTGTGATATTTACTCTCTTATGTTGGAAACTGGAAACGTGGTCTTTATTCTTCTTTGGTTCTTGCATTTTAAGTGTCTAAAATAATCAATGTCTCTCAAG
>TTN-213,,0,629,2734125,2734753,GTAGATAACTTTCTAAGAAAATAACATTTCAAAGTCATCCTTGTCTTATTATTGTCTAATATTTGAAGTAGGTAAATGTAAAATTTACCCCAGGAAATCAACATATTCAGATTCTAAAATAAATTATTATTAACCTAATAGAAATTGGGCAGGCAAATTAATATTATTTGAATCTCTTTGCATGTTCAGCCTGTTTGTCTGTTTGCTATTTGTTTTATTTTAATTAGAATTCATGAAGGGAAACTGTATTTGCTGTGGGAAATTTTTCATCAAATGACTTAGTAGGCAACTGTAAAATAAGCTTATCCAAGAGAAATTCCAGTTAAGCCTGAGTAACTGGTGCAGAAAATCTGATTTCTACCCCAAGTGGCTGTTTGACTTCAAACAAGTCTTTCATTAAAAAAAAAACAATAATAATTTTTTTATTATTATAAATTATCTGAAGTCCTTTCCAGTTCACAAATGCTGGGATATGCCTAACATATTTTGAAGACCCAGTAGAGATTTTTTAAGGACTAGTGAGTTTACACAAGCGTTTCGAAGGCTGAGCAGTTTTCAGATATTATCACTGTAGTCTAATATTCAAAATAATTATAAAAATAATTTACAAAATAATAATCTTTTTAAAG
>TTN-213,,0,603,2734754,2735356,GTATAACCGCTTTTAAGGATTGAACATTTAAAATTCCTGGTGTTCCAAATCTTTCTCAGTAGCTAAATCTAAGATTCACCAGTATGCTTTTCTTATATCGTATCCATGATAAAGTGAAGATTAATTATTCCTGGCACCTGAATCTATGTGTCCTTTTTTTACCCTAAATTTTTCTACAACATCTGCAATACAACTAAGAATGAGAGATTACTATTTTGTTATTGGCGATTGAATTTTTTTCTGACCAGGCCCTACTATAATAGTTTCTCCTAGATTTCAATCCTTAATTTTGTTTTTAATATTAATATGGGGGGAATCTATTTCTCTGGTGAAAGTGTTCATTTTTTAAGAAAAATCTTTAATTTACTATTCCTGAAGAGTGTGATAATATTTTGCATAATTGGTATTACATTTGCTTATAGGATTTCTAAGTAATATCCTTTACACCTCTAGGGTTCCTACTCCACATTTATTATTACCATTTAGGTTGCTAATATCTTTTAAAAATAAGTCAATGTTTTGTGATATTTATTTATTGGTATATGGGTGGTGTTCTGCTCATCACATGCCACTTTTCAAAATGTTCATAAAATTTCTTTTAAG
>TTN-213,,0,929,2735357,2736285,GTATATCAAATCCTCATTATTAATATCTTTAACTTCCCATTAATTTTCTTTCTTAAAAGCAACATTTTCTTTTTTGACTGCCTTCTTATAATCATTTAGATAGTGAACTGATTAAGGACCAGTAAAAATATAACTCATTCCATTTCTTTAATCTTTTCTAGGATGTTAACGAATAATTGTGTGCATGTGTTTACGTATGAATTATTCTAGAAGCTTCTTAACTGAGAATTTTAATATATTAGTATGTCTCTATATACTTATACACATAGCAATGGATCCCTCTTCCCCACATTTTAGATTTTATTCCATAAGTGGAACGGAGTTTTCTTCTGTGTTATAATAATTATTTTACTATATTTATTATTTTATGGAACAAACCTAATGCTTGGATAATAACTATTTTAAAGAGCCTCACGTCCCTTTTGTAATGTTTAGCCCAAGCATTCAAGGTTATTACAAAATGTCTACTTTTCCCTGCTTCCTAATTCACTTAATGCTTCAGACAGTGCTCTTAAGCAGTTAGATTATGCTGTCCCTGTCATAGTAGACTCCTCAGCTAATAGAAGAGTGCACAGCAGAAAGTGAGGCCAGTGTCAGGGCTTAAATACTCTACAATGGTAATCACTTCAAAAAAGTCTTCATCAAGTTAAAAATAGTAAAAGTGAGTCCATATTGGTAATCCCTGTTATTAAAAGAAAAAAAAAAGAATGGCACAGGTACTTTGTGGACATTTCTTCTTCTATAGGAATGTTAGAACAAATGAGTGATTTGAGAAAGTATCTTTATTGCCTCTAAAATGGATGTCCCACAGTACAGAGTGACTTCTGAAAAACTTTAATTATTGTAATGTTGGCGTTGTCTCTGGTGTTTTTATTTCATGTGTGTTATTGAACATTCTCAGCTAACTAAAACACCTAATATCTTTAAAG
>TTN-213,,0,153,2736286,2736438,GTACATCTTCTCTTTTAAACCTGACTTCCTCTTCTGTCTTTTTTCGTTAAGACTTTTATGTTTCATGTCTCTGTGTCTTGATTGTTTTTGATGATTTTTGTCTATGAAAGCTTGCTCTCGACAGTCCTAAATATTAAAACTGTATCTTTAAAG
>TTN-213,,0,139,2736439,2736577,GTATTTTTGGAAAGATCCTGGATTTTCGTGTATTGTTGCATGCAATCCTTTATTCAGTTTTAAAAATATATATTTTGAATGTACATCTTTATTTCTTCAGTGTTTAAAAAAATAAGTCTTAAAATAGATGCTCTTTCAG
>TTN-213,,0,800,2736578,2737377,GTATAGGGAATTCTTCAAATACTACAAATTCTTATATCTTGCTCTAACTTTCCTTTGAAAGTAAATTTTGTGTTCAGTTTGGAAGATTAGAAACCCCATGAAATACTTTAAACATGAGTTTAAACTAGTTGACACAAAGATTAATATCTCTTAACCACACGGAGTATAATTTTAGTAGATGATAGTAATATTTGATATCTACTTATCTAAGGAGGTCACTGTATGAATTTGGGGATTATTTTTTAAATCTGACTAAGAATGTTACACAATTGTTACAGGTACCAAAATAACTGACCAGTGTCATTGGTTAAGTGAAAAAGAAACTCCTCAGTTCACTGAGGAATTTACATGTTCAGGCAAAATAATCACTGCTTTAACATTTTAGTCAACTGTTCACAAACTGAGAAATACTTACCAAAAGCTTTTGCCAGTTTATGATACTTTCATTAGAGAAACAACATTAAGGAAGTGAAGTATTGTTAATGGCACCTGTATTCTAGCATACTGTGAAGACAAGCCATAGCACAAATAAGTTATCTGCAATACCACTCTAGATCTTGCACAAATTAACAATATATGTGTAATATGAAGGAATGTGTGTGTGTGTGTGTTTAGCATATATAGCAAATTACAATATACATGATATTTAGCAAATCAAATCTCTTTTGGAAATAAGTGTGTTATAAATTAAAAAAATATAGATAAAGAATTTTGTGACCCCTCATTGTACTAACGTTAGTAGTAGTGCTCCAAAATACTTCAAGAGTTCATTCTAAACCAAAATACTAATATCTTTGAAG
>TTN-213,,0,794,2737378,2738171,GTATCTTCTTTGTGAAAAATTACTACTTAACTTTACATACAATAGCACCTTGGTTGCTTTATAAGCACAAGTTTGCATTCCACTTGATGTCTTTCTTCTGTATTTCTTGTTTCTGACATGTCTAAAACAAACTAATATCTTTAAAGCAGCTGAGGGTCCAAGGGAAGTTCTACCAAAAAAAGACAGTCACTGTTGTTATACCTAAAACAACCAAAGCAAATATCTCTAGTAACCAAATAGTGAGCCCAAATTTCCTCCTTTGGTGCTATTTGGTTATATATTCACTAACATGCTTACTGATAAACACATGTTTTTCTATTTATTATTAATTATATTAACCTGGCAAATATAAATACATAGTGAATATGTGTTTAATGTTCTTGCTTTGTTCATTTTTGCAAATCTCTTAAATTTCACAATAGAAATAAAAACAGTATCTAATAAATAATATAAACTTATTTCTTTAAAGTCTCTGAAGCATGTGCGTAAGTTATCACTGAAGAGAAGGTAGCAACTCTTCCACAAAAACAAACAGTAATAGCACCAGCTGAAGGTGTACTGTTAATTTTTCTTCTCAAGTTCTTACCATTCTAACATGGGAAATTTCCCTGGATTTTTGTTATTATATATTTTTTAAATTCAATGCATTTGAAATACTGTAATGTATTTGATAAAGTGTTGTCTGCATTTTATATTGTTGCTGTGTTCTGTTCTGTGTTTATATCTCTCATGCTCTGCTTGTTAAAAAATTGTATATTTAAAAATAAAAGAAATTATTACTATTATCTTTAAAG
>TTN-213,,0,542,2738172,2738713,GTAACTGGCTTTTCTCATTCATCATTAATATAAAATCCTTTTTTATTCACTTACTATGTAAGAGAGACCTTTCTCTTCTCAATGCCACAAGATGGCTATGAATGACATAAACTTCAATTTATGTTCTATAACATAATCCTGCCTTTTGAGGCAATGTTTTAGGCGTAAAGACATAAGCCCAAAGTTATCATTTGTATTGATCCTCTTATTTAATAACTAAATAATATTGATCCCTCAACTTCTCTTTCAAAAATAATTCATTTTGGAAGCTCTTCTGAAGTAGCTCTGGAAAAAAAAAAGTGTGCTCTAAATGGCAATAGAAAATGATACTATCTCCAAAGAGCAAAGTGTTTCTGATATAATGAATCAAGAACTCATCGACAAAGCAATTCAGAGAAATGCAATGACTACATTTGACTTATAGTTGACTTATAATTGAGGGGTTTTTGGCGTTCATCTTGTTAGATGCCCCTTCTAGGCTTGCTATGTTTACACCCAACTATAATGTTCTGAAAAAATAAGATAAATAAATATCTTTAAAG
>TTN-213,,0,144,2738714,2738857,GTATACAGTGATGCTAATCAGAACATGAAATAATTCTTGGTTTAGTTTTTCATGGTTTAAAGTGAATGTGTGTGACATTAAATCCTTGTATTTCGTATCTTATATTTGTTATCTGTAACAATTAATATACTAATATCTTTAAAG
>TTN-213,,0,1651,2738858,2740508,GTGAGTGTAGAAAAATTAGTGGTTCTTTTTCGTTTCATTTATGTCCTTAAATTCACTATGTTTGTCTTTTTAGCTTTGAAAAGTAAATATACTAAACTCTTATAAAAGCCTAACATGCCACAAATATATGACTCAAATAATCTTAGTGTCTATTATCCTCAGACAAGTTATATTTCCTCACCAATTTAAAAAAGAAATACTCTACTTATCAGAGTGTATGATTTCAGAAAAGTCAGTTGTCTTGTTAAATTTTCCTAACCTATTCTGTATACAAGTGTCTTTTGCTTTGAAGCAATTTATTTTCTCAGATCATGAAGTAACTTAACTCCATAATATTTTAATTGGATTTTATAAAATCAAAATGTTTCACCATTATTTTTTTTTTTACTCTTGATAACCATAATTGGAAACATTTTGGCAAAACTGCTCAAAGGACCCTAGGTTTACAAGGCCACTCAAACCTCAAAAGAATTCTCACGACCTTTTTTTTTGGGGGGGGGTTTCATACAAAATTAGGTTTAAATAATTTGAATTATGAAATAATCCAAATAGTAAAATATTGTGAATAGAATACTGTTCAACAACCTGAATAGTAAAAGTGACAGTAGTCAAAATATTCTTCCTTTTTTTTTTTTTTTTGAGATGGAATCTCACTCTGCTGCACCCAGGCTGCAGTGCAGTGGCACGATCTTGGCTCACTGCAACCTCCGTCTCCTGGGTTCAAGCTATTCTCCTGCCCCAGCCTCCCGAGTGGCTGGGATTACAGGTGCCTACCACCAGGCCCGGCTAATTTTGTGTATTTTTAGTAGAGACAGGGTTTTACCATGTTGGTCAGGCTGGTCTCAAACTCCTGACCTCAGGTGACCCGCCCACCTCAGCCTCCCAAAGTGCTGGGATTACAGGCATGAGCCACTACACCAGACCCGCTTCCATTTTTTTTAATCTAAAAAATTTCCTGTTGAAACTCAACTTTCTTGTTGTTCATCCTGTTATACTAAGTTGGGATAAAATAATATAATCACTTCCTCCTTTGAATATCCTTTCTATTCTTGACTTTAGTTATTGTTTTCAGACAGTTTTTCTTTCTAAAGGCTGGAGAAATTTTTGTTGTCTTTATTTGCCTTATTTTCTAAGTATTTAATTTTTTTAATTTTCTGCCTCCAAACCCTAAATGGCTTTTACATTCATATTAAACTGTGAAACCATATATTAGATGTGATTTGAAAATATAGATAATGAGGCTTCTAGAAAGGGAAAAGACTTACATGAATTTCTAGTAGGTCAAATATCGGAGAATTCTCAATGTGCAATTCAGCATCTTCCCTGTTCTTTATAGACAAATCCATTAAAAATAAGACCAATAGGACAATTTTACCAATAACTTTCTTAAGGCAAAATGAAGAATTATATAGTCCTTGCCTGAACAATTCCTCCATTTTATTATCATCATCATAGAGAAATGCTTAGAGTCTTACATCATGAAACTGGGAGTGAGGCTATCCCCAGCCAATGCATTCTAGCCACTAATTTGCCTCTATGTGCTACTATTAATTTTGGTGATGAATGTGGTATTATATATTATATTTTTCTTAATACACTTCTTTATCCACCTTGAAACATCCTAATTATTTAAATACTAATATCTTTAAAG
>TTN-213,,0,112,2740509,2740620,GTATATAACACCAATGATCCACTCTGAAGAAAAATTATTTTTTGGCCCCTTTTAAAAAGCTCAATATTTTTCTTCACCATTTATAAATATAACTATACTCATATCTTTTAAG
>TTN-213,,0,122,2740621,2740742,GTATATTTCAAATACATCAAACCCAGATGAGTATCTTTAGCTTTATGACTCAAACATTGCATGCTTTTTATAATTTACTGTTTTTACAACTTTTAAATGTAAACCTACTAATATCTTTAAAG
>TTN-213,,0,334,2740743,2741076,GTATAATTCTCTAGTTAGGAAAATCTAAAGAAGAAAATATACTGTCTTCAGTCTGCAAAATATTTAATGTTTAATATACATTCTCACAACCTCTAATGTTAAAATACTGTGTTTAAAGGATCTGATATACCCACAACAAAGAATGACCTATGACTTGCCCCCAAGAAAGTCAAGTCCCACACATATAATATACAAAGATAAAATATTAGAACAAAAATAACATTTCTAACATAAAGATATCTGAAATGATATTAACATATCTAACTTTCTTAGTATGTCATGTCTTTATGCCTTTGCCTTTTCTCAATTAAAAAAAATACTAATATCTTTAAAG
>TTN-213,,0,1032,2741077,2742108,GTACAAGTTGGAAGAAAGTCACCTTTTTAATCTCATGTTTGCAGTTGTACTTAACACATGTAAAAATACTAATATCTTTTAAGCCAAAGTGGCTACAGTGGAAATCATTTCAGAGATGGATCCCCCAAGTAGAAGCTCAACCAAATGTATTCATGTCCCAGTGAGTCACTCAAGAGACAACAGAGGGAAAAAATACCTTTAGCTTATACACATGAAAGATAGTTGAGTCAGTGTATTTTTATGAGGACTCCAAAGAAAATATATATACACATATTATGATCAAAACATGTCTTAAAGAAAATATTAATTCAGTGTGAAGCTGATCTGTAATATCTCTACAAGATTAGAGCACCTGAGACCCTCCCAGAATATCCTCCAACCTAGGGAAAAATAATTCCAGTTAAAGCTGGAAATCTCCCCTCCATGTTCATTTGCTCCTCTCATAGCCTATCTTTTATTTTTCAAGCATCATTTTTTTTCATTTTGAATATCTTTAGATAAGTCAAAACATGAAAAAGCTTTAAAACCTCCAGAACAATAATTTCATCATAACACCCATGGTATTCTGTAATTTGAAGAATATCTGAATATTTTGATATTTTTTCTCAGTCTGGAATCTTTTGGTTGTTCTCCTCTCTCCTAAACTTGAAAAACACTCACCTTTTTAAGGTGCCTGAGGTGTGAATACAAAAAAATGCCGACCTAGATTTTTCGAAGTGGCTGTAATTTGTTTTTCTCAACATAATAGCTAGAGGTATAGCATTAATTATAATCAATGTTTCCACTTTCCATGATCTAGTTTTCTATGCATCTACCATTCCAAGAAATAAAATTACTAATACTGATAGTGCCTGAGGTGACCAAGAAAACAGCCGCTTATAACCAAATACTCACACTGCTACAAAAGATCCGATTCTGGGGGCGGGGAGTGGGAGAAGGTTCCCATCTGGAATGTTCTGTATGTGCAGTTAAGATGGGAACTCTTTACTCCTCTTCATAACTCCAAAGTACAATGCATTCATATCTTTAAAG
>TTN-213,,0,247,2742109,2742355,GTATCGTTCATCCTGCCATTCCTTCCTTCATTTATTAGAGTGCTTAGCATGTACAGGGTGCTAGGGAACTGGAGAATAATAAACAAAGACAATTAATATGTGGTTCCTCTCCTCAAGATTGTATACCTCCTCAGATTCTTTAAAGGAATCATCTTTTTAGCCATAAATATCACTTTGGTTCAGCTCATTTAATTAATGTCTCCACTGATCCTTTTAACCTCTAACCATAATACTAATATCTTCAAAG
>TTN-213,,0,450,2742356,2742805,GTACGTTACCTCTGAACAAATGTGGAAGAAGAAATTATCTGTCCTCTGCTCTTAAAACTATGGTTTCTTCCTAATACTCTTCATAAATTCTAAATATAAACATACTAATATCTTTTAAGTGTCTGAGGTTCCACAGGAAGTTTCCTCTAAAAAGAAATTATTTATGGCTGTTTCTGCCAAAACAGAAAACACTCCTGCTGGAAGTATTCATTCAACAAATCCTTTATAATGAGAGTGTAGAGTGTCGCGAGAGCTCTGTGAGGTTCTGGAGGAGGGGGAGCACCTCCTCTCAAGGATCCACTAACCCCTTAAAAGACTTAGCCTATTGGTGGAACAAAGGGAGGATGGAGGAAAGAGAAGAAAATGTGGTTATATTTCCTAACTTATTGTGGTTACTGTTTTCCATTAATCATTTTAACTCTTAAATGTGAATTGCTAATATCTTTCAAG
>TTN-213,,0,114,2742806,2742919,GTACAAGTCACCATGCTCTCAGGGTCAAGAACTAGCTCTTGTAGTTTTGAGAATATTTTTGCTATTCCTAGTTATCTGCATAACACTAAACATAAAACTACTAATTTCTTAAAG
>TTN-213,,0,116,2742920,2743035,GTATATCTTGCTGGAAGCTTAGAGGGGTGGGAACATGTCTTTTCTTGTATAAATGTTTTTCCTGATTGTGTTGATTCTTGTAACTTCTAAATGTAAAATTATTAATATCTTCAAAG
>TTN-213,,0,361,2743036,2743396,GTACATTCTTAACTGTCTTTTTATGGTGGGATAGTGGGTGGGGCGATAGAAAGGACCACCTTTCTAGTTTTGAAAATTATTTTGATGTGTACATGTGAATCATGTCTGTGTTGACTCTTGCAACTCAAGTGTAAATGTATTAATATCTTCAAACTGCCTGAAGCTCCCAAAGAAATGGCTACCAAAAAGAAAATACCGGAAGTTCCTCCTCTAAAACCTGAAACACCACCTATTATGGGAACTTGTTACCACTGATCTCAGCTCAGGAGAAAAAAATAGCTCTTTTGTTCTTGAAAATGTCTTTGTATCTATCTAGTAATCTCTGTATTTTCTGAGTGTAAAAATACTAATATCTTTCAAG
>TTN-213,,0,112,2743397,2743508,GTATTTGTCACTGACTTTAGGCTTCAGAAGACCTAATTCTTCTGCTCTTGACAATATTTTTTTCTAGCGGTCTTCATAACACCTAAATGTAATTTCACTAATATCTTTCAAG
>TTN-213,,0,108,2743509,2743616,GTAGTTGCCACTGACCTTAGGCTTCAGATCTCATTCTTTTGCTCTTGAAGATATTTTTTCCAGTGGTCTTCATAACTTCTGAATGTAATTTTGCTAATATCTTTTAAG
>TTN-213,,0,110,2743617,2743726,GTATTTGTCACTGATTTTAGGCTTCAGATGATGTATCTCTTCTGCTCTGGAAAATATTTTTCTAGTGGTCTTCATAATGCCTAAATGTAATTTCACTAATATCTTTCAAG
>TTN-213,,0,83,2743727,2743809,GTAGACACCCTCTTGTTGCTGTGTTTGATATTGTTTGTTTGTCTTTACTTTGTCTAATAATGAAAATACTAATATCTTTAAAG
>TTN-213,,0,210,2743810,2744019,GTAATGCCAAAGCTATACAAACTATAGGAGAAAAATAACTGTTATTTTAACTAGGAAATTACATGTTAAAAATCCTACTACATAAAGATGATATAATTCTAAAGAAAACAAATGTCAATCGCTATCCAAAATATCTTGGTGGGTGTTTATATGCAAAAGGCATCCATCATTTTCACCTTTTCTAAACACAAATTACAAATATCTTTGAAG
>TTN-213,,0,153,2744020,2744172,GTAGGTATCATTACACATTGTCAGTCGGGGGGCCCTGGGGAAAGACTGCATAGAAGTGTCCGCCGATCTCACAAGTTGTATTTGCTTGGGTAAATGTGGAGTCGATATTCCCCCTTTATAGCTTCTAACTAAAAGATACTAATATCTTCAAAG
>TTN-213,,0,112,2744173,2744284,GTATTTATTCCCTCTCCTCTGCTAAGAAAAACTTATCGTCTGTACCCCTCACAATCACTGTAATATATACCTTCACCATTCATAAATTATAAAAATACTAATATCTTTCAAG
>TTN-213,,0,114,2744285,2744398,GTACATGTCAGCTCAACCTTATCCTGCAGAAGAAATCTCTCTTCCATTCCTGAAAACAATTTTAGTCCATTCCTCTTCATTAACCTAAGTATAAAACTACTAATATCTTTCAAG
>TTN-213,,0,115,2744399,2744513,GTACACTTTAGCCCTGACTTCATTCTGCAGAAGAGATATCTCCTCTCCTACTGTAAACAATTTTAGCCCATTTCTCTTCATTAACTTAAGTCTAAAACTACTAATATCTTTCAAG
>TTN-213,,0,113,2744514,2744626,GTATTTTTTACCCCTGTCCTTTTTCTGCAGAAGAAATATCTCTTCTGATCTTAGAAATATTTTACTCCATTTGTCTCATTAACCTAAGTGAAAAACTACTAATATCTTTCAAG
>TTN-213,,0,105,2744627,2744731,GTACTTGTCATTTGACCTTAAGCTTCAGAAGATCCAATTCCTCTGCTGTATATTTTGCTAGTAGTCTCCATAGCTCCACATGTAACTTTACTAATATCTTTTAAG
>TTN-213,,0,2503,2744732,2747234,GTATTTGTCACTGATTTTAGGCTTCAGATGATCTATCTCTTGTGCTCTGGAAAATATTTTTCTTTTTATATATATATATATTTTTATTATACTTTAAGTTCTAGGGTACATGTGCACAACGTGCAGGTTGTTACGTATGTATACATGTGCCATGTTGGTGTGCTGCACCCACTAACTCGTCATTTACATTAGGTATGTCTCCTAATGCTATCCCTCCCCCATCCCCCCACCTCACAACACACTCCGGTGTGTGGTGTCCCCCTTCCTGTATCCATGTGTTCTCATTGTTCAATTCCCACCTATGAATGAGAACATGCAATGTTTGGTTTTTTATCCTTGTGATAGTTTGCCAAGAATGATGGTTTCCAGTTTCATCCATGTCCCTACAAAGGACATGAACTCATCATTTTTTATGGCTGCATAGTATTCCATGGAGTATATGTGGAACATTTTCTTAATCCAGTCTATCATTGATGGACATTTGGGTTGGTTCCAAGTCTTTGCTAATATGAATAGTGCCGCAATAAACATACGTGTGCACGTGTCTTTATAGCAGCATGATTTATAATCCTTTGGGTATATACCCAGTAATGGGATGGCTGGGTCAAATGGTATTTCTAGTTCTAGATCCCTGAGGAATCGCCACACTGACTTCCACAATGGTTGAACTAGTTTACAGTCCCAGCAACATTGTAAAAGTGTTCCTATTGCTCCACATCCTCTCCAGCGCCTGTCGTTTCCTGACTTTTTAATGATCACCATTCTAACTGGTGTGAGATGGTATCTCATTGTGGTTTTGATTTGCATTTCTCTGATGGCCAGTGATGATGAGCATTTTTTCTTGTGTATTTTGGCTGCATAAATGTCTTTTTTTGAGAAGTGTCTGTTTGTATCCTTCGCCCACTTGTTGATGGGGTTGTTTTTTTCTTACACGTTTGTTTGAGTTCATTGTAGATTCTGGATATTAGCCCTTCGTCAGATGAGTAGATTGCAAAAATTTTCTCCCATTCTGTGGGTTGCCTGTTCATTCTGATGGTAGTTTCCTTTGCTGTGCAGAAGCTCTTTAGTTTAATTCGATCCTATCTGTCAATTTTGGCTTTTGTTACCATTGCTTTTGGTATTTTAGACATGAAGTCCTTGCCCATGCCTATGTCCTGAATGGTATTGCCTAGGTTTTCTTCTAGGGTTTTTATGGTTTTAGGTCTAACATTTAAGTCTTTACTCCATCTTGAATTAATTTTTGTGTAAGGTGTAAGGAAGGGATCCAATTTCAGCTTTCTACATATGGCTAGCCAGTTTTCCCAGCACCATTTGCTAAATAGGGAACCCTTTCCCCATTTCTTGTTTTTGTCAGGTTTGTCAAAGATCAGATGGTTGCAGATGTGTGGTATTATTCTGAGGGCTCTGTTCTGTTCCATTGGTCTATATCTCTGTTTTGGTACCAGTACCATGCTGTTTTGGTTACTGTAGCCTTGTAATACAGTAGCGTGACGCCTCCAGCTTTGTTCTTTTGGCTTAGGATTGACTTGGCAATGTGGGCTCTTTTTTGGTTCCATATGAACTTTAAAGTAGTTTTTTCCAATTCTGTGAAGAGAGTCATTGATAGCTTGACGGAGATGGCATTGAATCTATAAATTACCTTGGGCAGTATGGCCATTTTCACGGTATTAGTTCTTCCTATCCATGAGCATGGAATGTTCTTCCATTTGTGTCCTCTTTTATTTCGTTGAGCAGTGGTTTGTAGTTCTCCTTGAAGAGGTCCTTCACATCCCTTGTAAGTTGGATTCCTAGGTATTTTATTCTCTTTGAAGCAACTGTGAATGGGAGGTCACTCACGATTTGGCTCTCTGTTTGTCTGTTATTGGTGCATAAGAATGCTTGTGATCTTTGCACATTGATTTTGTATCCTGAGACTTTGCTGAAGTTGCTTATCAGCTTAAGGAGATTTTGGGCTGAGACGATGGGGTTTTCTAGATATACAATCATGCCATCTGCAAACAGGGACAATTTGACTTCCTCTTTTCCTTATTGAATACCCTTTATTTCTTTCTCCTGCCTGATTGCCCTGGCCAGAACTTCCAACACTATGTTGAATAGGAGTGGTGAGAGAGGGCATCCCTGTCTTGTGCCAGTTTTCAAAGGGAATGCTTCCAGTTTTTGCCCATTCAGTATGATACTGGCTGTGGGTTTGTCATAAATAGCTCTTATTATTTTGAGATACGTCCCATCAATACCTAATTTATTGAGAGTCTTTAGCATGAAGGGCTGTTGAATTTTGTCAAAGGCCCTTTCTGCATCTATTGAGATAATCATGTGGTTTTTGTCGTTGGTTCTGTTTATATGATGGATTACGTTTATTGATTTTTGTATGTTGAATCAGCCTTCCATCCCAGGGATGAAGCCCACTTGATCATGGTGGATAAGCTTTTTGATGTGCTGCTGGAAAATATTTTTCTAGTGGTCTTCATAATGCCTAAATGTAATTTCACTAATATCTTTCAAG
>TTN-213,,0,83,2747235,2747317,GTAGACACCCTCTTGTTGCTGTGTTTGATATTGTTTGTTTGTCTTTACTTTGTCTAATAATGAAAATACTAATATCTTTAAAG
>TTN-213,,0,210,2747318,2747527,GTAATGCCAAAGCTATACAAACTATAGGAGAAAAATAACTGTTATTTTAACTAGGAAATTACATGTTAAAAATCCTACTACATAAAGATGATATAATTCTAAAGAAAACAAATGTCAATCACTATCCAAAATATCTTGGTGGGTGTTTATATGCAAAAGGCATCCATCGTTTTCACCTTTTCTAAACACAAATTACAAATATCTTTGAAG
>TTN-213,,0,153,2747528,2747680,GTAGGTATCATTACACATTGTCAGTCGGGGGGCCCTGGGGAAAGACTGTATAGAAGTGTCCGCCGATCTCACAAGTTGTATTTGCTTGGGTAAATGTGGAGTCGATATTCCCCCTTTATAGCTTCTAACTAAAAGATACTAATATCTTCAAAG
>TTN-213,,0,112,2747681,2747792,GTATTTATTCCCTCTCCTCTGCTAAGAAAAACTTATCGTCTGTACCCCTCACAATCACTGTAATATATACCTTCACCATTCATAAATTATAAAAATACTAATATCTTTCAAG
>TTN-213,,0,114,2747793,2747906,GTACATGTCAGCTCAACCTTATCCTGCAGAAGAAATCTCTCTTCCATTCCTGAAAACAATTTTAGTCCATTCCTCTTCATTAACCTAAGTATAAAACTACTAATATCTTTCAAG
>TTN-213,,0,115,2747907,2748021,GTACACTTTAGCCCTGACTTCATTCTGCAGAAGAGATATCTCCTCTCCTACTGTAAACAATTTTAGCCCATTTCTCTTCATTAACTTAAGTCTAAAACTACTAATATCTTTCAAG
>TTN-213,,0,113,2748022,2748134,GTATTTTTTACCCCTGTCCTTTTTCTGCAGAAGAAATATCTCTTCTGATCTTAGAAATATTTTACTCCATTTGTCTCATTAACCTAAGTGAAAAACTACTAATATCTTTCAAG
>TTN-213,,0,105,2748135,2748239,GTACTTGTCATTTGACCTTAAGCTTCAGAAGATCCAATTCCTCTGCTGTATATTTTGCTAGTAGTCTCCATAGCTCCACATGTAACTTTACTAATATCTTTTAAG
>TTN-213,,0,2502,2748240,2750741,GTATTTGTCACTGATTTTAGGCTTCAGATGATCTATCTCTTGTGCTCTGGAAAATATTTTTCTTTTTATATATATATATATTTTTATTATACTTTAAGTTCTAGGGTACATGTGCACAACGTGCAGGTTGTTACGTATGTATACATGTGCCATGTTGGTGTGCTGCACCCACTAACTCGTCATTTACATTAGGTATGTCTCCTAATGCTATCCCTCCCCCATCCCCCCACCTCACAACACACTCCGGTGTGTGGTGTCCCCCTTCCTGTATCCATGTGTTCTCATTGTTCAATTCCCACCTATGAATGAGAACATGCAATGTTTGGTTTTTTATCCTTGTGATAGTTTGCCAAGAATGATGGTTTCCAGTTTCATCCATGTCCCTACAAAGGACATGAACTCATCATTTTTTATGGCTGCATAGTATTCCATGGAGTATATGTGGAACATTTTCTTAATCCAGTCTATCATTGATGGACATTTGGGTTGGTTCCAAGTCTTTGCTAATATGAATAGTGCCGCAATAAACATACGTGTGCACGTGTCTTTATAGCAGCATGATTTATAATCCTTTGGGTATATACCCAGTAATGGGATGGCTGGGTCAAATGGTATTTCTAGTTCTAGATCCCTGAGGAATCGCCACACTGACTTCCACAATGGTTGAACTAGTTTACAGTCCCAGCAACATTGTAAAAGTGTTCCTATTGCTCCACATCCTCTCCAGCGCCTGTCGTTTCCTGACTTTTTAATGATCACCATTCTAACTGGTGTGAGATGGTATCTCATTGTGGTTTTGATTTGCATTTCTCTGATGGCCAGTGATGATGAGCATTTTTTCTTGTGTATTTTGGCTGCATAAATGTCTTTTTTTGAGAAGTGTCTGTTTGTATCCTTCGCCCACTTGTTGATGGGGTTGTTTTTTTCTTACACGTTTGTTTGAGTTCATTGTAGATTCTGGATATTAGCCCTTCGTCAGATGAGTAGATTGCAAAAATTTTCTCCCATTCTGTGGGTTGCCTGTTCATTCTGATGGTAGTACCTTTGCTGTGCAGAAGCTCTTTAGTTTAATTCGATCCTATCTGTCAATTTTGGCTTTTGTTACCATTGCTTTTGGTATTTTAGACATGAAGTCCTTGCCCATGCCTATGTCCTGAATGGTATTGCCTAGGTTTTCTTCTAGGGTTTTTATGGTTTTAGGTCTAACATTTAAGTCTTTACTCCATCTTGAATTAATTTTTGTGTAAGGTGTAAGGAAGGGATCCAATTTCAGCTTTCTACATATGGCTAGCCAGTTTTCCCAGCACCATTTGCTAAATAGGGAACCCTTTCCCCATTTCTTGTTTTTGTCAGGTTTGTCAAAGATCAGATGGTTGCAGATGTGTGGTATTATTCTGAGGGCTCTGTTCTGTTCCATTGGTCTATATCTCTGTTTTGGTACCAGTACCATGCTGTTTTGGTTACTGTAGCCTTGTAATACAGTAGCGTGACGCCTCCAGCTTTGTTCTTTTGGCTTAGGATTGACTTGGCAATGTGGGCTCTTTTTTGGTTCCATATGAACTTTAAAGTAGTTTTTTCCAATTCTGTGAAGAGAGTCATTGATAGCTTGACGGAGATGGCATTGAATCTATAAATTACCTTGGGCAGTATGGCCATTTTCACGGTATTAGTTCTTCCTATCCATGAGCATGGAATGTTCTTCCATTTGTGTCCTCTTTTATTTCGTTGAGCAGTGGTTTGTAGTTCTCCTTGAAGAGGTCCTTCACATCCCTTGTAAGTTGGATTCCTAGGTATTTTATTCTCTTTGAAGCAACTGTGAATGGGAGGTCACTCACGATTTGGCTCTCTGTTTGTCTGTTATTGGTGCATAAGAATGCTTGTGATCTTTGCACATTGATTTTGTATCCTGAGACTTTGCTGAAGTTGCTTATCAGCTTAAGGAGATTTTGGGCTGAGACGATGGGGTTTTCTAGATATACAATCATGCCATCTGCAAACAGGGACAATTTGACTTCCTCTTTTCCTTATTGAATACCCTTTATTTCTTTCTCCTGCCTGATTGCCCTGGCCAGAACTTCCAACACTATGTTGAATAGGAGTGGTGAGAGAGGGCATCCCTGTCTTGTGCCAGTTTTCAAAGGGAATGCTTCCAGTTTTTGCCCATTCAGTATGATACTGGCTGTGGGTTTGTCATAAATAGCTCTTATTATTTTGAGATATGTCCCATCAATACCTAATTTATTGAGAGTCTTTAGCATGAAGGGCTGTTGAATTTTGTCAAAGGCCCTTTCTGCATCTATTGAGATAATCACGTGGTTTTTGTCGTTGGTTCTGTTTATATGATGGATTACGTTTATTGATTTTTGTATGTTGAATCAGCCTTCCATCCCAGGGATGAAGCCCACTTGATCATGGTGGATAAGCTTTTTGATGTGCTGCTGGAAAATATTTTTCTAGTGGTCTTCATAATGCCTAAATGTAATTTCACTAATATCTTTCAAG
>TTN-213,,0,83,2750742,2750824,GTAGACACCCTCTTGTTGCTGTGTTTGATATTGTTTGTTTGTCTTTACTTTGTCTAATAATGAAAATACTAATATCTTTAAAG
>TTN-213,,0,210,2750825,2751034,GTAATGCCAAAGCTATACAAACTATAGGAGAAAAATAACTGTTATTTTAACTAGGAAATTACATGTTAAAAATCCTACTACATAAAGATGATATAATTCTAAAGAAAACAAATGTCAATCACTATCCAAAATATCTTGGTGGGTGTTTATATGCAAAAGGCATCCATCATTTTCACCTTTTCTAAACACAAATTACAAATATCTTTGAAG
>TTN-213,,0,153,2751035,2751187,GTAGGTATCATTACACATTGTCAGTCGGGGGGCCCTGGGGAAAGACTGTATAGAAGTGTCCGCCGATCTCACAAGTTGTATTTGCTTGGGTAAATGTGGAGTCGATATTCCCCCTTTATAGCTTCTAACTAAAAGATACTAATATCTTCAAAG
>TTN-213,,0,112,2751188,2751299,GTATTTATTCCCTCTCCTCTGCTAAGAATAACTTACTGTCTGTACCCCTCACAATCACTGTAATATATACCTTCGCCATTCATAAATTATAAAAATACTAATATCTTTCAAG
>TTN-213,,0,114,2751300,2751413,GTACATGTCAGCTCAACCTTATCCTGCAGAAGAAATCTCTCTTCCATTCCTGAAAACAATTTTAGTCCATTCCTCTTCATTAACCTAAGTATAAAACTACTAATATCTTTCAAG
>TTN-213,,0,115,2751414,2751528,GTACACTTTAGCCCTGACTTCATTCTGCAGAAGAGATATCTCCTCTCCTACTGTAAACAATTTTAGCCCATTTCTCTTCATTAACTTAAGTCTAAAACTACTAATATCTTTCAAG
>TTN-213,,0,113,2751529,2751641,GTATTTTTTACCCCTGTCCTTTTTCTGCAGAAGAAATATCTCTTCTGATCTTAGAAATATTTTACTCCATTTGTCTCATTAACCTAAGTGAAAAACTACTAATATCTTTCAAG
>TTN-213,,0,105,2751642,2751746,GTACTTGTCATTTGACCTTAAGCTTCAGAAGATCCAATTCCTCTGCTGTATATTTTGCTAGTAGTCTCCATAGCTCTACATGTAACTTTACTAATATCTTTTAAG
>TTN-213,,0,113,2751747,2751859,GTATTTGTCACTGACCTTAGGCTTCAGATGATCTAATTCTTTTGCAGTTGAAGACATTTTGTTCCAGTGGTCTTCATAACCCCTAAATGTAATTTTACCTAATATCTTTTAAG
>TTN-213,,0,109,2751860,2751968,GTATTTGTCACTGGCTTTAGGCTTCAGAAGACTGAACTCTTCATTTCTTGAAAATACTTTTCTAGTGGTCTTCAAACTTCTAAATGTAATTTCACTAATATCTTTTAAG
>TTN-213,,0,111,2751969,2752079,GTATTTGTCACTGGCTTTAGGCTTCAGAAGATCAAACTCCTCTATTCTTGAAAATATTTTTTCTAGTGGTCTTCATAACCCCTAAATGTAATTTCACTAATATCTTTTAAG
>TTN-213,,0,111,2752080,2752190,GTATTTGTCATTGAGTTTAAGCGTCAGAAGATCTATCTCTTCTACTCTTGAAAATATTTTTCCTAATGGTCTTCATAACTTCTAAATGTAATTTCACTAATATCTTTTAAG
>TTN-213,,0,110,2752191,2752300,GTATTTGTCACTGATTTTAGGCTTCAGATGATCAAACTCTTCTGCTCTGGAAAGTATTTTTCTAGTGGTCTTCATAATGCCTAAATGTAATTTCACTATTATCTTTCAAG
>TTN-213,,0,84,2752301,2752384,GTAGACACCCTCATGGTGCTGTGTTTGATATTGTTTGTTTGTCTTTACTTTGTCTAACAATGAAAATAATAATATCTTTTAAAG
>TTN-213,,0,128,2752385,2752512,GTAATAATGAAACTATTCAAATTAGTGTTTTTTAAAAAAATCTTTCCTTAGTGTTGTAAAAACATTTTTTTGCAAACTATCTCAGTTTTAGTCAATTCTGGCATTAAAATGAGCTCATGTCTTTAAAG
>TTN-213,,0,134,2752513,2752646,GTACATGGCAAGAAAGCTGCTAGGACACCTCGGCCACTCTTTCCCCTTCCTGCCCTGATAATTCTGGGTGCTCTGAGCTTTTGTCTTGTTTCTCAATCTTCGTTCTTTCTAAAACATACCTTCTAATTCTTTAG
>TTN-213,,0,129,2752647,2752775,GTATTCCTCACTGCCACTAACTCCCTAACAAAAAACTTTCTTTGAAGTGTCATATTCTACTGTTCTGCTTCATGATTTTCACATTTCATTGAAACCATGAGCTTAAACAACTACTAATATCTTTTATAG
>TTN-213,,0,132,2752776,2752907,GTATATGTGGCTGTCCACTGTTTGATGGGGGCGGATGGAGCCCCCAGCTTCTAAAAGGGTTTTGTTCTGTGTAAATGTGATGAATGTTTACTGGTGATTGTTTCTAATGTTAAAATACTAATATATTTGAAG
>TTN-213,,0,408,2752908,2753315,GTACATGTCACTAATGAGATTCTGCAGAAAAGCACTCACCCTTGTCTAATAAGTCACCTATTATCAAACCTTTTGTTTGCGAGTCCTCTTAAATTTGCAACTACAAAACTGTCATTCTGGATTTTTAGGGTCTGAATACTTTTTAATAATTTTTTCATTGACTTTAAAAAGTGATATATTTACTTATTACAAGCATTGGAAAAGTTTACTAACTTGGTTCTTTTATTCTTAATAGGCCATATTTTCCTCCCCACTATATGAGGGTCCAAAGACAGATCACTGACCTTATTGTGAAATTTGTTCTTGGATCTGTCCCTGGGTTATTTGAGCAAAATGTGAAGTCGATGTGGTATAAATTTAATATACTTCTCAACTACTCATAAGAAAAATGAATTAATATCTTTAAAG
>TTN-213,,0,479,2753316,2753794,GTACACGTGAGACCGGTGATTAATGACCTTGCCACTTGCGACTATTTCTAATTTAAGCTTTGTTCTTCTTCCTTCCTAACTCATTATTTCTTGGTCATTTTCTAACCTTTAATTATTTGTCTTAATTCATCATTCTAAATTAGCTCCAATCTCAAATCTATTTTGGGTTATTGGTCCACAGTATCTACATAAGTCATAGTAAGCTATATTAAACAAAGCTTCTCCAATGTACATAGAAAGTAAGGCAGGAGAACTAATGATTATAAATGACATTAAACACTAAAAGGGCTTTGCAAGCATTTGAATCAATAGACAAAGAAGTCAGTGCAAATGAGATAGATTTTATCTAAACAAAAATAAGAGAAGGTATCAATTGAAACAAAGGAAGAAATCAAGATTACTATTTATCGTGTTTAGTGTTTGTCCATCTTAGAATATTGTTCCATACATTGAAATAAAATTAACTAATATCTTTAAAG
>TTN-213,,0,269,2753795,2754063,GTACAAAGCAGAATCCACTGTATGGGAAAATACAGTCATTTCATTTTTCATGTCTATATATCTTCCTTAAGGCAAAATATCAGTCTTGTATCTTGTTGCCTGAAATCTGACTACATTAAGAACAAAAGTTATTTCTACACATAAAACTTTGGACCCACAGAATTTGGTCCCACATATACCAAGAAATATGTGTGGTTTTTAATTCATTCATTAGCATTAAATTTTTCATTGTAATCACCTAATTCTAAAAGAAATTCCTATTATTCAAG
>TTN-213,,0,185,2754064,2754248,GTACTCATGTTAAAATGAATACTTCATTTTTGTGGTGTCTACAATTTTACACTCTTCTTATTGTGTGTTGTGTTGTATTATATGTTTGTTAACTCTTACCTATATGTTACAGTGTTGAATAAACTTGTATGTATATCTTACATCTCACAACTTTGTATTATTAAATGCTACTGATATCTTTAAAG
>TTN-213,,0,222,2754249,2754470,GTATTCACTTCATCGTTGGCATCATAAAAAAGAAAGTATTCTGATATCTTAAAGTGGAATCCAATAAGTTGTCCTCATTGTTGTTGCATAACTAAGGACAAAAATTTCCTTATTTTGCTTTCATTAATTTTAATGCTGCTCCAATAAATACAGGTTTTTTATTCTTAATATTTTAAAATGTTTTTAAATACTATTTTTAAAACAAAACTAATATCTTCAAAG
>TTN-213,,0,1783,2754471,2756253,GTACCTACCATGAAGAAAAAATAGATTTCTCTAACTGCTATTTAAGCATGTTAATAATAGGTCTTAGAGAAAAACATACTGAATGTGAATTTATGTTAAAACCATATTGCACAGAAAAAAGGGAAATAATGAAGGGAAAAAAATGAAACAGACAAGCAGGAGTGAAAAAATGAGTGGGATTCAGTTGTGCTGTGATATATCACATGGCTACAACTAGTAGAAAAGAACCTTCTCTCATTCAATGTGTAAAACAGCTCAATTCAACATATTTTGTTGAATGTTGACCATTAACAAGACATCATATTAGAAAAATTAAGGCCTGATTCTGTCTTCAAATAAGTTAAATCTGGTGAGAGGATAGAAAGATAACAGGACTCTAATACAGACAGGAAGTGATTACACATAGCAAGTGAATACAAAAGGGCTGCAGAAACACACGGCAAGAAAAGATTAAGTTCAGGCAGAGGCATCATGGGAAGCTGTGTTAAACTGAATTTAAATTTTGATGGACTTTTACATGTAGAAATTGAGGAAATAAGGCCGGATGTGGTGGCTCACGCCTGTCATCCCAACACTTGGGGAGGCCAAGGTGGGTGGATCACTTGAGGTCAGGAGTTCAAGACCAGCCTGGCCAACATGGTGAAACCCCGTCTCTACTAAAAATACAAAAATTAGCTGGGGGTGGTGATATGTGCCTGTAATCCCAGCTACTTGGGAGGCTGAGGCAGGAGAATTGCTTGAACCCAGGAGGCAGAGGTTGCAGTGAGCTGAGATAATGCCACTGCACTCCAGCTTGGGTGACAGAGTGAGCCTCTGTCTCAAAAAAATTAAAAAAAAGAAATTGAGGACATGATATCCCATGGAAAGGGAAGAGCATATTGAAAGGCACAGAGATAGAAGGGTCTAGAATGTTCAAGGATTGTCAAGTAAACTTATGTCAAGTAAACTCAATTTGAGTATGGATTGGCTGTGGAATGTCTTGAAAGATAATACCAGATATAAAGATGGGGTCATATTTTGGAGTACTTCAAATGCCAGTAAAAGGCTTGTACTTTTTTCTGTAGGCAATAGGAAGCTTCAAAGATTTTGAAGCAGGCTTACATATTAATAGGATTTGGGCTTTAGAAAGATAACTGGCAGCAATTTCAGCTACTAAATAGTAAAGACCCATTGCAATTATTTAAGGTCTTTAAGAGTTGGACAAGATCCGTGGCGGCAGAAATGGAAAGGGGGACTGGGTTTGAAAGAGATGGAGACTTAGTGGCCTCTGACCATTATCAAAACCATTAGGGAAATTGAGGAGCCCAAGATCATTGTAAGGTTTAAAGCTAGATGGCCAAAAGAATGGTTCATTGGGTCTCTGAACTAACGTTAGAGGAAAATGGTAGATGTGCTTTTCACCTTTAAAGCATAAAAGTTGGGAGTGTGTATCAGGAGCTTAAGAAAGAGATCAGGCCTAGAGATGTAGATCTTAAAGTCATTCACATGTAAATAAGAATTGAGTGTGCAGGAACAATTACTCAGAAAATGTAGAGCAAATTTTTTTAAGTGTCAAAGTTAGACCACCTTCATTTAAGTGTACACAGAGGACTAGAAGCAAATGAAGAAAGCTGAGAAGATTCATATATAAAATTAGGATGTCCAAAATGGTGCCATGTCTCAGAAGCCATTTTCCCCATGAAATCTAAGATGAAGCTCTTGCCCCTGCATTCTTTGCCTGCTCTTTAGACAATCTTGCATGTCTTCTAAATTCTTAATAGTAAACAAAATCATATCTTTAAAG
>TTN-213,,0,236,2756254,2756489,GTACACGGCTTCTCCATAAATCTTGGAAAGATGACAATTGTCTTCATCCTCTTGCTTTGATTGTAGATGAATCTTACGTATTTGTCTGTCTGTATTGAAGTTATTGATATTTGGGGGGTCATCTGAATAATCTGTTATAGAGTGTTACTTAATGTAACTAGGTTGATATGTTAGAATAGTAGTTGCAGTATTCTGTTCTAAATATAGTCTAAAATAAAATACTATGTTTTTTAAAG
>TTN-213,,0,504,2756490,2756993,GTATATATATATATATATATATACATTTTTTTAATCTCCTGAAGATTCCTGTTAGAATTACAAAAGCATTTACAGGACAATATTCCTTCTTGAAATTATATACAAGAGCAGTCTAGCATGTTTGACTGCTTTATTTTTGAAATAGTTACACTTCTTTTAAGTTAGAATCTTTAATTTAGTTACTGTTGTTGGTAATTACAATTTCCAAAAGGTACAGTTTACTGAAGCAAAATGGAATAATTGCCTTGGATCCTCAAATGATAACACGGTATCAAATTTTAAAAGTCATCTCATTTGCCATCAATATACATTGAATAATCTAATTAATAGGCAGTTCAAGTAAAAGAACTTTTTCTTATACGTGAATTTTTCTATACATGAATTTGTATGAATTGTATATTTTTATTTTGTGACTGTAATCTTTGCATCAATGTGAAATTTGTATGAGTCTTTTTGAAGAACTTTACATTGCAACCTCATCTCCTTTGTCAACATTCTTTAAAG
>TTN-213,,0,454,2756994,2757447,GTATTCAATCCAGTGGACTTAAATCTTCTTTATCATATTCTTTCTCTTGAAATGTATATGGTTTATGTTGTTGTACATATGTAGTATGTCTGTTCCCATTTGTATGTAAAGTATTCTTTGTTGTAAATGTGAGCCTCATTCTTAGGTTTCCATGTAACTTGTACTGTTTCTCTCATGTCAACTGTGGCTTGTCTGGATGCTTTGTTTGTTGTTGTTATTGGTGCCTTTGCTGTATTTCTCATCATCTTTGTAAAGGGTTGATATTTTTATGTTTTATGTTCTGTGTTTTATGTTGGATACTGGTATTACGTACCTTAAAAAGTAAACTTTGTACTTCATATATATATATATATATATATATATATATATATATATATATAATTTCTATTAAATATACTACATATCCACATGCTAACATATACATATACTAACACCTCTGAAATACTCTTTCAAG
>TTN-213,,0,1303,2757448,2758750,GTAAAAAATGCCACTTCCAAAGTTTTATTAGCCTGCTTCAAACTTCTATCCAGCCATCTGAAATGATGCTTGCAAGAAATGTATGACTTTTAGAAGTGTGTACTTTCAGACATGATTGTACTGTGAGATTGCATAGAGCTGTCTCTTCTGCTGCCCCATGGTTCCTGGGTTGCTTGTCATGCCATGCCTGCTGCTGCAAAAGTCAGAAAGTACATTGATAGCGTCATCCGGGATATCTGAATGCAGGCACTGTCCAATTAACTTTCTTTTGTGGAGTGGGGAGAAAGAGTTTTCTGATTTCAAAGCCTGATTGCTATACATATCATTGCGATCTTATGCTTAAGGAATGTATAAGAAATCCTTGCAAGATATTTTTAATATTGCAGTAACACATTTACATAAAAGCCAAAACTTTGTTCTTAAAGAATTGCATGTGCTTTTAAATATATTACAAGTAATATAGTTATGATTTCCAGTAGCTGATATGTGCCTATATATCATGAAAGGAAAGCATATGAATGACTTGTTACAGTTCCCCCATCTCTTTTTTTTTCTTGCAACTTAAAGAAGTGTTCTGTGTGGTTCTCAGGGGAGCTGGAAAGAGTGGTTATGAAGACATTTGGTATCCAGCATTTATTATTAAACTTCCCTTCCCCCTTCTTATATTTTGATTTTTCTATGAATTGACACAATGTTACTTAATTTTAAAAATATCAGTTTCTTTAAAAGCTGAAATAAACTGGCAGAAACATATTATTCTTATTTTAATAAAAAGTTGTCTTGTGACGTCATATGATTCCCCAATCTAAAATTATCTAGATATAATCTTAGATATGCACTTTCCCTATACAGACCTATGTATCTTCAAACCACAGTCTTCCAGCATAAGACATTGCTGCTGGTGATTCTTGCCCTCTACAACCCTCATAGCCATTAGGGGGACCTTCTGGCACCTCTTGAAAGGCCACCCATCTGTTAATTGACACTCCATGAAGACACACACATAAATACATTTCCCTTAATGTAAAATATATGCTTAAAGGAAAATTTCTTCCTCCTGCCAATAACAAAAATTGTCTTCTTTTTCTGCTGGTCTTTAATTAACTACTGAACTTTGGAGTAAAACTGCAGTCTGTTTTCATGGTTCGAATGCTGCTTGTATGTTCTTTGAAGGCTGTTCTTGGCTGTTATTAATGCTTTCTGGTTATAAGCAAAGCTTGGTTTTGATTCTTGGAGTAGAAAGTTAATCACTTGCTTCAGATTAAATATACAAATAACAAAAGTAAAATCATATTCTTTAAAG
>TTN-213,,0,2230,2758751,2760980,GTATTTCACAGGCTGAAAAATACATACTTATGTAGTACCCCTTTACCTGACTCCTTGCTCTTTCTGCCTCCATCGAATGTTCTGTCTCTCTTTTTCAATGATCAGAGAGTAGTCCCATTCATTTCTTATATTTCTGTGGCTTTTATGGTCCTGGCTCATGAGTGTTGCTTCCTTTGTCTCCCATCCATTTCATACATGTATAGACATGGTCTATCTTTGTCTCATCTACATATGTCTTCTTGCATTTTCCTAAACTTAAAAATAACAAATTTTACTGGTTAGCCAAAATTGATATCAAGAGACATATGAGATTAAAATGCTGAGAGCTAGTAGTAAACTGTTTTGACATTTCACCTGACATAAAAATTTTAGCCAATGTAATAAGCACTAAAAATAAGTCCTATCTTCCTTTTATATTATTAAGGTTATTTGTAGGGATTTCCTTAGGACTTTCATGTCACTCTCTTCTCACTGGCTCTAAGTCATTCTCTGAGGGGTACGGAACTCACATTTCAGAAAAATTTCCTTATTACTGTAGGTAATTTTTCAAAATGTATTTTTCTGTAAACAATATTTTCCCTAATAAGGTCTCATCTAAAATTAGACCCTAAAGAAAACTAAATGAATTATAAGAGTCTAGAAAACATCTATCAAAAATAAACATAATTTTTCTAATGGGTAGTAGTGTTCTGTTCAAGTAATCAACACATTCAGACCTAGAAATTAAGACTGTTTCTGGTCACTCTGAAATTTTGGGGAAAAAAGTCACCCATATAAATATACATTTCCTGATTTCATAAAGAGGCAATTACAAAATAATGTTATCATGGATATTGATCATAAACATTAAAATAGCATATAATCACATATAATGACTTTAAAAATAATAGCTACAATGTTGGGTTCTCAAACATCAATAAGATTTTTAAAATCAAATAATAATATAAAAAATGCACAGATATATTTTCACTATGTTCATTATATCAGTAAAGAAAATCTATATTATGCCTCCTCACTTTACATTAATTAGATGCATGTGCTTCCTTCTGGGTTTGAGCAATAAAAATAGTTATTAAGAAGATTGGTACCTCTAAAATAGTATTGAAGGCCAACACAATTTATCCTGGATAAAATACGTAATGTTTAACTTTAAAATTTTTACTTAAAATATTTGACATTAAAAAAATGATTATTCAAAACGAAATACATATTTGCCTATTGTAGGTTTAAATTTTTGAAATAAGAGTTAAGCAGTTATCTTTATCACATAAAAAACCATTTAATGAATTGCAAATATCTTGTTTAAAGCCCTAAATAGGAAGTTTTATAGAAATATCTAAAAATTCAGATTCCTAATAGCAAATAGTTACACAATACAAATAAATACTGTTTTAAATTAGATTTTAATTGACATTAGTAGAGAGGAAAATGGTTTAATAATCACCACGTGTTCCTTTCTTTCACCATTCAAATCTATGAGGGCCATAATAGCAAAAGAGGCTGCTCTATAAAATAGCATCATCCACCATGCTCAGTATTCACTGTAGACGCAACAGGAAATTTTGAATTCCTTGCGTTCCTTAATTTGAATGAATTTAAGAACATTTTCTTATTCATGAAAAACGAGCTTCCAACACCAGCTTTGAAATTTTATAATTCTATAATTTTAAATATTTTATCCAGCATTATTTCAAAAAGGAAATCTTAAGAAAGGCTACTCTTCTTCTGTTCAGAAAGTGAGATATGGCCCTTCCCCAGCATCAAAGTCACAAACCGGAACTCTTGGCCACCTTCTTCCCTCAGTGGAGAAGACTGAATGATGGCACTAACACTTGCCAGTATCATTTTCATACATTTAGTGGTTGGGTAGATAACATCGTAGATTTGGACAATCTACAATTGCAGTTTGGGACAAAGATGCTGTCAAGAACCCTGTAATTTGATGAAAGATTCATAAAGTCAGTATGGAGCAACATCCTCTACATGCATTTAAAATGAATACATTTGCCTGCAGTTAATGGAGTTGAATTTCATCACAAGGCTGTATAGATATTTGCAGAGGAGATAACTTGAAATGTATCATTTAAACTTAAATTCTGTGGTATTTATATGCAGCGAAAATTGTTACTTAATGCACTACAGTTAACTAGTTTTAGGAGAGACATTTTTCTTGTTGAAATTCCGTTTTTATATAAATTCACTTCAAAATTTGAAATCATATTCTTTTAAG
>TTN-213,,0,921,2760981,2761901,GTATAGTATTTTTCAACCATTCTGTCAGCGTTAAGTATATTTTAAAAATGAACTTGAAAGCTTACAAAATGTTTCTGTCCTTTGGTTTTCTTTGAATTGGTTCGCTATTTATCAAAATTTGTTTGTAGTTTCATTGAAAATTAAGAAAAATGTCATTTCCAGATCTTTTTTTTTAAAAAAAAAAGACAGAAATTTTGTGAGCATTCACAGTATTTTGAAATTTAAAATGTTAATAGACATAACTAAGTTGATAATATTCTAAACTAACAACAACTATGACTGCCATTTTCATAACCAAATTATGTAGTAAAGTACACTAAACCTATTAAATACCTTACATGAAACTACTTTAGCTTAAATTCAATATTCAGTTTTAAAGTGTGACACAGGATCACCACAACTAATAAATAACATTTTTAAAAAACTGAACATTTCTTTCTGACTAATAAAATATTAAAGAATGAGAAACAAGATAGTCAAATGAAGAATTAAGTTCTAACATTGTCTTCACATAGAATTACTGATTTTTAGGCTACATTTCTTCAGATATCTCTGCTTAAGTAAACTTTCTACTTATTTACATACTCATTAAATCATTAACATTTAATTATTATTATAATTCGTTGCTATTCAAATTATTCATTTTGTGTTGGAGCTGTTTCTCCCACAGACTTGTCTCAGAATAGACCCTCTATCTAGATAGAAACAAAGTAACTTTGAGTGCTATTATAATTGACAACCTTTGATTTTAAAAAAAACAAAACAAAAAACACTTTCGGTGTAAATGCTTACTTTCCAGAGTGCTAGGTAGCATGCTTTTTTTCATTTTCCTTGCTTTGTACATTATTTGCATTTGTCAAGCTTATTCAACATCTTCATTAGTTTGTCTTGGTTTACATATAAACCTTTTTGTCTTTAAAG
>TTN-213,,0,610,2761902,2762511,GTAGGAATCTCAGTGACAATTTGTAAGATTATCTTTTAACAAAATGGACATTTAACAAAAGGTTTATCTTGTAAACATAAATGAAGTTAGATGTAAACATGGCTTCATATTTCATCTGTGATGTAGTCTCTGTTTTCCATTGTCTGCTTTCTGTTTAAATATTTTTATAGTAATTCCCAAATCCATTCATGTATTTCCCTGCACTTCATTCTTATCATTACTTTGCAACTTAAGTTCTTCCAGTAGAAATGACTGAAATAATCAAGTGGCTATTCATGGGAGGGTGTCAGCAAAGGTTTCATAATCTGGGGGCTTTTAAATGGGTTGGTTTTTATCATTAGCCTATTCTCAAAGGGCAAAATTATTGGGAACTATTATAGAAGTGATTTAGAAGGAGAGAGCTAAGGGGAGTGGAAGATAAGTGGATGGAATAAAAGGAAGAAAAATAAATGGAAGCAGAGTCAAGAAAATAAAATAGAAATTACTTGATAAACTATAAGGTTTTTTAAAAAACCATCCATAGAGTTTTTGAAAAATAAATTGATATTTCAGATGAGGTGCTTCCTAAATATTCAAATATTAACACTGAAAAAATAATCTTATCTTAAAG
>TTN-213,,0,430,2762512,2762941,GTACAAATCTACTGTCATTCTTAGTTGTCTCTAAAAATGCAAATATGTATCATTTAAAATATCATTACACTGACATCAAGATTTGAACACATGACCTTAATCTGTTAATCACATATGGCTTAATTTTCTTTACCATCTCACTCTCCTATGCAATTGGCTAATGATTACTCAGTTGCTAAATAAGTTACCTGAAAAAAAATTGTATTTATGGGCAATGAGATAAATAACAACATTAAAACCAAGAACATTGCCTTACTATATTTTCCAAATATTTTGTTTAAAATGAAAACTAATCAAATACTTGATTTGATAATTATATGTATATAAATTCTAATATCTTCCAAGATACGTGGGCTTAATTTTAGTTTTGACTTTGTGAAAAACTTCAAAAATCCTGTAATAATCTGCCCTCTACTCTAAATTATTTCAG
>TTN-213,,0,259,2762942,2763200,GTGAGCAAGCTTATCCTCAATGTCAACAGCATATTCTTTCTGTATTCACACACATAACATGTACTTAATAAAAGATAGTAGGTGAAAGTCAGTATGTATCAAATGATTTCTAACGTCTCAAAATGCTTAATATACTATTCTCTTAAAAACTAGTTATTTGAAGATTTCAAAATTATATCAGAAGAGGCAAATAAGCTACCAAATAAGTTTTTAGGAAGTGACAAATTGATACACTAATGCAATGGACTTCTCTCTACAG
>TTN-213,,0,2279,2763201,2765479,GTATTTATCCTGTAGCTTTCTTTTTGCTAGTTTGTTTTGGTGACTTAATAAAAGTATTCACACTTGATTAAAATTCAAGCCCTGTTTATGCTGCAACATAGGTATCATTTCAACTTCGGAGGTTTATGGTAAGTTTCTACCTTTTCTTCATGTGATATCCTTTATCCACCTTGTCTCTTGCCCAGTGGGTGAATATTGTGCCTTAACTGGAATGTACGTTCCTGGGTTGCACCATTTCTTTCATATGCTTTGGAGATTAAGTAATGAATATGTTTGGGGCTGATAAAAACTAAGGAGACAGGCAGAGACCCTGTAAGGGTATACATATAAGAATCCCATGAAGCTTCAAATTTCCCTTATACCCTATTGGAACAATTTCTCTTTTTTAAAAAAGTGTGTATATTGGGATAATGTAAAAGTTCTGGAAATGGATAGTGTTGATGGTTGTACAATATTGTGAATGTATTTCATGCAACTGAATTGAATACTTAAAAATGGCTAAAATGGTAAATTTTATGTTAGGTATATTTTACCACAATAAGAAAGAAAAAGAAAAAAGAGACTCCATATTTCAGTCTTTTAATCTGTATAAGGAATTAGATCAATAATAATTTTCTTAAATGTTCTAACTTAATGATATAGGTATCTCAAGTCCAAACTTAAAGCACCTATTAATTGTATATGAACTATTTAGTATAGTTCATCATTTAAGTGATAATTTGAGATATAATTGATCAAAACTGATTTGATGTGTAATTGATAGTCATTGATAAACATACACATCCTGACTATTTGCCCTTTGGCTCACTATCTGGGTGATGAGATCACTCATATCCCAGACCTCAGCATCATGAAATATATCCACATAACAAAACTGCACATGCATCCCATGAGTTTAAAATAAAAGTTGAAATTATTTTTTTAAAAAAGAAACAACAAAACCAAAAATAAAACAAAGTAAATTTAAAGCGGGGGCGGTGGTGGTGGGGTGGGGAGAAGGCATGTATTGATAATTTTCTAAGATGTGAAGAATCTAAGATATTCAATATAATGCCTTGACAATTTGTTCCTATGGAAAAATGATCATCTCCACTGATAAAGCACAAAATAAAAAATTCAGGGTGAATTTAAAAAAAAAAAAAGAGAACTATTTGTTACATTCCACAGTGAGATGTGCATAGGCCCCGGGAATAACATTTAGAAATGTCCATAATAGTTTGACAGAGAAATTTTTTAATTTAATTTTCTGAACCTAATAATAAAAATTGGCTTATATCTTTAATAAATCAATAAATAAAACTATTTGGAAAAATTATATTATTTTAGATTATTAATTCAATAATTAGTCATTTTATATTTGTTTATATATTTTTATATAAATTATTTAGAAATTTTTTTATTTAAAATTATCTCAAAATATTTGGACATTACCATGTTTAATGACATAAAAAAATACACTATATTCTTTTGACTGTAGTTTAATTTTTAATATTTGTGTTATATTTTGTTGCTGATGTTTATGATTTGGGCATATTCTTTTAAACTTTTATAATGTCAACGTAGTACTTTTATTATTCAGAAAAAGGTGATGAACTGCTCTTGTCTAATTAAGTATGTATAAAAATAAAGCTATTCTCAGTTATCCTGGGGGCTGAAGCTAGAGAACTCATTCCACAGTTTATACTGTCCCTGTATTAATAATGGAATCAAACTCTAAATGTCAGAACTCTCTTGCTTCTGCCTTACTTCATTGTCTAAAGGAAATCTTCAAAGAAACTCATGCATGTGTGGTACATGGACTCTTTTTCCTTAGTCTTCCCTGGATTTGTTTGTCTGCCCAATTTAGACATAAAAAGAAAGGCTTTTGGTAACCTCTCAGCCATTTCCCTTTTCCCTACACTGATTTATTGACAAAACCTTATTTCCTTGGTTCACATAATCAGGACTTACATAAACATATAAAATATTTTGCACAGCTAGGCAGGAGCAAAACTTTTCCTCACAAGGCAACAGTAAGCCTTCCAAAAATGGGAAGATAATAAGGCACTTGCTGAAAGAAGTTGTTAATCCTAAATATGTTGGCAGTTTAGCTTGAGCTCTTCAGTCTCAGAATATGCCTTCCTGGAAATGTGATTATCCATAGAAGTCATATAAATGAAACCAATTTCTCTTTATGCGTTAATATTTATAATGGAGCATGACTCACCCTCCATGGTTTACTATTAAACATGAAATAAGTCCGAAAAGTGTTTAAATGCTGAGTTTTATTTTTATTTCAG
>TTN-213,,0,569,2765480,2766048,GTGAAATTCATTTTTCTAGTACTTGCATTGTAACCTTCCACTCTGAATTTCCAAAGTTCATATTCAAGGGGAAAAAAATTTCAAAATTCATAACAATTTTTATTTTTTCTAATTGATTCTACTAAAACTAGCATGTTTTCTGATATTTCAAATAATACTTTTAGTATTATGCAAGGAGATATATATATATATATATATATATATATATATATATATATATATCCAACTATATTTTAGCATAGTGAATCCCATAAGTTCTTAGCTTCATTTTTCATATGCATGGTATTTATACATGGCAGATAAAATAATTAGACATTAATCTGGCTATTTTATACTTCAGATTAAAACTTGAGAAAAGGGACATTTATTATTCATGGATTCCTTATACCATCTCATTTTCCTGCCTGAAACAAGGCAGTATAAACTCAATTGGCCTTTCAATTGCCTGGTCTTTAGTTTTCTCGTCTTCTAATTGCTTTACGGCTGGTTTTATCCAGCAGGCAGCCAAGTATGAACTTTCTGACTCCTAAGGAGATGCCAAATCAACTTTTTATTTTACTTTGAATTAG
>TTN-213,,0,156,2766049,2766204,GTAATTTCTAGTCTTCTGAACATAATCTATATTAAACTTTAATGTAACAAACCTTAGTAGCAACTTGCATTGTAGTTTTACAAAACCTCTTATTTCCAAGTTTTATTTCATTGAAAATATTGTATTTATTGAAATATATACTGAAATTCTCCATAG
>TTN-213,,0,247,2766205,2766451,GTTAGTACTTTCCTGGGAGATTTCGTTCTGCTTATTGTTACACTAAGAAAATGGAAGAAAGGACCTCGTTTCCCAGTATTACAATATCAGAAATCTTGTACCTAAGAGGGGAATAACAATATATCCTACAGTGGATTAATTATGCCCAGTATTGTGAAATTTTTCCTATTCCTGAAATTTACTAAGGAAGCTATGTATATTACTTGTTCAGACCTTAATCATTTTTTCTGATCTTATTTTCATATAG
>TTN-213,,0,135,2766452,2766586,GTATAAAATCTTACCTTTTATTCAAATTATAAGTTTTGCGTATGTGTAAAGCCAAATAACACACCAAAACACATAAAAGCAAAGCATCGTTGGGTTGTCTAAAGCATTATGTTACTTCATCCCTGACCAATACAG
>TTN-213,,0,315,2766587,2766901,GTGAGTAATTTCACATTTTAAATTGTTAGTCATATAAAATAACCACATCCAATATTCAGGATCTATATCCTAGATTCGGGTTGCTTTAATAATAATGGAGTTAATGGAGTCTTCTAAAGTCTCCAAGAAGGAAAGAAATTTTACGTATCATTTGGGGACAACTTGAACAATTTGTGTAAAATGTTATGACAGGGAATTCTCTGCTTACTTTTATTAGTAGTAATTTTTAAAACTCTATAGAAATTTGTATCTGAAACACTTCTCCTATAGGGAATTTATCTCTTTCAAATGGTTACTAAAACTATTGTTTTTCAG
>TTN-213,,0,93,2766902,2766994,GTATGGGGCTTTTAGAATTTGGGGAGGGGTCTCAACTTTATTTCACTTCCCTGTGCATTCTGAAAAGCCTCATTCTTAATGTCTGATTTTCAG
>TTN-213,,0,282,2766995,2767276,GTAAGCGAGCTAATGAGATCTGTGACATCCCATAAAGGCATGCAAATATATGACTTTAAAGATAGGACGCCAAGTTCTAAAAGCTGTGATAATGCATCACTAATTAACTTTCACAGTGTTACCAAAACAACCCCCCTTAATTTGTTTTTAGTGGAGCTCTATTTGGAAAGATGAATAAATAAGTGCCATGTGAAATGGGTCCCTTTTACTCAGGCAGATTAGAATGGAATCTTTCTGAAGGTGAATTGTGTTTCTGAGGCATTATCTATGCTTGCATTTCAG
>TTN-213,,0,140,2767277,2767416,GTAAATGTAACCAAGTATAACCAGATAGCCAGTTTCTGAATCATGGGAGTGGGGAGTAATAAAATATTTTGCAACCTTTTACTCTTTAATAAACTTTAATTTTCACATTCTTCTAATTTTATGCTAAATGTCTTTTACAG
>TTN-213,,0,86,2767417,2767502,GTGAGTTGCTCAACAATGTAAAATTTACCCTATCTGAATCTGCAGTTTATTAGTTCAGTCATGCTAACAAAACTGTATCATTTCAG
>TTN-213,,0,142,2767503,2767644,GTAAGTCAAGATTAGCTAATTATATAGGAGAGGGGTTGCTTGGTTGTGTAGGGTGAAAAAAGGCATAAAATATCTTGATGATTTGTAGGAATAACTATATAAATGATGTTCTTTCTTTCCTTCTAACCCTCACTCCAAACAG
>TTN-213,,0,125,2767645,2767769,GTATGCTCTACTTGTCAGCCACGTTTTTGTATTTTCTCTGCAAGACTTCCTGATACACCCCTGCATTGATCAAGGGTCATCAATGGAAACGTATTCTGACTTCATCCACTGTCCACTTCTTTCAG
>TTN-213,,0,112,2767770,2767881,GTAAATAGTTTTATCAAATAGTCCACCCCAAAATCATTTTTTTTGCCTTTAGTTTTATATTTCTTCTTTAAAGTGCTTCAATTAATAAGTTCTTTCTTTTTTTTCTTGATAG
>TTN-213,,0,846,2767882,2768727,GTAAGTGCTTTTTAAATTTTAATTTTACTGCATTAAATTCAACAGAAATTTGTGGAGTATCTATTCTATAAAATAGTCTTCTAAGTGTTATATTGCATGAAAGCAGCCCAACTCCTTAAGAAGCTATCACATATGTAATCAGGCTTATTTCTAAAACACTTTACCTTCATTACTATAAGTTAATGAAGATTCTAGCTTACACCCACAAAATAGCCAATTAAAAGCCAACTTAAAATTCTTCATTAATTATTGAGCCCTGTCATGTTTAAAATAGGAGTATATAAATACTTTCTATCTCTTCATTTTATCAAAATTATTTCAGAGGAATGTTTTTCAAGTTTCCCATAAGAGAAGATATTACATAATTTACATTAATAAGCCTCATTGTTTTTCTTGGCCACCTAATATCAACAAGATTAAACATGAAGGCTAACATATATAGACATGATTAAAGGCAAACTATTAATTGATTAAGAAAAACTAACAATGTGAACCTGAAAGCTTAAAAGTAAACTAGACATAATAGAGTTGCTAAGAATTAGAAATTTACCCAAATAATGGAGGAACACAAAATTGTATTTGAAGCTAAATTTCAGTCTTTTTAGCTACTGTTAATAAAATGTTTCAAAATTCAATATGAATGGATTAGATCTTGATAAATCCCACACACTGATTCCCTTCCTAATATTTAGAGAACTTTTGAACATAAACAGGTTAAATGATTGAACACTTGACACAATTTTAAAAGATACTCAGAACTCTGTGAGTTGTGTCTTAAACTTTCCAAGAGATTGTCATTTCCCTAAGGTGATTAATAAAAGCTTTTCACTTATACTTTACTTGCAG
>TTN-213,,0,90,2768728,2768817,GTAAGGAAATTTCCATGAGTTTCACTCTTGAAGCATTGGGGTTATTTGTGCCAGAGGCTAATGACCCATGCTGGCCCTTCACTTTTCTAG
>TTN-213,,0,436,2768818,2769253,GTAAGGCTATTTCTGAACTTGTCAACACCTAAAGGAGCTGTGTGAATTAGAAAAGAACAGGTGAAAGTCAGAGTGGATGCAGGACATTTAAAACATGATAGCAGTTTCTCTATCAGACCCTAAGCCAAAGAGAGATGTCAGGGTCTATGAATGGGCTCAGACTGGCACACTTGCATTACTTTTGATCCAGCAGAGTGAGTATAAGGTTGTAGATACTCTGTGATGCTGCTAGTTGGCTCAGAATTATACAGCTAAAATAAATGTGGCTTTCCTCTTAGTACTTGTAAGCTTTACTTCCTAAAAAAAGAGCTCAAAGTTATATAAAGTTTCATCACCATTTATTTGTTGCATTCCTTTAATTAAGATAATCTATCCTTAGAACAAAATTTCAAAGAAAATTATTTTCTATGAAAGTTTTTCTGTTTTGTTGGTACAG
>TTN-213,,0,797,2769254,2770050,GTAAGTATTGTATATTTTTCAGGGAAATTAAATAAACACTTTTTCAGAAAATGAATGTGAGTGAAATTAATTGGACCTATTTTATTAGTTAGAAAATATTATTAAAACACAAAAACTGGCTCTCTTGTATTTGCCACTTTGACATTCCAATACAGAAGTGGTTCAAATCGTAAAGTTTTGGAAATTTTGTTGACCTTGCCATTTGAACAAAAGAAAATTTAGCAAATCAGATTTTCCTGCTCTGTAGTCCTCTCATTGAAAGTAGATACACATACAATGAGAATCTAACTCAGAACCCTTAAAGACCACTTCCCTCAAGTGGCTGTGCAACTAGAGCACCAGAAAGACAAGCTTTGCTGTGTGGGCATTTTAGATTCAAGAAAGAAGGTGGGAAGCATTAGGCTAACGTTTCTGGAAGGTGCAAAGTGTTTGATGGATAGGGACAGCCTCTGATTGAGGGCCCCTTGTCCTCTCCCAATCAGAGTCTTAGTTATTTTGGAAGTCACATACCTTATGTAGCAAGAAGAACTTGACGCCTGGCAGAGAGACAGATGCAGCACAGATTTCTCGCTGACCTTGTACGTCAGAACGAAAGGGCCCCTACATATACTCGCTCTCTGGCTACCAGCTCTCCCCTTCTCAGCGCCGTGGGGCCACGTTCACGTGGGAGTTAAAATAGTGGCCAGTCCTGTGGCTTCTTGAAGAAAGCAACCATGAAGATTCATATCTAAGTCTCTATTTATTCTTTTGGGATTACAAAATGAGTAACGCAAAGCTGTTTCTTCCCTCTCGAAAAG
>TTN-213,,0,3904,2770051,2773954,GTAAAAAGCAGGCATGCCTTGTCTTTCCCGTTCTTTTTCTGGAGTTCTTCCACCTTCACTTGTATGTTCCTTATTCTTTGCTCTTTCTAATGTCTCTTCCTCTGTCTTTGCCTTTCTCTTTCCGCCTTTAGCCTGATTTCTGCTGAAACTGTAAAGCCAATTTTTTGCATTTTTTCTTAGGTTTAACCTGATGATTTTTTTATTGAAATTGAAATAAATTTAAAGTATGATCATGTTTTAGTTTTTTGAAGAAAAGACAAGACTCATTGACTATGAATGATAGTTTGATTAACCAGAAGGCAGGAAGGATCAAAAAGGCTTTCTGATTGCACGCTCTGCAGCCATGGTGCACATTAAGTTTTAAGACTAACGCTCTCCATCCTATTTAGTGTTCTGCATATAAGGGGATTAAGAGGAGAAGACTGAAATTCCATTTCGGGCAGTTGATCAAGTAGTTGAGATAACTTCTGGGCAGATTTGCTCTTCAAGCATTTCTCCAAAGCTATTTTTAACCTTCAAGTGCTCTGGGCTGTGCGATATCTGGAATGCAAGTGGACTATTTAAAGTGCAACTGATGGTACTGACAAGAAAGAAGGGCTCTGTGGTTATCCACATATGTGGATGAAATATTTTTTTTAAGCTTTGGTAAATAACTAGCTCCTGCTTTTAGCTTTTACTAACATTCTTTATGCCCAAGATTTTACCCATAAGTAAAAACTAAGGGATTATTCAGATAGGCCCACAATACAATTTGCCTAAATTGATCTATATGTTTTGTCCCCAGAAACAACATATGTCTTTAAATTATCTTGACAATCCATCATTAATTTTGAATTCTTAAAATAAAATATATGGAATATGTCCAGCCTGGGTTGGAAATAAAGCACAGGACAGTACATTGTTCTGTGACATATTCCCCCAATATTTCAGAAATACTATTAAATGTGCTATAAAGATCTCAACAAAAATCAAACTTTGAAGACTTAAAGGAATATAATTAAAAAGTGATTCAGTTTAACAAAAAGCCACAGCATTGACTGAAGTATTTGAAAGCAATGCCTTCAAGTAACTGCTTTGAAACAAACAAACAAACAACAACAACAACAACAAAACTAGTATTCCACTAAAGTGATTACAGGGTAATTCACCAGCAGTCATCTGATAGGTAACGCCTGCCTGTTATACAGATAATAAGATCTTCTTGGTCTCCTTTTCCAGTGACCAGAAAAAGCAGCAGTACATTCCATTTGTAGCATGGGAATTAAGTTACATATCACAAAACCTTCCTTACAATGAGGTCTTCTAAATATTGAACTGAGGGAGGCACCTCTACCTTCAAGCTTATTGTTTGAAAAAATATATTTTGCCTATCATGCATGATTTAATTAACTTCATGTCTAAAGGCAGAGAATTGGTTGCTTTTTCAAGATTCTTTCTAGATCTGCAAATTCATGATTTATATATAGGAACACTGCTTAAAGACAAATGATATTATTTTTTCATTACCAAATATCTTTTTGTCATAGTAAGAGCTTCTTATTAAAAGATCAGTCTCAGTTCTAATACAAAAACTGCACTATTTTAATTCAAATGTAGACTCCTAAAAATCTTATTCACATTTTATTTTTAAAAAATTCTCATTGTAACTAAAATTTTTTCTAGGGTTAGAAAGGATCAGTTTACTATAATTCTATAGGGCCCCTTTACATCTCTTTTGGCATAGGAATTTTAATCCTTTACTCTAGGCACCCGAAATACCTTAGCCTTTTGTGAACTTGCTCTTGCATTACTTAAATGTCTCTTTTCAAAAAGAACTTAAATATAAACTTTGAAGTAATAAAATCATTTTGTTACATGTGGCAGATTTTGTTTAAATTAAGTCTGTCAGAACAAACTTGCTCTTGTCAATGTAATTCCGAACTTTAATACTCATTTTATGTAAAAATTTTCGCCTTCAAAACTACAATAACCAAACAAGCAAAAACAAGCTGTAGGAATAGGAAATATGAAGAGAAACTTGTAGACATGAGTTGTTTGCATTTTTTCTTTGTTGTTGTAGTTGTTTTTGGCTGTCAGTTTAAGAAAGGACTGCCAAGTTCCAAATGGCATTTGATAATTTTAAAGTTAAATTTTAAATTTGATAAAATTAAAGTTTAAATACAAAACTTTAATAGTTTTGTCATGGTCATAAGCCTACCGTATTATATTAATATGCTTCCACTATAAATAAATATTTTTAAAATCTCTAACATTATTCTTACAATCTACTGCAAAATCTTCAACATTCATTTCATTGGTTTATTTTTATAAGGCACCTACCAGTTTTCCTTTTTTTTCTTTTAACATAGTGGAGGTAGATTGTATACAAGCTGTTTATTGAGACATACTGCATTCTGAGCAGTGTCCTAGAGTAGCTACAGAGGAACTCAGATGATAAAGCAACATAATATTAATAGATAAAATATATCTGTGGGTGGGTTAGAAACTGAGACACCTTTTCAAATAGCCAAAAGTTGCATGCCAAAATTTATACTGAAATGTTATTAAAAAAACAAATTTTTCCCATTTCAGCACCATGCCCTCGGATAAGTAGCTCTGTTCCAAGGGCATATTTAACTACCCCCTCCTAGCTGTTATTTTTCCTTATTATGTTTTTTGGCCACTCTCAATTATTAAGATAATTATGTGACTAACCATGCCCAGTTCTTAATTAAAGAAAACACTTTTAGATGAAACCTTATTTCTGATTCTTTTCTTTACACTAGCATAACAAATAGTTCCACTGGTGAAAAACTTTACATTATTTTTAACGCTAAGTAAACTCTTAAGCAGTGCAAAATCAGTCTGGATGACAGGGCACAGCTTCTTAGGAATTTTATATCATAGAACTGGAAGAACCCCCAAGTCTCTTATCTTTGCTGTCAGAATGACCCCTATCTGTCGCACCATTGACATCTGATTTTCCCATTCCTGATGCTTAGACACATGAAAAAGGAAGAAGAGTCCAACTTTCATTTGCAGTTTTGAACAAAATTAATAGGTTGTACAAATTATTTAATCACAGGTTTAATTGGTTTGCAAAATAAGTTTAATTGCTAAAATAAATGGGAAGAAGAGTTATAGCTTGTTGTTGCATGGCAAACACCTTACATACAGAACATAAGGTTTACTTTTAGCTTGCCATAGCTGATATTTTCTTTCATCCTTTCATGAATTCGCTTTTCTAAGTTCTTCCTTTATATGTATATAAGCCCAGGGGCAGAATGGGGGCACACATATATATACACATATACGTATATACTATATGTGCTGTATATCTACGCATATGCAAAAAAGACCACAAATGTAAACAGAAACTGGCCTGGGCAATTTCAATGTGAAAGGCCACCTAGTAATTATATAAAGGTAACTATGAAACCCTAAAATTTTCTTGAAAGATCCCAAACTGCATAGTATTCCATGGTGTATATGTGCCACATTTTCTTAATCCGGTCTATCATTGTTGGACATTTGGGTTGGTTCCAAGTCTTTGCTATTGTGAATAATGCCACAATAAACATACGTGTGCATGTGTCTTTACAGCAGCATGATTTATAGTCCTTATACCCAATGCTAGATGATGAGTTAGTGGGTGCAGGGCACCAGCATGGCACATGTATACATATGTAACTAACCTGCACATTGTGCACATGTACCCTAAAACTTAAAGTATAATAATAATAAATAAATTTAAAAAAAAGATCCCAAACTATTGGTTGAAATGATTTTTGAATGCATACGTGCTAAATAGATGATTATAAAACAACTTGGAAAGCTCTATTTCCATTTATTTTTATCTAAATGAATTAAATGCACCCATATACTAGATTGCTGTTTCATGTATTCTTTTTTTAAAAACAACTAG
>TTN-213,,0,541,2773955,2774495,GTAATTACAAGGCTTATTTTAAAAACATGTATAAGGCAGAGGCTCATGAACAATGCCAACTCTCAATTATCTTTATATGATGAGTACTATAGATGTTTAAAATCAACCAAATAATCAAAAGTCTGATTTTACTTTTTAGCATAACAAAATAATTCACAGACTATCTTTTTAAAGAGCCAAAATTGACTAGCATAGGTTTTACTTCCTCCTTCCATCTCTATTGTTTTTATTGCACATCCTAGATTTTCAAAAGCCAGCTGGAGGAAGAATTATTATCAAGCTAGGTATCCATCACTTTATTAACCAAGAGTTGGCTGTTATTTCCTTAATGTTTCCTAGTTTTTAAAAATGATTTTCCTCTTGTCTGTACAAATAATGATAAAATATCATTTTTAGAGGAAAATGTCTGAGTGTAATCAAAACTTGAAAATAAAACTTAGGACAGAACAAAGCCCTGGAGATGGCAGGGGAAAGTTGAGAAGGTACCAAAACTCTTGGAGAAGGAAAGGAGTACCTTGGCTAATGAGTATGATTCTTTCAG
>TTN-213,,0,1697,2774496,2776192,GTAAGTATTCTTCTTACAAAGGACTTTTCATTTGCAATTCTTTAATAACTACAACAACAAAACAACACAACACTTTTTGCATGCCCTTCTTGGCCTAACTGCATTTCTTGGCAACTTCTAGTATTGACACTGACCTAACCTGATCCTTTATGTGTTTAAAGAAAAAAAGAAAAGAAAAGTCTTATTCTATGTCTGGTCTGATTAATGATGGAGCAATCACTTTTCCCTATGCTTCTTTTCTCTCACTGAGTAGTGAGTAGATGTGCTCTTTGTCTACATGGGGTCAGCCTACTGTATGGATATCCTGATATGGATGAGGAGAAACTGAATTTTAAAGATAAGTAGGGAGTCCTAATTTTAAAAACAAAGTAAAAGTGATTTCCATGTGGAAGGAAAATGAATTTTCAGGTGTGGGGAACAACTAGAAAATGAGCATGAAATTTCAGTCTGAATAGGAGCATACTAGAGATCTGCTGTAATATGACAAAGCACATTCACATGATTCAATCTCTGAGAATAAGAATGGATAAGAAGATGGAGTGAGGCCCTGGATCTTTTGAGTCCTGGACTCTTTGAATGAAGAGAACTCTAATGGTTTTTAACATTACTTCTTCCTCTGGTGAAAAATGTAATGTCTTTTTTCAAAATGCCACATACTAGCTTATTTGTTTCATTCATTCCTTTGTCCAGTGATGACATTTTTCTGCAAATTTTTTGTGCAATATTTGTTTGTTTGGTTTGGTTGCTTCCCATCTGTCAACAGCTACAACCTAGTGACTCTGTGCTTCATGCATCTTGTACCATGTTTTTCTTACCACTTTGTGGTTGCTCTGCTCAAGCTTATGTCAAAGTAGCTTCTTGGGTCTCCTTCTTCACCTTGACATCTACCTTCACTCCAAGAAGGCTCAGCTGCAAGGAGCATATTTTCAAACCTATTAGACAGCATTTGTCTCAGAATCTTATTGCTCAAGAATGGTCATCTTGGGAAGGACTCACAGGGAGCTCTGAAAGAAGGAAGGGCAAGGGGGCAGCTCCCTAATCCTATACACCAGCTGAATTAATTCTACAGATGAATGAAATAACAGATGTAAAATCCTAATCACCCTCCCATACAAAACACATTGCTTTATTGCACTAATAGATGTTATGCCTGACTTATATGTGACGTCTTCAAAGCTGATTTTTTTAAAAAGCTAAATGTATGTTTCAATTACAGCCTCATGCCTCTTAGCCATACACAAGGCTGGCCATAGTGCTTCACGTGTTCTATCTTTGAATTCTGCTAATTTCTCAAAGATTGTGCTAAGTGCCTTAAATAAGACAATGTTTCTTTGCCACTGGTGTCTGAAGTTTCCTTTGACATTATCTTTCAAGTCTGGTGCAGTGCAAATGAAGATTTTTCCTCCAGCTATTATTCAAAAGAACTGAGATGGCTCCCTAGTATATATACTGTACACACACACATGCACACTAGTTGAACATATAGAATGCCACATAATTTTATGTAAACTAAAGAGATATCTAAAAAGCAAAGCATCATACCTGATGGGCAGCTTCAAGTGATTTCAAAGTCAGTTGTAGTCTATTAAGATGGAAAATCCCTAAAAAAGAGTCACTTTTTCTTAATGTATACTATGGTAATGTCAGAGTAAATTTCCAGAAACCTCATTTTGAATTCTGATGACATTCTCTTACAG
>TTN-213,,0,661,2776193,2776853,GTCTGTGACTGTATACCTGTCATCTTGTACTGTCAAATAACTTTATATTTACTTTTGGTCTAGCCAAAATGGAAAAAAAAAAGTTAGTCACAACTTCTCTGGTCACCACTTTACTTTTAAAGATAATTGTAGTATAAAATGTATTCTTGACTTTAATTGCTCTCTTTTTAGTATTATTAATTTACTATTACTTGAAAAACACTGGACTCACAATCAGGAGATTTAGATATTAGTTTGAACCATATGAAAGTGCTGTTTTCTTAGATCAGAAAGTCAAATATCAGCAATTATATTTCTTTCAACTAAGTACCTCCTGTTGCTATTAACTACCATTGGCAAGTTTCTTCAAGTCTGAGCCTTAGTTTACACATCCAAGAAGTTAGTCTGCATAATGTCTAAGGCTCACTATAGCTCTAAACTTATATGATCCCATTGTTTTTAATAACTGATAATAGTATCACAGCAGCTAACTTAACAGTAATTGGTAAGATTGTTCTTGCTTTTGGGGTTTGTTTATATTTGTGTCTGCCACCTTGGTTCTTCTTCACACTATGAAGTCTTGTTGGTTGCTTTCAGAAAAACTCAGGATCATAGTTTTTCTTAAGGACACCTGTGTGAAGGAACAACAAGAAAACTGATAATCTATTTATCTTAAATATAG
>TTN-213,,0,98,2776854,2776951,GTAAGAGTAAAGTCATTCTTTGTGAAGTATATGTGTTGGGAAAAAATAATAATTTCCAGCTTAACTCAATGTGGTTTTTGTTTTTTCAATGCTTGCAG
>TTN-213,,0,106,2776952,2777057,GTATGAAAACTACAGTGAATAATCTTTTATTTCTAACAATTCACACTTGCTAGATTTAAAGTACAAAGACATATGTTTCTAATATCTTGTAACTTTTTCTTCCCAG
>TTN-213,,0,108,2777058,2777165,GTAAGTTTGTTCTTGCTTTTAGGGTTTTTTGTTTGTTTGTTTGTTTTGTATTTGTATTTACCACTTTGATCATTATTCATACTATAAAGTCTTGTCGGTTGCTTTCAG
>TTN-213,,0,89,2777166,2777254,GTAAGTAATTTATATACCACTAGAGATTTTTTCATCAGTTTCTGTTATAAAAATAATTAAAATCAACATATTTTTCTCCTTTACAACAG
>TTN-213,,0,104,2777255,2777358,GTAAGCAAGATCTTTTTATTCTCTATTTCTGTAGCTATATATACACTTTTGACAATTTAGTGGCCATCATTGCAAGCTAACTGATAATCCAATGTCTCCTTTAG
>TTN-213,,0,100,2777359,2777458,GTACATATTAAGTGAAAAAACAATTCTAATGTTACCAATTTTTTAAAATTGTTAATCAAAATGTAAACATATTTGTATTTATTTCACATTTTCTTTCCAG
>TTN-213,,0,767,2777459,2778225,GTCAGTCCCTTTATTTTAAAATATCCTTCCAATATCACAGAGTTTAGATTTCAGATTTCACAGTTATTTAATGAGGTAATCCTTGTGAGGGTCTTTCATTTCTAGCAAGCCCTACCCACATGTTAACAACTCTAATTTTGCTCACTACAAAGTAAGTGTCTTGAGTAAGAGGAAATTAATAGCAATAATCTTTACATGCCAGAGCCTTGGACAGTTGCTAGTACATGATGACTATTTATGAACTTAGGCTACAACTAAGCTATCACCCTGAGAGTCTTGGCAAATCTAAAGACGGTCTTATACTCTCCTACTTTACAAACCCCTGTGTGCCTTTTAGGTATGTTCTCATCCTGACCCAGGACATCCTTATACACTGTCCTTATGAAAAAGCCATTAGTGTACCTCTCATTCATAAGAAAAAAGTTTCTCTGATTTATTGAACTAAGTATGCAGTGCCTACTCTATCAAAAAACAAAACAAAACATGTTTTGCACTACACTGAGTCCTATGTTACTATTTTTGGCAAGGAATGCATGTCTTATGATTTTATGCCATTCTCAATCCTCTACTCTCCAATCTAATTTGCACGCACAACAACAACAAAAAGCTATGAGAACTCTAAGCCACTTAGTTTTCTCTGCTATAAAGTTACTGTAGCTTACTTCCAAGGTTATGTAACCAATATTTTCTAATAAATGCATAATAACATGATGTAGCTTGGCTACGTTTAATAGTCGAAAGCGTTCACATGTTATCTTTCTCACTAG
>TTN-213,,0,92,2778226,2778317,GTAAGCCCTTGGGTCTCTCAGACTTAATTGGCAAAGCACAATTTAAAAGCAAGACAGCACACTAAAAAAATTCCTCTATATGTGAATTTCAG
>TTN-213,,0,107,2778318,2778424,GTAAGAAGTTTTAAGTAAATTCAAGTTAGCTTTTAAGTAAATTGCAGTCTTTGCCTTCATCATCGTTACCCCAAACTCATATTTTCTTCTTCTGTGGTGAAATCCAG
>TTN-213,,0,266,2778425,2778690,GTAAGCCCATCAAAAAAGGGAAATAATTACTGCATGAAATCCAGATATTAGGCCTATCAATTAAAATAAATCAAGTTAAATGAAAGTTAATAAAAAGGTAGAATATCATAAAAATTTGGATAAAGTTTTAGAAACCCAGACTGTGCCTACTTTACTTAGTGAATTTGATAAACCTGTTAATGAGGATGATATAATTGATTACAACACTGTTTTCATAAATTGTCACTAACGTAAATGGTATGCTCCAACTCCTTCTTTTATTCCAG
>TTN-213,,0,90,2778691,2778780,GTAGGTCATTTGCATATAAAAAAGAATATTCAATGTGGATCATGGACATAACTGTATGTGTTTTTTACAAATATTAATTCATAATCGTAG
>TTN-213,,0,106,2778781,2778886,GTAAATAGATATTTTATTTTTAGATCGGGGAATAGCACATAGCTACTTTGGGGCAACAGGGACTTAAATATGGCACTGCAAACTCATTAACTTTTCTTCTTTGTAG
>TTN-213,,0,98,2778887,2778984,GTAAGGAACAAAACATTTATCATCTAAGGTGATTTGGCAGTATTAACAAATATTAGTTCAGACTATTAACAGTGACTCGTGAGTGCATTTTTTTTCAG
>TTN-213,,0,690,2778985,2779674,GTGAGTTTTGAGCAGCACTGCATCAATGCCAAAAATGAGAGTAGGGGAAATCCCAGAAGGTTGGGATGCCATACAAAAGTCTTATGTGCTACAACTTCTTACCTTTACCTCACTGAAAATGTACAAAAACTTTTTAAGAATGCATCGGTGCTAATGCTTCCTGAGGTAGCTCAACCAAGGATTGTATAATTGTAATTGTCTTGTCTTGTGAGCCTTACCAAATTTGTAATAAAAAAAAAAATTCCCTACTGACTTGGTACCTGCTAAGTACCCAATATGTACCCATTAAGCTAGAAGTGGAAAGTAAATATTTATTTCCCTGGTGGTCACACTTCTTATTCCACTAGAATACCTTAGTTGACCTAATCAGCCATTATTTCCTTGTGTTTATATTAGTTACTATTCTTTACCCTGAATTAAAATCATATTTCTGATAAGCAAACTGGTAGAATCAACACCTCATTTGCCATCTTTTTTCATGTGTACAAACTATGAAGCAGTTTTTCTTATATTGAGTCAAATATTATCATGTATCCTACTTTGCAATTTTCCCTAATATGAAATTAATGTAAGAATAATCCCTAGCATTCAAAACAACTGCAGTTTGTATCCCTGGTCATGGTAAAAATCTTTTGGGTTGGCGAAAGGGTTTTTTGGAAATAACTGATTAACTGTATTTCTTTGTCCCAG
>TTN-213,,0,156,2779675,2779830,GTGAGTACATTCTTGATGATTTCTTACCTAATCTTGTTGCCTGTTTTTGCTTTTAGACCTAGAGTTGAAGTTATGGGGCAAGGCAGGGGTTGGCAATGTGAAGAGAACTGCATAGGTGGCCTGTGTAAGACTGACTCTCTCTTCCAAATGTTGTAG
>TTN-213,,0,338,2779831,2780168,GTAGGTTTTTAATTTGGCATGAGAGTAAATGTGTACTCCTAGTCACTAAAATGGGCTTTGTTGGGGAAAATTTAAATGTTTGTCTTTTTTCATTGAGAATCCTATGCTGCCGGTGTATCTGTCTGATTTTTAAAGGTGCTGCTGAATGTACTGCCTGCTCAGGGTTTTCATGACAGTATTGAAATGAAAATGTATTCAGTTATAGTGTTGAAGTAATCCAGGTTTAATTTAAAGACTAGTATTATACCAGGGGTTTGAATTTTTGAAAGATTATGAGTACTACACAATGAAACGATTATCGACATCACAGTAAAACATCCTATTCTGTTTTCTGACAG
>TTN-213,,0,93,2780169,2780261,GTATCTATTTTTGATTTTTGTCTTATCAAATAGGCCTCTGACCTTAAATCTGCTTGAACTTGATAACATCATAAATAATCTTTTCCAATTCAG
>TTN-213,,0,117,2780262,2780378,GTAAGGAAGGTTCTCATTTTAAAAGGGGATAAACTCTTTGCAGTTACTTTCTTGAAAGAAAAAAATAAAAAAAATGGTGAACAATTTTTTTTTCTGCATCTGTAATGCCATACACAG
>TTN-213,,0,114,2780379,2780492,GTAAGTTTCTCAATCAGCTGATAAAAAAAAAAGGATGCTTATGTCAAACTTGCATTTTGGTGTCATATTTATATACAGGACATATAACATTTTACACCATTATCCTGTCTATAG
>TTN-213,,0,474,2780493,2780966,GTATGCTCAGAATCCCCATCAAGATGTTAAGACAGCAGTATATTCAAATGTTTACTCTTTAGTATTCCTTGGGATTACAGATGATTATATATTACTAAAAAAATTTTAAACTACTTTTACTCATATTTTCTATTACCTCATAATTTGAAAAATTATATAAATTCCATTCAAGGGCACATTTCTTAGTTTACTCTAAAATATTAACCTTCAGGAAGTTTCAAAGTGTTTGATCCCCCAGTATATTATGATAATGACCACTGTCATAGATATTATAATTAGATTGGTATGTTTGGCCCAGTCTAAAGTGTGTGGCAGTTAAAAAGCAATTTTTAATTTATATTGAAGTGCTTTTCAGTTAAATTTCCAAATCACCTTTTCACAATTTAAATAAATTAGTCTCTTCTGTGTAAAATAAACATAGGCTTCTTCTGCTTCTTACCATGATGATACACATGCACTTTGTTCCTAATTCAG
>TTN-213,,0,88,2780967,2781054,GTATTATTTATATAATTTTTGTGGTTATTTCGAAGTTCATATGAACTCCTTTTTGACAAACCTAAACAATGATTTCATTGGCTTGCAG
>TTN-213,,0,196,2781055,2781250,GTAAGTCACTCTTGATGTCTGGGATATATAAATTCTTCTAATATCTGCCTGTGAGCTACGATATGAGAAAATATGAAAAATTCATTACTATTATTTCCTCCTGGCTACATTACTTCTTAATGACTGCCTGCACTTTCAGACTGACTATTGGGTAATAAAAAAAAAAATGAATTTGTTTTCCTTCCTTCTTTTTCAG
>TTN-213,,0,114,2781251,2781364,GTATGCTCTTGCACTTAATCTTTGTGACAATAAGTGCTCTCGCACTTAATTTTTGTGACAGGAGATTATCACCTTTCCTCTGGTTTTCCTAATCATTGTTTATTTTATTTTCAG
>TTN-213,,0,102,2781365,2781466,GTAGAATTTGAATTAATTCATAAAGAATAACTTACACTTGGCTGCAAATTCTTAACTGTGTTTTTTCATTAATGCTAATGAAATGCTTTGTTGTTTCAATAG
>TTN-213,,0,80,2781467,2781546,GTAAGTAGTGCTGATTATACACAAGATATTGTCTAGAACTTGATGAGACTGTGGATATGAATATTTCACTCTTTTCTCAG
>TTN-213,,0,100,2781547,2781646,GTAAGAGCACAAGGTCTTTTATAGTTAATAAAATACCCTTTATTCATGCATTGCATTTTGACATACTCTGTTTTTTGCTCTTTTGAATGATATCTTACAG
>TTN-213,,0,603,2781647,2782249,GTAATCATTCTTTGAAGAAAAACCAGACATTCTTCACATGTAGAGGAAATTAGTTAACTTTGCAGTGCTATTAATAATATAATTGGCTTCATGAACTGGCCACTTGTAAACTAAATGTCACTTCTGATTATGTCTTTCCATAGGAGAAGTAAAACAATTCTAAAGAGATGAAATCGCTAAACGCTTATTAGACTAATTTATACTAGTTTTAGTTAATTGCATGTGAAATACTAATTTAAATAACAGATATTAGCATACCCAAAGAGCATTGAAATGACCACAATTTTTTAATTGCACAGCTTCACATTTTCCCATAGTGTTCTTAACCAGGGATAGTAACATTTTCTGCATTCCCCCCAGCCCTGCAAATAATGTCTGGAAATTTGTGGGGCCATTTTTGCTTGGCACACAGACTTGAGGTAGATACCACTGACATTTAGTAGTTGGGAGCCAAGGATGCTAAATGCTCTGCAGTGTGAATGACACTCCAGCACATCAAAGATTATCCTACCCAAAATACAGATAGCCCCACTTAGAGACAAGTGCATTATTAAAATGCTGATTTTTCAGGATTACTAGAATAATTATCCATTTTTGTAATAG
>TTN-213,,0,103,2782250,2782352,GTAAGTTTGGACATGGATGCACTATGGCTAAGAACTAATAAACCATAGTTTTGTTTTAAGAAGGTGGTTTTCCTGATACTAACATTTTTTTCTTGTTCTTCAG
>TTN-213,,0,113,2782353,2782465,GTAAGTTTTGTTTCATGGAGTTGCCACTTTCCCATTTTGAAATAAATGAAAATAATGTTTTGTCAGTTATTTTCATCAGAATTGAAAACATTTATTGGTTATGATCACTATAG
>TTN-213,,0,299,2782466,2782764,GTGAGTCATTAAAACTACACTTTCCAATGGAAAAAGGTTTTAGTAAAACATAAAAATAAAAAGTTTGGGAGAGAGTTAAAAGAAATGGGACATAGCTTCAGCAAGTTATCCTCAATCATATTTTATCTGCTGGCCATGTAAAAGAAATCACCTGATCTTGTTATTTATTAGCTAATGGAATACAAAGATAGATGTGGGAAAACCACAAATCATGTCAGAGGAGCATGCTCACATTTATATTTTCCATAGCAACCCTTCCCACACAAATTTTTGATTACTGTTCTCTTCTGAAATATTAG
>TTN-213,,0,128,2782765,2782892,GTAAGTTTCCTTTGGCATCTAAAGTTTGCCTTTTTACCATGTACTTTGGTATATAATTACTACAGCTTTTAAAATTGCATTTTTATGTCATACTGGGAAATTTACTTCAAATGTTATTTTTTTATCAG
>TTN-213,,0,96,2782893,2782988,GTAAGTAGTTCCTTAAGAAGAAGGTGGAGTAGAACAAGCTATTGTACATTTTAAAACCATCAGGGAGTTTGATTTGTCTATCTTCATTCATTCTAG
>TTN-213,,0,99,2782989,2783087,GTACTTAACGTTATTGGAATAAAATTATGGATATTTTCTCTATATGGGACTATTTTTTAATCTTTCATGGGCTAATGCATGACTGTTCTCTTTCAACAG
>TTN-213,,0,86,2783088,2783173,GTAAGGAATGTTGCACTGATTTTCACAGGATTTTCCCAAGTGATACTATCTTATTACATTGATTTTTGGCTTTGTTTTGTTTTCAG
>TTN-213,,0,1307,2783174,2784480,GTAAAAGAGAAGGTTTCATTGTGTTTATAGAGTAATGTTTTGCTTCTAGTTATATTATTTACTGAGCTTTATGGCTTCAAACTCCCAACAGTCTCAAAATCTATAGCTAAAGAGTAATAAGAAAAGTAAATCAAAAAACTATTAGCAACATTAAAGATATCATATTTCCTATAATTTCAATGTAATTTGTGGCTGTAAGTATATTAATCATGCATGGTTTCTTGTACTGAAAAACTTGGATCTACAGGGGCTTAATAATAACCTAGAAGTAGTTTAGACATATTATATCTCTCCAGTAGAACACATTGGAAGTCGGGTTTTTAAAACTTACTAGCGTAGTAGTTAAAGAGAATTCAATGTTCTTCTAAAAGATTAGACAATTCCTGAGAATAAATGCCTTAGTCTTCCTCTATATTCAAAAAGTCCCCATACTGGAAGGATAGAGAGGCCCAAAACCAGAAACAGCCTCCAAAGAATAGAAAACCAACCAGAGGGAATCTCCCAGAAATCAATACGAAACACTAAAATTGCACACACAGTAATGCACACTGACATCCCATCTAAGAAAGCAAAGGCTTTGAGGAAGACCCATTCCTCAAGAGACAGAAGAACTTATTCCTTCACCATCACCCCCTGAAAAAAAAAAATACATCCTATATCACTGCTGCAGCTCATCTATGAACGTCCAATATACCACAGGCTGTGCCAGAGGCACCAGAACAGAGCTGAGCTTCCACTCCTTCTGGTTGCAATAACAGTCAACAAGTATGGATTGGGTCTAGTTTTACCACTGAAAGCTTAACTCTTAGTTTGGTCCTTCAGGAAAGAAAACTTCAGCAGCATTACATACATCCTCTTTCCACCATATTTTGAACCCACATGTGAGGCAACATGACTCAAAGTATGTTCATAGACATATCCACTATCTGTTAATAAAAGAAAAAACACTTTGCTCTCAGCTGGTCATTCAAAGCAAAGCTTCACAGACTTACTTTCCTAGTTCAGTAGAATTAGAAGCATCCCCAGTTACAAAGGTAAACAATCTAAAATGTTAAATTAAAAAAGCATACGTGCCCTTGATTTATTTTTCACTGATAATCTTGATGAAAAGTTTGCTAAGAAAAATTCTGTCTACATGAATGTCTATAATTTTGGCAACTGACAAGTTTTAGGAATGATTTTAAATAAGGATGTAAGGTTATGCCAAACAGAAGGCTATTTTTTACATAATTAAGTTGAAGTGAAATATTATTTCTTACATGAATATTTATCTCATGCTAATCATTTTCACTTGCCTCTGGCTAAAG
>TTN-213,,0,118,2784481,2784598,GTGCGGAATCTGAATATAATAATAATTTTAATGCATTTTACAGTGTGCCTTTATCCCATAAGTTGAAAAAAACATCCTTATGACTTTGTTACTGTTTTTCTTTCTCTTCTCTTTGCAG
>TTN-213,,0,88,2784599,2784686,GTAAGTGACTTGCTTTCTTACATCAAAAAGGCATCCAGTGTCTGTTTAAGAATTGCCTTCTCAATATTCTCTGTTGATTCCTTTCCAG
>TTN-213,,0,402,2784687,2785088,GTAAACTCTTCTGAATATTTTCTTATACACATTAAAAGTACATGACTCTGGTTTGATGCCATTTTAATATAACCTTGGAATTTGATAATTAAACTCAAAACCACACACGATAAGCTGTTATTTTGTTATTGTAGTGTTTAGCCCCACACACATAAGGCTCCTTAGTACATAGCGTTTGATACACAGATACTCTTTTAATTGAGATCCACTATCAGGTACAATACATCTACATATTTTTATTTTAAAAAAAGCTTTCTCCTTTTCTCTGTCTTCCCATGTTTTGAGTCTATATATTTATTTCTTCTTACAGTCATCCCTCCCAAAATAAGTTGAATTTTTAAATGAGTGAAAACCAACATAAGTATATTCTCTTCAATAAATTTCTGTTTTTCTAATTTCTAG
>TTN-213,,0,1285,2785089,2786373,GTAAGTATGCTTCCGTTTCTGGGGACTAATTTCTAAAGCACAAAGTCACTAAATGGATAATTCTGCCTTAAATTTCTTATATTTTTCTATGCCAAATTATTTTATTTATTAAAATAAAAAAGGTTCATGTTCACATAGACTATCGGAAGTATATATTTATGTGTGTATACATACATGCACAGATATATACATACACACATACATAAAATCATACAGTTTGTAAACTCTTGGATTAAACCAAATATTTTATGAGGAATCACAATAATAAAGACCTGGACTATAAACTCCTATGTCTTCTGATACTTTAAATAAATTTCTATCTCATTAGATACTGGGGAAATCATCTCTCCCACTAAACAGTCAGACCTTCCAGTAGGAATTCAACAAAAAACAGAATGTTGTTAGCTTTTCTATAATATTATTGAACAAAGATTTAGGATTCTCAGGCATAGTCTGTGAGGTCAAATAAGAGAGAAAAATTCTTCTAAAAGATCTGTGAGCAGATTCGTTCAAAAATTAAAAAATACTGTGGCCATAATAATTCATCCTATTTGCTACATATCTGATTAGATTCTCTATAGAAGAAAAATTCAATTATTTGTTAAAAAGAAAATTTTAAATACTCAAGTGCTATGTGGAGCATATATACCTATATAATGAGGTAGTTATTCATTCATTTGCAAACTAGTATTGAACATGTGCTTTGTGCAAGGATCTATATTAACCACTGGAGGGGGAAAAGTTAAGATTAAAAAGACAAGTACAGTAAAAGAATTTCTGTAATTGTAAAGCACTTTCAGAAAGGTAAAGGATTGTTATGGGATTATTGTAGACACTGATCCTGTCCCTAAAGGGCATTAAGATTAGTTTGTGTTCAAAGGTTTACTAGCTATTGATGGAATCCTTTTTAAATTTTCATATTGTGGCAAATTAAATTTAAATCATGTTTTCAGTAAAGGCTATTGTAGAATTTCTTCAAAGGGATCTCAAAAGTAAAGTAGTTTTTTACCAATCATGTATAAATAGAATGTAAATCTAACAAGATAGGAAGTAGTCTTTCTATTCCCAGTTAGTTGTTTGCTTTCTCTGTTTTTGCATTAATGCTAAAGGAAAATAGACCATTTCCTTTATTTCTCTTCTCTAGAAGGCAACTGTATTTCCTTTTAGCATTTCTATTTTAATATTTTAATAGATTAAAATAATATATGATCATGTGTAGTAAAAGACTCCAGCACTTCATCAGCTTCAAAATCTGATGAAGCTTTTTTTTTTCTTTTGTTATTAG
>TTN-213,,0,131,2786374,2786504,GTACTAGTACTTACTCAGTTTATGTATTCCTCTTTTGATCTTATTATGAAATTGATTAATTTACTGAAGATATTTCAATTACTTTTGACAAATATGAGCTAAATCCTGTTAAATTGTATGTGGTATTACAG
>TTN-213,,0,87,2786505,2786591,GTAGGAAAATAACCATTCTCCTCTTTTTTCCACTGAATCACTATAAGGAGTATTTATACTACAACTGACTGTCTCCTTTTCTAATAG
>TTN-213,,0,94,2786592,2786685,GTAAAAAAATAATAATTAAAATAATTCAGAATATGGTTGACTTCAATATTGCTATGATTTCATTCAATGTATGACTACTATTTTCTTTGTACAG
>TTN-213,,0,93,2786686,2786778,GTAAGAAAGACTTTGAAAGTTGCTACAGAATAAAAACAAATTATTTTTAAGCATTTAAGGAACGTTGCTTATATTGTGATTTACATCCAACAG
>TTN-213,,0,93,2786779,2786871,GTAAGCTTTAAAATCTAAATTTAAAATATCTTCTCAAAATTGAAGTATATTATTATAAACAACGCTTAATACTTCCTTTAATTATTTTTACAG
>TTN-213,,0,1003,2786872,2787874,GTAAGTACCAATGTACTGACAAAGAATGTCCTCCTTACAGCTGCCTTCCTAGGTGTTCAATAATAGTTCACAATTAAAAGAGCTATATCTGTACCTTAGGAAGCTACTATGGCTTGAATGTAGACATGGGCACATTACTTAATTACTCATTCCTTCAATTTCCACAGAATTTTCACATTCCCTTACCTGTTACCTTTTCCCTGTTCAAAGGAGATGATGTCTGTAATTTCCTCGCTGTAATTTTCCTCGCAGTCTGTTTTATTTATCAGAGGCTAAAGCAATTTCTCTGCATGCTCCTCAAAAGGGACAGAAAGTAACCAGTCATTTTCTTAGCAACTGCTGAGACCCATTTATCTTCACAATCAAGTTTTTATTTCTCTATATGAGAAAAGATATATCCATTTTAATGAAGTATATATATATATATATATATATATATATATGGTAATAATTCTTCCTCTGATAATTACCATCACTACTGTTGTGTATTTGTTTATTCTCTCATCTAAGTGTGAAGAAACTGTAGTCACTACCCTCTTTGAATATTTCTGTCCTAAATTTGTGCAAAATGGAAAATTGCTTTCCTTTTATTAACAGTTATATTTCTTAAAAGGGGAATTCACCTTCTTGTGTATCCCTTCATAATTCTGTGTAAATATTAAAGAGAGTATCCCATGATACTCTCCTACTACAATCTCCTCTCTTCCCTTTTGTCAGGATATGAGAATATAATAATACACATCATTACATGCATAATGATGCCAAATAAAGTGAGGCAAGCACAGATACATAGCCACATGTAGATCCAATAAAAGATGCTGACCCCGTGTACCTGCTCCCCAAACTAGCGTAATAGTGTTAAAGACAGAACCATTCTTTATATTGGGCTGAGCTACAAAGTCTGCCTACAGTGGATCCAAACAACTTTATAGTAACTGTGAATTCTACTTTCTATCCCTCAATGCTTTTTGCTCCTAATGACAACTTTTTTTAAATAATCTAG
>TTN-213,,0,108,2787875,2787982,GTAAAGACTGCATGGTTTGGTTAAAATTACTTGTTTTTCTGTTCATAAATAACATTTGGCTTTAAAATCATCTGAGTGATAAAGGGTTCCTTCTTTAAACCATTTTAG
>TTN-213,,0,83,2787983,2788065,GTAAGTAGGAGAACATTTTCACATACAAAGCCATTTTTACTTTTTTTTTAAATTTCTTATAATCAATATGATCTTTTTCACAG
>TTN-213,,0,93,2788066,2788158,GTAAGCCTGGAAACCATTCCTTTTTTTTAAATCTTATTTTCCAAAAGTGCCTTGGAAAAGTCAAGAATACTAACGTATACTGGCTCTTTGCAG
>TTN-213,,0,447,2788159,2788605,GTAGGAAAACTTGGCACTAAGGAAATGCACTATGAATAAACTAAAAAATGTCATAGTTATTCTCAATCCCATTAACTTCTGTCTATACTTTTTGGATTAAGAAATCAGGAAAATAGCATAATTTTAACTCACATTCCAAACATCTGTTAATGTCAGAAATCGAATCAAAAGTTAAGTCATGTTATTACTAATCTTTTGGTTATAAACCCTGGAATGTGGAATAAATAAATCAAGGTTTAATCATTTGACAATAATTTTAAAGCATAACTCCTGCCAAGTTATTCCATTCAGTGTTGCCTGTAATATCTGATCCCTAAAACCTAAACCAGCAACAATTTTCCCAGAGTAAACAGTTAAATAGGCTGCTGGTGATGCTTTAGGAAGCCATTAAAGCAAGAAGCTACAAAGAACTATTCTAATTATAAAATGTCTATGATTTCTCCCCAG
>TTN-213,,0,88,2788606,2788693,GTAATTATCAATCCTTCCTTATGCCATCAGTATTTATGTTTCAGATTGAAGGGGAAAAATCACATTTGTAATTTTCAATTGCTTCCAG
>TTN-213,,0,1728,2788694,2790421,GTAAATACTTTCAATTTGTCTGTGCAACTTTTTAAACCAACATTCTTATTATATTTACACAAAGCTATGCTGTATGCTGTGTAACAAACATTTTGGAAAATAAGAAAAATCACCCATAATCATGTTGAACATTATTAGAATTTTTAAAAATTTCCTCCTTACTTTTTTATTCTATGTGTATTCTGTATGGTGGGTGTAAGTTTACAAATTATATAATTGAGAAAACAGATGCTAACAAGAAGACATGCATCCATGTTTCCAGTGAACCTAAAGAGTGCATGTACACAATTCTCAAATTGCTAGAAGGCCATGAATATGTATTCTGAATCATGGCCCAGAATAAATATGGCTTTTTTATAGAACTTGCCCCCATAGTGTCTATTATGTTGTTATATAGTTTTCATAGAAGCAACTTTCCTTAAACTGTACATGAATGTTTAACAATCTGCAACTTTCCTTAAACTGTACATGAATGTTTAACAATTTGCCAGTGCTGACCATTTCACATCATGAGACTCTACCCCTATCGCTAAATTATCATAATAATGCAAAAACCTGTTTGAAGGGTTTCAGTATTCTAATTGAAGAGAAGCATCATAGTTGGTTATCAATATTGCATTTCTAGTCACTGAATATAGAGTTGAACTCTATGAGGCTTTTTCATGGCTCTCACTGGAGGCTTTAGTCCAGTGATTTGCTCAGAACACGAAGCCTTTCCACTCAGGGCTCTTTCTAAGCATGTCTCTAGGCACAACAATACTCCAGCCACAGTTTTTATGTGAAAATTGCCAGTTCTATGTTGAATATAATTAATATAAGAATGGCATAAGGAAAAATATTTCATTAAGCAGTAGCCCCACAAACTTTCAGGTTAGTTTCAAGCACCTAAAGCTCTTTTGCCTAATGGTTATTACTTTAATTTGAGAACTGGTACATTTCCACGTTAATTATTTGCAACCTCCTCAAAGTCATTCTGAAATTTGGGGCCTCCTATGCTGCTTGTTGATCCACTGGTCATCCAGAAATAAACCATCTCTCTCTCCGTTTCCCCTGCAGAGGAAACTGGACATAGAAACTGACTATGCCACTCTTACCCATCTCTTGTATCCCTCTGCATGCTTGCCTCCCAGCTCCCTCCTGTCCAACTCACAAATTGCTTTTAAAAAGCATTTTTATTTTCCCTTCAGCCTCTACTAAAACCATGGTAACCAATAACTGTTGCAAACCTACTTCATTAACAAATATGGGGCTTGATGCTATGGCTCACACCTGTAATCCCCTGACTTTGGGAGGCCAAGGCAGGTGGATCACTTGAGGTCAGGAGTTCGAGACCAGCCTGACCAACATGGTGAAACCCTGTCTCTACTAAAAATGCAAAAATTAGCCTGGTATGGTGGCACATGCCTGTAGTCCCAGCTACTTGGGAGGCTGAGGCAGGAGAATTGCTTGAACCTGGGAAGCGGAGGTTGCAGTGAGCTGAGATTGTGCCACTGAACTCCAGCCTGGGTGACAGAGCGAGACTCCCATCTCAAAAAAAAAAAAAAAAAAAAAAAGTGGTTGACTGTTTTTGTATTGACTAGATAGCAGAAGGAAAAACTAACTCAATTAGTAGACACAAAACCTTACTTTCTTCAAAACAACATTTTTGTCTCCTTTTAAAAAAACAAGTGTTGAGCATTATCTTTCATTGAAGGCAAACAGCTTGAATTATTTTCTTCTTATTTCCAG
>TTN-213,,0,860,2790422,2791281,GTAAGTAAAAAAAAAAAAATGTATACTTAATCACTTCTTTACTCATTTAGTACAAGACTATGGTGAAAAAATATGTGTATAAATGCCGTACATTTCATTCACTTGACAAGCAGTTATCACACAACTACTCAGTATCTGATTTGGTAGTATTTGGACAGTGATTGTGAAAGAGATTTTACAAATATGTATAATTCATTGAATTTCTTTTTGTTTTTTTTTTTCTTTTTGGTTTTGTTTTGACACATAGTCTTACTGTTACCGAGGCTGGAGTATAGTGTCATGATCTTGGCTCACTGCAACCTCCACCTCTGAGGTTCAAGTGATTCTTGTGTCTCAGTCTCCCGAGTAGCTGGGATTACAGACATGCACCACCATGCCCAGCTAATTTTTCTATTTCTAGTAGAGGCAGGGTTTTGCCATGTTGGCCAGGCTGGTCTCAAACTCCTGGCCTCAAGTGATCCACCTGCCTCGGCCTCCGAAAGTGCTGGCATTACCACTCCTAGTTCATTTATCAAATTTCTTCCATCTATACCTCACAGATTTTTTTTTAATTTCCCACTTAATGGCATTAATAGAAACTGAATTATTTTCCTACTTCTAAAACTACCAATTCTGAAGACCTTTCCTAAATTATTTTGCCTCAACAAACCTCTATTTCCTCATCTGTCAAGTGAAGAAATTCAATTGTATTGGGTCCTTTTTAACTCTAATAGTTTTATGATGAGATCTCTTTTGCTATTTATGGGAGCAGAGAGTTTAATGTTTAAATGCAATCTTCAGAAAAGGAATATTCACTACATCCTACTACATTCTTAATGTGACATTTTTTTCTACCACAATTCCTATACTTATATTCGCAG
>TTN-213,,0,101,2791282,2791382,GTATGTGTCTACTACAATTTATACTTCTGAAACTTGCACATTTGTAGATTTGTAATAAGACATCAATAAAAATGACTTGCCTTTATAATTACAAATTTTAG
>TTN-213,,0,93,2791383,2791475,GTAAGTCTTATTTAGTGGAAAGAATAGATCTTCTGTTCTTTCAAAAGCAGAAATGGCAATAACATTTTGTGCCATGATTTTTTTTTTCTGCAG
>TTN-213,,0,92,2791476,2791567,GTATGCATTATGTTTCTTTTTAGTGATTCAATGCTTGATAAAACTAATATAAAGAAATAAATTTCTAACGCATTTTCCAACATTTGTTACAG
>TTN-213,,0,89,2791568,2791656,GTATAGTATTAATGGATTTATTCAGTTTTCATGTTATCTAACTTTGTTTTCAGCTATATGCTAATTCGTTTTTTACTTTTATTTTTTAG
>TTN-213,,0,114,2791657,2791770,GTGAGTAAAATGCTCTCACTTGTGTTTGCAAGGAAAATAGATGTCTGATTGTATGTGTTTAATTGTAATCTGCATTATGGATCAAATCTGAGTGTTCTGTTCTCTTTATTCTAG
>TTN-213,,0,101,2791771,2791871,GTAAGAATTTTACTACTTAGGCCATTAAAAATAAATTTTGATAATTTTGAGCTCTTATATGGATAAAATTACTTATCAAACTGTTATTTAACACTTTTTAG
>TTN-213,,0,85,2791872,2791956,GTAAGTTGCTTTCTCTGAATACAAAACTATTGTTTGACTGTCTTTAAGAATATTACTTTTTCATCATAACTTCTTCTTTGAAAAG
>TTN-213,,0,94,2791957,2792050,GTAATTTTTGGACTAGCAGTATTACCTTATTTCTTTTTAAAATTATTCATATAGGTGAAAATCAAAATCTAATTTTTTCATGTTTACTTTTCAG
>TTN-213,,0,318,2792051,2792368,GTAGGATGTCCTTGTTTTTTCTGATATTACAGCAACTCTTAATCTCAAGCACAGAAGTATTCGATAAATAAGTTAATGTAACATCTAAATCTGTAACATCCAAACTGTATTTAGCAAATATTTTTCCAAATAGACCTTTTACCAAAATACCTAAAAGGTACAAACAATAGTAGATTCTCATTTTTATGAAGGAAAATAAAGAGGACACTAATTGAAAAATTGGATGACCTATATTTGATTAACTGAGAATAGGCTATATAAAATTACACATTGAAGTATCACTAGTAGTAGTTAACTATATGTATATTTTACTTTCAG
>TTN-213,,0,98,2792369,2792466,GTAAGTCCTTCCCTTAGCATGTGATTCATTCACACTTAATTTCTTATGATTTCCCCACATTCTGAAAAATCAATTAATGACCTTAATGTCATTTGCAG
>TTN-213,,0,98,2792467,2792564,GTGGGTTACTAAAATGCTTCTCCCTCCCACTTCAAAAATGAATTTGTTAATAGGGATGCTGAGGAGACATGTATATCTGATTTTATGATTCTTTACAG
>TTN-213,,0,310,2792565,2792874,GTAAGTATTATGCTTTCTTCCTCCTTTTAACCCCAGTCTCCTATTTTAGCAAGGTCAAGATACTAATACCATTTTAATCCACTTCTGAAAGAGATTTCATTTGTAGAGACCGAAATAGTGTAATAAATATCTATCTCACTCATGAAACACTTTTTTGATCTGTCTCATCTTATATGTTTTGCTTTTAATGTACTGAACTACAGGTTCTATGTACATTGGAGCAAATCCATACTAAAACTCTTATGTACATTAACAAAGGGGATTTGATTAGGTTACCTAGGTAATCTTCTAAATTATGTTTTTCTTCTAG
>TTN-213,,0,1157,2792875,2794031,GTAAGTAGTCTTTGCTTCATTTATGTCATGTGGTAAGTTTATTAGAATTTCTTCTTTTATATGTAGACATTTCTCCCTGAGGAATCTAGCTCTAGAAATTCTTGAAAAACAGTAGAGAACAGTGGCTTTCAAACACATGAGTGGGCCAAAAACACACAGTAAATAAACTTATACAAACACATATATAACTAAAAAACATTTCCTGAAACAATACCCATTTATTATCATGTGCATTCTTATGTTTTCTACCCTATTCTGTGTTTTTAAAAATATTGGCTGTACAACAAACATATGAAGAAAAGCTCATCACCACTGGTCACTAGAGAAATGCAAATCAAAACCACAATGAGATACCATCTCACACCAGTTAGAATGGTGATCACTAAAAAGTCAGGAAACAACAGGTGCTAGAGAGGATGTGGAGAAATAGGAAAGCTTTTACACTGTTGGTGGGAGTGTAAATTAGTTCAACCATTATGGAAGACAGTGTGGCGATTCCTCAAGGATCTAGAACCAGAAATACCATTTGACCCAGCAATCTCATTACTGGGTATATACCCAAAGGATTATAAATCATTCTACTATAAAGACACATGCACATGTATGTTTATTGTGGCACTGTTCACAATAGCAAAGACTTGGAACCAACCCAAATGCCCATCAATGACAGACTGGATAAAGAAAATGTGGCACCACATTTACACCACAGGATACTACGCAGCCATAAAAAAGGATGAGTTCATGTCCTTTGCAGGGACATGGATGAAGCTGGAAACCATCATTCTCAGCAAACACAAGAACAGAAAACCAAACACCACATGTTCTCACTCATAAGTGGGAGCTGAACAATGAAAACACATGGACACAGGGAGGGGAGCATCACACACTGGGGCCTGTCAGGGGTTGGGAGGCTAGGGGAAGGATAGCATTAGGAGAATACCTAATGTAGACGATGTGTTGATGGGTGCAGCAAATCACCATGGCACATGTATACCTATGTAACAAGCCTGCACATTCTGCATATGTATCCCAGAACTTAAAGTATATATTAAAAAAAATTGGTGGTAATACAAGCATTAATTTGCACCAGTATAGCTCTCCACCAGAAGAAACTTATCCACCTTCCCAAAATTAATATCTTTTCATTTTACTTTCAG
>TTN-213,,0,103,2794032,2794134,GTAAGTTAAGTATTAGACAAATGGCCATCTAAATATGAAGCTCAGAAATATTTTTACGTATCAAATCCTTGTTCTTACATTTCTTTCCTCTTGGTTCATGTAG
>TTN-213,,0,90,2794135,2794224,GTATGTTTTTGTGAAGGAGAAAAAAAGTTGTTTTCTTTCTAGTTTGTTACTTAATGTAGAAACTGACATCTTCCTTGTCTTCATCTCCAG
>TTN-213,,0,369,2794225,2794593,GTAAGTTTTGGGGTTTTTTTATTGTTGTTGTTGTTTTAGTATTATGGAGGCACATTTAAATCTCGGAGTCTAAGATTTGGACTCCAAGACACAGAGAGTAGTAGAGATCTGAAGATTACAACTCCCATTTAAGAATATGTTCTATCTCTTACAATGAAGATGACATATTAAAAAAAGAAAAGGACATATAATTTCCTTTAAAGCATACAGCAAGGACTCAAAAGTGCATACTAGTTGGACGGTTATTAAAATGGGATAATTGTCTTCCTGTTGAGCTTGTTACTTAGCAGCAGGGATGATAATGTGAAATATGGAAGTTTAAACTTCTGCTGGTAAGATAAATGGTGAGTGTACCTCTTTTTGTTTTAG
>TTN-213,,0,379,2794594,2794972,GTAAGATTCTGCTGAGTATTATAGGCAAAGATGTAACAGCATTCATGATGGTCATTTTTCCTAATAAAAAACTAAATATACACCTAAGGAAAAAAGGAAAATTAAAATGATGTTTTGTATATAGACACAAACATTATGATTATGGAGAATCATAATAACATGCTAAATTAAAAAGCAAGATACACAACTGTGGCAACTATATAATTTCAATAGTTATTCAATAGTGCAGTTATTATTTGTCTATTAAAAATAAACAAAATGAAATAACACTAAAATTCCATTCTTGAAAGAAGCAGCATATGAATTTCCCACTATTATTAATAAGGATTACATAATATAGCTTTGCATACATTAAGTCCTTTATCTTATTTCTTTCCAG
>TTN-213,,0,347,2794973,2795319,GTAACTAATAAACTTCATTGGAATCCCATATTTTACTTTGGATAATGGGATGTAAATAGGATTTACAGAATAATGTGGGAGAAGACATTCATATTCTAATGTGTATTTCCTATGCACAGAATTATTCTTATGACAGAACCACGTTTTAGAGTTAAAAAGAGCTTTAGAAATCACATATTTCAATTACCTAATTTTACAAGTGAAGAAACTAAGATTCTAAAAAATTAACTAACCTCCTAGGTCATATAGGAAATTGACAATAGAAAGACTGCAGCCCAGGTCTCCAGACCTCTACTCTATACTCATTCCCCATTCCACATATTCACTCTTCTTCCTTATTCCTTCAG
>TTN-213,,0,87,2795320,2795406,GTAGGAACATTTCCCGGTGGTTTTTCATTTTATTTTTTAAAATTATCTTTTAGCCTGGGAAATTAACTTTTCAATCAATTTCTGCAG
>TTN-213,,0,101,2795407,2795507,GTAAGTGTTCATGAACGAGTTCCATATCCTGTGTTAAAAGCAGCATTAAACACCCAGGAAGGAAGTTTTCATGAAAATTTCCTATCATTATTTATTCTCAG
>TTN-213,,0,889,2795508,2796396,GTAAGTATTACCAGGGGGAGTACATAAGGCTTTTCCTATTAATCATATTCTAAGAGGGAGACTAGAACTCCCTTAGGTAGATTAATTTATTAACAAGGTGTAGAGCTGGTAACTCCAAGAGTACTTTTTAGGAGAGCTGGGTGGGTACTTTACGGTATTGTGGAACAGGCAAATCAAATGCACATGATTTGTGGTTTTGAAAAGCTTTTCATATATATAAGAATTTCCTGTCTTCAAAAGACATGAAATGAGAGAATTTTATTGGAATGTAAGAATTTTATTTTAGGAATAAAGAGGCCTTTTAACTAAGTAGTGAGCTATTTACTATTCTTAGGGTTTCTGTTTTCCAATCCACCATCTCCCTAAGTATGTGACTGGTGGGCTCTCCATCTTAATTTCCCTTCTTCTTATTTCTTCTATTTGCTTATCCTCCATGATAATTTCCCCTTTATTTGAATTACTTGATATTATATGTCACCCTCCAGGTACTTTTCTTCCTACTATGAAATAATAAAGAGAGCTAGAATATGTGGCAGAATACCTTCATGGAATATAGAAAGGAAAAAACAAGAATGAAAGGGAGCCAAAAATCAATCGTCTACTTTCCTTTTAATATATGTAGCATTTCAGAGTACATAAGGCTCATGAAAGAGGAGGTACAGATCCTCCGGGGGGAAAACCTGGTTAAGCCTAAAGCATAGTGGAAAATGGAAAGATCAACAATTAGTACAGAACAGAAAAATGATTTTGAGGATTGTATTAAGGAAGTTTTAAAGAACAAGAAATCAGCTCTAGAAAATAAATGTATTTTAGGAGTGACAAGGCCAGTCCCTGGAAATACATTTGACTATTAAATTTTTATTTAACTTCTTCACCCAAAATTAAACAG
>TTN-213,,0,92,2796397,2796488,GTAAGTCTATTTCAAAAAAGAATCATATATATTTTAAAATAGCTTATGTATTTTTTACACATTCATTTCTTATTTACCTACTATTTATCCAG
>TTN-213,,0,90,2796489,2796578,GTAAGCAAATGAACCATCATCCCATCATTTTGAGTTATATCCTTCCTTTGTTATATGGGGCTTACACTTATCATTTCTCCTTTGCTTTAG
>TTN-213,,0,167,2796579,2796745,GTAAGGCTCTATGCACACATCTTCATTTTTCCTTTATTGTCATCGAAAGTGCACTCTTGTGTCCCACTCACTAGCTTATCTAAAAATCCGTTAAAAGCTAGAACTATTTGAAAAAGTTAATCGCCTGGCCTTAAAAATAACAGTAATTTATCTCTGCTATTTTACAG
>TTN-213,,0,90,2796746,2796835,GTAAGTGTCTTAAATTCAGAAGACGTAAAGCAAAACACGGTTTTGAGGAGGCTTCTTATTATAAATCTTGCATTATCTACTTTTTTCTAG
>TTN-213,,0,425,2796836,2797260,GTATTTTGTTTGTTCTTATCCTACAGCTTTTACATCAAGATTCCTCACAAATATTTCCCTGAGAACAGTTGAACATGTGCTTATCGATAACATTATCTGCTTATACAGAAATGTGTTTTTATTTCAGTACATATGGTTAATGTTTAATTTTATTGAAAATATCCTAATGTAATAGTTAATAAAGTATTTCTTAATTATAATATCTATTTTTGTAAGTTAAAATTGTTCACCAAAAAAGACAACAACTATGCATATTCCAAGAGGAAAAAAAAAATGGCACTATGCTTGGGTAATAAAAGTATAGATACTAGCAAGAATGACTACTTGTTCAATATATATGGATATGTATAAATAATTTGGGCAACACATATATATTGTAAAATCAAGCTGCATTTATACTTGATACATCCCTGGGTCTTTTGTAG
>TTN-213,,0,89,2797261,2797349,GTAAGTCATTATATGAAGAAAAACCCAGGTGCATGTTTTACATGAAGAAAACTGGTATTTGTTTGACTGGTTTTGCTTTTATGTTTTAG
>TTN-213,,0,91,2797350,2797440,GTAGGTCCATTTTACTTTTTATGTACTTTTTTTTTTAAAGCAAATTAAGCCTCCTTCCTTTTCTGATTAAAATGTATTTTTTTCTTTGCAG
>TTN-213,,0,91,2797441,2797531,GTATGTAGAGCATGTGAGGGAATTGACATGGAAACATTTATAGCAGAGTTTAGGAAATCATGGATTTCTAATAAATTTGCTTCCTTTTCAG
>TTN-213,,0,112,2797532,2797643,GTTAGTATTTGTCTTTTTCAACACCGTTCATTCCAGAGTGCCAATATTTTATCTAAATTACCCAAAAGCCAAACTCTGAATATATACTTTTGTGTCTTTGTTTCTTTCTCAG
>TTN-213,,0,673,2797644,2798316,GTATGTTTTAAGAATAAGGAAATTCTACATATCCACGTTAATTTTGCTAGAATAGTGTGAGTCATTCTAATTAGTCGTTATTTCATCTTAAATGCTTTTGGGTTCACACCCTTCACACCCCAAACTATTCATACTATGGCACAAAATGGAATCTCTAGTGAAGAGTCTTTCATTGATTAAAAAAACAGAAATTTACGTAGCTAAAATTGGATAATATATGTTGAATTTAAGTATTATTGAATCTAACTGTATATATATGTAGGTATACATGTTTATATATATATATACACAGATTATATATATATAGTATGTGTGTATGACATATATCATATGTGTGTATGTGCGTGTGTACAGAAATTGTATATAAAGTTTTTTAAAAGATTGTTCATCTTGTTCCTCTTTTTTATCCCCATGGTGAATTTGGAGTAAATTTTATCATTTAATCTGGTCATTTTACCCTTAATTTGGATTTGAATGCTATAGCATGTAATGACATAGCTTGTGGGAGCCTTGGTTGGTTCAGAAGCAAAATGGGTTATGTAAAAAGGAAGACTAAAATCAACATAAAAATATGGCCTTCATTTAAAAGTTTTCTTTTGACAATACATGAAGAGTGCACATTTAAAAGTGCTGTAATAATTATTCACTTTCTTTTGATGCTTTGTTTTCTTAG
>TTN-213,,0,105,2798317,2798421,GTATGTCTAATTTTGTGTAGAAGCAAAATTTGAAATTATTTGCATTGATTTATGTTAATTTTCAGAAACACTTTTTCACTTTCACTTTCTATACTCATTTTTCAG
>TTN-213,,0,92,2798422,2798513,GTAAGTTGTCCAACTTTTCAAAGATCCAGGTTTTCTTTTACCATAAATGTGTTATTGTCTGTACTAATCTATAGGATTTCTCTCTTTTGTAG
>TTN-213,,0,108,2798514,2798621,GTACGTATTTGTCATGGGAAGGGCAGTTCTGATAACAAAAATGCAAATCTTACTTCTGCGAAGCAAAATATTATAAGTGCCGCTAATCTGCTTCTCTTATTACCACAG
>TTN-213,,0,1695,2798622,2800316,GTAAGCATGCTTAGCACTTTGAATCAAAATTGCTATTTAACTCAGTATTTCCGCATACCTTTTCCTGGTTCTAATCCTATAGAATAACTTTTACTCTGTGCCTTAATGGGGTTTTTGGAAGAAATTATGGACTAGCTGGGAGTCTGAGGAAAATTCCTTAAATACCTTTCCAGCCCTCTTGACTTGACTGTAAAGTGAGAGATTTAGACCTCAGGATATCTATGGGCCTTTCCAACTTCAACCTTTTATGATTGATTGTATGAGTTGGTGCTTTCATTCTGTTTTAAATTATCAGAGTCAATAATTAAACCATGGTTGAGTTCCTAGAGAATATTGCTCTTAAATAAGCCACAGACTAAACAGAGACTTCATTTTTTGGTTTTTTTTTTTTTGTTTGTTTGTTTGTTTGTTTGTTTTGAGACAGAGTCTCACTCTGTCGCCCAGGCTGTAGTGCAGTGGCACGGTCTTGGTTCACTGCAACTTCCGCCTCCTGGGCTCAAACGATTCTCGTGCCTCAGTCACCTGAGTAGCTGGGATTACAGGCATGCCCCACCACACCCAGCTAATTTTTTGTATTTTTAGTAGGGACGGAGTTTCACCATGTTGGCCAGGCAGGTCTCAACCTCCTGACCTCAGGTGATCCACCCACCTCGGCCTCCCAAAGTGTTGGGATTACAGGTGTGAGCCACCATGCCTGGTCTAAACACAGACTTTGATGATGATAGTATTAGCAGCAGCTAACATTTATTGAGGAATTTTCATGAATTCTTTCCCTTAGTTCTCACAGCCCTCATATTAGCCATCTTATAGAAGGGAAACTGAGGCTGAGAGTGCTTTTGTAACTTCCCCGTTAGGGATGGAGTGGGAATTCAGACAGACAGACTTCAGAGCCCTCTCTATCATGGTTAGTCCAAAATGCGTATTCTTCACCATTCTGGAAAATAAGTGGCACATTCAACTCAACAATGTTTTGAAAATTAAAACGTCATGAGAGTCAGGTATCCTGTGACACTTTACCTAAAAGATCTCCATTTGCTAAGAGAAAATTGAGCCACTGTAGTGTCTGGGCAAAAGTATCCACTTCCATCTTCATGCTGAGAATCTCAGGGCTGTTCATTATTTATGAATCAGGCTTTGTGGATACTGAATCAGTGTTTATGAGAGTATAAAGCAAGTCGAATTTAGTTATCTTTCTTGATAATTCCAAACAGCATGGCAGAAAATCTGTCCAGTAATTATGTAGCTCTGTGGGTAGAGAATTCAGACTTTAAGTGTCTGACATGAACCATCCACACTTGGATATCAGTGAACTGGGATGGGAAAAGAAAAAGAATAGGAGGTGCGTAGAAGAAAAGGAAAGAAAAGCTAAAGTGAAAGGAAATGTTTTAACAGCTTCTTCCATGATGTTCTCACTACCATATCCCATTTCTTCACTGGAATAAAGCAACTAATGGACTTTAAAACACATGTAAAAGGTGCTTAAGTCCCTGCACAACTCACAGTCTTTCTACCCCATCTGAGATAGAAGAGTGGCCTATAAATTTTTAATTTTTAAATAATAATTGCATAGAATTATAATGATGGTGTGTGTGTATAATTTAATAATGGCCAATGACCTTACTTTAAGGTTGGTGCAACTATTTTTTTTTCCATCCTTATAATATTTTAAATATTTCTCATCTGTTTTTCTTGCAG
>TTN-213,,0,112,2800317,2800428,GTAGGTGCTGAATACAGACCACTGTCATATTACATTTGCCTAAAGCTTAGTAATTTTGAACAAGTAGGCTTTAAAGAAGTACTAACATCGTGTTTTGTCCTTTCACTGATAG
>TTN-213,,0,236,2800429,2800664,GTGAGACATGATTTCATTAGAAAACTGAAACGTGAAAAATTTAAAAATAAACTACGCTAACCTGTGCATATGCTTTAATTTTCTTTTATATAACACCTGTCTCATTACCATCCTTTTCACAAGGTGAAAAATATAAAAAATAAAACCAATGTTCTTGGAAAGAATGCGAACATCAAAGGTATAATTTATCAGTAATGTGGATTCTTGTACCTTGTTTTCCCTTCCTTTCTAAATAG
>TTN-213,,0,106,2800665,2800770,GTAAGTGCTCATACCTGCAGCATCTTCACCTGTGTCTTCTATATTCACCTGTGTGACTAAATTGTACATGATTGTGTAATTATTTTATTGTGAATGGCCATTCCAG
>TTN-213,,0,105,2800771,2800875,GTATGTACCTACTGGTTTGATTATGTTTTTTAATAAGCATACTTCCAGGAAATCACTCTTTTTTGCTTTTAAAATTCACTGTATGTATCCATTTTATGTCTACAG
>TTN-213,,0,369,2800876,2801244,GTAAGTGATTATTATTCAAATACATTTAGTTTAGCAATTGAACATATTAGAAACAAATATATCAAGGAATGCTTTTCTTCTCTGCATCACCTTCTTACATATCTTCTTGTCACTAGAGAACTGGTCATGTAAAGCAAGAGGAATTATTTTAAGTCAGTCTAATAAACTAATTTGAAGTTCATTTTAAAGACTATGAAATGGAAAGTTGAAATTAATGACCAATATGAGTTTGGGAGATTGAATAAATTACTTATTATAAAAATTTTACTTATTTATTAAAATTATAGAATAATTGTATTGTTCTTCCATGGATGATTAAGACCTGGTTACAAATGTAATGATGCATTTACCTTCCTTATAATTTTTTAG
>TTN-213,,0,693,2801245,2801937,GTAAGCATTTACAACTTATTTCCAATGAGACTAAGAGCATTCACATTTTTAAAAAACACATTTGGCCCCTGGCCTGTAAAATGGTAACAGAAACAAATTACCCAAGGTTGCTAAGTGGATGAATTATGTCTTTCTACCTTTCAGATGAAAAGAAGAAAAAAATAATTGGCATCAATTATTTTTTCTATTATTTCACTCCATTCCCATATAAAGAGCATGCAGCAAGTGGGAATGAGTTTTTAGCTTTGTAATTTTCGCCACTTAACAGTACATAAAGAAAAGGTTCTCGAGAATAAGTGTCCATCTTTACTGAAGTTATTAAAATACAACATACATCCAACAACACAATCATCCCCTTGCTTGAATGCAGCTGATGGCCTCTTAAAAGAACTTGTGTGACTGTGCAGCAGTATTAGGAAGTACATGATCTGTAAATGTTTCACTTTCCTTTTTACAAAGAGCAATGCAAAATTAAAAACATGACAGGCATTACAAAGGGAATAATAATAGGCAAATATTTAACCCCATAGTCCAAATTCTCAATTATCAATCCTACTTTCAAAATAGGCTTTGGTAGCACAGTAGAAGTCACTACTCTTCCTGGCCTTGTGATATGGCACTACTGAAAAATATATATTTATGTATGTCTTTATTAAGCCAAACTAATACATAGTATTTCTCTTTCTTTTATAG
>TTN-213,,0,116,2801938,2802053,GTACTTTTAAAATAGCTTCTTAATGCTACAATTTATGAACTTGGATTAGAGACATGCCTAGTTGTATTTTAATGGACAAGGAAAAAGAAACTAACTCTAGAAACTTTTTCTTATAG
>TTN-213,,0,96,2802054,2802149,GTAAGTTTGCGTTTTTACTAAGCGGTACTATGTCAAAAGTTTAACCTTCCAAGCAAATGCATCTAATTGATTTGGGGTTTTGTTTTTGTTTTACAG
>TTN-213,,0,101,2802150,2802250,GTAAGAAAAATAAAAATCCTATTTCAAAGTCTCTATTATTAAATGTTTCCCCTGAATTTTATAAAATTGTATTCATACTTAATACCTTTGTTTATATTTAG
>TTN-213,,0,97,2802251,2802347,GTATGTATCACAATTTAAGGGCATATTTGTTTATTATTACTGATTCTAGTAGAACTCAGAGTGGTATATTTTAACCTTATTTTTGCATCCCTTCCAG
>TTN-213,,0,97,2802348,2802444,GTAGGAAATAGTCAACATTCTCCTTTTTAAAATTATCTCAATTTATGTGAAAATAAACTCTCAGATATTCATTCATATCTGTTTTGCCTACTGACAG
>TTN-213,,0,95,2802445,2802539,GTAAGCATGTCAAATGTTCTCACATTTATATAGCATTTTCCAGTGTGGGCAGAAAGAATGATCTTCATCATGGCTTGTCATTACACCTGTTTCAG
>TTN-213,,0,126,2802540,2802665,GTAAGTATTAACACTTTTAAATAATTTGACAGTTGAAATGTAATAGAATCAGGGGGAGAAGGGAGAAGGGCAGTCTTATCAATAGTAATTTTGTGCAATTCTCATCATCCTTATTTTCATAAACAG
>TTN-213,,0,881,2802666,2803546,GTGAGCTCCAAGAATCATACATAAATACAATGCTCCTCAAAACTATATGACAGATAATTTTCCAACACACAATCTCTAAGAATTTTTAGAATTTATGAATGGTCTAGAAAAGCACATGCTTATTTGCATGATCATAAATATAGCTTAAGTCAGAGAACATTTTAACTATTACATCTGTTAAGTTAGCAATTAGAATTGCTAAAAGTTGTACAGCATTTTCCAATTAATGAAAAAATATTCTATCAATATGAAAAGAATCTATTTTATAAATTTTCCTTAGAGAAAAATGCATTGTACTGTAATAACTGAAAAGAAAAATGGCAAAACTCCTTTTAAGAAGAGGTTTAGCAGGAACATACAGTTTCTAGTGGTTTCATAAGTTACTGACAAAGTAATTGTGACAAGAGCTTCAAAAATAAGTGGCAAATCCTTTTACAGAGTCTGAGCCCAAGAACTATAAAGGAATAGTCACTGGGACTGAATTGGGGAAGCTAAGGAAACCAATTCTTGTATTCATTAGAAATGTATTGGTGGCAAGTGATACTAACCCAGTGAAAGATAAGCAACTAAAGAAAAGTCCCTAAGAATGGGTACTTTAAGTAATGAGCTTAGCTAATAGAGAACACACAGTAAAGCTGGCCAAAGAAGTAGGGAAGAAATATCTACTTTCCTAAAGCAATTTAATTCTTAAGATAATAATATTAAATTATAATGTGGCACTCTGTGCTGTCCTATAATATCAGGAGCCCAGTTAATAAAGATTATCTTGGTGAGTGTGGACAAGAGCAATAATGCCTTTGTGAGTCTTGAAAACAAAAAATACAAATCTCAACATTTCCTTATTTGCCTAATATCTGCATCTCACTTTTTAAATTCCACAG
>TTN-213,,0,85,2803547,2803631,GTATTTATCACAGAAGCTTTTAGGTGAATTATTTTCTTCTCACACCTGTCCATGAATTAATTAAATTTTGTCATTAACTTTCCAG
>TTN-213,,0,171,2803632,2803802,GTAAGCATTTTACTTAAAATTGGCTATACAATGAGTAGATCCTCTAAAACAATATAGCTTGACCTATGATTGATCACCTCTCTAGAAAGGAACTATGTTGATTATATTTCCCCAAGAAAAAAAAAGCTATCAGGCAAATAGGAAATATGAATCTTTCATTCTGTTTTTCAG
>TTN-213,,0,119,2803803,2803921,GTATGTACCAAATAGCCAAAAAAAAAAAAAAAGTAAAGTAAAATGAAAACATTCAGAATTCGTAACAATTTACCATAAAAATAATGCTTAAGAATAAATGCCTGATTTCTTTCCCATAG
>TTN-213,,0,98,2803922,2804019,GTAAGGATGTGTGACAAAGATACAAGCAAGTTGATGTTCAGTCACCCAATTTTGATTTGAAGTAAAAATTAATTTCCTGTATTTCTTCTCTTTCATAG
>TTN-213,,0,679,2804020,2804698,GTAAGTCCACAGGCCCTTCCACCACTCTCCCCACCTCTGATTCTGAATGTTAACAAAAAAGAATTTGTTTTTAATATGCCCTAATGTAAATAAAAATAGGTCACAAAATTAACCCTGTGGTCTTTCTAAGGTTTCTAAACCTCCTTTTCTCAGGTTTCTAAACCTCCTTTTCTCAGAGGTTTTCAACACACTTAGGCTTGATTTTTTTTTTAATATCTTCACTCTTATGAAAGAGAAGAGGAGGGAGTTAGGAAGAAAGGAATGGAAGGAAGAAAAGAGAGAAGGGAAGGAGGAAGAGAGGAAAGGAAGGAGGACTGGCAATGTTATAGTGAGAAAAAAATACAGAGTGCATGCTTAATAAATGTAGAATTGAAGAAAATGAGGAACAGCAAGGAAAGTACAAAATTAAACCTCAGCATCATGCAATATACCCATGTAACAAACTGCACATGTACCCCTGAAGCTAAAAGTCAAAAATTTTTAATAAAAATAATTAAATAATTAAATGATTTAAATTAAAATTTACAAATAGTACAAAAGTGAAACTATTGGAAAAATAGTCATGTGCCTTATGTACCTTTTAAAATACCAACCAAAACCTAAGGAAAACACAAATATATGAGTCATTGTTTTAACGTATTCATATTGCCATATCGTGTTAACCTCTGTCTTGCTGCAG
>TTN-213,,0,911,2804699,2805609,GTAAGGACATTTTGTATCAGTCAAATTGATTGAGTTACAATTTATATGTGGGAAAATTCACCTTTTTGAAATATATAGTTCTATGACTTTTGAAAAATGTACTGTTTTGTAATCACCACCACAATCAAAATGTGGAATATTTTTATTACCCCGTAAAGTTCCCTTGTGTCCGTTTGTAATCAGTCCCTTCCCCACCCCAGCTGCTAGCGATTTCTGGCAAATAATTTTTAATATTCTTCTCTGGAGTCAATTTCCACTTCTTTAAGATGAGATTCATAATATATGCTTTCTATCACACTTAAAATTTTAAAACAAGTTAATATTTCTGGAAGCACTTTAAAAACTGCTGATAAATGTAAGATAATAATAGTGATTACAAATGAAGCACATTTAAGAGAAAGGAAAGTGAAAAAATGTTAAGTATTTTTAGCTGATAAAATGAATAAAATTTTCTTTTTTCTTTCTTTTGTTTTTTTGTGTTTTTTTGAGACAGAGTCTCACTCTGTCACCCAGGCTGGAGTGCAGTGGCATGATCTTGGCTCACTGCAACCTCTGTCTCCCAGGTTCAAGCAATTCTTCTGCCTCAGCCTCCTGAGTAGCTGGGATTACAGGTGCCTGCCACCACGCATGGCTAATTTTTATGTTTTTAGTAGAGACGCGGTTTCACCATGTTGGCCAGGCTGGTCTTGAACTAACTCCTGACCTCAAGTATCTGCCCACCTTGGCCTCCCAACTTGCTGTGATTACAGGCATGAGCCACCACACCCAGCCATGAATAAAATTTTCACAAGACAAAAAAACAGGCTAATGTTAACAGTCCGTTTCAACAACTCATTGAATTTGTTAGGTGGCACAGCTAATTTTCAACTTTGCAGCAACTTTAACCAGTATATTCTTATTCTTATTCTCAG
>TTN-213,,0,101,2805610,2805710,GTGAGACATATGATCATTTGCTTTCTGCAATAATTGCCATAGACTTATTTCTTAGTCCCCCTACCCCAAATGCTAAATTGAAACCCTACCTTTTTTTCCAG
>TTN-213,,0,130,2805711,2805840,GTAAGTGCCCTTTCAACCACAAAATTATAAACATTATTTCAGCACTTTTCTGTTTTTAAATGAAAGTCATTGGCTTATAATACTTGGGACTGTATTCTAATACATGTGTGCTTTCCACTTATATTTACAG
>TTN-213,,0,106,2805841,2805946,GTAAGGAATTCAGAAGAAGGGGTTAAATTAAAGAAGCAAGCCATGTTTGGTCCTTTTATTTCACCAGTAAAGCTGACTCCCTTTTCATTATTTTAAAATATTTCAG
>TTN-213,,0,622,2805947,2806568,GTAAGTAGCCTTTGGTTCTCTACTTATGATTTACAAACTAAACAAGTTAAGGCTAATTCCCCCTCTATACTAAGTAGAACCCTGGAAAGCTTTATTGGAGAGCAAGTGTTAAGAAAGAAAAGCAAGTACACACACAGGAAATATGACAAGTTCTACAGGAAACCATTCCAAGCACACAACCTCAGCAGATGTTAGATGGAGTGAACTGAGCACTTTCCTTGAGTAATTCCCTCTAATGCAATGGTTTCTTTTTAAAAATATTTCCCAACAAGATTTGAAAGGTCAACAATTGTATGCCACTTCAATGAACCTAAGTAAGGGCAAGAATACTACAGAATTATAGAGAGAATTTACAGTCCCTTAAAAGCCTATACATTATTAATCCCCTTCCAATCATAAAGAGAAAAAAACACTCTACATAAAATGTGACGATGTGCTCATTGAATCCCTATTTACCATATGATCCTAGGAAAATCACTTCAAAGAGTTTTTAAGAATTAGGCTAATATGTAAATCATGGTATGTGTCAGTAAATAAGGTAAATTCATTCCTGATATACAAGGACAAAGGATTACAGATTGAGTATTAACAGTCACTTAATATTATCTTTCATATTGTTCAG
>TTN-213,,0,98,2806569,2806666,GTATTTTATTTTTATTTTCAGTGCTTTTTATTTTTAAAGAAAAAAAAATCTCAAAAACACACTATGAAAACCACCACAATTGTATTTTCCCCCAACAG
>TTN-213,,0,362,2806667,2807028,GTGAGTACAACTTGATTTCTGTATCTTCCTATGGTAAAGTTCCATCTTTGCATAAAATTCTTTTAAACAGAAAGAAATTTTGAAAGGAAATAGCAAAGATTCAGATAAAGTACAAGTGCCTTTTCTTTCACTTTAATTGAATGTTTGCATATCTAAAAGGAGAAATATATATCCTAACCCCATTGTAAAAATAGAACTTTGGTTTTTGATATGTCTTAGTATAAAGTAACCAATTTCATCTTTCTGGAATAGCTATTTTTTAACAAAATTTTGGACTCATATAACATTCTTTTTTAAAAAAATAAGCTTTAATAAAGCTGCCTGTTTCATCTCATGACTCAAATCTTTTTTTTGTTTAATAG
>TTN-213,,0,132,2807029,2807160,GTAAAAATAAATAAATTATCATCAAGTTGAGGCTAAATGAGTTATTAACTTGGGGGTGGAGGCTATTGCACTTAAACACATACTGTTAGATGTTGCTAAATTATATTCTTTTTTTTTTTTTTTCTGATACAG
>TTN-213,,0,124,2807161,2807284,GTAACCAGTTCTTAAATGTCTCTTTCTTTTATCTTCTAAAATATTTTATCTTCTAAATTCAGCTTCCCAAAAAAAGCTTAAAATGAAATCACTTTTTAAAACACAAATCATTTGCATTCTACAG
>TTN-213,,0,740,2807285,2808024,GTAGGTTGGCTTTTGTTTTTACCCACATTTCTTCAGAAGATAATATTAGGGAAATATTTTCAAACATCCCCCCTTATATACACATACAAGAAAGTATTAAAATAAAATTATTTTCCTAATTCCAGAATACAATTTGTACACCAAAGCAGAAACACACATTTGAAGTTAGCATATGCTTTTCTATGAGCATAAAAAGCAGTTATTAAGTACCTAGTTATATGTGGTATTATATAAGATTCCATAGTGTCAGCCCCTGCTCCCAGGAATATTTAAGAATAAAGTCAGTGAATATACAAAATGGCACTACTTGCCTAAACCTTCACAGTTGCTAATTTTCCAAAGCAGTGCAAAGTTAATTAAAGAACTATTTCTATTTTACCAATTAAAATTAGTTTGCTTTCATTTCAATCTTCTGAAAGATAATTTAATGTTTTGGTTACTCAAAATCTCCCAAATCCACTTATCTCCTAAATCCGTTGACTATTCTTTTCAAGACTTTTTTCCTTAAGTCATATGAATCATCTTTGGCTCAGTTTAGTTTAAGGAATCATTACAGTGATCTCAAAAGTCACACATGATAATTTTCCAAAAGTGGAACTGAGAAAGTATTAGGTATTACCTACATTGCATGAAGAAGTTGACTTTTTTTCTTTTTATGTTTTTCACACGCAGAATCTAGAAGAGTAAAAGGTGGGGGTCTCTTTCTAATTAAGTTTGCCTTACAGAGGTTTCTTTTTTAG
>TTN-213,,0,100,2808025,2808124,GTAAGTTTAATTATGAATATATTATTGAAGAAAAACTAAAATACCATGTCTTCCACATCTGAAGAACTTCAACATTTCTTTTCTTTTTCCTTTGTCTTAG
>TTN-213,,0,525,2808125,2808649,GTAAGTATCTCCTCACCCTTCTTCCTTACATGTTTAAGGCCTTTAGATCGTTTTTTTGCCTCTCTTTCAAGCACAGAAAACTCTAAGAAGCCTTATTAAATTCCATGTGAAAGAGGGACAGCCAACTGATGTGAATTCATTCTTGTAGTCAAACTTTCTTTATAGCTACACAGAAACTTGGATAGATTACATTTCAAAGTAAAGCTACCAACTGCCGTGTAACATTTATTTGCAGGATGCACAATATGTCAATTACTTTCTATATGACTAATCATTTTTCTCCTAGTGATTCCTAGCACCTGCATGTAATGTAATGATAGAAATATAAGGATTCATGTTTTGGAGACATTGAGCTAGCTCTTGACAAATGTATGTATATATGTATTTGCTTATGCTTCAACAGCAAATTGTTTGGGTTATGCTGCTGTGTGTGTGTTGAAGTTTCCATTTCTGTAAGTCAGCGTCATATGTCATCAATTAACCAGATGTCATTGATGTTCACTGTGTATCTGCTATGCTCCACAG
>TTN-213,,0,138,2808650,2808787,GTGAGCAATAAAATTACTGGTAGAGGTAGACAAGCCAAGTAACATGGTGTAGTCTTTAGTACACACAATTCAGTAGAAAGCAAATCTTTATTTTTTTCAGTGATTCTAAGACCTTTTTTTTGTCATTGTTCCATAAAG
>TTN-214,ENSE00001465556,1,212,2808788,2808999,GAGCAGTCGTGCATTCCCAGCCTCGCCTCGGGTGTAGGGATTGCATAGAAAAGCAAAACTACACAGTCTTGACTGTGTAGTTTTGTTTTTAGGATTAGAGGCTCACCGATTCATGTCGGAGATGGTCAGAAAAACCAACTCTCCATAGGACGTCGTTTCAGAAGCAACCTTGGGCTTAGTCCCACCCTTTTTAGGCACTCTTGAGAAATCAG
>TTN-214,ENSE00003502146,1,104,2809000,2809103,AGTGCCTAGAAAGATGACAACTCAAGCACCGACGTTTACGCAGCCGTTACAAAGCGTTGTGGTACTGGAGGGTAGTACCGCAACCTTTGAGGCTCACATTAGTG
>TTN-214,ENSE00003807606,1,204,2809104,2809307,GTTTTCCAGTTCCTGAGGTGAGCTGGTTTAGGGATGGCCAGGTGATTTCCACTTCCACTCTGCCCGGCGTGCAGATCTCCTTTAGCGATGGCCGCGCTAAACTGACGATCCCCGCCGTGACTAAAGCCAACAGTGGACGATATTCCCTGAAAGCCACCAATGGATCTGGACAAGCGACTAGTACTGCTGAGCTTCTCGTGAAAG
>TTN-214,ENSE00003810976,1,288,2809308,2809595,CTGAGACAGCACCACCCAACTTCGTTCAACGACTGCAGAGCATGACCGTGAGACAAGGAAGCCAAGTGAGACTCCAAGTGAGAGTGACTGGAATCCCTACACCTGTGGTGAAGTTCTACCGGGATGGAGCCGAAATCCAGAGCTCCCTTGATTTCCAAATTTCACAAGAAGGCGACCTCTACAGCTTACTGATTGCAGAAGCATACCCTGAGGACTCAGGGACCTATTCAGTAAATGCCACCAATAGCGTTGGAAGAGCTACTTCGACTGCTGAATTACTGGTTCAAG
>TTN-214,ENSE00003809662,1,86,2809596,2809681,GTGAAGAAGAAGTACCTGCTAAAAAGACAAAGACAATTGTTTCGACTGCTCAGATCTCAGAATCAAGACAAACCCGAATTGAAAAG
>TTN-214,ENSE00003809782,1,245,2809682,2809926,AAGATTGAAGCCCACTTTGATGCCAGATCAATTGCAACAGTTGAGATGGTCATAGATGGTGCCGCTGGGCAACAGCTGCCACATAAAACACCTCCCAGGATTCCTCCGAAGCCAAAGTCAAGATCCCCAACACCACCGTCTATTGCTGCCAAAGCACAGCTGGCTCGGCAGCAGTCCCCATCGCCCATAAGACACTCCCCTTCCCCGGTCAGACACGTGCGGGCACCGACCCCATCTCCGGTCAG
>TTN-214,ENSE00003805863,1,331,2809927,2810257,GTCCGTGTCTCCAGCAGCAAGAATCTCCACATCCCCCATCAGGTCTGTTAGGTCTCCATTGCTCATGCGTAAGACTCAGGCATCCACCGTGGCCACAGGTCCTGAAGTGCCTCCCCCTTGGAAGCAAGAGGGCTACGTGGCCTCCTCATCTGAGGCTGAGATGAGAGAGACAACGCTGACAACCTCTACTCAGATCAGGACAGAAGAGAGATGGGAAGGGAGATACGGTGTCCAGGAGCAAGTGACCATCAGTGGTGCTGCGGGTGCTGCCGCCAGTGTGTCGGCCAGTGCTAGCTACGCAGCAGAGGCTGTTGCCACTGGTGCTAAAGAG
>TTN-214,ENSE00003803639,1,153,2810258,2810410,GTGAAACAAGATGCTGACAAAAGTGCAGCTGTTGCGACTGTTGTTGCTGCCGTTGATATGGCCAGAGTGAGAGAACCAGTGATCAGCGCTGTAGAGCAGACTGCTCAGAGGACAACCACGACTGCTGTGCACATCCAACCTGCTCAAGAACAG
>TTN-214,ENSE00003810843,1,138,2810411,2810548,GTAAGAAAGGAAGCGGAGAAGACTGCTGTAACTAAGGTAGTAGTGGCCGCCGATAAAGCCAAGGAACAAGAATTAAAATCAAGAACCAAAGAAGTAATTACCACAAAGCAAGAGCAGATGCACGTAACTCATGAGCAG
>TTN-214,ENSE00003803899,1,126,2810549,2810674,ATAAGAAAAGAAACTGAAAAAACATTTGTACCAAAGGTAGTAATTTCCGCAGCTAAAGCCAAAGAACAAGAAACTAGAATTTCTGAAGAAATTACTAAGAAACAGAAACAAGTAACTCAAGAAGCA
>TTN-214,ENSE00003808716,1,138,2810675,2810812,ATAAGACAGGAAACTGAGATAACTGCTGCATCCATGGTGGTAGTTGCCACTGCAAAGTCCACAAAACTAGAAACAGTCCCGGGAGCTCAAGAAGAAACTACCACACAACAAGATCAAATGCACCTAAGTTATGAAAAG
>TTN-214,ENSE00003809802,1,138,2810813,2810950,ATAATGAAGGAAACTAGGAAAACAGTTGTACCTAAAGTCATAGTTGCCACACCCAAAGTCAAAGAACAAGATTTAGTATCAAGAGGTAGAGAAGGCATTACTACCAAAAGAGAACAAGTGCAAATAACTCAGGAGAAG
>TTN-214,ENSE00003805623,1,138,2810951,2811088,ATGAGAAAGGAAGCCGAGAAAACTGCCTTGTCTACAATAGCAGTTGCTACTGCTAAAGCCAAAGAACAAGAAACAATACTGAGAACTAGAGAAACTATGGCTACTAGACAAGAACAAATCCAAGTTACCCATGGAAAG
>TTN-214,ENSE00003801659,1,294,2811089,2811382,GTGGACGTTGGAAAAAAGGCTGAAGCTGTAGCAACAGTTGTTGCTGCAGTAGACCAGGCCCGAGTCAGAGAGCCCAGAGAGCCTGGGCATCTTGAAGAATCCTATGCTCAGCAGACCACTTTGGAGTACGGATATAAGGAACGCATTTCCGCCGCAAAGGTAGCTGAGCCTCCCCAACGTCCAGCCTCAGAACCCCACGTTGTCCCTAAAGCAGTCAAGCCTAGAGTAATCCAGGCTCCTTCTGAGACTCATATCAAAACTACTGATCAAAAGGGAATGCACATATCATCACAG
>TTN-214,ENSE00003804455,1,123,2811383,2811505,ATCAAGAAAACTACAGATCTAACAACGGAAAGATTAGTCCATGTGGATAAACGCCCCCGCACAGCTAGCCCTCACTTTACTGTTTCAAAAATTTCTGTTCCTAAGACAGAACATGGATATGAG
>TTN-214,ENSE00003810306,1,282,2811506,2811787,GCATCAATAGCCGGTAGTGCTATTGCCACATTACAAAAAGAGTTGTCAGCCACATCTTCTGCTCAGAAGATCACCAAATCGGTGAAGGCTCCTACTGTGAAGCCCAGTGAGACTAGAGTAAGGGCAGAGCCCACACCCTTGCCACAGTTCCCCTTCGCTGACACACCAGATACTTACAAGAGTGAAGCTGGCGTTGAGGTGAAAAAGGAAGTAGGGGTGAGCATCACTGGCACCACCGTCCGTGAAGAGCGCTTTGAAGTACTGCACGGACGCGAAGCCAAG
>TTN-214,ENSE00003805296,1,66,2811788,2811853,GTAACAGAAACAGCAAGAGTACCAGCACCTGTTGAAATTCCTGTTACTCCACCAACTTTGGTCTCG
>TTN-214,ENSE00003806123,1,259,2811854,2812112,GGCTTAAAAAATGTGACTGTCATAGAAGGTGAATCTGTCACCTTGGAGTGCCACATCTCTGGATACCCATCCCCGACAGTGACATGGTACAGGGAAGACTACCAAATCGAAAGTTCCATTGACTTCCAGATAACCTTCCAGAGTGGAATTGCTCGTCTTATGATTCGCGAAGCATTTGCGGAAGACAGCGGGCGATTTACTTGCAGTGCTGTAAATGAGGCTGGAACCGTCAGCACATCCTGCTATCTGGCTGTGCAGG
>TTN-214,ENSE00003808554,1,64,2812113,2812176,TGTCAGAAGAATTTGAAAAGGAAACCACAGCCGTGACTGAGAAATTTACTACAGAAGAGAAACG
>TTN-214,ENSE00003804962,1,216,2812177,2812392,CTTTGTTGAGTCAAGAGATGTGGTTATGACTGATACTAGCCTCACAGAGGAACAAGCAGGGCCTGGAGAACCTGCCGCGCCTTACTTTATTACAAAACCAGTGGTCCAGAAACTGGTGGAAGGTGGGAGCGTGGTGTTTGGATGCCAAGTTGGCGGCAACCCAAAGCCCCATGTATACTGGAAAAAATCTGGTGTTCCTCTAACCACTGGATACAG
>TTN-214,ENSE00003804165,1,143,2812393,2812535,ATACAAAGTGAGTTACAACAAACAAACCGGTGAATGCAAGCTGGTGATTTCTATGACTTTTGCTGATGATGCTGGAGAATACACTATTGTTGTTCGCAATAAGCATGGAGAAACTTCTGCATCTGCTTCCTTGCTTGAAGAAG
>TTN-214,ENSE00003802603,1,206,2812536,2812741,CTGATTATGAGTTACTGATGAAGTCCCAGCAAGAAATGCTTTATCAGACACAAGTGACTGCATTTGTTCAAGAACCTAAAGTTGGAGAAACAGCACCTGGATTTGTATACTCTGAGTATGAAAAAGAGTATGAAAAAGAACAAGCCTTAATTAGGAAGAAAATGGCCAAAGATACTGTAGTGGTCAGAACTTATGTAGAAGATCAG
>TTN-214,ENSE00003807963,1,234,2812742,2812975,GAATTCCATATTTCTTCCTTTGAAGAGAGACTTATTAAAGAAATTGAATATAGAATAATAAAGACTACATTAGAAGAACTTCTTGAAGAAGATGGAGAAGAAAAGATGGCAGTTGACATTTCTGAATCTGAAGCTGTTGAATCAGGATTTGATTCAAGAATCAAGAATTATAGAATTCTTGAGGGGATGGGTGTCACTTTTCATTGCAAGATGTCTGGATATCCATTACCAAAG
>TTN-214,ENSE00003808968,1,245,2812976,2813220,ATTGCTTGGTACAAAGATGGCAAGCGCATCAAACATGGAGAAAGATACCAAATGGACTTTCTACAAGATGGCAGAGCTAGTCTGCGTATACCTGTTGTTCTTCCAGAAGATGAAGGAATCTACACTGCATTTGCCAGCAATATTAAAGGAAATGCAATTTGCTCAGGGAAATTGTATGTGGAGCCTGCTGCACCACTTGGAGCTCCGACTTACATTCCCACACTAGAGCCAGTGAGCAGAATCAG
>TTN-214,ENSE00003802614,1,272,2813221,2813492,ATCTCTCTCTCCACGTTCAGTGAGCAGGTCTCCTATACGCATGTCTCCTGCACGGATGTCACCTGCAAGGATGTCTCCTGCACGGATGTCCCCTGCAAGAATGTCCCCTGGACGTAGGCTGGAGGAGACAGATGAGTCACAACTTGAGAGACTATATAAACCAGTCTTTGTGTTAAAACCTGTTTCTTTCAAATGTTTAGAAGGGCAAACTGCCAGATTTGACTTAAAGGTTGTTGGTAGACCTATGCCAGAGACGTTCTGGTTTCATGATG
>TTN-214,ENSE00003811446,1,165,2813493,2813657,GCCAGCAAATTGTCAATGACTATACCCATAAAGTAGTCATTAAAGAAGATGGTACTCAATCACTAATTATTGTCCCTGCCACACCCAGTGATTCTGGGGAATGGACTGTGGTTGCCCAAAACAGGGCAGGCAGATCTTCAATTTCAGTGATTTTAACTGTGGAAG
>TTN-214,ENSE00003805710,1,169,2813658,2813826,CTGTGGAACATCAGGTAAAACCGATGTTTGTAGAAAAACTGAAAAATGTCAATATAAAGGAAGGTTCCCGACTTGAAATGAAAGTCAGAGCTACGGGTAACCCCAACCCTGACATTGTATGGTTGAAAAACAGTGACATCATTGTGCCTCATAAATATCCCAAAATCAG
>TTN-214,ENSE00003809358,1,1694,2813827,2815520,AATTGAAGGAACCAAGGGAGAAGCTGCCCTTAAAATCGATTCCACTGTCAGCCAAGATTCTGCCTGGTATACTGCGACTGCTATTAATAAAGCTGGCAGAGACACTACAAGATGCAAAGTAAATGTTGAAGTTGAGTTTGCAGAGCCTGAGCCAGAGAGAAAGTTAATCATCCCACGGGGGACATATAGAGCAAAGGAGATTGCAGCCCCAGAACTGGAGCCCCTCCATTTGCGATATGGCCAAGAGCAATGGGAAGAAGGTGATCTCTATGACAAAGAGAAACAACAGAAACCATTTTTCAAGAAAAAACTCACTTCCTTAAGACTTAAGCGCTTTGGGCCTGCCCACTTTGAATGCAGGCTAACACCCATTGGTGACCCAACGATGGTGGTGGAGTGGCTCCATGATGGAAAGCCACTTGAAGCAGCCAACAGGCTCCGTATGATCAATGAATTTGGGTACTGCAGCCTTGATTATGGCGTTGCATATTCTAGAGACAGTGGTATCATTACTTGCAGAGCCACTAACAAATATGGAACAGATCACACATCTGCTACCCTTATTGTTAAAGATGAGAAAAGTCTTGTGGAAGAATCCCAATTGCCTGAGGGGAGGAAAGGCTTACAGAGAATTGAAGAATTAGAGAGAATGGCTCATGAAGGTGCACTTACAGGTGTAACAACAGATCAGAAAGAAAAGCAAAAGCCAGACATTGTCTTGTACCCAGAGCCAGTTAGAGTACTTGAAGGGGAGACTGCAAGGTTCCGCTGCAGGGTAACAGGCTACCCTCAGCCCAAAGTCAACTGGTACCTCAATGGACAGCTCATCCGCAAAAGCAAAAGGTTCAGAGTTCGCTATGATGGTATCCATTACCTGGACATCGTGGACTGCAAATCATATGACACAGGTGAAGTGAAGGTCACCGCGGAAAATCCTGAAGGTGTGATAGAGCATAAAGTGAAGCTTGAGATTCAACAGAGGGAAGATTTTAGGTCTGTCCTTAGGAGAGCTCCTGAACCAAGGCCTGAGTTTCACGTACATGAACCAGGAAAGCTTCAGTTTGAAGTACAAAAAGTGGATAGACCTGTTGACACCACTGAAACCAAAGAAGTTGTGAAGTTGAAAAGGGCTGAAAGAATTACCCATGAAAAAGTGCCTGAAGAGTCGGAAGAGCTGCGCAGTAAATTCAAGCGCAGAACAGAAGAGGGCTATTATGAAGCCATTACCGCTGTGGAGCTCAAGTCTCGAAAGAAGGATGAATCCTATGAGGAACTCCTCAGGAAGACAAAAGATGAACTTCTCCACTGGACCAAAGAGTTAACTGAAGAGGAAAAGAAAGCTCTTGCCGAAGAAGGCAAAATCACGATTCCAACTTTTAAACCTGACAAGATTGAACTAAGTCCTAGTATGGAGGCTCCAAAAATCTTCGAAAGAATCCAGAGCCAAACAGTGGGCCAAGGATCTGATGCACACTTCCGGGTCAGAGTCGTGGGGAAACCAGACCCCGAATGTGAATGGTACAAAAATGGTGTCAAAATTGAACGGTCTGACCGGATCTACTGGTACTGGCCCGAAGACAATGTTTGTGAATTGGTCATAAGAGATGTGACTGCTGAGGACTCTGCCAGCATCATGGTAAAAGCCATCAACATAGCTGGAGAAACCTCCAGTCACGCATTCTTACTTGTCCAAG
>TTN-214,ENSE00003809440,1,282,2815521,2815802,CCAAGCAATTGATCACTTTCACACAGGAATTACAAGATGTTGTTGCTAAGGAAAAAGACACTATGGCAACCTTTGAATGTGAAACTTCAGAACCATTTGTCAAAGTGAAATGGTATAAAGATGGTATGGAGGTTCATGAGGGAGATAAATACAGGATGCACTCTGACAGAAAGGTTCACTTCCTCTCCATACTGACCATTGATACGTCTGATGCTGAAGATTACAGCTGTGTACTTGTGGAAGATGAAAATGTCAAAACGACTGCTAAACTTATTGTTGAAG
>TTN-214,ENSE00003802960,1,267,2815803,2816069,GTGCAGTTGTTGAGTTTGTGAAAGAACTTCAGGACATAGAAGTTCCAGAATCATATTCAGGAGAATTAGAGTGCATTGTATCCCCAGAAAATATAGAAGGAAAATGGTATCATAATGATGTGGAGCTTAAATCCAATGGCAAATATACAATTACATCTCGTCGTGGACGTCAGAACCTCACGGTCAAGGATGTAACCAAGGAGGACCAGGGAGAATACAGCTTTGTCATCGACGGGAAAAAGACAACCTGTAAATTAAAGATGAAAC
>TTN-214,ENSE00003804241,1,273,2816070,2816342,CCCGCCCCATTGCTATCCTACAAGGACTTAGTGACCAAAAAGTCTGTGAGGGTGACATTGTTCAGCTTGAAGTTAAAGTCTCCTTGGAAAGTGTGGAAGGCGTCTGGATGAAAGACGGCCAAGAAGTGCAGCCCAGTGACAGGGTTCACATTGTGATAGACAAACAATCTCATATGCTGCTCATTGAAGACATGACTAAGGAAGATGCTGGAAATTACTCTTTCACCATTCCAGCCCTTGGCCTCTCCACCAGTGGGCGTGTCTCTGTCTATA
>TTN-214,ENSE00003806988,1,264,2816343,2816606,GTGTGGACGTGATAACACCTCTAAAAGATGTTAATGTGATTGAAGGCACCAAGGCTGTGCTTGAATGTAAGGTGTCAGTCCCTGATGTGACTTCTGTTAAGTGGTACTTAAATGATGAACAAATCAAGCCTGATGACCGTGTACAGGCCATTGTGAAAGGTACTAAACAGCGACTAGTCATTAACCGAACTCATGCTTCAGACGAAGGACCTTACAAGCTGATAGTTGGCAGAGTTGAAACCAACTGTAATCTCTCTGTAGAAA
>TTN-214,ENSE00003804968,1,261,2816607,2816867,AAATTAAAATTATCAGAGGTCTTCGTGACCTTACCTGTACAGAAACTCAAAATGTGGTGTTTGAGGTTGAGCTGTCCCACTCTGGAATTGATGTCCTGTGGAATTTTAAGGACAAGGAAATCAAGCCCAGTTCTAAATATAAAATTGAAGCACATGGAAAAATATATAAATTGACAGTTCTAAATATGATGAAAGATGATGAAGGAAAATACACATTTTACGCGGGAGAAAATATGACATCTGGAAAACTTACTGTGGCAG
>TTN-214,ENSE00003809850,1,261,2816868,2817128,GTGGGGCCATCTCCAAGCCACTCACAGATCAGACCGTAGCTGAATCCCAGGAAGCTGTGTTTGAATGTGAAGTTGCCAACCCAGATTCCAAAGGCGAATGGTTGAGGGATGGCAAACACCTACCACTGACTAACAACATCAGAAGTGAGTCTGATGGCCACAAAAGGAGACTTATCATTGCTGCCACCAAATTAGATGACATTGGAGAATATACCTACAAGGTGGCCACCTCCAAAACATCTGCCAAACTCAAAGTTGAAG
>TTN-214,ENSE00003806479,1,264,2817129,2817392,CTGTCAAAATTAAGAAGACTCTGAAGAACCTCACAGTGACAGAAACACAGGATGCTGTTTTCACTGTCGAGCTTACACACCCTAATGTCAAAGGTGTCCAGTGGATCAAAAATGGAGTTGTGCTGGAATCCAATGAAAAGTATGCTATCTCTGTCAAAGGAACAATTTACTCTCTGAGGATTAAAAACTGTGCCATCGTGGATGAGTCTGTTTATGGCTTCAGGCTTGGAAGGCTTGGAGCCAGTGCCAGACTGCACGTGGAGA
>TTN-214,ENSE00003804523,1,261,2817393,2817653,CTGTCAAGATCATTAAAAAGCCAAAGGATGTGACAGCCTTGGAAAATGCCACTGTTGCCTTTGAAGTTAGTGTTTCCCATGACACTGTTCCAGTAAAATGGTTCCATAAGAGTGTGGAAATTAAGCCAAGTGACAAACACAGACTGGTCTCAGAAAGGAAAGTCCACAAGCTGATGCTGCAGAACATCTCCCCCTCAGATGCTGGGGAATACACAGCTGTGGTCGGGCAATTGGAATGCAAAGCAAAACTGTTTGTGGAGA
>TTN-214,ENSE00003807378,1,261,2817654,2817914,CATTACATATTACAAAAACCATGAAAAATATCGAGGTGCCTGAGACCAAAACTGCCTCTTTTGAGTGTGAGGTGTCCCACTTCAATGTCCCTTCCATGTGGCTGAAGAATGGTGTGGAAATTGAGATGAGTGAAAAGTTCAAGATAGTTGTGCAGGGAAAACTCCATCAGCTGATCATCATGAACACCAGCACAGAGGACTCGGCAGAATACACATTTGTCTGTGGCAATGACCAAGTCAGTGCCACCCTGACAGTCACCC
>TTN-214,ENSE00003807271,1,261,2817915,2818175,CAATCATGATTACTTCCATGCTGAAAGACATCAACGCTGAAGAAAAAGACACTATTACTTTTGAGGTGACAGTGAACTATGAAGGCATCTCTTACAAATGGTTAAAGAATGGTGTGGAAATCAAATCAACTGACAAGTGCCAGATGAGAACCAAAAAGCTCACACACTCACTGAACATCAGGAATGTTCACTTTGGGGATGCTGCTGACTACACCTTTGTGGCTGGAAAAGCAACATCAACAGCCACACTTTATGTGGAAG
>TTN-214,ENSE00003808172,1,142,2818176,2818317,CTCGTCATATAGAATTTAGGAAACACATTAAGGACATTAAGGTACTGGAGAAGAAGCGAGCCATGTTTGAATGTGAAGTTTCTGAACCTGACATCACTGTACAGTGGATGAAAGATGACCAGGAACTGCAGATCACAGACAG
>TTN-214,ENSE00003808223,1,166,2818318,2818483,AATAAAGATTCAGAAGGAGAAATATGTCCACCGCCTTCTGATCCCATCCACCCGGATGTCTGATGCTGGGAAGTACACAGTGGTGGCAGGAGGCAACGTGTCAACTGCAAAACTCTTTGTAGAAGGCAGAGATGTTCGCATCCGAAGTATTAAAAAGGAGGTTCAG
>TTN-214,ENSE00003810851,1,232,2818484,2818715,GTCATTGAGAAACAGCGTGCTGTTGTTGAATTTGAGGTCAATGAAGACGATGTTGATGCCCACTGGTATAAAGATGGCATTGAAATCAATTTCCAAGTTCAAGAACGACACAAATATGTAGTGGAAAGAAGAATCCACCGAATGTTTATCTCTGAGACCAGACAGAGCGATGCAGGAGAATACACCTTTGTGGCAGGAAGGAACAGGAGTTCTGTCACTCTCTATGTCAATG
>TTN-214,ENSE00003802092,1,285,2818716,2819000,CTCCTGAACCGCCCCAAGTTCTGCAGGAGCTCCAGCCTGTCACTGTGCAGTCTGGCAAGCCTGCCCGCTTCTGTGCCGTGATATCCGGAAGACCACAGCCCAAAATTTCCTGGTACAAGGAAGAGCAGCTGCTTTCCACTGGCTTCAAGTGCAAATTTCTTCATGATGGGCAAGAATACACGCTTTTGCTAATTGAAGCCTTCCCAGAGGATGCGGCAGTCTATACCTGTGAAGCCAAGAATGACTATGGTGTTGCCACAACATCAGCTTCACTCTCAGTGGAAG
>TTN-214,ENSE00003807103,1,126,2819001,2819126,TTCCAGAAGTTGTGTCTCCTGATCAGGAAATGCCTGTTTATCCACCTGCCATCATCACCCCGCTTCAGGACACTGTCACTTCTGAAGGGCAGCCAGCCCGTTTTCAATGCCGGGTTTCTGGAACAG
>TTN-214,ENSE00003801355,1,189,2819127,2819315,ATCTAAAAGTGTCGTGGTACAGCAAAGACAAGAAAATCAAGCCATCTCGGTTCTTTAGAATGACTCAATTTGAAGACACTTATCAACTGGAAATTGCCGAAGCTTATCCAGAAGATGAAGGAACTTACACGTTTGTTGCTAGTAATGCTGTAGGCCAAGTATCAAGCACAGCCAACCTGAGTCTGGAAG
>TTN-214,ENSE00003810791,1,57,2819316,2819372,CTCCTGAATCAATTTTGCATGAGAGGATTGAACAAGAGATTGAGATGGAAATGAAAG
>TTN-214,ENSE00004024265,1,2781,2819373,2822153,AGTTTTCTAGTTCTTTTCTGTCTGCCGAGGAAGAAGGACTTCATAGCGCCGAACTTCAATTATCTAAAATAAATGAAACACTTGAACTTTTGTCTGAATCTCCAGTTTACCCAACTAAATTTGATTCCGAAAAGGAAGGCACTGGCCCAATTTTCATCAAAGAAGTGTCAAATGCTGATATAAGCATGGGGGATGTGGCTACACTGTCTGTAACTGTCATTGGCATCCCCAAACCTAAAATTCAGTGGTTCTTTAATGGAGTGCTATTAACCCCTTCTGCTGACTACAAATTTGTTTTTGACGGTGATGATCATAGCCTGATCATTCTGTTCACCAAATTGGAGGATGAGGGAGAGTATACATGTATGGCCAGTAATGACTATGGAAAGACAATATGTAGTGCCTATCTAAAAATTAATTCCAAAGGAGAGGGTCACAAAGACACTGAAACAGAATCAGCAGTGGCAAAATCTCTGGAAAAGCTGGGAGGTCCTTGTCCTCCTCACTTCCTTAAGGAGTTAAAACCAATTCGCTGTGCTCAAGGGCTTCCTGCCATCTTTGAGTACACAGTGGTTGGAGAGCCTGCCCCTACTGTTACATGGTTCAAAGAAAACAAGCAGCTTTGCACCAGTGTTTATTACACTATCATTCATAACCCTAATGGCTCTGGAACTTTCATTGTCAATGACCCTCAGAGGGAAGACAGTGGCCTCTATATCTGTAAAGCAGAGAATATGTTGGGTGAGTCCACCTGTGCAGCAGAGCTGCTTGTGCTTCTGGAAGACACAGACATGACTGATACCCCCTGCAAAGCAAAGTCCACACCAGAGGCTCCTGAGGATTTTCCACAGACACCCTTAAAGGGTCCCGCAGTTGAAGCACTTGACTCAGAGCAGGAAATTGCAACGTTTGTAAAAGACACCATTTTGAAAGCTGCTTTAATTACAGAAGAAAACCAGCAACTATCTTATGAGCATATTGCTAAAGCCAATGAATTGAGCAGTCAGCTTCCTTTGGGAGCTCAGGAATTGCAATCCATTTTGGAGCAAGACAAGCTCACTCCTGAAAGCACCAGGGAATTTCTTTGCATCAATGGCAGTATTCACTTTCAGCCTCTCAAGGAACCATCTCCCAACCTACAGCTGCAGATTGTACAGTCCCAGAAAACCTTCTCCAAAGAAGGTATTCTAATGCCTGAAGAGCCTGAGACACAGGCAGTTCTATCAGATACCGAGAAAATCTTCCCAAGTGCCATGTCCATAGAACAAATTAATTCATTAACAGTTGAGCCTCTGAAAACTTTATTAGCTGAACCTGAAGGGAATTATCCACAGTCTTCAATAGAACCTCCAATGCATTCTTATCTAACCTCTGTGGCTGAGGAAGTACTTTCACCAAAAGAAAAGACAGTATCTGACACCAACAGAGAGCAAAGAGTGACTCTTCAAAAGCAAGAGGCACAAAGTGCGCTCATCTTGAGTCAGAGCTTAGCTGAGGGACACGTGGAGAGTCTCCAGAGTCCTGATGTCATGATCTCTCAGGTAAACTATGAGCCCCTAGTCCCTTCAGAACACTCATGCACAGAAGGAGGTAAAATTTTGATAGAAAGTGCAAATCCACTGGAAAATGCAGGGCAAGATTCTGCGGTCAGAATTGAGGAAGGCAAGTCCTTAAGATTTCCACTAGCACTTGAAGAAAAGCAGGTACTGCTCAAAGAAGAGCATTCTGACAACGTGGTGATGCCCCCAGACCAAATCATTGAGTCTAAAAGAGAGCCCGTGGCAATAAAGAAAGTGCAGGAGGTACAGGGAAGGGACCTTCTTTCTAAGGAAAGCTTGCTTTCTGGTATTCCAGAAGAGCAGAGATTAAACCTGAAAATTCAAATCTGCCGGGCTTTGCAAGCAGCCGTGGCCAGCGAGCAGCCAGGTCTTTTCTCTGAGTGGCTAAGAAATATTGAAAAGGTGGAGGTCGAGGCTGTAAACATCACCCAAGAGCCCAGACACATCATGTGCATGTACCTTGTTACTTCGGCAAAGTCTGTAACAGAAGAAGTAACCATCATTATTGAAGATGTTGATCCTCAAATGGCTAACCTGAAAATGGAACTTAGGGATGCTTTGTGTGCTATTATATATGAGGAAATAGACATCCTAACAGCTGAGGGTCCTAGAATTCAGCAAGGAGCCAAAACAAGTTTGCAAGAAGAAATGGATTCTTTTTCAGGTTCACAGAAGGTTGAACCCATTACTGAACCAGAAGTTGAATCTAAATATCTGATCTCAACTGAAGAGGTCAGTTATTTTAACGTGCAAAGTAGGGTTAAATATTTGGATGCCACACCTGTCACTAAAGGGGTTGCTTCAGCTGTTGTCTCTGACGAAAAACAAGATGAGAGTCTGAAACCATCAGAGGAAAAAGAGGAGTCTTCCTCTGAAAGTGGTACTGAGGAGGTTGCTACAGTAAAGATACAGGAAGCTGAGGGTGGCTTAATCAAAGAGGATGGCCCCATGATACATACACCTTTAGTGGACACTGTTTCTGAGGAAGGTGATATTGTACACCTCACAACATCCATAACAAATGCTAAAGAGGTGAATTGGTATTTTGAGAATAAACTGGTGCCTTCAGATGAAAAGTTCAAGTGTTTACAAGATCAAAATACATATACGCTAGTCATCGACAAAGTAAATACCGAAGACCATCAAGGAGAGTATGTCTGTGAGGCCTTGAATGACAGCGGAAAAACAGCAACTTCAGCCAAACTCACTGTAGTAAAAAGAG
>TTN-214,ENSE00003805227,1,279,2822154,2822432,CTGCCCCAGTGATCAAGAGGAAAATCGAACCCCTGGAAGTAGCACTGGGCCACCTAGCCAAATTCACCTGTGAGATCCAAAGTGCTCCCAATGTCCGGTTCCAGTGGTTTAAAGCTGGCCGAGAAATTTATGAGAGTGACAAGTGTTCTATTCGATCTTCAAAGTATATCTCCAGCCTTGAAATCCTGAGAACCCAGGTGGTTGACTGCGGCGAGTATACATGCAAAGCTTCCAATGAGTATGGCAGTGTCAGCTGTACAGCCACACTAACTGTGACAG
>TTN-214,ENSE00003808619,1,564,2822433,2822996,AGGCATATCCACCAACCTTTCTCTCCAGACCTAAGTCCCTTACAACTTTTGTGGGTAAGGCAGCCAAGTTCATCTGCACAGTGACAGGGACTCCTGTGATAGAAACCATTTGGCAGAAAGATGGTGCTGCACTCTCACCTTCACCTAACTGGAGGATTTCCGACGCAGAAAACAAACACATTTTAGAACTCTCAAACCTTACCATTCAAGATAGAGGAGTTTATTCTTGTAAGGCTTCCAACAAGTTTGGAGCAGACATCTGCCAAGCAGAGTTGATCATCATTGATAAGCCACATTTCATTAAAGAATTAGAGCCTGTGCAGTCCGCTATCAATAAGAAGGTCCACCTTGAGTGCCAAGTAGATGAAGACAGAAAAGTCACAGTTACGTGGAGCAAAGATGGGCAAAAACTCCCCCCAGGGAAAGATTATAAGATCTGTTTTGAAGATAAAATAGCAACACTTGAGATTCCTTTGGCCAAACTGAAAGATTCAGGAACCTATGTCTGTACAGCTTCAAATGAGGCTGGAAGCAGCTCCTGCTCAGCCACAGTCACTGTCAGAG
>TTN-214,ENSE00003811334,1,282,2822997,2823278,AGCCACCATCCTTCGTGAAGAAGGTGGATCCCTCTTATTTAATGCTCCCAGGTGAATCAGCACGCCTCCATTGCAAGCTGAAAGGCTCACCTGTGATCCAGGTTACTTGGTTTAAAAATAACAAAGAACTCAGTGAAAGTAACACAGTCCGAATGTATTTTGTCAATTCTGAGGCTATACTTGATATTACGGATGTAAAAGTTGAAGACAGTGGGAGTTACTCATGTGAAGCAGTGAATGACGTCGGCAGTGATAGCTGCAGTACTGAAATAGTTATCAAAG
>TTN-214,ENSE00003807496,1,279,2823279,2823557,AACCTCCTTCTTTCATCAAAACTCTTGAGCCTGCAGACATAGTGAGAGGAACAAATGCTCTACTTCAGTGTGAAGTCTCAGGCACTGGACCATTTGAAATTAGCTGGTTCAAAGACAAGAAACAAATTCGAAGTAGTAAAAAATACAGATTGTTTTCTCAGAAGTCTCTTGTGTGTCTGGAGATCTTTTCGTTTAATAGTGCAGATGTTGGTGAATATGAATGTGTTGTTGCTAATGAAGTCGGCAAGTGTGGCTGCATGGCAACCCACTTACTCAAAG
>TTN-214,ENSE00003806831,1,279,2823558,2823836,AACCTCCAACCTTTGTAAAGAAAGTAGATGATTTGATTGCACTAGGAGGACAAACCGTTACCCTGCAAGCTGCTGTGAGAGGGTCAGAGCCCATTTCTGTCACATGGATGAAAGGTCAAGAGGTCATCAGAGAAGACGGAAAAATCAAAATGAGCTTTTCCAATGGTGTTGCAGTCTTGATAATCCCTGATGTTCAGATTAGTTTTGGAGGCAAATACACGTGCCTGGCTGAAAATGAAGCTGGAAGCCAAACATCTGTTGGGGAATTAATAGTTAAAG
>TTN-214,ENSE00003801788,1,279,2823837,2824115,AACCTGCCAAAATCATTGAGCGAGCAGAACTGATCCAGGTGACAGCAGGAGATCCCGCCACACTGGAGTACACAGTGGCAGGCACGCCAGAACTGAAGCCCAAATGGTACAAAGATGGGAGACCCTTGGTCGCCAGTAAAAAATACCGAATAAGTTTTAAAAACAATGTTGCCCAGCTCAAATTTTATTCAGCTGAGCTGCACGACAGTGGCCAATACACATTTGAGATTTCCAATGAAGTGGGCAGCAGCTCCTGTGAGACTACATTCACTGTATTAG
>TTN-214,ENSE00003804186,1,288,2824116,2824403,ATCGAGACATTGCTCCATTTTTTACCAAACCCTTGCGCAACGTGGATAGTGTTGTTAATGGTACCTGCAGACTGGACTGCAAAATTGCAGGCTCCCTCCCCATGAGGGTGTCCTGGTTTAAGGATGGCAAAGAAATAGCTGCTTCTGACAGATACAGGATAGCATTTGTGGAAGGCACAGCCTCTTTGGAGATCATCAGAGTAGACATGAATGATGCAGGGAATTTCACTTGTCGAGCCACAAATTCCGTGGGAAGCAAAGACAGCAGTGGAGCCCTGATTGTGCAAG
>TTN-214,ENSE00003805178,1,279,2824404,2824682,AACCACCCAGTTTTGTAACTAAACCCGGCTCAAAGGATGTTCTGCCTGGCTCAGCAGTCTGCCTGAAGAGCACTTTCCAAGGATCTACTCCTCTCACAATCAGATGGTTTAAGGGCAACAAAGAGCTGGTTTCTGGTGGAAGCTGCTATATTACCAAAGAAGCTTTAGAGAGTTCCCTGGAACTCTATTTAGTAAAAACCTCTGATTCGGGCACGTACACATGTAAAGTCAGCAATGTCGCTGGAGGGGTGGAATGCAGTGCAAACTTGTTTGTAAAAG
>TTN-214,ENSE00003806856,1,282,2824683,2824964,AACCTGCCACATTTGTTGAAAAGTTAGAGCCATCACAGCTGTTAAAGAAGGGAGATGCCACCCAGCTAGCCTGCAAAGTAACTGGTACCCCTCCAATTAAAATAACATGGTTTGCAAATGATAGAGAAATTAAGGAGAGCAGCAAACACAGAATGTCTTTTGTGGAGTCTACTGCAGTTCTAAGACTGACAGATGTTGGCATCGAAGACAGTGGTGAATATATGTGTGAGGCCCAAAATGAGGCTGGCAGTGACCACTGCAGTAGCATTGTAATAGTCAAAG
>TTN-214,ENSE00003804074,1,279,2824965,2825243,AGTCACCTTATTTTACCAAGGAATTTAAGCCAATTGAAGTCTTAAAGGAGTACGATGTCATGTTGCTGGCTGAGGTGGCAGGCACTCCTCCCTTTGAGATCACTTGGTTCAAAGATAACACAATCCTGCGAAGTGGTAGAAAGTATAAGACTTTCATTCAGGATCATCTGGTTAGCCTGCAGATCCTCAAGTTTGTAGCTGCAGATGCTGGCGAATACCAGTGTCGGGTGACCAATGAGGTGGGCAGCAGCATCTGCAGTGCCAGGGTGACTTTAAGAG
>TTN-214,ENSE00003807057,1,279,2825244,2825522,AACCCCCATCCTTCATAAAGAAGATCGAGAGTACCAGCTCCCTCCGGGGAGGCACAGCTGCCTTCCAGGCCACTCTGAAGGGCTCCTTGCCAATTACGGTGACTTGGCTAAAAGACAGCGATGAAATCACTGAAGACGATAATATAAGAATGACCTTTGAGAACAATGTGGCCAGTTTGTACCTCAGTGGCATTGAAGTCAAGCATGATGGGAAATATGTCTGTCAGGCCAAAAATGATGCAGGAATACAAAGATGTTCTGCATTACTCTCAGTAAAAG
>TTN-214,ENSE00003807032,1,279,2825523,2825801,AACCTGCAACAATCACCGAGGAAGCTGTGTCTATAGATGTCACCCAAGGAGACCCAGCCACTTTGCAGGTTAAATTTTCAGGGACTAAGGAGATTACAGCCAAATGGTTTAAAGATGGCCAAGAACTGACCCTGGGCTCAAAATATAAAATCAGTGTCACTGATACAGTCTCAATACTGAAGATTATTTCTACAGAAAAGAAAGATAGTGGAGAATATACTTTCGAGGTCCAAAATGATGTTGGGAGGAGCAGCTGCAAGGCTAGAATTAATGTATTAG
>TTN-214,ENSE00003810010,1,288,2825802,2826089,ATCTTATCATACCTCCTTCATTCACCAAAAAGCTGAAGAAAATGGACAGCATTAAAGGTTCTTTCATTGATTTAGAATGTATAGTGGCTGGGTCACATCCCATAAGCATCCAGTGGTTCAAAGATGACCAAGAAATATCAGCTAGTGAAAAGTACAAATTCTCTTTTCATGACAATACTGCCTTCTTGGAAATCAGCCAGCTGGAAGGTACAGACAGTGGGACATACACTTGTTCTGCCACAAATAAGGCAGGGCACAACCAATGCAGTGGGCATCTGACAGTCAAAG
>TTN-214,ENSE00003805733,1,279,2826090,2826368,AACCCCCTTACTTTGTGGAAAAGCCACAGTCACAAGATGTCAATCCCAACACAAGGGTACAGTTAAAGGCTCTTGTGGGTGGCACTGCACCCATGACAATAAAGTGGTTTAAAGATAACAAAGAGTTACACTCAGGAGCAGCCCGCTCAGTTTGGAAGGATGACACCTCTACCAGTCTAGAGCTCTTTGCAGCCAAAGCTACCGATTCTGGAACCTACATTTGCCAACTAAGCAATGATGTTGGCACAGCAACCAGCAAAGCCACTCTCTTTGTAAAAG
>TTN-214,ENSE00003805836,1,282,2826369,2826650,AACCTCCTCAATTCATTAAGAAGCCCAGTCCAGTCTTAGTGCTGAGGAATGGACAGTCAACAACATTTGAATGCCAAATAACAGGCACTCCTAAAATCCGAGTGTCTTGGTATCTAGACGGGAATGAAATAACAGCCATTCAGAAACATGGCATTTCCTTCATTGATGGTTTAGCCACTTTCCAGATTTCTGGTGCCAGGGTAGAAAATAGTGGGACTTATGTGTGTGAAGCTCGAAATGACGCAGGCACGGCGAGCTGCAGCATTGAACTCAAAGTGAAAG
>TTN-214,ENSE00003802637,1,279,2826651,2826929,AACCCCCCACCTTTATCAGAGAGCTGAAGCCTGTGGAGGTAGTAAAATATAGTGACGTGGAGCTGGAGTGTGAAGTTACGGGAACACCTCCGTTTGAAGTCACTTGGCTGAAGAATAACAGGGAAATTCGAAGCAGCAAAAAATACACATTGACCGACAGAGTGTCTGTGTTTAACCTCCATATAACCAAGTGTGACCCTTCAGACACTGGGGAATACCAGTGCATTGTATCCAATGAAGGCGGCAGCTGCTCATGCAGTACTAGAGTTGCCCTGAAAG
>TTN-214,ENSE00003809504,1,279,2826930,2827208,AACCACCATCATTCATTAAGAAGATAGAAAATACCACTACTGTTTTGAAAAGTTCTGCCACCTTTCAGAGTACCGTGGCAGGTTCTCCTCCTATTTCTATAACCTGGCTAAAGGATGATCAGATTCTTGATGAAGATGATAATGTCTATATTTCATTTGTGGACAGTGTGGCCACACTTCAAATCAGAAGTGTGGATAATGGACACAGTGGGAGATATACCTGTCAAGCCAAGAATGAGTCAGGAGTTGAGAGGTGTTATGCTTTCCTTTTAGTACAAG
>TTN-214,ENSE00003802968,1,279,2827209,2827487,AACCAGCTCAAATCGTAGAGAAAGCTAAATCAGTTGATGTTACGGAGAAAGATCCCATGACCTTGGAATGTGTTGTGGCTGGAACACCAGAACTCAAAGTGAAATGGCTTAAAGACGGGAAACAAATAGTTCCCAGTAGATACTTTTCAATGAGTTTTGAAAATAACGTGGCCAGTTTTAGAATTCAGTCAGTAATGAAGCAGGACAGCGGTCAGTACACTTTCAAGGTGGAAAATGACTTCGGAAGCAGTAGCTGTGATGCCTACTTAAGAGTGCTAG
>TTN-214,ENSE00003810612,1,288,2827488,2827775,ATCAAAATATTCCTCCATCATTCACCAAAAAATTAACCAAAATGGATAAAGTTCTGGGCTCTTCTATTCATATGGAGTGCAAGGTGTCTGGTTCACTTCCCATTAGTGCTCAGTGGTTTAAGGATGGAAAAGAAATATCTACAAGTGCAAAATACAGACTTGTGTGCCATGAGAGATCTGTGTCTCTGGAAGTTAATAATCTGGAATTAGAAGATACTGCAAATTACACATGCAAAGTGTCAAATGTAGCAGGAGATGATGCATGCAGTGGCATCTTAACTGTGAAAG
>TTN-214,ENSE00003806423,1,279,2827776,2828054,AACCACCAAGCTTCCTAGTGAAACCTGGGCGACAGCAAGCCATACCTGATTCTACAGTGGAATTTAAGGCAATACTAAAAGGAACACCACCATTTAAAATAAAATGGTTTAAGGATGATGTGGAACTTGTCTCAGGTCCTAAATGTTTCATTGGCTTGGAAGGGTCGACTAGCTTCTTAAATCTCTACTCAGTGGATGCTTCTAAGACTGGACAGTATACTTGCCATGTTACCAATGATGTTGGTAGCGACTCTTGTACTACGATGTTGCTTGTGACAG
>TTN-214,ENSE00003805536,1,282,2828055,2828336,AACCACCAAAGTTTGTAAAGAAATTAGAAGCCTCCAAAATTGTGAAAGCAGGTGACTCTTCACGACTTGAATGCAAGATAGCTGGATCCCCAGAAATCAGAGTTGTGTGGTTCCGAAATGAACATGAACTTCCAGCCAGTGATAAGTACAGAATGACTTTCATTGACTCAGTGGCCGTCATACAGATGAACAATCTCAGTACTGAGGACAGTGGAGATTTCATTTGTGAGGCTCAGAATCCCGCTGGCAGCACAAGCTGCAGTACCAAGGTTATAGTAAAAG
>TTN-214,ENSE00003807762,1,279,2828337,2828615,AGCCACCTGTTTTTAGCAGCTTCCCTCCTATAGTAGAAACCCTTAAAAATGCTGAAGTCAGTCTTGAATGTGAACTTTCGGGAACACCACCGTTTGAGGTGGTATGGTACAAAGACAAGCGGCAACTCAGAAGCAGCAAGAAATACAAGATTGCATCCAAAAACTTCCACACAAGTATTCACATTCTCAATGTGGACACTTCAGACATCGGTGAATACCACTGCAAAGCACAGAATGAAGTGGGAAGTGATACTTGTGTTTGTACTGTAAAATTGAAAG
>TTN-214,ENSE00003809887,1,282,2828616,2828897,AACCACCAAGATTTGTCTCCAAACTGAACAGCCTCACTGTTGTAGCCGGAGAGCCTGCTGAATTACAAGCATCCATAGAAGGCGCCCAGCCTATTTTTGTCCAGTGGCTTAAAGAGAAGGAAGAAGTGATTAGAGAAAGTGAAAACATCAGGATTACATTTGTGGAAAATGTTGCAACTCTACAGTTTGCAAAAGCAGAGCCAGCTAATGCTGGAAAGTATATCTGCCAAATCAAGAATGATGGTGGAATGAGGGAGAACATGGCCACACTGATGGTCTTAG
>TTN-214,ENSE00003811356,1,279,2828898,2829176,AGCCCGCAGTCATTGTTGAGAAGGCAGGACCGATGACGGTGACTGTAGGAGAAACGTGCACTCTGGAGTGTAAGGTGGCTGGCACTCCGGAACTCTCTGTTGAATGGTACAAGGATGGAAAGCTGTTGACCAGCAGCCAAAAACACAAATTTAGCTTCTACAACAAAATCTCTTCCTTAAGGATTCTCTCAGTTGAAAGGCAAGATGCAGGCACATACACTTTCCAGGTTCAAAATAATGTTGGGAAAAGCAGCTGCACAGCTGTGGTTGATGTTTCAG
>TTN-214,ENSE00003804298,1,288,2829177,2829464,ACCGAGCAGTTCCTCCCTCTTTCACACGAAGACTGAAAAATACTGGTGGGGTGTTAGGTGCTTCTTGCATCTTGGAATGCAAAGTAGCTGGATCATCACCTATTTCAGTTGCCTGGTTTCATGAGAAAACCAAGATTGTCAGTGGAGCAAAGTACCAAACCACATTTTCAGATAATGTCTGCACATTGCAGTTGAATTCTCTGGATTCCTCAGATATGGGCAATTACACATGCGTGGCTGCTAATGTCGCTGGGTCTGATGAATGTCGTGCAGTGCTAACTGTACAAG
>TTN-214,ENSE00003807700,1,279,2829465,2829743,AACCACCCTCTTTTGTGAAAGAACCTGAACCTTTGGAAGTACTACCAGGCAAAAATGTAACCTTCACAAGCGTTATTAGAGGAACCCCTCCATTCAAAGTCAACTGGTTCAGAGGTGCCAGAGAACTAGTGAAAGGAGACCGGTGCAACATCTATTTTGAAGACACTGTGGCAGAACTGGAATTATTTAATATTGACATATCTCAGAGTGGGGAATACACCTGTGTGGTTTCTAACAACGCTGGCCAAGCATCTTGCACTACCCGTCTCTTTGTGAAAG
>TTN-214,ENSE00003803086,1,279,2829744,2830022,AACCAGCTGCATTTTTGAAGAGATTAAGTGATCATTCTGTAGAACCAGGGAAGTCCATAATTCTGGAGAGCACCTACACTGGAACACTTCCAATTTCTGTCACTTGGAAAAAGGATGGTTTTAACATAACTACCTCTGAAAAATGTAACATAGTCACAACAGAGAAAACTTGTATCCTGGAAATTCTGAATAGCACAAAAAGAGATGCAGGGCAGTATTCCTGCGAGATTGAAAATGAGGCAGGAAGGGATGTTTGTGGAGCTCTGGTATCTACATTAG
>TTN-214,ENSE00003806655,1,279,2830023,2830301,AACCGCCTTATTTTGTTACGGAACTGGAACCTCTGGAGGCAGCAGTTGGAGATTCGGTTTCTTTACAATGCCAAGTTGCTGGGACACCAGAAATTACAGTGTCTTGGTACAAAGGAGATACCAAATTACGGCCAACTCCTGAATACAGGACCTACTTTACAAACAATGTGGCCACACTTGTTTTTAATAAAGTGAACATCAATGACAGTGGAGAGTACACATGCAAAGCAGAAAATAGTATAGGAACTGCTTCTTCTAAGACTGTGTTCAGAATTCAAG
>TTN-214,ENSE00003805355,1,288,2830302,2830589,AGCGCCAACTCCCACCTTCTTTTGCAAGACAATTAAAGGACATTGAACAAACTGTGGGGTTACCTGTTACACTCACTTGTCGATTAAATGGCTCTGCACCCATCCAAGTGTGCTGGTATAGAGATGGAGTACTTTTAAGAGACGATGAAAATCTACAGACTTCATTTGTAGATAATGTGGCAACTTTAAAAATTTTGCAAACTGACTTGAGTCACTCTGGCCAGTACTCTTGCTCAGCTTCCAACCCACTTGGAACAGCATCTTCTAGTGCTAGACTCACAGCAAGAG
>TTN-214,ENSE00003804884,1,288,2830590,2830877,AACCCAAGAAATCTCCCTTCTTTGACATCAAGCCTGTATCTATAGATGTTATTGCTGGAGAAAGTGCTGATTTTGAGTGTCATGTTACTGGTGCTCAACCGATGCGAATCACTTGGTCAAAAGATAACAAGGAGATCCGTCCTGGAGGAAACTATACAATCACATGTGTGGGAAACACTCCTCATTTGAGAATTCTTAAAGTAGGCAAAGGAGACTCTGGTCAATATACTTGCCAAGCAACCAATGATGTTGGCAAAGACATGTGCTCAGCTCAGCTCAGTGTAAAAG
>TTN-214,ENSE00003805805,1,282,2830878,2831159,AACCTCCAAAGTTTGTTAAGAAATTAGAAGCTTCAAAAGTTGCAAAGCAGGGAGAATCCATTCAACTGGAATGTAAAATAAGTGGCTCCCCAGAAATCAAAGTTTCATGGTTCCGAAATGACAGCGAACTTCATGAAAGTTGGAAATACAACATGTCATTCATTAATTCTGTGGCATTGCTTACGATCAATGAAGCTAGTGCTGAAGACAGCGGGGACTACATTTGTGAGGCTCATAATGGTGTTGGTGACGCCAGCTGCAGCACAGCGTTGACAGTGAAAG
>TTN-214,ENSE00003803146,1,279,2831160,2831438,CACCTCCTGTTTTCACCCAGAAGCCTTCTCCAGTAGGAGCTCTTAAAGGTTCTGATGTGATTCTCCAATGTGAAATTTCGGGAACTCCCCCATTTGAAGTAGTATGGGTTAAAGATCGAAAGCAGGTTAGAAACAGCAAGAAATTTAAAATCACTTCAAAACATTTTGATACAAGTCTTCATATCCTTAATCTTGAAGCCTCCGATGTCGGGGAATATCACTGCAAAGCTACTAATGAGGTGGGAAGTGACACGTGTTCTTGCTCTGTCAAGTTCAAAG
>TTN-214,ENSE00003806016,1,282,2831439,2831720,AACCTCCACGATTCGTGAAAAAGCTAAGTGACACCTCAACCCTTATTGGGGATGCTGTTGAGTTACGGGCCATAGTGGAGGGCTTCCAGCCAATTTCTGTTGTCTGGCTGAAAGATAGAGGTGAAGTCATCAGAGAGAGTGAAAATACCAGGATTTCATTCATTGATAACATTGCAACCCTCCAGCTGGGGAGTCCAGAAGCATCTAATTCTGGAAAATATATATGCCAAATCAAAAACGATGCTGGAATGAGAGAATGCTCTGCAGTCTTGACTGTACTAG
>TTN-214,ENSE00003808302,1,279,2831721,2831999,AACCAGCAAGAATCATAGAGAAGCCCGAACCCATGACTGTCACTACTGGAAATCCTTTTGCATTAGAGTGTGTAGTGACTGGAACACCAGAACTCTCAGCCAAGTGGTTCAAAGATGGAAGAGAATTGTCTGCAGACAGCAAACATCACATTACATTCATCAATAAAGTGGCTTCCCTTAAAATCCCCTGTGCCGAAATGAGTGACAAAGGATTATATAGCTTTGAAGTGAAAAACAGTGTTGGCAAAAGTAACTGCACTGTATCCGTCCATGTTTCTG
>TTN-214,ENSE00003802442,1,288,2832000,2832287,ATCGGATTGTGCCTCCTTCCTTCATCCGCAAGCTGAAAGACGTGAATGCCATCCTGGGGGCCTCAGTTGTTTTGGAGTGCCGAGTCTCTGGCTCAGCCCCGATTTCAGTTGGCTGGTTTCAGGATGGAAATGAGATTGTTAGTGGGCCCAAATGTCAGTCCAGCTTTTCGGAAAACGTCTGTACTTTGAATCTGAGCTTGTTGGAGCCCTCCGACACAGGCATATACACGTGTGTGGCTGCCAATGTAGCTGGTTCCGATGAGTGCTCAGCAGTCCTGACTGTGCAAG
>TTN-214,ENSE00003809965,1,279,2832288,2832566,AACCACCATCTTTTGAACAAACCCCTGATTCTGTGGAAGTTTTGCCTGGAATGAGCCTCACATTCACCAGTGTCATCAGAGGCACCCCTCCTTTCAAGGTCAAGTGGTTTAAAGGCAGCAGGGAACTGGTGCCTGGGGAGTCATGCAACATCTCTCTGGAAGATTTTGTCACAGAACTGGAGTTGTTTGAGGTGCAGCCATTAGAAAGTGGAGACTATTCTTGCCTCGTTACAAATGATGCTGGCAGTGCTTCCTGTACCACACATCTTTTTGTGAAAG
>TTN-214,ENSE00003809650,1,279,2832567,2832845,AACCAGCCACCTTTGTGAAAAGATTGGCTGATTTCAGTGTTGAGACAGGAAGCCCCATAGTTCTCGAGGCCACATACACTGGCACACCTCCAATCTCAGTGAGCTGGATAAAGGACGAGTATCTTATTTCACAATCTGAGAGATGCAGTATTACTATGACAGAAAAATCTACCATACTGGAAATTCTTGAGAGCACAATAGAGGATTATGCACAGTACAGCTGCCTGATAGAAAATGAGGCTGGTCAAGATATCTGTGAAGCTCTGGTGTCTGTCTTAG
>TTN-214,ENSE00003810498,1,279,2832846,2833124,AACCACCGTACTTTATTGAACCTCTGGAACATGTGGAAGCAGTCATTGGAGAACCTGCAACTTTACAGTGTAAAGTGGATGGAACTCCAGAAATTAGAATTTCTTGGTATAAAGAACACACAAAGCTACGATCAGCTCCTGCATATAAAATGCAATTCAAAAATAACGTTGCTTCCTTAGTAATCAACAAAGTGGATCACAGTGATGTGGGAGAGTATTCATGCAAGGCAGACAACAGTGTGGGGGCAGTCGCTTCTTCAGCTGTGCTTGTTATCAAAG
>TTN-214,ENSE00003807178,1,288,2833125,2833412,CGCGCAAACTTCCACCTTTCTTTGCAAGAAAACTGAAAGACGTTCATGAGACTCTAGGCTTCCCAGTTGCATTTGAATGCCGCATCAATGGCTCAGAACCTCTTCAAGTGTCTTGGTACAAGGATGGGGTTCTTTTGAAAGATGATGCTAATTTGCAGACATCTTTTGTTCATAATGTAGCAACTCTTCAGATTTTACAAACTGACCAGAGCCACATAGGGCAGTATAATTGCTCTGCTTCTAATCCTCTTGGGACTGCTTCATCCAGTGCCAAGCTCATTCTCTCAG
>TTN-214,ENSE00003808579,1,288,2833413,2833700,AGCATGAAGTGCCTCCTTTCTTTGATCTAAAGCCTGTATCAGTAGATCTTGCTCTTGGAGAAAGTGGTACTTTTAAATGTCATGTAACTGGGACTGCACCAATCAAAATCACTTGGGCCAAAGATAACCGAGAGATTCGCCCTGGAGGCAACTACAAGATGACTTTGGTAGAAAATACTGCCACTCTGACAGTTCTCAAAGTAGGCAAAGGCGATGCCGGGCAGTACACCTGCTATGCAAGCAACATCGCTGGAAAAGACTCTTGTTCTGCTCAGCTGGGTGTACAAG
>TTN-214,ENSE00003801249,1,282,2833701,2833982,AACCACCCAGGTTCATTAAGAAGCTAGAACCTTCAAGAATTGTGAAACAGGATGAATTCACAAGGTATGAATGCAAAATCGGTGGGTCTCCAGAAATCAAAGTTTTATGGTATAAGGACGAGACTGAAATTCAAGAGAGCAGTAAATTCAGAATGTCATTCGTTGACTCGGTGGCTGTGCTGGAAATGCACAATCTCAGTGTTGAAGACAGTGGAGACTACACCTGTGAGGCCCACAATGCAGCAGGCAGTGCCAGCAGCAGCACATCCTTAAAAGTTAAAG
>TTN-214,ENSE00003810208,1,279,2833983,2834261,AACCACCCATTTTCCGCAAAAAGCCTCATCCTATAGAGACACTGAAAGGAGCTGATGTTCACCTTGAATGTGAGCTTCAGGGCACTCCCCCATTTCACGTTTCTTGGTATAAAGACAAGAGAGAACTTAGGAGCGGCAAGAAGTACAAGATAATGTCTGAGAACTTCCTAACCAGTATCCACATCCTGAATGTCGATGCTGCAGACATTGGGGAATATCAGTGTAAAGCCACAAATGATGTGGGAAGCGACACTTGCGTTGGTTCCATCGCTCTCAAAG
>TTN-214,ENSE00003802440,1,282,2834262,2834543,CACCACCAAGATTTGTGAAGAAGCTCAGTGACATATCTACTGTCGTTGGTAAAGAAGTTCAGCTGCAGACTACCATTGAAGGCGCTGAACCCATTTCAGTGGTGTGGTTCAAAGATAAGGGAGAAATCGTTAGAGAAAGTGACAACATATGGATTTCTTATTCAGAAAACATTGCAACCTTACAGTTTTCAAGAGTGGAACCAGCCAATGCTGGAAAATACACTTGTCAGATCAAAAACGATGCTGGGATGCAAGAGTGCTTCGCCACGCTATCCGTTCTCG
>TTN-214,ENSE00003802351,1,279,2834544,2834822,AGCCTGCAACAATTGTAGAAAAGCCAGAATCCATAAAAGTTACCACGGGAGACACCTGTACCTTGGAGTGTACAGTAGCTGGCACCCCTGAACTCAGTACTAAGTGGTTTAAGGATGGAAAAGAGCTAACAAGTGACAACAAATACAAAATAAGCTTCTTCAACAAAGTATCCGGCCTTAAGATCATCAATGTAGCACCGAGTGACAGTGGGGTATACAGTTTTGAGGTGCAGAACCCTGTTGGCAAAGACAGCTGCACAGCTTCATTGCAGGTTTCAG
>TTN-214,ENSE00003807933,1,288,2834823,2835110,ACCGAACCGTTCCTCCTTCATTCACAAGAAAATTGAAAGAGACAAATGGTCTATCCGGCTCCTCAGTTGTAATGGAGTGTAAAGTCTATGGGTCACCTCCAATCTCTGTCTCCTGGTTCCATGAAGGAAATGAGATCAGTAGTGGAAGGAAATACCAGACCACCCTGACAGATAATACTTGTGCTTTAACTGTGAACATGCTGGAAGAATCAGACAGTGGTGACTACACATGTATAGCTACTAATATGGCTGGTTCTGATGAATGTAGTGCTCCTTTGACTGTGAGAG
>TTN-214,ENSE00003804939,1,279,2835111,2835389,AACCACCATCTTTTGTTCAGAAACCTGATCCCATGGATGTTTTAACTGGGACCAATGTAACTTTCACAAGTATCGTAAAAGGAACACCTCCTTTCAGTGTTAGCTGGTTCAAAGGTAGCAGTGAACTAGTACCAGGTGACAGATGCAACGTGTCTTTGGAGGATTCAGTTGCTGAACTGGAGTTGTTCGATGTAGATACATCACAAAGTGGAGAATATACTTGCATAGTTAGCAATGAAGCTGGCAAGGCTTCTTGTACAACACATCTCTACATAAAAG
>TTN-214,ENSE00003810094,1,279,2835390,2835668,CCCCAGCCAAATTTGTGAAGAGGCTGAATGATTACAGCATAGAGAAAGGAAAACCCCTGATCCTAGAGGGTACATTCACTGGAACTCCTCCCATTTCGGTTACCTGGAAGAAAAATGGCATAAATGTAACTCCTTCTCAGAGGTGTAATATAACTACGACTGAAAAATCGGCAATCCTGGAAATTCCAAGTAGCACAGTAGAGGATGCAGGACAATACAACTGCTACATTGAAAATGCCTCTGGAAAAGATTCCTGTTCAGCACAAATACTCATACTAG
>TTN-214,ENSE00003811103,1,279,2835669,2835947,AACCACCGTATTTTGTCAAGCAGTTGGAGCCGGTTAAGGTGTCTGTTGGAGATTCTGCCTCTCTACAATGCCAGCTTGCTGGAACCCCTGAAATTGGGGTATCCTGGTATAAAGGAGATACAAAATTGAGACCCACTACGACTTACAAAATGCATTTTAGGAATAATGTTGCTACACTGGTTTTCAACCAGGTTGATATTAATGATAGTGGAGAATATATCTGCAAAGCTGAAAACAGCGTGGGAGAAGTTTCTGCATCAACTTTCCTTACCGTTCAAG
>TTN-214,ENSE00003801476,1,288,2835948,2836235,AGCAAAAACTTCCACCATCATTTTCTCGACAATTGAGAGATGTTCAAGAAACAGTTGGACTGCCAGTTGTTTTTGATTGTGCCATAAGTGGATCAGAACCTATCTCCGTGTCTTGGTATAAAGACGGCAAGCCATTGAAAGACAGCCCAAATGTACAAACATCATTTTTAGACAATACAGCCACACTCAATATTTTTAAAACTGACCGGAGCCTTGCAGGCCAGTATTCCTGCACAGCTACAAACCCTATAGGCTCTGCTTCTTCCAGTGCCAGGCTCATTCTCACAG
>TTN-214,ENSE00003808430,1,288,2836236,2836523,AGGGGAAGAACCCACCCTTCTTTGACATCCGTCTTGCCCCTGTGGATGCTGTGGTGGGAGAAAGTGCTGACTTTGAGTGCCACGTCACGGGCACACAACCGATAAAGGTCAGCTGGGCCAAAGACAGCAGAGAAATACGAAGTGGCGGAAAGTACCAGATTAGTTATCTGGAAAACAGCGCCCACCTGACAGTCCTCAAAGTAGACAAAGGAGATTCTGGACAATATACCTGCTATGCTGTGAATGAAGTGGGAAAAGACTCTTGCACAGCTCAGCTGAATATAAAAG
>TTN-214,ENSE00003809007,1,291,2836524,2836814,AGCGGCTCATCCCACCAAGTTTCACTAAAAGACTCTCAGAGACAGTAGAAGAAACAGAAGGGAATTCTTTCAAACTTGAGGGACGTGTGGCTGGTTCCCAACCTATAACTGTTGCCTGGTACAAAAATAATATAGAGATACAACCAACTTCTAACTGTGAAATAACATTCAAGAACAACACGTTAGTGCTGCAAGTCAGGAAAGCAGGCATGAACGACGCTGGTTTGTACACATGCAAAGTGTCCAATGATGCAGGCTCTGCTCTGTGCACGTCTTCAATCGTCATCAAAG
>TTN-214,ENSE00003803910,1,288,2836815,2837102,AACCTAAGAAGCCACCTGTATTTGATCAGCACCTTACTCCAGTAACAGTGAGTGAAGGAGAATACGTGCAGCTCAGCTGCCATGTCCAGGGATCTGAGCCAATTAGGATCCAGTGGTTGAAGGCTGGCAGGGAAATAAAGCCTTCAGACAGATGCAGCTTCAGCTTTGCTAGTGGGACAGCTGTACTGGAACTCAGAGATGTGGCTAAAGCAGATTCGGGAGATTATGTGTGTAAAGCTTCAAATGTGGCTGGAAGTGACACTACCAAATCAAAAGTGACCATTAAAG
>TTN-214,ENSE00003804245,1,93,2837103,2837195,ACAAACCAGCTGTGGCCCCAGCAACCAAGAAAGCTGCGGTAGATGGAAGACTCTTTTTTGTGTCAGAACCTCAGAGTATCAGAGTCGTAGAAA
>TTN-214,ENSE00003801649,1,286,2837196,2837481,AAACCACTGCGACCTTCATTGCAAAAGTTGGAGGTGACCCAATCCCAAATGTTAAATGGACAAAAGGGAAGTGGAGACAGCTGAACCAAGGAGGTCGTGTTTTCATCCACCAAAAAGGCGATGAAGCAAAACTGGAGATTAGGGACACCACAAAAACTGATTCTGGGTTATACCGATGCGTGGCATTTAACGAACATGGTGAAATTGAAAGTAATGTTAACTTACAGGTGGATGAAAGGAAGAAACAAGAGAAAATTGAAGGCGATCTTAGAGCAATGCTGAAAAA
>TTN-214,ENSE00003805371,1,184,2837482,2837665,GACTCCAATCTTAAAGAAAGGAGCTGGAGAAGAAGAGGAAATTGATATCATGGAACTTCTCAAAAATGTTGATCCTAAAGAATATGAAAAATATGCCCGCATGTATGGAATCACTGACTTCCGAGGTCTTCTTCAAGCATTTGAACTGCTCAAGCAAAGCCAAGAAGAAGAGACACATAGACTG
>TTN-214,ENSE00003802112,1,90,2837666,2837755,GAAATTGAGGAAATAGAGAGGTCAGAGAGGGACGAAAAGGAATTTGAGGAACTTGTATCATTTATTCAGCAAAGACTGTCACAGACAGAG
>TTN-214,ENSE00003810323,1,268,2837756,2838023,CCTGTCACTCTGATCAAGGACATTGAAAATCAGACAGTTTTGAAAGATAATGATGCTGTCTTTGAAATTGACATTAAAATTAATTATCCAGAAATCAAGCTTTCGTGGTACAAAGGAACTGAAAAACTGGAACCCAGTGATAAATTTGAAATAAGCATTGATGGTGACCGACATACACTCAGAGTCAAAAACTGTCAACTTAAAGACCAGGGCAATTATCGATTGGTTTGTGGTCCACACATCGCTAGCGCTAAACTAACTGTAATTG
>TTN-214,ENSE00003810781,1,261,2838024,2838284,AGCCTGCATGGGAACGGCATCTTCAGGATGTGACTCTGAAAGAAGGCCAGACTTGCACCATGACATGCCAATTTTCTGTACCAAATGTAAAATCTGAATGGTTCAGAAATGGCAGAATCCTTAAACCCCAAGGTAGACATAAAACAGAAGTGGAACACAAAGTCCATAAATTGACCATTGCAGATGTTCGAGCAGAAGACCAGGGTCAGTACACCTGCAAATATGAAGACCTTGAAACTTCAGCAGAACTCAGAATCGAAG
>TTN-214,ENSE00003805599,1,210,2838285,2838494,CTGAACCAATTCAGTTTACAAAGCGCATACAGAACATCGTGGTGAGTGAGCATCAGTCTGCCACCTTTGAGTGTGAAGTGTCCTTTGATGATGCCATTGTAACATGGTACAAAGGACCAACAGAACTGACAGAGAGCCAGAAATACAACTTCAGGAATGATGGCCGCTGCCATTATATGACCATCCACAATGTGACCCCAGACGATGAAG
>TTN-214,ENSE00003809461,1,78,2838495,2838572,GTGTCTACTCGGTCATCGCTCGGCTGGAGCCAAGAGGTGAAGCAAGAAGCACGGCAGAGCTGTACCTAACGACGAAAG
>TTN-214,ENSE00003805821,1,27,2838573,2838599,AAATCAAACTTGAGCTGAAGCCTCCTG
>TTN-214,ENSE00003803485,1,60,2838600,2838659,ATATTCCTGACTCCAGAGTTCCAATCCCAACCATGCCTATCAGAGCAGTGCCACCAGAAG
>TTN-214,ENSE00003803812,1,84,2838660,2838743,AAATCCCTCCTGTGGTTGCTCCTCCTATCCCCCTTTTGCTACCAACACCCGAAGAAAAGAAACCACCACCAAAACGTATTGAAG
>TTN-214,ENSE00003804844,1,72,2838744,2838815,TTACCAAAAAGGCTGTGAAGAAAGATGCCAAAAAAGTTGTTGCAAAGCCCAAAGAGATGACACCACGTGAAG
>TTN-214,ENSE00003810688,1,48,2838816,2838863,AGATTGTCAAGAAGCCTCCACCTCCTACTACCTTAATTCCAGCAAAAG
>TTN-214,ENSE00003806388,1,405,2838864,2839268,CTCCTGAAATCATTGATGTATCCTCTAAAGCTGAAGAAGTAAAAATAATGACTATAACCAGAAAGAAAGAGGTTCAGAAAGAAAAAGAAGCTGTGTATGAGAAAAAGCAAGCAGTCCACAAGGAGAAGAGAGTCTTCATTGAATCTTTCGAAGAACCTTATGACGAACTGGAGGTAGAACCATACACAGAGCCATTTGAACAACCTTATTATGAAGAACCAGATGAAGACTATGAAGAGATTAAGGTAGAAGCTAAAAAAGAAGTTCACGAGGAATGGGAAGAAGATTTTGAAGAAGGGCAAGAATACTATGAAAGGGAAGAAGGCTATGACGAAGGGGAGGAAGAGTGGGAAGAGGCTTACCAAGAAAGGGAAGTAATTCAAGTTCAAAAGGAGGTCTATGAAG
>TTN-214,ENSE00003803093,1,63,2839269,2839331,AATCACATGAGAGAAAAGTTCCAGCCAAAGTACCTGAAAAGAAAGCACCACCACCTCCTAAAG
>TTN-214,ENSE00003802009,1,78,2839332,2839409,TTATAAAGAAGCCAGTAATTGAAAAAATTGAAAAGACTTCTCGAAGAATGGAGGAAGAAAAAGTTCAAGTCACCAAAG
>TTN-214,ENSE00003806356,1,78,2839410,2839487,TACCTGAAGTTTCAAAGAAGATTGTTCCACAAAAACCTTCCCGGACTCCAGTACAGGAAGAAGTTATTGAAGTGAAAG
>TTN-214,ENSE00003803112,1,87,2839488,2839574,TACCAGCTGTGCATACAAAGAAGATGGTTATTTCAGAAGAAAAGATGTTCTTTGCTTCTCACACAGAGGAGGAGGTGTCAGTCACAG
>TTN-214,ENSE00003811115,1,81,2839575,2839655,TCCCCGAGGTACAAAAGGAAATTGTTACTGAAGAGAAAATTCACGTTGCCATTTCCAAAAGGGTTGAACCACCACCTAAAG
>TTN-214,ENSE00003810048,1,84,2839656,2839739,TCCCTGAGCTACCTGAGAAACCAGCTCCAGAAGAAGTGGCCCCTGTTCCTATCCCTAAAAAAGTGGAGCCCCCAGCACCAAAAG
>TTN-214,ENSE00003809302,1,84,2839740,2839823,TTCCTGAGGTTCCCAAGAAACCCGTGCCAGAGGAGAAAAAGCCAGTTCCTGTGCCTAAGAAGGAACCTGCTGCTCCCCCAAAAG
>TTN-214,ENSE00003811271,1,84,2839824,2839907,TCCCAGAGGTGCCAAAGAAACCTGTCCCTGAAGAAAAGATTCCCGTTCCTGTTGCAAAGAAAAAGGAAGCTCCCCCAGCTAAAG
>TTN-214,ENSE00003811169,1,81,2839908,2839988,TTCCTGAAGTACAGAAGGGAGTTGTGACAGAAGAAAAAATAACCATTGTAACTCAAAGAGAGGAATCTCCACCACCAGCAG
>TTN-214,ENSE00003802187,1,84,2839989,2840072,TGCCAGAAATACCAAAGAAGAAAGTTCCTGAAGAAAGGAAACCTGTTCCTCGGAAGGAGGAAGAAGTTCCACCACCACCAAAAG
>TTN-214,ENSE00003810484,1,84,2840073,2840156,TGCCAGCTCTGCCTAAGAAACCCGTCCCAGAGGAGAAAGTTGCAGTGCCAGTTCCTGTCGCTAAGAAAGCTCCTCCTCCCCGAG
>TTN-214,ENSE00003810121,1,102,2840157,2840258,CTGAAGTCTCTAAGAAAACTGTTGTAGAAGAAAAGAGATTTGTTGCTGAAGAAAAACTATCCTTCGCAGTTCCTCAAAGAGTGGAAGTCACGCGGCACGAAG
>TTN-214,ENSE00003805410,1,114,2840259,2840372,TATCTGCAGAGGAGGAATGGAGTTACTCAGAAGAGGAGGAAGGTGTGTCCATTTCAGTTTATAGAGAAGAAGAAAGAGAGGAGGAGGAAGAAGCAGAGGTTACAGAATATGAAG
>TTN-214,ENSE00003801264,1,81,2840373,2840453,TGATGGAAGAGCCTGAGGAATATGTTGTGGAAGAAAAGCTGCACATTATTTCTAAGAGAGTGGAAGCTGAGCCAGCTGAAG
>TTN-214,ENSE00003805756,1,78,2840454,2840531,TGACAGAGAGGCAGGAGAAGAAAATTGTACTGAAACCAAAAATTCCTGCTAAAATAGAGGAGCCTCCACCGGCTAAAG
>TTN-214,ENSE00003808334,1,84,2840532,2840615,TTCCTGAAGCACCTAAGAAAATTGTGCCAGAAAAGAAAGTTCCTGCTCCAGTTCCTAAAAAGGAAAAGGTGCCCCCACCTAAAG
>TTN-214,ENSE00003808052,1,84,2840616,2840699,TGCCAGAAGAGCCAAAGAAACCAGTTCCAGAAAAAAAGGTTCCTCCAAAAGTCATTAAGATGGAAGAACCTCTCCCAGCCAAAG
>TTN-214,ENSE00003803067,1,84,2840700,2840783,TGACTGAGAGGCACATGCAAATTACCCAGGAAGAAAAAGTTCTTGTTGCTGTAACTAAAAAAGAGGCGCCTCCAAAAGCAAGAG
>TTN-214,ENSE00003808806,1,84,2840784,2840867,TGCCAGAGGAACCGAAGAGAGCTGTCCCAGAAGAAAAAGTTCTGAAACTCAAACCTAAAAGAGAGGAGGAACCACCAGCTAAAG
>TTN-214,ENSE00003805330,1,81,2840868,2840948,TGACTGAATTCAGAAAAAGAGTGGTTAAAGAAGAAAAAGTATCAATTGAAGCTCCAAAAAGAGAACCTCAACCCATCAAAG
>TTN-214,ENSE00003807878,1,207,2840949,2841155,AAGTAACTATAATGGAAGAGAAAGAAAGGGCTTATACCCTAGAAGAAGAAGCTGTTTCAGTACAACGGGAAGAAGAATATGAGGAATATGAAGAATATGATTATAAAGAATTTGAGGAGTATGAACCAACAGAAGAATATGACCAATATGAAGAATACGAGGAGCGGGAGTATGAACGATATGAAGAGCATGAAGAATACATCACAG
>TTN-214,ENSE00003806244,1,78,2841156,2841233,AACCAGAGAAGCCTATCCCTGTAAAGCCTGTCCCAGAAGAACCAGTTCCCACAAAACCAAAGGCCCCACCGGCTAAAG
>TTN-214,ENSE00003810594,1,75,2841234,2841308,TGCTGAAGAAAGCTGTCCCTGAAGAAAAAGTACCAGTGCCCATTCCTAAGAAACTCAAACCTCCACCACCCAAAG
>TTN-214,ENSE00003809388,1,93,2841309,2841401,TGCCTGAAGAACCAAAGAAAGTTTTTGAGGAAAAAATACGTATTTCAATTACCAAACGTGAAAAAGAGCAGGTGACTGAACCCGCTGCTAAAG
>TTN-214,ENSE00003807405,1,78,2841402,2841479,TGCCCATGAAGCCCAAGAGGGTTGTCGCAGAAGAAAAAGTACCTGTCCCTAGAAAAGAAGTAGCACCACCTGTTAGAG
>TTN-214,ENSE00003810081,1,162,2841480,2841641,TGCCAGAAGTGCCTAAAGAACTTGAACCAGAAGAGGTTGCCTTTGAAGAGGAAGTTGTAACCCATGTAGAAGAATATCTTGTAGAAGAAGAAGAAGAGTACATTCATGAAGAAGAGGAGTTCATAACTGAGGAAGAAGTGGTGCCAGTGATACCAGTCAAAG
>TTN-214,ENSE00003806496,1,84,2841642,2841725,TGCCTGAGGTACCCAGGAAACCTGTTCCAGAAGAGAAGAAACCTGTTCCTGTTCCCAAGAAGAAGGAAGCTCCACCGGCAAAAG
>TTN-214,ENSE00003802498,1,78,2841726,2841803,TGCCTGAGGTTCCTAAGAAGCCAGAGGAGAAAGTTCCTGTGCTTATTCCTAAAAAGGAGAAGCCTCCGCCAGCAAAAG
>TTN-214,ENSE00003809653,1,84,2841804,2841887,TTCCTGAAGTGCCCAAGAAACCTGTGCCAGAGGAGAAAGTACCAGTACCAGTTCCTAAAAAGGTGGAAGCTCCACCTGCCAAAG
>TTN-214,ENSE00003810862,1,84,2841888,2841971,TGCCAGAGGTACCCAAGAAGCCTGTGCCTGAGAAGAAGGTGCCAGTTCCTGCTCCTAAGAAAGTGGAGGCTCCACCTGCAAAAG
>TTN-214,ENSE00003805059,1,84,2841972,2842055,TGCCAGAGGTGCCCAAGAAGCTCATCCCAGAAGAAAAGAAACCAACACCTGTTCCGAAAAAAGTGGAAGCACCACCACCCAAAG
>TTN-214,ENSE00003801382,1,297,2842056,2842352,TGCCAAAGAAACGTGAACCAGTTCCAGTTCCTGTAGCTCTACCTCAGGAAGAGGAAGTTCTATTTGAAGAAGAAATTGTTCCTGAAGAGGAAGTTCTACCTGAGGAAGAGGAAGTTCTACCTGAGGAAGAGGAAGTTCTACCTGAAGAAGAGGAAGTTCTACCTGAAGAAGAGGAAATTCCACCTGAGGAAGAGGAAGTTCCTCCCGAAGAAGAATATGTACCTGAGGAAGAAGAATTTGTACCTGAAGAAGAAGTCCTTCCAGAAGTTAAACCTAAGGTGCCAGTACCTGCACCAG
>TTN-214,ENSE00003805240,1,75,2842353,2842427,TGCCTGAAATTAAGAAGAAAGTGACAGAGAAGAAAGTGGTCATTCCCAAGAAAGAGGAGGCTCCCCCTGCCAAAG
>TTN-214,ENSE00003804875,1,75,2842428,2842502,TTCCTGAGGTGCCTAAGAAGGTGGAAGAAAAACGAATCATTCTCCCTAAAGAAGAGGAAGTTCTACCAGTTGAAG
>TTN-214,ENSE00003801552,1,96,2842503,2842598,TGACTGAGGAGCCTGAAGAAGAGCCTATTTCAGAAGAAGAAATCCCAGAAGAACCACCTAGCATAGAGGAAGTTGAAGAGGTGGCACCACCTAGAG
>TTN-214,ENSE00003804385,1,78,2842599,2842676,TGCCTGAAGTGATTAAGAAAGCAGTACCTGAAGCACCTACTCCTGTTCCTAAAAAAGTGGAGGCACCACCAGCTAAAG
>TTN-214,ENSE00003805135,1,69,2842677,2842745,TGTCAAAGAAAATTCCTGAGGAAAAAGTACCTGTTCCTGTTCAGAAAAAAGAGGCACCCCCAGCCAAAG
>TTN-214,ENSE00003808243,1,75,2842746,2842820,TGCCTGAAGTACCAAAGAAAGTCCCAGAAAAGAAAGTCCTTGTGCCTAAAAAGGAAGCTGTTCCCCCAGCTAAAG
>TTN-214,ENSE00003808353,1,297,2842821,2843117,GGAGAACTGTCCTTGAAGAAAAAGTATCAGTTGCCTTCCGCCAAGAAGTAGTAGTAAAAGAAAGACTAGAATTAGAAGTAGTAGAAGCAGAAGTGGAAGAAATTCCGGAAGAAGAAGAGTTCCATGAAGTTGAAGAATATTTTGAAGAAGGCGAGTTTCATGAAGTAGAAGAATTCATCAAATTAGAACAACATAGAGTTGAAGAAGAACACAGAGTTGAAAAAGTTCATAGGGTAATAGAAGTTTTTGAGGCTGAAGAAGTGGAAGTATTTGAAAAACCAAAAGCTCCACCTAAAG
>TTN-214,ENSE00003807571,1,81,2843118,2843198,GGCCTGAGATATCTGAGAAAATCATCCCTCCAAAAAAACCGCCCACTAAAGTTGTTCCTCGAAAAGAGCCACCAGCTAAAG
>TTN-214,ENSE00003808118,1,78,2843199,2843276,TACCGGAGGTGCCTAAGAAAATTGTGGTAGAAGAAAAAGTACGTGTTCCTGAAGAGCCCAGAGTTCCACCAACTAAAG
>TTN-214,ENSE00004025984,1,90,2843277,2843366,TGCCTGAAGTGCTGCCACCGAAGGAAGTGGTCCCAGAAAAGAAAGTACCGGTGCCTCCTGCCAAAAAGCCAGAAGCTCCACCTCCTAAAG
>TTN-214,ENSE00004025993,1,84,2843367,2843450,TGCCTGAGGCTCCCAAAGAAGTTGTTCCTGAAAAGAAAGTGCCAGTGCCTCCTCCTAAAAAGCCTGAAGTGCCACCCACAAAAG
>TTN-214,ENSE00004025989,1,84,2843451,2843534,TCCCAGAGGTGCCAAAGGCAGCTGTCCCAGAAAAGAAGGTGCCTGAAGCTATTCCTCCCAAACCGGAAAGTCCTCCCCCTGAAG
>TTN-214,ENSE00003806373,1,84,2843535,2843618,TGCCAGAGGCTCCGAAAGAAGTTGTTCCTGAAAAGAAAGTGCCAGCGGCTCCTCCTAAAAAGCCTGAAGTCACACCTGTTAAAG
>TTN-214,ENSE00003807489,1,84,2843619,2843702,TGCCTGAGGCTCCCAAAGAAGTTGTTCCTGAAAAGAAAGTGCCAGTGCCTCCTCCTAAAAAGCCTGAAGTGCCACCCACAAAAG
>TTN-214,ENSE00003805050,1,84,2843703,2843786,TCCCAGAGGTGCCAAAGGTAGCTGTCCCAGAAAAGAAGGTGCCTGAAGCTATTCCTCCCAAACCGGAAAGTCCTCCCCCTGAAG
>TTN-214,ENSE00003808824,1,84,2843787,2843870,TGTTCGAGGAGCCTGAGGAAGTTGCCCTAGAAGAGCCTCCTGCTGAAGTTGTGGAAGAGCCAGAGCCAGCGGCGCCTCCACAAG
>TTN-214,ENSE00003807203,1,84,2843871,2843954,TGACCGTACCACCTAAGAAACCTGTCCCAGAAAAGAAAGCACCTGCTGTCGTTGCCAAAAAACCTGAACTACCACCAGTGAAAG
>TTN-214,ENSE00003811260,1,84,2843955,2844038,TGCCCGAGGTGCCCAAGGAGGTTGTTCCTGAAAAGAAGGTGCCTCTGGTGGTTCCCAAAAAGCCAGAAGCCCCACCTGCTAAAG
>TTN-214,ENSE00003806229,1,78,2844039,2844116,TGCCTGAAGTTCCAAAAGAAGTTGTTCCAGAAAAGAAAGTAGCTGTTCCCAAAAAGCCAGAAGTCCCACCAGCAAAAG
>TTN-214,ENSE00003807893,1,84,2844117,2844200,TGCCAGAAGTGCCAAAGAAACCTGTCTTGGAAGAGAAACCAGCTGTTCCTGTTCCAGAAAGAGCGGAGTCTCCTCCCCCAGAAG
>TTN-214,ENSE00003809515,1,108,2844201,2844308,TATATGAAGAACCTGAGGAAATTGCTCCTGAAGAGGAAATTGCTCCTGAAGAGGAAAAGCCAGTTCCTGTTGCAGAAGAGGAGGAACCAGAGGTTCCACCTCCAGCAG
>TTN-214,ENSE00003804845,1,78,2844309,2844386,TGCCTGAAGAGCCCAAGAAGATCATCCCAGAGAAGAAAGTTCCTGTCATCAAAAAACCAGAAGCACCGCCTCCTAAAG
>TTN-214,ENSE00003806702,1,111,2844387,2844497,AACCTGAACCTGAAAAGGTTATTGAGAAGCCAAAACTCAAACCAAGACCCCCACCTCCTCCACCTGCTCCACCTAAGGAAGATGTGAAGGAGAAAATATTCCAACTTAAAG
>TTN-214,ENSE00003809179,1,69,2844498,2844566,CTATTCCAAAGAAGAAAGTTCCTGAAAAACCTCAGGTTCCAGAAAAAGTGGAGCTTACACCTCTGAAAG
>TTN-214,ENSE00003804802,1,81,2844567,2844647,TGCCTGGAGGTGAAAAGAAAGTTCGCAAATTACTTCCGGAACGTAAACCTGAACCAAAGGAAGAAGTTGTTCTGAAAAGCG
>TTN-214,ENSE00003811452,1,75,2844648,2844722,TTCTAAGAAAAAGACCTGAAGAAGAAGAACCTAAAGTAGAACCTAAAAAACTAGAAAAAGTTAAAAAACCTGCAG
>TTN-214,ENSE00003807205,1,90,2844723,2844812,TACCAGAACCACCACCTCCAAAACCTGTTGAAGAGGTTGAAGTACCTACTGTTACAAAAAGGGAAAGGAAGATTCCTGAACCAACAAAAG
>TTN-214,ENSE00003806747,1,63,2844813,2844875,TGCCTGAAATCAAGCCAGCAATACCTCTCCCTGCACCTGAACCGAAACCAAAGCCCGAAGCAG
>TTN-214,ENSE00003810755,1,90,2844876,2844965,AAGTGAAAACAATCAAACCACCTCCTGTGGAACCTGAACCAACCCCCATCGCTGCCCCAGTAACAGTGCCAGTGGTTGGAAAGAAAGCAG
>TTN-214,ENSE00003806122,1,51,2844966,2845016,AAGCCAAAGCACCTAAGGAAGAGGCTGCCAAGCCAAAAGGTCCTATCAAAG
>TTN-214,ENSE00003804858,1,402,2845017,2845418,GTGTACCCAAAAAGACTCCTTCACCAATAGAAGCCGAAAGGAGAAAGTTAAGGCCAGGAAGTGGTGGAGAGAAACCTCCTGATGAAGCCCCGTTCACCTACCAGCTAAAGGCTGTGCCACTGAAGTTTGTGAAAGAAATCAAAGACATCATCTTGACAGAATCAGAGTTCGTTGGCTCTTCAGCAATCTTTGAATGTTTGGTCTCCCCTTCCACTGCAATTACAACCTGGATGAAAGACGGTAGCAATATCCGTGAGAGTCCCAAGCACAGGTTTATTGCAGATGGTAAAGACAGAAAGCTGCACATCATTGATGTTCAACTTTCCGATGCTGGTGAATACACCTGTGTTTTACGTTTGGGAAACAAAGAAAAGACCTCCACGGCTAAACTTGTTGTAGAAG
>TTN-214,ENSE00003803996,1,279,2845419,2845697,AACTTCCTGTGCGTTTTGTAAAAACACTGGAAGAGGAAGTCACAGTGGTCAAAGGACAGCCATTGTACTTGAGCTGCGAGTTAAACAAAGAGCGTGACGTGGTCTGGAGGAAGGATGGCAAGATTGTGGTGGAGAAACCTGGCCGAATTGTGCCAGGCGTCATTGGCTTGATGCGGGCTCTGACCATCAACGATGCAGATGACACAGATGCTGGAACATACACAGTTACTGTGGAAAACGCCAACAACCTGGAGTGTTCATCTTGCGTAAAAGTAGTAG
>TTN-214,ENSE00003807976,1,276,2845698,2845973,AAGTCATTAGAGATTGGCTGGTGAAACCTATACGAGACCAGCATGTGAAACCCAAGGGGACAGCTATTTTTGCCTGTGATATAGCAAAAGATACTCCAAACATTAAGTGGTTCAAAGGATATGATGAAATCCCTGCGGAACCAAATGATAAGACTGAAATACTGAGAGATGGAAATCATCTGTACCTCAAAATTAAGAATGCTATGCCAGAAGATATTGCTGAGTATGCAGTGGAAATTGAAGGAAAAAGATACCCTGCAAAGCTGACACTTGGAG
>TTN-214,ENSE00003804328,1,140,2845974,2846113,AGCGTGAAGTTGAACTGCTTAAACCAATAGAGGACGTTACCATTTATGAGAAAGAAAGTGCAAGCTTTGATGCAGAAATCTCAGAGGCAGACATTCCTGGACAATGGAAACTGAAAGGAGAACTTCTAAGGCCCTCACCT
>TTN-214,ENSE00003802254,1,127,2846114,2846240,ACTTGTGAAATCAAAGCAGAAGGTGGAAAACGCTTCTTAACTTTGCACAAAGTCAAACTGGACCAAGCTGGTGAAGTCCTCTACCAGGCCCTTAATGCAATTACAACTGCCATTTTGACAGTAAAAG
>TTN-214,ENSE00003811410,1,264,2846241,2846504,AAATCGAACTTGACTTTGCTGTGCCCCTGAAGGATGTCACTGTTCCAGAAAGGCGACAGGCTCGATTCGAATGTGTCCTCACCCGAGAGGCAAATGTTATATGGTCCAAAGGACCTGATATAATTAAGTCATCTGACAAATTTGATATCATCGCTGATGGAAAGAAACATATTCTTGTTATTAATGATTCTCAATTTGATGATGAAGGGGTCTATACTGCTGAGGTGGAGGGCAAGAAGACCTCAGCTCGGTTGTTTGTCACAG
>TTN-214,ENSE00003805150,1,267,2846505,2846771,GTATAAGACTGAAATTCATGTCACCTCTTGAAGATCAAACAGTAAAAGAAGGTGAAACAGCAACTTTTGTTTGTGAACTTTCTCATGAAAAAATGCATGTAGTCTGGTTCAAAAATGATGCCAAACTCCATACAAGCAGAACAGTACTCATCTCTTCTGAGGGCAAGACTCACAAATTGGAAATGAAAGAAGTGACATTGGATGATATATCTCAGATAAAAGCTCAAGTCAAGGAGCTGAGCTCCACAGCACAGCTGAAGGTCTTAG
>TTN-214,ENSE00003801907,1,264,2846772,2847035,AGGCCGATCCCTACTTCACTGTGAAATTACATGACAAAACTGCAGTGGAGAAGGATGAGATTACTTTGAAGTGTGAAGTGAGCAAAGATGTACCAGTGAAATGGTTCAAAGATGGTGAAGAGATTGTCCCTTCACCCAAATATTCTATCAAGGCAGATGGCCTGCGCCGCATCTTAAAAATCAAAAAGGCGGACCTTAAAGATAAAGGCGAATATGTGTGTGACTGTGGCACAGACAAGACCAAGGCAAATGTTACTGTTGAGG
>TTN-214,ENSE00003802031,1,140,2847036,2847175,CTCGACTAATAAAAGTGGAAAAGCCTCTGTACGGAGTAGAGGTGTTTGTTGGTGAAACAGCCCACTTTGAAATTGAACTTTCTGAACCTGATGTTCACGGCCAGTGGAAGCTGAAAGGACAGCCTTTGACAGCTTCCCCT
>TTN-214,ENSE00003811443,1,127,2847176,2847302,GACTGTGAAATCATTGAGGATGGAAAGAAGCATATTCTGATCCTTCATAACTGTCAGCTGGGTATGACAGGAGAGGTTTCCTTCCAGGCTGCTAATGCCAAATCTGCAGCCAATCTGAAAGTGAAAG
>TTN-214,ENSE00003811384,1,267,2847303,2847569,AATTGCCTCTTATCTTCATCACACCTCTCAGTGATGTTAAAGTCTTCGAGAAAGATGAGGCTAAGTTTGAGTGTGAAGTATCCAGGGAGCCCAAAACATTCCGTTGGCTAAAAGGAACCCAGGAAATCACAGGTGATGACAGATTTGAGCTTATAAAGGATGGCACTAAGCATTCAATGGTGATCAAGTCAGCTGCTTTTGAAGATGAAGCAAAATACATGTTTGAAGCTGAAGATAAGCACACAAGTGGCAAACTGATCATTGAAG
>TTN-214,ENSE00003801954,1,267,2847570,2847836,GAATCCGGCTCAAATTCCTCACCCCTCTCAAAGATGTAACTGCCAAAGAGAAGGAAAGTGCTGTATTTACTGTGGAGTTATCTCATGATAACATCCGAGTTAAATGGTTCAAGAATGACCAGCGCCTACACACCACCAGGTCGGTCTCAATGCAAGACGAAGGGAAAACTCATTCGATCACATTCAAAGACCTGTCTATTGATGACACCTCCCAAATTAGAGTAGAAGCTATGGGGATGAGTTCAGAAGCTAAACTCACTGTGCTTG
>TTN-214,ENSE00003809996,1,267,2847837,2848103,AGGGAGACCCATATTTTACAGGAAAACTTCAAGATTATACTGGTGTAGAGAAAGATGAAGTTATTCTACAGTGTGAAATTAGCAAAGCAGATGCACCAGTGAAATGGTTTAAGGATGGGAAGGAAATAAAGCCATCCAAAAATGCTGTTATTAAGGCAGATGGCAAGAAACGCATGCTAATCCTAAAGAAAGCCTTGAAATCAGATATTGGACAGTACACCTGTGACTGTGGGACAGATAAGACCTCAGGAAAACTTGACATTGAGG
>TTN-214,ENSE00003804589,1,140,2848104,2848243,ATCGGGAAATTAAACTGGTGCGACCCCTGCACAGTGTGGAGGTGATGGAGACTGAGACAGCACGCTTTGAAACCGAAATCTCTGAAGATGATATCCACGCCAACTGGAAACTCAAGGGAGAGGCCCTACTCCAAACACCT
>TTN-214,ENSE00003805931,1,127,2848244,2848370,GATTGTGAAATTAAGGAAGAAGGCAAAATACACTCCCTTGTTTTGCACAACTGTCGCCTGGACCAGACGGGTGGGGTGGATTTCCAAGCTGCCAATGTTAAATCTAGTGCCCACCTCCGAGTTAAGC
>TTN-214,ENSE00003811344,1,143,2848371,2848513,CACGAGTAATTGGTCTTCTGAGGCCTTTAAAGGATGTCACCGTGACTGCAGGGGAAACAGCCACCTTCGACTGCGAGCTCTCCTACGAAGATATCCCAGTGGAATGGTATCTCAAAGGGAAGAAACTAGAGCCCAGCGATAAG
>TTN-214,ENSE00003802375,1,124,2848514,2848637,GTGGTCCCACGTTCAGAAGGAAAAGTTCATACACTTACTCTGAGGGATGTAAAGTTAGAAGATGCTGGGGAAGTCCAACTAACAGCAAAAGATTTCAAAACTCACGCCAACCTCTTTGTGAAAG
>TTN-214,ENSE00003806733,1,267,2848638,2848904,AACCCCCAGTTGAATTCACTAAGCCTCTTGAGGACCAGACGGTCGAAGAGGGAGCCACTGCAGTGCTGGAGTGTGAAGTCTCCAGAGAAAATGCTAAGGTGAAATGGTTCAAAAATGGGACAGAAATCCTCAAAAGCAAGAAGTATGAAATTGTTGCTGATGGCAGGGTCAGAAAACTTGTTATACATGACTGTACCCCAGAGGATATTAAAACATACACTTGTGATGCTAAGGATTTTAAGACTTCCTGTAACCTGAATGTCGTGC
>TTN-214,ENSE00003807497,1,98,2848905,2849002,CTCCTCATGTGGAATTCTTAAGACCACTCACCGACCTTCAAGTTAGAGAAAAAGAAATGGCTCGATTTGAGTGTGAACTTTCCCGAGAAAATGCTAAG
>TTN-214,ENSE00003802530,1,169,2849003,2849171,GTTAAGTGGTTTAAAGATGGTGCTGAAATTAAAAAGGGCAAAAAATATGACATCATATCCAAGGGAGCAGTGCGCATTCTTGTCATCAACAAATGTCTACTGGATGATGAAGCTGAATATTCCTGTGAAGTAAGGACAGCGAGAACTTCTGGCATGCTGACAGTTCTGG
>TTN-214,ENSE00003811387,1,267,2849172,2849438,AAGAAGAAGCTGTCTTTACCAAAAATCTTGCCAACATTGAAGTTAGTGAAACAGACACTATAAAACTGGTTTGTGAAGTCTCCAAACCTGGCGCAGAAGTGATTTGGTATAAAGGGGATGAGGAGATCATTGAAACAGGAAGATATGAAATACTGACTGAAGGACGGAAGAGAATCCTGGTCATTCAGAACGCTCACCTTGAGGATGCTGGCAACTACAACTGTCGACTCCCAAGCTCTCGAACCGATGGCAAAGTCAAAGTACATG
>TTN-214,ENSE00003802653,1,267,2849439,2849705,AACTGGCTGCTGAATTTATCTCAAAGCCTCAAAACCTTGAAATACTTGAAGGAGAAAAGGCTGAATTTGTCTGCTCTATATCAAAAGAAAGCTTTCCAGTCCAGTGGAAGAGGGATGATAAGACACTTGAATCTGGAGATAAATATGACGTTATTGCTGATGGTAAAAAGAGGGTCCTAGTTGTGAAAGATGCCACATTACAAGATATGGGCACTTACGTTGTCATGGTAGGGGCCGCCAGAGCAGCAGCTCACTTGACAGTCATTG
>TTN-214,ENSE00003802540,1,279,2849706,2849984,AAAAACTCAGGATCGTAGTTCCTCTTAAGGACACCCGGGTGAAGGAACAACAGGAAGTTGTCTTCAACTGTGAAGTCAATACTGAAGGTGCCAAAGCCAAATGGTTCAGAAATGAAGAAGCTATATTTGATAGTTCAAAATACATCATTCTCCAAAAAGACCTAGTCTACACCCTCAGAATTAGAGATGCACACTTAGATGACCAAGCCAACTATAATGTGTCTTTGACCAATCACAGAGGTGAAAATGTTAAAAGTGCAGCCAATCTAATAGTAGAAG
>TTN-214,ENSE00003802874,1,409,2849985,2850393,AGGAAGACCTTAGGATTGTTGAGCCTCTTAAAGATATTGAAACAATGGAGAAGAAATCTGTCACATTCTGGTGCAAGGTGAATCGTCTCAATGTAACACTGAAGTGGACCAAAAATGGTGAAGAAGTGCCTTTTGACAACCGTGTCTCATACAGAGTTGATAAGTACAAGCACATGTTAACCATTAAAGACTGTGGCTTCCCAGATGAAGGTGAATACATTGTCACTGCTGGACAAGATAAATCTGTTGCTGAGCTTCTCATCATAGAAGCCCCGACAGAATTTGTGGAACACTTGGAAGATCAGACAGTCACTGAGTTCGATGACGCTGTCTTCTCCTGCCAGCTCTCCAGAGAGAAAGCCAATGTAAAATGGTACAGAAATGGGAGAGAAATCAAAGAAGGCAAAAA
>TTN-214,ENSE00003804130,1,125,2850394,2850518,ATACAAATTTGAAAAAGATGGAAGTATACACAGACTCATTATAAAAGATTGCAGGCTGGATGATGAGTGTGAATATGCTTGCGGGGTAGAAGACAGGAAGTCTCGTGCTAGACTTTTTGTGGAAG
>TTN-214,ENSE00003807647,1,267,2850519,2850785,AAATTCCTGTTGAGATCATCAGGCCTCCACAAGATATTCTTGAAGCCCCTGGTGCTGATGTTGTCTTTTTAGCAGAACTCAATAAAGATAAGGTGGAAGTCCAATGGCTAAGAAATAACATGGTTGTTGTCCAGGGTGATAAACACCAGATGATGAGTGAAGGAAAGATACATCGACTACAGATTTGTGATATTAAGCCCCGTGACCAGGGTGAATACAGATTTATTGCCAAAGACAAAGAAGCCAGAGCTAAGCTTGAACTGGCAG
>TTN-214,ENSE00003802353,1,270,2850786,2851055,CTGCACCAAAAATCAAGACAGCTGACCAAGACCTTGTGGTTGATGTTGGCAAGCCTCTGACAATGGTGGTGCCATATGATGCCTACCCCAAAGCAGAAGCTGAATGGTTTAAAGAAAATGAACCTTTATCTACAAAAACCATTGATACTACGGCTGAACAAACTTCTTTCAGAATTTTAGAAGCCAAGAAAGGAGACAAAGGGAGGTATAAAATTGTGCTTCAGAACAAACATGGAAAAGCAGAAGGATTCATCAATTTAAAAGTTATTG
>TTN-214,ENSE00003809195,1,303,2851056,2851358,ATGTTCCTGGGCCAGTACGTAACTTAGAAGTGACAGAAACATTTGATGGTGAAGTGAGCCTTGCTTGGGAAGAACCTTTAACTGATGGTGGAAGCAAAATCATAGGTTACGTTGTTGAAAGACGTGACATTAAGAGAAAGACCTGGGTTCTGGCCACAGACCGTGCAGAGAGTTGTGAGTTTACTGTCACTGGTCTACAGAAAGGAGGAGTTGAGTACCTATTCCGTGTGAGTGCAAGAAACAGAGTTGGCACTGGTGAGCCAGTAGAAACTGACAATCCTGTAGAAGCAAGGAGTAAATATG
>TTN-214,ENSE00003803170,1,303,2851359,2851661,ATGTTCCAGGCCCTCCTTTGAATGTAACCATCACTGATGTGAATCGATTTGGTGTCTCACTGACATGGGAACCACCAGAGTATGATGGAGGTGCTGAGATCACAAACTACGTCATTGAATTAAGAGACAAGACTTCTATCAGGTGGGATACTGCCATGACTGTGAGAGCTGAAGACCTGTCTGCAACTGTTACTGATGTGGTAGAAGGACAGGAGTACAGTTTCCGAGTGAGAGCCCAAAATCGAATTGGAGTTGGAAAACCAAGTGCAGCCACACCCTTCGTCAAAGTTGCTGATCCAATTG
>TTN-214,ENSE00003806295,1,188,2851662,2851849,AGAGACCAAGTCCTCCTGTAAACCTAACTTCCTCAGATCAGACTCAGTCATCAGTTCAGCTCAAATGGGAACCTCCTCTGAAAGATGGAGGAAGCCCAATATTAGGCTATATAATTGAGCGATGCGAAGAAGGAAAAGATAATTGGATTCGTTGCAATATGAAACTTGTCCCTGAACTGACTTACAAG
>TTN-214,ENSE00003810732,1,115,2851850,2851964,GTTACCGGATTGGAAAAAGGAAATAAATATTTATATAGAGTATCTGCAGAAAATAAAGCTGGTGTTTCAGATCCATCTGAAATTCTTGGTCCTCTCACCGCTGACGATGCATTTG
>TTN-214,ENSE00003809985,1,285,2851965,2852249,TTGAACCAACAATGGATTTAAGTGCATTTAAAGATGGTCTGGAAGTTATTGTCCCAAATCCTATCACGATCCTGGTTCCAAGTACAGGCTATCCAAGGCCAACTGCAACCTGGTGTTTTGGAGATAAAGTACTAGAAACAGGGGACCGGGTGAAAATGAAGACCTTGTCTGCCTATGCCGAACTTGTCATTTCTCCAAGTGAACGTTCAGACAAGGGCATTTATACACTGAAATTAGAAAACCGTGTGAAAACAATTTCTGGGGAAATTGATGTCAATGTAATTG
>TTN-214,ENSE00003808828,1,152,2852250,2852401,CTCGCCCAAGTGCACCCAAAGAATTGAAATTTGGTGATATAACCAAGGACTCAGTACATTTGACTTGGGAACCACCTGATGATGATGGAGGAAGTCCGTTAACTGGATACGTTGTTGAAAAACGAGAAGTCAGCCGGAAAACATGGACTAAA
>TTN-214,ENSE00003803811,1,148,2852402,2852549,GTTATGGACTTTGTGACTGATCTAGAATTCACAGTTCCTGATCTTGTTCAAGGAAAAGAGTACTTATTTAAAGTTTGTGCTCGTAACAAATGTGGCCCTGGAGAACCTGCATATGTTGATGAACCTGTAAATATGTCAACTCCTGCAA
>TTN-214,ENSE00003803944,1,178,2852550,2852727,CGGTACCTGACCCACCAGAGAATGTTAAATGGAGAGATCGAACAGCCAATAGCATCTTCTTAACATGGGATCCACCTAAAAATGATGGTGGTTCACGCATCAAAGGATATATAGTTGAAAGATGTCCACGTGGTTCTGATAAATGGGTTGCCTGTGGAGAACCTGTTGCAGAAACAAA
>TTN-214,ENSE00003802090,1,122,2852728,2852849,AATGGAAGTGACAGGTCTTGAGGAAGGCAAATGGTATGCCTACCGCGTGAAGGCCTTAAACAGGCAGGGTGCTAGCAAACCAAGCAGACCCACAGAGGAAATCCAGGCTGTGGACACACAAG
>TTN-214,ENSE00003809522,1,288,2852850,2853137,AGGCCCCAGAAATCTTCCTCGATGTGAAGCTCCTTGCTGGTCTCACTGTAAAAGCTGGGACCAAGATTGAACTTCCTGCCACCGTAACCGGAAAACCTGAACCTAAAATAACTTGGACAAAGGCTGATATGATTCTGAAGCAGGACAAAAGAATTACCATTGAAAATGTCCCTAAGAAATCCACAGTGACTATTGTTGATAGTAAGAGAAGTGACACTGGCACATATATCATTGAGGCTGTGAATGTGTGTGGCCGGGCCACTGCTGTGGTGGAAGTGAACGTCTTAG
>TTN-214,ENSE00003804879,1,297,2853138,2853434,ATAAACCCGGACCACCAGCTGCCTTTGACATCACAGATGTAACCAATGAGTCATGTCTTCTAACATGGAACCCACCACGCGATGATGGTGGATCTAAGATCACAAACTATGTTGTGGAGAGACGAGCAACTGATAGTGAAGTGTGGCACAAGCTCTCATCCACCGTCAAGGATACAAACTTCAAGGCCACCAAATTAATCCCCAATAAAGAGTACATCTTCAGAGTTGCTGCAGAAAACATGTATGGTGTTGGTGAACCAGTTCAGGCCTCTCCAATAACAGCCAAATATCAGTTTG
>TTN-214,ENSE00003809410,1,187,2853435,2853621,ATCCACCTGGTCCTCCAACTCGCCTAGAACCTTCTGATATCACTAAAGACGCAGTGACTCTCACATGGTGTGAGCCAGATGATGATGGTGGCAGCCCAATCACAGGATACTGGGTTGAAAGACTGGATCCTGATACAGATAAATGGGTTAGATGCAATAAGATGCCAGTAAAGGACACAACATACAG
>TTN-214,ENSE00003808827,1,116,2853622,2853737,AGTGAAAGGTCTCACTAATAAGAAAAAATACAGATTCCGTGTGTTGGCTGAAAATCTTGCTGGACCTGGAAAACCAAGCAAATCAACTGAACCAATCTTAATAAAGGATCCCATAG
>TTN-214,ENSE00003806136,1,300,2853738,2854037,ATCCTCCATGGCCCCCTGGAAAACCAACTGTAAAAGATGTAGGCAAAACATCAGTAAGGTTGAATTGGACAAAACCAGAACATGATGGAGGTGCAAAGATTGAGTCTTATGTCATTGAAATGCTGAAGACTGGAACAGATGAGTGGGTCAGAGTGGCGGAAGGGGTTCCCACCACTCAGCACTTGCTCCCAGGGCTCATGGAAGGACAGGAATACTCATTCCGAGTTAGAGCTGTGAATAAGGCTGGGGAAAGTGAACCCAGTGAACCCAGTGACCCTGTGCTTTGCCGGGAGAAGCTAT
>TTN-214,ENSE00003804290,1,300,2854038,2854337,ATCCTCCATCACCACCACGCTGGCTTGAAGTTATTAATATCACAAAAAATACAGCAGACCTAAAATGGACAGTTCCTGAGAAAGATGGAGGGTCCCCCATCACCAACTACATTGTGGAAAAGAGAGACGTCAGGCGAAAAGGCTGGCAAACAGTGGATACCACTGTCAAGGACACCAAGTGCACAGTCACCCCACTGACTGAGGGCTCTTTATATGTGTTCCGAGTTGCTGCAGAAAATGCTATAGGACAAAGCGACTACACCGAAATTGAGGACTCTGTGCTGGCCAAAGACACCTTTA
>TTN-214,ENSE00003803723,1,106,2854338,2854443,CCACTCCTGGACCACCCTACGCCCTGGCAGTGGTTGATGTGACAAAACGACATGTTGACCTAAAGTGGGAGCCACCTAAAAATGATGGTGGAAGACCAATACAGAG
>TTN-214,ENSE00003805819,1,197,2854444,2854640,ATATGTCATTGAGAAGAAAGAAAGGTTAGGTACCCGTTGGGTGAAAGCTGGAAAGACTGCAGGACCTGACTGTAACTTCAGAGTAACTGATGTCATCGAAGGAACAGAGGTCCAGTTTCAGGTTCGGGCTGAAAATGAAGCTGGAGTTGGCCACCCAAGTGAACCCACAGAAATCCTATCCATTGAAGATCCAACAA
>TTN-214,ENSE00003806467,1,306,2854641,2854946,GTCCTCCCTCACCACCCCTTGACCTACATGTGACTGATGCTGGGAGAAAACACATTGCCATTGCTTGGAAGCCTCCAGAGAAAAATGGTGGAAGTCCTATCATAGGATACCATGTTGAAATGTGTCCAGTAGGCACTGAGAAATGGATGAGAGTTAATTCTCGCCCAATAAAGGACTTGAAATTCAAGGTTGAAGAAGGTGTTGTTCCTGACAAAGAATATGTCCTGAGAGTGAGAGCAGTCAATGCTATTGGTGTCAGCGAGCCATCTGAAATCTCTGAAAATGTGGTTGCCAAAGACCCAGACT
>TTN-214,ENSE00003808061,1,279,2854947,2855225,GCAAGCCAACAATTGACCTGGAGACTCATGACATTATTGTTATTGAAGGTGAAAAGTTAAGCATTCCTGTTCCCTTCAGAGCTGTCCCAGTTCCAACTGTTAGTTGGCATAAAGATGGCAAAGAAGTTAAAGCAAGTGATAGATTAACAATGAAGAATGATCACATCTCTGCACACCTTGAAGTTCCCAAGAGTGTCCGTGCAGATGCCGGAATTTATACCATTACACTGGAGAATAAGCTCGGCTCAGCAACAGCCTCAATCAATGTCAAAGTCATAG
>TTN-214,ENSE00003811164,1,300,2855226,2855525,GCCTACCTGGACCATGCAAAGATATTAAAGCAAGTGACATTACCAAGAGTTCTTGTAAGTTAACTTGGGAACCTCCAGAATTTGATGGTGGAACCCCAATTCTTCATTATGTCCTGGAGCGCAGAGAAGCTGGGAGGAGAACATATATACCAGTCATGTCTGGTGAGAACAAACTGTCATGGACTGTGAAGGATCTCATACCAAATGGTGAATACTTCTTCCGTGTTAAAGCAGTCAACAAGGTTGGTGGAGGAGAATATATTGAACTGAAAAATCCAGTCATTGCTCAAGATCCAAAGC
>TTN-214,ENSE00003805132,1,303,2855526,2855828,AACCCCCTGATCCACCTGTAGATGTAGAGGTTCATAATCCTACAGCGGAGGCAATGACTATTACATGGAAGCCACCTTTGTATGATGGAGGGAGCAAGATAATGGGCTACATCATAGAGAAGATTGCTAAGGGTGAAGAAAGGTGGAAGAGATGCAATGAACACCTGGTACCAATCCTGACCTATACAGCAAAAGGACTTGAAGAGGGGAAAGAGTACCAATTCCGTGTGCGAGCAGAGAACGCCGCGGGTATTAGTGAACCTTCTCGGGCTACTCCTCCAACCAAAGCTGTAGATCCCATTG
>TTN-214,ENSE00003805056,1,363,2855829,2856191,ATGCCCCCAAAGTCATTCTGAGAACAAGCCTAGAAGTGAAACGAGGTGATGAAATAGCACTTGATGCAAGTATTTCTGGATCACCTTACCCAACTATTACATGGATAAAGGATGAAAATGTTATTGTACCAGAGGAAATTAAGAAGCGTGCAGCACCCTTGGTTAGGAGAAGGAAGGGTGAAGTTCAAGAAGAAGAACCATTTGTCCTGCCTCTGACACAGCGTTTGAGTATTGACAACAGCAAAAAGGGAGAATCTCAGCTACGCGTCCGAGATTCTCTCCGACCTGACCATGGTCTGTATATGATCAAAGTTGAAAATGACCACGGTATTGCAAAAGCTCCTTGTACTGTCAGTGTGTTAG
>TTN-214,ENSE00003811138,1,303,2856192,2856494,ATACACCGGGACCACCAATCAACTTTGTATTTGAAGATATCAGAAAGACCTCAGTCCTTTGTAAATGGGAACCACCCCTTGATGATGGTGGCAGTGAAATCATAAACTACACTTTGGAAAAGAAAGACAAGACAAAACCCGACTCAGAATGGATTGTTGTCACTTCAACACTTAGACATTGCAAATATTCAGTAACAAAACTGATTGAAGGAAAAGAGTACCTCTTCCGTGTAAGAGCTGAAAACAGATTTGGGCCAGGTCCACCATGTGTTTCAAAGCCACTTGTGGCTAAAGATCCATTTG
>TTN-214,ENSE00003809346,1,300,2856495,2856794,GACCACCTGATGCACCAGATAAGCCCATTGTGGAAGATGTTACCAGCAACAGTATGCTAGTGAAATGGAATGAACCAAAAGATAATGGAAGCCCCATTTTGGGTTACTGGCTTGAAAAACGTGAAGTTAACAGTACACATTGGTCTCGTGTCAACAAAAGCCTTCTGAATGCCTTGAAAGCCAATGTAGATGGCTTATTAGAAGGACTCACCTATGTCTTCAGAGTATGTGCTGAAAATGCAGCTGGACCTGGAAAGTTCAGTCCACCTTCAGATCCCAAAACAGCACATGATCCAATCT
>TTN-214,ENSE00003806782,1,297,2856795,2857091,CTCCTCCTGGGCCACCTATCCCAAGAGTCACTGACACAAGCTCTACAACTATTGAACTAGAATGGGAACCCCCAGCTTTCAATGGTGGTGGGGAAATTGTTGGCTATTTTGTTGATAAGCAGTTGGTTGGCACAAATGAATGGTCACGCTGCACAGAGAAGATGATCAAGGTCCGTCAGTACACCGTCAAAGAAATCCGAGAGGGTGCTGATTACAAACTTCGGGTGAGTGCTGTCAATGCCGCAGGGGAAGGACCGCCTGGAGAAACACAACCTGTTACTGTGGCTGAACCACAAG
>TTN-214,ENSE00003804121,1,285,2857092,2857376,AGCCTCCAGCTGTGGAACTGGATGTTTCTGTCAAGGGTGGAATACAAATAATGGCTGGGAAGACTCTTAGAATTCCAGCTGTGGTGACTGGTCGCCCTGTACCTACAAAAGTATGGACCAAAGAAGAAGGGGAGCTGGATAAAGACCGTGTTGTAATAGACAACGTTGGAACCAAATCTGAACTAATTATCAAGGATGCACTGCGAAAAGACCATGGCAGATATGTGATTACAGCTACAAATAGCTGTGGTTCCAAATTTGCAGCAGCCAGGGTAGAAGTTTTTG
>TTN-214,ENSE00003804454,1,294,2857377,2857670,ATGTCCCTGGTCCAGTTCTTGACTTAAAACCTGTTGTAACAAACAGAAAAATGTGTCTACTTAACTGGTCTGATCCAGAAGATGATGGAGGAAGTGAAATAACAGGCTTTATCATTGAAAGAAAAGATGCCAAGATGCATACTTGGAGACAACCAATAGAGACTGAGAGATCTAAATGTGACATCACAGGTCTGCTTGAGGGACAAGAATATAAGTTCCGTGTTATTGCCAAGAACAAGTTTGGCTGTGGCCCTCCTGTTGAAATAGGACCAATTCTTGCAGTTGATCCACTAG
>TTN-214,ENSE00003803420,1,300,2857671,2857970,GTCCTCCAACATCTCCAGAGAGGCTCACATACACTGAAAGGACAAAGTCCACTATCACACTTGACTGGAAAGAGCCCCGCAGTAATGGTGGCAGTCCCATCCAAGGATATATCATTGAAAAACGGCGTCATGACAAACCTGACTTTGAAAGAGTTAACAAGCGACTCTGCCCAACCACATCTTTTCTGGTTGAAAATCTTGATGAACACCAAATGTATGAGTTCCGTGTCAAAGCTGTCAATGAAATTGGTGAAAGTGAACCATCCCTACCTCTTAATGTAGTCATACAAGATGATGAAG
>TTN-214,ENSE00003809028,1,309,2857971,2858279,TGCCTCCAACTATTAAGTTGCGTCTGAGTGTTCGAGGAGACACTATCAAAGTTAAGGCAGGAGAGCCTGTCCACATCCCTGCAGATGTGACAGGCCTTCCAATGCCTAAGATTGAATGGTCCAAAAATGAAACTGTAATTGAAAAACCCACTGATGCACTTCAGATAACCAAGGAAGAGGTATCCCGAAGTGAGGCAAAAACTGAGCTTAGCATTCCCAAAGCGGTCCGGGAGGACAAAGGCACTTACACAGTTACTGCTTCCAATCGCCTTGGCTCAGTGTTCCGAAATGTTCACGTTGAAGTATATG
>TTN-214,ENSE00003801894,1,191,2858280,2858470,ACCGCCCATCCCCACCAAGAAATCTTGCTGTTACTGACATTAAAGCTGAATCTTGCTACTTGACATGGGATGCCCCTCTTGATAATGGTGGCAGTGAAATCACCCATTATGTTATTGACAAACGTGATGCAAGTAGGAAGAAAGCAGAATGGGAGGAAGTCACCAACACTGCTGTAGAGAAAAGATATGGG
>TTN-214,ENSE00003809851,1,430,2858471,2858900,ATCTGGAAACTTATCCCCAATGGTCAGTATGAGTTCCGAGTCAGGGCAGTGAATAAATATGGAATCAGTGATGAGTGCAAATCAGATAAAGTAGTCATTCAAGATCCTTATCGCCTTCCTGGACCTCCAGGAAAACCAAAAGTTTTGGCACGCACCAAAGGATCAATGCTAGTGAGCTGGACTCCTCCTTTGGACAATGGTGGCTCTCCAATTACTGGCTACTGGCTGGAGAAAAGAGAAGAGGGAAGTCCTTATTGGTCACGTGTTAGCCGAGCACCAATAACCAAAGTGGGATTGAAAGGCGTGGAATTTAATGTTCCTCGTTTGCTTGAAGGCGTTAAATACCAGTTCAGAGCCATGGCAATAAATGCTGCAGGAATTGGTCCTCCCAGTGAACCATCAGATCCAGAGGTTGCAGGAGATCCCATAT
>TTN-214,ENSE00003808594,1,309,2858901,2859209,TTCCACCGGGGCCACCTTCTTGCCCAGAAGTTAAAGATAAAACGAAGTCAAGCATCTCACTAGGATGGAAACCTCCAGCCAAAGATGGTGGCAGCCCAATCAAAGGATACATTGTAGAAATGCAAGAAGAAGGTACTACTGACTGGAAAAGAGTAAATGAACCAGACAAACTTATAACTACCTGTGAATGTGTGGTGCCTAATCTGAAAGAGCTCAGGAAGTACAGATTCAGAGTGAAAGCTGTCAATGAAGCTGGTGAATCTGAACCAAGTGATACAACTGGGGAGATCCCTGCCACTGATATTCAAG
>TTN-214,ENSE00003810473,1,149,2859210,2859358,AGGAACCAGAAGTTTTCATTGACATTGGAGCACAGGACTGTCTGGTTTGTAAAGCTGGCTCACAGATTAGGATTCCTGCTGTCATCAAGGGACGCCCAACACCAAAATCATCTTGGGAATTTGATGGAAAGGCAAAGAAAGCAATGAAG
>TTN-214,ENSE00003801625,1,33,2859359,2859391,GATGGAGTTCATGACATACCCGAAGATGCACAG
>TTN-214,ENSE00003802643,1,130,2859392,2859521,CTGGAGACTGCTGAAAACTCCTCAGTAATTATTATTCCGGAGTGTAAACGATCTCATACAGGCAAATACAGCATCACAGCCAAGAATAAAGCAGGACAAAAGACTGCAAATTGCAGAGTTAAAGTCATGG
>TTN-214,ENSE00003804239,1,300,2859522,2859821,ATGTACCAGGCCCACCCAAAGATCTGAAAGTCAGTGATATCACAAGGGGTAGTTGCAGACTTTCATGGAAGATGCCAGACGACGATGGAGGAGACAGGATCAAAGGCTATGTTATTGAGAAGAGGACTATTGATGGAAAAGCCTGGACCAAAGTCAATCCAGACTGTGGAAGCACCACATTTGTAGTGCCTGATCTCCTCTCTGAACAGCAATATTTCTTCCGTGTGCGAGCAGAAAACCGTTTTGGTATTGGCCCACCTGTGGAAACCATTCAGAGGACCACTGCCAGAGATCCGATAT
>TTN-214,ENSE00003806278,1,318,2859822,2860139,ATCCTCCTGATCCTCCTATTAAACTCAAGATTGGCCTCATCACAAAGAACACAGTGCATCTGTCATGGAAACCCCCGAAGAATGATGGGGGCTCCCCTGTTACCCACTATATTGTTGAGTGCCTTGCATGGGACCCTACTGGGACAAAGAAAGAAGCCTGGAGGCAGTGCAATAAGCGTGATGTGGAAGAACTGCAATTTACTGTTGAAGACCTAGTAGAGGGTGGGGAATATGAATTCCGAGTCAAAGCTGTCAATGCTGCAGGAGTCAGCAAGCCTTCAGCCACTGTTGGCCCTGTGACTGTCAAAGACCAGACAT
>TTN-214,ENSE00003801391,1,297,2860140,2860436,GCCCACCATCAATTGATCTAAAAGAATTCATGGAGGTTGAAGAAGGAACCAATGTTAACATTGTGGCCAAAATTAAAGGTGTGCCATTCCCGACACTAACCTGGTTTAAAGCTCCTCCAAAGAAGCCTGATAACAAAGAACCTGTTCTCTATGACACCCATGTCAACAAACTGGTGGTAGATGATACTTGCACTTTAGTTATTCCGCAGTCTCGCAGGAGTGACACTGGCTTATATACCATCACAGCTGTAAATAATCTGGGAACAGCATCAAAGGAGATGAGACTGAATGTCCTGG
>TTN-214,ENSE00003806021,1,300,2860437,2860736,GTCGTCCTGGCCCTCCAGTGGGACCCATAAAATTTGAATCTGTTTCAGCAGATCAAATGACACTATCTTGGTTTCCACCTAAAGATGATGGTGGGTCTAAGATTACAAACTATGTAATTGAGAAAAGAGAAGCTAACAGGAAGACATGGGTCCATGTCTCCAGTGAACCTAAGGAGTGCACGTACACGATTCCCAAATTGCTAGAAGGCCATGAATATGTATTCCGAATCATGGCCCAGAATAAATATGGCATTGGAGAACCTCTTGACAGTGAACCTGAAACAGCAAGAAACCTCTTCT
>TTN-214,ENSE00003803442,1,315,2860737,2861051,CTGTCCCTGGAGCACCAGATAAACCAACAGTTAGCAGCGTGACTCGTAACTCCATGACTGTCAACTGGGAAGAGCCAGAATATGATGGAGGCTCTCCTGTGACAGGGTACTGGCTGGAAATGAAAGACACCACTTCAAAGAGATGGAAGAGAGTTAACCGAGATCCTATCAAAGCCATGACTTTGGGTGTTTCTTATAAAGTGACTGGTCTTATTGAAGGTTCCGACTATCAATTCCGGGTATATGCAATCAATGCTGCTGGCGTGGGTCCAGCAAGTCTGCCATCAGACCCAGCGACTGCTAGAGATCCAATTG
>TTN-214,ENSE00003801787,1,149,2861052,2861200,CCCCTCCTGGTCCTCCATTTCCCAAAGTGACAGATTGGACTAAATCATCTGCAGATCTGGAGTGGTCTCCCCCACTAAAAGATGGTGGATCCAAAGTAACTGGATACATCGTTGAATATAAAGAAGAAGGAAAAGAAGAATGGGAAAAG
>TTN-214,ENSE00003802004,1,151,2861201,2861351,GGTAAAGATAAAGAAGTGAGAGGAACAAAGCTTGTTGTGACAGGATTAAAGGAAGGAGCATTCTACAAATTTAGAGTTAGAGCAGTCAACATTGCTGGCATTGGAGAACCTGGAGAGGTCACAGATGTCATTGAAATGAAGGACAGACTTG
>TTN-214,ENSE00003808790,1,282,2861352,2861633,TTTCACCTGACCTTCAGCTAGATGCCAGTGTCAGAGATAGAATTGTTGTCCATGCTGGAGGGGTGATCCGAATCATTGCCTATGTGTCTGGAAAGCCTCCTCCAACCGTCACCTGGAACATGAATGAAAGAACCTTACCTCAAGAAGCCACCATTGAGACCACAGCCATTAGCTCATCCATGGTCATCAAGAACTGCCAGAGGAGCCATCAAGGCGTCTATTCTCTTCTTGCCAAAAATGAAGCCGGAGAAAGAAAGAAGACAATTATTGTTGATGTATTAG
>TTN-214,ENSE00003807896,1,303,2861634,2861936,ATGTTCCAGGTCCCGTTGGAACACCATTCCTAGCTCACAACCTAACCAATGAGTCCTGCAAACTGACATGGTTTTCTCCAGAAGATGATGGAGGCTCTCCAATCACCAATTATGTCATTGAAAAGCGTGAATCTGACCGCAGAGCATGGACCCCAGTGACATATACAGTTACCCGACAAAATGCTACTGTCCAGGGTCTCATTCAAGGAAAAGCCTACTTTTTCCGAATTGCGGCTGAAAATAGTATTGGCATGGGTCCATTTGTTGAGACATCAGAGGCACTTGTTATCAGAGAGCCAATAA
>TTN-214,ENSE00003801753,1,303,2861937,2862239,CTGTACCAGAGCGTCCTGAAGACCTGGAAGTCAAAGAAGTTACTAAAAATACTGTAACTTTGACTTGGAATCCTCCTAAGTATGATGGTGGGTCAGAAATTATTAACTATGTCCTAGAAAGTCGGCTCATTGGGACTGAGAAGTTCCACAAAGTTACAAATGACAACTTGCTTAGCAGAAAATACACTGTTAAAGGCTTAAAAGAAGGTGATACCTATGAGTACCGTGTCAGTGCTGTCAACATTGTTGGACAAGGCAAACCATCATTTTGCACCAAACCAATTACTTGCAAGGATGAGCTGG
>TTN-214,ENSE00003807039,1,282,2862240,2862521,CACCCCCAACGCTTCACCTCGACTTCAGAGATAAGCTCACGATTCGAGTTGGTGAAGCTTTTGCCCTCACTGGCCGTTACTCAGGCAAACCAAAGCCTAAGGTTTCCTGGTTCAAAGATGAAGCTGATGTGCTGGAAGATGATCGCACTCATATAAAGACTACACCAGCAACACTTGCTTTAGAGAAGATCAAGGCCAAACGTTCAGATTCCGGCAAATACTGTGTGGTTGTGGAGAACAGTACAGGCTCTAGGAAAGGTTTCTGTCAAGTTAATGTTGTTG
>TTN-214,ENSE00003804106,1,300,2862522,2862821,ACCGTCCTGGACCACCAGTAGGACCAGTTAGTTTTGATGAGGTGACCAAAGATTACATGGTTATCTCTTGGAAGCCTCCTTTAGATGATGGAGGCAGTAAAATCACCAATTATATTATTGAGAAGAAGGAAGTGGGTAAAGACGTCTGGATGCCAGTGACATCTGCAAGTGCTAAAACAACATGCAAAGTTTCTAAACTACTTGAAGGAAAAGATTATATTTTCCGGATACATGCTGAAAATCTGTATGGAATAAGTGATCCTCTGGTGTCTGATTCAATGAAAGCCAAAGATCGTTTCA
>TTN-214,ENSE00003801817,1,303,2862822,2863124,GGGTTCCTGATGCACCTGATCAGCCAATTGTTACAGAAGTTACCAAAGACTCTGCATTAGTAACCTGGAATAAGCCACATGATGGAGGAAAACCCATCACAAACTACATCCTGGAAAAGAGAGAAACTATGTCTAAACGATGGGCTAGAGTTACCAAAGATCCTATTCATCCATACACTAAATTTAGGGTTCCTGATCTTCTAGAAGGATGTCAGTATGAATTCCGGGTTTCTGCAGAAAATGAAATTGGTATTGGAGATCCAAGCCCACCATCCAAACCAGTCTTTGCTAAAGATCCAATTG
>TTN-214,ENSE00003810564,1,309,2863125,2863433,CTAAACCAAGTCCACCTGTTAATCCTGAAGCAATAGATACAACATGCAATTCAGTCGATCTAACTTGGCAGCCACCACGTCATGATGGTGGGAGCAAGATTCTGGGTTATATTGTTGAGTACCAGAAAGTTGGAGATGAAGAGTGGAGAAGAGCCAATCACACCCCTGAGTCATGTCCTGAAACTAAATATAAAGTCACCGGTCTTCGGGACGGTCAAACCTATAAGTTTAGAGTGTTAGCAGTCAATGCAGCTGGTGAATCAGATCCAGCTCATGTTCCGGAGCCAGTCCTAGTAAAAGACAGGCTTG
>TTN-214,ENSE00003807476,1,282,2863434,2863715,AACCCCCTGAGTTGATTCTTGATGCCAACATGGCAAGAGAACAACACATTAAAGTTGGTGATACTCTAAGACTTAGTGCCATCATCAAAGGAGTGCCATTCCCAAAAGTAACTTGGAAAAAAGAAGACAGAGATGCTCCAACTAAAGCAAGAATTGATGTGACTCCAGTTGGTAGCAAGCTTGAAATTCGTAATGCTGCCCATGAAGATGGTGGAATTTATTCTTTAACAGTGGAGAATCCAGCTGGTTCAAAAACTGTCTCAGTAAAAGTACTTGTATTAG
>TTN-214,ENSE00003807363,1,300,2863716,2864015,ATAAACCTGGGCCACCTAGAGATCTGGAAGTCAGTGAAATTAGGAAAGATTCATGTTACCTTACTTGGAAAGAACCACTGGATGATGGTGGTTCTGTTATTACCAATTATGTGGTTGAGAGGAGAGATGTTGCCAGCGCCCAGTGGTCACCTCTCTCAGCTACATCAAAGAAAAAGAGTCACTTCGCTAAGCATCTGAATGAAGGCAACCAGTACCTCTTCCGAGTAGCTGCGGAGAACCAGTATGGACGTGGTCCTTTTGTTGAAACACCAAAACCAATCAAGGCTTTGGATCCTCTCC
>TTN-214,ENSE00003808994,1,294,2864016,2864309,ATCCCCCAGGGCCACCCAAGGACCTGCACCATGTAGATGTTGACAAGACTGAAGTCTCCCTAGTCTGGAATAAGCCGGATCGTGATGGTGGTTCTCCAATCACTGGATATTTGGTAGAATATCAAGAAGAAGGCACCCAGGACTGGATTAAATTTAAGACTGTGACAAACTTAGAGTGTGTGGTTACTGGACTACAACAAGGAAAGACCTATAGATTCCGTGTAAAAGCTGAAAACATTGTGGGTCTTGGTCTCCCTGACACAACTATCCCGATAGAATGTCAAGAAAAACTAG
>TTN-214,ENSE00003810188,1,2967,2864310,2867276,TGCCTCCATCCGTGGAGCTAGATGTGAAATTAATTGAAGGTCTTGTGGTAAAGGCTGGAACCACAGTCAGATTCCCTGCTATTATAAGAGGTGTGCCTGTTCCTACTGCAAAGTGGACAACCGATGGGAGTGAGATTAAAACCGATGAGCACTACACAGTTGAAACAGACAACTTCTCATCAGTACTTACCATTAAGAACTGCTTAAGGAGAGACACTGGGGAATATCAAATCACAGTTTCCAATGCAGCCGGTAGCAAAACAGTAGCCGTACATCTTACTGTTCTTGATGTTCCTGGGCCACCAACAGGTCCTATTAATATTCTGGATGTTACTCCTGAACACATGACTATCTCATGGCAGCCACCTAAGGATGATGGAGGAAGCCCTGTGATAAATTATATTGTTGAGAAACAAGATACAAGGAAAGACACGTGGGGTGTTGTCTCTTCCGGAAGCAGTAAGACAAAGCTGAAAATCCCACATCTGCAGAAGGGCTGTGAATATGTTTTCCGAGTTAGAGCAGAGAATAAGATAGGTGTTGGTCCTCCCCTTGACTCCACACCTACTGTTGCTAAGCATAAATTTAGTCCTCCGTCTCCTCCTGGTAAACCAGTGGTTACTGACATTACTGAAAATGCAGCAACAGTGTCTTGGACCCTGCCAAAATCTGATGGTGGCAGTCCAATAACTGGCTACTATATGGAACGTCGAGAAGTAACTGGCAAATGGGTGAGGGTCAACAAAACACCTATCGCTGACCTGAAGTTCAGAGTGACTGGACTCTATGAAGGAAATACATATGAGTTTAGAGTTTTTGCTGAAAATCTTGCAGGACTAAGCAAACCATCCCCAAGTTCTGATCCAATAAAAGCTTGCCGGCCCATCAAACCACCTGGACCACCTATTAATCCTAAACTGAAAGACAAGAGCAGAGAAACAGCTGATTTGGTGTGGACAAAGCCTCTCAGTGATGGTGGTAGCCCCATTCTAGGATATGTAGTGGAATGTCAGAAACCTGGCACAGCACAATGGAACAGGATTAATAAAGATGAACTCATTAGGCAATGTGCCTTTAGGGTACCTGGACTAATTGAAGGAAATGAGTACAGATTCCGTATAAAGGCAGCTAATATTGTAGGAGAGGGTGAGCCAAGAGAACTAGCAGAATCTGTGATTGCAAAAGATATCCTTCATCCTCCAGAAGTAGAACTTGATGTTACTTGTCGTGATGTTATTACCGTGAGAGTAGGCCAAACTATCCGCATTCTAGCTCGAGTCAAAGGCAGACCTGAACCAGACATAACTTGGACTAAGGAAGGCAAAGTATTGGTCCGAGAAAAGAGGGTGGACCTTATTCAGGATCTACCTCGTGTTGAGTTACAAATTAAAGAAGCTGTTAGAGCTGATCATGGCAAGTATATCATCTCAGCTAAGAACAGCAGTGGACATGCCCAAGGTTCAGCCATCGTTAACGTCCTTGACAGACCTGGGCCTTGCCAGAATTTGAAGGTTACCAATGTAACCAAAGAGAACTGTACAATTTCTTGGGAAAACCCACTAGATAATGGTGGCTCAGAAATAACAAACTTCATAGTAGAATATCGCAAACCAAACCAGAAAGGCTGGTCAATTGTTGCATCAGATGTCACTAAACGATTAATCAAGGCCAACCTTTTAGCCAACAATGAATACTATTTCCGAGTTTGTGCAGAGAATAAAGTAGGTGTTGGGCCAACCATCGAAACAAAAACTCCCATTCTGGCTATTAACCCTATTGACAGACCAGGTGAGCCTGAAAACCTTCACATTGCAGATAAAGGAAAGACATTTGTCTATCTAAAGTGGCGGAGGCCTGACTATGATGGTGGCAGTCCAAATCTGTCATATCATGTTGAGAGAAGGCTTAAGGGCTCCGATGACTGGGAAAGAGTGCATAAAGGAAGCATTAAAGAAACTCACTACATGGTTGACAGATGTGTTGAAAACCAGATTTATGAGTTCAGAGTGCAAACAAAGAATGAAGGTGGGGAAAGTGACTGGGTGAAGACAGAGGAAGTTGTTGTGAAAGAAGACTTACAAAAACCAGTACTTGATCTGAAATTAAGTGGGGTCCTAACTGTCAAAGCAGGGGACACCATTAGGCTTGAGGCAGGGGTTAGAGGCAAACCATTCCCAGAAGTTGCATGGACCAAGGACAAAGACGCTACAGACTTAACAAGATCACCAAGGGTCAAGATTGATACCCGTGCTGATTCATCTAAATTTTCTCTTACTAAAGCAAAGCGAAGTGATGGGGGTAAATATGTAGTTACGGCAACTAACACGGCTGGCAGTTTTGTGGCCTATGCCACTGTCAATGTTTTAGATAAGCCTGGTCCTGTGAGAAATCTGAAAATTGTTGATGTGTCCAGTGATAGGTGTACTGTTTGCTGGGATCCACCAGAAGATGATGGTGGCTGTGAAATCCAAAATTATATTCTAGAAAAATGTGAGACAAAGCGAATGGTTTGGTCTACCTATTCTGCTACTGTCTTGACACCTGGTACTACAGTAACACGTCTCATAGAAGGAAATGAATATATTTTCAGAGTCCGTGCAGAAAATAAAATAGGCACAGGGCCTCCAACAGAAAGTAAACCAGTCATAGCCAAAACCAAGTATGATAAACCTGGTCGCCCTGATCCCCCAGAAGTCACTAAAGTAAGCAAAGAAGAGATGACTGTGGTTTGGAATCCACCTGAATATGATGGTGGAAAGTCTATAACTGGATACTTTTTGGAGAAAAAGGAAAAGCATTCAACACGATGGGTCCCTGTCAACAAGAGTGCAATCCCTGAGAGACGTATGAAAGTACAGAATCTCCTCCCAGACCATGAATATCAGTTCCGTGTCAAGGCAGAAAATGAAATTGGAATTGGAGAACCAAGCTTGCCTTCAAGACCGGTGGTGGCAAAAGACCCCATAG
>TTN-214,ENSE00003811401,1,321,2867277,2867597,AGCCACCTGGTCCACCAACCAATTTCAGAGTGGTTGATACAACCAAACATTCCATAACTCTTGGGTGGGGAAAACCAGTCTATGATGGTGGTGCACCGATCATTGGATATGTTGTGGAAATGAGACCAAAAATAGCAGATGCGTCTCCTGATGAAGGCTGGAAACGGTGTAATGCTGCAGCACAGCTTGTACGCAAGGAATTCACTGTTACCAGCTTGGATGAAAACCAGGAATATGAGTTCAGGGTGTGTGCCCAAAACCAAGTTGGTATTGGGCGCCCTGCAGAGCTAAAGGAAGCTATCAAACCTAAAGAAATACTAG
>TTN-214,ENSE00003805661,1,285,2867598,2867882,AACCTCCGGAGATTGATTTGGATGCCAGCATGAGGAAACTGGTCATAGTGAGAGCAGGATGCCCTATTCGTCTCTTTGCTATAGTGAGAGGACGACCAGCCCCTAAAGTCACTTGGCGAAAAGTTGGCATTGATAATGTGGTCAGAAAAGGACAAGTTGATCTGGTTGACACTATGGCCTTCCTTGTCATCCCCAATTCTACCCGTGATGACTCAGGAAAATATTCCTTAACACTTGTGAACCCAGCAGGAGAAAAGGCTGTATTCGTAAATGTCAGAGTATTAG
>TTN-214,ENSE00003804742,1,300,2867883,2868182,ACACTCCTGGGCCTGTGTCTGATTTAAAAGTTTCAGATGTCACTAAAACATCATGCCATGTGTCCTGGGCCCCTCCTGAAAACGACGGTGGGAGCCAAGTGACACATTATATCGTGGAGAAACGTGAGGCAGACAGAAAGACATGGTCGACCGTTACCCCAGAAGTTAAGAAAACAAGCTTCCATGTAACCAATCTTGTCCCTGGGAATGAGTATTACTTCAGAGTAACTGCTGTCAACGAATATGGCCCTGGCGTCCCAACAGATGTCCCAAAACCAGTGCTTGCATCAGATCCTCTAA
>TTN-214,ENSE00003810357,1,303,2868183,2868485,GTGAGCCGGATCCCCCAAGGAAATTAGAAGTGACTGAAATGACCAAGAACAGTGCCACCTTAGCCTGGTTACCTCCCCTACGTGATGGAGGTGCTAAAATCGATGGCTACATCACTAGTTACAGAGAAGAAGAGCAGCCTGCAGATCGCTGGACAGAGTACTCAGTGGTAAAAGATCTGAGCCTTGTTGTCACTGGCCTAAAGGAAGGAAAGAAATACAAATTTAGAGTAGCGGCCAGAAATGCTGTTGGAGTCAGTTTGCCAAGAGAAGCTGAAGGAGTGTATGAAGCCAAAGAACAACTGT
>TTN-214,ENSE00003801707,1,276,2868486,2868761,TGCCACCAAAGATCCTTATGCCAGAGCAAATAACTATCAAAGCTGGGAAAAAACTCCGAATTGAAGCCCATGTGTATGGAAAGCCTCATCCCACCTGTAAATGGAAAAAAGGAGAAGATGAAGTTGTCACATCCAGCCACCTGGCAGTGCATAAAGCAGACAGCTCTTCAATTCTGATCATAAAAGATGTGACTAGGAAAGACAGTGGTTACTACAGCCTCACAGCAGAGAACAGTTCTGGGACAGACACTCAGAAAATCAAAGTTGTAGTCATGG
>TTN-214,ENSE00003810399,1,300,2868762,2869061,ATGCCCCCGGCCCCCCTCAGCCTCCATTTGACATTTCTGATATAGACGCTGATGCTTGCTCCCTGTCATGGCACATCCCTCTGGAGGACGGAGGCAGTAACATCACCAATTATATAGTGGAGAAGTGTGATGTAAGCCGAGGTGACTGGGTCACGGCTCTAGCTTCAGTCACAAAAACTTCCTGCAGGGTTGGAAAGCTGATCCCAGGCCAGGAGTACATCTTCCGGGTCCGTGCTGAAAACCGATTTGGCATTTCAGAGCCTCTCACATCTCCAAAGATGGTTGCGCAGTTCCCATTTG
>TTN-214,ENSE00003810448,1,303,2869062,2869364,GTGTTCCTAGTGAACCAAAGAATGCACGAGTCACCAAAGTCAACAAGGACTGTATTTTTGTTGCTTGGGACAGACCAGATAGTGATGGAGGGAGCCCCATTATTGGTTATCTGATTGAACGCAAGGAAAGAAACAGTTTGCTGTGGGTGAAAGCCAATGATACTCTTGTCCGGTCAACTGAATATCCTTGTGCTGGCCTTGTAGAAGGTCTTGAGTATTCATTCAGAATCTATGCCCTAAACAAAGCTGGATCCAGCCCACCCAGCAAACCCACAGAATATGTAACTGCAAGAATGCCAGTTG
>TTN-214,ENSE00003802505,1,300,2869365,2869664,ATCCTCCTGGGAAACCTGAGGTTATTGATGTCACCAAGAGTACTGTATCTCTGATCTGGGCTCGTCCAAAGCATGATGGAGGCAGTAAAATTATTGGCTATTTCGTAGAAGCTTGCAAACTTCCTGGTGATAAATGGGTACGGTGCAATACTGCACCTCACCAGATTCCCCAGGAAGAGTACACAGCTACTGGCCTAGAAGAGAAAGCTCAGTATCAATTTAGAGCTATTGCCAGGACCGCGGTAAACATTAGCCCACCTTCTGAACCTTCTGATCCAGTGACTATCCTCGCAGAAAATG
>TTN-214,ENSE00003806397,1,288,2869665,2869952,TCCCTCCCAGGATAGACCTGAGTGTGGCTATGAAATCTTTGCTTACTGTGAAAGCTGGAACTAATGTCTGCTTGGATGCTACTGTTTTTGGTAAACCGATGCCAACAGTTTCTTGGAAAAAAGATGGCACACTGCTAAAACCAGCAGAAGGCATAAAGATGGCCATGCAGCGGAATCTGTGCACCTTGGAGCTATTCAGCGTGAACCGGAAGGACTCAGGAGACTATACCATTACTGCTGAAAATTCAAGTGGTTCTAAATCAGCCACCATTAAGCTTAAAGTGTTAG
>TTN-214,ENSE00003807889,1,297,2869953,2870249,ATAAACCGGGTCCTCCAGCATCTGTTAAAATCAACAAAATGTATTCAGATCGTGCTATGCTTTCTTGGGAACCGCCTCTTGAAGATGGAGGCTCAGAAATCACCAACTATATTGTTGACAAACGTGAAACAAGCAGGCCCAACTGGGCTCAAGTCTCTGCAACTGTGCCTATCACCAGCTGCAGCGTGGAGAAACTTATAGAGGGCCATGAGTATCAGTTCCGTATTTGTGCTGAAAATAAATATGGAGTAGGCGATCCAGTCTTCACTGAACCAGCAATTGCCAAAAACCCATATG
>TTN-214,ENSE00003811290,1,303,2870250,2870552,ACCCACCAGGACGCTGTGATCCTCCTGTTATTAGCAACATAACCAAAGATCACATGACAGTCAGCTGGAAGCCACCAGCAGATGATGGGGGCTCACCCATCACTGGCTATTTGCTTGAAAAGCGGGAAACCCAGGCTGTTAACTGGACTAAGGTCAACAGAAAACCTATTATAGAAAGAACATTAAAAGCAACAGGTCTTCAAGAAGGTACCGAATATGAGTTCCGTGTTACAGCTATAAATAAAGCTGGACCAGGCAAACCCAGTGACGCATCCAAGGCCGCTTATGCTCGGGACCCTCAGT
>TTN-214,ENSE00003808853,1,306,2870553,2870858,ATCCTCCTGGCCCACCGGCTTTCCCTAAAGTATATGATACAACTCGCAGCTCTGTGAGTCTATCTTGGGGCAAGCCAGCCTATGACGGCGGCAGCCCTATCATTGGTTATCTCGTTGAAGTAAAACGGGCTGACTCCGATAACTGGGTGAGGTGCAACTTACCACAGAATCTACAGAAAACCCGCTTTGAGGTTACTGGCCTGATGGAAGACACACAATATCAATTCCGTGTGTATGCCGTTAATAAGATTGGATACAGTGACCCCAGTGATGTGCCAGATAAACACTATCCCAAGGACATCTTAA
>TTN-214,ENSE00003807542,1,288,2870859,2871146,TTCCACCTGAGGGAGAACTTGATGCGGACTTAAGGAAGACACTCATATTACGTGCTGGAGTTACTATGAGACTATATGTACCAGTAAAAGGACGCCCACCTCCAAAGATTACTTGGTCTAAACCAAATGTCAATCTAAGAGACAGGATTGGACTGGACATAAAGTCAACTGACTTTGACACTTTCTTGCGCTGTGAAAATGTGAACAAATATGATGCAGGAAAATATATCTTAACCCTGGAGAACAGCTGTGGTAAAAAGGAATATACCATTGTTGTGAAAGTGCTTG
>TTN-214,ENSE00003810775,1,291,2871147,2871437,ATACTCCTGGGCCACCTGTCAATGTGACTGTTAAGGAAATATCCAAAGACTCTGCTTATGTTACCTGGGAGCCTCCCATTATTGATGGCGGAAGCCCCATCATAAACTATGTGGTACAAAAACGTGATGCAGAGAGGAAATCCTGGTCTACAGTGACAACTGAGTGCTCCAAAACAAGCTTCAGAGTAGCTAATTTGGAGGAGGGAAAATCCTACTTCTTCCGAGTGTTTGCTGAAAATGAGTATGGCATTGGTGATCCCGGTGAAACTCGTGATGCTGTCAAAGCTTCCC
>TTN-214,ENSE00003811210,1,288,2871438,2871725,AAACTCCTGGACCAGTTGTGGACCTGAAAGTGAGGTCTGTATCTAAGTCATCCTGTAGCATTGGCTGGAAAAAGCCTCACAGTGATGGTGGAAGTCGGATTATTGGATATGTAGTTGATTTCCTGACTGAAGAAAATAAGTGGCAACGAGTTATGAAATCCTTAAGCCTACAGTACTCTGCAAAAGATTTGACTGAAGGGAAGGAATATACCTTCAGAGTGAGTGCTGAGAATGAAAATGGAGAAGGAACCCCAAGCGAAATCACTGTTGTGGCAAGGGATGATGTTG
>TTN-214,ENSE00003805436,1,588,2871726,2872313,TGGCTCCTGATCTTGACTTAAAGGGTCTACCTGATTTGTGCTACTTGGCTAAAGAAAACAGCAACTTCCGGCTTAAGATCCCCATAAAAGGCAAGCCAGCTCCATCAGTCTCCTGGAAGAAAGGGGAAGATCCTCTAGCAACTGACACTAGAGTCAGTGTTGAGTCATCTGCGGTTAACACAACTCTTATAGTGTACGATTGCCAAAAATCTGATGCTGGAAAATACACAATCACACTTAAGAATGTTGCTGGCACCAAGGAAGGAACTATCTCCATAAAGGTTGTTGGCAAGCCTGGCATCCCCACTGGACCAATCAAATTTGATGAAGTCACAGCAGAAGCCATGACCTTAAAGTGGGCTCCTCCAAAGGATGATGGAGGTTCTGAAATCACCAACTATATCCTAGAGAAGAGGGATTCTGTGAACAACAAGTGGGTGACGTGCGCCTCAGCTGTCCAGAAAACCACCTTTAGAGTAACCAGACTTCATGAGGGCATGGAATATACCTTCAGGGTCAGTGCCGAAAATAAATATGGTGTAGGGGAAGGCCTGAAATCGGAGCCAATTGTTGCGAGACATCCATTTG
>TTN-214,ENSE00003808777,1,105,2872314,2872418,ATGTGCCTGATGCTCCCCCACCTCCCAATATTGTGGATGTCAGACACGATTCAGTATCTCTAACTTGGACTGACCCCAAGAAAACTGGTGGTTCTCCAATTACAG
>TTN-214,ENSE00003806939,1,198,2872419,2872616,GGTATCATCTCGAGTTCAAGGAAAGAAACAGCCTTTTGTGGAAGAGAGCTAACAAGACTCCGATAAGGATGAGAGACTTTAAAGTGACAGGATTAACTGAAGGTCTTGAATATGAATTCCGAGTTATGGCAATCAATTTAGCAGGTGTGGGCAAGCCAAGCCTACCATCAGAGCCTGTTGTGGCACTGGACCCAATTG
>TTN-214,ENSE00003811024,1,297,2872617,2872913,ATCCTCCTGGAAAACCTGAGGTTATTAACATAACAAGGAATTCAGTGACTCTCATTTGGACTGAACCTAAATATGACGGTGGTCATAAGTTAACTGGATATATAGTGGAGAAGCGAGATCTACCTTCGAAGTCTTGGATGAAAGCCAACCATGTTAATGTCCCAGAATGTGCCTTTACTGTAACTGACCTTGTTGAGGGTGGAAAATATGAATTCAGAATTAGAGCAAAGAATACAGCAGGTGCTATCAGTGCTCCATCAGAAAGTACAGAAACCATTATTTGCAAGGATGAATACG
>TTN-214,ENSE00003803896,1,588,2872914,2873501,AGGCACCAACAATTGTCCTTGATCCCACAATAAAAGATGGGCTAACAATTAAAGCAGGGGATACCATTGTTTTGAATGCCATTAGCATTCTTGGCAAACCCCTTCCAAAATCAAGTTGGTCCAAGGCAGGAAAAGACATTAGACCATCAGATATCACTCAGATAACTTCAACCCCAACATCTTCCATGCTTACTATCAAGTATGCCACTAGAAAAGATGCGGGTGAATATACCATCACTGCTACCAATCCTTTTGGCACGAAGGTGGAACATGTGAAGGTAACAGTCCTTGATGTACCTGGTCCCCCAGGTCCTGTTGAAATCAGTAATGTTTCTGCTGAAAAAGCAACACTTACATGGACACCTCCCTTGGAAGATGGCGGCTCACCAATTAAGTCCTATATACTTGAAAAGAGAGAAACCAGCCGACTTTTGTGGACAGTGGTTTCTGAAGATATTCAGTCTTGCAGGCATGTGGCAACCAAACTTATCCAAGGAAATGAGTACATCTTCCGGGTCTCAGCTGTAAACCACTATGGCAAAGGAGAACCTGTACAGTCTGAACCTGTCAAAATGGTAGACAGATTTG
>TTN-214,ENSE00003807419,1,303,2873502,2873804,GTCCCCCTGGCCCTCCTGAAAAACCAGAGGTATCAAATGTCACTAAGAACACTGCCACTGTCAGCTGGAAAAGGCCAGTGGATGATGGTGGCAGCGAAATTACAGGATATCATGTAGAAAGGAGAGAAAAGAAAAGCCTGCGATGGGTGAGAGCAATAAAAACACCAGTTTCCGATCTCAGGTGCAAAGTAACAGGACTGCAAGAAGGAAGCACCTACGAATTCCGTGTCAGTGCAGAAAACAGAGCAGGAATTGGTCCACCCAGTGAGGCTTCAGATTCTGTTCTGATGAAAGATGCAGCAT
>TTN-214,ENSE00003811193,1,17106,2873805,2890910,ATCCTCCAGGACCACCTTCAAATCCGCATGTCACTGATACTACCAAGAAATCTGCTTCTTTGGCATGGGGCAAGCCTCATTATGATGGTGGACTTGAAATCACTGGCTATGTCGTGGAGCATCAAAAAGTAGGAGACGAGGCCTGGATAAAAGATACCACAGGAACCGCCCTCAGAATCACTCAGTTCGTTGTTCCTGATCTTCAGACTAAAGAAAAATACAACTTCAGAATCAGTGCCATCAACGATGCAGGTGTTGGGGAGCCAGCGGTGATTCCAGATGTTGAAATCGTAGAACGGGAGATGGCTCCTGATTTTGAACTAGATGCCGAGCTTCGAAGAACACTTGTTGTTAGAGCAGGACTCAGTATTAGGATATTTGTGCCAATTAAAGGTCGTCCTGCTCCTGAAGTGACATGGACCAAAGATAACATCAACCTGAAAAACCGAGCCAACATTGAAAATACGGAATCATTTACTCTTCTGATTATCCCAGAATGTAACAGATATGATACCGGTAAATTTGTCATGACCATTGAAAACCCGGCTGGGAAGAAAAGTGGCTTTGTGAACGTCAGAGTCTTGGACACGCCAGGCCCAGTCCTCAACCTGCGGCCTACAGACATCACAAAGGACAGTGTCACCCTGCACTGGGACCTCCCTCTGATAGATGGAGGCTCACGTATAACAAACTACATTGTAGAGAAACGTGAAGCAACACGGAAATCTTATTCCACAGCCACCACTAAGTGCCATAAATGCACATATAAAGTTACCGGCTTGTCTGAAGGGTGTGAATATTTCTTCAGAGTGATGGCAGAGAATGAATATGGAATTGGTGAGCCAACAGAAACTACAGAGCCCGTAAAAGCCTCTGAAGCACCATCTCCACCAGACAGCCTTAACATCATGGACATAACTAAGAGCACCGTCAGCCTGGCATGGCCTAAGCCCAAACACGATGGTGGCAGCAAGATCACTGGCTATGTGATTGAAGCCCAAAGAAAAGGCTCTGACCAGTGGACCCACATCACAACCGTGAAAGGGTTAGAATGTGTTGTGAGGAATCTAACTGAAGGAGAGGAATATACCTTCCAAGTGATGGCAGTGAACAGCGCGGGGAGAAGTGCCCCTAGAGAAAGCAGACCCGTCATTGTCAAGGAGCAGACAATGCTTCCAGAGCTGGATCTCCGTGGCATCTATCAGAAACTGGTCATTGCCAAAGCTGGTGACAACATCAAAGTTGAAATTCCAGTGCTCGGTCGACCGAAGCCCACAGTGACATGGAAAAAAGGAGACCAAATTCTTAAACAGACACAGAGAGTTAATTTTGAAACCACAGCGACTTCAACCATTTTAAATATCAATGAGTGTGTCAGAAGTGATAGTGGGCCCTATCCATTAACAGCAAGGAACATTGTAGGAGAGGTTGGTGATGTCATCACCATTCAAGTCCATGATATCCCAGGGCCACCTACTGGACCAATCAAATTTGATGAAGTTTCATCTGATTTTGTAACCTTCTCTTGGGACCCACCTGAGAACGATGGTGGTGTACCAATAAGCAACTATGTAGTGGAAATGCGGCAGACTGACAGTACTACCTGGGTTGAGTTAGCAACCACCGTTATACGTACTACCTATAAAGCCACCCGCCTTACTACTGGATTAGAGTATCAGTTCCGTGTAAAAGCTCAGAATAGATATGGAGTTGGACCAGGCATCACATCAGCATGCATAGTTGCCAACTATCCATTTAAGGTTCCTGGACCTCCTGGTACCCCTCAGGTAACTGCAGTTACCAAGGATTCAATGACAATTAGCTGGCATGAGCCACTTTCTGATGGTGGAAGCCCCATTTTAGGATATCATGTTGAAAGAAAAGAACGAAATGGTATTCTCTGGCAGACTGTGAGCAAAGCTTTAGTACCAGGCAACATTTTCAAATCAAGTGGACTTACAGATGGTATTGCTTATGAGTTCCGGGTGATTGCAGAAAACATGGCAGGCAAAAGTAAGCCAAGCAAGCCATCAGAACCTATGTTGGCTCTGGATCCCATTGACCCACCTGGAAAACCAGTACCTCTAAATATTACAAGACACACAGTAACACTTAAATGGGCTAAGCCTGAATATACTGGGGGCTTTAAAATTACCAGTTATATCGTTGAAAAGAGAGACCTTCCTAATGGACGGTGGCTGAAGGCCAACTTCAGCAACATTTTGGAGAATGAATTTACAGTCAGTGGCCTAACAGAAGATGCTGCATATGAATTCCGTGTGATCGCCAAAAATGCTGCAGGTGCCATCAGTCCACCATCTGAGCCATCTGATGCTATCACTTGCAGGGATGATGTTGAGGCACCAAAGATAAAGGTGGATGTTAAATTTAAGGACACGGTTATATTAAAAGCAGGTGAAGCATTCAGACTGGAAGCTGATGTTTCAGGCCGCCCACCTCCAACAATGGAATGGAGCAAAGATGGAAAAGAGCTGGAAGGCACAGCAAAGTTAGAAATAAAAATTGCAGATTTCTCTACTAATCTGGTAAACAAAGATTCAACAAGAAGGGATAGTGGTGCCTATACCCTTACAGCGACTAATCCTGGTGGCTTTGCTAAACACATTTTCAATGTCAAAGTTCTTGACAGACCAGGCCCACCTGAAGGACCTTTGGCTGTAACTGAAGTGACATCAGAAAAGTGTGTACTATCATGGTTCCCTCCACTGGATGATGGAGGTGCCAAAATTGATCATTACATAGTACAGAAACGTGAAACCAGCAGATTGGCATGGACAAATGTAGCCTCAGAAGTCCAAGTAACAAAGCTAAAGGTCACTAAACTCTTGAAAGGCAATGAATACATATTCCGTGTCATGGCTGTAAATAAATATGGAGTGGGAGAGCCACTGGAATCAGAGCCTGTGCTTGCAGTGAATCCTTATGGACCCCCTGATCCGCCCAAAAACCCTGAAGTGACAACTATTACTAAAGATTCGATGGTTGTCTGCTGGGGACATCCTGATTCTGATGGTGGAAGTGAAATCATCAATTATATTGTGGAACGGCGTGATAAAGCTGGCCAACGCTGGATTAAATGCAACAAAAAAACTCTTACTGATTTAAGATATAAAGTGTCTGGACTGACAGAAGGACATGAATATGAGTTCAGGATTATGGCTGAAAATGCTGCTGGAATTAGTGCACCAAGTCCTACCAGTCCATTTTACAAGGCTTGTGACACTGTGTTTAAACCTGGACCACCAGGTAACCCACGTGTTCTGGATACAAGCAGATCATCCATTTCAATCGCTTGGAATAAACCTATCTATGATGGTGGTTCAGAAATCACTGGGTATATGGTTGAGATTGCCCTGCCAGAGGAAGATGAATGGCAGATTGTCACTCCACCAGCAGGACTCAAGGCAACTTCGTATACTATCACTGGCCTCACAGAGAATCAGGAATATAAGATCCGCATCTATGCCATGAATTCCGAAGGACTTGGGGAACCTGCCCTTGTTCCTGGAACTCCAAAGGCTGAAGACAGAATGCTGCCTCCAGAAATTGAACTGGATGCTGACCTGCGCAAAGTTGTTACTATAAGGGCCTGCTGCACCCTGAGACTTTTTGTTCCCATCAAAGGAAGGCCTGCACCTGAGGTGAAGTGGGCCCGGGACCATGGAGAATCTTTAGATAAAGCTAGCATCGAATCCACAAGCTCTTACACCCTGCTTATTGTTGGAAATGTAAACAGATTTGACAGTGGCAAATATATACTAACTGTAGAAAATAGTTCAGGCAGCAAGTCTGCATTTGTCAATGTTAGAGTTCTCGATACACCAGGCCCCCCACAGGATCTGAAGGTAAAAGAGGTCACTAAGACATCTGTCACACTCACATGGGACCCACCTCTCCTTGATGGAGGTTCAAAAATCAAGAACTATATTGTTGAAAAGCGGGAATCAACAAGAAAAGCATATTCAACTGTTGCAACAAACTGCCACAAGACTTCCTGGAAGGTAGACCAGCTTCAAGAAGGCTGTAGCTACTATTTCAGGGTTCTCGCAGAAAATGAATATGGCATTGGGCTGCCTGCTGAAACCGCAGAATCTGTGAAAGCATCAGAACGACCTCTTCCTCCAGGAAAAATAACTTTGATGGATGTCACAAGAAATAGTGTGTCACTCTCTTGGGAGAAACCAGAGCATGATGGAGGCAGCCGAATTCTAGGCTACATTGTGGAGATGCAGACCAAAGGCAGTGACAAATGGGCCACGTGTGCCACAGTCAAGGTCACTGAAGCCACTATCACTGGATTAATTCAGGGTGAAGAATACTCTTTCCGTGTTTCAGCTCAGAATGAAAAGGGCATCAGTGATCCTAGACAACTGAGTGTGCCAGTGATCGCCAAAGATCTTGTCATTCCACCAGCCTTCAAACTCCTGTTCAATACTTTCACTGTACTGGCAGGTGAAGACCTAAAAGTTGATGTTCCATTCATTGGCCGCCCTACCCCAGCTGTAACCTGGCATAAAGATAATGTACCACTGAAGCAGACAACTAGAGTAAATGCAGAGAGCACAGAAAATAATTCACTACTGACAATAAAGGACGCCTGCCGAGAAGATGTTGGCCATTATGTGGTTAAACTGACTAACTCAGCTGGTGAAGCTATTGAAACCCTTAATGTTATCGTTCTTGACAAACCAGGGCCTCCAACTGGACCAGTTAAAATGGATGAAGTGACAGCTGATAGTATTACTCTTTCCTGGGGCCCACCCAAGTATGATGGTGGAAGTTCTATCAATAATTACATTGTTGAGAAACGGGACACTTCCACAACCACCTGGCAAATTGTATCAGCTACAGTTGCAAGGACAACAATAAAGGCTTGCAGACTGAAGACTGGATGTGAATATCAGTTTAGAATTGCAGCTGAAAACAGATATGGGAAGAGTACCTACCTCAATTCAGAGCCTACTGTAGCCCAATATCCATTCAAAGTTCCTGGTCCTCCTGGCACTCCAGTTGTCACACTGTCCTCCAGGGACAGCATGGAAGTACAATGGAATGAGCCAATCAGTGATGGAGGAAGTAGAGTCATTGGCTATCATCTAGAACGCAAGGAAAGAAATAGCATCCTCTGGGTTAAGTTGAATAAAACACCTATTCCTCAAACCAAGTTTAAGACAACTGGCCTTGAAGAAGGTGTTGAATATGAATTTAGAGTCTCTGCAGAGAACATCGTGGGCATTGGCAAGCCGAGTAAAGTATCAGAATGTTATGTGGCTCGTGACCCATGTGATCCACCAGGACGGCCAGAGGCAATCATTGTCACAAGGAATTCTGTGACTCTTCAGTGGAAGAAACCCACCTATGACGGTGGAAGCAAGATCACTGGTTATATTGTTGAGAAGAAAGAATTACCTGAGGGCCGTTGGATGAAAGCCAGTTTTACAAATATTATTGACACTCATTTTGAAGTAACTGGCCTAGTTGAAGATCACAGATATGAGTTCCGGGTTATAGCCCGAAATGCCGCAGGAGTGTTTAGTGAGCCTTCAGAAAGCACAGGAGCAATAACAGCTAGAGATGAGGTAGATCCACCACGAATAAGTATGGATCCAAAATACAAAGACACAATCGTGGTTCATGCTGGTGAATCATTCAAGGTTGATGCAGATATTTATGGCAAACCAATACCAACCATTCAGTGGATAAAAGGTGATCAGGAGCTTTCAAACACAGCTCGATTAGAAATAAAGAGCACCGACTTTGCCACCAGTCTCAGTGTAAAAGATGCAGTACGTGTCGACAGTGGAAATTACATACTGAAGGCCAAAAATGTTGCAGGAGAAAGATCAGTTACTGTGAATGTCAAGGTTCTTGACAGACCAGGGCCACCTGAAGGACCTGTTGTTATCTCAGGAGTTACAGCAGAAAAATGCACACTAGCTTGGAAACCCCCACTTCAGGATGGTGGGAGTGACATCATAAATTATATTGTGGAAAGGAGAGAAACCAGCCGCTTAGTTTGGACTGTGGTTGATGCCAATGTGCAGACTCTCAGCTGCAAGGTTACTAAGCTTCTTGAAGGCAATGAATATACTTTCCGTATAATGGCAGTAAACAAATATGGTGTTGGTGAACCTCTTGAATCTGAGCCAGTAGTTGCCAAGAATCCATTTGTAGTACCAGATGCACCAAAAGCTCCAGAAGTCACAACAGTGACCAAGGACTCAATGATTGTTGTATGGGAAAGACCAGCATCTGATGGTGGTAGTGAAATTCTTGGATATGTTCTTGAGAAACGGGATAAAGAAGGCATTAGATGGACAAGATGCCATAAGCGTCTGATTGGAGAGTTGCGCCTGAGAGTAACTGGACTCATAGAAAATCACGATTATGAGTTCAGAGTTTCTGCTGAGAATGCTGCTGGACTTAGTGAACCAAGCCCTCCTTCTGCTTACCAAAAGGCTTGTGATCCTATTTATAAACCAGGACCCCCAAACAACCCCAAAGTCATAGACATAACCAGATCTTCAGTATTCCTTTCTTGGAGCAAACCAATATATGATGGTGGCTGTGAAATTCAAGGATACATTGTTGAAAAATGTGATGTGAGTGTTGGTGAATGGACAATGTGCACTCCACCAACAGGAATTAATAAAACAAACATAGAAGTAGAGAAGCTGTTGGAAAAGCATGAATACAACTTCCGTATCTGTGCTATTAATAAAGCTGGAGTTGGAGAACATGCTGACGTCCCTGGACCTATTATAGTTGAAGAAAAATTAGAAGCACCAGACATTGATCTTGACCTAGAACTAAGGAAAATCATAAATATAAGGGCAGGTGGCTCCTTAAGGTTATTTGTTCCTATAAAAGGTCGTCCTACACCAGAAGTTAAATGGGGAAAGGTGGATGGTGAAATCCGAGATGCAGCTATAATTGATGTCACTAGCAGTTTCACCTCTCTTGTTCTTGACAATGTCAACCGATATGATAGTGGAAAATATACGCTTACATTAGAAAACAGCAGTGGAACAAAGTCTGCCTTTGTTACTGTGAGAGTTCTGGACACGCCAAGTCCACCTGTTAACCTGAAAGTCACAGAAATCACCAAAGACTCAGTATCAATTACATGGGAACCTCCTTTGTTGGATGGGGGATCCAAAATAAAAAATTACATTGTTGAGAAACGTGAAGCCACAAGAAAATCATATGCTGCTGTTGTAACTAACTGCCATAAGAATTCTTGGAAAATCGATCAGCTCCAAGAAGGTTGCAGTTATTACTTTAGAGTCACAGCTGAGAATGAGTATGGTATTGGCCTTCCTGCCCAGACTGCTGATCCAATTAAGGTTGCAGAAGTGCCACAACCTCCTGGAAAAATAACTGTGGATGATGTCACCAGAAACAGTGTCTCTCTGAGTTGGACAAAACCTGAACATGATGGTGGCAGTAAAATCATTCAGTATATTGTGGAAATGCAAGCTAAACACAGTGAGAAATGGTCAGAGTGTGCTCGAGTAAAGTCTCTTCAGGCAGTAATTACCAACCTAACTCAAGGGGAAGAATATCTTTTTAGAGTTGTTGCTGTAAATGAAAAGGGGAGAAGTGATCCTCGGTCCCTTGCAGTTCCAATAGTTGCCAAAGATCTGGTAATTGAGCCAGATGTAAAACCTGCATTCAGTAGTTACAGTGTACAGGTTGGCCAAGATTTGAAAATAGAAGTGCCAATTTCTGGACGTCCTAAGCCAACCATTACCTGGACTAAAGATGGTCTCCCACTGAAGCAGACCACAAGAATCAATGTTACCGATTCACTGGATCTCACCACACTCAGTATTAAAGAAACTCATAAGGATGATGGTGGACAATATGGAATCACAGTTGCCAATGTTGTTGGTCAGAAGACAGCATCCATCGAAATTGTAACTCTAGATAAACCTGATCCTCCAAAAGGACCTGTTAAATTTGATGACGTCAGTGCTGAAAGTATTACATTATCTTGGAACCCTCCATTATATACAGGGGGCTGCCAAATCACCAACTACATTGTTCAGAAAAGAGATACAACCACCACAGTATGGGATGTTGTTTCTGCTACTGTTGCTAGAACTACACTCAAAGTGACCAAACTGAAAACTGGTACAGAATACCAATTTAGAATATTTGCCGAAAACAGATATGGACAAAGCTTTGCCTTAGAGTCTGATCCAATTGTAGCTCAATATCCCTACAAAGAACCAGGCCCTCCAGGTACACCATTTGCCACAGCCATTTCCAAAGACTCCATGGTCATACAGTGGCATGAACCAGTCAACAATGGTGGAAGCCCCGTCATAGGTTACCACCTGGAGAGAAAAGAAAGAAACAGTATTTTGTGGACAAAGGTCAACAAAACTATTATTCATGACACCCAATTCAAAGCACAGAATCTTGAAGAAGGCATTGAATATGAATTCAGAGTGTATGCTGAAAATATTGTTGGTGTAGGCAAAGCAAGCAAGAATTCTGAATGCTATGTAGCCAGAGATCCCTGTGACCCACCAGGAACCCCAGAACCAATAATGGTTAAAAGAAATGAAATCACTTTACAGTGGACCAAACCTGTGTATGATGGTGGAAGTATGATTACAGGCTACATTGTAGAGAAACGTGATTTGCCTGATGGTCGTTGGATGAAAGCTAGCTTTACAAATGTCATTGAAACTCAATTTACTGTGTCAGGTCTTACTGAAGATCAAAGATATGAATTCAGAGTCATTGCAAAGAATGCAGCTGGTGCAATAAGTAAACCCTCTGACAGTACTGGACCAATAACTGCCAAGGATGAGGTTGAACTCCCAAGAATTTCAATGGATCCAAAATTCAGAGACACAATTGTGGTAAATGCTGGAGAAACATTCAGACTTGAGGCTGATGTCCATGGAAAGCCCCTACCTACCATTGAGTGGTTAAGAGGAGATAAGGAAATTGAAGAATCTGCTAGATGTGAAATAAAGAACACAGATTTCAAGGCTTTACTTATTGTAAAAGATGCAATTAGAATTGATGGTGGGCAGTATATTTTAAGAGCTTCCAATGTTGCAGGTTCTAAGTCATTCCCAGTAAATGTAAAAGTATTAGATAGACCAGGACCTCCAGAAGGGCCAGTCCAGGTTACTGGAGTCACTTCTGAAAAATGCTCTTTAACATGGTCTCCACCACTTCAAGATGGTGGCAGTGACATTTCTCACTATGTTGTTGAAAAGCGAGAAACCAGTCGACTTGCCTGGACTGTTGTTGCTTCAGAAGTTGTGACCAATTCTCTGAAAGTTACCAAACTCTTAGAAGGTAATGAATATGTTTTCCGTATAATGGCTGTCAACAAATATGGTGTTGGAGAGCCTTTGGAATCTGCACCAGTACTAATGAAAAATCCATTTGTGCTTCCTGGACCACCAAAAAGCTTGGAAGTCACAAATATTGCCAAAGACTCCATGACCGTCTGTTGGAACCGTCCAGATAGTGATGGTGGAAGTGAGATTATTGGTTACATTGTAGAGAAAAGAGACAGAAGTGGCATTCGATGGATAAAATGTAATAAACGCCGCATTACAGATTTGCGTCTAAGAGTGACAGGATTAACAGAAGATCATGAGTATGAATTCAGGGTCTCTGCAGAAAATGCTGCTGGAGTTGGGGAACCAAGTCCAGCTACAGTTTATTATAAAGCCTGTGATCCTGTGTTCAAACCTGGCCCACCTACCAATGCACACATTGTAGACACCACTAAAAATTCAATCACACTTGCCTGGGGTAAACCCATCTATGATGGCGGCAGTGAGATCTTGGGATATGTAGTAGAAATCTGTAAAGCAGATGAAGAAGAATGGCAAATAGTTACTCCACAGACTGGCCTGAGAGTCACTCGATTTGAAATTTCAAAACTCACTGAACACCAAGAGTATAAAATACGAGTCTGTGCCCTCAACAAAGTTGGTTTAGGTGAGGCTACATCAGTTCCTGGTACTGTGAAACCAGAAGATAAACTTGAAGCACCTGAACTTGACCTTGACTCCGAATTAAGAAAAGGAATTGTTGTAAGAGCTGGTGGATCTGCCAGAATTCACATTCCATTCAAAGGTCGTCCAACGCCTGAGATCACTTGGTCTCGAGAGGAAGGTGAATTCACAGATAAGGTCCAAATTGAAAAGGGAGTAAACTATACCCAACTATCAATAGATAACTGTGATAGAAATGATGCTGGAAAATACATTCTTAAGTTGGAAAACAGCAGTGGATCAAAGTCTGCTTTTGTAACTGTGAAAGTTCTTGACACTCCAGGACCACCACAGAATTTGGCAGTCAAAGAAGTGAGAAAAGATTCTGCCTTCCTGGTATGGGAGCCACCCATCATTGATGGAGGGGCAAAGGTCAAGAACTATGTGATTGACAAACGTGAGTCAACCAGAAAAGCGTATGCTAATGTGAGTAGTAAATGCAGCAAAACAAGTTTTAAAGTGGAAAACCTTACAGAAGGAGCCATTTATTACTTCAGAGTCATGGCTGAAAATGAATTTGGAGTTGGTGTTCCAGTGGAAACTGTTGATGCCGTGAAAGCTGCTGAACCTCCTTCCCCACCAGGAAAGGTTACACTCACTGATGTGTCCCAGACCAGTGCATCACTTATGTGGGAGAAACCTGAACATGATGGCGGTAGCAGAGTCCTGGGGTACGTTGTTGAAATGCAGCCCAAAGGAACTGAAAAATGGAGCATTGTGGCTGAATCCAAAGTCTGTAATGCAGTTGTTACTGGTTTGAGTTCTGGACAAGAATATCAGTTCCGTGTCAAGGCTTATAATGAGAAAGGAAAAAGCGATCCAAGAGTGTTGGGTGTTCCTGTCATAGCCAAGGACTTGACTATACAGCCTAGTTTAAAGTTACCATTTAACACATATAGTATCCAAGCTGGAGAAGATCTTAAAATAGAAATTCCAGTTATAGGCCGACCAAGACCTAACATTTCTTGGGTCAAAGATGGTGAGCCTCTTAAACAGACAACAAGAGTAAACGTTGAAGAAACAGCTACCTCAACTGTTTTGCACATTAAAGAAGGTAACAAAGATGACTTTGGAAAATACACCGTAACGGCAACAAATAGTGCAGGCACAGCAACAGAAAATCTCAGTGTTATCGTTTTAGAAAAGCCTGGACCTCCAGTTGGCCCAGTTCGGTTTGATGAAGTTAGTGCAGACTTTGTAGTCATATCTTGGGAACCTCCAGCCTATACTGGTGGCTGCCAAATAAGCAACTACATTGTAGAGAAGCGAGATACAACCACCACCACTTGGCACATGGTATCAGCAACAGTTGCAAGAACAACAATTAAAATAACCAAACTGAAAACAGGCACGGAGTACCAGTTTAGAATTTTTGCTGAAAACAGGTATGGAAAAAGTGCCCCACTGGATTCTAAGGCAGTTATTGTACAATATCCATTTAAAGAACCTGGACCACCTGGAACTCCTTTTGTGACATCAATCTCAAAAGATCAGATGCTTGTGCAATGGCATGAGCCAGTGAATGATGGAGGCACCAAAATTATTGGCTACCATCTTGAACAGAAAGAAAAGAACAGTATTTTATGGGTCAAGTTAAATAAGACCCCCATTCAGGACACCAAATTCAAAACAACTGGGCTTGATGAGGGCCTTGAGTATGAGTTCAAAGTTTCTGCTGAAAATATTGTTGGCATTGGCAAGCCTAGCAAAGTGTCAGAATGCTTTGTTGCTCGTGATCCATGTGACCCACCTGGTCGCCCTGAAGCCATTGTTATTACAAGAAACAATGTCACACTGAAATGGAAGAAACCTGCCTATGATGGTGGTAGCAAAATAACAGGTTATATTGTAGAAAAGAAAGATCTACCTGATGGCCGCTGGATGAAAGCCAGCTTTACCAACGTATTAGAAACTGAATTTACAGTGAGTGGACTTGTAGAAGACCAAAGATATGAATTTAGAGTAATTGCAAGAAATGCAGCTGGAAACTTTAGTGAACCATCTGATAGTAGTGGTGCCATTACTGCAAGAGATGAAATTGATGCACCAAATGCCTCTCTGGATCCAAAATATAAAGATGTCATCGTTGTTCATGCAGGAGAGACTTTTGTTCTTGAAGCCGACATCCGTGGCAAACCTATACCTGATGTTGTTTGGTCAAAAGATGGAAAAGAACTTGAAGAAACAGCTGCTAGAATGGAAATTAAATCTACTATTCAGAAAACAACTCTTGTTGTCAAAGACTGTATACGGACTGATGGAGGACAATATATTCTGAAACTCAGCAATGTTGGTGGTACAAAGTCTATACCCATCACTGTAAAGGTACTTGACAGGCCAGGGCCTCCTGAAGGGCCTCTGAAAGTTACTGGAGTTACTGCGGAAAAATGTTACCTGGCATGGAACCCACCTTTGCAAGATGGTGGTGCTAATATTTCACATTACATCATTGAAAAGAGGGAGACAAGCCGACTCTCTTGGACCCAGGTTTCAACTGAGGTACAGGCCCTTAACTACAAAGTTACTAAACTTCTTCCTGGTAATGAGTACATTTTCCGTGTCATGGCTGTGAATAAATATGGAATTGGAGAGCCCTTGGAATCTGGGCCTGTTACGGCCTGTAATCCTTATAAGCCACCAGGTCCTCCCTCAACACCTGAAGTCTCAGCAATCACCAAAGATTCTATGGTAGTAACATGGGCACGCCCAGTAGACGACGGAGGTACCGAAATTGAGGGCTACATTCTTGAAAAACGAGATAAGGAAGGCGTTAGATGGACCAAGTGCAACAAGAAAACATTAACGGATCTGCGGCTCAGGGTAACTGGTCTTACCGAAGGCCATTCCTATGAATTCAGAGTTGCTGCTGAAAATGCAGCTGGTGTGGGAGAACCTAGTGAGCCATCTGTTTTCTACCGTGCGTGTGATGCCTTGTATCCACCAGGTCCCCCAAGCAATCCAAAAGTGACGGACACTTCCAGATCTTCTGTCTCCCTGGCATGGAGTAAGCCAATTTATGATGGTGGCGCACCTGTTAAAGGCTATGTTGTAGAGGTCAAAGAAGCTGCTGCGGATGAATGGACAACCTGCACTCCACCAACAGGATTACAAGGAAAGCAGTTCACAGTGACCAAGCTTAAAGAAAACACTGAATATAACTTCCGTATTTGTGCCATCAATTCTGAAGGTGTAGGTGAACCTGCAACTCTACCTGGCTCAGTGGTTGCTCAGGAGAGGATAGAGCCACCAGAAATAGAACTCGATGCTGATCTCAGAAAGGTGGTCGTTCTGCGTGCAAGTGCTACTTTACGCTTATTTGTCACTATCAAAGGTCGACCAGAACCCGAAGTTAAATGGGAAAAGGCAGAAGGCATTCTCACTGACAGGGCTCAGATAGAGGTGACCAGCTCATTTACAATGTTGGTGATTGATAATGTTACCAGATTTGACAGTGGTCGGTATAATCTGACATTAGAAAATAATAGTGGCTCCAAAACAGCTTTTGTTAACGTCAGAGTTCTTGACTCACCAAGTGCCCCTGTGAATTTGACCATAAGAGAAGTGAAGAAAGACTCAGTGACGTTGTCCTGGGAACCACCACTTATTGATGGTGGAGCTAAGATTACAAACTACATTGTCGAAAAACGAGAAACTACAAGAAAAGCCTATGCTACCATTACAAATAATTGCACTAAAACTACTTTCAGAATTGAAAATCTACAAGAAGGATGTTCTTACTACTTCCGAGTCTTGGCTTCCAATGAATATGGGATTGGTTTGCCAGCTGAAACAACAGAACCCGTTAAAGTGTCTGAACCACCCCTCCCACCTGGAAGAGTAACTCTTGTTGATGTGACCCGTAATACAGCTACAATTAAGTGGGAGAAACCAGAAAGTGATGGTGGCAGCAAAATTACTGGTTATGTGGTTGAAATGCAGACTAAAGGGAGTGAAAAGTGGAGCACCTGCACACAAGTTAAGACTCTAGAAGCAACTATATCTGGCTTAACTGCAGGAGAAGAGTATGTCTTCAGGGTAGCTGCAGTTAACGAAAAGGGAAGAAGTGATCCAAGACAACTTGGAGTGCCAGTAATTGCAAGGGATATTGAAATAAAGCCTTCAGTTGAGCTTCCTTTCCATACTTTCAATGTAAAGGCTAGAGAACAACTTAAGATTGATGTGCCATTCAAAGGAAGACCTCAAGCTACTGTGAACTGGAGAAAAGATGGTCAGACTCTTAAAGAGACAACTAGAGTCAATGTTTCTTCTTCAAAGACTGTAACATCACTATCTATTAAGGAAGCTTCAAAGGAAGATGTTGGAACTTATGAATTATGTGTTTCAAACAGTGCTGGATCCATAACAGTTCCTATTACTATAATTGTCCTTGACAGACCAGGACCTCCAGGTCCTATACGTATTGATGAGGTTAGTTGTGACAGCATAACCATTTCTTGGAATCCTCCAGAATATGATGGTGGCTGCCAAATTAGCAATTACATTGTTGAAAAGAAAGAAACCACCTCTACAACATGGCACATAGTTTCACAAGCAGTTGCAAGAACATCCATTAAAATAGTTCGCCTGACAACAGGAAGTGAGTATCAGTTCCGTGTTTGTGCAGAAAACCGCTATGGAAAGAGCTCCTACAGTGAATCTTCAGCTGTTGTTGCAGAGTATCCATTCAGTCCCCCAGGTCCTCCTGGTACTCCTAAAGTTGTGCATGCCACAAAATCTACCATGCTTGTAACCTGGCAAGTGCCAGTTAATGATGGAGGAAGTCGAGTAATTGGCTATCATCTTGAGTATAAAGAAAGAAGCAGCATTCTTTGGTCAAAAGCAAATAAAATCCTCATTGCTGATACTCAAATGAAAGTCTCCGGCCTTGATGAAGGACTGATGTATGAGTATCGTGTATATGCTGAAAATATTGCTGGAATTGGTAAATGCAGTAAATCTTGTGAACCAGTCCCTGCAAGAGATCCTTGTGACCCTCCTGGACAACCTGAAGTCACAAATATCACAAGAAAATCAGTGTCACTTAAATGGTCTAAACCACATTATGATGGTGGAGCTAAGATCACAGGATACATTGTTGAACGCAGAGAACTACCAGATGGCCGGTGGCTGAAGTGCAATTATACTAATATACAAGAAACATACTTTGAAGTAACTGAACTTACTGAAGATCAGCGTTATGAATTCCGGGTTTTTGCAAGGAATGCTGCTGACTCAGTTAGTGAGCCATCTGAATCCACTGGGCCTATTATAGTTAAAGATGATGTTGAGCCTCCAAGAGTTATGATGGATGTCAAGTTCCGAGACGTTATTGTTGTCAAAGCTGGAGAGGTCCTTAAGATAAATGCAGACATTGCAGGGCGACCTCTGCCAGTAATTTCCTGGGCCAAGGATGGTATAGAAATTGAAGAAAGAGCAAGAACAGAAATCATCTCAACAGACAATCATACTTTGTTAACAGTTAAAGACTGTATAAGACGAGACACTGGGCAATATGTACTAACACTGAAGAATGTTGCCGGCACTCGGTCTGTGGCCGTTAATTGCAAAGTACTTGATAAGCCTGGTCCACCAGCAGGACCACTTGAAATAAATGGCCTCACTGCTGAGAAATGCTCTCTTTCCTGGGGACGTCCCCAAGAAGATGGTGGTGCAGATATCGACTATTACATCGTAGAAAAACGTGAAACAAGCCACCTTGCATGGACAATATGTGAAGGAGAGTTACAGATGACATCCTGTAAAGTAACCAAGTTACTCAAAGGCAATGAATATATATTTAGAGTAACTGGTGTTAATAAATATGGTGTTGGTGAGCCCCTAGAGAGTGTAGCTATAAAGGCACTAGATCCATTTACAGTTCCAAGTCCACCCACGTCTTTGGAAATTACTTCTGTGACCAAAGAATCTATGACACTTTGCTGGTCAAGACCCGAGAGTGATGGAGGTAGTGAAATATCTGGATATATAATTGAAAGGCGAGAGAAAAATAGCCTAAGATGGGTGCGTGTAAACAAAAAACCAGTTTATGATCTAAGAGTGAAATCAACAGGACTTCGGGAAGGATGTGAATATGAATATCGTGTTTATGCAGAAAATGCTGCTGGCCTAAGTCTTCCAAGTGAAACCTCTCCCTTAATTAGGGCAGAAGATCCAGTGTTCCTACCATCTCCTCCATCCAAACCCAAAATTGTGGACTCAGGCAAGACAACTATAACTATTGCCTGGGTTAAGCCGCTGTTTGATGGTGGGGCCCCGATAACTGGATATACTGTAGAATACAAAAAATCTGATGACACTGACTGGAAAACTTCCATTCAGAGCTTACGAGGGACAGAATATACAATAAGCGGACTAACAACAGGAGCTGAATATGTTTTCAGAGTAAAATCTGTCAATAAGGTTGGTGCTAGTGACCCCAGTGATAGCTCTGACCCTCAGATAGCAAAGGAAAGAGAAGAAGAACCTTTATTTGATATTGACAGTGAAATGAGGAAGACCTTGATTGTCAAGGCTGGTGCCTCATTTACCATGACTGTGCCTTTCCGAGGAAGACCAGTACCCAATGTCTTGTGGAGTAAGCCAGACACTGACCTCCGTACTAGAGCTTATGTTGATACCACAGACTCTCGTACATCACTGACCATTGAAAATGCCAACAGAAATGACTCTGGAAAGTACACATTAACAATTCAGAATGTTTTGAGTGCTGCTTCACTGACCTTAGTTGTCAAAGTTTTAGATACCCCAGGTCCTCCAACCAACATTACTGTGCAAGATGTAACCAAAGAGTCTGCAGTGTTATCCTGGGATGTTCCTGAAAACGATGGTGGAGCACCAGTGAAGAATTACCACATAGAAAAACGTGAGGCCAGCAAGAAAGCATGGGTCTCTGTGACCAACAACTGTAACCGCCTCTCCTACAAAGTTACCAATTTACAAGAAGGAGCTATCTATTACTTCAGAGTCTCTGGAGAAAATGAGTTTGGTGTTGGTATACCAGCTGAAACAAAGGAAGGAGTAAAAATAACAG
>TTN-214,ENSE00003802597,1,297,2890911,2891207,AAAAACCAAGCCCACCTGAAAAACTTGGAGTAACAAGTATATCCAAAGACAGTGTTTCCCTGACCTGGCTGAAGCCTGAACATGATGGCGGAAGCAGAATTGTACACTATGTCGTTGAAGCACTAGAAAAAGGACAGAAAAACTGGGTTAAATGTGCAGTGGCAAAGTCAACCCATCACGTTGTTTCCGGTCTGAGAGAGAATTCTGAATACTTTTTCCGAGTGTTTGCTGAAAATCAAGCTGGCCTGAGTGACCCGAGAGAGCTTCTGCTTCCTGTTCTTATTAAGGAGCAACTAG
>TTN-214,ENSE00003802941,1,588,2891208,2891795,AACCACCTGAAATTGATATGAAGAATTTCCCAAGTCACACTGTATATGTTAGAGCTGGTTCAAACCTTAAAGTTGACATTCCAATCTCTGGAAAACCACTTCCCAAAGTGACCTTATCAAGAGATGGTGTCCCCCTTAAGGCAACCATGAGATTTAATACCGAAATTACTGCTGAGAACCTGACCATCAATCTCAAAGAAAGTGTTACAGCTGACGCTGGGAGATATGAAATCACTGCTGCCAACTCCAGTGGTACAACCAAAGCTTTCATTAACATTGTTGTGCTAGACAGGCCTGGTCCTCCAACTGGCCCTGTTGTTATTAGTGATATAACTGAAGAAAGTGTGACTCTCAAATGGGAGCCACCTAAGTATGACGGTGGAAGTCAAGTTACCAACTACATTCTACTCAAAAGAGAAACAAGTACTGCAGTGTGGACTGAAGTGTCTGCAACAGTTGCAAGAACCATGATGAAAGTCATGAAACTGACCACAGGAGAAGAATACCAATTCCGCATCAAGGCAGAAAACCGCTTTGGCATCAGTGATCATATAGATTCAGCTTGTGTGACTGTCAAACTACCATACA
>TTN-214,ENSE00003808789,1,303,2891796,2892098,CAACACCTGGACCACCATCTACACCATGGGTCACTAATGTTACTCGAGAAAGCATCACTGTGGGCTGGCATGAACCAGTGTCAAATGGAGGCAGTGCAGTCGTAGGCTATCACCTGGAAATGAAAGACAGAAACAGTATTTTATGGCAAAAAGCCAACAAACTGGTCATCCGCACAACTCACTTCAAAGTCACAACAATCAGTGCTGGACTTATTTATGAATTCAGGGTGTATGCAGAAAATGCTGCTGGAGTTGGAAAACCTAGCCATCCTTCTGAACCAGTCTTGGCAATTGATGCTTGTG
>TTN-214,ENSE00003806587,1,297,2892099,2892395,AACCCCCAAGAAATGTTCGTATCACTGATATTTCAAAGAACTCTGTCAGCCTTTCATGGCAACAACCAGCTTTCGATGGAGGTAGCAAGATTACAGGCTACATTGTTGAGAGACGTGACCTTCCAGATGGCAGATGGACCAAGGCCAGCTTCACCAATGTTACTGAAACTCAATTCATCATCTCTGGCTTGACTCAGAATTCCCAGTATGAATTCCGTGTCTTTGCTAGGAATGCTGTTGGTTCCATTAGCAATCCATCTGAGGTTGTAGGGCCCATTACTTGCATCGATTCTTATG
>TTN-214,ENSE00003807681,1,288,2892396,2892683,GTGGTCCTGTAATTGATTTGCCTCTAGAATATACAGAAGTTGTCAAATACAGAGCAGGTACATCTGTGAAGCTCAGAGCTGGCATTTCTGGCAAACCTGCGCCTACTATTGAGTGGTATAAAGATGATAAAGAATTACAAACCAATGCACTGGTGTGTGTTGAAAATACCACGGACCTCGCATCTATACTCATCAAAGATGCCGATCGCCTTAATAGTGGATGCTATGAATTAAAACTAAGGAATGCCATGGGCTCAGCCTCAGCCACCATCAGAGTACAGATCCTTG
>TTN-214,ENSE00003811102,1,300,2892684,2892983,ACAAACCAGGCCCACCTGGTGGACCAATTGAATTTAAGACTGTAACTGCTGAGAAGATCACCCTTCTCTGGCGGCCTCCAGCTGATGATGGTGGTGCAAAAATCACTCACTACATTGTGGAAAAGCGTGAGACAAGCCGCGTTGTGTGGTCTATGGTGTCTGAACATTTGGAAGAGTGCATCATTACAACCACCAAAATTATCAAAGGAAATGAATACATCTTCCGGGTCCGAGCCGTGAACAAATATGGAATTGGCGAGCCACTGGAATCTGATTCCGTTGTAGCCAAGAACGCATTTG
>TTN-214,ENSE00003802386,1,303,2892984,2893286,TTACACCTGGGCCACCAGGCATACCAGAAGTGACAAAGATTACCAAGAATTCGATGACTGTTGTATGGAGCAGGCCAATTGCAGATGGCGGTAGTGATATAAGTGGCTATTTCCTTGAAAAACGAGACAAGAAGAGCCTAGGATGGTTTAAAGTACTAAAAGAGACTATCCGTGACACCAGACAAAAAGTAACAGGACTCACAGAAAACAGTGACTATCAATACAGAGTTTGTGCTGTAAACGCTGCTGGACAGGGTCCATTTTCTGAACCATCTGAATTCTACAAAGCTGCTGATCCTATTG
>TTN-214,ENSE00003809908,1,306,2893287,2893592,ATCCTCCAGGTCCACCTGCTAAGATAAGAATCGCAGATTCAACCAAGTCATCCATCACCCTTGGCTGGAGTAAGCCTGTCTATGATGGGGGCAGTGCTGTTACTGGGTATGTTGTCGAGATAAGACAAGGAGAGGAAGAGGAATGGACTACTGTCTCTACCAAAGGAGAGGTCAGAACTACAGAATATGTGGTATCCAACCTGAAACCTGGAGTCAATTACTACTTCCGGGTATCTGCTGTAAACTGTGCTGGACAAGGAGAACCTATAGAAATGAATGAACCTGTACAAGCTAAAGATATACTTG
>TTN-214,ENSE00003808993,1,1767,2893593,2895359,AGGCACCAGAGATTGACCTGGATGTGGCTCTCAGAACTTCTGTTATTGCCAAAGCTGGTGAAGATGTACAAGTGTTGATTCCCTTTAAAGGCAGACCTCCACCTACTGTCACATGGAGAAAAGATGAGAAGAATCTTGGCAGTGATGCCAGATACAGCATTGAAAACACTGATTCATCCTCATTACTCACCATTCCTCAAGTTACTCGCAATGATACAGGAAAATATATTCTCACAATAGAAAATGGAGTTGGTGAACCTAAGTCTTCAACTGTGAGTGTTAAAGTGCTTGACACACCAGCTGCCTGCCAGAAACTACAGGTTAAACATGTTTCTCGAGGCACAGTCACTTTGCTCTGGGATCCTCCTCTCATTGATGGAGGATCTCCAATAATTAATTATGTCATTGAAAAGAGAGATGCCACCAAGAGAACATGGTCTGTCGTGTCACACAAATGTTCTAGCACATCCTTCAAGCTAATAGATTTGTCGGAGAAGACTCCATTCTTCTTCAGAGTTCTTGCAGAAAATGAAATTGGAATTGGGGAACCCTGTGAAACTACAGAGCCAGTGAAGGCTGCTGAAGTACCAGCTCCTATACGTGATCTCTCAATGAAAGACTCAACAAAGACATCTGTCATCCTCAGCTGGACCAAACCTGACTTTGATGGTGGTAGCGTCATCACAGAATATGTTGTAGAAAGGAAAGGTAAAGGTGAACAGACGTGGTCCCACGCTGGCATAAGTAAGACATGTGAAATTGAGGTTAGCCAACTTAAGGAGCAGTCAGTCCTGGAGTTCAGAGTGTTTGCCAAAAATGAGAAAGGACTGAGTGATCCTGTCACTATTGGGCCAATTACAGTGAAAGAACTTATTATTACACCTGAAGTTGACCTGTCAGATATCCCTGGGGCACAAGTCACTGTGAGAATTGGGCACAATGTGCACCTTGAATTACCTTATAAGGGAAAACCCAAACCATCCATCAGTTGGCTGAAAGATGGCTTGCCACTGAAAGAAAGTGAATTTGTTCGCTTCAGTAAAACTGAAAACAAAATTACTTTGAGTATTAAGAATGCCAAGAAGGAGCATGGAGGAAAATACACTGTTATTCTTGATAATGCAGTGTGTAGAATTGCAGTCCCCATTACAGTCATCACCCTTGGCCCACCATCAAAGCCCAAAGGACCCATTCGATTTGATGAAATCAAGGCTGATAGTGTCATCCTGTCATGGGATGTACCTGAAGATAATGGAGGAGGAGAAATTACTTGTTACAGCATCGAGAAGCGGGAAACTTCACAAACTAACTGGAAGATGGTGTGTTCAAGTGTTGCCAGAACGACTTTCAAAGTTCCTAATCTAGTCAAAGATGCTGAGTACCAGTTTAGAGTGAGAGCAGAAAACAGATACGGAGTCAGCCAACCACTTGTCTCAAGCATTATTGTGGCAAAACACCAGTTCAGGATTCCTGGTCCCCCAGGAAAGCCAGTTATATACAATGTGACTTCTGATGGCATGTCACTAACTTGGGATGCTCCAGTTTATGATGGTGGTTCAGAAGTTACTGGATTCCATGTTGAAAAGAAAGAAAGAAATAGCATCCTCTGGCAAAAAGTTAATACATCACCAATCTCTGGAAGAGAATATAGAGCCACTGGACTGGTAGAAGGTCTGGATTACCAATTCCGTGTATATGCTGAAAATTCTGCTGGCCTAAGCTCACCTAGTGACCCAAGCAAATTTACCTTAGCTGTTTCTCCAGTAG
>TTN-214,ENSE00003811205,1,294,2895360,2895653,ACCCACCTGGCACTCCTGACTACATTGATGTCACCCGGGAAACCATCACACTTAAATGGAACCCACCATTGCGTGATGGAGGCAGTAAGATTGTGGGCTATAGCATTGAGAAACGGCAAGGAAATGAACGCTGGGTGAGATGCAACTTTACTGACGTCAGTGAATGTCAGTACACAGTTACAGGACTCAGTCCTGGGGATCGCTATGAGTTCAGAATAATTGCAAGAAATGCTGTTGGAACTATAAGCCCGCCCTCACAGTCTTCTGGCATTATTATGACAAGAGATGAAAATG
>TTN-214,ENSE00003808021,1,288,2895654,2895941,TTCCACCAATAGTAGAGTTTGGCCCTGAATACTTTGATGGTCTCATTATTAAGTCCGGAGAGAGCCTTAGAATTAAAGCTTTGGTACAAGGAAGACCAGTGCCTCGAGTAACTTGGTTCAAAGATGGAGTGGAAATCGAAAAGAGGATGAATATGGAAATAACCGACGTACTTGGATCCACCAGCCTATTTGTTAGAGATGCTACTCGGGACCATCGTGGTGTATACACAGTGGAAGCCAAAAATGCATCTGGTTCTGCAAAAGCAGAAATTAAAGTGAAAGTACAAG
>TTN-214,ENSE00003804355,1,300,2895942,2896241,ATACACCAGGAAAAGTAGTTGGGCCAATAAGATTCACCAATATTACTGGGGAGAAGATGACTCTGTGGTGGGATGCCCCACTCAATGACGGTTGTGCTCCCATAACCCACTACATCATTGAAAAACGGGAAACCAGCAGACTTGCCTGGGCACTAATTGAGGATAAATGTGAAGCCCAAAGTTACACTGCCATTAAACTAATAAACGGCAATGAATACCAATTCCGTGTTTCTGCAGTTAACAAGTTTGGTGTTGGCAGGCCACTTGATTCTGATCCAGTGGTTGCTCAAATACAATATA
>TTN-214,ENSE00003807046,1,2067,2896242,2898308,CTGTTCCTGATGCCCCTGGCATTCCAGAACCTAGCAACATAACAGGCAACAGCATTACCCTGACATGGGCAAGGCCAGAATCAGATGGTGGCAGTGAAATTCAACAGTATATCCTTGAAAGAAGAGAAAAGAAAAGCACAAGATGGGTAAAAGTGATCAGCAAACGACCAATCTCTGAAACAAGATTCAAAGTCACTGGTCTGACAGAAGGCAATGAGTATGAATTCCATGTCATGGCTGAAAATGCTGCAGGAGTTGGACCTGCAAGTGGCATCTCAAGACTCATTAAATGTAGAGAGCCCGTCAACCCACCAGGTCCTCCCACAGTGGTCAAAGTAACAGACACATCAAAGACAACTGTGAGCTTAGAATGGTCCAAACCAGTGTTTGATGGTGGCATGGAAATAATTGGGTATATTATTGAAATGTGTAAGGCCGACTTAGGAGACTGGCACAAGGTGAATGCAGAGGCATGTGTGAAAACAAGATATACAGTCACTGATCTACAAGCAGGTGAAGAATACAAATTCCGAGTTAGTGCTATCAATGGTGCTGGAAAAGGCGACAGCTGTGAAGTGACTGGCACAATTAAAGCAGTTGACCGGTTAACAGCTCCTGAGTTAGACATAGATGCAAACTTCAAACAGACTCATGTTGTTAGAGCTGGGGCCAGTATTCGCCTCTTCATTGCCTACCAAGGTAGACCTACTCCTACAGCTGTGTGGAGCAAACCAGACTCTAACCTTAGCCTTCGGGCTGATATCCATACAACAGATTCCTTCAGCACCCTCACTGTGGAAAACTGCAACAGAAATGATGCAGGGAAATATACCCTTACTGTGGAAAACAACAGTGGTAGTAAGTCAATCACATTCACCGTGAAAGTGCTAGACACTCCAGGCCCACCTGGCCCAATTACCTTCAAAGATGTGACCCGGGGATCTGCTACATTGATGTGGGATGCCCCTCTTCTTGACGGTGGTGCCCGAATCCATCATTATGTGGTAGAGAAACGAGAGGCAAGTCGCCGTAGTTGGCAGGTTATCAGTGAAAAATGCACTCGTCAGATCTTCAAGGTCAATGACCTGGCCGAAGGTGTTCCGTACTATTTCCGTGTTTCTGCAGTAAATGAGTATGGTGTTGGTGAGCCCTATGAAATGCCAGAACCAATTGTAGCCACAGAACAGCCTGCTCCACCTAGGAGACTTGATGTTGTTGATACTAGCAAATCCTCCGCAGTCTTAGCTTGGCTTAAACCTGACCACGATGGAGGCAGCCGGATCACTGGCTACCTGCTTGAAATGAGACAAAAGGGATCTGACTTCTGGGTTGAAGCTGGTCACACCAAACAGCTAACTTTCACAGTAGAGCGTCTTGTTGAGAAAACTGAATATGAATTCCGTGTGAAGGCCAAGAATGATGCTGGCTATAGTGAACCCAGAGAAGCCTTCTCTTCTGTCATCATTAAGGAGCCTCAAATCGAGCCCACTGCTGACCTCACTGGAATTACCAATCAGCTTATAACTTGCAAAGCAGGAAGCCCATTTACCATTGACGTACCAATCAGTGGTCGTCCTGCCCCCAAAGTAACATGGAAACTGGAAGAAATGAGACTTAAAGAGACAGATCGAGTGAGCATTACAACAACAAAAGACAGAACCACACTGACTGTAAAGGACAGCATGAGAGGTGACTCTGGAAGATACTTCTTGACCCTGGAAAATACAGCTGGTGTTAAAACATTTAGCGTCACAGTTGTGGTCATTGGAAGGCCAGGTCCAGTAACCGGCCCCATTGAGGTCTCATCTGTCTCAGCTGAATCGTGTGTCCTGTCATGGGGAGAACCTAAAGATGGAGGAGGCACTGAAATTACTAATTACATAGTTGAAAAGCGTGAATCGGGTACAACAGCTTGGCAGCTTGTCAATTCCAGTGTCAAGCGCACTCAAATTAAAGTCACTCATCTCACAAAATACATGGAATATTCTTTCCGTGTCAGTTCAGAGAACAGATTTGGTGTCAGCAAACCTCTAGAATCAGCACCAATAATTGCTGAACATCCATTTG
>TTN-214,ENSE00003810611,1,303,2898309,2898611,TCCCACCAAGCGCTCCTACCAGACCTGAGGTCTACCATGTGTCTGCCAATGCCATGTCTATTCGTTGGGAAGAACCCTACCACGATGGTGGCAGTAAAATCATTGGCTACTGGGTTGAGAAGAAAGAACGTAATACAATTCTTTGGGTGAAAGAAAACAAAGTGCCATGCTTAGAGTGCAACTACAAAGTAACTGGTTTAGTAGAAGGACTGGAATATCAGTTCAGAACTTATGCACTCAATGCTGCAGGTGTTAGCAAGGCCAGCGAAGCTTCAAGACCTATAATGGCTCAAAATCCAGTTG
>TTN-214,ENSE00003803222,1,306,2898612,2898917,ATGCACCAGGCAGACCAGAGGTGACAGATGTCACAAGATCAACAGTATCACTGATTTGGTCTGCCCCAGCGTATGATGGAGGCAGCAAGGTTGTGGGCTACATCATAGAGCGTAAGCCAGTCAGTGAGGTAGGAGATGGTCGCTGGCTGAAGTGCAACTACACCATTGTATCTGACAATTTCTTCACCGTGACTGCTCTCAGTGAAGGAGACACTTATGAGTTCCGTGTGTTAGCCAAGAATGCAGCAGGCGTAATTAGCAAAGGGTCTGAATCTACAGGCCCTGTCACTTGCCGAGATGAATACG
>TTN-214,ENSE00003801213,1,291,2898918,2899208,CTCCACCCAAAGCCGAACTGGATGCCCGATTACACGGTGATCTGGTTACCATCAGAGCAGGTTCTGATCTTGTTCTGGATGCTGCAGTTGGTGGCAAACCTGAACCCAAAATTATCTGGACCAAAGGAGACAAGGAGCTAGATCTCTGTGAAAAAGTCTCTTTGCAGTATACTGGCAAACGAGCAACTGCTGTGATCAAGTTCTGTGACAGAAGTGACAGTGGAAAATACACTTTAACAGTGAAAAATGCCAGCGGGACCAAGGCCGTGTCTGTCATGGTCAAAGTGCTTG
>TTN-214,ENSE00003809128,1,297,2899209,2899505,ATTCCCCTGGCCCATGTGGAAAGCTCACCGTCAGCAGAGTAACACAGGAGAAGTGCACTTTAGCCTGGAGCCTTCCGCAGGAAGACGGAGGAGCAGAAATCACTCACTACATCGTGGAAAGACGCGAGACTAGCAGGCTCAACTGGGTGATTGTTGAAGGCGAATGCCCAACCCTATCCTATGTCGTTACCAGGCTCATCAAGAACAATGAGTACATATTCCGAGTGAGGGCAGTAAACAAATATGGCCCTGGTGTGCCTGTTGAATCAGAGCCAATTGTAGCCAGAAACTCATTCA
>TTN-214,ENSE00003803385,1,306,2899506,2899811,CTATTCCATCACCACCCGGCATACCTGAAGAAGTTGGGACTGGCAAAGAGCATATCATCATTCAGTGGACAAAACCTGAATCTGATGGTGGCAATGAAATCAGCAACTACCTAGTAGACAAACGTGAGAAGAAGAGCCTGCGCTGGACACGTGTCAACAAAGACTATGTGGTGTATGATACCAGGCTGAAGGTGACCAGCCTGATGGAGGGTTGTGATTACCAGTTCCGGGTGACCGCAGTGAATGCAGCTGGTAACAGTGAGCCCAGCGAAGCTTCCAACTTCATCTCATGCAGAGAACCATCAT
>TTN-214,ENSE00003807140,1,306,2899812,2900117,ATACCCCTGGACCACCTTCTGCTCCAAGAGTTGTGGATACCACCAAACACAGCATTAGTTTGGCATGGACCAAACCCATGTACGATGGTGGTACTGACATTGTAGGATATGTTCTGGAAATGCAAGAGAAGGACACTGATCAGTGGTACCGAGTGCATACCAATGCCACAATAAGAAATACTGAATTCACTGTGCCAGACCTTAAAATGGGCCAGAAATATTCCTTCAGAGTTGCTGCCGTGAACGTGAAGGGTATGAGCGAATACAGCGAATCAATTGCTGAAATTGAGCCCGTGGAAAGAATAG
>TTN-214,ENSE00003809946,1,282,2900118,2900399,AAATACCAGATCTTGAGCTTGCAGATGATCTAAAGAAGACTGTGACCATCAGGGCTGGGGCCTCCTTGCGCTTGATGGTGTCTGTATCTGGAAGACCACCTCCTGTCATAACGTGGAGCAAGCAGGGCATTGACCTTGCAAGCCGGGCAATTATTGACACCACTGAGAGCTACTCATTGCTAATAGTGGACAAAGTTAATCGGTACGATGCTGGAAAATACACAATTGAAGCTGAAAACCAATCTGGCAAGAAATCAGCAACAGTCCTTGTTAAAGTCTATG
>TTN-214,ENSE00003810384,1,594,2900400,2900993,ATACTCCTGGTCCCTGTCCTTCAGTGAAAGTTAAGGAAGTATCAAGAGATTCTGTGACTATAACTTGGGAAATTCCCACGATTGATGGTGGAGCTCCAGTCAACAATTACATCGTTGAGAAGCGTGAAGCTGCTATGAGAGCATTCAAAACAGTAACTACCAAATGCAGCAAGACACTTTACAGAATTTCTGGACTTGTAGAAGGAACCATGTACTATTTCAGAGTGCTGCCAGAAAATATTTATGGCATTGGAGAACCTTGTGAAACATCTGATGCAGTACTGGTCTCAGAAGTGCCTTTGGTGCCTGCAAAGCTAGAAGTGGTCGATGTCACCAAATCCACTGTTACCCTTGCCTGGGAAAAACCACTCTACGATGGTGGTAGCCGACTCACTGGATATGTTCTCGAGGCCTGCAAAGCTGGCACAGAGAGATGGATGAAGGTTGTCACCTTAAAACCCACAGTCCTAGAGCACACTGTTACTTCCTTAAATGAAGGTGAACAATACTTATTTAGAATAAGGGCACAAAATGAGAAAGGTGTGTCAGAACCAAGAGAGACTGTCACAGCCGTGACTGTACAAGACCTCAGAG
>TTN-214,ENSE00003802641,1,288,2900994,2901281,TGTTGCCAACAATCGATCTTTCTACAATGCCTCAGAAGACCATCCATGTCCCAGCTGGCAGACCAGTAGAGCTGGTGATACCTATTGCTGGCCGTCCACCTCCTGCTGCTTCCTGGTTCTTTGCTGGTTCTAAACTGAGAGAATCAGAGCGTGTCACAGTTGAAACTCACACTAAAGTAGCTAAATTAACCATCCGTGAAACCACTATCAGAGATACTGGAGAATACACACTTGAATTGAAGAATGTTACCGGAACTACTTCAGAAACCATTAAAGTTATCATTCTTG
>TTN-214,ENSE00003806194,1,300,2901282,2901581,ACAAGCCTGGTCCACCAACAGGACCTATTAAGATTGATGAAATTGATGCTACATCAATTACCATTTCCTGGGAACCACCTGAATTGGACGGTGGTGCTCCACTGAGTGGTTATGTGGTAGAACAACGTGACGCTCATCGTCCAGGATGGCTGCCCGTTTCTGAATCAGTGACTAGGTCCACGTTTAAGTTTACCAGACTCACCGAAGGAAATGAGTATGTGTTCCGTGTGGCTGCAACAAACCGCTTCGGGATTGGCTCTTACTTGCAGTCTGAGGTCATAGAGTGTCGCAGCAGCATCC
>TTN-214,ENSE00003805894,1,303,2901582,2901884,GTATTCCTGGACCCCCAGAAACATTACAGATATTTGATGTTTCCCGTGATGGCATGACACTTACTTGGTACCCACCAGAGGATGACGGTGGCTCCCAAGTGACTGGATATATTGTGGAGCGCAAAGAAGTGAGAGCAGATCGATGGGTCCGTGTAAATAAAGTACCTGTGACAATGACACGGTACCGCTCCACTGGCCTTACTGAAGGCTTAGAATATGAACACCGTGTCACAGCCATTAATGCAAGAGGGTCTGGGAAACCAAGTCGTCCTTCCAAACCCATCGTTGCCATGGATCCAATTG
>TTN-214,ENSE00003808643,1,303,2901885,2902187,CTCCTCCAGGAAAGCCACAAAACCCAAGAGTTACTGATACAACAAGGACATCAGTCTCCCTGGCCTGGAGTGTTCCAGAAGATGAAGGAGGATCTAAAGTCACAGGCTACTTGATTGAAATGCAAAAAGTAGATCAACATGAATGGACCAAGTGTAACACCACTCCAACCAAGATTCGAGAGTATACTCTAACACACCTACCTCAGGGTGCAGAATACAGGTTCCGCGTCCTAGCTTGTAATGCTGGTGGACCTGGTGAGCCTGCTGAGGTACCAGGAACAGTCAAAGTCACTGAAATGCTTG
>TTN-214,ENSE00003805779,1,585,2902188,2902772,AATATCCTGATTATGAACTTGATGAAAGATACCAAGAAGGTATCTTTGTAAGGCAAGGTGGCGTCATCAGACTTACCATACCAATCAAAGGAAAACCATTCCCAATATGTAAATGGACCAAGGAAGGCCAGGATATTAGTAAGCGTGCCATGATTGCAACATCTGAAACACACACTGAGCTTGTGATCAAAGAAGCAGACAGGGGTGATTCTGGCACTTATGACCTGGTTCTGGAAAATAAATGTGGCAAGAAGGCTGTCTACATCAAGGTCAGGGTGATAGGAAGTCCCAACAGTCCAGAAGGGCCACTGGAATATGATGACATCCAAGTCCGCTCTGTGAGGGTCAGCTGGAGACCTCCTGCTGATGATGGTGGTGCTGACATCTTAGGCTACATCCTCGAGAGACGAGAAGTGCCTAAAGCCGCCTGGTATACCATTGATTCCAGAGTCCGAGGTACATCTCTGGTGGTAAAAGGCCTCAAAGAGAATGTAGAATACCATTTCCGTGTTTCAGCAGAAAACCAGTTTGGCATAAGCAAACCCTTGAAATCTGAGGAACCAGTCACACCAAAAACACCATTGA
>TTN-214,ENSE00003806836,1,306,2902773,2903078,ATCCTCCAGAACCTCCAAGCAATCCTCCAGAAGTACTCGATGTAACCAAGAGTTCTGTTAGCTTGTCCTGGTCCCGGCCCAAAGATGATGGTGGTTCTAGAGTCACAGGCTACTACATCGAACGCAAAGAGACATCCACTGACAAGTGGGTCAGACACAACAAGACTCAGATCACCACCACAATGTACACTGTCACAGGGCTTGTTCCCGATGCTGAGTATCAGTTCCGCATCATCGCACAGAATGATGTTGGCCTGAGTGAGACCAGCCCTGCTTCTGAACCAGTTGTTTGCAAAGATCCATTTG
>TTN-214,ENSE00003810204,1,300,2903079,2903378,ATAAACCAAGCCAACCAGGAGAACTTGAGATTCTTTCAATATCCAAAGATAGTGTCACTCTACAGTGGGAGAAACCTGAATGTGATGGTGGTAAAGAAATTCTTGGATACTGGGTTGAATATAGACAGTCTGGAGACAGTGCCTGGAAGAAGAGCAATAAGGAACGTATTAAGGACAAGCAATTCACAATAGGAGGTTTGCTGGAAGCTACTGAGTATGAATTCAGGGTTTTTGCTGAGAATGAGACTGGGCTGAGCAGACCTCGCAGAACTGCTATGTCTATAAAGACTAAACTCACAT
>TTN-214,ENSE00003805486,1,576,2903379,2903954,CTGGAGAGGCCCCAGGAATACGCAAAGAAATGAAGGATGTTACCACAAAATTGGGTGAAGCTGCTCAACTCTCATGCCAGATTGTTGGAAGGCCTCTTCCTGACATTAAATGGTACAGATTTGGTAAAGAGCTCATACAAAGCCGGAAATACAAAATGTCTTCAGATGGACGCACACACACTCTTACAGTAATGACAGAGGAACAGGAAGATGAAGGTGTTTATACCTGCATAGCCACCAATGAGGTTGGAGAAGTAGAAACCAGTAGTAAGCTTCTCCTGCAAGCAACACCGCAGTTCCATCCTGGTTACCCACTGAAAGAGAAATATTATGGAGCTGTGGGTTCCACACTTCGGCTTCATGTTATGTACATTGGTCGTCCAGTACCTGCCATGACTTGGTTCCATGGTCAGAAACTTTTGCAAAACTCAGAAAACATTACTATTGAAAACACTGAGCACTATACTCATCTTGTCATGAAGAATGTCCAACGTAAGACTCATGCTGGGAAATACAAAGTCCAGCTCAGCAATGTTTTTGGAACAGTTGATGCCATCCTTGATGTGGAAATACAAG
>TTN-214,ENSE00003801306,1,306,2903955,2904260,ATAAACCAGACAAACCTACAGGACCAATTGTGATCGAAGCTCTATTGAAGAACTCCGCAGTGATCAGCTGGAAACCACCCGCAGATGACGGAGGCTCCTGGATCACCAACTATGTGGTGGAAAAATGTGAGGCCAAGGAGGGGGCTGAATGGCAATTGGTGTCTTCAGCCATCTCAGTGACAACCTGTAGAATTGTGAACCTCACAGAAAATGCTGGCTATTACTTCCGGGTTTCAGCTCAGAACACTTTCGGCATCAGTGACCCTCTAGAAGTGTCCTCAGTTGTGATCATTAAGAGTCCATTTG
>TTN-214,ENSE00003808123,1,594,2904261,2904854,AAAAGCCAGGTGCTCCTGGCAAACCAACTATTACTGCTGTCACAAAAGATTCTTGTGTTGTGGCCTGGAAGCCACCTGCCAGTGATGGAGGTGCAAAGATTAGAAATTACTACCTTGAGAAGCGTGAGAAGAAGCAGAATAAATGGATTTCTGTGACAACAGAAGAAATTCGAGAAACTGTCTTTTCAGTGAAAAACCTTATTGAAGGTCTTGAATACGAGTTTCGTGTGAAATGTGAAAATCTAGGTGGGGAAAGTGAATGGAGTGAAATATCAGAACCCATCACTCCCAAATCTGATGTCCCAATTCAGGCACCACACTTTAAAGAGGAACTGAGAAATCTAAATGTCAGATATCAGAGCAATGCTACCTTGGTCTGCAAAGTGACTGGTCATCCAAAACCTATCGTCAAATGGTACAGACAAGGCAAAGAAATCATTGCAGATGGATTAAAATATAGGATTCAAGAATTTAAGGGTGGCTACCACCAGCTCATCATTGCAAGTGTCACAGATGATGATGCCACAGTTTACCAAGTCAGAGCTACCAACCAAGGGGGATCTGTGTCTGGCACTGCCTCCTTGGAAGTGGAAG
>TTN-214,ENSE00003808212,1,5609,2904855,2910463,TTCCAGCTAAGATACACTTACCTAAAACTCTTGAAGGCATGGGAGCAGTTCATGCTCTCCGAGGTGAAGTGGTCAGCATCAAGATTCCTTTCAGTGGCAAACCAGATCCTGTGATCACCTGGCAGAAAGGACAAGATCTCATTGACAATAATGGCCACTACCAAGTTATTGTCACAAGATCCTTCACATCACTTGTTTTCCCCAATGGGGTAGAGAGAAAAGATGCTGGTTTCTATGTGGTCTGTGCTAAAAACAGATTTGGAATTGATCAGAAGACAGTTGAACTGGATGTGGCTGATGTTCCTGACCCACCCAGAGGAGTCAAAGTTAGTGATGTCTCACGAGATTCTGTCAACTTAACATGGACTGAGCCAGCCTCTGATGGTGGCAGCAAAATCACCAACTACATTGTTGAAAAATGTGCAACTACTGCAGAAAGATGGCTCCGTGTAGGACAGGCCCGAGAAACACGTTATACCGTGATCAACTTATTTGGAAAAACAAGTTACCAGTTCCGGGTAATAGCTGAAAATAAATTTGGTCTGAGCAAGCCTTCAGAGCCTTCAGAACCAACCATAACCAAAGAAGATAAGACCAGAGCTATGAACTATGATGAAGAGGTAGATGAAACCAGGGAAGTCTCCATGACTAAAGCATCTCACTCTTCAACCAAGGAACTCTATGAGAAATATATGATTGCTGAAGATCTTGGGCGTGGTGAGTTTGGAATTGTCCATCGTTGTGTTGAAACATCCTCAAAGAAGACATACATGGCCAAATTTGTTAAAGTCAAAGGGACTGATCAGGTTTTGGTAAAGAAGGAAATTTCCATTCTGAATATTGCTAGGCATAGAAACATCTTACACCTCCATGAATCATTTGAAAGCATGGAAGAATTAGTTATGATCTTTGAGTTTATATCAGGACTTGACATATTTGAGCGCATTAACACAAGTGCTTTTGAACTTAATGAAAGAGAAATTGTAAGTTATGTTCACCAGGTCTGTGAAGCACTTCAGTTTTTACACAGTCATAATATTGGACACTTTGACATTAGACCAGAAAATATCATTTACCAAACCAGAAGAAGCTCTACCATTAAAATCATAGAATTTGGTCAAGCCCGTCAGCTGAAACCAGGGGACAACTTCAGGCTTCTATTCACTGCCCCAGAATACTATGCACCTGAAGTCCACCAGCATGATGTTGTCAGCACAGCCACAGACATGTGGTCACTTGGAACACTGGTATATGTGCTATTGAGTGGTATCAACCCATTCCTGGCTGAAACTAACCAACAGATCATTGAGAATATCATGAATGCTGAATATACTTTCGATGAGGAAGCATTCAAAGAGATTAGCATTGAAGCCATGGATTTTGTTGACCGGTTGTTAGTGAAAGAGAGGAAATCTCGCATGACAGCATCGGAGGCTCTCCAGCACCCATGGTTGAAGCAGAAGATAGAAAGAGTCAGTACTAAAGTTATCAGAACATTAAAACACCGGCGTTATTACCACACCCTGATCAAGAAAGACCTCAACATGGTTGTGTCAGCAGCCCGGATCTCCTGTGGTGGTGCAATTCGATCTCAGAAGGGAGTGAGTGTTGCTAAAGTTAAAGTGGCATCCATTGAAATTGGCCCAGTTTCTGGGCAGATAATGCATGCAGTTGGTGAAGAAGGAGGACATGTCAAATATGTATGCAAAATTGAAAATTATGATCAGTCTACCCAAGTGACTTGGTACTTTGGCGTCCGACAGCTGGAGAACAGTGAGAAATACGAAATCACCTACGAAGATGGAGTGGCCATCCTCTATGTCAAAGACATTACCAAATTAGATGATGGTACCTACAGATGCAAAGTAGTCAATGACTATGGTGAAGACAGTTCTTATGCAGAGCTATTTGTTAAAGGTGTGAGAGAAGTCTATGACTATTACTGCCGTAGAACCATGAAGAAAATTAAGCGCAGAACAGACACAATGAGACTCCTGGAAAGGCCACCAGAATTTACCCTGCCTCTCTATAATAAGACAGCTTATGTAGGTGAAAATGTCCGGTTTGGAGTAACTATAACTGTCCACCCAGAGCCTCATGTAACATGGTATAAATCAGGTCAGAAAATCAAACCAGGTGACAATGACAAGAAGTACACATTTGAGTCAGACAAGGGTCTTTACCAATTAACAATCAACAGTGTCACTACAGATGATGACGCTGAATATACTGTTGTGGCAAGGAACAAATATGGTGAAGACAGCTGTAAAGCAAAGCTGACAGTAACCCTACACCCACCTCCAACAGATAGTACCTTAAGACCCATGTTCAAAAGGTTACTGGCAAATGCAGAATGCCAAGAAGGCCAAAGTGTCTGCTTTGAGATCAGAGTGTCTGGCATCCCCCCACCAACATTAAAATGGGAGAAAGATGGTCAGCCACTGTCCCTCGGGCCTAACATTGAAATTATCCATGAAGGCTTGGATTATTATGCTCTGCACATCAGGGACACTTTGCCTGAAGACACGGGTTATTATAGAGTCACAGCCACTAACACAGCTGGGTCCACCAGCTGCCAGGCTCACCTACAAGTGGAACGCCTGAGGTACAAGAAACAGGAATTCAAGAGTAAGGAGGAGCATGAGCGACACGTACAAAAACAAATTGACAAAACCCTCAGAATGGCTGAAATTCTTTCTGGAACTGAAAGTGTACCACTGACACAGGTAGCTAAAGAGGCTCTGAGAGAAGCTGCTGTCCTTTATAAACCGGCTGTAAGCACCAAGACTGTAAAAGGGGAATTCAGACTTGAGATAGAAGAAAAGAAGGAGGAGAGAAAACTCCGGATGCCTTATGATGTACCAGAGCCACGCAAGTATAAGCAGACTACCATAGAAGAAGACCAACGCATCAAGCAGTTCGTGCCCATGTCTGACATGAAGTGGTATAAAAAGATACGTGATCAGTATGAAATGCCTGGGAAACTTGACAGAGTTGTACAGAAACGACCCAAGCGCATCCGCCTTTCAAGATGGGAACAGTTCTATGTGATGCCTCTTCCACGCATTACAGATCAATACAGACCTAAATGGCGTATTCCTAAACTGTCCCAAGATGATCTTGAGATAGTGAGACCAGCCCGCCGGCGTACACCTTCTCCTGATTATGACTTTTACTACCGACCTAGAAGACGTTCTCTTGGGGACATCTCTGATGAAGAATTACTCCTCCCCATTGATGACTACTTAGCAATGAAAAGAACAGAGGAAGAGAGGCTGCGTCTTGAAGAAGAGCTTGAGTTAGGTTTTTCAGCTTCACCCCCAAGTCGAAGCCCTCCACACTTTGAGCTTTCTAGCCTACGTTACTCTTCACCACAAGCTCATGTCAAGGTGGAGGAAACAAGAAAAGACTTCAGGTATTCAACCTATCACATCCCAACGAAGGCTGAAGCTAGTACAAGTTATGCAGAACTGAGGGAACGGCATGCCCAGGCTGCGTACAGACAGCCAAAGCAACGGCAAAGAATCATGGCTGAGAGGGAGGATGAAGAGTTGCTTCGCCCAGTTACGACCACCCAGCATCTCTCAGAATACAAAAGCGAACTTGACTTCATGTCAAAGGAGGAAAAGTCTAGAAAGAAATCAAGGCGACAAAGAGAAGTGACAGAAATAACAGAAATTGAGGAAGAATACGAAATCTCAAAACATGCTCAAAGAGAATCATCCTCATCTGCGTCTAGACTACTGAGACGACGGCGCTCCCTGTCTCCAACTTATATTGAGTTAATGAGGCCAGTGTCTGAGCTGATCCGGTCACGTCCACAACCGGCTGAGGAATACGAAGATGACACAGAAAGAAGGTCACCTACTCCAGAGAGAACTCGCCCACGATCCCCCAGCCCTGTGTCTAGTGAGAGATCACTCTCGAGATTTGAGAGGTCTGCAAGATTTGATATCTTTTCCAGGTATGAGTCCATGAAAGCTGCTTTAAAAACTCAGAAGACATCAGAAAGGAAGTATGAAGTTTTGAGTCAGCAGCCTTTCACACTGGACCATGCCCCTCGAATCACACTGAGAATGCGCTCGCACAGGGTACCATGTGGCCAAAATACACGTTTTATTTTAAATGTTCAGTCTAAGCCAACTGCCGAGGTTAAATGGTACCACAATGGTGTGGAACTCCAAGAAAGCAGTAAGATTCATTACACCAACACGAGTGGAGTCCTCACCCTGGAAATTCTGGACTGTCATACTGATGACAGTGGAACCTACCGTGCTGTGTGCACCAACTACAAGGGCGAAGCTTCTGACTATGCAACGTTGGACGTGACAGGAGGGGATTATACCACCTATGCTTCCCAACGCAGAGATGAAGAGGTCCCCAGATCTGTTTTCCCTGAGCTGACAAGAACAGAGGCGTATGCTGTTTCATCATTTAAGAAAACATCTGAGATGGAAGCTTCGTCTTCTGTCAGGGAAGTGAAATCACAGATGACGGAGACAAGGGAAAGTCTCTCCTCATATGAACACTCTGCATCTGCAGAAATGAAAAGTGCTGCATTAGAAGAAAAGTCACTGGAAGAAAAATCCACAACCAGAAAGATCAAGACGACTTTGGCAGCAAGAATTCTAACAAAGCCACGGTCCATGACCGTCTACGAGGGCGAGTCTGCAAGGTTTTCTTGTGACACCGATGGTGAGCCGGTACCAACTGTGACCTGGCTGCGTAAAGGACAAGTGCTAAGTACTTCTGCCCGCCACCAAGTGACCACCACAAAGTACAAATCAACCTTTGAGATCTCTTCAGTCCAGGCTTCCGATGAGGGCAATTACAGCGTGGTGGTAGAAAACAGTGAAGGGAAACAAGAAGCAGAGTTCACTCTGACTATTCAAAAGGCCAGGGTAACTGAAAAGGCTGTGACATCACCACCAAGAGTCAAATCCCCAGAGCCTCGGGTGAAATCCCCAGAAGCAGTTAAGTCTCCAAAACGAGTGAAATCTCCAGAACCTTCTCACCCGAAAGCCGTATCACCCACAGAGACAAAACCAACACCAACAGAGAAAGTTCAGCACCTCCCAGTCTCTGCCCCACCAAAGATTACTCAGTTCCTGAAAGCAGAAGCTTCTAAAGAGATTGCAAAACTGACCTGTGTGGTTGAAAGCAGTGTATTAAGGGCAAAAGAGGTCACCTGGTATAAAGATGGCAAGAAACTGAAGGAAAATGGGCATTTCCAGTTTCATTATTCAGCAGATGGTACCTATGAGCTCAAAATCAATAACCTCACTGAATCTGATCAAGGAGAATATGTTTGTGAGATTTCTGGTGAAGGTGGAACGTCTAAAACCAACTTACAATTTATGGGGCAAGCCTTTAAGAGTATCCATGAGAAGGTATCAAAAATATCAGAAACTAAGAAATCAGATCAGAAAACCACTGAGTCAACAGTAACCAGAAAAACTGAACCAAAAGCTCCTGAACCAATTTCCTCAAAACCAGTAATTGTTACTGGGTTGCAGGATACAACTGTTTCTTCAGACAGTGTTGCTAAATTTGCAGTTAAGGCTACTGGAGAACCCCGGCCAACTGCCATCTGGACAAAAGATGGAAAG
>TTN-214,ENSE00003811220,1,157,2910464,2910620,GCCATTACACAAGGAGGTAAATATAAACTCTCTGAAGACAAGGGAGGGTTCTTCTTAGAAATTCATAAGACTGATACTTCTGACAGTGGACTTTATACTTGTACAGTAAAAAATTCAGCTGGATCTGTGTCCTCTAGCTGCAAATTAACAATAAAAG
>TTN-214,ENSE00003801641,1,692,2910621,2911312,CTATAAAAGATACTGAGGCACAGAAAGTCTCTACACAAAAGACTTCTGAAATTACACCTCAGAAGAAAGCTGTTGTCCAAGAGGAAATTTCCCAAAAAGCCCTAAGGTCTGAAGAAATTAAGATGTCAGAGGCAAAATCTCAAGAAAAGTTAGCCCTCAAAGAGGAAGCTTCAAAGGTTCTGATTTCTGAAGAAGTCAAGAAATCAGCAGCAACCTCCCTGGAAAAATCCATTGTCCATGAGGAAATCACTAAAACATCACAGGCATCAGAAGAAGTCAGAACTCATGCTGAGATTAAAGCATTTTCTACTCAGATGAGCATAAACGAAGGTCAAAGACTGGTTTTAAAAGCCAACATTGCTGGTGCCACTGATGTGAAATGGGTACTGAATGGCGTAGAGCTTACCAACTCTGAGGAGTACCGATATGGTGTCTCAGGCAGCGATCAGACCCTAACCATCAAGCAAGCCAGTCACAGAGATGAAGGAATCCTCACCTGCATAAGCAAAACCAAGGAAGGAATCGTCAAGTGTCAGTATGATTTGACACTGAGCAAAGAACTCTCAGATGCTCCAGCCTTCATCTCACAGCCTAGATCTCAAAATATTAATGAAGGACAAAATGTTCTCTTTACTTGTGAAATCAGTGGCGAGCCATCCCCTGAAATCGAATGGTTTAAAAACAACCTGCCA
>TTN-214,ENSE00003801638,1,154,2911313,2911466,ATTTCTATTTCTTCAAATGTCAGCATAAGCCGCTCCAGAAATGTATACTCCCTTGAAATCCGAAATGCATCAGTCAGCGACAGTGGAAAGTACACAATTAAGGCCAAAAATTTCCGTGGCCAGTGTTCAGCTACAGCTTCCTTAATGGTCCTTC
>TTN-214,ENSE00003805382,1,303,2911467,2911769,CTCTAGTTGAAGAACCTTCCAGAGAGGTAGTATTGAGAACAAGTGGTGACACAAGCTTGCAAGGAAGCTTCTCGTCTCAGTCAGTCCAAATGTCTGCCTCCAAGCAGGAGGCCTCCTTCAGCAGTTTCAGCAGCAGCAGTGCTAGCAGCATGACTGAGATGAAATTTGCAAGCATGTCTGCCCAAAGCATGTCCTCCATGCAAGAGTCCTTTGTAGAAATGAGTTCCAGCAGCTTTATGGGAATATCTAATATGACACAACTGGAAAGCTCAACTAGTAAAATGCTTAAAGCAGGCATAAGAG
>TTN-214,ENSE00003809884,1,1319,2911770,2913088,GAATTCCGCCTAAAATTGAAGCTCTTCCATCTGATATCAGCATTGATGAAGGCAAAGTTCTAACAGTAGCCTGTGCTTTCACGGGTGAGCCTACCCCAGAAGTAACATGGTCCTGTGGTGGAAGAAAAATCCACAGTCAAGAACAGGGGAGGTTCCACATTGAAAACACAGATGACCTGACAACCCTGATCATCATGGACGTACAGAAACAAGATGGTGGACTTTATACCCTGAGTTTAGGGAATGAATTTGGATCTGACTCTGCCACTGTGAATATACATATTCGATCCATTTAAGAGGGCCTGTGCCCTTATACTCTACACTCATTCTTAACTTTTCGCAAACGTTTCACACGGACTAATCTTTCTGAACTGTAAATATTTAAAGAAAAAAAAGTAGTTTTGTATCAACCTAAATGAGTCAAAGTTCAAAAATATTCATTTCAATCTTTTCATAATTGTTGACCTAAGAATATAATACATTTGCTAGTGACATGTACATACTGTATATAGCCGGATTAACGGTTATAAAGTTTTGTACCATTTATTTTATGACATTTTACAATGTAAGTTTTGAAACTAACTGTTGGTAGGAGAAAGTTTCTTATGGAACGAATACCCTGCTCAACATTTAATCAATCTTTGTGCCTCAACATACTGTTGATGTCTAAGTATGCCTCAGTGGGTTGAGAAAATCCCCATTGAAGATGTCCTGTCCACCTAAAAGAGAATGATGCTGTGCATATCACTTGATATGTGCACCAATACCTACTGAATCAGAAATGTAAGGCATTGGTGATGTTTGCATTTACCCTCCTGTAAGCAACACTTTAACGTCTTACATTTTCTCTGATGATGTCACACAAAATTATCATGACAAATATTACCAGAGCAAAGTGTAACGGCCAACACTTTGTTCGCTCATTTTACGCTGTCTCTGACATAAGGAGTGCCTGAATAGCTTGGAAAAGTAACATCTCCTGGCCATCCCTTCATTTAACCAAGCTATTCAAGTATTCCTATGCCAGAGCAGTGCCAACTCTTGGAGGTCCCAGAGTGCAGCCAATGCCTTTGTGTGGTAGTTCTAAATTTTAATTGCACCTGAAAAACCTGGGCACCTAAGCAATGAGCCACAGCAAAAAGTAAAGAACAACAACAAAATAAAGCTGTTGTTAAATTTTAAACAATATTACTAATTGCCCAAAATGTCAATTTGATGTAGTTCTTTTCATGCAAGTATAAATTCAATTGTTAGTTATAATTGTTGGACCTCCTTGAGATAGTAACAACAAAATAAAGCAAGCTATCTGCACCTCAAAA
>TTN-214,,0,2556,2913089,2915644,GTGAGCAGCAACTTTTCTTATTTTAATAGTAGAGTCACTTTCTTATTGATCTCTGGCTCTGGATTATTTGTGTGTGCTAAATGCCTATGTACAAGTGTTTGTATGACTATTTCTTGCCAGTGCTGACCCATTATTTAAATCTGCTTGTTAAATTCTATTTTAAAATGTCTGAACATTTTTCCTTAAAAAGTTGAAAGCTTTATTATATCAGCTAAATGATTCCATGATTCAAATTGTTTAAGTTCACTTAATATTCTAAAAGTTGAGGTCTGAAATGTTGAGAGAAATGTTTACTTCTTTTCTAGACTCTCTTTGCCTGTTGAGAATGTTCAAGGTTATATTACTCAATGATAAAGTTAAGCACACCAAGAATAGCTCTGATAAAATGCATGTGGTATCAGCTACACCCTGATGACTTTTTAAGGGAATCAACTGCTGAGGTATCAGTTGCAGGACAGTGACAGAACACTTGCCTGCTGTCAGTCAACCTTGGAGAGTTTAGGAGAGTTTATTTTAAGAGCATGACATTTTAGACGCATACCTTCAGCCCCAGTTAGACAAAGGCCTGTGAAGAGCAAGTGCTAAGGCAATAAAATTTACCTAGACAATAGGAATGTAAGATCAATTTAAGCTGGTTAATTGCAACATAGTTGGAGATTTGGAATAAAATGATATAATTGTTTTCTAAAATATTCAGAATCTCTTCATGCATTTTAACTCAGCACACAGTCCAATTATATATTTTGAGATAAATGTTGACACTAAGAAGGGTAAGAAATAATGTTTAAAGGAAAGGTTTCTTACTTCTAAATACACTTTGATTTCTCATCTTCCTAGAATTTGATTACTAATTGTCAATGCCTGTAAATACATAGATATATAATTAGGTATTCTATGTCTAAGAGGACAGCTATTTTTAGATATACTAACTTATAAACAGACAAAGTTAGACACAGAAAGTTGTTCATCCCAAAGATAATATGCTACAAAAAGGAGTTTCTGACAAAAAAAATTTATGAAAGCTTTTGGATATTATCTGATTTTTCCAAATATAAATTTTATTGTCTCAGAGAATGCTGGTTTCATTTTTTTAACTAAGTAGAAGGTTACAGTAAGGAACAGAATTATCACTAAGAAGATTATTGCTCCATGAAGTTTTAGTAAACAAAGAATTTAATGAAAAATAGTAATGAAGTGATTGACAATTCAGAAATGTTCTATTTCAGAACAGAATAGTCATGTTGAATAATTAGGTATTTATGCATCAGAAAATTCTTCACATAATGTCTCTGAAACTGATAGGCAAAGTACTTTCTTGCACTTAACAAAATGACTTAACTGCAAATTTTATATTCGTTTCTTTGATGTTGAATATTTTACTTTATGAAAGCATAGGCCTTTTCACTTCATCTACATTTTACACCAGCCTTCCATTATTCAAAGTTTGCAAATTGTTCCATATTAAGAACTCAAGCCAGCATTTTTCTTTCAGAACTATAATAAACTTTGGCCTGTTCACTAAAATTTAAATTTTTCTGAATATTTACTTCAGCAGTAACAACATTTACTGCACAGTTACAGTATGAAGAAATGTTAAGAAATAGAAAGCACCGTATGCCGTCTACAAAAAGCTTGCATATTTGATAAGGCTTGCCAAAGCTTCTCCAGTCAGGAAAGAGATTACAAAGTTCAGATTTTTACTTCTGGCAACTATTTTAAGTAATCAGATAATGTCTGAATCAATGTCAACTTTATAAATATAGAGTGAACGAAAAATATTGGGGAGAAGGAAAATTTTTAAAATAATTTTCACTTACTAAGCTGATGCAGAGGTTTATTTATTTTAATTTTTTTTTTTTTTTTTTTTTGAGACAGAGTCTCATTCTGTCACCCAGGCTGGAGTGTGGTGGCACCATCTTTGCTCACTGCAACCTCCACCTCCTGGGTTTAAGCAATTCTCATGCCTCAGCCTCCCAAGTAGCTGGGACTACAGACATGGGCCACCACGCCTGGCTAATTTTTGTATTTGTAGTAGAGACAGGGGTTTCACCATGTTAGCCAAACTGGTCTCAAACTCCTGACCTCAAGTAATCCTCCCGCCTCGGCCTCCTAAAGTGCTGGGATTACCAGCATGAGCCACCACGCCAGGCCCAGAGGTTTATTTTACATTTATCACATGTCTTGTCTCTCTAATTACACTTCACTAACCCTGCATTGCTGTGGTTTTCTTCTTCAACTCTGAACCTGGTTTTCCACCATTGGTAAGACTGTATATTCCCTCTTTGACCACTAGGGTTCATTCCTTGTTCTGTTTGGCTAATACTTTTTTCCATTTCCCCTTACACTTGCTACTTTGGGTTAGGCTTTAAGTCAACTCAATGATGAACTATGCAAAACTGTTCAAGCCACAAAAGAGAAGACCTGCCCATCACTCTAGGCCCACAGATGACCTATGGAGCAATCCATTTGGAGAAACGTGTGTCTCTGCTATCTGCAAAGCAGCTCCAGAGTGACCCTTAGCTGGGACACCCTAATTTATTTTCTCTTCTTTTTCAG
>TTN-214,,0,2210,2915645,2917854,GTAAGCTCACACATTCACACTTTTGTTTTTTTTTCCTTTGCCTCCTCTCCAGTAAGTTAACGTTGCTGCAGGACTTGACGCCAAGTTTAAGCCCTGCTTTCACTTCGGAAAATTAGTCCAACACTATGGAAAGGTCATTTTAAGGGTATACCATTCACAGAGTACTGACAAAATCTGACAATATAATGGCTTGAAATGTTTTATTCATATTTATTATTCCACAAAGCAAAAATAATTAGTGTTGGATTAAAATTGCCGTTAGAATCCAGCAACTAAATAGGACCAAATTTAGTCATTCTATATTTGGGCTCAGCTGCAGAGCCAGACTGGAAGCCAAGAACTCAAGCCCAATAGAAGCCAGCCACAGAGCCATGGGGTAGGCAGTCTGGGCTGCCTGCTCTGGACACCTGAACTTCAGTTGGTTCACACGCAAAATAACAGTGCATCTAATTTTCCTCAGAGGCAGAGCTGTTCAGTAATTAACCAACTCCTCATTATTTTATTATTTTATTTTCAATCTTTATTGAGTGATTCTAATGAATTAAAAGACTTTCCAATCGTTTTGAAATGACAGAAAATAATATGCTTCTCGGGTGTCTCTATTTAAAAGGAAGCAAACACTAACCCTAGAATTTTATCTGAAAGGAAGTTCATCTCTTTTTTGCCTTCTTTTTCTTCCTCATAACTCAGTTTATGGATGGTTCAAAAAAATGCATGGTATCATCTTATGAAAAAATGGAGAGTAGTGTATGAACTATATTGTAAATAATTTTAAAATTAATCAATATTTTCTCTTTCTGTAGTATTGTAACGAGCCATGTAAGATGGATACGGATTAAAAAAAATCATGCTTAATTCTTAATTTAGTGCACTTCCATGGTTCATTGCCCACTTCTTTTTTAAAATTTTATGGCTTATAATAAAGATATAAAATAAAATTTCTTTTTTTCTCTTTTTTTCTATTATATGCACCAATCTTATTCATAACTGGATAATACTTTCTTTTACATTGTACAAATATCATATAATCATTGCTTATTTTCTATTGTACATATATAGACCAATGAAATTCCCTTTTCATTGGTCTATATATGTACAATAGAAAATAAGTCTTACCGACTTCCAAATAATTTACCTATTTATCTGGTAACACTCAGTAACTTCTGAACTGAGCAGAACACATATGACTTCAGTGGGAATTTGCCTCCTTGAGAAGTAGTGGAATCTGGCTACTTCATATCTTCTTGTTCCTTCAAACTATATGCAAATAAATTATTACAAAGACACTACTGAAAATATCCAATACCCATAAATCAGTCCAATAAACTATTTAATTGGCCATAGTGGGAGATGGGCTAATGTATAAACAACAAAATAGACTTTCTCTAGATTATCTTTACCTACCAGCGTAAGTAGATAGAGCATCAACCTTTATGCCAAGTGTGAAATAAATCATGCCCTGAATGTGCCTCGTACATTCTCAATGTACAGAGTTTTAATATATTTAAAACATCAAACCATGGACATGTAGTTCTTGGCTCTACAATTTATGGCAGATAAAGAGAATTTGGCTTTCTACCTGCAATTCCAATGATCCATGTTGTTCTGGAAGACTAGGTTTGGATTAGTCTCTTATGAGAAATTGCTTGTCCATGTTACAATGTTTTTACTGATTGCACTTGTGAAAGCAGAAGAGTCCAAGAAGACAGTGTCCCTGTAACCACAGAGGAGGGAGGAGGGCATGCCTCCTGGGCTTGTCAGGCAGAAACTGGAGATCAGTTTGCTGCTTTTGTTCTTCACTTGCTCTCAAAGAGGACAACAATCACTCTTTATTTCAAATTTTCCTTGGTTCTTCATTTTTATAAGTCCCTTTCATGATTTTAATGTTGTCTATTAAATTGCATCAGATAGAGCCCTAGGCAGGCAGGCAGGAGATGGAAATTCTAGTCCCCTCTGTGTCACTGCTAGCTGAAGGACCTTGGAAAAATCATTAGGCCTCTTTTGGTCTCAGTTTCCTCCCTTCCTGCCTTCCTAATGGTCTGCAGGTTTACACACTGATCATGCAACTGTAGGGTTTTCCCTATCATTAAGTGGCATTCCATGCTGGAAAGCTTTTACAGATTCGGACAAGGCAGTGAACATGATGGGACAGAGCAGAGGACTTTGTGGTGCCCATTCAAACATAAAGGTGAATTGTTCTTGCTCTTCAG
>TTN-214,,0,1455,2917855,2919309,GTAGGCTGCTGGGGACCTGCCAATCCTCTGCTCCCCCAGAGGACATCTCCAGCAAATTGGGAAAGGAGTCCAGAAAAAGCTATGGGCAGAGGTAGATGCAGCTCTTAAACTACAGAAGGGTCTACTGGAGGCTGAATTATTTATAACCAAGTTGTTTGCCTTTTGGAATTTAATTTTCCTCTAGAGTACATCGTAAAAGTGACTGAGAATCAGTTTCTCAATACACATATTAAACACTCAAAAGTATGTTAAGGAAATATTAAAAATCATGTTTCTCAGCAAGTAGAAAAGCTTGGAGCCTTGTTTATAAGTCCTTTAAGGAATAAGACATATTCTCCAGGGAAGTGTGAATCTCCAGGAATTCACACTTTAACAAGCATCCAGATAATTCTGATGCCGGTAGTCTACAGACCACCCATTTAAGAGGCATGTAAACATACCCAGAAGAAAATAAATGCTTGTTTATTATTCAAATGCATGACACTGTTTCCCCAGAAAACTTATCACCAATCTTAGTGGCCTCTGTTGTTTTTCTCTATCCTTTACTACCTAGTGAGACATTAGTATACAGAATATTGCATGCCTTTACATGTTTTATAACAATATCTTACATGAGCTACGTAAAGTTACATATGCTTATCCAATAAACTTTACCTTCAATGATGTTCAATTATAGGGCTATAATTGACCTAAGCAGAAACCACATCAAGTAACATCAGGTAGAACTTTAGCATGCACCCAGAAAATTCACAAATGGAAAATGCACAGGGTTGGCAGCACCTGCTGTTGTTTATTACTCAAAATCATGTCAAAGTTAATTCCACTCACTCCTCACACTTATAAAAAATTTCCTTCAACATAACCAAAAAAATCCCCTTTCTGTAACACAATTAAAATGAAGTAATGTTATTATTGGGATTAACGTTTTAAATGCAAGTAAATATTTGGGTTATTTGAATACCTATCAAGTTGGAGAAGGTTTAGAATTTTAAAAATTAAATTAAAAATGTAATGATTCTTTAAGTAACAGGTACACCCATCGTAGCAACCACTGGAATTCATTTTAATGCAACTTACTGGAATATGCAACATGGCTTTCACATATTAATAGAGCGCTAGATGTGAGGTAGAGGGGGAAGTACCAGAAAGATTCTCAAGAAATGTTATAACAAAATCTAGAGCTTTTATTTAAAACAAAGAAACAAAAGGTGGTGGCCTAAACTGCTCAGCAAAACAAAGCAAATAAAATAAAATATGGTGGTGAGAAAGCCTTCTGTAATCTCCTGGCTCCCATTCTTGCTGTCATTGCTGGGTGAGCTGGGTTCAAGGACATTCAAGGATGTTTAGATTGGCGAGTCATCACCTGGTTTTGGAATTGGAGCTGTGATTATTTAAAAATACCTTGTAGGGAGCACCCTGGCTCTCACTCTTGACTTTGTTCTCTTGTCCCCGCAG
>TTN-214,,0,484,2919310,2919793,GTACGTGCTGGAGGTTGAGGAACAGAGAGAAGGGGAGAGAGCTGGTTTGTGTCTAAATGGGGCCAAGCGTCCACTTGCCACCTCTCACAGCCCTGGGAAGAATGCTGTGAGCTGATATAAAAGCTGGCTTTTCGACACCCATGAAAAGTCCCTGAGATTCTAGTCAGGAGCGCAGAATAGAAGCAATCTGTGCTTATGAATCTCATTATAAACTGGAAAGGGTTTCAATTAAGTGATCTACATTTCCAAATTATTGGCAAATAATGAAATTTTAAAAAATCATTCTAAGTAAATTTTTATCTTGTAATGAACATTTTCTATTTTTAAACCTAATTTATATTCATGCAAAATCCAAAACTTTCTGCAATTTTCTCCATTGGGATATCCAGAAAATCTTTTTGACTTTGTAGTCAGAATTAACAGAATCTCTTTTAAAATGGGTCATTGTGCCCCCTCCCAAACATTCATCTTTCCCTTCCCACAG
>TTN-214,,0,93,2919794,2919886,GTATTTTTCTATACTGTTGGTTTTCAAGCCTTTCAGGCTGTTGCGTCCCCAGCTATTCCTCCTCAACGTGGGCTTTGTTTTAATCTTTTACAG
>TTN-214,,0,4234,2919887,2924120,GTAAAGCTGCCATAGAGAGAGCAGATTATTGCACATTTTGGAACTAGGTTTTGAAACGAGAAAGATTCCCTTGTCCCCCTCGCAGGGCATGCGACGCGGAGAGTGGTTCGCTTCTTCAGTGTCCCGCTGCTCAAACCTCTAGGGGAGCATACAAACGGGCAGGTTGTGGGGCTCCGTGTTCCTCTGGACATCCAGCCGCTTGTGTGTCTGCCTACTAGGGTCTCAGGGGTTTTTATAGGCATAGGGTGTGGGCGTGGCAGGTCAGGGTGATCTTGGGAAATGCAACATTTGGGCGGGAAGGCAGGAGTGTTTGTCCTCACCTAGGTCCATGGGCACAGGCCTCGCTAGGGACCACGCACTTCTCTTCCCAGCACTTCCCTGCCCTCCTCCCGTGTAAGTTTCATGCACTCAAAAATGTAGCAGGTGACAAAGGAGGTAAACCAAGAAGTTACTGAATATGATTTTCACAAATCCTCACTGTCCACAGGTAAATTGAAGACCCTTATAAACTTCTGAATTCTTATTTATATTTCATGTAATAAATATCTACTTTAGGGGCCAAAATATGGCACAGTGAAAGGAGAAGAGCACAGAAGTTAGAGTTCAAAGCCCTAAGGACAAATCAGCCTGATCACTTAACAGTTTGATTTAGGGCAATAAGTATAAATAATAAAATAATTGTTATTATATATGGATCACTTCCTCTATCAGATTGGAACTATACATACATTATCTCATTAAATGTTCACAACCTGTAAGAATTATTATCCTCAATGTTATTGATAGGTAACTGGAATTAAAGAAGTTAAGCAGTTTATTTAAGGTTTCAGTTGTGTCATCTGTAAATTAAAGAGAGTCACAATAAGAATGATCTCAAGCTGCATTTTGGGGCTTCAATGAGATAATTAGTTGAAAGTGCCTTGTAAATAGAAAATAATTATGCCAATATTCTTATATTCAGATGGTAAGTAAAACCTTTTAAATATTTTGCATATGCTTGTGTTATTTTATCTAGAAAATAAAATGGACTTCTATGCTTACTTAATATGGAAGTATTTTAGAAGGTGATCATGTATCATGATCAGGGCTCAGAAATTATATAATCAAGTGTAAATTGTCCACAACAGTTTTGAAAGTTTGGGATTTAGTTTATCATGATGAAACTTTTAATATGATGAAATGAAAAATGTACAAAATTTGAGCAAAGAAGTGTTTATTGATCAATTTAAATGAAATAAAAAACACATGGATGTTCCCTGCCAAGAAAATTTTTTATAAAAGAATAATAAGGAGATAGTTGACCTAAATAATATTCAAACATACTGTAAAGTTACTATAATCAGAACAGTATGGTATTGGTAAATGAATAGAAAAATACACCAGGGGAACAAAACAGAGAGTCCAGAAAGAGATCCAAGTATAATAGATCCAAGTATATAGGGAATTCAAAAAGCAAAGTGGCCTTTCAATTCAGGGGAGGGAGAGGTATTTTAATAAAGAATGCTGGTCCAATTAGCTATCCATCTGGAAGCAAACAAACATAAACCTCTGCCTCTCACTATTTACAGAATAAATTTCAGCTTGATTAAATAGTTAAAAAATGAAAAAAAAAGAGAAGACAATCTGCAAAAGCATTTATGGGTGAAAGCTTTTAAAAAGACAGTTACAGATTCAACTACATAAAAATCAACATGTATGTATGGCAAAAGCAAAAAGTCATTTCTAAACCAAACAGCACTTGTGAAAAAATTTTAAGACCTTTCTCCTCCTCAAGGTACTTCATTGCCTCTGCCATAAAAGTATCACAATAAACATAAAATGGCTACAAGGTAGACAACACCAGCCTAGAAACAGTATATAACATACAAAATTACGTAAGCTTATGCTGGATAAGACCCATAAACAAGCAAAATATTGAAATGGATTAAAAGAAATGGATCTGGGGGAATGTTTGCAACACTTACGACAAATAACCAATAAATGCACTAAATGCATTAAAAATCATCCACAAATTAATTTTTAAAGGAAAAAAATGCAACACAAAAAAAGACAAAAGATACAAAAAAGTATTTAACATAAGAGGCAATGTAAAAGTCCAATAAACATGTGAAAAAAAATGCTAGATGTTTTCCAATTTTTATTGTTTTAGCCACAAAAATGTAAAGATATTGGCAAACACTAACATGAAACCTTGAACAAAAAGCTTACTTTAAAAAACATGTCTAGCAGTCGAATAAAAAAAAATGTTCAGTCTCAGGCTAAATCCAAGTTTGCACACCATGAAATCACAACACAAGCCAAATGCAATTTCTTGAGGAGATAACAACCTAACTATATTTTAAAACCCAAGCCTAAGGGTCATTTAGAATCATGGAGTGTCCCTGATCCCATGGAGCATTTTGACCATCTTAGCAGTTTTGAAAGTTCATTAATAACCATCCAAATTGCCCCAAAATTTTGCTTTCCAATAATTAAGAAATAAAATGCCAATTTGCAGAGAAAATAATGGTTATCAAAGATAGACTGCTTCCTAAATATCTCATAGTTTAATCTTGATTTTTGTTGTAGAGTAAGGCAAACATATTTCATTGAATAAGGTGCATTGTATCTCGCTGTGACCAGGTGATTATTTTTTGTTGTAAGTACAGAAATAAGCACTCTCCTATAATGACCAAAATTACAATGATTTTCACAGTTATGGGCTTACCTGTGTCCTGCTGTTAATCAGTCATGTCATGCTAATCATGTCTTTAACTCTTTTTGAATTAAACCCATTTACTAAGTACAGCAAGAACAAGGCACAGGGTGAAACTTAAAAGCACATGTCTCTTTGCTTTTCTTCAGTTAGTGGAAACCACACATTATTCTAACTTGGTTTTTGTTATATTTCAAAGGCAGTCATGTTCAGAAAAGAGGCTTATTCCCTAGATTTCCCTTTAGTTTGATTACAACTTCATTTACAAAATGTAAATGGATTTTCACACAAAAAAAGCCATTCTTCGAGAAAATAAACATTTCTTCGTGAAACTGGTTAATGTTGTAATGTACTGTTAGGGTACTCTGTAAGTTAGAGAAAATATCAACTGTACCTTGAGCTTAATTAGAATAATCATTTCATGTATGATCAGTGTAAGCTAAATATCCTAGATAGTGACAAGATGCATTTATAAACATTTTCTTATATGCAGAATTAATAAAATGCAATGATAGGGCAATACTGCCACCTAGAGAGGAAAATGTAATAAGCCTTATTAAGAATTAAATCAGTTCTGAAAAAAATTTTACCTTACAATAGTTGGCCAATCCCCAGAATTATTGCTATAGATCAGAAATAGTCTTTTTTGGCCATCAGTGCTGGGATTTAGCACCCAAATTCTTCAACTGATGCTACTTGCACTTTGGATACACCTAAAAAGCAAACAATGAAAACTATTCTGGAAGAAGCAACTTTATCAATTTACCCAAAAATCACAGAATCATTAGTTTTTAAGTTAGTCAATTCCCACAATAACTCTAAAGATATTTAAAATAAGTCCAGAGTGCAATACAAGGGGGGCGAGTGTAAACAAATATGGAGGAAATTAAAAGTAGCTGTCCACAAACACTTCGGCTAAAGCAGCAATTTGCAAAGTGCACTGCACAACCTGTACCCAGCAACATGCTGCAGAAAGCTTCCTGAGGATGTGTCCCCCTGTCCTGGAAATTCACAAGGCATACTGACATAGTAAAGGCTGTGGGAAGTCCTGCAGGGGAAAAAAAAAAATGGCTTAAGCTGCTTAGTCAAGAGTGGCACAAGCATTTTGATTACAGAAACCTTTCTTCTTATAACACCTATTTGACATCCTCTAACCCCCCCAGAATTGGAATACAGAGATGAATTTGGAATACAGAGGTTGCTGGATTTGACATGTCTTTCCTTTGGCTGCATATTAAAGAAGTAGCTTTTTCTGTTGTGATTTTTTTTTTTTTTTAATGTGAGAAGGTGCAAGGCACAAAATCTCCAGCTTATTTGGAATTAAAGCTGATTCTCTTACAGGGTTACAGCAGATAAGAATAGGTTTATTGAGATTTAAAACAAATTACTTCCAAGTACATTATTTACCCTCTGAATGGGTTATGGAGGCACACATTTTAAAACTCTGCCTTAAAGCACTTCCAGCTTTTCATCTCATGATTCACATCCAGTTACCCCTCCTTGCTTTGACATTCTTGACCTCTGCCTTTTGGTTTTCAG
>TTN-214,,0,370,2924121,2924490,GTACTGTCAGAATGGTTTTGTTTTTCCTTATTTCACATTCTAGTTTCTCCAACTGGATTTCTGCCATGAAACTCAGTCTGTATAAATTGGAGGAAAAATGCATATGAACATAAAAATATAGCAGCAACTGAAGACCAAATTCAGTAGTCATGCTTTGTAAAACCATTTTTAATTAGGACAAAAGCTCCAATCTGTGAAGTTTCCATAATATACAGGTTTTAATGATACAGTCTCTGTATTTCTTGGCAATAATAAATGCTTATGTATGAGTGTATTTTGCTCTAGGTGGCTCAGTTTTCCAGTATGCTTTTTTATTTTCTACTGGGCATGTCATTTAAAAAAGTAATCTACTTGGTCATTTCTAATCTAG
>TTN-214,,0,857,2924491,2925347,GTACGTGCGAGGCTGCCATGGGGCACCCGCAGAGCCACGTCCTTCAGTGCACATTAACTCAACCACCATCCACTGAGCTTGGCATGCAGCTGTGCTCAATTCATTCTGAAGACAGCCTTGAGCCCAGCAGGGCCCAGACTTTTAGAACTTTCTGAGCAAAAGGTGGTCGGAGATGTCAAAGGTGTTGACAATGTGAGTATCACAAGAGCAGAGTAGGCCAGAAATACCTGGGCTATATGAGCAGGCAAAAGTCAACTATGGTATTCAAGGTAGGAAGGCAAAGAGTGGCCAGAGAAACAGAGACCAGTCAATTCCAGAGCTCAGTCACTGCACACACTGGATGTGGAAACTACTATTTCAGGGAAGGCATTACATTTCTCTAAGTTTCCCCAAAGGACTTTTGTTTTTACTTTTCTCAAAACAAACATGACACTTGATTCATAGCTGGAACAGTGTCATAAATCCAGGATAATGTCCCACCTCGCATTTGAATAGATTTTCTGTTACAGTTTAAAATCATTCCAGCTTTCCTCCTTATCCTCTTGTGTGACATTTATGTCTAAATCCTGACAGATTATTGTAACTTTTTTTTCTTTTCTGAGACAGAGTCTCGCTCTGTCACCCAGGCTAGAGTGCAGTGGCATGACCTCCGCTCACTGCAGCCTCCGCCTCCTGGGTTTAAGTGATTCTTGTGCCTCAGTCTCGTGAGTAGCTGGGATTACAGGTGTGCGCCACCACACCCAGCTAATTTTTGTATTTTTTAGTAGAGGATTTCACCATGTTGGCGAGGCTGGTCTTGAACTAATTTTTATGTAAGATGCATTAAGGTGTTTTCTTCCTTTCTCTATGAAAAGCAG
>TTN-214,,0,1206,2925348,2926553,GTGAAAATGGGTTTGTATTTTAAATTCACTGAGGTTCTTACAGGGGTCAACACAGATAATCACCTTTACCATGAAGAGTGTTGTTCCTTGGGCCACATGGTTGTTAGCATACTAATAAGATCCCCTTGTTGTATGTGTAAATTTCTGGGTACTGGATACCAAAGTTTGGTAGTGTCCCTGAATGCTCCCCTTGTGAGTATGAAAAAGAACTCTGTGAACATACACCAGGAGTAGAAACAGGGGTCTCATCACATTGATCTGGGGATGCACTAAGTATAAGACTATAGGGAGAGGACAGATGGCTAAAACCAGGAGGAAGAAATAGATGCTGAGGCAGGAATGGGGAAAAGTGGAGGAGACACTGAACTCACTTTGCTTTAGAAATCTTAGCAACTGCTTCCTGGCTCCTTCGGAAGACATTTGCACATGAGTTTGAAGTGGAATGGACAGCATGGCTTTAACAAGCCAAATGACCAGAAAAGGTGAAAAGGACAGCCCCATGGTTGGCGGCATTTGGGGACAGATTGGAAAATGCCAGTTAGTAGAGCTCTTGGCCAGTGGAACCAGTTGGCAGTTGGGTGGTTTGAGAAGATGAATTTCAAGTCCCTTTCAGCCTTGAGATCCTGTGTTTCAGTGATGAGATATTTGAGAATGGCAAAGAGGCAAATAGAGAAAACTGTCCCCCTACATACGCATATACCTTAGGTGCCCAGATGGAAACAGCATTCTTCACAGTATTTAGGAAAACTGACAAAACAAAAATATTGTATAAATGCAGATTATAAATTATCCATGCTTGATTTCTCACATGTAAAATAAAAAGATCAGACAAAATTACTTCTAAAGTCTTCCATTCTGATATATATTCTAAGATTACCTTTAGATGACAGAATTAGTACAGAATAATATTGCCATAGATCTATTTGTAAACATTGGAAGTCATTTTAAAGAAGACTACAATTCTGCTGTTCAAAACAAAGTGTTGAATTCAACTTTGTTTTCTCTAAGCAGCCTACATAATTTACAGTTTAAGGAGAGAAAGAGCATGATCTTATTTATGAACATGGGATTATTTATTTTATTTAGTGACATCTGCAGAAAAGGGATTTTACATCTTCAAATTCCTATGTTGTTATATTTAATAAACACCATATTATTTCATTGGGCATCAGGAAATAAAGTTTTTTCTTAAATCATTCTTTGCAG
>TTN-214,,0,1226,2926554,2927779,GTAAGTCTGATTTTCTAAATATTTTGTAGTTTGTTGACAATATCACATTACAGCCAGCTGCAGGTAGCTTATAGTCAAAACCCTTAAATGGAGAAGTCTTTGGTTGTATATTTTTTGTTATTGTTCCTCTATGTCTAGTATTGAAACTCAGGATGGAAATTATGTTCACATTGCACTATTTTCCACTCACTTGATCAGTTTTCAGGAGATTGTCTACAGAACAGTTTAGGGCACATCTATGAACTTTCTAGAACATACATAAATGGATGATAGATATCATGCCAGTCCAGTTACCCACCGGGACAGTTGGTTTCTTCGTGCATAGCCTAAGCCCTCAGTCACTTAGATTGTAATGCACAAACTTTACATGCACACACACATGCACACACACACACACACACACACACATATACACATACATCAGCCATAAACACCCCGAATAAATAGCAAGGGAAAGTGAGGATATGCCAGACATCGGAGAAAGCAAATACTTCCTCAAAAAAAAAAATTCCTTCAATTCACGGTTGATAAACAGTGACCTAGAAGCATTTGCTGCTGTTGTGCCGTAGAGCTGTGTGAGGACAATCTCAGTGTCACTAAAATCCACATCTCTCCCGTATGTGAAATCAAACCTTTAAGTGTCAGGAGAGAGGCATTTATCTTGAATTCTTCCATGTCAAAGAGGGCGCCTGTGCTCATCCTCCTTGAACTCAAGCTCTTTGCTGATCTTAGAGCTACTTTCTTTAAAGGTCCAGTTGAGAACCTTGTACACTTAAAAGGCTGACCAGAGGCTGCTGACTGAATTTCCCTCTCCTTACTGTGAGTGAGACATTTTGAAAGCAGCAAGAACCCTACTTAGGATAATCAAAGGCATAGAAATCCCCATTGCCATTGCAATGCTGGTGACTGGCAAGTTCAGCTGGCCTATGGTTTTCCAGCCACTTGTCAGCAGCCACCCACCGGGTTCCCTAACACGTTGACATGTCTCAAGATGAGATATGTTCAGTTCTAGGACAATTTGCTAAGGCGCATGTGGGCAGAAAAGAAGCCCATTCCTCAGGAAAGCAGTCTATGTATTAAGCACAAGTGTAGGCCCCTGAAATGGAAATCTGACATTTTATCGTTCACCACTAAGCATCCTGTATTTTCCTGAGTGTTTCAAGGATGTCTTCCCATTGCTTTTGTATCTTTTGAAACTCAAATCTTTATTTTACTCTAAACATCAG
>TTN-214,,0,592,2927780,2928371,GTGATGACTTCCTGCCAATGTGAAAGTCACTCTTGCACCATTTCATTTGCAAATCACCTACATTTTCATCATGGATCTTAATCATCACTTCTTCACTTCCACCTCTTCTTATAATGCAAATAGAAAATTTCTTTTCCCACACAGCTACCTTTCACTGTCAATTCATTCCTAACTTTCAGACTTTCTTTGGCTTGTTACTAATATAATATAATAATTCACTTTAATATCTTCCTATTGAAGCAGATGTCCGTAAACAAGTCAATTCATAATACAAAAAATTATGTGCTATTTACAGTGCTACTGAAATGTCTCAGAGATTGCAGTTTTAAAAAATGTGAAAAGTACAAAATAGCACTCATTAGTCTTTTATTGCTAATCACATTTTTTTCTTTTAAACTGGACTTATTGTTTTGATATTTTTGCCAGTGAAACAGTATGGATGATCAAAGTAACTCAAATGATATATTTTAGTGCAATTAAAATTTCCTTGAATAGGAAGAAATTTTGCCTCCTTTCTTTTTGACTTACGTTTCTTTTATTAAAGATTTATGGAATTTAATGACTATTTTCTTACTTTCTTTTGTATGATCAG
>TTN-214,,0,480,2928372,2928851,GTGAATACAGATATTTGAGCTGTGAAAAGTTCATCTTTAAACTAATTTCTAGTAAACTATTAACTACAATATGGTATGAATTATTAATCTGTATTTGCCTTTTAAAATCCCTAACTAAAAACAAAATGGTAAATATGAGACTGATTATCATTAATTTTATCTGCACATTTGATTTTCATCCATCTGTAACATTTATAATTCATTTTATTCACCATTATTCTTTGCATGAAGATTAGCATTTTTTAGCTTAATTTTTAAAAAGTGACACAGGGACTCATCTAGAGGTTTTTTAATAGCTAACATTTCTAAGTTTTGTGATTCTCAGTCAGTATATGTAGACATTGCCGGTGAAAGTTTATTTCTCTTGTGTATTTAACCCTGAATAACCATCTTGCATCCCCATGAGGAAGGGGGAAGGGTCATACTATGTGTGTTTGAAGCCCTGTTCAACTTAAATCTTGATTTTACTGTAATAATCAG
>TTN-214,,0,3218,2928852,2932069,GTGACTATTGTTGTTCCAAGTGTGAAATCCCCTATTATAATACATTAATACCACATATCATGTGAAATTCCTTATTGTAATACATTAATATCAAGTCTCTGAATTTCTTATGTATGAGTCACTATTAACCAAATTTATTTTTTAGACAATTAAATAATTGGAAACTAAAAAAATTTATTATTGTTAATATTACTACATATCCCTTTCTCCACTTATCTCTTCACCATTATTGTCAACATTTTATTAACATCTGGGAATCTTCCAGAAGTTGATTAAAATTGCATGCAGGCTAATTTTAAGAGGCCCATGAACATTTTTTAAAAACACGGAAGATGTATAAGTAAATGATGACTCTTACTCACTGTCAAGAAGATGTGTGTTTTGAAGGGTCATAAATTCAGTATATTATGTTATGGAGTATGACTTATTTCAGTAAATTACCCATAATTTTCTTTGTATGAAACTTTATCTTTTTTCCCTCCTGTAAATATCAGAGGAGAAGATAAGCTGAAAAAATTATAATGCATGCTGTAGCAGCTCCCACTAAAGCTAAACAAGATGCATATTAAAATCTAGAGAAGGAAGTATCCAAACAGAACAATTACACATAAGCCATGAAAAGATTACCGTATCTATTTGTAGCTATGAAATATCCATGAATTAAACTGTTTCCCATGACTCTGTCATTTACTCCAAATGAGCCATTTACCTAATTGTATTCTTTATTGCTAATATACCACTTGAAAATTAGCAACTAAAGTTTTTCCATTTCATTAGCAGGATGGCCTGAATCCTATTTGTATTTCCCTCAGTGTCATTTTCTGACTCTACATCTTTTTTTTCTAAGATATGATTTAAGATAAACTTTTTAAACCTTTACTCAAATCTAACATTTAATGGCATATCAGCCTTTCAGAAGTCTCATAAATGACAGAAATTCCACTATGCAACATACTTCATGAGTGATTAACTTTTTACTTTTGTTTCCATTCAAATTTTGTCATGAATTGACTATCTTGTTTTTGTTAAAAATTAGCTAAGGATGGAAGCTGAGAAAATGTTTATACCTGAAGTAGTAGTTACCACTGCAAAATCTGCTGAACCAGCCACACCGCCAATGACTAGAGAAGGATTCACTATTAAACAAAAACAAATACATCTTTTTCGAGAAGAGATGAAAACTGATGCTATGGAGGTGAAAAGTATTGTTTCATCCCATTTCATCATCAACTCTCATAACTTTTCATCCGTCGTGAATTGTGCTTCTAGTGTTCCATCTAATTGTTTAACTGATCAATAAAACAATAGAGATGGTTAGATTCAGTCCATCCTCCAGTTGAACAGTGAGCATTTCTAGTAGTGAAAAGTCAGACCAAATAATACTCTTCTTTATGTCTCCTAAATTTATTCTCAGCATTTAACTCGTATGAATTGGAGTATTCTAGTCCAATTTGTCTTCCTGCTTCTCTAGGTTACAAACATGTGAGAGATATCAAAGTCCACTAAGAAATAAAAGCGGTTACCAGCATACTCATTTGTAGTCCACCAATAAGTGTGTGTATATAAATCTGATATACAATAATTCAAGGAAAAAACAGACAGATGCTTCCTCAATTTAAAATATTTTACCATGATTAAGATTTTTCCATATGTTTAAAATCAAGAACAAAATTTAAATATTTCAGTTGTGTGATATTTAGTCATATGACAGTTTCTTTGACAGTTTCTTTTATCATTGTTAAAATAAAATTAAGACTTAAGCTGACTACTTCATAGCAGACTGGCTAAAAGGTTCAAATGAGATATAGTGGAAATGTGATCACACTACAATCAAAATAATATTTATTTATTTAGTGTTATCTGTCGAAGATGTTAACATTTTAAAATGTCTATACAATTAAAGTCAGCTCATTGCCAATATAGTTTTTAAAAAAGAAAAAAATAAATGGACAAACTTAACTCACCTAAGCCTCATGTGTATTTTATGTTTTTTTCTGAGATGATGCAATCTAAAGTGAAGATGGTATTTGCAGTCCTTCGAGGCAGATGAAATTGTTTGTGTCTTCCTAAAAGGAAGCCCTGGATAAAGCCCATGATCACTAAAGACCCAATTCCATCTCAGAAAAATCTCATTTATATCTTGAATGGTTCAGAGAATAATTTTTAAAGATATGCAGGTAGCATAGTTGAAGAATGTTTCTGATGCATTCTAGATTCTATTCACAGGTATAGAAAACTGAATATTAATAAAATTTTCCAATCTTACTTTTAAAATGCACTTTTAAAATGTACTTTTAAAATGAACATGGCTATGTGATTTTTGAGGTATGCTGTTTCCAAGTATCACATAGAATCATAATATCTAAGCCACATCAGCTAGTTTGCCTTCTTTAAAAGAGAACCTCCTCTGCAAATTGTATTTCCATTAATGTTCATCAGACTCAGAAACGAGAAAATAATATTTGTTTCATTCTTTGCTTTAACTCTCCATAATAATGAAAGTAAATTAAACTTCAATGTGAAAGGTTGTTCTCTTGAATCCAAACATGATAACACTTTCATTTTAATCACAATATTTTTATTTGCACGGGGTTCTCTTTGTCATCTGTGTGTTTTAAGAAAGGTATTTTCTGATAGATTAAACAATCTTACCCTTAGGGAATCATAAGTAAATTCATATGCTCACTCTGTGTTTGTGAGCTTTCATGTTATGTCCGATTTGCATGCAACCATATAACTCTGTAGTCACTGATTTTTCTGGACAGGATGATGACGGTATTTGAGTGCACTTATATCATCACTGTCACTGCATTAATACCAGACTAAATGGTCAACAAGATAATAAAAATAATCAGTGAAAAGAACCAGCTCCAAAATTCTGATTTTCCAATTGCTGATTGATTGTCTGCCTGGAAAAATTCTAGAAAATTTCAAAATCTTCTTGTGATTTTATGTTCATATTGTGATTGTCCTATGTTGTGTATATGTGATTTAATGTCTAGTATAATTAAGTAGGTGTACAGAGAGTATATCTAAATAGATGTCTGTACAATATAATAATCAATGAAATAGTCCCTAAAAGTGTTTCTGAGATACATTTCTAGACACGTTAACACTGCTGTATAATGTGGACGCCATCTGCCTGTCCTGATGCCCAGGAGATATTCCAGCCTGATCTCGATATTCCTATGTATTAATTCTGGAAACCTTGTCTCCAG
>TTN-214,,0,105,2932070,2932174,GTGAGTCTATACCTGCTGATTTTTCACCTTGTTCATGGTAAAGCAAGCCTCACTGCTGTGGTCATCTGGTGATCAATGGTATCACTGAGTTTCATTTCAATGCAG
>TTN-214,,0,1268,2932175,2933442,GTAAGAAGTTACAGAGCATGATACAGAAATGTTTAAAGGAAATAAGTATCTAACCTGTGAAACAGAGCATCTCTGGGGTAGGCCAATGGAGGATTCTTTTTTGGTGATGTGTGTGTGCGTGTGTTTGCATTCACAGTGGGCCCAGACACCCTAAAGATTTGGTTTCTGAAACTCGCCCAGGGGAGTGAGCCTAGAGTCACAAGTGGTTATCTTATACCTCTGAGGAGAGACAAATCCACACAGGCTTCTCTCTAGTTCACATTTCAGGGACAGCTCAAACTCAATTGTTTTGATTACTATTGTTCTAATGATTTTGTGAAAGGTAGTGTGTTACACAGCATAGTTTTACTTATGCTGTGAGACATTTCAGAGTAACTTAACTGTGAATGTGTTTCAATAATAAAGACAGACATTGAGAAATCATATATTTATATACTCAATATAGCAAGATGGAGAGGTGGTACTGTATGGTGGTCGGGTTGGATTGTGGAATCAAATAGCTCTGGATTAGTGCCCTATCTTCTCCCTTATAATCTCTGTCATCAGGAGAAAGTAAGCATACATGTAAAATGCAAGTAAAAAGGACATAAAAACCTGCAGTTGTCAGCATGTAATAAATCCTTGATATTAGTCACTATTGTTATTATACACATCCAAGAAATAGAACCCAAACCTTCTATGCCTTCAAAGAACTGTAAGTTACATATAATGCCTATATTTGATTTAGTCCCAAATTACAAAACAAATAACCATAGACCACAACAGAATAAAAGCAGTAAGGAAACCTTTAAAATATTTTTTCTGAATGTCTTCATGTTTACCTTTCACATAGATTTGTGGCTAAAACCCAAATGTACTATTGCAAAGTAGTTCTTAGGCATTTACCAACAATTTCAATAATTTCTTAATTTTGAATCTCCCACTGTGGTATTTTCAAAAGTGGCATTCATCGGAATGGTTAAGTGAAAATTCGTGACTAAGCTTTAGAAGATCCTGTCCTTTTATGATAAAAGCTGTAAAATAAGGAGTTCTGAATACAACTCTTTAAAAAAGATATTTTAAAATTTGTTTTACAAACTAACAGGCATGACAAGGAGCTTTATAATTGGCTTATCTCTAAATGACTTTTCATTAACTGTGTGATAATGAGTGCTAATGAGAACATTAAAGAACAGACCTTATAGAAAATAGGCTCAGACTCAGTCCAAGAGGGCTAGCCATCGGAGGATGGTTAAATGACTTTATTTTCTGACTCTGTTTCCATGTAG
>TTN-214,,0,284,2933443,2933726,GTTGGTCACTGGTTACCCGCTGTTACATGGTCCACTCCCATTGAGCAGGGCCAGGTGGTTGGCTAGTTTGTACTGAAAAGTAGCCAGTGGAGTCTTGCCTTTCTCCTTTGCCATACTAAGACTTGATTTTTATGGAGCATAGTATGGGTCAGAGATCATTTTCTCAAATTATTTTTATAATTATTTTTATATTTTTATAATTATATAATGTTGCATGAGCTAAGAGTTTATGAGATTTCCCTTAATTTCATGAGCATTTTGTAATATAATTTGTAAAAATCTAG
>TTN-214,,0,655,2933727,2934381,GTGAGTAAAGAAGTTGATAATGCTGGACCCTATTCATATCTCCTCAAATCATTTTAATACACGTTTGCAAAGATCAGTTTCTCAAATTAATACAAAAATGACATTAGTGAGCTTACAGATGCTCATTTTAAGACCGTATTTGGTCTGGAAGACCATATTTGACCATATTTGGCAAGGAAGAAGGGAATTCTATGTGGTACATCATTCATGGATTCAAAAGATTTAATGAGCTTCTAATATGCAGAAGGCATTATTGCAGGAGCTGTGCAGACATAAAGACCAATCCATCCCTCTTTGAAATATTTTCTTTGCCATCAGAGAAAATGTACACAAACAAGCATAATAAAATATATAAGGTGATAAACATCACAACAGAAGGAGAATCCATGGGAGGCATAGATTCATTCCAGTTGGTGATACCATGGCAAAGCTTTGTTGAATAGGTAGCATTTGCTATTGAGCCTTACAGCTCTTTACTAATATATTAGTATATTATATAAATATTAGTTTCTCTACTACTATTTCTGGAGTCCTGATTAAAAGGCCATTTTGTGGCAGTTGAAATGCATAAGTTCAAACTCTACATTTGTTACAAAACAGAAGTGATTAATGAATATGCACACGTATCATTATTTATTTTTTCTCCTCTCTTCAG
>TTN-214,,0,203,2934382,2934584,GTTAGTGGCCACCCTCCCACAGTCCTAATGCACATGCCATCACTTTCATCTGACACTCTTTTCCACAATATGGTTTCTGTGCACCTTGAAATGATGTCCCTTTTTGGAACTTGGGGGGAGATTATATGGTCAATTTAACTGTCAGTGCTAAGCAGGGGTCACTAAACATCTCATCTCAATGAGAAACTTTTGTCTTCTTTTAG
>TTN-214,,0,111,2934585,2934695,GTAAAATATTTTGCTAATTAGTAGCTGTTCTAGTACCATTTTGACTTTCAGCCCCACCAGTATTGGCAAATTGCAACCCGGAAGCTAATATGAGGGGAATTCTCTTTCCAG
>TTN-214,,0,948,2934696,2935643,GTATTTTGATGGCTGAATATAGAGTTCTCTGTGACTTGTATAATACGTGCATGAAGCCTAGAGTAGAATTTACTCACCCCACCGACCCTGAGCATAGGCTCTTTCATTGTGGAGCCTTCTTAGTTTGTTTTGAGGTATTTTTACATTTTTTTTGTGCAAAGTCTTCCTAAGAAATAAAGCTATGTGACAAAAGTGGATGGAAGATATATTTCTTTACATTATAGTTTAATTCATTGAGTTTGTGAAAGTAGAGAAAATATGGATTTTCACACAAACACACCCACACACACACACACACACACACACTTCCAGAAAAGATTTGAGACAATTTTCAATAAAAACATGTAATAACTAAGTGACTAAAAGATAGAAGAATAGCCATGTAATGAAGAAGAAAGCTAGTTATGCACAAAAATCTATGCTAGTAATTTTTCTTCAATTCAATATAAAATTTAGCTCTGAATATTTTGCAATTTAAGATAAAAAGAGCAACCTGGTAATCTAAAAATGTAGGTGCCGTACCTTCATAATAATAAATATAATGTACCAGAGAGTTAATACTGAAATATTTGAAGGAATTTATTGTTTTAATTATTCATTTGATCTCTGAATGAAATAATGAGAAAAATAACGAACAAAGAGAAAATACCTGTTGTTTAAGTGACCTGATCATTTGCTAACATAAACACTGAAAACCACTTAATTTCATGACTGATTCTAGCAATAAATATTCTTTAAAATGAATATTTTAACTTATTTGGCCCTAATTACTCATGTTCTTGCATTTTTCTCAATTTTCAGCAATCTTATAATCTATTGTGGAGCTTAGTCATATGTTTAGGGTCATTGAATTTTATACCACAGATCCACTCACAGATAAGTCCAATTATTTTACCCACAGAAGAGTTGTTGATAACTGATTTTTAAATTTTGTACATTTACATAAAG
>TTN-214,,0,915,2935644,2936558,GTAAGTGCAACTCCAGTTTCTATGTGCATGATAAGAACTGAAATACAAGGAGATAGCAGTGCTGTCCGTTTGCTGAAAAACCTGTTGCCACTTACTGGTTCTGATACTTTGCCCCAGTGTCTTTGCCTCAGTTGTATGGAAAATGTTTTAGACCACATGGCCTCAAAAACTATACTGTCATTAAACTTCTGAGGTTCTAGCAATAGTTTCTTTTTGTTGTATTTGTTTCTAGGCATATCATGCCTCTGAAAATGCAGAGATTCTAAATCCGGTTGCCTTCCAGGCCCAGGCAGGTAACAGTGAGCTCAATGAAAACAGTAGCAAACTGGAGAGTAGGTGCCCTGCCTCAAAGAGACAGTAGCTGTGTTGTTGCCAGGCATGCACCAGGCTGTTACCAGGCTCAGTGTTGCTAGAGCTCCTGATATCTTAAAGAAAACCTGGAAGTCAGGATTTTCAATGTTTATAACTTGAAAACAAATGTAACAGCTTTCATGCTAGACTGTTCACATTTACAGTGAACTGGCTCACACTCTGTTTCACTTGACCTACACAGTATCCCTTAGAGGAAATTACAATATTATCTTCATTTAGCAGATAAAGCACTCAATATTCAGGAAGGTAAATGAATTGTTAAAAGACACACAGCAAATTAGGAAGTCCTCCGTGGTAGATCCCCCCAAAACTGACTGCTAATATAAAATTCTTTCTACAATTGTAATGGCTGGTTGGATTTGTTAGTGTTAGTTTGGTTTCCAAATTCCATCTAGAAAATATTGAGCACTTCAATAGTAGATATTTGGAAAATTTGGTTTTTGGTTATCAACTTTCCCCAGTGTAGAGTTTACCTGAATGCATAGTGGTATGACTGTTTTCTAATAAGAGCATTAAAAATTAACTGATGTTCTTAACTCTTAG
>TTN-214,,0,537,2936559,2937095,GTGAGTATAAAAGTAATGACCAACCAAACAATTTCATAAATTATACTTTCCTTTTTTTATTTGATATTTTCATTTTCAAGTGATGAGCTCGGGGTTAGACAGCTATTAGAAGGTCCAAGTTCACTGTTGCTAAGTTTCCTTAATCTTCATGGTATGTTGCACCTGTGAGTTTAGAAATAGAGATTACATATAGGCCATAAATGTGACTTTAAAAATAGGGCTTATAATATATTAAGGAAAACACCAATATTAGCACAGCTGAGTTCATTCATGCCAAGATCTCTTCATCTGTGTGATAAGCTAATGTAACCTCTAACCCAAATCTAACTCCTGCTTTTGGAATACCTTTCTACCCAAGATGCCACAACATTCACTGGGAAAGATGACCATAATGCAGATTAAAACAAACAAACCAAAAAGTCCTCTAGATTCTTCTCCCAGCTAAAAACTTCAACAGTCTAGCTCAGATACATCTCCTTAAATAATTTATATCAGTAAGGATATGTATTTTTAACAGACCATAATCTTTTTGCATAG
>TTN-214,,0,110,2937096,2937205,GTAAAATATAAACATTTATCATAGCTCCTTGCCACAGTAAAGATACAAATTGGTTAAAATATAACTATTTGATGTAAATTTTATTCATACATGCATGGTATTCTTTGCAG
>TTN-214,,0,898,2937206,2938103,GTAAGACTTGTAATAATTTGGGTTATTTAGTATGTAAATTGTTTTCAAAACATCAAATAGTAGCAAATTGCTATTGTGTAAGAAGAAAATCGAGGGCTAAAATGGCACAGAAACTTACCATTGGCAACACCAACAATTGCCAGAAGTTTTTATTTCTTGCCCCTGTGTAAGATGAGCAAAGAATTTTCATCAGTGTAACATACTGTTTATTTTCCTAGTGCTATAGCTAATATCACAATAGCTCTTATTTGACACCTGATTTTTACATATGTAAATTTATACAACAGCCCTGCAATAAAAAGATGACTATTATTGGTTTGGAAATAGGAACACTGAGGCCCTGGGAATCTATGAAAATTGTCTTAATTCATCCAGCCTGTAAGCGGTGGTGCCAGCATTCAAACTCCAAGTCAGTCTGGCTGCAATGTGTAGATGGAGTCTTGTTTTGCTTTGTTTTGTTTCCAAATTCATTTCTATGTTTTCCTCCTCTGAGATAAAGAATGTGTATTTTTTATTTTTCCATAAATGTATTCATTGGTTTACTTATCCAACCAACATTTATTAGGATGTTTTAGTAGTTAAATCAAAAAAGTCTAGTGACTGATTAAATCCAAGTGGTAAGGAAAAGAGAGTATTGAGGATTATTCCAAGATTTTTGAGCCTGGGTACCTGGATATACTGAATGACTACCAGCTAAAATTGAGAATATAGGAAAAACATAGTTGTGGGGGCAACAATAATATATTCTATTTTAGATCTGAATGAGTTTGAGGTGCCTTCTAATACGTGCAAGAAGTAAATTCTAAAATAACATGAATAATGAATAAGACAAAATGAAGTTTGTTTTGCTGAGTTTTCTTTATGCCTCACGAAAGTATTGTGTGTCTTTGTTTTGCAG
>TTN-214,,0,119,2938104,2938222,GTAAGCGTGATAAGTTTTTGCTCATGAATCATAAAAACACAAAAACAAGCTTATGTATGCATCTAACAATTTTTAAAAACTATTTTAAAATCTACTTTCTTTTAAACATATTTTCACAG
>TTN-214,,0,102,2938223,2938324,GTAAAATGAGATAAAATAAAAATAAATGAATTTTCTTATCACTTGGGTTATAAACAGGTATTTCAGCCTTACTCCCTCTAAATCATGACCTTTCTCTTTCAG
>TTN-214,,0,99,2938325,2938423,GTAAGTATGGAAATAATAAAGCTAAGCTCATTATACAAATCCAATAACCAGGGAAGCTATACCACTATATTGATTATTCCCTCCCCCAACTTTTTATAG
>TTN-214,,0,153,2938424,2938576,GTAATTTGCATGTCTTTCCTTTGATGGACCTGTCTTTGTATTCAAGAATATCCATGAGTGTGTTTACTTTTATTTTCTTTCCCCATTCCTCAGGTTGAGAATTTAATTTAATATAATGTGCTCTCCCCTTTTTCCCCCACCTTTTTCTTGTAG
>TTN-214,,0,447,2938577,2939023,GTATTCAACAACGAAGGATTTCATTGTTTACCTAAGCTCTAAAGTCACCCTTAGCATGTGGTAAAATTAGCTATGCAATTTTTCTTTCATGAAACAATTATTTGGAAATTGACTATAAGTTTCATAGCCAGAATCATAAATTTATGTTCGTAATTAAGAATGTTAACAATTTGACCATTTGGATTTTTTAAAGTAGTATTATCTTGATTTTTAGCTTTTAAGTTTTTTATTGAAGCATAATTCTTTACTTTCAAAAATATTTAAAAATTAAAATAAAATAACTGCTTCTTATTGAAAATTTATCTCTCAGCCCATCAGCGGGTAGATATTAAGAATACACCTGATAGTATGGGGGAGATAAAAGACATACAAGACATCATCTCTATCCTAAGTCTAGATGCATACCTCTCCAAAAAAATTGATTTATCTTTCTGTTATACACTTCAG
>TTN-214,,0,96,2939024,2939119,GTAAGTCCTCCCATTCCTGTCAGCCTGCAGTGAGCATCATTATGGTTTATTGATAAAAAATGATCATAACATTCTTTTTCTCCCCATATTTCACAG
>TTN-214,,0,112,2939120,2939231,GTGAGTCCTAATTATAAAATTTTATGTTTACACTATTAAGCAACATAAAGAACTTCAAGGAGCAGACAATTTCAACAAAATTCATTCATCTTGTGTGTGTATGATTTTGCAG
>TTN-214,,0,92,2939232,2939323,GTAAGGATTATTCTACCTATCTAATAATTACTTTAAGCATTCTACTTTCCCAGTGTAACAATAACCAAGAGATTATTTTATTTTTTCCCCAG
>TTN-214,,0,1637,2939324,2940960,GTTGGTATATTTATTAACCTAAATTCTTACGAGGAGTGATTGTTATTTTAAGAAATTATTATTCATTTCCCCCAAAATTCCTTTCAGTTTCCCACTTCCATGCCTCTGCTTATGCTGTTCCCAAAGCCAATAGTACTTGCAACACCATTCCCACCAGCCTAAATTACAAATGTTCTTCTAGGCCTACCTCAAACGTCACCTTCTCCATTAAACCTTCCTTAATCTCTCCATTTGTATATGATCTCTTCCTCATCCAACCCCAGGATCACTTTATATGTGCCTCTTTCCTAGTGTTTATTATGCACTTGTCTTATTCCCCATTTCCTCTTTCAATATCAGTGTATAAACTCCTGAAATCTGGAATTCTATTTGTATATTCCAATATATTGCAAATGACAGATAATCAATTGGTGTTTGCTGTATTGAGCTTTATTTAAACTTCCTTACTCTAAAGAATTATTTCCTTTTTTAGCCATTCTTGCTTCTTTAGCCTTTGTGCCTTTTATTTTCTTCCTACTTTTTAATGAAATCAATAAATATTTTCAAAATACAGCTTAATGTAACTGTATTTCTTATGATATCATGTAGAAATAAGACCATCATTCAGTAGAATTTCTTAGCTTTACAATGAAGAATAAAAAATGTAAATCAATTGCCAGAAAAAACTAGAAGTCATCATTAATTTGTTTGGTTCATTACAGTTTAAATTTTGAGGAGTTGAGATGTTACATTCAGATCGTGTTGTCCATTACATCTAGTATTGAAGCAAGTCATATGGTAATGATTTGTCTTATTTGGTATGAAAGTTTCATGGTTTATACTTACTTACGTTATAAGATTTCTTCAGAGATCGGACCATGAAAAGACTTGTAAAACAAAATTTCAGATTCAGCATTTTTATACATTTAATATAAATTACATGTTTTAAATGTGTGGAAACAGGAATAAACTATGAACTCCTCTGTGATTTCACCCAGTGTTTTTAAAGTACCTACCATTGGTCAGACACTTGTAGAAACTCAGGACACAAAACTAAATAAGAAATGATTTTTTTCTTGAGAAATTCATAATTTAGAGAGGACAGATACATAAGCAACTAGCTTGTTAAAGCAGTAATTATTTCTGCTAATGGATGATAAGAGTGGAGGCAATGGGGTGAAACTTCATAGAATGGGCGACATTTGCCAACACAGTGATTTTTAATATATAGAAATCCTCAATGTAGTAGAAACATTGATGACTCGTACATTTTGTTTAGCAAATTTTTATGTAGTCAAAATATCAGATTCCCAGGAAATAATCATTAAAAGACCAAGTAAAATGCTTTTGAAGAAGAAGGAATTGGGTTAGAGACTATCCTGGTGGTATACTGTTCTAAGAATTTCCTATTAATTCAACAGTTATTTTTTCTTCACAAAACTTTTCTGATTCCAGTATTTCTCCTAATTATCAGTTATGCATACTTAGAATAAGGGATTTCTTTGGTACCTTCTCAATATGGGTAAAAACAATCATAGACATTTCATGATTTCAAAATCATGTTCTTAAATTTGATATTTTATATTTACTTCTGCAAAGATTTTCCCATTGTGTGAATATGTTTAAAGGACTCATACTGTACATCTCTTGTTCCAAAG
>TTN-214,,0,535,2940961,2941495,GCAAGTAACATAGGATTTGTCCTTTTCAAATCATATTACAATCTTGATCGTTATCGTTTTAAAAGACAAACGATATGGCCATTTTGGATACCATAAATTTTCATTTCATAAAGTCATTCTAGATCCTCTAAACCTTCCTGAGACACATTCCACAAGGTACAAAATTGCTTATCAAATGCGTTTATGCAAAAAAGCCATTTCTTAGGTTAAAGCTCTGTGAAACAGCTAAATCAGACACTGATTCTCCATTCGTCTTTCACCCTTCTCCAATCAGTCTATTATGCTGCTAATACATAGCTATGCAAACTTCATACTACTAAAGCATAGAAAAATCATTTCACGATGTACATGTCCAGTTGGATCCCAGGTTCCCCTAAATAATCTCAGGTGTTTTTTAAAACAGAGGTGCTGCATAACTGTAAAATGTTTGGTAGCCATTCTTTTGCAGGGTGAGTAAGCAATGATCTTGTTCAGGACTTCTTTTCCTTGATGATGTCATCTATATTTTCTAACCCAATCATAAATTTGTCTTTAG
>TTN-214,,0,91,2941496,2941586,GTAAGTTGATTTAGAAACACTTTTCAAGCAGTCAGCCCATGGTTACCATTAAGTTAACCCTATCACTGAATTGCTCCAATTTTCCTCTTAG
>TTN-214,,0,120,2941587,2941706,GTAAGTATCAGGCAGCCCCCTACAGCCCTTTCCTTAATGAACCCCATGTATCTATTTGTTTGGTTTCATCTACTTTTTAAACAAATTGTATTAACTGAAGTGCTCTTTGATTTTACCAAG
>TTN-214,,0,745,2941707,2942451,GTAAGTTAAAAAATATATATATATATATACACATATATATAAAATATCAAATATTCAGTAGATTCATTGATATTCTATATCCTACACTTTGCTGACCACTCAAAAATCCTTGATTGGGTGGGCAGGGTGGCTCAAGCCTGTAATCCCAGCACTTTGGGAGGCCAAGGCAGGAGAATCACTTGAGATCAAGATTTTGAGACCAGGCTGGGAAATACAATGAGATCCTGCCTCTAGCAAAGACAAAAGGAAAAAAAAAAATTAGCTGGGCATGGTGGCACACACTTGTAGTCCCAGCTACTCAGGAGGCTGAGGTGGGAAGATCGCTTGGGCCCAGAAGGCCAAGGCTGCAGTGAGCCACAATCACGGCACTGCACTGCAGCCTGGGCGACAAAGTGAGAACCTGCCTCAAAAAATAAAGAAAAAAAATTGTTAATTGAAACATCTAGTATGTGGTTACACTGAGTAAAGCACTAGTATCTCCACCTGGATAAAATGTTCCAGTTAGAGTAGCATTGAAAGGCTACCTGGAAAGATGCCTCAGTGTCTATCACTTGATCTTTCTGTTCCTCTGTGAGTTGGCACTGTCCTGTATAGTACATGGAAGGTATCAAAGCTTATATCTCTAAACTGTAATCTCCTCAACAGACGCACTAAAAACATTCCAAATTTTTATTCTGCACCTGTTATAACCCACATCATATTTACGTAAAGTCTCCTTGGGTGTTTTTTCTTTTCTCCTTTGCAG
>TTN-214,,0,517,2942452,2942968,GTATGGTTTCATACATATTAGATCCATAGAAAAAATGTCATACATGCTTTATAAAATTTAGTGTATCAATTAATGAATGGATAAATAAAATGTGGGATAGCCATACGATGGGATATCATTCAGCAATAAAAAGGAAGCACTACGATATGCTACAACATGGATGAACCTTTAAAACTTTATGCTAAGTGAAAGAAGCCAGAGACCATACAAAGACCACATATTGTATGATTCCATTTATATGAAATGTCCAAGATACACAAATCTATAGAGATGTAGATTGGTGGTTGCTTAGGTCTACAGGGGAGACAATAGAAAAGTCCTTGGGGTGATGGCTAAGGGTTACATGATTTCTTCTTGGGGAATGAGAATGTTCTAAAATTATGGTGATGGCTACACAATGATGAATACATGGAAATTCATTGAATTGTATACTTTAAATTGGTGGATTGTACAGTATGTGAATTATATCTCAATAAAGCTGTTAAAAATGTTAATTTTTCTACATGCTATTTTCCAG
>TTN-214,,0,89,2942969,2943057,GTCAGTTGTTTTGTCTTGCTACATTCCAGTAATTCCCAGTTTCCTCTGAATCACCATACGGTAAACTCGAATTTCCATTTCATCCATAG
>TTN-214,,0,1146,2943058,2944203,GTATTGTCTACATACTAAATGTTTTGAAAAATCATCAGTAGTCCATAATCTATCATTTTATATTTTAATGTTTCCCTTTTACATTTTCTAACCACCATCCTTTAAAGAATTAAATCAGCTCATTCTTACTTGGCTTAGACTCTCTTATGCTGACCTCAATTTAGTCACAGTTTCCACTCAGGGAATAAGGGTGTCCCTAGCAGCTGTCTAAATACGTTAATTAAAGCAGCTGTAGAAATTTCACTGTCTAATAAATGGCTGCTTGCCAAGCAGCACCAACCAGAAAAGAATTAAAATGTAAATCGTGAGGTTCACACATCAATTAGAATTAAGGAAATTTAGAACAAGGTGATATTTTCTCAGAAGGTTTCTATCTGTGGAGAGGCAAGTGTCAAGGAACTTAGTGGCTAGAAATACTTTCTGTGAAGTCTAAGAGAAAGCCCTGTCCAAGCCGTGCTGGGTTCCTGGCAAGGATGCTGGGCACTCTTGCTGTCGGCTGCATTTACAGAGCTTGTCCTCATAAGTGTCCACCATCCCAAATGATATAATGGAGGAAACATGTCTAGAGAAATACCAGTTGAGTTCAGCTTTATCATATTGCTCATCCAAAGAAAACCAGGCTTTACAGACTGTGGACTATAATGAAAAAGGCTTCAATGAGGACTCAGATAACCTGGAGATGTCTTCCATCATTTATTTGCCAATTCTGAACCTCAGTGTTCTCACTCTTAAAATGAGGATAATAATTCCTACCTAGCCCACAAAGTTATTATTCATATAAAATGAAATCAAATTAAGTAATAACTTTTTAGACAATAAAAAGCCCCCAAAGGTAAAGCATCATTATATCCCTTATTAGTAAATAAGAAGCAAACATTTAAGGATGAAATAATTGTCTCTTTGGGGCAGCTCCTTTCCTCCATGCAGCTGTAAACACAATTCTCTACAAGAGAAGTTTATGTACCATTTGTCCAATACTAGGCAGGAAAAATTAGAGAGTGCTATAATCAGCCAACTTATTACATTATAATATATTGGTTTCACATGCCATTCATTGACCAGTTTTAGAAATTGATTAACTGGGAGGAAACCAGAGCTTCAAGTTTTTGTTGTTGTTGTTGTTTTTTTATGTTGTTCCATCAACAG
>TTN-214,,0,1569,2944204,2945772,GTATGTAGGGACAGATTTCAGCATATTTTGTGGATCCATCAGAAATAATCCTCCTGTTTAAGTCACTAAATTCTTGTAACTTGAAGGAAATTTCTAAAGAACCTATGGTATTCATGTGGTTCCAGCTACATTTTTTTTCACATTATATCTATGGAAAAGGGAGGGCAGCTGTTAAAAGACCTATTGAGAAGTTATTTTCAGAAAGCACCTGATGGCCAGATCCTCATCTGGTTGCTCAAAACTATTGAACACCCATTGGGTGTCCATTTTCATATACCCCAGATGAGCTTCTAGATTCGCTGTTAAACTATTTTAGTTCTCTGCCCTCTGCCTGAACTGCTCAAGTCCTAGCAGCACTACCAAGTGAAAGGGGTGTTTCCAGCCTCTGATATGGAGTGCCTGGGAGAACTCAAAAGTCCTCTTTGAGACCCTGGAAGGCCTAGAGAGCCTCAGGCAATGTGGAACTCGATCCTCTCTACCCCAAGCTCTAAGAACAGGGGCTCTTACTTTGGACAGGGAATTCCACATGCTACCAAGCACTCCTGAGGAGCCTCTGAGCAGTCCCCAGGGAAGTGCTGTTAAACCTCTGCTCTCCTCATTAGAAATCTTAAGGCTGAATCTCAAGCTGACCTTGTTTTGAGTCTAACCTAGATGCAAGAGAAAAATGGAACCTCCCTTCCTATTCTCATCCTAGGCCATATCTCTTTGAATAAAATACCCCTGAGGCAGATGCAGGAACTCCAGGGGTAATCTCAAGATTCACAAAGATGAACCATATCGCCAGCATTCCCTAGGTTCCTAGAAGACCAAATGGTCATGGCATCCAGTTCTTATTATCTCTGTATTAGTAGTGGAGAAACTGAGGCACAGAAAAGTAAAGATCTTTTCTATGATAGTGTCAGAAACCAGCCTCACAGAAGTCATTTCTTCTAATTTCTGGGTTCCATGAACTAACCAGGTCCCCTCACTCATCACAGCACTGAGAATATGCTTTAGTTAGCAAAACAGGAAAGCTGAATTTGTTAAGTCTACCTAATGGCATTTAACTAGATCTGAAATAGTGTTAATTCAGTCATTCATTCAATACTTACTGATTGCATTTTACTGGCACTGGTACATAACAAAATGACTATGACATAAACACAAATACTTGCAAAACAAACAAACTGGAATGATATGAGCCTCTTCACCACATGATTTGTCCAAATGAATTTTAAAAATAGGTAGCACACGGAAGTTATTGTATAATTCATTCAGGTGTCCATCGCTAAGCCCCCACCACAAACAGAAACTGGGATAATCAGGTTAACTCGGCACTCTCAGCATGCCCCCCAAATATCAAAAATATCTTTCTGAAGCTATTCCCTCTGCATGTGGACAAATTCCAAGTGCTTTCTTCATTCTTAGCACAAAGAATGTTCTAATATTCTGAGGCAAGTAAAAATACCACAATTCCAAAATTTTGTCTCTGGATGTATAACTAGCCAGCAACAAATTAATGTAGAGTTTTGCATGCTCTCTTGTGTTTTTACACTTTTTCATGGGCTATTTGTCAACATTTACTCCTAG
>TTN-214,,0,224,2945773,2945996,GTAGGAATGCCTCGCTACTTCCAGCTGAAAATAAAACCTAAGAAGCAGGCTTTTGTCCTTTCCCAGTGCATTTAAAAATACAATTTGGAGCTCATAAAAGTAGATTGCTACCCAACTTTGAAAGCACTCTGCAGTGAAATAAATTAAGATAAACCTACATGCTCCCTTCTGTGAGGTCTCTATGGTGACTTAATCATGACAAATCTTGTGGTTTCTTTCTTTAG
>TTN-214,,0,5004,2945997,2951000,GTAGGTTTAAGAACAAAAGGTGTCATTGCCAATACTTACAAATAATTACATGGGAAAAACATTCTGTCAGCTTCTCCTCCATCACAAACATCTCTCATGCATAATTTGAAGCTTAATGGAAATCTAACAGAAAACTTATTTCAATTATTAAATTAAGAATTAGATAAGTGTTTTTCACTATTTTGTGCCCTTAATAATGGTTGTTTATGTTATGTTATGTGTTCTTTATCACAATAAAAAAATTAGTGTTTTTCACTAATATTAAAAAAGGTCATGTTCCCTTTATGATTGTAGCTGCACTTTAATTTCTTCATTGATAAAATACAATGACAAAACTAAAATTATTAGATTATAATAGCATCTACATATAATTCAAAAGAATAATACATTTATATAAGACATTATTCAGTCTATGGACAATGCTTGTGTGAAAGGTATCCTTTGGAAGACAATATCCTATAGTGGTCAAAAGTCGGGGCTTCATTGTCAAAGATGCTGAATTTGAATCTTGCCTTCAATATATATCATGTCTCTCGTTCTCCTTCTGTCATGAATACATTGAGTATATGATTGCATTCAATCCTAGAAAATATATTTTATGAGGCTAGGAATTCCGTTTTAGTGCCTAGAATTTGGCATCTGAAAAATAGTACCTGCTAGAAGGTAAGCTCTATGAAAACAAGAGTGGATGGTTGCCCCAGAATATCACCTGATACATAGTAGATACTCCATAAGTAATTGTTGACTGGACTAATTAATGATGGTTAAATGACTGTTACCAAACACTTAAGATTATTATCAAGATTAAGTTAGGTAACTCAAGTCAGCACATAGCACAGTGCTCATCATACAGTAATCAATCAGAGTTAGCTGCTACCATTTTTAATTGGGGCATGCTTCTCAAGTACCACCAGCCAATTTCCTCATCCCAGGAATCTGATCTTGGTAGAATGAGACAATATATGTGGAACCACTTCAAGTCATAACTGATTGTCTATAATCACAATTATTTGAGAGTTTCCCAGCCAAAGGGAAACTCTCAAAGCTTGGGCATCTCCCAGCCCTCTTATTAGGCTGATGCAAAAGTAATTGCAAAGTTGTATTGTTTTGTTTATTATGCTTCTCCCATTAGTTTATAATCCAATCTCTACCTTGTCAAGATTTATTTTTCTCAACAGGTTAGTACTTCAGTTGGTCTTCTGACCCAATTATTTCCTCCTCAGGAATGGAGATGGTGATCTAGAAATCTAATAGACCTATTTGATTTTATGAGCATAATTAAAAGATATAATGTATGTAAAGCACCTATAGGCATGGCTGCCAGGTAACTGGGGCTCAATACATTCATTTTATTATAGCCATAGAGAGGAATTATATAAACATCAATGTTTAGTATTGTATGGCCAGTATGGACAAATACCATAGACTGTATATTTGAGGGATAGTGTTCAAGAAATGCTAAATATTAATAAATGAGGACTGATTTGATAATATCCTACTAACACAATAATACAAAATATATTTTAAAAGCAAGTTCATTAAAGCTACACTAAATAATTTATCCATTTATTTAATTTTTAGAGGAATTTTTTAATATAAACATATATGTACATCATTCAAAGTAGTAATATTTGTCTTAACTATATTGGTATAGTGCTTTTAAGTCTATAACATATTAACATATGGTAGTATTGCCTTTAAAGTGTTGTAGAAATACACCTGAAGCACTCTACAAGACACCAATTGGGGTAGAAAGAGAAAAATTTCACTATCTTTTCTGCATAACCAATGTCTTTAAAAAGGTTTGAATAGGCTTTGTAAACTGAGAAGATCATTAACTTCCTATGTGTGGTAATATCTGTACACATATAGTGGTTTTAGCATCCTCTTATAAATTTGTTTTCTATATGAAAGAAATTAAATTCATTAAATAGAATGACCCTTCAAAAACTTGCCAACTCACATAGTTTCATACCACTGGGACTAAAAATATTTACAGAACTTCCTCTGGCCAGGTATTGCCTTAAGTAAGTGTAGCCCTGCTTTCCACAAATTGGAAAGAAATTGGGAGTCTTCAGAAGCTCCCATGTTCTTGGGGGTTGTAATACTTTCTGAAGCATGAAACGTGGCCCTGAGCAACCAGGTGCTGTTTCTAACAGCGAAAATGTTACCTATTGAAGGTCTCCAGTGCCACCTACTGGTAGAGGAGTAATTTGGAAAAGCAGAATCTTAAAATGTAAAAAAGCTATTTTTTTGCTGTTTATTCTACAGATGATGAGTCAGTGTCATTTGGAGGCTTACAGAGTGACAGCTAGCTAAACAGAAATGATGAATAATTAGTTTAACAATGATATTGTCTGTTATTCATTTAAGCATCTGTGCAATTTTAATTCTACCATTTATTGTTTCCCTGCTATTGAGATATTACCCTAGGTGCTGGGGTGCAGATCTTGCTCTTGCCTTTAAGGAGCTTGACATGTAGGTGAGGAGATGCATGCACACAACTATATCCCAAGGTTGTAAGTGCTATTAACAGGCCCACGTACTCATCATTCTCTGTCTGGGAGAGAGCCAGAGAAAGATGTGTGAACTGAGCATTGAAAAATATGTAGGATCATTGAACACAGTGGCATCCTATGATGAGAAAACAACATCTCCAAGTCATCAAAACTTGCAATAATGCTTCATGTGCTAGAAGCAAGTGGTTTAAGTACAGTTGGAAAGTGATATCATGAGTGGGTAAGAAGGCTGGATAATACAGCAAAGGCCGTGCTAAAGTTTTTGGTATTCTATGCTGAAGATTTTGGAATTGATCTTGTTTACATTTAGGAGACACTGCAGGATTTTTAAGCCCCTGGGTACCATGATCAGGTTTACTTTTTAGAAGTGATACTGTGATAGGGAAAGAAGGGATGGACAGATGTGGGAGGCAAGACTGGCAGTCAGGAACTGGAGAGAGATTATTACAATAGGCCTGGAGAGCGTGGATGAGGCCCTCAGCCAGGGCAGTCAGGAGAGACAAGTGGGGTATTGCAGAAGTAGTAATATGGGAGAAGAATGGCCTCAAAGAAGACACGAGAGGCTAATGAGTAACGCAGATCATGGCATCACAGCCACAAGCACCAAGTCCACTACCAAGAAAAGTTTTACCTGTTAACTCACTTATTGTGTGCAGTTCATGTCCAGTGGCAGTTCATGTGTATCCTGGTGCCTCATTCAGTTCACCAAAGGAAGAAGCTGTCAGTAGAAATAAGCAGAGAACCTTGTAAGAGGATGTACCATTGATGATCTCACACACACACACACACACACACACACACACACACACCCCTTCACACAAACTAAATAGGGGTGGTGTTTCATGTTATATCACATGGCACTGTCTTTTGGCGTGTTATTGAAGACAACGTTGCTTCCATCTGTGATGTTAGATATTCTTGCTATAATGACTGACTTGTGCCAGTGGCTTATAAAGCCCTTCCATGTGTGTTATATCATTTAATTCTCACAGCAATTATATGCAACGAATAGCCCATAAATTATTACGCATGCCATTTTACAAATGAAAAGACTAATCCAGAAAGCTTAAATGACATTTCCAAGGCCACACAGCTGACAAGTTGTAGTGTCAAGATTTCATTTTCTTTATATGTATATATTTTGATGGAGTCTTGCTCTGTCACCAGGCTGGAGATCTCGGCTCACTGCAACCTCCCCCTCCCGGGTTCAAGCTATTCTCCTGCCTGAGCCTCCTGAATAGCTGGGATTATAGGTGTGTGCCACCACACCTGGCTAATTTTTGTATTTTCAGGAGAGACTAGGTTTCACCACGTTCGTCAGGCTGTTCTCGAACTCCTGACCTCGTGATCTGCCCGCCTCAGCCTCCCAAAGTGCTGGGATTACAGGTGTGAAGCACCGCGCCTGGCCAGGATTTCATCTTCTACTTTACCTTACTATCTAAGGAACTGAACAGATTTGTTACTCTAAGAGGAGAACCTGCCATTTATACACATCTACCATCATGGGCAGGAGAGTAACTTTTATAGACAAGTATTGGCATTAAAATGCAGACAAATGCTAGATGATTGGACTATTAGAAGATCATCTTGGATGGTTTTGAGACCAAGAAGTGGTATAGTGACTGTGCTCCAAAAACAAGATGGCTTTGATTTTGGCTATTCAAACAGTTAACTAAAATTAAAGTGCATATCACCTACAATTATTACAACACAATAACCTGCTACTTTACTGTAATTTGGGTTTTTACTTTCTATTATTTTAAGATGGTTCAAATCCTTATATAGAAATAGCTAGCTTTATTATAATGTCTTATAACTGCCACTCTGAAAAGAGTCAAATGTATCTAAGATGCTCAAATACCATAATAAATCACCCTCTTTATTTAAAAAATTATTTTCTCTACAATTATTTGTGCCATATATACTGCGTACTGAAACCTTTTGCTCATTAGTAACAAAGATAGAGATTTTTTTTCTACAGCCTTCAAAGGTATCTATTTTAGACTTTTCATATCTTGATCTTCTCAGCTCTCTTTTTGATTGATTTTTCTGCAAACCAAAAGTGGAGATTTTTCTCATTTCCTGTCCCAGAAGGCAACTACAAGCCCAGATCAAACCTTTCCTGATGACTCTTCTTAGGACTGTCTTTTTCTCAAAGTCACTGAATATGTCAAAATCTTGTCTCTGCTTCCACTGCATGACATGCAAATGTCTAAAGAGAATGTAACTGAAGTTCTATCATTTTAAACATTACAACCAGTTCAACCTTAGGACAAGCTATATTTTTCTATCATTACATTTCCTTCTTGAAGATGAAAGGAAATCATTTAACAATAGTAGATATGGCATGCCCAGAGAAAAGTATCATGTTATTAAGTCAAATATGAAATGTAGGCACTAGTATTATTAACATTGTGTTTGCAGGTAAATTGTAAAAATCCACTCATTTTTGTGGTTGAAGTATCTCTTTTCTTTTGTGTCGCAG
>TTN-214,,0,5803,2951001,2956803,GTAAAGTAAAACAACTTTCAGAACCCCATTTAAATATAGATCGAATCTTAACAATGTCTGTAACAATTACTCAAGAGTTCATGTAAATCATTGTTGTTCCTACCATTCTCTTCTAATTCAACTAATTATTTCCCTGTTATATGCCATGGTCTCGCCTCTCCTTTACCACTTTTCATTGTGAATCATAGACCATCACGTTTCATTTGGCCCCGCTTTTTCTCTGTAACAATTTGTAATGTATTGCTGCTGTCACCAGCTGTCATGCTTCCTAATCAGCATGAATCAGAAGGGGGCGAAATATGCTGCATAAATAGGTAGATTTGTTTTCTCAATTGGCTAAGATAAAAATTAAATTTTAAAAACATCTAAGAGTGTTATCATCCTCCTATCATGCTGACACAATTTTGATTTCACAAAAGCTAGACCGTTTCAGGTCTGTACACCAGCGAGCTATATTCATCCTCCTCTCAAGAATGTCTTAGTGTTAAGAAGTCCAGTCCTAAAGTGGTTTAACATTTCTGTTAGTTGGGGCTCTTAAATTGTAATCAGAAACACTTCCTCAGTAACATGGGGAATTTGATTCAAACAAGGATAGCATTTTTATATAGTGGTACTATTTTTCCTGAGCAAATATAGTCTATGTAGTATTAAGTACATACAAATACATAAGGATTTAGAGAAACTATTTTTTTCTTAACCTTATGCATTAACTGTAACTAGATGTTTTTTTAAATAATGAATTTAAAGTGGTTTAAAATTAAAAAGTTGACTTTACAACAAGAGGAAGAAAGAAAAGAATATCCAAAACCCTGTTGGGTACTCCACTATTGCCTTCATGAACAATGTAGTGAAGTTCCTTAGCCCATTCATGTCTCAGCTTGCTTCTCTGGGAAATGGAAGTGAACTTGTGTGACTTCGAGTCAATAGTGACATACAAGGACAAGGCAGTAGGAGTGGACTGAATTCTAGTCCATTATTGAAATTTGTGACAAATCTGTAGACAACTCCAAATGAGTTCTGGTTTCAGTGCAAGGTAAGACATTAAAAATTGGTATGCTTCTTTTCAGGATTTAGCAAATTTGAAGAAAATACATCAAACTCCCAATGGCATGTCTCTTTATCAGTTTCATTTAAGAAGGAGCCCCTTGGCCAAAAGCCCAGCTTCATCCAGCCTCTGTCAAGCCTCAGGGTGCACAACGGGGAGACAGTCAGATTTCATGCGAGGGTTTCTGGCATTCCCAAGCCAGAAATCCAATGGTTTCATAACCAGCAGCTAATTCTACCAACAAAAGATGTAGTTTTCCATTTTGAGGAGTCCACAGGCATGGCTTTAATGCTTATAGTTGATGCTTACTCAGAGCATGCTGGGCAGTACTCTTGCAAAGCAGCCAATAGTGCTGGGGAAGCCACTTGTGCAGCTACACTCACAGTGACTCCAAAAGGTAAAGCCCATCTTGCTTCAAGGACTTTGATTTGCTGTATACCTCTCAGTCCCACTGTTACTAATGAGAGTCTCTGCTGTTTGTTTTATTGCATACTGTGGTCAGTCCATAACTTACTAATAAAATAACATGCAATAACTCCCGCTAGGTCCTCAATTATGGGTTAACCTACATACTTTAAATTTCACTGAAGTATGTGTTCTATGCACTAGAGAACCAATAATTATTTTATTAGGCACCACCTTTGCTTGGCTTCTTTACTCTTCTAAGCAATATTGTATCATTGCATCATTAAATGATCTATTTGCTGATTATTACTTACTGTACTTAAAGTAAGTACAGTATTACTTACTGTACTTAAAGTAAGTACAGTATTACTTACTGTACTTAAAGCATACAGTGGACGGAGAGCAAATGCTAACCCAAATACAGTCAGCTAGAGGGAGAGAGAGAAAGACAGACTGGGTCACTTTGGATAGCTGAAATGACAACAGAAAGAAGGAACCAGATACTGCATGGCATCTGCATGAGTCTTCATCAACCACTCAGCACTGAATCACCAGGAATGAATTTTCTTTTGTGTGATCCTGACATCTAGATCATATTGCATCTGGCATGCTGCTTTCAAGTGACAACTACGTCTTTCATCTTCATCTTCCATGCCATTTTGTGTTACTAACATGGGCAAGTGACAAAGCTTAGATCTTAATATTCTTTTCTTTTTCTTGTCACTTGATTATACAGTGCAAGCCCTAGATAGGCAAAGTTCTGGGAAAGATGTAAGAGAGTCCACCAAGTCCCAGGCAGTGGCAGATTCCTCTTTCACAAAGGAGGAGAGCAAAATATCTCAAAAGGAAATTAAGTCATTTCAAGGATCATCATATGAATATGAAGTGCAGGTTTTTGAAAGTGTATCTCAAAGTTCCATCCACACAGCTGCATCTGTTCAAGATACACAGTTGTGCCATACTGCATCCCTTTCACAAATTGCAGAAAGCACTGAGCTATCTAAGGAATGTGCTAAAGAGTCCACGGGTGAGGCGCCCAAGATTTTCCTGCATCTTCAGGACGTCACTGTAAAGTGCGGTGACACGGCTCAATTCCTCTGTGTTTTAAAAGATGATTCTTTCATTGATGTAACCTGGACTCACGAAGGTGCAAAGATAGAGGAATCCGAGAGACTGAAACAATCACAAAATGGAAATATTCAGTTTCTTACCATATGTAATGTTCAGCTGGTAGACCAAGGACTATACAGCTGCATTGTACACAATGACTGTGGAGAGAGGACAACGTCAGCAGTACTAAGTGTAGAAGGTGGTTAATTGATTTTTAGCTATGACTTGCTTCATTTCATCCTCATCGCTTTATGCAGCTTTTCTGCCATGCAAATTCAATCGACGAATATATTAATTAGAATATCTCTAAATTAGCACCCTATTCATAAGTGACTTCTGAAAGTCAGCCAAGTCATTGGCCATGATTATCCTGAAAATTTAACTTACCAGTCTAGATTCAGAAAGTTTAATTTTTAAACGTAGGTTCGGGAAGCAAAGGTTTATTTCCTATGTGCTGCATTTTCTAATATTTACCAACGCACTACCAAGAAAGTGTAGCAAAGTTAAAATGTTGTATTCTGAGAAGTACTTATTGGGTATTTATTATTGTGCCAGATACTGTGGTAAATTTCAGTTTAATTGTTTTAATAGCAAGAGGTTCAACAATTCTTATCTCCTCTTTATTTTCACATCTGGAGGTTCTAGTTGTTTACAAAGGGGCCATGAAAATAGAAAATTGGGACCAAGTACAGTGACTCATGCCTGTAATCCCAGCACTTTGGGAGGCCGAGGCAGCCAGATCACTTGAGGTCAGGAGTTTGAGACCAGCCTGGCTAATATGGTGAAACCCCATCTCTACTAAAAATACAAAAATTAGCCAGGCATGTTGGATGTTGGTGCATGCCTGTAATCCCAACTACTCAGGAGGCTGAGGCCAGGAGAATCGCTTGAACCCAGGAGGCAGAGGTTGCAGTGAGCCGAAATAGGGTCACTGTACTCCAGCCTGGGCAACAGAACTAGACTCCATCTCCAAAAAAGAAAAATAGAAAATTGAAAATTGGGCACTGAAAATAACAAAGCTCTCTCTGGACCAAAATTAGAAGTCTCTAGATATTTCTCCATAAATGATGCTGCTTTTACAGGCTTAAAATCCTCCTGGAATTGTATAATTTTCTCATGGCAAGATCACAATTTTTGTCGTTATTGGGCTTGATTCTCCATTATGTCTGGAAGAGCAGGAATAAACTTGTCTGGGCAAGTAATAACTTCTTCCTCTTATCCATGGACTTTCCTTTTGGATATTAATGAAATGAGAAAAATATTTTTCAGGTGCCATAAGCCTGTGTTGTGTGCCCGTAGTCAAAACAGCTTCACTGAGTCTCATGGAAGGAAGCTGGTGGAATAAATTCAGGCATCTCCAGGGGTCTGTGGAAAGCTCTGGCCTCAAGTTCCTCCCTGATCCTGGCCATAGTGGTGTTAGGGATGAAAAGGGGGCAATGCAGTGCTATGTAGGTGCACAGCCATCTCTGCACAGAATTTTGAAACAGTGGCCTTTCTTCCTACCCAGTACAGAGAATACAGTTTATTGATTCATATAATGTATCCGCAACACCTACTCACCAAAAAGAGGTCTTATTCTTTCTTAATGAGATTTTGTTCTATAGCTATCTCTCATTCTGTCACCGTAGCCTACAAAGGCAATATCTCAAGAACTGAGGTCTAGTTATGTAAATTAGATAGAAAATTCCACCAGCCAGAGAGTTGACCCTCAATTTCACTACAGCTGCTGGCTAGCACAGTAATCACACAGAGTCACTATTTATTTGGAGGTGTTGTCTACAAGTCCTGTAGGTGACAGTGTGACAATTTTTTCAGTAATGTAATTGGGAGTTGGCTGTGTTGTGAAGGTGGGAGAAATGTAGATCTCTTAACTCACTTCCTAAAGAATCTAGTGCTATAGTGCGGTGTTTGACTGTCATATTCCCAGAATTGATTTGAACTCGGCTCTTTTGCCCTAGGATCTCCAGTTCATTCAGTTCCAATTGATAATATTATTAAAGTGTTCTTGAAGCAAAAGAATTTTTTTGAACATCCAACTGCCTTACTTGTACCTAAGAAAGTTGAAAGATAAGACATTTTTAGATGTTTGAAGAGTGAAAGATCAGGCACAGTTGTCTAATTATTTGACATAGGCCAGTCTTTATATGTTCCTTTTTTATTTTGGCTTAATAAGTTCATATAGGCTACAGAGTTATCCACCAAGATCAAGTAGGAATGTCAAACCCCTGGAAGTCTTTTTGAATACAGTTATTATGTGCATAATAAACATAAACATATCATATATAAGTTTCATGACTAACATGCTGCCTTTCCTTCTCATCCTAATGACATTCCATCTTCTCCACATTCAGCATGTTTTTCATTCTTACAAACACAGCTAATTTATGCCTTTCCCTAACTTTATTCTTACCTAGCAAAAGAATCGCAAGCCAGAGCACTTACAAAAATTACTCTGGGTTCTGACACTAAAAGTATTAAAACACTCAGAGAGTCACAAATTAAAACAACCCGTGAAGTAAAAAGAGAATCGTCAAAGAAAACATCAAGTTTGTCATTAACTTCATGCCAAAAACCGTAAGAAACTGAGAACAAGGGAATAAAGTCTACTGACAGGATACCACGTGGACTGAAGACTGAGAGTGATACGAGAGCCCCAGCCTTTCCCAAGGAGCTGCCCTAGATATGACTGTGTCTAAAAGCTGTGCATATTCCTTGTGGAATAAAAACAGTTTTGATAAGTCTTTGTTTTGTTTCTTAATATGTAATTTGGACTTCATGTAGTTCAAAGTTTGAAAGGTGATTCAAATCAAAGGAGTGTTTACTAGCAGGAAAAACTGAGAATAGCCCTCTGCTAAAGTAGCAATTTAGAAAATGCATGTTCTTTCTAAATGTGATTTCATCTCTTAGCAAGTGTTTAGTCAATAGGACATTTTTTAGAAAATAATATTCCTTCGGTTTGTAGATTGCTTTCTGCATGCATGTAAAGGCATGGGGAATTATAGAACTAAAAGTGGAAATTTCATGAAGAACCTAAAATAAAAATGTTTTAAATCTTTCTGTCAACATTGTCATGTGTTTTATCAGCTCAATAGTTTGTTTGGCATGGACTTTTTGGTAAATTTGGGGAATGTAGTTTTCTGTTGTTATAATAAAAAGAAAACTTTAATCATACAAGTCATGAATTGATGCAGAAAATATATGCAATTAATCACTAAAATCTCTTTATATGTTTTTCTATTTTAG
>TTN-214,,0,11202,2956804,2968005,GTATTGTTATAATGGATGTGAGATTTAAGTAGAAATTCTAAAGGATTAATAGGATCCTTGAGTTGCCTTCTTTCTCTTAGTATTATTGAGAAAAAAATGACATAGATATACAAATATATCTCTTAGAGTATATATTACTATGTCGCATGCTTGGTTTAGAATTTTGATGGTTACATGCATTTCACAGTAATTTATTGTAAGTTAATTTAAAATTTTGTATTTAAAATTTATCAGCCAAATTCAACTTTATGTTTGCAGTCATTTCCAAAAGTGTATATTAGGAGAAGTTGTCATCTTAATGCATGAAATCATGAAGTAGAAGTTTGTTTTCAAAATCACGGTGAATTACATTGAAAATAGACAATAACCTAGCTGTCATTCTCAGAATGCAATGTCATGAATGAATTATGATTGAAATGCTACTTTACTGAGGTTGTGTGAAAACATTACATTCCCATCTGGTTTACACTTCATTCACATATATCATTTTAACATTGATATGTCTCTTACACTGGCTTGCAGATAGCTGCCTTATGTGATCCTTATTGCCTGCTTTTCTTTGCATAACATTGTGACTTTATGGCTGTATTAGTTCGAATAAACGCCTTCTCATTTTATTTTAGCTAATTATTTATGGTTATAGTTCTTGTATATACTCTTTAAATAGTTGATTCTCAAAAATATAATAATTTAATCTACAATCAAAAGAATCAGAAAGGGCGTTTATTCCACTCTCTGCAAGTCAGGTAAGATTTTCCACTTAGCCATCAAAAGAACAAAGTTTTCCTGCTCTCAAAACAAATATGCACAGGAACATGTTATTTTGAAATGCATTTTTGCTTGTTCAAGAAGAAATTTCAACAGTTTGAAGAAAAGACCAGACAACGAACGATTTTCGTGTCAGAATCTTTTAAACAGAGCATGGTGTTGCGTTTATTCGAACAAATATGGTGAGTGAATTTTTCTATGGATTTGTGAGATCTGTAGCATGCAATTTATTTCATTTCCTATTTTGCAATTTTATTTACTTTCAACTTTTTCAAGTTCTATGGAAAATAGTAAAGGTTTTTTTTTTTTTTTCCAGAATTATTCTCTGAGGGGGAATCTGAACATTCAGAAAGGGATACACGTGACGCCTTTTCAGATTCTGAAGACATAGACCACAAATCCATGGCTGCTAAAAGATATGCAAGTAGAATATCATCTACAAGCTCCTGGCCTGAATATTTTAAGCCTTCTTTTACCCAGAAACTTACATTTAAATATGTTTTAGAGGGTGAACCGGTTGTTTTTACATGTAGATTAATTGCCTGTCCAACTCCAGAAATGACTTGGTTTCATAACAATCGGCCCATCCCAACAGGTCTTCGTCGGATTATAAAAGCTGAGAGTGATTTACACCATCACTCTTCCAGCTTAGAGATTAAAAGGGTCCAAGACAGAGATTCTGGAAGTTATAGGTTACTAGCAATTAATAGTGAAGGGTCTGCAGAATCAACTGCATCATTGCTTGTTATCCAAAAAGGGCAAGATGAGAAATATTTAGAATTTCTGAAAAGAGCAGAACGGACACATGAAAATGTGGAGGCTTTAGTTGAAAGGGGAGAAGATAGGATAAAGGTTGACCTGAGGTTTACTGGCTCTCCCTTTAACAAAAAACAAGATGTGGAACAAAAGGGAATGATGAGAACTATACATTTTAAGACAATGAGTTCTGCCAAGAAAACAGATTACATGTATGATGAAGAATATTTAGAAAGTAAATCTGACATAAGAGGTTGGCTTAATGTAGGTGAAAGTTTCCTGGACAAGGAGACCAAAGTGAAGTTGCAACGTTTAAGGGAGGCTAGAAAAACATTAATGGAGAAAAAGAAATTATCTCTTTTAGATACGTCTTCTGAAATAAGCTCAAGAACTTTGAGAAGTGAAGCTAGTGATAAAGATATTCTGTTCTCTAGAGAGGACATGAAAATCAGATCTATGTCTGATCTAGCTGAAAGTTATAAGGTAGATCATTCAGCTGAGAGTATTGTGCAAAATCCACATGCCCTTTCTAATCAAATGGATCAAAATATAGAATCTGAGGAACTTCCCACAAGCTTTCAAACTATTGTTGATGAAGAAATTTTCCAGACTGAAATAAGAATGAGCCAAGAAGCACTGGTAAAGGAAAGTCTACCAAAAGACCATTTATATGGTGAAATTCTAGTAAATGAAAATACCCAAGCAAGAGGACAGCTGGAAGAAATTATGGCCAATACTACAATTGGAGAGTCATCCACATATATCACTAATGTATGTGAGAAGGAGGAAGTATATGAGACTCCTGAAAATGTGTCTCAAGCTATTACACCACATGCCAGCGAATCTTTTGGTACACTTGTAAATGTTGAAGAAAGTGAAGAAATAGCTAGTGAAAGAATAAAAAAGGATGATTTGAGAGAATTACAACTCTCTGCTTCTACACGAATTGATGAATTCAAAACCGAACAGAAGGAAGAAAACATGAGATTTTTTGAAAATTCTTTTCGAAAACGCCCACAACGTTGCCCACCTTCATTTCTTCAAGAAATTGAATCTCAAGAAGTTTATGAAGGTGACAGTTGTAATTTTGTGTGTCATTTTCAAGGATATCCTCAACCTATAGTGACGTGGTATAACAATGACATGCCAATCCCACGTAATCAAAACTTTATCATTCATTCGTTGGAAAACTATTCAATATTAACTCTTTCATCTGTTCATCATCAGAATGAAGGTTCTATTACTTGTGTGCTATTTAACCAATATGGAACAGTAAAAACAACCAGTATGCTTAAAGTGAAAGCAAAACAAAAACATGATGTCAAAGCACATAAAGTCCCAGTGTTCCATGACTACTTGGATGAGGAAGAAGAGTTAGCATTGGTGTTTGACCAAGCAAAAGGCGCCCATCCATCTATGAGTCAAGAGGGCCAAACAAATCTTCATTTGTTAAAAACTAACCCACCAGTTCCTCCCTCTGGAGACACAGAATTGCTTTCCTTTCCTGTAGAAATTCAGGTAACAGCAGCTACTCCTATCCCAGAACAGGATAAAGAGTCTAAAGAAGTGTTTCAAACTGAGGAGCTGGAACCTAAAGCAATGCCTCAAGATCAAGTTACTCAATCACCAAAACACAGATTTGTATTTTTGTCTGATATTACTAATGAACCACCAAAAATGTTACAAGAAATGCCAAAGCATGCCAGGTGTAGAGAAGGGGATTCCATCATTCTTGAATGTTTAATATCTGGTGAGCCCCAGCCAGTTGTAACATGGTTTCAAAATGGAGTCCTTTTAAAGCAGAACCAGAAGTTTCAGTTTGAAGAAGTTAATTGTAGCCACCAATTATATATTAAGGATGTTAATTCTCAAGATTCTGGAAAATATAAATGTGTTGCTGAAAACAATTCAGGGGCAGTTGAAAGTGTTTCAGATCTAACAGTGGAGCCTGTCACTTATAGAGAAAATAGTCAATTCGAAAATATTGGTGAAATTTATGGAAAATATTCCAGAGATCAGCAACTGCAAGACCAGGGAGAATCTGTAAGGGCACATTTTTATGATTATCCAGCTGGTCCCTTTACTCCCTGGACAAATGTAAAAGAATATTCAGTAAGGGACTATTTTCAAAGCCTTGAGACTATTGAGCAAATAGACCAGAAAGAGCAGGTGCGTTGCATACCTTCTAGAGAAAAAATTCCCAGATTTGTGCATGGTGCTTCAAGAACCATAAAAATCAGCAAGCCCATCAGGGCTGAATTCATACAATGTCAGGCTGAAGGGAAAGAGAGACATGTAAGTGAAAAATCAAAGCTGCACCAAGCAGAGGGTACTGTTTATCCATTTGTTGATGATTTCAGTGATGTCACTATTAAGAAAGAAATAAGAAATAATTTTGGAAAACTTGGTAGATCAGAAAAGGAAAATGTACAAGAATGTGCCCAAAGTGACTATTTACCAAATATTCACTCTGAGAGAATTTCTGACAGTTACAATACAAAAGATTCATCTGCCATTGTATATGAAGAATCCCTTGGTGAAGAGATACACTACCCGGGGAAAAAGGTGAAGCATAGAATTATCGAATTTGAAAAATTACATGTAGAAAAAGGAGTTCTAGAAAAAAGACCTACCAGAACATCAATTGTTAATCCTCCTCAAAAGAAGATTGATGACAAAGCCTTTTCATTAAAGCAAAGAGAATCAAGATCAAGCAATCTAAATGCAAATATGTATCAGGCAGAGAAAATGTCTCCAAATACTGAATCAGATTCATCTAACATTGCAATAAATTTAAAGCTGCTTTCCTCTCAAACTCATAAAGAATTTGACGCACAAGAAAGGGAACAACAGGAAAAAATAAGTCTTATAGATAAACCTGCAATTTCTAAAAGAGCTGAACATGAATCACCTATTACATTTGACTTAAAGCAGTTTCACACTCAAATAAAACACACAGATGTGAAATTCCAAGAATTAGATAGTGGTCAACCAGAAGAAGCTTATTTTAAAATCCAACATCCTGCTGACACTGAGAACATTGTATTTGATCTAAAACAAATGTATTCTCATATAGGAGATCCAGCTCTGGAGTTCCAAGGGCAAGAAACTAGGGAACAGCAGGAAATACATTATAAAGAAAAAATTCCTAGCCCTGAAACGTTACAACCTGACACACACAATATCTCTAAAAGTGTGCAAAATAATGTATTTGCCAGTCAAGAAATTTCTTCCAGTCAAGAGCTTTCAAATAGAACTATGGTGGAGAAAAGTAGTATTGATGAAAATTCCATTTCTTTAGAAAAAGAAGTCCGACATGTACAGGAACAAAACTTAGACATTTTAAAAACTGATCTTTCTCTTAAATCCTTTTCTGAAGAAATCTATAGTGAATCATGTGCCCTACTTCCAACCTCATCTGCAGATATAGAAGAAACTGATCTTTCTGAGAAAAGTTGTCCTCTAGAAAATGGAGGCAGAAGTTCCATCTCACATTTGAAAAAAGCAGCAAGTGAGGAAAAGCCTTTAGGGGTTGGTGAAATGGAAGAAGAATGCACTCTAGAACCAGAGTTGGCAGCATTTCCAAAGCAGGATGGTGGGACACAGGAATATACAGATGCCACTTTGGAAGACCACAGAGGTGATGTTCAGGAAGCTGACACACTCCATAGACAGCTCTCCCTGAGTCAGTGCTTCCCACTCTTGATGACTGAAGAACAACAGAATCCAGGTGAACAAATAAGTACAAACATTCATGCCTCTGGAGAAGAAAAATGTTATGAAGAAGTTCAAGTTCAGAATGAAGCTTCTTTCTCCACTTTAGAAGGAGAAATGATAGAAACTAGTTTTTCTCAAAATATTCCTAAATTAGATGAGGCACATACCACTGAGGCAGCAGAATCTGAGACCTCCCTAACACAATATTTACTTGCTGCTGGAAAGCGTGAGGTTCCTGAAACTAAAGACACCAGAGACCAGGCAAAGCTTGTCCAGAGTGAATCAATCACTTCAATGGAGGTGGAAGAAGTAACTTTCAACACTGTGTATGAATACTACAACCAGAAACAGGAATCACTAGGTCGTCCACTTTCTCCTGAGTCTGACATTTCCATTGGTGTGGGAAGTACAACCAGTGAAGAAATATCTGAGTTAGATCAGTTTTATACCCCACCATCATCTGTTGAATATTTTGAATCTCCAAAGTCCCCTGACTTATATTTTAATCCTTCAGATATAACTAAACAATCCTCAATACATTCAGGAGGTGAGACAGTTGAAAGATATTCCACACCTTTAGGGGAAGTTGCTGAAAGATATTCAACACCTTCCGAAGGTGAGGTAGGAGAAAGATACTCCACACCCCCAGGGGAGACACTAGAGAGATACTCCACACCTCCAGGAGAGACTCTAGAGAGATACTCCACACCCCCAGGAGAGACTCTAGAGAGATATTCCACACCCCCAGGAGAGACTCTGGAGAGATACTCCACACCCCCAGGAGAGACTCTAGAGCGATATTCCACACCCCCAGGGGAGGCACTAGAGAGATATTCTATTCCTACTGGAGGACCAAACCCCACTGGTACTTTTAAAACATATCCATCAAAAATAGAAAGGGAAGACGGTACACCAAATGAGCATTTCTACACACCTACAGAAGAGAGGGGTTCAGCTTATGAAATATGGCGTTCCGATTCATTTGGTACACCCAATGAAGCCATTGAGCCAAAAGACAATGAAATGCCTCCATCTTTTATTGAACCTCTGACCAAAAGGAAGGTATATGAAAACACAACACTAGGCTTCATTGTTGAAGTTGAAGGTCTTCCAGTTCCTGGTGTGAAATGGTATCGAAATAAATCTTTACTAGAGCCAGATGAAAGAATCAAAATGGAAAGAGTGGGTAATGTGTGTTCACTGGAAATTTCTAACATTCAAAAAGGAGAAGGGGGAGAGTACATGTGTCATGCTGTAAACATCATAGGGGAAGCAAAGAGCTTTGCAAATGTAGACATAATGCCCCAGGAAGAAAGAGTGGTGGCACTACCACCTCCAGTAACACATCAGCATGTCATGGAGTTTGATTTGGAACACACCACATCATCAAGAACACCTTCTCCTCAAGAAATTGTCCTGGAAGTTGAATTAAGTGAAAAAGACGTTAAAGAATTTGAGAAGCAGGTGAAAATAGTGACAGTTCCCGAATTTACTCCTGACCATAAAAGTATGATTGTGAGTCTAGATGTTCTTCCATTTAATTTTGTAGATCCAAATATGGATTCAAGGGAGGGAGAAGACAAAGAACTAAAAATTGATTTAGAAGTATTTGAAATGCCTCCTCGCTTTATAATGCCTATTTGTGATTTTAAAATTCCAGAAAATTCAGATGCTGTATTCAAATGTTCAGTCATAGGGATCCCGACTCCCGAAGTTAAGTGGTATAAAGAATATATGTGTATTGAGCCAGATAATATTAAATACGTGATTAGCGAGGAGAAGGGAAGTCACACTCTTAAAATTCGAAATGTCTGTCTTTCTGATAGTGCAACATACAGGTGCAGAGCTGTGAATTGTGTAGGAGAGGCTATCTGTCGGGGATTCCTCACCATGGGAGATTCTGAAATATTTGCTGTGATAGCAAAGAAAAGCAAAGTGACTTTAAGCAGTTTAATGGAAGAATTGGTCTTAAAGAGCAACTACACAGACAGTTTTTTTGAATTTCAGGTGGTGGAAGGGCCTCCCAGGTTTATCAAAGGTATTTCTGACTGTTATGCACCAATAGGTACAGCAGCATATTTTCAGTGCTTAGTTCGTGGCTCTCCAAGACCCACGGTTTACTGGTACAAAGATGGAAAATTAGTCCAAGGAAGAAGGTTCACTGTTGAGGAAAGTGGCACAGGGTTCCATAACCTGTTTATAACAAGCTTAGTAAAGAGTGATGAAGGAGAGTATAGGTGTGTAGCTACAAACAAATCAGGAATGGCTGAGAGCTTTGCAGCACTCACCTTAACTTAAAATGTAATGTTTTAGTGCCTCAGTAATTATTAGCATTGATCTGAGTGCTTTCATATTTTCCAAATTATGTGGATCTAATAAACTTCCAAACAGGTCCACCATATTTGAATTCATTACCTTGGAGACCCCTAAAGAAATAATCTCTATGTAGAAATCTCATCTTTGTAATACATGTAAATATTTTGTTATCTGAACTGTGGAATCATCACTTGTGTCAATCATGCTGTGTAATATCAAACACAATTAAATCTCTCCTTGGCTACCTAATTGTTTGTACTTCTATTTACCCTCATGCCTCCTCCACAAAGTGTTTCAGTGGAATGGACTCTCTTTTAGCAGATAAACCATATATGCAAAAGTACAATGTAAAAGTGGAGACCATATCAGATGACCACGCAGACAAATTGGTAAGGGCAAATCTCTCTGCTCCCATTCTAAGTTATTTTTGGAATTTTAACCCCTTTGCATCCAAACTCATGTTTATTTACTTTGACTTAGAATAGGCAAAACAAACAACAAAAACCAGCTTCTCCCAATTGGCAACTAACTCTATAATCTGTTTGACATTTCAATCTTAATATATTAACTTCATCTCTTTTAAAAATGTTTTCGTTATTAATATTCCTCTTCATAAGTGCTTTAATTCTCACTGGCTTCAAGGGACCAATTGTGCTCTTTGTGGGCAGGGTTCACCTAGACATTTGCAAAATAAGCAAATAGATCTTTCCACTTTTGGAGATACCTTATTTTTCTCCATTTTTGAGATGACATCAAGTGTAAAATGCAGCAATAATTTAGTATTGGCCTGGGGAAAAAAGGGAAACTATCATATTGTGTTTACATATAGATTTTAAAACTGTATTCTGATTTCAGAATCTTTAAAATTTAAAAAAAGGTGGGATATTTTTAGAATTGAGACAATATGGTAATTTGTATTTCAGATTATATATAAATAACAAGATAACAAGCTTTCCTATCAGTTTCACTGAATTTCATCTTTAAAACGAATATAGCTTAATAAGCATTCAATTTTTATTGTGATGTTTATGTTTCTAAAGTAACTCTTTAATTTTGTCTTTTAAAATTAAAATAACAGTAAATTAACATACTCCTTAATATCTTACCTATATACTAATGTGGACCCAAGTCTTCTCATATAAGACTCGACAAATATAAAAAATTCTGAAAATGAAGGGTAGGACCAAAAGACCTTAGAGGTGATCATTCAACAATACAATTCTGTGTTAAGCTAATAGTAATTATTCTTAATACAATTTAGAATAAACTTTAATTTTGTAACAAAGGACGAGAGAAATAATATTACAATGAAAGATAAATTTTATCTCCCTCCACCTCTTAAATTACTTATTGTTACTTAATGGCTACATTTGTCACCTGCATTTAGCAATATTTAAGTACCATTATCATATTTAAAATGCTAATTTTAATTAGAAATGTAAACAATTTAAATTTAATTTTCAAAAGAATTCATATCCAATTATGTTTATTATGTTTCTTTCATCTATCAGTCTTTATTCTCAACATGGGAATTCTCTAACAGCTATCCAAATTAAAGAAGCAATAGAGACAATGTACAGAAAATAGGCAGAGCAGCCAGGCCTCCCCTGCCTCCCTCACAAAAAAAATTTTGAATTATCTGTTTGAGCCACCATAACTCATCAGCATAGATACACTATTGTAGAACAATCATTCCTGTTCCAACCAGTGAGCACACAATATCTGTGATAATAATTATAGACATAATGTAATATATCACATCACAAATTCCTGAAATAAAACTAATTCTATAGATTAGGAACTTAGAGATTTATTCTGCACTTAGTCACATAATGGATGTTAAAATTAACGAGAAACTCAGATTGAGGCAAACATGACAAGCATGCTTTACTCAAACATCATACAGCACAGCAACAGTTCAAACCTTGTTTCTTAAAAAAAGAGAAAGAGAGAAATAGAAAAATGTTTTTATGTCCTACTGGATTTCAGGAAGAGCTGAAAAACACTCTTATTCATATAGTAAAGAGGGCTTTGTTTGGTTTTGCTCATTAGAATTCTGTAATTCTGTTAGTTTCAAGTATGGTGAGCTTGAGTATACGCAGAATAACAGTGACTGAATAAAGAAAAGTAAGCCTTGGCTTACTTTAATTGTCATAGATAATGAAATGGAATTTTTTATTTTCTGACTCAATGGCACGTAACATAAAACCCCAAAATATTAATTTCTCTGATTCTGGATAAAGAATTTATTGTATTGCACATAGTTGAGTTTAGACAATTAATAGCTGCTACCACAACATGTAATTTTTTAAACTATGCCTTTCAAGTTTCAGCACATTTGAATTTCATTTACTATCCTTTTTATGGCTAATAATACCATGGCTTGAAGTAAAATATTTGCAAATAGTTCAACATAGTAGTGAGTAAGGGTATTTTAACTGTATTCACATTCACTCCCTTTACAGATATTTTGTGAGTTCAAGTGAAGGGAAAGGTAACGCGAATTATGTATTGTAGATTAAATGCGAAGTTAAGTGATCACCATTAATATGTAAAATTATCAATGGTTTTATGGTTTACTTAAAATAATAAATACCTGAATATGTATTCTGCATGCTATAGATGAGTTTCTCCAGTATTTTTACAGCCAGCAGACACTTGAGTCCTGTCTTCTAATGCTTATATGCTAGAACAGAAAGGAATTAAGGTGTAAGTCTATTTCATGTGATGCAAGTGAAGTCACCAAATAAAATCATAAAACTGCCTTTTGCTAAGGCAATAAAACTACTAATAACAGGCCTGTTCTACATAGCTAAGAGGTTTAATAAAAAATCGAATTCCTTGTTTAAAATTACATGTCTTTCATCCTGTCATCCAGGATACTGTTTAAAGAGTCTCTGTTATGCACTGCTTTGTTTCTTGCTCAGTGGTTCTGTATAGGTTTTCTTATACAATAAAATACAATGAACTTTTAATATTGGAGTTGTTTTCTCTTATTTTTGATTATCTTATTTTCTTGGCTAATGCCTTATTACAAAGGCTTTGTTCAAGTAATATGGTGATTTACATAGATGAAAGAAGGCCTGCATTTCTAGAAACTGAAAACAGTGGTTCTCTTACAAATCCAAATTAAACATTTCCTGTAGCCTCTTATTTTTAATAATGACTTTAGAGGCAGTAATTAGAACATCAATGGTTTATTTTGGAAATAATCAGTCTTTAACAAAGAAGATTATTCTTAACCTCAAGAAAACTCTAAATATAAATAACAATTCTGGATCTTTTTAGAAGTTGATTTAAATAATGCTGGATTATTATAACTATTTAATTAGCAGTTTTTCAAACTTTAAAATTGGAATTATATCTCAAGAAAAACTCATGAGAGCATTTTTAAAACATGAACTCTATCACAGATGAAGTGGATCAAAAATTGCTTTTGTACAGTATCTATAATTTTGCATAATTTTATATGTTAAGCTAAGAAAAATTTAGAAATGTGCTTTTTGATACATTAATCTTGGAATAATCTAATCATTCCAGGAATAAAGCAGAAGAAGGCCATCAACTGGTGTCTAATTCTTTGATTTCTATTTTTATATTAAATAAAATTTTATAGTAAAATAATAATCATTTTTCCCCATACAG
>TTN-214,,0,780,2968006,2968785,GTTGGATTTTAAGGATAAAATAGATCAAATGCTAACATTCACTGGATTGTAATGATTTAGCTTGCATCACTTAAATTTTCACTTATCTGCCACTTCCAGAATGTAATTTATTTAGAGTAAGAATGAAATCACAGACATAATCATGGTTATGAACTCACCTTTTCCCTTACTGCCCTGTTGGGTGCTATGCTATCATATCCATGGTACTATTTATTTTAAAAATAAAACATATTTTCATATGTTTCATAATACCAATAGATAAGCTTTTAGTTAATTTTCATATGAAGATAACTTTCATAATATGTAATAAAAAGTATCAGTGAACACCTAGCCACTCTGAAATCACTGGTCTCACCCTTAGATTTAAAATAACCATGATTAGTTGTCTGTTTCTTTTTTCTGTTTATTTTTTGTTGTTGTTTCACTTCATCACTTTATTTAGTATATCATGTTTCTTCACATTATTTTCAGTGTTCCCATTCAGCATGGTATATTTAAAGAATATATCATGTTGTTATGCATATAATCCAATAGCATCACATTTTTTCACAATTCACTGCAAAGCAATGATTGAATAGGTTTTTTTTAAAAAAAGCTTATTGTCTTCTTTTGCCTTCAATGATCTTTCTCATTTTCCAGTCACTTGCCTTAAACTGCTGTAATCCATCTCACCAATTTCAACTGTTTTACTCCATTAACAGCAACAAAAGTTAGAAGAAAAACAAAAATGTCATATGCCTGATAAGGAGGCATGTTAATGGACTCTACTTCCCTTTGCAG
>TTN-214,,0,2007,2968786,2970792,GTAAATGCCATACATTGGCACAGATGTTGTCACTTCATTTCATATTGTTGTCCTTTTTGCTTTCTGTACATGTGTGGGAAATGCTTGTATTACCAACTGGAGAGACCAACAACCAAGACAGTAACATGGTAGGTAGGTACTGCAGAGCCTATATGGGATAAGAAATCATTATTTACAGTCACATTTCTACTACTGACCAAAGAAAAAATAATTTATTATTTGAGAACAAAGTTAAGTAATCAAATGAGCTCAGCTTGGCCCTTCATATAAAACATATCAGGACAGTTTGGTGCCACTAAAAAAAAATAATGTCTCAATGTATTTAAAAATTTTAAATCAAATAACCAATTAAGAACAGAATTACAAACTTAAAAAAGTCAGTGTCTAAGTCTAAAATTAAATCCTAATGTAAGACAGGGAGCTAGTATAGGACTGAAAACTAGGATTCTCTCTAGGCATTTTTACTAATTTAAAAATAAGACGGCTGGGCACGGTGGCTCACGCTTGTAATCCCAGCACTTTGGGAGGCCAAGGCAGGCGGATCACAAGGTCAGGAGATCGAGACCATCCTGGCTAACACAGTGAAACCCGATCTCTACTAAAAATATAAAAAATTAGCCAGGCGTGGTGTCACGCACCTGTAGTCCCAGCTACTTGGGAGGCTGAGGCAGGAGAATTGCTTGAAGCCAGGAGGCAGAGGTTGCAGTAAGCCAGGATTGCACCACTGCTCTCCAGCCTGGGCAACATAGCGAGACTCCACCTAAAAAAAAAAAAAGAAAGAAAGAAAATAAGACAACTACACAAATATCCTATTCCCAATTTTCTAATTGATATGTAGGGTGACTTTCAAATAGTTAACACTCATCAAATACTTGAATGCCTTCATTAACCAAAATATTAGTAGCAAGCTTTTCTTCCTTTCTTCCTACCTTCTTTCCTTCCTTCCTTCCTTCCCTCCTTCCCTCCCTCCTCTCTATCTTTCTTTCTTTCTTTTCTTTCTTTCCCTCTTCCCAAGAGAAAGTGTGAGTATGAACTGTGGTTTGAGGACAGGGGTAGAGGTACAGTCAAGCCATACTTGGACTGTTGGGGAAGGCTGTCCCTTGGTCTTCTTTGTCAATGAGAATATCAAGGGGAAGGGCAAATGCAGCACATCTCTTGAATGTGAAAACGATGAGGTTCCCTATAGCTTCCTCTTCTCTACAATCCTTTTACGTGATCCTAAGAAAAACCCAGGCCCATGATGACCCAACCAGTGCTTTTCACTCTGGTCAAAATGTCTCCATAAAACCAAGTACATGATATTATTCATACTGACGCGTTTGGAAGTTTCTTTACTCAAATTAGGTCAATTTAGGAATGCGACTAATATTGAAGCTTCAGATAATAAGAGGAAAGGATAAGGAGGATGACTTAAAAAAATTAAAAAGAGAGGTTCTGAAAGTCTGGCTTCAAGATGCAGAATGGAAAGGGGAAGTTGCTGCTATTAAATATTTTTACAAGTTTGAGTTGGCCTAGAGGATGCATTCATAGTTAAGCCATATAAGAATTTCCAGGCAGTTGACATGAGGGTTAGAAAGACATTACAAAACTACTTCAATCTTCTTATCACTTAATATCCCTACTCTTCAGAAGAGTCAAATACATTTTCTTTATCTTCCTTACATAATCTTCTAATTTGCAGAATTAAAGTATCAGCTCAATAGCTTATCAAATAATTAAACAAGCAGCCACTAAAATGGACAAATCTTTAGTAATGTTACTTAATAAAGGAACGCTTGTCTTTTCTTTGATAGAGACAAGTAAAGTGATGTCTTGCTCCCTTATAAAGAACACTCTCATCCCTTTCCTTTGACAATCTTTTGTTCTTATTAACACATTACTCCATTTTAAATTATGGCTCATGTCTATCTAAAGACTTAACTCATCTTTTCTCTGTCTTGGAATATATAATTACAGCAAGTGCTTTGGTGGGGACTAAATGTAATGCTGGAAAAATTTCTTTTGCAG
>TTN-214,,0,522,2970793,2971314,GTAAGAAACGTGTGAATGTATTTTCTAGTCCCTTCTCTGCAAGGAATCCTCAGTAGAAAAACTGTTGGCAAACAATTCAGTCAGTACACTTTGTTATTAAAATAATGTCATTCAGCAAACATTATGGTTTGGGAAAGTCCTGGCATTGTTTGATTTTATTTTTTTAATCCTCTTCAAAGTTCACTTAACTTTTGTTCTTTTAAATTGTCTGCTATTAACAAAGCTTGCTTAAAATTTCTTCTAAGAAAAAACTCCAAGTGTCTGAGCAATTCTTAACTATCTTCTTTTATAAAATTCTTCTTTGTGTAGGTAGTCTGTTTATTGTTGTTTTATTTTAAATCAAGAGACTGGGAAAGTGTCTTAGAATGATAGGAACCTATTAAATGCACCACAGCTTTTACAGAAATTTTGTGGAGATATTTTATGTGTGTTGGGTCTCTTTGTTGTATATGTCTACTTTTCTTTTGCGGAGTTTATGTTTCAGATATCTTCTCCTTTTTCTTTTTTGTAAACTTCATGTAG
>TTN-214,,0,100,2971315,2971414,GTTTGTTTACTGAGTTTCCATCCAGTATTTTTCTGAGAAAAGATTTCCCTTTTAATTACTTATTACCCATTACTTACACAATGCTTTCATGCTTTTGTAG
>TTN-214,,0,435,2971415,2971849,GTTAGTGCTTGAAAAACTAATGTCTCTTTAATAAATTGTCAAACTAGCTTTCTTACCCCATGGAAGAAAAACTGGTACTTTCTTCTCTTGTCCTATCCTTTAAATTTGTTTTGTCTTGGTTTGACCTGGGACCTTGGGAACAAAGTCAGTAACTTTCACCTGGTCTTTTTCCCGAGACTAGTGTAAATATCTATTATCTGATAACAAAAGGGAATAATAAGCCATTTTGTCAGCTGACAAACATGTATCATCTATGCCTCTGTCTCTTGGATGGAATTATAATTATTCTTAACTTTTATTTCTTCTTCTAATTAACACTATGAAATAGTAGTATTGGGACAAGATAAATATAATCTTGAAAAAACTCTTAAATATAGATGGTGTTGAAAGTGTTTGGGAATTGATATGTTTTATATGCTCTCTTTCCTTAACTAG
>TTN-214,,0,96,2971850,2971945,GTTTGTGTAGGAACATTTAAACCTCAAATTGCTATTTAGAATTAAAGTGAAACCCTAACAAGCATTTAGGGTGCTAACTATTTCATACCATTGTAG
>TTN-214,,0,117,2971946,2972062,GTTAGTATTTTTAGAAAATGATGCTACATATGCATTTGAAACCCAACAAATGGCCTAAAGTCAATCACTGAGCACTCTTCTATATTGACCTTTTCTCCCTTCTTGTGCAACACACAG
>TTN-214,,0,115,2972063,2972177,GTTGGCTGGAGACTTTGCATTTTATCCTTATTAAAGATTATGTTCAAATTAAGTCATCTTCCCTTAGATCAACCCTCTTAACTCTTTGAAATTCTTTCTTATACCCCTTCTTCAG
>TTN-214,,0,92,2972178,2972269,GTTTGCATTGTTTTCTTGACATCTTTGTGCTAACCTTGTTATAAATTCTTTCCTCTTTCTCACATTTCTTAATAACTTCCTTCCTTCCACAG
>TTN-214,,0,94,2972270,2972363,GTTTGTGTTCACTTTGCCTCTTGTGTTGCCAAAGTTATGGCCCATGGCACAGACCCCTCCTCCCTTAATGCAAATCATTCCTTTTTTACTGTAG
>TTN-214,,0,109,2972364,2972472,GTTAGTGTTGGTTCCAGTGAGGGACTGGCTTTTCTGAAGAGTCAATTCTTTTTTTTAAGCCACTTTTGCTATAGGGATAATATTGATTGAGAATTCATTCTTCTGTTAG
>TTN-214,,0,101,2972473,2972573,GTTGGTTCAGAACGTTTGCCTTGGGTTTGAGGAAGAAATGCAGATGTAAGCCTTTCAGCAGGGTAATGCACAACCCACATCTATCCCTTTGTTTTCTACAG
>TTN-214,,0,132,2972574,2972705,GTTGGTATTGTTCTTCTACAGAGAGGATTGGGCATTTCCATGCTCCTTCTTCCCTTAAAATTTAAAAAAAAAAACAAAAACAAATTAGTAGATTGACCTTTTTTTGTTGTTGTTTGCTTTTTCATTGAATAG
>TTN-214,,0,133,2972706,2972838,GTTGGCAAATTTTATTTCCACTTATCAAGAACTTACAAAATATTTTTGTTTCATTTCTAAATTTTCACCTTTATTGCTAAGTTATAAAATAAAACTTCCTATTTTCTTTTGCTTGTTTTTTCTTTCACCTCAG
>TTN-214,,0,147,2972839,2972985,GTCTGGTCTCTACATCTCCTCACTTTCTTGCTTGTCTAGATTTTCTTGCCTGGGGTGGGCCGGGGCGGGGGACGCTTAAGACAGCAGTTTTGCCCAGTGACCTGTTTTTAAAAATATTCAACATCACAATTCTTTTTCCATCTTTAG
>TTN-214,,0,97,2972986,2973082,GTTCGTGAATGGAATCTATTCTCCATTTTGGCTGTGCTGCCTGATAAGTTTGGGGTCTTCCCTTGAGTAAGCTACTGTCTTCCTTTTGAATCTTTAG
>TTN-214,,0,118,2973083,2973200,GTCAGTTATACAAGAAGCAGCCTATCAAATAAAAATTCTGTAACGCTTTTAAATCTTATCATTATGGGTAGGAGTTACAATATGTTTCTTCTTTTCACACTCTCTTATTTAATCACAG
>TTN-214,,0,112,2973201,2973312,GTTTGTAAGCTATTCTCTTTCAAAGATAGTCTATAGCGACAGTTTCATTAGCAGACATTATTTCTAGTGGAGTTACCAATGTAACTCATCCACATTTTCATTTTTACTACAG
>TTN-214,,0,102,2973313,2973414,GTTTGTATCTTCACCCCAGTCAGCTTCCCTTATTTATAGTATGTCCTTTGTAAACAAATAGCAAGAGATTAATGGATGTGTTTTGCTGTTTGCATTGGACAG
>TTN-214,,0,246,2973415,2973660,GTTAGAATTTCTTTACCTCTTCTTGATTCTTCCTTGCGAATGCTTCTTAAATGTATCACTCTTGCCTTTGTATCCTTTAGAGCTAAAATCTCTATGATTCTGGTTCTTTAGATACATATTCATTGTGTTCAAGAAATATTCAGCCATTGCCTCTTTCCAAGAGTGTTTTCTTAAATGTCCATAAAACTGTCACAATAATTCAACTGCAAGCAATTTAATTAAATATATCTCTCTTAAAATCTATAG
>TTN-214,,0,213,2973661,2973873,GTGTGCAAATTTGATTCCTTTATGTTTCTGTCTGACTGTGTCTTTGGTTCTCTGTATTCAGTTACAATGTCTCTAAACAATCAAGAAAGTAGTATTCTTTCTAACATAGTAAACAGTATTTGCTCATGTTTTTCTCTTGCCTGTATACTATCTAATTTAACTATTGTTATTTATTTCTGTTCCCTGATACTCTCCTCTTTCCTGACTCTTTAG
>TTN-214,,0,1043,2973874,2974916,GTAGACATCTTGTTCTTGTGTTTCTCATTAAATGAAAACCACCTTCTCCCCTGGGTATTATAGCTCTTTATTCATTTACTATCATTTTAGTTTCCATTTGAGATCATAGAATATTTTTCTGAGCTAGTATTATTTCCCTTTTTAGATGGTTTCCTTCTTGAATTTTGCTTACATGTAACTAGTCATTATGAAATATTTTTGTTATTCCAGTGTCATAATTCTGATTACCTCAACACATTTGCCAAACATCAAACGTGATGTTTCAAAACTGCACAAAAAAATGAAGTAGGCATTTTAAAATTAGTCTTTTGCTTTCAATCAACTTACAGATATATCATTCTCACTATAATCTATATCATTAATAACAAGCACTTTTACTATATCTATGCAAAGTGAAAGCAATACAGGTTTTAAACTTATGTTTAAAACAGGACAATAATATTTTTTCCTTCTCTCTCAAGGATCACTTCCTATCCTTTAAAAATTATATGACTATACCTTGGTACAAATAGTATCTGTGTTTTTTTGCTGCAATTTTCCAGTGCTTTTTTTTTTTGTCACAAAGGCCAAGTTTGTCTTGTTTTAAGACAATTATTGCAGTAATCATTTGCTGAAATGGAAGACTTAGATCACGGATGTTGTGATGACTTCCAAGTGTCTGTTATAGAACATATACAAAAAAAATCATCCTTGAAATTAGAATTCCATACTTCATGCAAATCATTATTTATTGCTATACTTGCTTGTTTGCAATTTTTGTATCAATCTTTGTAGCCTAAGATACATCAGTAAGGTGTAGTAGATAGAATGTTGAACTGTTCAGTAACGACATCTAGGATCTATCTGGGTTCTCTGCCCATCTAGCTGGTTATCTTGTGAAGGCAAATGGCTTCTGAGGCTGTTATCCCATGAGAGTGTTAGTGCTGGACTCTACTTACCCATTAGAATATCTTAAACCTTTCTTCCAATTTAAAGACAAATAAAAAATTTTCATTTTGTGAAATTCAGTAGCCCAATTCATGAGAAATTCTTGTTTTTTGCAG
>TTN-214,,0,118,2974917,2975034,GTAAATATAGTTCATCCACATGGCAGAAATGTCATAAATGTGCAAAATCCTACTTTTTTCACTCTCGCATGATCTGGACAATCTTTTCAACAATTTCCATCCATCTTTTCCTGTTCAG
>TTN-214,,0,829,2975035,2975863,GTTGGTACAATAGCCCACGATAGAAACTGGTGCCAAATGCTGGAATGAATTACTAAGAGTTACTGGCAGATTCTTTTTCTGAGTTTCTTCTAGAACTATATTTATCCTCATCTATTTGAAAGGTCTAGAGGAAAGACATAGTTGATCTTTCAAACACTCTTTTCTGTTTCTGTGATTCTAACAAAAATTAGACATCTGTTTTATTGTTTAATAACTACCTGTCTATATCAATTAGCAGATACAATCATGACTCTCTTTGATTAAGCATGAAAGAATACAGAGCCCAGCATGTGCTACAAGAGTAATTGTTAAAACTAACAAGAACTCCAAAGGTTGGCATTTGATAGCAAAGCTTCCACATAAAATTAATGACAATTAAACAATTGTTTGAATAACAACTTTCAAAGAATTGTCTTTAGCACCTTAAGGTAGAGCAAAAATACCAAGTAATTCACAATAACCTGTAGACTTTGATCTACAGAGGGTCAAGTGGAAATCAATATATACTATCTAATGCACATTGTTTAAATTGTTTTGAAGTTGAGTCATGCACGAACATATATTTCTTAAGAATAATTGCTACATAAGACGACAGCAAGAGTGGTGGGAAAAACAAAAAATAAAGAAAAAACTGAAAAGAAAAAATATTAAAATAAAAAATAGCTATAATTCTATGACTGCATGTAATTATGGAATCACACTTTAAAGTCGAGAGAGAGAGCACCCTAACATAACCATCTCACTGGGAGAAACAATCTTAGTGAATGTGATAGTAGAGACAGAGTAAAGATCCCAGACTTTGACAGATGGATATCACGTTTTATTTCAG
>TTN-214,,0,116,2975864,2975979,GTTAGTTCTGCTGTTTTCTTCTGGTTGCTTATGCAAATTCCTTTTACAAGTTTCCTTCTTTCAAGTCTCTTCTATTCTTTCAAATCATGATGAGTCTCTTACCTTTCCTCACACAG
>TTN-214,,0,159,2975980,2976138,GTCAGTAGACAGTCAAACTTGTAAGGAATTTCTTACAAATTCCTCTTCAGGTGCACATCTATGTTGACAAACATTTGAAAGTGCTCTAATGTTTTATTCAAAATTGCAACTCCATCTGAAGCTTACAGGATCTTTTAATTGTTCTCCATGTCTATATAG
>TTN-214,,0,93,2976139,2976231,GTTTGCTCAAGTGGATTCACTTTTTCTGTTTTCTGTATACCGACATCCTTGTGTTTTTCTTGTGTTTAACTGCTGTGCTTTGTCACTTACTAG
>TTN-214,,0,108,2976232,2976339,GTGTGTTGTCTTATTGTCTCTTAAATCATTTGCATTCTTCTAACATGTAGCATAGTTTCTTTGATATTCATTAATTCCAGTTGCTAACTGTGAGCCTTTCTTCCTTAG
>TTN-214,,0,112,2976340,2976451,GTGATGATATTTTACAAATTAAAAAAATTCTTTTTTCCTTAACTCTTGTATCTTTATGGTGAACTTCTCATTTCATCTCCTAACACCTTAAGTATTACATGTCTCCCTACAG
>TTN-214,,0,124,2976452,2976575,GTTTGTTCACACGTCACTCTTTTTCTTTGCAAACTGTGGCTTCATATTTCATTGTCAAAGTAGAAACGACCAATGGCAAAAAAACAAACAAAAAATACACATTGCCTTTCTTCTCATCCTCCAG
>TTN-214,,0,644,2976576,2977219,GTATCATTCCATGACTTTTGACAATATTTGTTCCTTACCATATTTGCATAATTGTCTTATAAAAGTTTCTTTGGTTTTTAAATGTTTGAGAGAAACTAACTGGACATGTTAGAATTTGTGTATTAGTGTTGGAGGCAACATTAATCAAAGTTGTGTTTTCTCTTTATATTGTTCTTTACATTAGTGTAACTCTAAGTGTAATCTTATCAAAAAGTATTGTTTAATTGAAATTTGTTAAATGTTGTTTTAACTATCTAGTCCATTTTTTAATGCTTTCTTGTTATATGGCATTCTGATTTATCATTACTAAATGTTGATCAAATACATCTATAATACATTAACTTTTATGTTTTAACTTACATAGTCAAACTAAAAAAAAGAATCAACTAAATTCTCTATTAAAAATGCACATGTACCCTAAAACTTAAAGTATAATAATAATAAATTTTAAAAAACTAAAAAAAAAATGTTATGAGATTATTTAACTTAAAAGATAACTTATTTTACTGTAAAATCCTCAGAAAGTATATTCTTAATAACAAACCAGTTTAAATATAAATTTATGGGATCTTCAGCTACAAAAACAAGCTCTTTTAACATGTATAATAAATATCCCTTACTGACTGTTTTGTTTGGTTTACTAG
>TTN-214,,0,257,2977220,2977476,GTTAGACACACTAAGCTTCTTTGTTTCTTTATTCTCCTCTGATTTGGGCTCTTAGCAAAGTTATGAGTTCCAAAATAAAAGGATAATTAAGGTTATTTGGTTGCAATTCTTCAACAAGTTTTAATGAATTGTCATTTCTTGTGTCAGCATGTATTGTCATATGATCACACCAGTCACTCTTCAAGGTTCTAGATTTAATTTTTTTTTCCTTTATAGTAAGCAAGTGTTCTCATTGTTTATCTCCTTTTTTCTGGTAG
>TTN-214,,0,120,2977477,2977596,GTTTGTATACATGGACACAAAAATATATGCCCCTTCCTCCTATCTGTTCTTGCCTAACTAATAACTTGTGTGGCCATGATTCTCACATTTTTTCCTCTAACCACAAATTTCTTTCATCAG
>TTN-214,,0,150,2977597,2977746,GTTAGTAGCAAAGCACAGCCAGAGAAAAAATCAATTTACTTGATCCATGATCATTTTCCTCAAATATTCCTCTTATCCAGTAATTCAGTGATTGCACTCTTGAGTTTGAAAGGTTACTTTGTTTTCAATGCAAAATACTTCTTCTTTTAG
>TTN-214,,0,102,2977747,2977848,GTGAGTAGAATGAGATTTTTATGAATATACAATATTTCCAGGGGGTGGAGGGGCACAGAATAAAACTTCTCTTTAAACGCAAAACTACCCTTCCCCACATAG
>TTN-214,,0,190,2977849,2978038,GTCAGTGTGCAAGGATAAAGCTGCTGCTTCTCTAACACCTCTTTCATGTGGACGTGGTGCCTGCCTTCCCTGGAGTTTCTTTATTTTGTCTTCATGTTTAGTCTTAGCTCCCTTTTTTTAAGGAGCAAAAGCACTTCTCACTTGGATTTCTTTCTTCTCTTTATCTCCCCTTCCGCCTTGCAATATCTAG
>TTN-214,,0,94,2978039,2978132,GTTTGCTCTTTCCCCCAATATATACATCTTTTAAAATTTCTCTTAAGTCTTCATTAGAAGGCAAGAATTTTACCCACATGTTTTCTCCTTATAG
>TTN-214,,0,100,2978133,2978232,GTGTGTTGACAGCTACCTCTTTTTATTGCTCTCTTTCTTTTCAAACATCCTCTTTTACATGGCATGACTGACTTGCTGACTACCATCCTTTGTACCATAG
>TTN-214,,0,132,2978233,2978364,GTGATGGTGTTGTTTAACCTAGTGTGTGTGAACAGATTCATTTTCTTAAAAACGTTAAAACTTTTATGAATTGAAATATGTTGTGGATGCCTTCTCACCTGTAAATAAGGATTATCTGTAACTTCTTTACAG
>TTN-214,,0,140,2978365,2978504,GTGAGTAACTCACAGTACCCTCTTCATTGTAAAGCAGCTTCACTGCTCCAGGCCACCAAAAGGCTGGTGCCATTTAGTTTCTGCTCTGTATGTGAGAGCATGGAAATAAAAATCACCATGTTGGTCTTCATTCTTTTCAG
>TTN-214,,0,1320,2978505,2979824,GTACTTGTTAGAGTGAAGGAGCAAGATCTCTTTTACATTTTCAGTATCTTAAAATATAGGAGGGTGGGTGTGCTTGAGAGAGAGCTATGTTTAGGACCAGGGTCTAGTGATGAAAATGGATCAAGTGGATCAAGGACCTTCCAAATGGAGACAAGTATTTTTTAATTACTTTAAAAAAAAAATTTAAAACTAGGAAAACATGGACCAAAAGTCCATTTTAAGAGACTAAAAATAGAGACTAGAGAGAGATAACCGAAACTCTACAAAATTGCAAGAAAATCCTAGTTTGAAAGACGGTATCATAGGACAAAAGCGAAGTTATTGCAAATGACTTTTTTCCCACAGTACTTAGTAAATGAATGGATTTTGTCCCTCTAAGGCATAGCAAAGAGCCAAACTATCAAGCCCTTCAAGGAGAATTCAGATGAGAATGATAAGTTCAACTTACTTTCCTCCACTAGCCCCACTTAAATAATAGTGGAGGTCAGGGGCTGGGGAGTAAGTAGATCAGTATCTGCTATTATGGAAGGCAGTCATGTGTTTCTGCCACATGTTTATCGCTGCTACTGTCAGAAATTAAATAGTTCACTCAATGGACTGCTAGTCTAGTCCATTAGAGTATTTTTAAGGGTTTTTGTAGTGGTGGTTTATAAATATCTTGAAATTAAAATATAATTAGATTTAGCAGCCCATTTGCTCTATGACATATAGCTAATCACTTTTACTTCCCTATGCCTGAATTTTTTGCTTCAGTTAATGAGGAAATCATTACTCTCACACACTTCAAAGGAAAATTATGAAGGTTGAGGAAATACCCATTTAACACCTAAAAGAGGAAAATGGCATTTTAAAAATATTAAGATATCTGACCCACTTTGCCATTCCGGCTCTTCATGCTATGTAACTGATAGCATTGCAGCCTTAGGAAATAGTTCTCCACTGGTTCATATACAAGACAGTAATCAAATTCTCATTCCCCGTGGACCTCAGAGGGCTTCCACTGACAGATACATGCTATTATCTCTGATCTTGGCACTAGAGAAGGGACTCTTTTGCTGGGGAGAGGATGGCACAATAAAGAGTAATGTCTTTTTCTCCTTCTTTTAGTAATAATACTTGATGTGGATGCTTACAAAAACAAGCATATTTTATTTTAGAAATTTTCTATTTAGGTTTCATTTAACTCTTCTTCCTTGAACTGCATAAATTTGTTTTCCAGAGCTAAAGACCTCTCTAGCAAAGATTATTTTTTCCACCTCATCTTGAATTATATGCATCTGTTCCATCCCTTACCCTGTGTTTTTCCTCTTGGTTCCATAG
>TTN-214,,0,228,2979825,2980052,GTCAGCGCTCTCCCCACCTGTGTGTTTTTCACATTAGCCTCCTCTTTAATTGTCCTCTTAACTTCCTGTTTGACTCTTCAACGATGTTTTAAAATAGGGAAAGGACACAACAAAGAATTGAAAGTGTTTTTTTCACTCTCTATCTCTCTGATGGAGTGGAAGATTGATTCTTACTTTTAACTATATACTTACAGAATACATCCGTATTTTCCTTTTTTCCAATTTTAG
>TTN-214,,0,412,2980053,2980464,GTTAGATGGACTGCATTCACTTCTGCTCACTACTTCCCTTCTAATTGTAATACTCTGTTGCCCCCTCCACCCCAGCCCAGTCTTATCACTAGCAGCCTATTCCACTTTCCCTTTGTTTCCTCTCCAAGTCCTTTTCTGTTTAGTCTGCTTCCCTTTTCCAAATCCTACTGAATATCCTTTTAGATAATGTTGTAATTAGGTTTTGATTGGATTAAGAAAGCTGGAGTAGATGAGATATTCAACTTTCCTACTGAATACAAACTTTAATGTGTCCCTGCTCGCATCCACCAAAAATGCCTCTTAAATGGAAATAACACATTATCACTAGTTTGATTCCCGGCATTCACGATTTGAGCAAAATGCTGTCAGTCTCACAAATTTTAAAACCCAGGCTTTCCTCCTTTTTCATCAG
>TTN-214,,0,116,2980465,2980580,GTTAGTAAAAAGATGATGTTATCACAGATACAAGGCACACACTCACCAGGATCTGTATTTTCTTTAGTTTTTCAATTTGAGTTTAAAATATGGATATCTTTTACATTTCATTCCAG
>TTN-214,,0,524,2980581,2981104,GTTGGTTGATTTCTTGGGCTTTTCCTTCATCATTATAATAATGTAGTTCCTGATTTTCATAAATGTATATGGGTTGTTACATCTTCTATAGGATAACATGAGTCCGACATCTTCTGAATCAGCAAATTCAGAGGCAATACCATCTGTAGAATTAGAAGAAAACCATGTTCAAAAGTTATATCCCTTTCTTTTTGAGGAATTTCCAAAATGATGATAGGAATGAAAAATAGTCCCTGGATAAGGTTAAAGCAGTCTTCATTTATGCTGAAATAATTCACCACATAATTCTTCACGGCAAAGAGAGAACAAAATCCCTAGCAAGTCAACCATCACATTCTGCCCACTGATTCTCCAAGCTTTTGATAGTGTGAACCCATAGAGGAGTTTTTAATACCGTCACAAAAGAGCCAAATGGATCTAGGGATAGTCCATCAAAAAGACAGTTCTCTCTTCAAGTCATTTTATAATTGTTGTCCTTTGTTTTTTTTGTTTTGTTTTGTTTTGTTTTGTTTTGTATCATTCAG
>TTN-214,,0,109,2981105,2981213,GTCAGTTTACAAAACAGTAAAATGAATTGCATTTCATAGTTTATTAAGCATGTTTGTCATAACAATTCACAAATACTAAACCTTTTCTGATATGTGCTTTTGTGTTTAG
>TTN-214,,0,103,2981214,2981316,GTTTGTCAGACTGCTCTTCTAGATTTATACGATTAGTAATTAGATGTGTCTTTGTCTGTATGTATATGTGTTTGATTTTATATTTTCAATTTGGTCACTTTAG
>TTN-214,,0,92,2981317,2981408,GTTTGTCATGATTGCACATTTTTATCTTTGTATACAATCGATGATCTGGCATGTCTCCTTCATGACTGATTGATTATCTCTCTTGGCTGCAG
>TTN-214,,0,594,2981409,2982002,GTGATTGCAATATTTTTAAAGTGAACGAATTTGTGTTTCTTTTGAACAAGATTTAAAATGTCTGGGGAGGCCTATTTTTTAGGAAAATCTTTCCAAAGGCTTAAAATTCTGCTTAAGTAATCCTATTTACAGTTAGTGGCTTATCTTTTTCTATGGATTCTACAGAGAGATAATATGACTAAATCTTTAATTGGAAGGATTATGCAATCATTTGCTTCTATAATTAAATCTTTTTTAAAAAGTGACCATATATTTTTAAATTCCACCCCGTAAGTATCTCATGCAAATTGCTAGAAGGCAGTCTTTAAAATTACAGGAATCTGCTGCTTGCCCAGAGACATGCCTTCAGCCAACCAATTGCTTTATTGGTTTTCATACTGTTTTGCACCTACTGTGCATTAGGGTTGGTCTCAGAGTGATACTTTTGCTCCAGAAATCTATATGCTTTTCTTTATCTCCAAGTTAATTCAAGAGACATTAATAATTCCTGATTTTTAATAGAAATTGCATATATACGTGCGTTTGTATATATATAATTGTGAGAAGAGCATTTAGTAAATTAAAGTATTTGTTACTTTTATTCTGTTCCTACAG
>TTN-214,,0,139,2982003,2982141,GTTTGTGGATTCTTAAACTTTCATTTCTAGAATTAAAGTATTATAATCAAATATGAACTTAGGGAGAAATTTCTATTTCAGTAAACTGACATGGTCCAGATATTGAGCCTGAAACCTTGTCTTTCTGCTCTACTATTAG
>TTN-214,,0,778,2982142,2982919,GTATCGTTTATTTTGCAAGTGGTCCAACAAAAGTGTAATCATTTTGTAGTATAGCCTGAAGGTGTCGTTTTTATGATGATGAATGCAATTTAGGACATTTTTAAACAAATGAAAAGAAAATGTTTAAGAGGAAATAAGTTTATCTAGAGAAGAAGTCATTTTTTAAATCTGTATTTCTTTCTTTCCTCGAGACAGGATCTCATTCTGTCGCACAGGCTGGAGTACAGTGGCGTGATCTCAGTTCACTGCAACCTCTGCCTCCTGGGTTCAAGTGATTCTTGTGCCTCAGCCTCCTGAGTAGCTGGGATTACAGGCGCCTGCCACCATGACCAACTAATTTTTGTATTTTTTGGTAGAAACGGGGTTTCACCATGTTGGCCAGGTTGGTCTGGAGCTCCTGACCTCAAGTGATCCACCCGCCTTGGCCTCCCAAAGTGCTGGGATTACAGGCATGAGCCACCACACCCAGCTTATAATCTATATTTCTAAAACTTTATATATTCCCTATGATACTGAGACTACCCCTTCTTTTTACAAATTTGTGATTCTCTAAATGGCCATGAGTTACTTCTTATCATCCACCTTGTAAGTCAAAGAACAGTTTAGAATAAGCTCGTAGAAGGAGGCTGAAATGTTTAGGAACATATTCTGATATAGTGTATTTAGTTGGTTAGCCTTGATTTTTAACTAAAAATATGAGGGTTTTTTTTCTTGAAAAGCTTCATATTAGTAATCTGCTTCTAGCTTCTACTTCATATATCCTTGCAATTTCTTATAG
>TTN-214,,0,1752,2982920,2984671,GTGAGTTATCCTCACAGCCCCAACCTGTTGTGTTTTTCTTCACTGCCTGTTATATATCCATGAGCATTTCTTATGATATCTTGACCAAGTAAGTTATAACAAATATAAATACACATTATTTAACTGTGTATTTATCACTCCATATGTTTACTAAAAATATAAATTATTGTAATTTAATTATGTGGCTTCCCGAAGGAGGTGTCATTTAACGGACTAATATCTTAGGTTTCTAAATCATATCCTAAAATTCCTTTAGGTAGTTAGAAGTTTCAGCGTACTCTGAAATGTGTGCATATGTGACATATATTTTTATGAAGCACATTTGTTTTGAAATTTTTTTAATGTTCATCACCAAATATCACATTAACTTGACTATTATTGAGTTATATATTATATCACAGTCTGAAACTTTCTCCTTTCCAAGTGTATTTCTAAAGGATTATTGTTTAATGTATATTGCCCAAAGCGTTTGACCTGCAAACAAATATTAATCCCAGACAAAAGGGTAACATTTGCCCAAAAAGAAAAATAATGGGTAGAAAACATTGCATATCATTATGGAAGACATATTTAAATACACAATCATCGCTTGAGAAAATGAAATAGACCATGTTGTTTAAGGATATCTTTATCTGTTTCTCTTCACTGTAATGGCTTCCAGTAATTACAACATAGCTTCATCAAAATCACATTAAAAACTAACCTCCTAGAGCAGCCTGGAATTAATTACCAACTCTTATGATCTGGTTAGTTATCTCACAGTGCACAGGTAGTAAGTTATTATTAATAGGCTGATATCACTAATAAGTAAATATCACTGAGTTGTCTTAAAATTCCAGTTTCACCACTCATTTTGTGGAATTTAGATGCATTTAGTTTTAAAACACATTTTATAAAATGAAAAATATATACTTAGCAGTGGCTTATCTTCATGATTTACACTCATGATGGTTTTACCATGGGCAGATAAATGCTTTCTATAGAATTCTGAAGCTATTTATAAAATGTTTTTAAAGGATAGACATCAGAAGTTTTAATCTTTGCAATAACAAAAAAAATGGCCTTATTCTTTCTAGGTACAGGTCTCAGAACCATTGAACAAAATCATTACATAATACTGAGTTGTACATTGCCTTCCTATCATGTTACTCATCAATGTCTTCATCATTGGTCTTCAGTTAAACACTGAGCCTCAACTCCTAATTCCCTTGGGCTAAGATTGGATTTTAAATGCTACTGTGGCTGCATTTAATAGCTAAAGATGAACATCAGAGAAAATCACATATAAATATGTGGGCTCATGTATTACTCAAATGCTAGCTTTCTTTCCTAGAGGGTAGCAATCATTGCCGCTGGAGATAAGCAGAATTCCCAAATAAGCCCTTCATTTTCAGGGTTCAGCAAAAACACCGCTGTACACAGGTTTGAGAGAATTAATAGTGTGCTATATGGCAAAGAAGTTCATAGTAACTGCCAATGTCTGCAGTGCTTAGTAAGGACACAGAGGCTGGGGCAATTTGTGGGCAGCATGTGATGTGTTCTTTGCTTGTTTTTAAACCTTTATCTTTTTAAAAAATCCAACAAATTTAAACTATTGTCTTTAGAGAGGAATAAACCAGGCACATAATTCTGTCCTACTACAGCAACAGTGTTACCTGTTAGAGGCCAGTTTTTCTCTTTATTTGTTTCTCTTGTGGAATTTAATACTTTTTTGCCTTTATGTTCCTCATGAAAATACCTTTTCAATTCCAG
>TTN-214,,0,571,2984672,2985242,GTACAGACACCTCAAAAGTATTATGCAGCTCAAGCCAGCAACCACTCATGTTTATTTGCTTATTATGATTTCCCTAGAAATGGAATTAGATTTTTAGAAATATCAGTTGTTGCTCATCTGCAATTTGTAGGCTCCTTATTATAATTGAAATATTAGGTAATTTAACAGAAATAATGTCAATACAAAGTATCTGAAATTACTACAAGTTTACCACCCTATTTCTTGAACTTCTTTTCACCATATCCATTAAGATGTAATTAACGCAGTTCCAAAAATGATGCTATAATAATGCGATAGAAAGTAGGCTGTTGTGATACACCTGGAAAAAATAAAACCAAGTCTAAAAATATTGACACTACTAATATGATTATAGTTCAACCTTTGATAGCTATCATTAGCATAAATGTCTGAGAAGCTGCTTTATCTTCTGTAACCCACCCTTACATAGAAAGAGAATTCTGCAGTACTTACTTATCAAACTGCCAACCTCCTAAGGCTTATTTTACAAAGGGGGATATGTATTGTAATTCTGAGGTGATTGTAGTAACAAAACATGTAAATGTTTTTTCAG
>TTN-214,,0,122,2985243,2985364,GTAAGTGCACTTCATGAGAAGTACATCTTCATCTATCTTATACCTTTTACTTATGATTTAATTTTGGAAGAACTGATTTTAGAAAATTAAATTTTTATTCACTTGTTTTCATTATTCCTTAG
>TTN-214,,0,1096,2985365,2986460,GTGAGTTCAATAAAAACCACAAATCGTACAATCAGCCCTCCATATAAGTGGGTTCCGCATCCACAGTCAACCAGCCCCAGTGGAAAGTATTAAAGAACAAAAAATTTAAAAATACAAATAAACAATACAGCATAACAACCATTTACACAGCACTTACATTGTATTAGATATTATAAGTAATCTAGAGATGAAGCATATGGGAGGATGTGCATAGGTTACATGCAAATACTATGCCATTTTGCATCAGGGACTTGAGCATCTGGCCACAGGCCTCCTGAAGCCAATCTCCCAGGCATAGAGAGGGATGACTGTAATGTCCCATTCACAAAAAGAATCTCTCAAGAGTCATGGGCCATCCATCTCAAGATTCAGATTGTTAAAGAACATAGGCATATAGACATTTTCACAGAAGCAGATAAGCAAATACACAACATCTGGGTGTTCTTGTTTCATTAGAATCAATTTCCGAATTTAAGAGAAAGTTTTAAGAATGAGGTGAATGTCTATTAAGATTTTTAAACAAAAAGAAATGGCCTATAAAGAAACCCCAGTATTGTCTGTGCCTAGGTATGAAACTTTTTTTCTATATATGATTTCTTATGTTATGAATGGTTCTCTAAAACAACTGTTTTAAACATTTTCCATAATTATCATTCATTTCAATATGGTTCATTTTTCAACATAATTATTAAATTAAATCCACACTCAATTTCCACACATCGTTTCCGTGATATGTATACTATTCTATTATTAAAGTTTTCCATTGCTATTATTATTTTTTCTGATATTATAATTCATTAGCTAGGCTCTTTGGTTATAAAGTTTACAGAAATACTTCTATTATCCTTTCCCTTCTTAAAATTTTCATTCCTACATCTATATTTTATTACAATGGTCCTAATCCATCTGATCTTAATCGACTCCATCTCCAAACCCACATTTTTAAATTGTTTCACAGCTAACATGGTAAAATTAATATTTATTGAATAAAGAACATAGAAAACCTTAATGAAGTATATAATCTTTGAATGATGATAGACAATTAAAAATAAGTAGAAGACAGGTGTTTTATCCTTACTTTTTAAATTTTATTTAG
>TTN-214,,0,207,2986461,2986667,GTATGCTCCTTCATATATAGCATCATGCTAAAAAAGTCACATTTAAAACATCTCACATATTCCCTTTGAATTACCAGAATCCTATAGTTATATGACGTCATTTAATATGACCTAACCAGCATCCAGAATGGAAGCTGAATATAGTCATGCGTCCTCTAAATCAAATTTTGTTTCATCTGTAATGCCTATCATTTTTGTTCTTCTCAG
>TTN-214,,0,99,2986668,2986766,GTAAAAAGAATTATGTTGATAATAAAATGAACAAGTTATTATTGAGTATTATTATAAGGGAAGGAGTAACAAATGTGTTTTAATTCTTTATTCTCCTAG
>TTN-214,,0,102,2986767,2986868,GTAAGTTAGAAAAGGCTTATGAAATACTTGTGAGATTTAAATTACTGTTGAGCACATCTGCGTGTGATATTGAACAAAATGCGTGTTGTATCACATGAACAG
>TTN-214,,0,1483,2986869,2988351,GTGCGTGAAACACTATGGAGTCCTTGTGGGTACAGCATAGGTCAATGGCAAATGTTGTGCAGGACCCCTGCAACCCTACCTGTAGACACACACCAAAGTGGTCATGTGTTCTTATTTCCCAACACACGTTCTCATAGTATTCATCTCAAAGTTCATACAAAAGCACAAGGGAAATATTCAAATGAGTGTCAGTTCTTTTGCATCGTTCTTTTAGATTTTAATCTAGTCTAAGACATAATCTTTAACAGTTATTTCTGTCTAAAGTCTAAATTTCATGATTCTCATATCTAGGATTGTAGAAAGAAAGCTAGGAAAGGACAAGATCTCATAGATGTAAATCTGGAGGATCTTGGCTAGGAATTGATATTTTGTTTATAGGACTTAGTCTGACTTTCTCTGTACAAAATTATATAGATAACATAAACATGTCATGTGCAATTAGCAACTATTTTTCAAAAATATTTATTTCATTTTCAGATCATGTTTCAACCTTCTGAATCTCTGAAATTAAGTGAAATCTCAGAATTTAGGAGTAACAACATTCATTTCCTAATTGATTATACACATTTTCCAAAGACACCCTCAAACTGTATTGAGAAAAATTTTGGCTATGATAATAGCATCTGCTTTCAGCTATTGGTGCCCATTCGTAGTTGCTGAAACACAAATATATGACATTGGATTTACATAAGCATGTCAACTTTTCTGACTTACCTTACAATGAATATCAGTGACTGGTTGTATTTTAAATGGTTTTCAAATTAAAGGGCCAGCTGCAAGTACTAATTATTTTTTAAATAATTGATATTTTTAATATAATTCTTTAGTAAATAGAGCTCACCAGAGTACTGTGATTTCTAAGACTTTATGGTACTGTTATACATATAAGACCCTCCCCTCCAGCCTCTTCTAGAAAGCACTCCTGCCATCCACACACATACTTTGTTTGTGCCCATATGTACTTAGCAGATTTCTGAACTCTAAAATTTTTCTTTTTGAAATTTAGAAGTGCAGATTTCCGATTGCGTTTGAAATTATTTTACAGGAAAAGTTATACATATTAGATAAACAATTATAGATCCTGAATAGCAAAAATTATTTTACTGAGGCAAGAAAGAATTTCACAGAGGAATAAGTTGTAGAGTACAATCAAGTTTGTGTTCCCTAACACTTTTAAAATTTAATTTGACTTTGGGTCATTAGCTCTCTTTAGTATGTTCTTTATATAAATATTTTAAGAACTCACAATAATTTCTTTACACTTTGCTACATTCGACCAGCATGAATACACTTAAGAATTGGGATACTTTTTTGTTAGTGATGCAAAGAAGAGTGCATTTCTTCTCATTTTGGATTTTTGAACTTTTCTTGCTATTTTATAACTGGGTACAAAGATGGAGATTTTAAGTATCTGAGGTAAAAGCAAGTAAAAGAAATTCCTCTCTATATAATCTAACTTTGAACCCTCTTTGTACTTAAACAG
>TTN-214,,0,208,2988352,2988559,GTGATTTCATTGACAGTTTTCCAGTGAATGTATAATTTAAGCCTCGTCTGTTTTCTGTATTTCTACCCTGTATGCGCTCATGCTCTCATTCTATCTAGAATGCTTTTTTAGAAAAGACAAGTGTAAATAAACACATACGTATATTGAAGTAAAGAAGTGTTATTTGCAACATATCAGAAAACAAAAGTTGGATGATTTTTCACCCTAG
>TTN-214,,0,101,2988560,2988660,GTGAGGTAGCGCCATCAGAAAGCCACCCTGCCATCTTCGAAACACGTAGCCTACCTATACCATTCTGAACACAAAAATATCATTTTTTTTTTATTTTGCAG
>TTN-214,,0,452,2988661,2989112,GTAAGTTGTTTTGTAAAAATCAATCCTTGCTTACAATAAATTTGGCATAATTTTGTAAATCACAGAAGCCAAACTAAAATGTATAAGATATCTTTCTCTTTTGGGTAAAATATTTTTCAATAAAACTGTTATGCAGTAGAATTACTTTCAGTCAAATAATAAAATGTTAAACCTTGTGAGTCTGGCAAATTAGAGATAATAAGGTCTCACTCAGCTGATGCTAGAATCATGTTAAATAGAATAGCCACAGAATGAAACAAATTTTGACAGTGAACAAAACTTACCTGCGTGGTTGCATACAAAAGAATACTAATATTATTTTGTCTGTATATTAGATTCTGCCATTAGATATGCCTGACATATCTCAGGATCTAATAAATCAAACACACCTTAGTTTTCTAATAAATAGCTTGTTCTCAGTCTCTCTATGCTTATTACATGTCCCTTTCCAG
>TTN-214,,0,324,2989113,2989436,GTAAGACCCAGAACCTCAACATCTGAGCTTGGAGCAGCAATATTCTAGCACTAGGAATCTGTACGAAATTTTATACCAGCGACCAAACTGCAGCAGAGTCAGAACAAAACCTTCCATGTCATATTCTTCAGTGAGCAATTAGAAATTAAAGTAAAAAAAAAAAGTAGTTCCAGTTATAAATAAATGCTACTTTTATTTGTTCCGACTGATGAATTCGTACTATAATACCTATGAAGTACTGAAAGAAATGCATGAGACTTTTCATTATATTTTACGCAAAATAAGAAACTAAAACATGTTACTAACGGCATTTATTTTCTTCAG
>TTN-214,,0,2205,2989437,2991641,GTATTATACCTCATCTACCTAGATGTCGAAATAAGAATTTCACTCTGCTGACCCGAAAAATGTTGCTTAATACAACGCATTGGCCCTCTAGTGGTCAAGAGGTGGAATTGCCTTTCAAAATGTAAATTACTTTCTCAAAGTATTAGCTAACTAAATGTGTAAGTTATGTGCTTAAAACTCTGAAAATCATCAAACAAAATACTATTTTGGTATTAAAATATTTTATTTTAATGAAATTACTGAAACATTAATAGAGAACTAATTTAATGTTTCATATTTTCCTAACTACTATGTATAACAAAAAGAATAATGGAACCAATTTCTAGTGCAGCTTATAGAAATAAACCATAGTAGTTTACAGCCAAATTGCAAATTATAGCTTGTGGCTTTTCTCAATTTATAGTATTAACTACTCTTAAAAATTTACTATTTTGTCACATAAAATATGATTTAGAATACTTATGAAATATTTGACTTCTTTTGTACCTAAGGCATGATCTCACCAATAAAGAGATCTTAAGTGTTCCAAGGAATTGCTCCTCTCAAATACTCAGTAGAGAAGTTGTAGTATTTGTGTCCCAAAGCTTCTCAACTAAATTAGACAACAGATTTCCTGGGACTTTCTGGAGTTATAGGGAGTTCAGAAATGCTGTCAGAATTCTCCCAGCATGGTCAGAAAAAATTCTGTATGTCAAAATCACATTTTTCTATAGCTAAGTCACTACTACTGTATTAGATTCAAGGGGTGGAAATGGTAGGCCCTTAACACCCGCTATAATTGGCATTAAACGCTTGACCTATTTTTCAGCCAGCCTTAGAGGAAATTCAATTAGAAACTTCCAATTTTGTGACTAATGCAACCTCATTAACAAAGAGAAGCATTTTTATGATTCATACGAACATAAGCATTTTATCTAGCTGTGAGAACAGAGAGGAACAAGAATCAACAATCATAAATTGGATTTCCATTTCTATTTCTGTTGTCAAAAATAATAACTTATGTTAATGAATGATTTGTTCTTTGACTGGTAGTATCAACATGGCTAAGTTTGGTACTCACTGTGAAACTTGAGAAGTTAAATAATGTTTTAAAAATTAAAAAAGAGGCCTGGCGCGGTGGCTCACGCTTGTAATCCCAGCACTTTGGGAGGCCGAGGTGGGCGGATCACGAGGTCAGGAGATCGAGACCACGATGAAACCGCGTCTCTACTAAAAATACAAAAAATTAGCCGGGCGTGGTGGTGGGCACCTGTAGTCCCAGCTACTCAGAGAGGCTGAGGCAGGAGAATGGCGTGAACCCGGGAGGCGGAGCTTGCAATGAGCCGAGATCGAGCCACTGCACTCCAGCCTGGGTGACAGAGTGAGACTCCGTCTCAAAAAAAAAAAAAAAAAAAAATTAAAAAAGAGTGGGCTGGGCGCGGTGGCTCACGCCTGTAATCCCAGCACTTTGGGAGGCCGAGGCGGGCGGATCACAAGGTCAGGAGATCGAGACCATCTTGGCTAACACGGTGAAACCCCGTCTCTACTAAAAATACAAAAAATTAGCCGGGCGCGGTGGCGGGCGCCTGTAGTCCCAGCTACTCGGGAGGCTGAGGCAGGAGAATGGTGTGGACCTGGGAGGCGGAGCTTGCAGTGAGCCGAGATTGCGCCACTGCAATCCGGCCTGGGCTAAACAGCGGGACTCCGTCTCAAAAAAAAAAAAAAAAAAAAAAAAAAAAAAAAAAAAAAAAAAAAAAGAGTGTTATTTATTCATGAATACAAAAGGCCATAATCAAGTATGATTAGGAACCGTGGTTAAGGTATAACAGCTGCACAACAAAGGACTTTAAACCCACTTGTTACTCTTCCTCCTAACATATTTGTGTTCGTCCCTAAGGATGAAGCAAAGATGAAAATGTGTACTTTACTATTTATGATATCACTTAGATTCACACTCCATGTTCTGAAAACTTTAACTCTCAGCAGACATAAAATCAGTGAAGATGTAAGATCACAGTACATTTTCTATATCCCTCCAAAACAATTTTTTTGCATCTAGTCCTAGATCTTTCCAAAACAAATATCTTGTAGTAATATGCAGAATCTCGCTACTATCAACATATGGAAAAATAAAATATTTCAATAAAATTCCTAGTTTCCTGAAAGCATTTTAGTTACTTACACCAGAAATATTTTTTCTTTTTTTTTCTTTTTTTTTTTTTTTAG
>TTN-214,,0,1674,2991642,2993315,GTATTATAATTAATCAAAAAGCAGTCTTAACACTTTTTTCTTGGCCAAAACTTTTAAATTCTAAACAGTGGAGGGTGAAGGAAGGGTAAGAGTTTGCAATCACAAAATGGTACCTCTCCCTTCACTCACTTTCGCCCTCGTCTTTGACTCAGTCCTCACTCTCTCAACTCCTTTTTTCCCCCTTTTCTCTTTCCTGTCCTCCTGAGCCCCTGGGAACCAATGACAACACCAGTGTATTCTGGTTATTTCTGGATGAAAATTTAAAGAAGGTCTTGCCCAGAAATCCAACAGCTATTCTTTTTTTTTCTTTTTTATTTTATTGTAAATTGACTATTTACTATTGTGTATATATTTATGGGGTACAAAGTGATGTTATGATCTGTGAATACAATATGGAATAATTAAATCAAGCCAATTAACATATCCATCACCTCAAATACTTAACATTTTTGTGGTGAGAATATTTGAAATTTACTCTTAGCGATTTTGAAATGTACAGTACACTATTATTAACTATATTCACCACTCTGTGCAACAGATCTCAAGAAAAGCCATGTTTCTTCTGTCTAAGATTTTGTACCCTTTGACCAACATTTCCCCATTCCCTCAAATCCCCAGCCTCTGTAACCATCATTCTACTCTTTATGAATTCAACTTTTTTAGTTCCACATCTAAGTGAGAACTTACAGTCTTTGTCTTTCTGTGCCTGGCTTATTTCACTTAGCATAATCTCCAGTTCTATCCATGTTGTCACAAATGACAAAATTCCCTTTTTTTATAAGGCTGAATAGTATTCCATTGTGTATTTATATACCACCTTTTCCTTATGTATTCATCCATTGATGGACACTTAGGGTGTTTCCATAACTTGGTCTTTGTGAATAATGCTGCAATGAACATGGAAGTACCCAACAGCTGGTCTTGATAAAGTCACATCAATGTAAGATCAAGGGTTGCTGCTAATTTTAAGAGGTTGCTGCAACCCACCTCAGTATCTTTCCTGATTTAGGTGATCTAAATATCAATATTTGAAGAAAAAATACTTTATGAAGGAGGATCAATTCAAATCACTTTAACTTTCAATATATCCTCGAAGATTTTTAGGAAAACAGTTGGATAACTAAATTTAAACAAATAGTTTTAACTCATTTGACTAAGATTAGAGTACAGCAACCTCCATAAAGAAGGAAAATATGGAAACACAAGGCATCATTCATCATTCAGACTTTTCTGAGTGGTCATTTGTGAAACATCATGGAATAAGAGGACACTCAAAAAGCATGGATATTTCATGAACTTCATAGTTAATAATTGAAAAAGTCTAATGTGTTATTTTTAGCATTGGACATATTAAACATTCTCTTCATGCTTAATGTTAACTTATTAGAAATCAATCTAAACTAGAACCAATTTAAATGATCTTAAATCAATCTAAACTAGAATCAAACTTTGGCCTTTTGCATGTTTGATTTTTGTTAATATGGCCTTGCATAGCATTTCTAATGAGCTAGATTTGGAAATTATAGAAGCATTATTATGATTCCTGGAAGGGCTGGTGTATGAGTAGTAGTCATAGCTCCTACAAACAACTAACAATGATGTGGAGGATTAGTAAACATTAATAATAATGTAATCTAAAAATAAACACACATTTTTATGTTTTTAAACTCCCAG
>TTN-214,,0,851,2993316,2994166,GTAAATAAAGATAAATTATTTTTATTCTGTTTATTCCTGAGATTTGCACTTCTGCTAACTATTCTTATTTTAAATATTAGGCTTCCAACTTATTGAAAGTTGTGGAGTCTCCTCTGCTGTGTTAAATTTAGCATTAGAAATGATGGCTATTTCATATTGCCCCTTTCCCAGGAAAACAAACCCAGGCAGATGTTTATGCTGCCTCTGTGCAATGGTCTCAGAGAAAGAAGAAGTGAGGGCTAGAAAGGAAGGGCCATTCCTTATTTTTTTATTGTAGTTAACACAAATGTTAAGAGTCATATAAATAATGAGAGCCCTTAAGAACTTTAAAAATCTGTTATCTAAAAGTACCTAATTAACTTGGTTACATAATTTTAAATGTTGTTTTTATGAAACTGACTAAGGGATCATATGCAATAGTCAAAAACCTAGGTTTAAAATTAGAAATGTTTTTGAAATAATAATCAGAACTTTTTAAAAAGGTTAACTGTATAAATATGAAATATAAATTCCATGAACTTATCGAATATTAAAACTATTCCACTGGAAGAAACTAGGGGTTCTGCAAACTGGAGCTCTCATGGAATAATAGAAGGTGTGTCCATTTGATAATATTTATTGAATCCATTTTTTCATACTGGAAAAATCCTCAAATCAAGAGTAGAATGCATCTTGATACTCTACTATGTTCCATAGTCAAAAATTTAAATGGAACCAATACAAAAAAAAAAAACAAATTATCAATAAAATAGATCTGAAATACTGATGTTGTTTAACTAGGTAGATTTTTGTTTAGTGAAGCAGTTGGATGGATAGAATTAATATGCTAATAGTATCTTTATCTATTTTAG
>TTN-214,,0,454,2994167,2994620,GTATGTATAAACTGAATGACTTGTTTCCCTCTTTTCTTCATTTTTGCTCAGTTCATTAAATTTTCAATGCTATGAACCTGATTTGCAGTTTATGTGAAATAGTTAAAATGATCTTAGATTTTTTTAAGGTTAGAAATCTTTTAAAAGTTATTTTCCTCAGAGTTACTTTCATGCTTTGACATTACAAGCTAAATCATTTAGTCTTATTACTAACACTAAATTCCAAGTGCTAATTTCTAATGCAGAAGTTCAAGTTTTACTTTTACTGCCTTGTTGCATCTCTGCTTGATCCTGCTTCAAATCCTAGCACTAAGAATTGTGTTGGTAATAACGATCCCAAATATAATACTTCACACGATTATATATTATCCTTACCTTATCTCATTTGCAATTAACAACCTAAGAGAACTTACCTATTTAAGCATCCCTTCTTATTCCTGTGTTTTTATTTCAG
>TTN-214,,0,441,2994621,2995061,GTAAGTAATTAGAAATATTTAAATAGACTAGAGCATCAACATCATTATCATGGCTTGTTTGGCAGCAATGTATAAATCAGCAGTTCAATCCAATAGGCACAACTTCTTCTCTAAGCTTTATTGTGAATGATTTTTTTTTCTTAAAATTTCTATCTAATTGATTTCATTAAAAAATCAAAAGATGATAAAAATTGTAATGGTAAACTTAAATATAACCAAAATATGTTAAGTACAGAAACTTGTACCCAGAGTTCAAAGTTGTGCGTAAAGGTCAAAGAAAAAAAAACCGAACTCATCTCTCTCTTTAAAAAATGATACATGTATCTGCATATACACTTATAGGTGTGTATAAACACATATACACAGAGAGAGAGAGATAGAGAGAGAGAGAATTTTAATAGGAATTCTAAAAGTACTGCAATTTCTCTAAAATGCTTGCAG
>TTN-214,,0,152,2995062,2995213,GTATTATTTAAAACATTCCTAGCACCCATGTACACAAGTAATATGTTTACTGATCTATACTCACATTAGTTATTTATATAATCAAATACTTTTAAATTTTGTGCAAAGCAATATTCTTCAAAATACAAATATATTTGTACATATTTTTAAAG
>TTN-214,,0,590,2995214,2995803,GTATACATCTTTGTGTTTCAGCTACAAGTTCAAAATTTTTTTATTTATGTGTATGGACATGTGTACATATATTGCTAAGTAACTCACAAATCTGAAACGACCAAAAACAGCACATTTTTACATAATACAAATTTTATGTTGAGTTGCACATATGTTTAATTTAAATAGTAACATTATCTACTTTGTTTCTAGTTCTGCTTAAAAATTACATTTTTTTATTATAAAGAAGGTTTGTGTTTAATTAGTAGTTTGCTAACTTCACTATGCAATGCATTCCATTGCATATAATATTCCCTGTCCTCTTATTTATAGAAATAGACCCTAACAGATTTGGAAAAGCACAACATTGTGTGTGAAGAAGTTGTGTCTATTTGATTCTCATTTAAGAATGTTTGATGAAGGCTGCATGCATTGTTTGTCCCTATAGATCAAAACATGATTTGTTTTCTTGTCAATACTGAATTTGTTCTCAAGCTACCATATTAACCCACTCATTCTGTGTCTAAATACTTGAGTATAAAATCCATGTGTTTGATCTGATGTCTTGTACTAAAAAAAAGGAATACTAATGTGAAATACTCTCTTTAAAG
>TTN-214,,0,232,2995804,2996035,GTATAAGGCAAACTGGAATGTGGGGGCTCAAATGGAAGGGTTTTAGGCAGATTTTTATCCCTCTTGTTGTCTAATTTGTGATCGTGTAGACATTTCTGTCTCCTTGTAAATTCTGTCATCTTTTTCATTTCATGTTTGTCTCTGTTTTCATTTTTATTTTAATGTTCTTTGTAAATTACAATTACCACCCACAACATGGCATATCAGTAATTAAAATGTACATTTTTTTAAG
>TTN-214,,0,1028,2996036,2997063,GTATTAGTAATTCATTCTAAGTTTAAACTCTTTTAATAAAAATTAGTACAAATACCATAGTAAAACATTTATGTTAGTATTAAATAATAGATTTAGTCACAGTGTGCATACCTATAGCCACTATGTACAAAGGATGTGATGGGGGACGGGAAGAACCATGAGGAAGGCACAGGGGGAAAAAAGTGAAAATTATGGGAGGCTCCATTCCCTGCTTCAGAGAGTTTGCAATCTCGTAACCTGTTACTTGGAAATACAGTGTCCTGGAGCCAGTTCATGCTAGCTCACCAGAGCCTATGGTTACATTTTCAGGAATTTTGCCAGTCAGTAGTTTAACACCACCATTATTAAAAATTAGATTATGTAAATTTACAGTCCAATAAAGTATATTTTTAAATATTAATAAATACTCAAAACTCCTATTTTACTGCATTTTGTTCTTATCTGTGTTTCTGAGATTGTTTCCATCTTTGTGTCTGTGTGGTGGAAATGCCATATAATGTACTACTGCACATCTCTTTCCAACTCCAGGACAATGACATCACCTTGACAGCCAGGGTGGGAGGGAGTGTTTATACCACCTTGGAAATCGGAAATCTGCAAGCACTATAGATCAAGGCTCCACCCCCTCCATCCCACCCAAATTGTTAAACATTTAAGACACAAAAAAATCTAATGCAATTGTATTTATGAAACTGCTTTATAAAAGTAAAGGTTACAAAAAAAAAAACTAACTTCATAGTTATCGATGTTCATAAAAAGCTGGTTTCTGAGGAACTGACACAGGCACCTCCGAGGGAGGATTGCTCCTACCTGTTCCTGACAAAGTAGAGGCTTCTGCAGTTAAAGGTGACAGCAGTCACATTTTCTAATTAGCCATTCAGCCATCTTCATTTACTCTCATTTCTAAAGCATAATTTTCTTGCATTCAGTTGGTATAAAAAGGGAATCTCTATTTAATTCTAAGTCTTACAACAACATATGCCTTGTCAAATGCACACTTTCTCAAAAATGGCACTTTTCTTTTAAAG
>TTN-214,,0,397,2997064,2997460,GTAGAATAATATTTGTGAAAAAAATAATTCTTAGCATCCATCTTGTATCTTTTTCTATAAGATCTGTGTATTAACAAAATAGCATCTGTAAACCATCTATAATATATTTAATTCTGTGTATATTGATTTCATTTATTTGTGGTGATGTGTTATACAAGTATTGGTAACATTTCTAAACTCCAGATCACGCTAACTGGGTCTTTGTCTGCTTGTGTAATGTATGTAATGTCTATATGGTGTTGAGGTATTTAGCTTTCATTTCTACCACAAGTAGGCATATTTAAATTACTTCCTAATTCTCACACTGTTAGTGAAGATTTATGCTTTAATGTAATCTTAGATGTCTCAGAAGGTGACTAGAATATTCCACATTATTTCAACAATTGTATCTTTAAAG
>TTN-214,,0,2119,2997461,2999579,GTACGCCAGAGCCAATGATGGGGAGACTCTTTGCTCCAAGTGCCAGCCTTTTGCTTTCTACGATCTTCATATGTACTATGCTGCCTTTGTCTTTTGTCTCTTTTACATTCTTCTTGTGTTTTTACTGTTTGTCAGCTTCCGTGCCATGCTCTTGACATACTTTATTTATTATACTGAATATTCCTAAGACATCACCAAAAAGTATTGTTAAAGGAAGTAACTATGTCAAACTGCTATCTTACATTTTTAATATCTTCCCTCTTTTAGAGAAAGAGGAAATGTTTGTGAAACTTGTTTTCTACTGACATGTTTCTAGGAAAAAACCTTTCATCCTTCATAAATGTAACTTTTTCTTAATAAAAGCAGTTTCATGCATTATGAAGAGGTGGAGACAGGCAATGACAACTGGAGAGTGTCTGGCAGAACTGAATGTTAATTACATAAAGACGTACATAGTACCACGCTTCTTAAAAGTCAATAGTGGCGAGTCTTCAATAGTGGGGAACATACAGATTTTTTGAAGTTTACTTTCACCATTTTCTTGAGACCTTAACTGAGCTTCAGTATTTGCCATAAATGTTTCCGTTATCTAATTAGCTAGTCAAAGTACCTTTCACAGAGGTATGTTTGAATGAAAATGTGCTGCTGTGGTATATCACAAATCCCTTGCTTTGGTTTGTTTGGGATTTTTTTGGCGATAAAAGGCACTATCTTATTGAAGCACTGAAGCTACAATTGCACGCATCCATTCAGTTATAGAGAGACTCAGCAAGAATTCAACATTATCCAATTTAGGAGAAACCAGACCTAACTAAAATAGTACATTTTGAATAGTGTTCCCTTGGCCTGACTTTGCAATGTTTCTATTTTCTTCCTGAATCAAATATGCTTCTCTCTTTCTCAAACTCTTGGCTCTTTCAAAATTCTTTTGATTATCTAACCATTAAATACAAAGGTCATGTTAGTAAAACCAATACTAATACTAAAGCTACTTGAGACAGATCGTCTTAGATAAATTAAATCCATTGTTATTATGTACTACATTTCCCCATACAAAGCATAAAGAACCTTTTCTATATACTATCTGAACATTCTTGACTGTTTGTGTAATCACTAATTCGTTTTCAGCAAAGTCATATATGTCTTCTAAAGGAGACACAGAGGCATCTCTCATTTACTCATAAAAACAAATACACATAGTATAATAGCACGTATATATATATAAATACTGCATGTATATATAGCATAACATATACATATATAAATTAACAGCTATATAATTGCACCAAAATATTACAAATGCACGTGCAGAGGTGCAGGGATTCACAAAAGCTGCCAATATTGTATTTAAAATGAGAACAATTATTGCCAATAATGCATGCTGTTAAAATTCATCTTCCAATTAAAAAGTCAACATTATCCATTCTTAGAATAGATAAATCAAATACACTGTAAACATTTTTTAGGTTGAAAACCCTGTTCAAAACTCTAGAGCCCCTTAGAAAAAAAAAGCACAAATACACATACCCACAAAATTCTGCACACAAAGCTCTGTAAAGTCATTAACACATGGGTATCAGATTGAGAGACCTACTCTAGAGTGTTTCCTGAGTTTTGAATTCACTACAGGCACACCCCCCAAAAATGAGAGGAGAAATGTGGGGAAGAGAAGTAAGTTACACATATTCAACTATTCTAAGACTTCTTAGTCTTAGTCTAAAATAGTCTTAGATAAACTAAAGCCATTGTTATTAAGTACTCCATTTCTCAATACAAAGCGTAAAGAAGTTTTCTATATACCATATCCACATTCTTGATTGTTTGTGTCATCACTAATTTGTTTTTAGCAAGGTCATACAATATATAAAGGATGAATTCTGTGCACAACTTTGTTACATAACTCATTTTTGCCTAAATGCCTCTAAAACATTATTTGTGATATTTATCACATTGTGATCCTTGGAATAGTATAGTTAGTTTAATTTTCTGGATAATTTTGCTGATGCATAGATAATCCATAACAACATTAATGTACTACATAAAGATTTGTGCATGTGCCTATGTTCTTTCATAAAAGTGATATATGTCTGAACTAACATTGTGTTTCAAAAACTTTAAG
>TTN-214,,0,217,2999580,2999796,GTACAGTGGCTTTCGACGTAAAGCCCTATCTTTTATCTTTGATACAAAATATGTTGTGTTTAATTATCTGTTCATTGAGTTAGTTTAATTCTAAATGAATGTTTTGTGGTGAGAACTGAACAAAAGTGTCTGTCCACCCGTCTGCTTTCTTAAAAAAAATAACTGTGCATAGCTACTTTAGAAAATATAAAGTCAATTCTAAAAATGTCTCTTCAAG
>TTN-214,,0,141,2999797,2999937,GTACTTAATCCCATCTCCATGAAATAACCTTGTCTTTCCTTCAAGCCTCTTTAATTGCATGTCTTCTTTAATTGCCACTTCTATGTTGCTCATTTATTTGGCCTTTTTGACAAATTTTAAAATTCAATACTATCCTTTAAG
>TTN-214,,0,153,2999938,3000090,GTATTGTTTCTCCATCTTCCCAAGAACTGTCTTTATGTTCCAGTGATTTTGTTAGTTTTGTGATATGAGTGCACTGTGGGTGTATTTCTTTGTTTTGCACTGGGCTTCAATGAGATCACATTAAATTTCTAAAAGTGCATAATGTCTCTAAAG
>TTN-214,,0,274,3000091,3000364,GTAGGATTTGCCTCAATCCTCTGACAAAAAAAAAAAAAAAAAAAAAAAATCTTCGAGTGTGTTAAATTCTTGCTTTTTCCATCTGGTCTGTGCTTATACTGATCCATTGTCTCACTTGCAGTGAAACTTTTGTGTTTATGTCCTTGTGATATGTAACTTGTTTTCCCATTTTGCTAGTCAAAGTGGTGTACTGTGCAACTCTTCCCCAAATTCTAGAAAGTGAGAATTGTTAAAATTCTTGATTTTAAACTTCAACTTTAACACTTTCTTAAAG
>TTN-214,,0,452,3000365,3000816,GTATATAATCGGAAGTCAGGGGATAAATGAGTTTGTGTGTGTTTCCTCAAAGTCTCTTCTTCTTCCACATGTGATTGTTTACTTTAGAACATGTCCTCATCAGTTATTTCTCCTTATGTTGGTATTAGAATGTGTCTACCTTTTGTAGCCTTCTGGGACTGAGTCTTTTGTGTCTATGTTGGCCTTGAATCATTCGAAGGAAGTGGATGAGTCCCGAAAATGTTATAATTTTGAAAGTGGCCACACTTGGACATAACTCAAGTATCATTCTCAGTCTTGGGCTGTACTTGCCCTCATCTTAAATTAGCTTCCTCCTTCTTATAGTGAGGAAGTACCATGAAGCTATGTCCTAAGCAGATAGAAGAACAGTTATCCATCTGTAGTGACCACATGGCTGTATATACATCTGTATCTCAGCAGGCTGAATTTAAATGAAACCTTATCTTTTAAAG
>TTN-214,,0,2512,3000817,3003328,GTAAACAATGCAAATAAGCTAGAGATGATCTGGGGTTTTGATGAGGTGTTTTCTTTCACAAATTGTCTACAGACCAATGAAAAGAGACAGAAAAAAGTGACACAAATTCAGTGAACATCTACCAGTCTCATTAAATGAATATTTTGATCAAAACACAAGATTCAGGAGGATTATACTAGATTAGAGAAATCCAGTGTATTTCTTCTGCATCCCTTCTTACTTGCCTACATAGAATAAAAGAGGCTTCATATTTATATATAATTAATCAGGGCAGGTATCTCCATATACATATATCCTTTCATTAAACAGGACTTGGCTTCAGCATGGTGGGCTGGCATAAGCTTTACCTTAGTAGCCTAATGCCTAATTGGTGTTTCTCAAACATTGCTTGTACCACAATCCACAGACAGAAATATATTTTATATTATAATCCTTTAATTTTTTTATTCTAGGCATTTAAAAAATACAAGTTATAATCCATTAAGTCAATTGCAGAAGTCACTATAATGTCTTAAAATGTTTTAAAATGAGCAAGAAAATATATTACCTCATTACATTCCAGGAGTCAATGCCATATTTGTGAGTCTGAAGCCCTGAACACATAAGGCTTTCCTGTATTTTACATATGGAGAAAACCATTGTGTTATATATGGGATCAGACTGACTTGTTACTCAGATCTTTTCATACCTATAATGCTAATTATCTATAGTTTCTTAAGGACAGAACCAACAAACTATTCCATTGGGATATTTTTTCAATGAATTAAGGCAGCACCAGGTTTCCAACTAAAATCCAGCATTCTGGCTAGAGCCATGTGGCCAAAAGAACTTTCCTAAGAAAGTTCCTAAGGTCTGCTTTTAAAGAGAAATCAATAAGCTCCTTAACCAAACTAACTCTCTCCCCAGTGAGAAGATGAGTAGAATTGAAGTACATTTAGATGTCCCAAGTATCTGTTTTTATCTGTCTAATAAAAGATGGCACACCATGCCCCTTTTTTCACTTGGAACAAAAGCCCATGTAAAAATCCAAGGTGCCATAGTCTTAGTGGAATGCCTTGGAATAGGCCAAGATGGGACATGACTCCCAGGAGGAAATCCATTAACTCTGTTGTGCTTCCTGGAAGAGGCCATGATGGTGGACATAAGTCAGGAAGCTGGTAGATTTGAAGACGACTCCATCTTTTCTAAAAGTGTTTGTAAAACCAAACATAGTCTGATTTCAACTTTTGACACTATAAACTTCCTGTAGTACTCCAGACTCTAGTTAAAAGGAGAAACACTGTGATTATTTTTATGTTCTCATTATGCCCCAAAGATGGGTGGCTTGTTAGGTTTACTTTCAGCGTAAGGAGCAGATATGTTTTTAACCAGACACTTCTATTCCTTATTTAACTTTGACCAGGCATGGTGGCTCATGCCTATAATCCCAGTGCTTTGGGAGGCTGAGAAGGGAGGATTGCTTGAGCACAGGAGTTCAAGACCAGCCTATGCAACATAGCAAGCCCCATTCTACAAAAATTAAAAAAACAGCTAGGCATGGTGGCATGCACCTCTAGTCCCAGCTACTCAGGAGGCTGATGCAGGAGGATCATTTGAACCCAGGAGTTCGAGGTTACAGTGAGCTGTGATTACACCACTGCATTTTAGCCTGGGCAACAAAGCAAGACATTGTCTTAAAAAAAATTAAAACTGGCCGGGCGCGGTGGCTCACGCCTGTAATCCCAGCACTTTGGGAGGCCGAGGCGGGTGGATCACGAGGTCAGGAGATCGAGACCATCCCGGCTAAAACGGTGAAACCCCGTCTCTACTAAAAATACAAAAAATTAGCCGGGCGTAGTGGCGGGCGCCTGTAGTCCCAGCTACTTGGGAGGCTGAGGCAGGAGAATGGCGTGAACCCGGGAGGCGGAGCTTGCAGTGAGCCGAGATCCCGCCACTGCACTCCAGCCTGGGCGACAGAGCGAGACTCCGTCTCAAAAAAAAAAAAAAAAAAAAAAAAATTAAAACTGTATACACTTAGGCTCAAAAATCATGTGAAGCCTCCTGCCTCTTCTACCATACCTGCCCCACAAAACTGGCGGGGAAAACAATATGGAATATTATCTTACAATTCACTTAAATCCTCAAGTATGTTTCTGCCCTGTGGCCTTCAAATCTACAGTGCTCTGCTATTTGTGAAACTCATCTTCAAATTCTTCTGTTCTTATTAACTCAGCTATTATAATCGTTTCTTGTCCCGTACTTGTCCTGTCGTTGCTGTGGATATAAGCATTATTATCTGTATGACACATTTGAAAATTAAGTTAATGAAACCTATTTCCCATTTCCCATACTCTTCATTAACGCATGTGCTTTGATTAAAATGCTCTTTGAGTATTTTAAATAGGAACAAGCAGGGGTTTGGCAAGGGTTAAACTTTTGCTATTTTGATTACTCTTTGAAGTGATAAATTAAAGCTAAAAATAAACATGAAAAACACTGTAATTTATCTTCTTTAAAACTGCTGTCTTTAAAG
>TTN-214,,0,187,3003329,3003515,GTATGCTGACTCTTTAATTAGTTTTATCCCTATGTTAGCTTGTCTCCTTCTTTATGTTTCCTTATAGCTAATTTGTCATCCATATTGCAAATATTGATAAATATCATGTCTAATAAAAAGATCCCTTACACTTTTATCGAAAAGAAATCTAGACATTTCTACAAACATATTTTATAATCTTTTCAAG
>TTN-214,,0,263,3003516,3003778,GTATGATTTCTTTCAAAGAAATGCAACACTATTTATTTTAATGTATATAATAATACCTTCACATTTGCATAACTGTCTTATGCATAACAATTTGCATAACTGTCTACGTTTTGTCAGAACACATGTATGAACGTATTTACTGAGTATAGTCATTAACGTTTGTATATATGTGCAATCTTTTCAAAAAGTGAATGCTAAGCCCCACAACTGTGTCACTTCATATGTAAGGCAAACTCATATTCTTAAACCTAATCTTTCTAAAG
>TTN-214,,0,156,3003779,3003934,GTATATTGGATTTTATTTTATTCTCAAGACTGTCTTTTTTTAATCTTAAATTGATACATTCTTCAGATTTTTTAAACATTAACCAGAAAATAAGTGTGCCTGTGTTTAGTGTTTTCCATATCGTATGTTTGATGGTATTGCCTGGTATCTTTTAAG
>TTN-214,,0,252,3003935,3004186,GTAAACAAACCTCCCCAGCAGAAAAACTAGGAACATATGGCTTGTCTTTCTTTCTCTCTGCTGCTGTTCTTTGGGTCATACTGTTTATATGTTGGTGGGTGACAATGGTGTCTTTGGGTAGAGTATTACTTGTGATGTTTTTGTGTGTGTGCCTTGTAAATTCTTCTATTCTAAAATCACAGTACTTTCTGGCTAGTATATTTTTTACGTCCACTTTGATATAACTCCCTAATCCTAAAATTATCTTTTAAG
>TTN-214,,0,247,3004187,3004433,GTACATCCGCCCTTCCATTATGCACAATATTGTACTTGCCCTACTCTCTTTACCAAATACACTGGTTATGGGGGCTGGTTTTTGTTGTTGTTGTTGTTGTTGATGTTGTTGTTGTTGTTACAGTTGTTGTTTTATGTTTGAAATAATGAAAATGTCAAGTGTTTATGTTTGGGCTACTACTTTATGGCTGCCTTTTTGTGGTTTGAAAGAGGGAAACAATACTTTAAAGTGAAATCTCTCTTTAAAG
>TTN-214,,0,707,3004434,3005140,GTATACTGACTCTTAAAAAAAAAAAAAAAATCAAAATAAGCATCCAGACACTAAAACTAATCTAGTGGAATAGGTTCCATTAGAAAAAAAAAGACATAGTATAAAGTAAGCAATATAAGTTTGTTAATGCATATCACTTCAAAACTAAACATTTTTGATAACAGAAAGTACTTTTTTCTTAAAAAAAAGTGAGGCTTCTTCTAAACGTATGTGAATAATTTTCCTTAATCTGTATTTGTCTTCTAATGTCTTTTCCATATACTAAACTCATCTGCCTAGATGCTTGCTTTATGTGGCAATCTCTGATGAAATTTTTAATTTTTTCAATTCTGAATTTTCTACATTGTACCAATAGAGCTAAGGAAAATGTCTTAGAAGTGAGGTGAAGAAACTATTCATGTAACATAGGTTTCTGTCTAATGCTTCTACTTAGTTTGATAGTCATTATTTATGCTGTTTAGTTGTCTTTTTAAACTTTTATAAATACTACTTGATTTTCCTAAAATTATTCAATGTCTTTGACGTACTTCATATGTATATTAGAGTAAGTTTATTTCCAAGTCTATTGATTTTCTTGCTTTTTAAATGAAAGTTTAATCAGGCACTGTTATGGTTGTCTTTGTCCTTGAATTGTTTGAACAAAATTTCTCTTCACACACACATTTTCAGAATCTTGCAATTCACTTTTAATAATTACTCCTTTAAAG
>TTN-214,,0,307,3005141,3005447,GTATATTGAACTTTGATTAAGTAATGTGAGGCATGAAACTATCTGGCTCTTTGCCTTCTAGTTCCCAATCTGACTCCTATACTTTATTAGCTTATTGTTGATTAAGGGCAGGGTATATAACATTTGAAATCACAATTGCTAAATATACTCTATGATACCTTGACTGGCCAAAAAAGAACAGTCAGGGTCTCCCATAATCAGTGCATGAAACAAACGCAAAAGAATAAAATCAAAGCACATTGTTACTATCAGTCATCCTTAAAAGTGCTTTAAAGTAAAGTGCTGCCTGTTGTTAATATTGTTTCAG
>TTN-214,,0,958,3005448,3006405,GTATGAGCAAAACTGCAAACTCAAAACCACACTAAATATGTGCACACTCAAACAAGATAAAACAAGATAAATCATAACAAGATAAAAATTTGGATACCCAAAGAAATTTGGAAAGAACTTTGTTTCATTTCGCAAATGCGGAATTTTCTTCTTTGATAACTTCTAGAAAAAATTTTAAAAACCCTCTATAAATCTTAAGGTTATTGTTAGACTTTTGTTCCGGGAATAATCTAATACCCCCCTCATTTTTGCTCGTATGCAAAATAGCAAATGTCCCTAAGTTTCTTTTTCAAAAAGGTTACAAGTTTATCTTCAAGTGCCCGTGATCATTCTAGTACATGGTTAAAAATTTCTGAACATCCTTTATTCTAAAACTTGCTATTACGGAGTATGATAGGCTATTGAGAAAATGTATTTACCCACAGGGTTCCCATTATCAAAACTTGACAATGACTGCTTCAAAAGTTAAGATAGAGATGTAAGCTAACACAAGCTGTTGTGTTTTACCTAATGAAGGTCAAATTTGTTGGCATATAGTTTGGGCTTCAAATTGTTTATTTTACTCAAAGAATAAATCTCTATTGAAATTTTGAAATGAATCAATCTTATTTCACTTATTCAGTCTCTGATGTTTCATAGCCCAACTTTGAGAACATTCTACATAGTCTTACTGATAGCTTTAAAAAAACCATATTATAGGGGAGTTTCAGCCAGGAATTTATCTACCTGAAATGAAATGAGAATTTTAATATGTAAGAATTACCTAATTAAAGAAAATAGCAAGAAGGAAAGGGCAATATGAGCTTGTTCTGCTTGGATCTCTGATTCTTGCCTACTTCAATAGGCTATGGCTATACTGTAGATAAAAGATATTATTTCAATTATTTGATTCCTTTTAAGAAATGTTTAAACTTATATTCTAAGTCTAACATGAAATACCTTGTATGTACTTTTAAAG
>TTN-214,,0,210,3006406,3006615,GTAGAGTGAAAAAAACATTATTACCTGTAAGAGATCTTTGTTTCCTCCATGTCTGTCCTACTATAAAAATATATGTAAAAGTGGCAGTGTACAAATTATGTGTGTGTTTGGGAATATTATGTTGTATTTGTCTTTCTTAACTTTTTGTTCTTGCTAGCCTTGAGAAACCTGTTTCAATTTTTAAAATCTCTTAATATTGATATTTTGAAG
>TTN-214,,0,204,3006616,3006819,GTACATTACTGAGTAATAATCACCAAAAACAACTTTGTTATGTATGTTCTAAAATCATGTCTTCCTAGCCCGTCTGATGGTCTGTGTTTTTGCTGAGTAGGATGTTCTTGTCCTGATTCTTACATTTCAGTTTTTTATGTGTATTTATTACATAGTATTCAAGGAGTTGGTTTTAATGCTCTTTAATAATTAATATCTTTAAAG
>TTN-214,,0,747,3006820,3007566,GTATAATGATTTCCTTCCTCGATTGTGATCTTTTCTGATGCCTCTTTTGAAATTAATGTAACTATGATTCATTTCATTTTGTTGTTTCATGTCTTTTAAATTAGTTGTCAGCAGAATGTTGGATGTAAAAATGTGTAAATACAGGATAAGAAGATAATGCCTTTAAAAGGAAAAATTATTTCTAAATACATCCATAGCCTGTTAGCCAGTGGCTGTGTCCTGCCACATGGCTACAATACATATAAAATAGAATGTTTGGGTTTAAAATCAGTGACCGTTTGGCATATTCCTGATTTACCTAAATGATGTAATGATACCATAATATTCACCAAGCTTTGGTAACTGTTTATTCATTCTAAATTCATTTTGAAGATTTTTTTTAAAGCTAACCAGTTTCCAGTCATTTTCCCCCTGATTCATACTAAGTATGAAGTATACTAATTGAGAAGTAAATTTCACTTTTCAGGAAGGATATTTCTTTCAAGCAGAGATATTTGAACACTAAACCTCATTTCACATTTGGGCTCTGCTACTTCATGTTTACTTGGGTACTTCTGTGTACTTGTATTTATATGAAGCTCAGAATCCTTTCCACAGAGAGTATATAGTTTCTTAAAGATGAACAATCGCATATGTATCTCATTAAAGGAAGATACATTATTCTATCTGCTTAAAGTACAGCAAAACAAGCATTGGCTGGGTGGCCTTTTACTGACAATAAAATTTCCTTATACTTCATATTTCAAG
>TTN-214,,0,198,3007567,3007764,GTACCTAATGGCACTCATTTTAATGTTTTGTTCGTCTTTTGCTGTTGAATTCCTCTTCAGTTCTGTGTGTGAAAACTTCTTTTGTGGGAAAAGTAAATCTTGTCCTTTCTTCTGTTATAAATGGGCCTGTGTTTCTAAGGTGTCTTAATTTTGTTGAGTCATTGGCAAATGTCCAACTTAAAGATAATATCTTTAAAG
>TTN-214,,0,211,3007765,3007975,GTAGATGATGCCTCCTGCAAAGGGCTGTGCAACAGCATCTTTGGAGTTTGGGGGTCTGATTTGGTCAGATTCTGGGGGTTATTGGCAGCACCAATGATTGCTTACTTTAAAGCAGATATTTTTAGATGCTGAAATATGATTTCTACAGGTGCTTTTCACATTTTATTTCTTTCCTGCAAAATTTCCAACATTCTTAATAATATCTTTAAAG
>TTN-214,,0,182,3007976,3008157,GTACACCACCATTCATTGACGGGTATCTAAGAGACTTCATCTGCCTAGAAATAGTTAACTTTCTTCTGAGTTCAAAACCTTGTGTGTGTGTCACTGTCCGTTGTTAAAAAACATTAGCTGTGTTTTATATGGATGTGTTGTTACTAGTAGTTAGAACTTAACAATAAACAATATCTTTAAAG
>TTN-214,,0,508,3008158,3008665,GTACATCCTTATAATCCATCAGTGGAATAGCATGATAATTCACCCATGCAGCATAACTTGGTGAGCCATAGCAGATCTTTCCCCATGACAATATTAACAACATTAATGCCATGACAAGCGCCTCTCAACTGGCCACAGGAGCAGTTTACCCGGTATTCATCTCTGAATTTTACCATCAAATTATGCTTATGCTCAATGGTTGGCTCCTCCTCTTTAGTGGAAAGTTCTTCAAGTAAAATACATTCCTTTTGCATATCAAAATGGACAAAACCATCATTTACCAGGCATTGTGTCTTGTCTTTATCACCAGTCCACGTTTTTTTCGGTGTTTTTTATTTTAATTTTTGTGTATTTTCTGGCCTTTGTTTTGTGGCTATTATAATTTTCAGTCTTAAAGTGAAATTGATAGAATATCTATGCTGCTTCAGTTAAGGCCTTACATTGCCAGCCTTAAAATCTTAGCTATGGGTAAAAAATGTGACACTAACTCTATTTGATATCTTTGAAG
>TTN-214,,0,249,3008666,3008914,GTACATGAACTTGCAATGTTGCAATATTTTTATTTCACATTTGCATATGGGTAAAAATTAATTGGTTTAATTCTGTACTCTTTGGGATGCAACTCTTTAGAGAAAATTAAATATTTTATTTTAAAAATAAAATGCTTCTTGGAATACCTTTGTCATACTTTTATTACCTTATCTTAATCTTTTGAAACTATGCTTGGAATCAGTATTTTTATGTCGTATAAAATTTTTCTCTAAATCATTTCGTTAAAG
>TTN-214,,0,205,3008915,3009119,GTACATAATTTCATCACTTAGAGTACTTGGGGGAAAAAACTCACATCTATGTATACTCACATACAAATTTCCCCATTACATTGTACATTTTTAAAGTGTCTATCTGGTTAGAAATATGTCAGATATTTTGTGATTCTTTTTCATATCTATTGCTCTAAGACATTTTAAAAGAACATATTCCTAAATATAAATAATATCTTTAAAG
>TTN-214,,0,207,3009120,3009326,GTACATTAATCTGTAACAGAGCCATGGTAAAAGACAAAACTAACTGGTGTTATACAGCCTTACTAATTATAATTAATGCTTAGTATTTATGTTGATAATAATTGATGCTTTGTGATCACAGAATATTTGCCTTTCATAAGCTTCTTCATTGTTGTGAATATTTTACATAAAAGTGATGTTTGTACCCTTGAATAAATATCTTTAAAG
>TTN-214,,0,1625,3009327,3010951,GTATAGCAGCTCTTCTTGGAATCATCAAGGCCTCTTTTGTGTTGAATTCTGCTTTCCCATCCTTTTGTTCATCTCCAGTTTTATCTATAATCCTTTACCCTCTGTGATTGACCACCTAAATCTTAGAAAACATTCCAGACATGTGTGTTCTTATTGTGTATCTGCCTTGTGTATCTGTCTATTGTAAATTATCTAAATGTCTTTTCAAATCACATATTATGTTTACATGTTTGTGGTCTTATCCTCACGTGTCTCTTTCATATATATATATATATATATATATATGACCATGTATATGTGGTTTTTAATGCCTTCAAATGAAATGTTTTTAAGTGCCTGAAGTGCCAAAGAAACCTGTACCAGAGAAGAAAGTCCCTGTTCCCGCCCCTAAAAAAGTGGAACCTCCACCACCACCCAAAGGTACACCTCCCCAAAGTGAATACACATTGTTCACCCATAGCTTGGTCACATAAATTATGATGAAACTGGGTTTTAGGAAAATTATATTTACAAAATGGATAATCACACAGTTACATATTTACTTCTAACGATGTTCAGGAACACTGATATCTACTTTTTTCACTGATACAAAGCAGTATTCAAGAACAAAGATGAAAGGAAGCATTGTCCCAGAACTGATACAAAAGTTCTGATTTCATATCATTTGATTAAACATCATAGTTTTCATGGAGATATATTTAAATATATATGAATAAGTATACTATATATTTAAATGTATTGAAAACTATTATGAATAAATATTCTTAAATTTCTTCCTTCAACCATTTATATTAAATGCCTTTTTAACACCAGGCTAAAAAGAAAAAAAGATGAATGTATTTATCAAAACACAGAATAATAGTTATGTCTTCTAATACATATATATAAAGGGCAGCCCAACAGGTTTTGATTTTAGCGTTGACTTTACACCTTGTTGTATTACTCTCAGCGAGTCCTTTAACCAACCTGAGCCTGAAGTTATTTTCCTGTAAATTGGGGATGCTAATATCAGTCTTAATGGGCTCAGCTATTATGGTGAGAATTAAATAAAGTAAGGTATTAAAGTAGTCTATCATTGAATGAATAGTATCCAGATTTAACATATTCAATCAGCTCATAGTACAGGACAGAATTAATATATTTGTGCTTTAAAGCTCAATAATATTTTCTACAAAAGATGCTGGCATGGCTGCTTAAAATCAGCATAACCCTCGCATCAGGCCATATAGTTATATAATCAAATGAAATAGTAAAGCTGATCTTTTATTGGATATCAACGATTCAGAAATACTTTCTAGACAATAAATTACTAGTGAAATTTAAATGTATGAAATGATATTAGGTTGGTGCAAAAGTAATTGCGGTTTTTAGCATTAAAAGTAATGTCAAAACCGCAATTATTTTTGCACCACCCTAATAGCATCTGTCCTCTGATAATGACATATGCTGCTGGTCCCTTGCTTTACAAATCCCAATTACATTATAATATCTGGGCTCCCAACTAACATGACAGACCTGTCTTGAGCGACTGTTAACACATTGGTCTTTCTGGGTGTGGGGTCTTCTTGGTTTCTCTTTTTTTGTCCTTCAAAATAAATCCTTATCATGAAATGATGTCTTTAAAG
>TTN-214,,0,807,3010952,3011758,GTATTGCTATTCCGAAGTAAATTAGACTATGCCATTTCCTTCCTTCTCCTATAAAAGTCAAAATGTCCTGTTTCCGTATTTGTTAATACAACTTATATTACTGCTGTGTCTACTTGTCTTTGTGTGTGTGAAACTGAACTTATAAAATAAAATAATATTTTTAAAGTGTCTGTGGTACCTAAGAAACCTGAGCCAGAAAAGAAGGTCCCTCCTCCTGGTCTTAAGAAAGCAGTGGCCCCTCCTGCCAAAGGTACATCATCCCATAACAGGGATATGTTTGCTGCACCGATGTTGAACTGTGGTTCTATCCACACAGGACACTCAACATAAATGTGTGCATTGTATGGTCTGTCATTCACATTCGTCATTTCTGACTCTTTTGCACCCAAGTTTGTGTTGTGTCCATTTTTTCACTTGGTGTTGGTGTGCTTTACATCGTTTCTCTATGTATGTTGTTTCTAAAAAATAAAAATATATCTTTAAAGAGCCAAAAATAACTAAGGAACTAGTCCCTGAAATACCCATTTCTTCATACCCATTTCTTCCTACAAAAAAAAAAAAGACAAAAGAAAAAAGAAATAGAGGCTCCAGCAGTAAAAAGTAGAATTTCTCTTTAATAAACCCTAAATCTTAAACCACAAACCTTTTTATTCTTTTCTCATTAACCGATTCTGTGAAATGTCAATGTTTCATCTTGTGTATGTGCCTTGTGATATTTACTCTCTTATGTTGGAAACTGGAAACGTGGTCTTTATTCTTCTTTGGTTCTTGCATTTTAAGTGTCTAAAATAATCAATGTCTCTCAAG
>TTN-214,,0,629,3011759,3012387,GTAGATAACTTTCTAAGAAAATAACATTTCAAAGTCATCCTTGTCTTATTATTGTCTAATATTTGAAGTAGGTAAATGTAAAATTTACCCCAGGAAATCAACATATTCAGATTCTAAAATAAATTATTATTAACCTAATAGAAATTGGGCAGGCAAATTAATATTATTTGAATCTCTTTGCATGTTCAGCCTGTTTGTCTGTTTGCTATTTGTTTTATTTTAATTAGAATTCATGAAGGGAAACTGTATTTGCTGTGGGAAATTTTTCATCAAATGACTTAGTAGGCAACTGTAAAATAAGCTTATCCAAGAGAAATTCCAGTTAAGCCTGAGTAACTGGTGCAGAAAATCTGATTTCTACCCCAAGTGGCTGTTTGACTTCAAACAAGTCTTTCATTAAAAAAAAAACAATAATAATTTTTTTATTATTATAAATTATCTGAAGTCCTTTCCAGTTCACAAATGCTGGGATATGCCTAACATATTTTGAAGACCCAGTAGAGATTTTTTAAGGACTAGTGAGTTTACACAAGCGTTTCGAAGGCTGAGCAGTTTTCAGATATTATCACTGTAGTCTAATATTCAAAATAATTATAAAAATAATTTACAAAATAATAATCTTTTTAAAG
>TTN-214,,0,603,3012388,3012990,GTATAACCGCTTTTAAGGATTGAACATTTAAAATTCCTGGTGTTCCAAATCTTTCTCAGTAGCTAAATCTAAGATTCACCAGTATGCTTTTCTTATATCGTATCCATGATAAAGTGAAGATTAATTATTCCTGGCACCTGAATCTATGTGTCCTTTTTTTACCCTAAATTTTTCTACAACATCTGCAATACAACTAAGAATGAGAGATTACTATTTTGTTATTGGCGATTGAATTTTTTTCTGACCAGGCCCTACTATAATAGTTTCTCCTAGATTTCAATCCTTAATTTTGTTTTTAATATTAATATGGGGGGAATCTATTTCTCTGGTGAAAGTGTTCATTTTTTAAGAAAAATCTTTAATTTACTATTCCTGAAGAGTGTGATAATATTTTGCATAATTGGTATTACATTTGCTTATAGGATTTCTAAGTAATATCCTTTACACCTCTAGGGTTCCTACTCCACATTTATTATTACCATTTAGGTTGCTAATATCTTTTAAAAATAAGTCAATGTTTTGTGATATTTATTTATTGGTATATGGGTGGTGTTCTGCTCATCACATGCCACTTTTCAAAATGTTCATAAAATTTCTTTTAAG
>TTN-214,,0,929,3012991,3013919,GTATATCAAATCCTCATTATTAATATCTTTAACTTCCCATTAATTTTCTTTCTTAAAAGCAACATTTTCTTTTTTGACTGCCTTCTTATAATCATTTAGATAGTGAACTGATTAAGGACCAGTAAAAATATAACTCATTCCATTTCTTTAATCTTTTCTAGGATGTTAACGAATAATTGTGTGCATGTGTTTACGTATGAATTATTCTAGAAGCTTCTTAACTGAGAATTTTAATATATTAGTATGTCTCTATATACTTATACACATAGCAATGGATCCCTCTTCCCCACATTTTAGATTTTATTCCATAAGTGGAACGGAGTTTTCTTCTGTGTTATAATAATTATTTTACTATATTTATTATTTTATGGAACAAACCTAATGCTTGGATAATAACTATTTTAAAGAGCCTCACGTCCCTTTTGTAATGTTTAGCCCAAGCATTCAAGGTTATTACAAAATGTCTACTTTTCCCTGCTTCCTAATTCACTTAATGCTTCAGACAGTGCTCTTAAGCAGTTAGATTATGCTGTCCCTGTCATAGTAGACTCCTCAGCTAATAGAAGAGTGCACAGCAGAAAGTGAGGCCAGTGTCAGGGCTTAAATACTCTACAATGGTAATCACTTCAAAAAAGTCTTCATCAAGTTAAAAATAGTAAAAGTGAGTCCATATTGGTAATCCCTGTTATTAAAAGAAAAAAAAAAGAATGGCACAGGTACTTTGTGGACATTTCTTCTTCTATAGGAATGTTAGAACAAATGAGTGATTTGAGAAAGTATCTTTATTGCCTCTAAAATGGATGTCCCACAGTACAGAGTGACTTCTGAAAAACTTTAATTATTGTAATGTTGGCGTTGTCTCTGGTGTTTTTATTTCATGTGTGTTATTGAACATTCTCAGCTAACTAAAACACCTAATATCTTTAAAG
>TTN-214,,0,153,3013920,3014072,GTACATCTTCTCTTTTAAACCTGACTTCCTCTTCTGTCTTTTTTCGTTAAGACTTTTATGTTTCATGTCTCTGTGTCTTGATTGTTTTTGATGATTTTTGTCTATGAAAGCTTGCTCTCGACAGTCCTAAATATTAAAACTGTATCTTTAAAG
>TTN-214,,0,139,3014073,3014211,GTATTTTTGGAAAGATCCTGGATTTTCGTGTATTGTTGCATGCAATCCTTTATTCAGTTTTAAAAATATATATTTTGAATGTACATCTTTATTTCTTCAGTGTTTAAAAAAATAAGTCTTAAAATAGATGCTCTTTCAG
>TTN-214,,0,800,3014212,3015011,GTATAGGGAATTCTTCAAATACTACAAATTCTTATATCTTGCTCTAACTTTCCTTTGAAAGTAAATTTTGTGTTCAGTTTGGAAGATTAGAAACCCCATGAAATACTTTAAACATGAGTTTAAACTAGTTGACACAAAGATTAATATCTCTTAACCACACGGAGTATAATTTTAGTAGATGATAGTAATATTTGATATCTACTTATCTAAGGAGGTCACTGTATGAATTTGGGGATTATTTTTTAAATCTGACTAAGAATGTTACACAATTGTTACAGGTACCAAAATAACTGACCAGTGTCATTGGTTAAGTGAAAAAGAAACTCCTCAGTTCACTGAGGAATTTACATGTTCAGGCAAAATAATCACTGCTTTAACATTTTAGTCAACTGTTCACAAACTGAGAAATACTTACCAAAAGCTTTTGCCAGTTTATGATACTTTCATTAGAGAAACAACATTAAGGAAGTGAAGTATTGTTAATGGCACCTGTATTCTAGCATACTGTGAAGACAAGCCATAGCACAAATAAGTTATCTGCAATACCACTCTAGATCTTGCACAAATTAACAATATATGTGTAATATGAAGGAATGTGTGTGTGTGTGTGTTTAGCATATATAGCAAATTACAATATACATGATATTTAGCAAATCAAATCTCTTTTGGAAATAAGTGTGTTATAAATTAAAAAAATATAGATAAAGAATTTTGTGACCCCTCATTGTACTAACGTTAGTAGTAGTGCTCCAAAATACTTCAAGAGTTCATTCTAAACCAAAATACTAATATCTTTGAAG
>TTN-214,,0,794,3015012,3015805,GTATCTTCTTTGTGAAAAATTACTACTTAACTTTACATACAATAGCACCTTGGTTGCTTTATAAGCACAAGTTTGCATTCCACTTGATGTCTTTCTTCTGTATTTCTTGTTTCTGACATGTCTAAAACAAACTAATATCTTTAAAGCAGCTGAGGGTCCAAGGGAAGTTCTACCAAAAAAAGACAGTCACTGTTGTTATACCTAAAACAACCAAAGCAAATATCTCTAGTAACCAAATAGTGAGCCCAAATTTCCTCCTTTGGTGCTATTTGGTTATATATTCACTAACATGCTTACTGATAAACACATGTTTTTCTATTTATTATTAATTATATTAACCTGGCAAATATAAATACATAGTGAATATGTGTTTAATGTTCTTGCTTTGTTCATTTTTGCAAATCTCTTAAATTTCACAATAGAAATAAAAACAGTATCTAATAAATAATATAAACTTATTTCTTTAAAGTCTCTGAAGCATGTGCGTAAGTTATCACTGAAGAGAAGGTAGCAACTCTTCCACAAAAACAAACAGTAATAGCACCAGCTGAAGGTGTACTGTTAATTTTTCTTCTCAAGTTCTTACCATTCTAACATGGGAAATTTCCCTGGATTTTTGTTATTATATATTTTTTAAATTCAATGCATTTGAAATACTGTAATGTATTTGATAAAGTGTTGTCTGCATTTTATATTGTTGCTGTGTTCTGTTCTGTGTTTATATCTCTCATGCTCTGCTTGTTAAAAAATTGTATATTTAAAAATAAAAGAAATTATTACTATTATCTTTAAAG
>TTN-214,,0,11423,3015806,3027228,GTAACTGGCTTTTCTCATTCATCATTAATATAAAATCCTTTTTTATTCACTTACTATGTAAGAGAGACCTTTCTCTTCTCAATGCCACAAGATGGCTATGAATGACATAAACTTCAATTTATGTTCTATAACATAATCCTGCCTTTTGAGGCAATGTTTTAGGCGTAAAGACATAAGCCCAAAGTTATCATTTGTATTGATCCTCTTATTTAATAACTAAATAATATTGATCCCTCAACTTCTCTTTCAAAAATAATTCATTTTGGAAGCTCTTCTGAAGTAGCTCTGGAAAAAAAAAAGTGTGCTCTAAATGGCAATAGAAAATGATACTATCTCCAAAGAGCAAAGTGTTTCTGATATAATGAATCAAGAACTCATCGACAAAGCAATTCAGAGAAATGCAATGACTACATTTGACTTATAGTTGACTTATAATTGAGGGGTTTTTGGCGTTCATCTTGTTAGATGCCCCTTCTAGGCTTGCTATGTTTACACCCAACTATAATGTTCTGAAAAAATAAGATAAATAAATATCTTTAAAGCACCCGAAGTACCCAAGAAAATTGTCCCAGAAGAAAAAGTTCGTGAAGCTGTTCTGAAAAAGCCTGAAGTTCCACCAGCTAAAGGTATACAGTGATGCTAATCAGAACATGAAATAATTCTTGGTTTAGTTTTTCATGGTTTAAAGTGAATGTGTGTGACATTAAATCCTTGTATTTCGTATCTTATATTTGTTATCTGTAACAATTAATATACTAATATCTTTAAAGTTCCTGGGATGCCTAAGAAAAGTGTTCAAGAAGAAAAATCACCTATTGTTATTTCTGAAGACACAGAGATGTACAGTGAGTGTAGAAAAATTAGTGGTTCTTTTTCGTTTCATTTATGTCCTTAAATTCACTATGTTTGTCTTTTTAGCTTTGAAAAGTAAATATACTAAACTCTTATAAAAGCCTAACATGCCACAAATATATGACTCAAATAATCTTAGTGTCTATTATCCTCAGACAAGTTATATTTCCTCACCAATTTAAAAAAGAAATACTCTACTTATCAGAGTGTATGATTTCAGAAAAGTCAGTTGTCTTGTTAAATTTTCCTAACCTATTCTGTATACAAGTGTCTTTTGCTTTGAAGCAATTTATTTTCTCAGATCATGAAGTAACTTAACTCCATAATATTTTAATTGGATTTTATAAAATCAAAATGTTTCACCATTATTTTTTTTTTTACTCTTGATAACCATAATTGGAAACATTTTGGCAAAACTGCTCAAAGGACCCTAGGTTTACAAGGCCACTCAAACCTCAAAAGAATTCTCACGACCTTTTTTTTTGGGGGGGGGTTTCATACAAAATTAGGTTTAAATAATTTGAATTATGAAATAATCCAAATAGTAAAATATTGTGAATAGAATACTGTTCAACAACCTGAATAGTAAAAGTGACAGTAGTCAAAATATTCTTCCTTTTTTTTTTTTTTTTGAGATGGAATCTCACTCTGCTGCACCCAGGCTGCAGTGCAGTGGCACGATCTTGGCTCACTGCAACCTCCGTCTCCTGGGTTCAAGCTATTCTCCTGCCCCAGCCTCCCGAGTGGCTGGGATTACAGGTGCCTACCACCAGGCCCGGCTAATTTTGTGTATTTTTAGTAGAGACAGGGTTTTACCATGTTGGTCAGGCTGGTCTCAAACTCCTGACCTCAGGTGACCCGCCCACCTCAGCCTCCCAAAGTGCTGGGATTACAGGCATGAGCCACTACACCAGACCCGCTTCCATTTTTTTTAATCTAAAAAATTTCCTGTTGAAACTCAACTTTCTTGTTGTTCATCCTGTTATACTAAGTTGGGATAAAATAATATAATCACTTCCTCCTTTGAATATCCTTTCTATTCTTGACTTTAGTTATTGTTTTCAGACAGTTTTTCTTTCTAAAGGCTGGAGAAATTTTTGTTGTCTTTATTTGCCTTATTTTCTAAGTATTTAATTTTTTTAATTTTCTGCCTCCAAACCCTAAATGGCTTTTACATTCATATTAAACTGTGAAACCATATATTAGATGTGATTTGAAAATATAGATAATGAGGCTTCTAGAAAGGGAAAAGACTTACATGAATTTCTAGTAGGTCAAATATCGGAGAATTCTCAATGTGCAATTCAGCATCTTCCCTGTTCTTTATAGACAAATCCATTAAAAATAAGACCAATAGGACAATTTTACCAATAACTTTCTTAAGGCAAAATGAAGAATTATATAGTCCTTGCCTGAACAATTCCTCCATTTTATTATCATCATCATAGAGAAATGCTTAGAGTCTTACATCATGAAACTGGGAGTGAGGCTATCCCCAGCCAATGCATTCTAGCCACTAATTTGCCTCTATGTGCTACTATTAATTTTGGTGATGAATGTGGTATTATATATTATATTTTTCTTAATACACTTCTTTATCCACCTTGAAACATCCTAATTATTTAAATACTAATATCTTTAAAGTTTATGAAGCATCTGAAGAAGCAGTCCTAGAAGAAAAAGTACTTGTGACTCAACCTCAAAAGACAAAACCCAAACTAGCAAAAGGTATATAACACCAATGATCCACTCTGAAGAAAAATTATTTTTTGGCCCCTTTTAAAAAGCTCAATATTTTTCTTCACCATTTATAAATATAACTATACTCATATCTTTTAAGTGCCTGAGCCACCCAAGAAAGTTGTTCCAGAAGACAAAATATATGTGACTATTCCTAAAAAGAGAGAAACACCAGCAACTAAAGGTATATTTCAAATACATCAAACCCAGATGAGTATCTTTAGCTTTATGACTCAAACATTGCATGCTTTTTATAATTTACTGTTTTTACAACTTTTAAATGTAAACCTACTAATATCTTTAAAGAACCTGATACAACCAGAGGCATTTTTCCAGAGGTGGAGCCACCTGAGGCTATTCCTGAAATTCCAGAACATCCTCCAACTGAAGGTATAATTCTCTAGTTAGGAAAATCTAAAGAAGAAAATATACTGTCTTCAGTCTGCAAAATATTTAATGTTTAATATACATTCTCACAACCTCTAATGTTAAAATACTGTGTTTAAAGGATCTGATATACCCACAACAAAGAATGACCTATGACTTGCCCCCAAGAAAGTCAAGTCCCACACATATAATATACAAAGATAAAATATTAGAACAAAAATAACATTTCTAACATAAAGATATCTGAAATGATATTAACATATCTAACTTTCTTAGTATGTCATGTCTTTATGCCTTTGCCTTTTCTCAATTAAAAAAAATACTAATATCTTTAAAGAGTTTGAAGTCTTCAAGGAAGTCATTCCAGAGGGAGAAACTCCTATTGTTAAAAGAAGAAAAACACCATCACCAACAGGTACAAGTTGGAAGAAAGTCACCTTTTTAATCTCATGTTTGCAGTTGTACTTAACACATGTAAAAATACTAATATCTTTTAAGCCAAAGTGGCTACAGTGGAAATCATTTCAGAGATGGATCCCCCAAGTAGAAGCTCAACCAAATGTATTCATGTCCCAGTGAGTCACTCAAGAGACAACAGAGGGAAAAAATACCTTTAGCTTATACACATGAAAGATAGTTGAGTCAGTGTATTTTTATGAGGACTCCAAAGAAAATATATATACACATATTATGATCAAAACATGTCTTAAAGAAAATATTAATTCAGTGTGAAGCTGATCTGTAATATCTCTACAAGATTAGAGCACCTGAGACCCTCCCAGAATATCCTCCAACCTAGGGAAAAATAATTCCAGTTAAAGCTGGAAATCTCCCCTCCATGTTCATTTGCTCCTCTCATAGCCTATCTTTTATTTTTCAAGCATCATTTTTTTTCATTTTGAATATCTTTAGATAAGTCAAAACATGAAAAAGCTTTAAAACCTCCAGAACAATAATTTCATCATAACACCCATGGTATTCTGTAATTTGAAGAATATCTGAATATTTTGATATTTTTTCTCAGTCTGGAATCTTTTGGTTGTTCTCCTCTCTCCTAAACTTGAAAAACACTCACCTTTTTAAGGTGCCTGAGGTGTGAATACAAAAAAATGCCGACCTAGATTTTTCGAAGTGGCTGTAATTTGTTTTTCTCAACATAATAGCTAGAGGTATAGCATTAATTATAATCAATGTTTCCACTTTCCATGATCTAGTTTTCTATGCATCTACCATTCCAAGAAATAAAATTACTAATACTGATAGTGCCTGAGGTGACCAAGAAAACAGCCGCTTATAACCAAATACTCACACTGCTACAAAAGATCCGATTCTGGGGGCGGGGAGTGGGAGAAGGTTCCCATCTGGAATGTTCTGTATGTGCAGTTAAGATGGGAACTCTTTACTCCTCTTCATAACTCCAAAGTACAATGCATTCATATCTTTAAAGTGCCTGAATCACCTCGAGAAATTGTCCCTGTAAAGGAAACACCCATGGCTGCTCCCCTTGAAATTGAAATACCTCCCACTAAAGGTATCGTTCATCCTGCCATTCCTTCCTTCATTTATTAGAGTGCTTAGCATGTACAGGGTGCTAGGGAACTGGAGAATAATAAACAAAGACAATTAATATGTGGTTCCTCTCCTCAAGATTGTATACCTCCTCAGATTCTTTAAAGGAATCATCTTTTTAGCCATAAATATCACTTTGGTTCAGCTCATTTAATTAATGTCTCCACTGATCCTTTTAACCTCTAACCATAATACTAATATCTTCAAAGCACCAGAAGCTATGAAAGAAGTTGTCCCTGAAATGAAAATATTTGAGGATGTACCTGAAGAGCCAGAAACTCCACGTATGAAAAGTACGTTACCTCTGAACAAATGTGGAAGAAGAAATTATCTGTCCTCTGCTCTTAAAACTATGGTTTCTTCCTAATACTCTTCATAAATTCTAAATATAAACATACTAATATCTTTTAAGTGTCTGAGGTTCCACAGGAAGTTTCCTCTAAAAAGAAATTATTTATGGCTGTTTCTGCCAAAACAGAAAACACTCCTGCTGGAAGTATTCATTCAACAAATCCTTTATAATGAGAGTGTAGAGTGTCGCGAGAGCTCTGTGAGGTTCTGGAGGAGGGGGAGCACCTCCTCTCAAGGATCCACTAACCCCTTAAAAGACTTAGCCTATTGGTGGAACAAAGGGAGGATGGAGGAAAGAGAAGAAAATGTGGTTATATTTCCTAACTTATTGTGGTTACTGTTTTCCATTAATCATTTTAACTCTTAAATGTGAATTGCTAATATCTTTCAAGCGCCCGAAGCTCCTCAAGAAATTATTCCTGCCAAGACAGTTCCTTCCAAAAAAAGAGAACCCCCATCAGTTAAAGGTACAAGTCACCATGCTCTCAGGGTCAAGAACTAGCTCTTGTAGTTTTGAGAATATTTTTGCTATTCCTAGTTATCTGCATAACACTAAACATAAAACTACTAATTTCTTAAAGTGCCTGAAGCTCTCCAAGAAATTGTCCCTGAAAAGAAAACGCTTGTGGTTCCTCTCAGAAAGCCTGAAGTCCTTCCTGATGAAGGTATATCTTGCTGGAAGCTTAGAGGGGTGGGAACATGTCTTTTCTTGTATAAATGTTTTTCCTGATTGTGTTGATTCTTGTAACTTCTAAATGTAAAATTATTAATATCTTCAAAGTGCCGGAGGCTCTCAGAGAAGTTGTCCCGGAAAAGAAAGTGCATCCTCCCCAAAGGGCTGAAGTTGTACCTGTCAAAGGTACATTCTTAACTGTCTTTTTATGGTGGGATAGTGGGTGGGGCGATAGAAAGGACCACCTTTCTAGTTTTGAAAATTATTTTGATGTGTACATGTGAATCATGTCTGTGTTGACTCTTGCAACTCAAGTGTAAATGTATTAATATCTTCAAACTGCCTGAAGCTCCCAAAGAAATGGCTACCAAAAAGAAAATACCGGAAGTTCCTCCTCTAAAACCTGAAACACCACCTATTATGGGAACTTGTTACCACTGATCTCAGCTCAGGAGAAAAAAATAGCTCTTTTGTTCTTGAAAATGTCTTTGTATCTATCTAGTAATCTCTGTATTTTCTGAGTGTAAAAATACTAATATCTTTCAAGTGCACGAAGCTCCCAAAGAGATTATCCCTGAAAAGAAAGTGTCGGTGGTGCCTCCTAAAAAGCCTGAAGTCCCACCTGTTAAAGGTATTTGTCACTGACTTTAGGCTTCAGAAGACCTAATTCTTCTGCTCTTGACAATATTTTTTTCTAGCGGTCTTCATAACACCTAAATGTAATTTCACTAATATCTTTCAAGTGCCAGAAGCTTCCAAAGAGGTTATCCGCGAAGAGAAAGTGCCCTTGGCTCCTCCTAAAGAGCCTGAAGTCCCACCTGTTAAAGGTAGTTGCCACTGACCTTAGGCTTCAGATCTCATTCTTTTGCTCTTGAAGATATTTTTTCCAGTGGTCTTCATAACTTCTGAATGTAATTTTGCTAATATCTTTTAAGTACCAGAGCCTCCCAAAGAAGTAGTTCCTGAAAAGAAAGCGCCAGTGGCTCCTCCTAAAGAGCCTGAAGTCCCACCTGTTAAAGGTATTTGTCACTGATTTTAGGCTTCAGATGATGTATCTCTTCTGCTCTGGAAAATATTTTTCTAGTGGTCTTCATAATGCCTAAATGTAATTTCACTAATATCTTTCAAGTGCCTGAGGCTCCCAAAGAAGTTGTTCCTGAAAAGAAAGTGCCAGTGCCTCCTCCTAAAAAGCCTGAAGTGCCACCCACAAAAGGTAGACACCCTCTTGTTGCTGTGTTTGATATTGTTTGTTTGTCTTTACTTTGTCTAATAATGAAAATACTAATATCTTTAAAGTCCCAGAGGTGCCAAAGGCAGCTGTCCCAGAAAAGAAGTTGCCTGAAGCTATTCCTCCCAAACCGGAAAGTCCTCCCCCTGAAGGTAATGCCAAAGCTATACAAACTATAGGAGAAAAATAACTGTTATTTTAACTAGGAAATTACATGTTAAAAATCCTACTACATAAAGATGATATAATTCTAAAGAAAACAAATGTCAATCGCTATCCAAAATATCTTGGTGGGTGTTTATATGCAAAAGGCATCCATCATTTTCACCTTTTCTAAACACAAATTACAAATATCTTTGAAGTGCCTGAAGTGCTGCCACCGAAGGAAGTGGTCCCAGAAAAGAAAGTACCGGTGCCTCCTGCCAAAAAGCCAGAAGCTCCACCTCCTAAAGGTAGGTATCATTACACATTGTCAGTCGGGGGGCCCTGGGGAAAGACTGCATAGAAGTGTCCGCCGATCTCACAAGTTGTATTTGCTTGGGTAAATGTGGAGTCGATATTCCCCCTTTATAGCTTCTAACTAAAAGATACTAATATCTTCAAAGTTCCTGAAGCTCCTAAAGAAGTTGTACTTGAAAAGAAAGCATCTGTGGCTGTGCCCAAAAAACCGGAAGCCCCACGTGCAAAAGGTATTTATTCCCTCTCCTCTGCTAAGAAAAACTTATCGTCTGTACCCCTCACAATCACTGTAATATATACCTTCACCATTCATAAATTATAAAAATACTAATATCTTTCAAGTGCCTGAAGCTGCTCAAGAAGTTGTCCCAGAAAAGAAAATTCCCAAGGCACCAATCAAAAAACCAGAAGCCCCCGCAGTTACAGGTACATGTCAGCTCAACCTTATCCTGCAGAAGAAATCTCTCTTCCATTCCTGAAAACAATTTTAGTCCATTCCTCTTCATTAACCTAAGTATAAAACTACTAATATCTTTCAAGTGCCAGAAGTTCCTCAAGAAGCCACAGAAAAAGAAATTCCCGTGGCTCCACCCAAAAAACCAGAAGCTCCAATTGTCCCAGGTACACTTTAGCCCTGACTTCATTCTGCAGAAGAGATATCTCCTCTCCTACTGTAAACAATTTTAGCCCATTTCTCTTCATTAACTTAAGTCTAAAACTACTAATATCTTTCAAGTGCCTGAAGCTCAAGAAGTTGTCCCAGAAAAGAAAGTTCCTAAGGCTCCTCCCACAAAACCAGAAGCCCCACCTGCCACAGGTATTTTTTACCCCTGTCCTTTTTCTGCAGAAGAAATATCTCTTCTGATCTTAGAAATATTTTACTCCATTTGTCTCATTAACCTAAGTGAAAAACTACTAATATCTTTCAAGTGCCTGAAGTCCCACAAGAAATTGTGCCAGAAAAGAAAACACTGGTGCTTCCTAAAAAGCCAGAAGTTCCACCTGTTACAGGTACTTGTCATTTGACCTTAAGCTTCAGAAGATCCAATTCCTCTGCTGTATATTTTGCTAGTAGTCTCCATAGCTCCACATGTAACTTTACTAATATCTTTTAAGTGCCAGAGGCTCCCAAAGAAGTTGTCCTTGAAAAGAAAGTGCCCTCGGCTCCTCCTAAAAAGCCTGAAGTCCCACCTGTTAAAGGTATTTGTCACTGATTTTAGGCTTCAGATGATCTATCTCTTGTGCTCTGGAAAATATTTTTCTTTTTATATATATATATATTTTTATTATACTTTAAGTTCTAGGGTACATGTGCACAACGTGCAGGTTGTTACGTATGTATACATGTGCCATGTTGGTGTGCTGCACCCACTAACTCGTCATTTACATTAGGTATGTCTCCTAATGCTATCCCTCCCCCATCCCCCCACCTCACAACACACTCCGGTGTGTGGTGTCCCCCTTCCTGTATCCATGTGTTCTCATTGTTCAATTCCCACCTATGAATGAGAACATGCAATGTTTGGTTTTTTATCCTTGTGATAGTTTGCCAAGAATGATGGTTTCCAGTTTCATCCATGTCCCTACAAAGGACATGAACTCATCATTTTTTATGGCTGCATAGTATTCCATGGAGTATATGTGGAACATTTTCTTAATCCAGTCTATCATTGATGGACATTTGGGTTGGTTCCAAGTCTTTGCTAATATGAATAGTGCCGCAATAAACATACGTGTGCACGTGTCTTTATAGCAGCATGATTTATAATCCTTTGGGTATATACCCAGTAATGGGATGGCTGGGTCAAATGGTATTTCTAGTTCTAGATCCCTGAGGAATCGCCACACTGACTTCCACAATGGTTGAACTAGTTTACAGTCCCAGCAACATTGTAAAAGTGTTCCTATTGCTCCACATCCTCTCCAGCGCCTGTCGTTTCCTGACTTTTTAATGATCACCATTCTAACTGGTGTGAGATGGTATCTCATTGTGGTTTTGATTTGCATTTCTCTGATGGCCAGTGATGATGAGCATTTTTTCTTGTGTATTTTGGCTGCATAAATGTCTTTTTTTGAGAAGTGTCTGTTTGTATCCTTCGCCCACTTGTTGATGGGGTTGTTTTTTTCTTACACGTTTGTTTGAGTTCATTGTAGATTCTGGATATTAGCCCTTCGTCAGATGAGTAGATTGCAAAAATTTTCTCCCATTCTGTGGGTTGCCTGTTCATTCTGATGGTAGTTTCCTTTGCTGTGCAGAAGCTCTTTAGTTTAATTCGATCCTATCTGTCAATTTTGGCTTTTGTTACCATTGCTTTTGGTATTTTAGACATGAAGTCCTTGCCCATGCCTATGTCCTGAATGGTATTGCCTAGGTTTTCTTCTAGGGTTTTTATGGTTTTAGGTCTAACATTTAAGTCTTTACTCCATCTTGAATTAATTTTTGTGTAAGGTGTAAGGAAGGGATCCAATTTCAGCTTTCTACATATGGCTAGCCAGTTTTCCCAGCACCATTTGCTAAATAGGGAACCCTTTCCCCATTTCTTGTTTTTGTCAGGTTTGTCAAAGATCAGATGGTTGCAGATGTGTGGTATTATTCTGAGGGCTCTGTTCTGTTCCATTGGTCTATATCTCTGTTTTGGTACCAGTACCATGCTGTTTTGGTTACTGTAGCCTTGTAATACAGTAGCGTGACGCCTCCAGCTTTGTTCTTTTGGCTTAGGATTGACTTGGCAATGTGGGCTCTTTTTTGGTTCCATATGAACTTTAAAGTAGTTTTTTCCAATTCTGTGAAGAGAGTCATTGATAGCTTGACGGAGATGGCATTGAATCTATAAATTACCTTGGGCAGTATGGCCATTTTCACGGTATTAGTTCTTCCTATCCATGAGCATGGAATGTTCTTCCATTTGTGTCCTCTTTTATTTCGTTGAGCAGTGGTTTGTAGTTCTCCTTGAAGAGGTCCTTCACATCCCTTGTAAGTTGGATTCCTAGGTATTTTATTCTCTTTGAAGCAACTGTGAATGGGAGGTCACTCACGATTTGGCTCTCTGTTTGTCTGTTATTGGTGCATAAGAATGCTTGTGATCTTTGCACATTGATTTTGTATCCTGAGACTTTGCTGAAGTTGCTTATCAGCTTAAGGAGATTTTGGGCTGAGACGATGGGGTTTTCTAGATATACAATCATGCCATCTGCAAACAGGGACAATTTGACTTCCTCTTTTCCTTATTGAATACCCTTTATTTCTTTCTCCTGCCTGATTGCCCTGGCCAGAACTTCCAACACTATGTTGAATAGGAGTGGTGAGAGAGGGCATCCCTGTCTTGTGCCAGTTTTCAAAGGGAATGCTTCCAGTTTTTGCCCATTCAGTATGATACTGGCTGTGGGTTTGTCATAAATAGCTCTTATTATTTTGAGATACGTCCCATCAATACCTAATTTATTGAGAGTCTTTAGCATGAAGGGCTGTTGAATTTTGTCAAAGGCCCTTTCTGCATCTATTGAGATAATCATGTGGTTTTTGTCGTTGGTTCTGTTTATATGATGGATTACGTTTATTGATTTTTGTATGTTGAATCAGCCTTCCATCCCAGGGATGAAGCCCACTTGATCATGGTGGATAAGCTTTTTGATGTGCTGCTGGAAAATATTTTTCTAGTGGTCTTCATAATGCCTAAATGTAATTTCACTAATATCTTTCAAGTGCCTGAGGCTCCCAAAGAAGTTGTTCCTGAAAAGAAAGTGCCAGTGCCTCCTCCTAAAAAGCCTGAAGTGCCACCCACAAAAGGTAGACACCCTCTTGTTGCTGTGTTTGATATTGTTTGTTTGTCTTTACTTTGTCTAATAATGAAAATACTAATATCTTTAAAGTCCCAGAGGTGCCAAAGGCAGCTGTCCCAGAAAAGAAGGTGCCTGAAGCTATTCCTCCCAAACCGGAAAGTCCTCCCCCTGAAGGTAATGCCAAAGCTATACAAACTATAGGAGAAAAATAACTGTTATTTTAACTAGGAAATTACATGTTAAAAATCCTACTACATAAAGATGATATAATTCTAAAGAAAACAAATGTCAATCACTATCCAAAATATCTTGGTGGGTGTTTATATGCAAAAGGCATCCATCGTTTTCACCTTTTCTAAACACAAATTACAAATATCTTTGAAG
>TTN-214,,0,3709,3027229,3030937,GTAGGTATCATTACACATTGTCAGTCGGGGGGCCCTGGGGAAAGACTGTATAGAAGTGTCCGCCGATCTCACAAGTTGTATTTGCTTGGGTAAATGTGGAGTCGATATTCCCCCTTTATAGCTTCTAACTAAAAGATACTAATATCTTCAAAGTTCCTGAAGCTCCTAAAGAAGTTGTACTTGAAAAGAAAGCATCTGTGGCTGTGCCCAAAAAACCGGAAGCCCCACGTGCAAAAGGTATTTATTCCCTCTCCTCTGCTAAGAAAAACTTATCGTCTGTACCCCTCACAATCACTGTAATATATACCTTCACCATTCATAAATTATAAAAATACTAATATCTTTCAAGTGCCTGAAGCTGCTCAAGAAGTTGTCCCAGAAAAGAAAATTCCCAAGGCACCAATCAAAAAACCAGAAGCCCCCGCAGTTACAGGTACATGTCAGCTCAACCTTATCCTGCAGAAGAAATCTCTCTTCCATTCCTGAAAACAATTTTAGTCCATTCCTCTTCATTAACCTAAGTATAAAACTACTAATATCTTTCAAGTGCCAGAAGTTCCTCAAGAAGCCGCAGAAAAAGAAATTCCCGTGGCTCCACCCAAAAAACCAGAAGCTCCGATTGTCCCAGGTACACTTTAGCCCTGACTTCATTCTGCAGAAGAGATATCTCCTCTCCTACTGTAAACAATTTTAGCCCATTTCTCTTCATTAACTTAAGTCTAAAACTACTAATATCTTTCAAGTGCCTGAAGCTCAAGAAGTTGTCCCAGAAAAGAAAGTTCCTAAGGCTCCTCCCACAAAACCAGAAGCCCCACCTGCCACAGGTATTTTTTACCCCTGTCCTTTTTCTGCAGAAGAAATATCTCTTCTGATCTTAGAAATATTTTACTCCATTTGTCTCATTAACCTAAGTGAAAAACTACTAATATCTTTCAAGTGCCTGAAGTCCCACAAGAAATTGTGCCAGAAAAGAAAACACTGGTGCTTCCTAAAAAGCCAGAAGTTCCACCTGTTACAGGTACTTGTCATTTGACCTTAAGCTTCAGAAGATCCAATTCCTCTGCTGTATATTTTGCTAGTAGTCTCCATAGCTCCACATGTAACTTTACTAATATCTTTTAAGTGCCAGAGGCTCCCAAAGAAGTTGTCCTTGAAAAGAAAGTGCCCTCGACTCCTCCTAAAAAGCCTGAAGTCCCACCTGTTAAAGGTATTTGTCACTGATTTTAGGCTTCAGATGATCTATCTCTTGTGCTCTGGAAAATATTTTTCTTTTTATATATATATATATTTTTATTATACTTTAAGTTCTAGGGTACATGTGCACAACGTGCAGGTTGTTACGTATGTATACATGTGCCATGTTGGTGTGCTGCACCCACTAACTCGTCATTTACATTAGGTATGTCTCCTAATGCTATCCCTCCCCCATCCCCCCACCTCACAACACACTCCGGTGTGTGGTGTCCCCCTTCCTGTATCCATGTGTTCTCATTGTTCAATTCCCACCTATGAATGAGAACATGCAATGTTTGGTTTTTTATCCTTGTGATAGTTTGCCAAGAATGATGGTTTCCAGTTTCATCCATGTCCCTACAAAGGACATGAACTCATCATTTTTTATGGCTGCATAGTATTCCATGGAGTATATGTGGAACATTTTCTTAATCCAGTCTATCATTGATGGACATTTGGGTTGGTTCCAAGTCTTTGCTAATATGAATAGTGCCGCAATAAACATACGTGTGCACGTGTCTTTATAGCAGCATGATTTATAATCCTTTGGGTATATACCCAGTAATGGGATGGCTGGGTCAAATGGTATTTCTAGTTCTAGATCCCTGAGGAATCGCCACACTGACTTCCACAATGGTTGAACTAGTTTACAGTCCCAGCAACATTGTAAAAGTGTTCCTATTGCTCCACATCCTCTCCAGCGCCTGTCGTTTCCTGACTTTTTAATGATCACCATTCTAACTGGTGTGAGATGGTATCTCATTGTGGTTTTGATTTGCATTTCTCTGATGGCCAGTGATGATGAGCATTTTTTCTTGTGTATTTTGGCTGCATAAATGTCTTTTTTTGAGAAGTGTCTGTTTGTATCCTTCGCCCACTTGTTGATGGGGTTGTTTTTTTCTTACACGTTTGTTTGAGTTCATTGTAGATTCTGGATATTAGCCCTTCGTCAGATGAGTAGATTGCAAAAATTTTCTCCCATTCTGTGGGTTGCCTGTTCATTCTGATGGTAGTACCTTTGCTGTGCAGAAGCTCTTTAGTTTAATTCGATCCTATCTGTCAATTTTGGCTTTTGTTACCATTGCTTTTGGTATTTTAGACATGAAGTCCTTGCCCATGCCTATGTCCTGAATGGTATTGCCTAGGTTTTCTTCTAGGGTTTTTATGGTTTTAGGTCTAACATTTAAGTCTTTACTCCATCTTGAATTAATTTTTGTGTAAGGTGTAAGGAAGGGATCCAATTTCAGCTTTCTACATATGGCTAGCCAGTTTTCCCAGCACCATTTGCTAAATAGGGAACCCTTTCCCCATTTCTTGTTTTTGTCAGGTTTGTCAAAGATCAGATGGTTGCAGATGTGTGGTATTATTCTGAGGGCTCTGTTCTGTTCCATTGGTCTATATCTCTGTTTTGGTACCAGTACCATGCTGTTTTGGTTACTGTAGCCTTGTAATACAGTAGCGTGACGCCTCCAGCTTTGTTCTTTTGGCTTAGGATTGACTTGGCAATGTGGGCTCTTTTTTGGTTCCATATGAACTTTAAAGTAGTTTTTTCCAATTCTGTGAAGAGAGTCATTGATAGCTTGACGGAGATGGCATTGAATCTATAAATTACCTTGGGCAGTATGGCCATTTTCACGGTATTAGTTCTTCCTATCCATGAGCATGGAATGTTCTTCCATTTGTGTCCTCTTTTATTTCGTTGAGCAGTGGTTTGTAGTTCTCCTTGAAGAGGTCCTTCACATCCCTTGTAAGTTGGATTCCTAGGTATTTTATTCTCTTTGAAGCAACTGTGAATGGGAGGTCACTCACGATTTGGCTCTCTGTTTGTCTGTTATTGGTGCATAAGAATGCTTGTGATCTTTGCACATTGATTTTGTATCCTGAGACTTTGCTGAAGTTGCTTATCAGCTTAAGGAGATTTTGGGCTGAGACGATGGGGTTTTCTAGATATACAATCATGCCATCTGCAAACAGGGACAATTTGACTTCCTCTTTTCCTTATTGAATACCCTTTATTTCTTTCTCCTGCCTGATTGCCCTGGCCAGAACTTCCAACACTATGTTGAATAGGAGTGGTGAGAGAGGGCATCCCTGTCTTGTGCCAGTTTTCAAAGGGAATGCTTCCAGTTTTTGCCCATTCAGTATGATACTGGCTGTGGGTTTGTCATAAATAGCTCTTATTATTTTGAGATATGTCCCATCAATACCTAATTTATTGAGAGTCTTTAGCATGAAGGGCTGTTGAATTTTGTCAAAGGCCCTTTCTGCATCTATTGAGATAATCACGTGGTTTTTGTCGTTGGTTCTGTTTATATGATGGATTACGTTTATTGATTTTTGTATGTTGAATCAGCCTTCCATCCCAGGGATGAAGCCCACTTGATCATGGTGGATAAGCTTTTTGATGTGCTGCTGGAAAATATTTTTCTAGTGGTCTTCATAATGCCTAAATGTAATTTCACTAATATCTTTCAAG
>TTN-214,,0,83,3030938,3031020,GTAGACACCCTCTTGTTGCTGTGTTTGATATTGTTTGTTTGTCTTTACTTTGTCTAATAATGAAAATACTAATATCTTTAAAG
>TTN-214,,0,2203,3031021,3033223,GTAATGCCAAAGCTATACAAACTATAGGAGAAAAATAACTGTTATTTTAACTAGGAAATTACATGTTAAAAATCCTACTACATAAAGATGATATAATTCTAAAGAAAACAAATGTCAATCACTATCCAAAATATCTTGGTGGGTGTTTATATGCAAAAGGCATCCATCATTTTCACCTTTTCTAAACACAAATTACAAATATCTTTGAAGTGCCTGAAGTGCTGCCACCGAAGGAAGTGGTCCCAGAAAAGAAAGTACCGGTGCCTCCTGCCAAAAAGCCAGAAGCTCCACCTCCTAAAGGTAGGTATCATTACACATTGTCAGTCGGGGGGCCCTGGGGAAAGACTGTATAGAAGTGTCCGCCGATCTCACAAGTTGTATTTGCTTGGGTAAATGTGGAGTCGATATTCCCCCTTTATAGCTTCTAACTAAAAGATACTAATATCTTCAAAGTTCCTGAAGCTCCTAAAGAAGTTGTACTTGAAAAGAAAGTATCTGTGGCTGTGCCCAAAAAACCGGAAGCCCCACGTGCAAAAGGTATTTATTCCCTCTCCTCTGCTAAGAATAACTTACTGTCTGTACCCCTCACAATCACTGTAATATATACCTTCGCCATTCATAAATTATAAAAATACTAATATCTTTCAAGTGCCTGAAGCTGCTCAAGAAGTTGTCCCAGAAAAGAAAATTCCCAAGGCACCAATCAAAAAACCAGAAGCCCCCGCAGTTACAGGTACATGTCAGCTCAACCTTATCCTGCAGAAGAAATCTCTCTTCCATTCCTGAAAACAATTTTAGTCCATTCCTCTTCATTAACCTAAGTATAAAACTACTAATATCTTTCAAGTGCCAGAAGTTCCTCAAGAAGCCGCAGAAAAAGAAATTCCCGTGGCTCCACCCAAAAAACCAGAAGCTCCAATTGTCCCAGGTACACTTTAGCCCTGACTTCATTCTGCAGAAGAGATATCTCCTCTCCTACTGTAAACAATTTTAGCCCATTTCTCTTCATTAACTTAAGTCTAAAACTACTAATATCTTTCAAGTGCCTGAAGCTCAAGAAGTTGTCCCAGAAAAGAAAGTTCCTAAGGCTCCTCCCACAAAACCAGAAGCCCCACCTGCCACAGGTATTTTTTACCCCTGTCCTTTTTCTGCAGAAGAAATATCTCTTCTGATCTTAGAAATATTTTACTCCATTTGTCTCATTAACCTAAGTGAAAAACTACTAATATCTTTCAAGTGCCTGAAGTCCCACAAGAAATTGTGCCAGAAAAGAAAACACTGGTGCTTCCTAAAAAGCCAGAAGTTCCACCTGTTACAGGTACTTGTCATTTGACCTTAAGCTTCAGAAGATCCAATTCCTCTGCTGTATATTTTGCTAGTAGTCTCCATAGCTCTACATGTAACTTTACTAATATCTTTTAAGTGCCAGAGGCTCCCAAAGAAGTTGTCCTTGAAAAGAAAGTGCCCTTGGCTCCTCCTAAAAAGCCTGAAGTCCCACCTGTTAAAGGTATTTGTCACTGACCTTAGGCTTCAGATGATCTAATTCTTTTGCAGTTGAAGACATTTTGTTCCAGTGGTCTTCATAACCCCTAAATGTAATTTTACCTAATATCTTTTAAGTGCCAGAGGCTCCCAAAGAAGTTGTTCCTGAAAAGAAAGTGCCAGTGACTCCTCCTAAAAAACCTGAAGTCCCACCTGTTAAAGGTATTTGTCACTGGCTTTAGGCTTCAGAAGACTGAACTCTTCATTTCTTGAAAATACTTTTCTAGTGGTCTTCAAACTTCTAAATGTAATTTCACTAATATCTTTTAAGTGCCAGAGGCTCCCATAGAGGTTGTTCCTGAAAAGAAAATGCCCTTGGCTCCTCCTAAAAAGCCTGAAGTCCCTCCTGTTAAAGGTATTTGTCACTGGCTTTAGGCTTCAGAAGATCAAACTCCTCTATTCTTGAAAATATTTTTTCTAGTGGTCTTCATAACCCCTAAATGTAATTTCACTAATATCTTTTAAGTACCAGAGGCTCCCAAAGAGGTTGTTCCTGAAAAGAAAGTGCCCTCGGCTCCTCCTAAAAAGCCTGAAGTCCCACCTGTTAAAGGTATTTGTCATTGAGTTTAAGCGTCAGAAGATCTATCTCTTCTACTCTTGAAAATATTTTTCCTAATGGTCTTCATAACTTCTAAATGTAATTTCACTAATATCTTTTAAG
>TTN-214,,0,110,3033224,3033333,GTATTTGTCACTGATTTTAGGCTTCAGATGATCAAACTCTTCTGCTCTGGAAAGTATTTTTCTAGTGGTCTTCATAATGCCTAAATGTAATTTCACTATTATCTTTCAAG
>TTN-214,,0,84,3033334,3033417,GTAGACACCCTCATGGTGCTGTGTTTGATATTGTTTGTTTGTCTTTACTTTGTCTAACAATGAAAATAATAATATCTTTTAAAG
>TTN-214,,0,128,3033418,3033545,GTAATAATGAAACTATTCAAATTAGTGTTTTTTAAAAAAATCTTTCCTTAGTGTTGTAAAAACATTTTTTTGCAAACTATCTCAGTTTTAGTCAATTCTGGCATTAAAATGAGCTCATGTCTTTAAAG
>TTN-214,,0,134,3033546,3033679,GTACATGGCAAGAAAGCTGCTAGGACACCTCGGCCACTCTTTCCCCTTCCTGCCCTGATAATTCTGGGTGCTCTGAGCTTTTGTCTTGTTTCTCAATCTTCGTTCTTTCTAAAACATACCTTCTAATTCTTTAG
>TTN-214,,0,129,3033680,3033808,GTATTCCTCACTGCCACTAACTCCCTAACAAAAAACTTTCTTTGAAGTGTCATATTCTACTGTTCTGCTTCATGATTTTCACATTTCATTGAAACCATGAGCTTAAACAACTACTAATATCTTTTATAG
>TTN-214,,0,132,3033809,3033940,GTATATGTGGCTGTCCACTGTTTGATGGGGGCGGATGGAGCCCCCAGCTTCTAAAAGGGTTTTGTTCTGTGTAAATGTGATGAATGTTTACTGGTGATTGTTTCTAATGTTAAAATACTAATATATTTGAAG
>TTN-214,,0,408,3033941,3034348,GTACATGTCACTAATGAGATTCTGCAGAAAAGCACTCACCCTTGTCTAATAAGTCACCTATTATCAAACCTTTTGTTTGCGAGTCCTCTTAAATTTGCAACTACAAAACTGTCATTCTGGATTTTTAGGGTCTGAATACTTTTTAATAATTTTTTCATTGACTTTAAAAAGTGATATATTTACTTATTACAAGCATTGGAAAAGTTTACTAACTTGGTTCTTTTATTCTTAATAGGCCATATTTTCCTCCCCACTATATGAGGGTCCAAAGACAGATCACTGACCTTATTGTGAAATTTGTTCTTGGATCTGTCCCTGGGTTATTTGAGCAAAATGTGAAGTCGATGTGGTATAAATTTAATATACTTCTCAACTACTCATAAGAAAAATGAATTAATATCTTTAAAG
>TTN-214,,0,479,3034349,3034827,GTACACGTGAGACCGGTGATTAATGACCTTGCCACTTGCGACTATTTCTAATTTAAGCTTTGTTCTTCTTCCTTCCTAACTCATTATTTCTTGGTCATTTTCTAACCTTTAATTATTTGTCTTAATTCATCATTCTAAATTAGCTCCAATCTCAAATCTATTTTGGGTTATTGGTCCACAGTATCTACATAAGTCATAGTAAGCTATATTAAACAAAGCTTCTCCAATGTACATAGAAAGTAAGGCAGGAGAACTAATGATTATAAATGACATTAAACACTAAAAGGGCTTTGCAAGCATTTGAATCAATAGACAAAGAAGTCAGTGCAAATGAGATAGATTTTATCTAAACAAAAATAAGAGAAGGTATCAATTGAAACAAAGGAAGAAATCAAGATTACTATTTATCGTGTTTAGTGTTTGTCCATCTTAGAATATTGTTCCATACATTGAAATAAAATTAACTAATATCTTTAAAG
>TTN-214,,0,269,3034828,3035096,GTACAAAGCAGAATCCACTGTATGGGAAAATACAGTCATTTCATTTTTCATGTCTATATATCTTCCTTAAGGCAAAATATCAGTCTTGTATCTTGTTGCCTGAAATCTGACTACATTAAGAACAAAAGTTATTTCTACACATAAAACTTTGGACCCACAGAATTTGGTCCCACATATACCAAGAAATATGTGTGGTTTTTAATTCATTCATTAGCATTAAATTTTTCATTGTAATCACCTAATTCTAAAAGAAATTCCTATTATTCAAG
>TTN-214,,0,3786,3035097,3038882,GTACTCATGTTAAAATGAATACTTCATTTTTGTGGTGTCTACAATTTTACACTCTTCTTATTGTGTGTTGTGTTGTATTATATGTTTGTTAACTCTTACCTATATGTTACAGTGTTGAATAAACTTGTATGTATATCTTACATCTCACAACTTTGTATTATTAAATGCTACTGATATCTTTAAAGAACCTGAGATGCCAAAGAAAGTTGTTCCAGTGAAGAAGGTCCCAACTGTTAAGAAGCCAGAAACACCAGCAGCTAAAGGTATTCACTTCATCGTTGGCATCATAAAAAAGAAAGTATTCTGATATCTTAAAGTGGAATCCAATAAGTTGTCCTCATTGTTGTTGCATAACTAAGGACAAAAATTTCCTTATTTTGCTTTCATTAATTTTAATGCTGCTCCAATAAATACAGGTTTTTTATTCTTAATATTTTAAAATGTTTTTAAATACTATTTTTAAAACAAAACTAATATCTTCAAAGTGCCTGAGGTGCCCAAGAAACTTGTTCCAGTAAAGAAAGAACCTGTGCCTGTTACCAAAAAACCAGAAGTTCTTCCAGAAAAAGGTACCTACCATGAAGAAAAAATAGATTTCTCTAACTGCTATTTAAGCATGTTAATAATAGGTCTTAGAGAAAAACATACTGAATGTGAATTTATGTTAAAACCATATTGCACAGAAAAAAGGGAAATAATGAAGGGAAAAAAATGAAACAGACAAGCAGGAGTGAAAAAATGAGTGGGATTCAGTTGTGCTGTGATATATCACATGGCTACAACTAGTAGAAAAGAACCTTCTCTCATTCAATGTGTAAAACAGCTCAATTCAACATATTTTGTTGAATGTTGACCATTAACAAGACATCATATTAGAAAAATTAAGGCCTGATTCTGTCTTCAAATAAGTTAAATCTGGTGAGAGGATAGAAAGATAACAGGACTCTAATACAGACAGGAAGTGATTACACATAGCAAGTGAATACAAAAGGGCTGCAGAAACACACGGCAAGAAAAGATTAAGTTCAGGCAGAGGCATCATGGGAAGCTGTGTTAAACTGAATTTAAATTTTGATGGACTTTTACATGTAGAAATTGAGGAAATAAGGCCGGATGTGGTGGCTCACGCCTGTCATCCCAACACTTGGGGAGGCCAAGGTGGGTGGATCACTTGAGGTCAGGAGTTCAAGACCAGCCTGGCCAACATGGTGAAACCCCGTCTCTACTAAAAATACAAAAATTAGCTGGGGGTGGTGATATGTGCCTGTAATCCCAGCTACTTGGGAGGCTGAGGCAGGAGAATTGCTTGAACCCAGGAGGCAGAGGTTGCAGTGAGCTGAGATAATGCCACTGCACTCCAGCTTGGGTGACAGAGTGAGCCTCTGTCTCAAAAAAATTAAAAAAAAGAAATTGAGGACATGATATCCCATGGAAAGGGAAGAGCATATTGAAAGGCACAGAGATAGAAGGGTCTAGAATGTTCAAGGATTGTCAAGTAAACTTATGTCAAGTAAACTCAATTTGAGTATGGATTGGCTGTGGAATGTCTTGAAAGATAATACCAGATATAAAGATGGGGTCATATTTTGGAGTACTTCAAATGCCAGTAAAAGGCTTGTACTTTTTTCTGTAGGCAATAGGAAGCTTCAAAGATTTTGAAGCAGGCTTACATATTAATAGGATTTGGGCTTTAGAAAGATAACTGGCAGCAATTTCAGCTACTAAATAGTAAAGACCCATTGCAATTATTTAAGGTCTTTAAGAGTTGGACAAGATCCGTGGCGGCAGAAATGGAAAGGGGGACTGGGTTTGAAAGAGATGGAGACTTAGTGGCCTCTGACCATTATCAAAACCATTAGGGAAATTGAGGAGCCCAAGATCATTGTAAGGTTTAAAGCTAGATGGCCAAAAGAATGGTTCATTGGGTCTCTGAACTAACGTTAGAGGAAAATGGTAGATGTGCTTTTCACCTTTAAAGCATAAAAGTTGGGAGTGTGTATCAGGAGCTTAAGAAAGAGATCAGGCCTAGAGATGTAGATCTTAAAGTCATTCACATGTAAATAAGAATTGAGTGTGCAGGAACAATTACTCAGAAAATGTAGAGCAAATTTTTTTAAGTGTCAAAGTTAGACCACCTTCATTTAAGTGTACACAGAGGACTAGAAGCAAATGAAGAAAGCTGAGAAGATTCATATATAAAATTAGGATGTCCAAAATGGTGCCATGTCTCAGAAGCCATTTTCCCCATGAAATCTAAGATGAAGCTCTTGCCCCTGCATTCTTTGCCTGCTCTTTAGACAATCTTGCATGTCTTCTAAATTCTTAATAGTAAACAAAATCATATCTTTAAAGTGCCCAAAGTGCCTGAGAAAATCATCCCAGAAAAGGAAGTGTCTGTGCCTATCCCTGCAGAGCCAGAAGTTCCACCTGCTGAAGGTACACGGCTTCTCCATAAATCTTGGAAAGATGACAATTGTCTTCATCCTCTTGCTTTGATTGTAGATGAATCTTACGTATTTGTCTGTCTGTATTGAAGTTATTGATATTTGGGGGGTCATCTGAATAATCTGTTATAGAGTGTTACTTAATGTAACTAGGTTGATATGTTAGAATAGTAGTTGCAGTATTCTGTTCTAAATATAGTCTAAAATAAAATACTATGTTTTTTAAAGTTGAAGAGACTCCTGAGGAAATAATATATGAAGAAAAAGCATCTATAACCATTGGTAGAAAAGAGACTCCCCCTGTTGAAGGTATATATATATATATATATATACATTTTTTTAATCTCCTGAAGATTCCTGTTAGAATTACAAAAGCATTTACAGGACAATATTCCTTCTTGAAATTATATACAAGAGCAGTCTAGCATGTTTGACTGCTTTATTTTTGAAATAGTTACACTTCTTTTAAGTTAGAATCTTTAATTTAGTTACTGTTGTTGGTAATTACAATTTCCAAAAGGTACAGTTTACTGAAGCAAAATGGAATAATTGCCTTGGATCCTCAAATGATAACACGGTATCAAATTTTAAAAGTCATCTCATTTGCCATCAATATACATTGAATAATCTAATTAATAGGCAGTTCAAGTAAAAGAACTTTTTCTTATACGTGAATTTTTCTATACATGAATTTGTATGAATTGTATATTTTTATTTTGTGACTGTAATCTTTGCATCAATGTGAAATTTGTATGAGTCTTTTTGAAGAACTTTACATTGCAACCTCATCTCCTTTGTCAACATTCTTTAAAGAACGTGAAATTGAAAAGTATATTAAACCTGAAGAGCCCGAACCTGAACCACAGCCTGAAGAAATACCAGTAAAAGGTATTCAATCCAGTGGACTTAAATCTTCTTTATCATATTCTTTCTCTTGAAATGTATATGGTTTATGTTGTTGTACATATGTAGTATGTCTGTTCCCATTTGTATGTAAAGTATTCTTTGTTGTAAATGTGAGCCTCATTCTTAGGTTTCCATGTAACTTGTACTGTTTCTCTCATGTCAACTGTGGCTTGTCTGGATGCTTTGTTTGTTGTTGTTATTGGTGCCTTTGCTGTATTTCTCATCATCTTTGTAAAGGGTTGATATTTTTATGTTTTATGTTCTGTGTTTTATGTTGGATACTGGTATTACGTACCTTAAAAAGTAAACTTTGTACTTCATATATATATATATATATATATATATATATATATATATATATAATTTCTATTAAATATACTACATATCCACATGCTAACATATACATATACTAACACCTCTGAAATACTCTTTCAAG
>TTN-214,,0,1303,3038883,3040185,GTAAAAAATGCCACTTCCAAAGTTTTATTAGCCTGCTTCAAACTTCTATCCAGCCATCTGAAATGATGCTTGCAAGAAATGTATGACTTTTAGAAGTGTGTACTTTCAGACATGATTGTACTGTGAGATTGCATAGAGCTGTCTCTTCTGCTGCCCCATGGTTCCTGGGTTGCTTGTCATGCCATGCCTGCTGCTGCAAAAGTCAGAAAGTACATTGATAGCGTCATCCGGGATATCTGAATGCAGGCACTGTCCAATTAACTTTCTTTTGTGGAGTGGGGAGAAAGAGTTTTCTGATTTCAAAGCCTGATTGCTATACATATCATTGCGATCTTATGCTTAAGGAATGTATAAGAAATCCTTGCAAGATATTTTTAATATTGCAGTAACACATTTACATAAAAGCCAAAACTTTGTTCTTAAAGAATTGCATGTGCTTTTAAATATATTACAAGTAATATAGTTATGATTTCCAGTAGCTGATATGTGCCTATATATCATGAAAGGAAAGCATATGAATGACTTGTTACAGTTCCCCCATCTCTTTTTTTTTCTTGCAACTTAAAGAAGTGTTCTGTGTGGTTCTCAGGGGAGCTGGAAAGAGTGGTTATGAAGACATTTGGTATCCAGCATTTATTATTAAACTTCCCTTCCCCCTTCTTATATTTTGATTTTTCTATGAATTGACACAATGTTACTTAATTTTAAAAATATCAGTTTCTTTAAAAGCTGAAATAAACTGGCAGAAACATATTATTCTTATTTTAATAAAAAGTTGTCTTGTGACGTCATATGATTCCCCAATCTAAAATTATCTAGATATAATCTTAGATATGCACTTTCCCTATACAGACCTATGTATCTTCAAACCACAGTCTTCCAGCATAAGACATTGCTGCTGGTGATTCTTGCCCTCTACAACCCTCATAGCCATTAGGGGGACCTTCTGGCACCTCTTGAAAGGCCACCCATCTGTTAATTGACACTCCATGAAGACACACACATAAATACATTTCCCTTAATGTAAAATATATGCTTAAAGGAAAATTTCTTCCTCCTGCCAATAACAAAAATTGTCTTCTTTTTCTGCTGGTCTTTAATTAACTACTGAACTTTGGAGTAAAACTGCAGTCTGTTTTCATGGTTCGAATGCTGCTTGTATGTTCTTTGAAGGCTGTTCTTGGCTGTTATTAATGCTTTCTGGTTATAAGCAAAGCTTGGTTTTGATTCTTGGAGTAGAAAGTTAATCACTTGCTTCAGATTAAATATACAAATAACAAAAGTAAAATCATATTCTTTAAAG
>TTN-214,,0,2230,3040186,3042415,GTATTTCACAGGCTGAAAAATACATACTTATGTAGTACCCCTTTACCTGACTCCTTGCTCTTTCTGCCTCCATCGAATGTTCTGTCTCTCTTTTTCAATGATCAGAGAGTAGTCCCATTCATTTCTTATATTTCTGTGGCTTTTATGGTCCTGGCTCATGAGTGTTGCTTCCTTTGTCTCCCATCCATTTCATACATGTATAGACATGGTCTATCTTTGTCTCATCTACATATGTCTTCTTGCATTTTCCTAAACTTAAAAATAACAAATTTTACTGGTTAGCCAAAATTGATATCAAGAGACATATGAGATTAAAATGCTGAGAGCTAGTAGTAAACTGTTTTGACATTTCACCTGACATAAAAATTTTAGCCAATGTAATAAGCACTAAAAATAAGTCCTATCTTCCTTTTATATTATTAAGGTTATTTGTAGGGATTTCCTTAGGACTTTCATGTCACTCTCTTCTCACTGGCTCTAAGTCATTCTCTGAGGGGTACGGAACTCACATTTCAGAAAAATTTCCTTATTACTGTAGGTAATTTTTCAAAATGTATTTTTCTGTAAACAATATTTTCCCTAATAAGGTCTCATCTAAAATTAGACCCTAAAGAAAACTAAATGAATTATAAGAGTCTAGAAAACATCTATCAAAAATAAACATAATTTTTCTAATGGGTAGTAGTGTTCTGTTCAAGTAATCAACACATTCAGACCTAGAAATTAAGACTGTTTCTGGTCACTCTGAAATTTTGGGGAAAAAAGTCACCCATATAAATATACATTTCCTGATTTCATAAAGAGGCAATTACAAAATAATGTTATCATGGATATTGATCATAAACATTAAAATAGCATATAATCACATATAATGACTTTAAAAATAATAGCTACAATGTTGGGTTCTCAAACATCAATAAGATTTTTAAAATCAAATAATAATATAAAAAATGCACAGATATATTTTCACTATGTTCATTATATCAGTAAAGAAAATCTATATTATGCCTCCTCACTTTACATTAATTAGATGCATGTGCTTCCTTCTGGGTTTGAGCAATAAAAATAGTTATTAAGAAGATTGGTACCTCTAAAATAGTATTGAAGGCCAACACAATTTATCCTGGATAAAATACGTAATGTTTAACTTTAAAATTTTTACTTAAAATATTTGACATTAAAAAAATGATTATTCAAAACGAAATACATATTTGCCTATTGTAGGTTTAAATTTTTGAAATAAGAGTTAAGCAGTTATCTTTATCACATAAAAAACCATTTAATGAATTGCAAATATCTTGTTTAAAGCCCTAAATAGGAAGTTTTATAGAAATATCTAAAAATTCAGATTCCTAATAGCAAATAGTTACACAATACAAATAAATACTGTTTTAAATTAGATTTTAATTGACATTAGTAGAGAGGAAAATGGTTTAATAATCACCACGTGTTCCTTTCTTTCACCATTCAAATCTATGAGGGCCATAATAGCAAAAGAGGCTGCTCTATAAAATAGCATCATCCACCATGCTCAGTATTCACTGTAGACGCAACAGGAAATTTTGAATTCCTTGCGTTCCTTAATTTGAATGAATTTAAGAACATTTTCTTATTCATGAAAAACGAGCTTCCAACACCAGCTTTGAAATTTTATAATTCTATAATTTTAAATATTTTATCCAGCATTATTTCAAAAAGGAAATCTTAAGAAAGGCTACTCTTCTTCTGTTCAGAAAGTGAGATATGGCCCTTCCCCAGCATCAAAGTCACAAACCGGAACTCTTGGCCACCTTCTTCCCTCAGTGGAGAAGACTGAATGATGGCACTAACACTTGCCAGTATCATTTTCATACATTTAGTGGTTGGGTAGATAACATCGTAGATTTGGACAATCTACAATTGCAGTTTGGGACAAAGATGCTGTCAAGAACCCTGTAATTTGATGAAAGATTCATAAAGTCAGTATGGAGCAACATCCTCTACATGCATTTAAAATGAATACATTTGCCTGCAGTTAATGGAGTTGAATTTCATCACAAGGCTGTATAGATATTTGCAGAGGAGATAACTTGAAATGTATCATTTAAACTTAAATTCTGTGGTATTTATATGCAGCGAAAATTGTTACTTAATGCACTACAGTTAACTAGTTTTAGGAGAGACATTTTTCTTGTTGAAATTCCGTTTTTATATAAATTCACTTCAAAATTTGAAATCATATTCTTTTAAG
>TTN-214,,0,921,3042416,3043336,GTATAGTATTTTTCAACCATTCTGTCAGCGTTAAGTATATTTTAAAAATGAACTTGAAAGCTTACAAAATGTTTCTGTCCTTTGGTTTTCTTTGAATTGGTTCGCTATTTATCAAAATTTGTTTGTAGTTTCATTGAAAATTAAGAAAAATGTCATTTCCAGATCTTTTTTTTTAAAAAAAAAAGACAGAAATTTTGTGAGCATTCACAGTATTTTGAAATTTAAAATGTTAATAGACATAACTAAGTTGATAATATTCTAAACTAACAACAACTATGACTGCCATTTTCATAACCAAATTATGTAGTAAAGTACACTAAACCTATTAAATACCTTACATGAAACTACTTTAGCTTAAATTCAATATTCAGTTTTAAAGTGTGACACAGGATCACCACAACTAATAAATAACATTTTTAAAAAACTGAACATTTCTTTCTGACTAATAAAATATTAAAGAATGAGAAACAAGATAGTCAAATGAAGAATTAAGTTCTAACATTGTCTTCACATAGAATTACTGATTTTTAGGCTACATTTCTTCAGATATCTCTGCTTAAGTAAACTTTCTACTTATTTACATACTCATTAAATCATTAACATTTAATTATTATTATAATTCGTTGCTATTCAAATTATTCATTTTGTGTTGGAGCTGTTTCTCCCACAGACTTGTCTCAGAATAGACCCTCTATCTAGATAGAAACAAAGTAACTTTGAGTGCTATTATAATTGACAACCTTTGATTTTAAAAAAAACAAAACAAAAAACACTTTCGGTGTAAATGCTTACTTTCCAGAGTGCTAGGTAGCATGCTTTTTTTCATTTTCCTTGCTTTGTACATTATTTGCATTTGTCAAGCTTATTCAACATCTTCATTAGTTTGTCTTGGTTTACATATAAACCTTTTTGTCTTTAAAG
>TTN-214,,0,610,3043337,3043946,GTAGGAATCTCAGTGACAATTTGTAAGATTATCTTTTAACAAAATGGACATTTAACAAAAGGTTTATCTTGTAAACATAAATGAAGTTAGATGTAAACATGGCTTCATATTTCATCTGTGATGTAGTCTCTGTTTTCCATTGTCTGCTTTCTGTTTAAATATTTTTATAGTAATTCCCAAATCCATTCATGTATTTCCCTGCACTTCATTCTTATCATTACTTTGCAACTTAAGTTCTTCCAGTAGAAATGACTGAAATAATCAAGTGGCTATTCATGGGAGGGTGTCAGCAAAGGTTTCATAATCTGGGGGCTTTTAAATGGGTTGGTTTTTATCATTAGCCTATTCTCAAAGGGCAAAATTATTGGGAACTATTATAGAAGTGATTTAGAAGGAGAGAGCTAAGGGGAGTGGAAGATAAGTGGATGGAATAAAAGGAAGAAAAATAAATGGAAGCAGAGTCAAGAAAATAAAATAGAAATTACTTGATAAACTATAAGGTTTTTTAAAAAACCATCCATAGAGTTTTTGAAAAATAAATTGATATTTCAGATGAGGTGCTTCCTAAATATTCAAATATTAACACTGAAAAAATAATCTTATCTTAAAG
>TTN-214,,0,430,3043947,3044376,GTACAAATCTACTGTCATTCTTAGTTGTCTCTAAAAATGCAAATATGTATCATTTAAAATATCATTACACTGACATCAAGATTTGAACACATGACCTTAATCTGTTAATCACATATGGCTTAATTTTCTTTACCATCTCACTCTCCTATGCAATTGGCTAATGATTACTCAGTTGCTAAATAAGTTACCTGAAAAAAAATTGTATTTATGGGCAATGAGATAAATAACAACATTAAAACCAAGAACATTGCCTTACTATATTTTCCAAATATTTTGTTTAAAATGAAAACTAATCAAATACTTGATTTGATAATTATATGTATATAAATTCTAATATCTTCCAAGATACGTGGGCTTAATTTTAGTTTTGACTTTGTGAAAAACTTCAAAAATCCTGTAATAATCTGCCCTCTACTCTAAATTATTTCAG
>TTN-214,,0,259,3044377,3044635,GTGAGCAAGCTTATCCTCAATGTCAACAGCATATTCTTTCTGTATTCACACACATAACATGTACTTAATAAAAGATAGTAGGTGAAAGTCAGTATGTATCAAATGATTTCTAACGTCTCAAAATGCTTAATATACTATTCTCTTAAAAACTAGTTATTTGAAGATTTCAAAATTATATCAGAAGAGGCAAATAAGCTACCAAATAAGTTTTTAGGAAGTGACAAATTGATACACTAATGCAATGGACTTCTCTCTACAG
>TTN-214,,0,2279,3044636,3046914,GTATTTATCCTGTAGCTTTCTTTTTGCTAGTTTGTTTTGGTGACTTAATAAAAGTATTCACACTTGATTAAAATTCAAGCCCTGTTTATGCTGCAACATAGGTATCATTTCAACTTCGGAGGTTTATGGTAAGTTTCTACCTTTTCTTCATGTGATATCCTTTATCCACCTTGTCTCTTGCCCAGTGGGTGAATATTGTGCCTTAACTGGAATGTACGTTCCTGGGTTGCACCATTTCTTTCATATGCTTTGGAGATTAAGTAATGAATATGTTTGGGGCTGATAAAAACTAAGGAGACAGGCAGAGACCCTGTAAGGGTATACATATAAGAATCCCATGAAGCTTCAAATTTCCCTTATACCCTATTGGAACAATTTCTCTTTTTTAAAAAAGTGTGTATATTGGGATAATGTAAAAGTTCTGGAAATGGATAGTGTTGATGGTTGTACAATATTGTGAATGTATTTCATGCAACTGAATTGAATACTTAAAAATGGCTAAAATGGTAAATTTTATGTTAGGTATATTTTACCACAATAAGAAAGAAAAAGAAAAAAGAGACTCCATATTTCAGTCTTTTAATCTGTATAAGGAATTAGATCAATAATAATTTTCTTAAATGTTCTAACTTAATGATATAGGTATCTCAAGTCCAAACTTAAAGCACCTATTAATTGTATATGAACTATTTAGTATAGTTCATCATTTAAGTGATAATTTGAGATATAATTGATCAAAACTGATTTGATGTGTAATTGATAGTCATTGATAAACATACACATCCTGACTATTTGCCCTTTGGCTCACTATCTGGGTGATGAGATCACTCATATCCCAGACCTCAGCATCATGAAATATATCCACATAACAAAACTGCACATGCATCCCATGAGTTTAAAATAAAAGTTGAAATTATTTTTTTAAAAAAGAAACAACAAAACCAAAAATAAAACAAAGTAAATTTAAAGCGGGGGCGGTGGTGGTGGGGTGGGGAGAAGGCATGTATTGATAATTTTCTAAGATGTGAAGAATCTAAGATATTCAATATAATGCCTTGACAATTTGTTCCTATGGAAAAATGATCATCTCCACTGATAAAGCACAAAATAAAAAATTCAGGGTGAATTTAAAAAAAAAAAAAGAGAACTATTTGTTACATTCCACAGTGAGATGTGCATAGGCCCCGGGAATAACATTTAGAAATGTCCATAATAGTTTGACAGAGAAATTTTTTAATTTAATTTTCTGAACCTAATAATAAAAATTGGCTTATATCTTTAATAAATCAATAAATAAAACTATTTGGAAAAATTATATTATTTTAGATTATTAATTCAATAATTAGTCATTTTATATTTGTTTATATATTTTTATATAAATTATTTAGAAATTTTTTTATTTAAAATTATCTCAAAATATTTGGACATTACCATGTTTAATGACATAAAAAAATACACTATATTCTTTTGACTGTAGTTTAATTTTTAATATTTGTGTTATATTTTGTTGCTGATGTTTATGATTTGGGCATATTCTTTTAAACTTTTATAATGTCAACGTAGTACTTTTATTATTCAGAAAAAGGTGATGAACTGCTCTTGTCTAATTAAGTATGTATAAAAATAAAGCTATTCTCAGTTATCCTGGGGGCTGAAGCTAGAGAACTCATTCCACAGTTTATACTGTCCCTGTATTAATAATGGAATCAAACTCTAAATGTCAGAACTCTCTTGCTTCTGCCTTACTTCATTGTCTAAAGGAAATCTTCAAAGAAACTCATGCATGTGTGGTACATGGACTCTTTTTCCTTAGTCTTCCCTGGATTTGTTTGTCTGCCCAATTTAGACATAAAAAGAAAGGCTTTTGGTAACCTCTCAGCCATTTCCCTTTTCCCTACACTGATTTATTGACAAAACCTTATTTCCTTGGTTCACATAATCAGGACTTACATAAACATATAAAATATTTTGCACAGCTAGGCAGGAGCAAAACTTTTCCTCACAAGGCAACAGTAAGCCTTCCAAAAATGGGAAGATAATAAGGCACTTGCTGAAAGAAGTTGTTAATCCTAAATATGTTGGCAGTTTAGCTTGAGCTCTTCAGTCTCAGAATATGCCTTCCTGGAAATGTGATTATCCATAGAAGTCATATAAATGAAACCAATTTCTCTTTATGCGTTAATATTTATAATGGAGCATGACTCACCCTCCATGGTTTACTATTAAACATGAAATAAGTCCGAAAAGTGTTTAAATGCTGAGTTTTATTTTTATTTCAG
>TTN-214,,0,569,3046915,3047483,GTGAAATTCATTTTTCTAGTACTTGCATTGTAACCTTCCACTCTGAATTTCCAAAGTTCATATTCAAGGGGAAAAAAATTTCAAAATTCATAACAATTTTTATTTTTTCTAATTGATTCTACTAAAACTAGCATGTTTTCTGATATTTCAAATAATACTTTTAGTATTATGCAAGGAGATATATATATATATATATATATATATATATATATATATATATATCCAACTATATTTTAGCATAGTGAATCCCATAAGTTCTTAGCTTCATTTTTCATATGCATGGTATTTATACATGGCAGATAAAATAATTAGACATTAATCTGGCTATTTTATACTTCAGATTAAAACTTGAGAAAAGGGACATTTATTATTCATGGATTCCTTATACCATCTCATTTTCCTGCCTGAAACAAGGCAGTATAAACTCAATTGGCCTTTCAATTGCCTGGTCTTTAGTTTTCTCGTCTTCTAATTGCTTTACGGCTGGTTTTATCCAGCAGGCAGCCAAGTATGAACTTTCTGACTCCTAAGGAGATGCCAAATCAACTTTTTATTTTACTTTGAATTAG
>TTN-214,,0,156,3047484,3047639,GTAATTTCTAGTCTTCTGAACATAATCTATATTAAACTTTAATGTAACAAACCTTAGTAGCAACTTGCATTGTAGTTTTACAAAACCTCTTATTTCCAAGTTTTATTTCATTGAAAATATTGTATTTATTGAAATATATACTGAAATTCTCCATAG
>TTN-214,,0,247,3047640,3047886,GTTAGTACTTTCCTGGGAGATTTCGTTCTGCTTATTGTTACACTAAGAAAATGGAAGAAAGGACCTCGTTTCCCAGTATTACAATATCAGAAATCTTGTACCTAAGAGGGGAATAACAATATATCCTACAGTGGATTAATTATGCCCAGTATTGTGAAATTTTTCCTATTCCTGAAATTTACTAAGGAAGCTATGTATATTACTTGTTCAGACCTTAATCATTTTTTCTGATCTTATTTTCATATAG
>TTN-214,,0,135,3047887,3048021,GTATAAAATCTTACCTTTTATTCAAATTATAAGTTTTGCGTATGTGTAAAGCCAAATAACACACCAAAACACATAAAAGCAAAGCATCGTTGGGTTGTCTAAAGCATTATGTTACTTCATCCCTGACCAATACAG
>TTN-214,,0,315,3048022,3048336,GTGAGTAATTTCACATTTTAAATTGTTAGTCATATAAAATAACCACATCCAATATTCAGGATCTATATCCTAGATTCGGGTTGCTTTAATAATAATGGAGTTAATGGAGTCTTCTAAAGTCTCCAAGAAGGAAAGAAATTTTACGTATCATTTGGGGACAACTTGAACAATTTGTGTAAAATGTTATGACAGGGAATTCTCTGCTTACTTTTATTAGTAGTAATTTTTAAAACTCTATAGAAATTTGTATCTGAAACACTTCTCCTATAGGGAATTTATCTCTTTCAAATGGTTACTAAAACTATTGTTTTTCAG
>TTN-214,,0,93,3048337,3048429,GTATGGGGCTTTTAGAATTTGGGGAGGGGTCTCAACTTTATTTCACTTCCCTGTGCATTCTGAAAAGCCTCATTCTTAATGTCTGATTTTCAG
>TTN-214,,0,282,3048430,3048711,GTAAGCGAGCTAATGAGATCTGTGACATCCCATAAAGGCATGCAAATATATGACTTTAAAGATAGGACGCCAAGTTCTAAAAGCTGTGATAATGCATCACTAATTAACTTTCACAGTGTTACCAAAACAACCCCCCTTAATTTGTTTTTAGTGGAGCTCTATTTGGAAAGATGAATAAATAAGTGCCATGTGAAATGGGTCCCTTTTACTCAGGCAGATTAGAATGGAATCTTTCTGAAGGTGAATTGTGTTTCTGAGGCATTATCTATGCTTGCATTTCAG
>TTN-214,,0,140,3048712,3048851,GTAAATGTAACCAAGTATAACCAGATAGCCAGTTTCTGAATCATGGGAGTGGGGAGTAATAAAATATTTTGCAACCTTTTACTCTTTAATAAACTTTAATTTTCACATTCTTCTAATTTTATGCTAAATGTCTTTTACAG
>TTN-214,,0,86,3048852,3048937,GTGAGTTGCTCAACAATGTAAAATTTACCCTATCTGAATCTGCAGTTTATTAGTTCAGTCATGCTAACAAAACTGTATCATTTCAG
>TTN-214,,0,142,3048938,3049079,GTAAGTCAAGATTAGCTAATTATATAGGAGAGGGGTTGCTTGGTTGTGTAGGGTGAAAAAAGGCATAAAATATCTTGATGATTTGTAGGAATAACTATATAAATGATGTTCTTTCTTTCCTTCTAACCCTCACTCCAAACAG
>TTN-214,,0,125,3049080,3049204,GTATGCTCTACTTGTCAGCCACGTTTTTGTATTTTCTCTGCAAGACTTCCTGATACACCCCTGCATTGATCAAGGGTCATCAATGGAAACGTATTCTGACTTCATCCACTGTCCACTTCTTTCAG
>TTN-214,,0,112,3049205,3049316,GTAAATAGTTTTATCAAATAGTCCACCCCAAAATCATTTTTTTTGCCTTTAGTTTTATATTTCTTCTTTAAAGTGCTTCAATTAATAAGTTCTTTCTTTTTTTTCTTGATAG
>TTN-214,,0,846,3049317,3050162,GTAAGTGCTTTTTAAATTTTAATTTTACTGCATTAAATTCAACAGAAATTTGTGGAGTATCTATTCTATAAAATAGTCTTCTAAGTGTTATATTGCATGAAAGCAGCCCAACTCCTTAAGAAGCTATCACATATGTAATCAGGCTTATTTCTAAAACACTTTACCTTCATTACTATAAGTTAATGAAGATTCTAGCTTACACCCACAAAATAGCCAATTAAAAGCCAACTTAAAATTCTTCATTAATTATTGAGCCCTGTCATGTTTAAAATAGGAGTATATAAATACTTTCTATCTCTTCATTTTATCAAAATTATTTCAGAGGAATGTTTTTCAAGTTTCCCATAAGAGAAGATATTACATAATTTACATTAATAAGCCTCATTGTTTTTCTTGGCCACCTAATATCAACAAGATTAAACATGAAGGCTAACATATATAGACATGATTAAAGGCAAACTATTAATTGATTAAGAAAAACTAACAATGTGAACCTGAAAGCTTAAAAGTAAACTAGACATAATAGAGTTGCTAAGAATTAGAAATTTACCCAAATAATGGAGGAACACAAAATTGTATTTGAAGCTAAATTTCAGTCTTTTTAGCTACTGTTAATAAAATGTTTCAAAATTCAATATGAATGGATTAGATCTTGATAAATCCCACACACTGATTCCCTTCCTAATATTTAGAGAACTTTTGAACATAAACAGGTTAAATGATTGAACACTTGACACAATTTTAAAAGATACTCAGAACTCTGTGAGTTGTGTCTTAAACTTTCCAAGAGATTGTCATTTCCCTAAGGTGATTAATAAAAGCTTTTCACTTATACTTTACTTGCAG
>TTN-214,,0,90,3050163,3050252,GTAAGGAAATTTCCATGAGTTTCACTCTTGAAGCATTGGGGTTATTTGTGCCAGAGGCTAATGACCCATGCTGGCCCTTCACTTTTCTAG
>TTN-214,,0,436,3050253,3050688,GTAAGGCTATTTCTGAACTTGTCAACACCTAAAGGAGCTGTGTGAATTAGAAAAGAACAGGTGAAAGTCAGAGTGGATGCAGGACATTTAAAACATGATAGCAGTTTCTCTATCAGACCCTAAGCCAAAGAGAGATGTCAGGGTCTATGAATGGGCTCAGACTGGCACACTTGCATTACTTTTGATCCAGCAGAGTGAGTATAAGGTTGTAGATACTCTGTGATGCTGCTAGTTGGCTCAGAATTATACAGCTAAAATAAATGTGGCTTTCCTCTTAGTACTTGTAAGCTTTACTTCCTAAAAAAAGAGCTCAAAGTTATATAAAGTTTCATCACCATTTATTTGTTGCATTCCTTTAATTAAGATAATCTATCCTTAGAACAAAATTTCAAAGAAAATTATTTTCTATGAAAGTTTTTCTGTTTTGTTGGTACAG
>TTN-214,,0,797,3050689,3051485,GTAAGTATTGTATATTTTTCAGGGAAATTAAATAAACACTTTTTCAGAAAATGAATGTGAGTGAAATTAATTGGACCTATTTTATTAGTTAGAAAATATTATTAAAACACAAAAACTGGCTCTCTTGTATTTGCCACTTTGACATTCCAATACAGAAGTGGTTCAAATCGTAAAGTTTTGGAAATTTTGTTGACCTTGCCATTTGAACAAAAGAAAATTTAGCAAATCAGATTTTCCTGCTCTGTAGTCCTCTCATTGAAAGTAGATACACATACAATGAGAATCTAACTCAGAACCCTTAAAGACCACTTCCCTCAAGTGGCTGTGCAACTAGAGCACCAGAAAGACAAGCTTTGCTGTGTGGGCATTTTAGATTCAAGAAAGAAGGTGGGAAGCATTAGGCTAACGTTTCTGGAAGGTGCAAAGTGTTTGATGGATAGGGACAGCCTCTGATTGAGGGCCCCTTGTCCTCTCCCAATCAGAGTCTTAGTTATTTTGGAAGTCACATACCTTATGTAGCAAGAAGAACTTGACGCCTGGCAGAGAGACAGATGCAGCACAGATTTCTCGCTGACCTTGTACGTCAGAACGAAAGGGCCCCTACATATACTCGCTCTCTGGCTACCAGCTCTCCCCTTCTCAGCGCCGTGGGGCCACGTTCACGTGGGAGTTAAAATAGTGGCCAGTCCTGTGGCTTCTTGAAGAAAGCAACCATGAAGATTCATATCTAAGTCTCTATTTATTCTTTTGGGATTACAAAATGAGTAACGCAAAGCTGTTTCTTCCCTCTCGAAAAG
>TTN-214,,0,3904,3051486,3055389,GTAAAAAGCAGGCATGCCTTGTCTTTCCCGTTCTTTTTCTGGAGTTCTTCCACCTTCACTTGTATGTTCCTTATTCTTTGCTCTTTCTAATGTCTCTTCCTCTGTCTTTGCCTTTCTCTTTCCGCCTTTAGCCTGATTTCTGCTGAAACTGTAAAGCCAATTTTTTGCATTTTTTCTTAGGTTTAACCTGATGATTTTTTTATTGAAATTGAAATAAATTTAAAGTATGATCATGTTTTAGTTTTTTGAAGAAAAGACAAGACTCATTGACTATGAATGATAGTTTGATTAACCAGAAGGCAGGAAGGATCAAAAAGGCTTTCTGATTGCACGCTCTGCAGCCATGGTGCACATTAAGTTTTAAGACTAACGCTCTCCATCCTATTTAGTGTTCTGCATATAAGGGGATTAAGAGGAGAAGACTGAAATTCCATTTCGGGCAGTTGATCAAGTAGTTGAGATAACTTCTGGGCAGATTTGCTCTTCAAGCATTTCTCCAAAGCTATTTTTAACCTTCAAGTGCTCTGGGCTGTGCGATATCTGGAATGCAAGTGGACTATTTAAAGTGCAACTGATGGTACTGACAAGAAAGAAGGGCTCTGTGGTTATCCACATATGTGGATGAAATATTTTTTTTAAGCTTTGGTAAATAACTAGCTCCTGCTTTTAGCTTTTACTAACATTCTTTATGCCCAAGATTTTACCCATAAGTAAAAACTAAGGGATTATTCAGATAGGCCCACAATACAATTTGCCTAAATTGATCTATATGTTTTGTCCCCAGAAACAACATATGTCTTTAAATTATCTTGACAATCCATCATTAATTTTGAATTCTTAAAATAAAATATATGGAATATGTCCAGCCTGGGTTGGAAATAAAGCACAGGACAGTACATTGTTCTGTGACATATTCCCCCAATATTTCAGAAATACTATTAAATGTGCTATAAAGATCTCAACAAAAATCAAACTTTGAAGACTTAAAGGAATATAATTAAAAAGTGATTCAGTTTAACAAAAAGCCACAGCATTGACTGAAGTATTTGAAAGCAATGCCTTCAAGTAACTGCTTTGAAACAAACAAACAAACAACAACAACAACAACAAAACTAGTATTCCACTAAAGTGATTACAGGGTAATTCACCAGCAGTCATCTGATAGGTAACGCCTGCCTGTTATACAGATAATAAGATCTTCTTGGTCTCCTTTTCCAGTGACCAGAAAAAGCAGCAGTACATTCCATTTGTAGCATGGGAATTAAGTTACATATCACAAAACCTTCCTTACAATGAGGTCTTCTAAATATTGAACTGAGGGAGGCACCTCTACCTTCAAGCTTATTGTTTGAAAAAATATATTTTGCCTATCATGCATGATTTAATTAACTTCATGTCTAAAGGCAGAGAATTGGTTGCTTTTTCAAGATTCTTTCTAGATCTGCAAATTCATGATTTATATATAGGAACACTGCTTAAAGACAAATGATATTATTTTTTCATTACCAAATATCTTTTTGTCATAGTAAGAGCTTCTTATTAAAAGATCAGTCTCAGTTCTAATACAAAAACTGCACTATTTTAATTCAAATGTAGACTCCTAAAAATCTTATTCACATTTTATTTTTAAAAAATTCTCATTGTAACTAAAATTTTTTCTAGGGTTAGAAAGGATCAGTTTACTATAATTCTATAGGGCCCCTTTACATCTCTTTTGGCATAGGAATTTTAATCCTTTACTCTAGGCACCCGAAATACCTTAGCCTTTTGTGAACTTGCTCTTGCATTACTTAAATGTCTCTTTTCAAAAAGAACTTAAATATAAACTTTGAAGTAATAAAATCATTTTGTTACATGTGGCAGATTTTGTTTAAATTAAGTCTGTCAGAACAAACTTGCTCTTGTCAATGTAATTCCGAACTTTAATACTCATTTTATGTAAAAATTTTCGCCTTCAAAACTACAATAACCAAACAAGCAAAAACAAGCTGTAGGAATAGGAAATATGAAGAGAAACTTGTAGACATGAGTTGTTTGCATTTTTTCTTTGTTGTTGTAGTTGTTTTTGGCTGTCAGTTTAAGAAAGGACTGCCAAGTTCCAAATGGCATTTGATAATTTTAAAGTTAAATTTTAAATTTGATAAAATTAAAGTTTAAATACAAAACTTTAATAGTTTTGTCATGGTCATAAGCCTACCGTATTATATTAATATGCTTCCACTATAAATAAATATTTTTAAAATCTCTAACATTATTCTTACAATCTACTGCAAAATCTTCAACATTCATTTCATTGGTTTATTTTTATAAGGCACCTACCAGTTTTCCTTTTTTTTCTTTTAACATAGTGGAGGTAGATTGTATACAAGCTGTTTATTGAGACATACTGCATTCTGAGCAGTGTCCTAGAGTAGCTACAGAGGAACTCAGATGATAAAGCAACATAATATTAATAGATAAAATATATCTGTGGGTGGGTTAGAAACTGAGACACCTTTTCAAATAGCCAAAAGTTGCATGCCAAAATTTATACTGAAATGTTATTAAAAAAACAAATTTTTCCCATTTCAGCACCATGCCCTCGGATAAGTAGCTCTGTTCCAAGGGCATATTTAACTACCCCCTCCTAGCTGTTATTTTTCCTTATTATGTTTTTTGGCCACTCTCAATTATTAAGATAATTATGTGACTAACCATGCCCAGTTCTTAATTAAAGAAAACACTTTTAGATGAAACCTTATTTCTGATTCTTTTCTTTACACTAGCATAACAAATAGTTCCACTGGTGAAAAACTTTACATTATTTTTAACGCTAAGTAAACTCTTAAGCAGTGCAAAATCAGTCTGGATGACAGGGCACAGCTTCTTAGGAATTTTATATCATAGAACTGGAAGAACCCCCAAGTCTCTTATCTTTGCTGTCAGAATGACCCCTATCTGTCGCACCATTGACATCTGATTTTCCCATTCCTGATGCTTAGACACATGAAAAAGGAAGAAGAGTCCAACTTTCATTTGCAGTTTTGAACAAAATTAATAGGTTGTACAAATTATTTAATCACAGGTTTAATTGGTTTGCAAAATAAGTTTAATTGCTAAAATAAATGGGAAGAAGAGTTATAGCTTGTTGTTGCATGGCAAACACCTTACATACAGAACATAAGGTTTACTTTTAGCTTGCCATAGCTGATATTTTCTTTCATCCTTTCATGAATTCGCTTTTCTAAGTTCTTCCTTTATATGTATATAAGCCCAGGGGCAGAATGGGGGCACACATATATATACACATATACGTATATACTATATGTGCTGTATATCTACGCATATGCAAAAAAGACCACAAATGTAAACAGAAACTGGCCTGGGCAATTTCAATGTGAAAGGCCACCTAGTAATTATATAAAGGTAACTATGAAACCCTAAAATTTTCTTGAAAGATCCCAAACTGCATAGTATTCCATGGTGTATATGTGCCACATTTTCTTAATCCGGTCTATCATTGTTGGACATTTGGGTTGGTTCCAAGTCTTTGCTATTGTGAATAATGCCACAATAAACATACGTGTGCATGTGTCTTTACAGCAGCATGATTTATAGTCCTTATACCCAATGCTAGATGATGAGTTAGTGGGTGCAGGGCACCAGCATGGCACATGTATACATATGTAACTAACCTGCACATTGTGCACATGTACCCTAAAACTTAAAGTATAATAATAATAAATAAATTTAAAAAAAAGATCCCAAACTATTGGTTGAAATGATTTTTGAATGCATACGTGCTAAATAGATGATTATAAAACAACTTGGAAAGCTCTATTTCCATTTATTTTTATCTAAATGAATTAAATGCACCCATATACTAGATTGCTGTTTCATGTATTCTTTTTTTAAAAACAACTAG
>TTN-214,,0,541,3055390,3055930,GTAATTACAAGGCTTATTTTAAAAACATGTATAAGGCAGAGGCTCATGAACAATGCCAACTCTCAATTATCTTTATATGATGAGTACTATAGATGTTTAAAATCAACCAAATAATCAAAAGTCTGATTTTACTTTTTAGCATAACAAAATAATTCACAGACTATCTTTTTAAAGAGCCAAAATTGACTAGCATAGGTTTTACTTCCTCCTTCCATCTCTATTGTTTTTATTGCACATCCTAGATTTTCAAAAGCCAGCTGGAGGAAGAATTATTATCAAGCTAGGTATCCATCACTTTATTAACCAAGAGTTGGCTGTTATTTCCTTAATGTTTCCTAGTTTTTAAAAATGATTTTCCTCTTGTCTGTACAAATAATGATAAAATATCATTTTTAGAGGAAAATGTCTGAGTGTAATCAAAACTTGAAAATAAAACTTAGGACAGAACAAAGCCCTGGAGATGGCAGGGGAAAGTTGAGAAGGTACCAAAACTCTTGGAGAAGGAAAGGAGTACCTTGGCTAATGAGTATGATTCTTTCAG
>TTN-214,,0,1697,3055931,3057627,GTAAGTATTCTTCTTACAAAGGACTTTTCATTTGCAATTCTTTAATAACTACAACAACAAAACAACACAACACTTTTTGCATGCCCTTCTTGGCCTAACTGCATTTCTTGGCAACTTCTAGTATTGACACTGACCTAACCTGATCCTTTATGTGTTTAAAGAAAAAAAGAAAAGAAAAGTCTTATTCTATGTCTGGTCTGATTAATGATGGAGCAATCACTTTTCCCTATGCTTCTTTTCTCTCACTGAGTAGTGAGTAGATGTGCTCTTTGTCTACATGGGGTCAGCCTACTGTATGGATATCCTGATATGGATGAGGAGAAACTGAATTTTAAAGATAAGTAGGGAGTCCTAATTTTAAAAACAAAGTAAAAGTGATTTCCATGTGGAAGGAAAATGAATTTTCAGGTGTGGGGAACAACTAGAAAATGAGCATGAAATTTCAGTCTGAATAGGAGCATACTAGAGATCTGCTGTAATATGACAAAGCACATTCACATGATTCAATCTCTGAGAATAAGAATGGATAAGAAGATGGAGTGAGGCCCTGGATCTTTTGAGTCCTGGACTCTTTGAATGAAGAGAACTCTAATGGTTTTTAACATTACTTCTTCCTCTGGTGAAAAATGTAATGTCTTTTTTCAAAATGCCACATACTAGCTTATTTGTTTCATTCATTCCTTTGTCCAGTGATGACATTTTTCTGCAAATTTTTTGTGCAATATTTGTTTGTTTGGTTTGGTTGCTTCCCATCTGTCAACAGCTACAACCTAGTGACTCTGTGCTTCATGCATCTTGTACCATGTTTTTCTTACCACTTTGTGGTTGCTCTGCTCAAGCTTATGTCAAAGTAGCTTCTTGGGTCTCCTTCTTCACCTTGACATCTACCTTCACTCCAAGAAGGCTCAGCTGCAAGGAGCATATTTTCAAACCTATTAGACAGCATTTGTCTCAGAATCTTATTGCTCAAGAATGGTCATCTTGGGAAGGACTCACAGGGAGCTCTGAAAGAAGGAAGGGCAAGGGGGCAGCTCCCTAATCCTATACACCAGCTGAATTAATTCTACAGATGAATGAAATAACAGATGTAAAATCCTAATCACCCTCCCATACAAAACACATTGCTTTATTGCACTAATAGATGTTATGCCTGACTTATATGTGACGTCTTCAAAGCTGATTTTTTTAAAAAGCTAAATGTATGTTTCAATTACAGCCTCATGCCTCTTAGCCATACACAAGGCTGGCCATAGTGCTTCACGTGTTCTATCTTTGAATTCTGCTAATTTCTCAAAGATTGTGCTAAGTGCCTTAAATAAGACAATGTTTCTTTGCCACTGGTGTCTGAAGTTTCCTTTGACATTATCTTTCAAGTCTGGTGCAGTGCAAATGAAGATTTTTCCTCCAGCTATTATTCAAAAGAACTGAGATGGCTCCCTAGTATATATACTGTACACACACACATGCACACTAGTTGAACATATAGAATGCCACATAATTTTATGTAAACTAAAGAGATATCTAAAAAGCAAAGCATCATACCTGATGGGCAGCTTCAAGTGATTTCAAAGTCAGTTGTAGTCTATTAAGATGGAAAATCCCTAAAAAAGAGTCACTTTTTCTTAATGTATACTATGGTAATGTCAGAGTAAATTTCCAGAAACCTCATTTTGAATTCTGATGACATTCTCTTACAG
>TTN-214,,0,661,3057628,3058288,GTCTGTGACTGTATACCTGTCATCTTGTACTGTCAAATAACTTTATATTTACTTTTGGTCTAGCCAAAATGGAAAAAAAAAAGTTAGTCACAACTTCTCTGGTCACCACTTTACTTTTAAAGATAATTGTAGTATAAAATGTATTCTTGACTTTAATTGCTCTCTTTTTAGTATTATTAATTTACTATTACTTGAAAAACACTGGACTCACAATCAGGAGATTTAGATATTAGTTTGAACCATATGAAAGTGCTGTTTTCTTAGATCAGAAAGTCAAATATCAGCAATTATATTTCTTTCAACTAAGTACCTCCTGTTGCTATTAACTACCATTGGCAAGTTTCTTCAAGTCTGAGCCTTAGTTTACACATCCAAGAAGTTAGTCTGCATAATGTCTAAGGCTCACTATAGCTCTAAACTTATATGATCCCATTGTTTTTAATAACTGATAATAGTATCACAGCAGCTAACTTAACAGTAATTGGTAAGATTGTTCTTGCTTTTGGGGTTTGTTTATATTTGTGTCTGCCACCTTGGTTCTTCTTCACACTATGAAGTCTTGTTGGTTGCTTTCAGAAAAACTCAGGATCATAGTTTTTCTTAAGGACACCTGTGTGAAGGAACAACAAGAAAACTGATAATCTATTTATCTTAAATATAG
>TTN-214,,0,98,3058289,3058386,GTAAGAGTAAAGTCATTCTTTGTGAAGTATATGTGTTGGGAAAAAATAATAATTTCCAGCTTAACTCAATGTGGTTTTTGTTTTTTCAATGCTTGCAG
>TTN-214,,0,106,3058387,3058492,GTATGAAAACTACAGTGAATAATCTTTTATTTCTAACAATTCACACTTGCTAGATTTAAAGTACAAAGACATATGTTTCTAATATCTTGTAACTTTTTCTTCCCAG
>TTN-214,,0,108,3058493,3058600,GTAAGTTTGTTCTTGCTTTTAGGGTTTTTTGTTTGTTTGTTTGTTTTGTATTTGTATTTACCACTTTGATCATTATTCATACTATAAAGTCTTGTCGGTTGCTTTCAG
>TTN-214,,0,89,3058601,3058689,GTAAGTAATTTATATACCACTAGAGATTTTTTCATCAGTTTCTGTTATAAAAATAATTAAAATCAACATATTTTTCTCCTTTACAACAG
>TTN-214,,0,104,3058690,3058793,GTAAGCAAGATCTTTTTATTCTCTATTTCTGTAGCTATATATACACTTTTGACAATTTAGTGGCCATCATTGCAAGCTAACTGATAATCCAATGTCTCCTTTAG
>TTN-214,,0,100,3058794,3058893,GTACATATTAAGTGAAAAAACAATTCTAATGTTACCAATTTTTTAAAATTGTTAATCAAAATGTAAACATATTTGTATTTATTTCACATTTTCTTTCCAG
>TTN-214,,0,767,3058894,3059660,GTCAGTCCCTTTATTTTAAAATATCCTTCCAATATCACAGAGTTTAGATTTCAGATTTCACAGTTATTTAATGAGGTAATCCTTGTGAGGGTCTTTCATTTCTAGCAAGCCCTACCCACATGTTAACAACTCTAATTTTGCTCACTACAAAGTAAGTGTCTTGAGTAAGAGGAAATTAATAGCAATAATCTTTACATGCCAGAGCCTTGGACAGTTGCTAGTACATGATGACTATTTATGAACTTAGGCTACAACTAAGCTATCACCCTGAGAGTCTTGGCAAATCTAAAGACGGTCTTATACTCTCCTACTTTACAAACCCCTGTGTGCCTTTTAGGTATGTTCTCATCCTGACCCAGGACATCCTTATACACTGTCCTTATGAAAAAGCCATTAGTGTACCTCTCATTCATAAGAAAAAAGTTTCTCTGATTTATTGAACTAAGTATGCAGTGCCTACTCTATCAAAAAACAAAACAAAACATGTTTTGCACTACACTGAGTCCTATGTTACTATTTTTGGCAAGGAATGCATGTCTTATGATTTTATGCCATTCTCAATCCTCTACTCTCCAATCTAATTTGCACGCACAACAACAACAAAAAGCTATGAGAACTCTAAGCCACTTAGTTTTCTCTGCTATAAAGTTACTGTAGCTTACTTCCAAGGTTATGTAACCAATATTTTCTAATAAATGCATAATAACATGATGTAGCTTGGCTACGTTTAATAGTCGAAAGCGTTCACATGTTATCTTTCTCACTAG
>TTN-214,,0,92,3059661,3059752,GTAAGCCCTTGGGTCTCTCAGACTTAATTGGCAAAGCACAATTTAAAAGCAAGACAGCACACTAAAAAAATTCCTCTATATGTGAATTTCAG
>TTN-214,,0,107,3059753,3059859,GTAAGAAGTTTTAAGTAAATTCAAGTTAGCTTTTAAGTAAATTGCAGTCTTTGCCTTCATCATCGTTACCCCAAACTCATATTTTCTTCTTCTGTGGTGAAATCCAG
>TTN-214,,0,266,3059860,3060125,GTAAGCCCATCAAAAAAGGGAAATAATTACTGCATGAAATCCAGATATTAGGCCTATCAATTAAAATAAATCAAGTTAAATGAAAGTTAATAAAAAGGTAGAATATCATAAAAATTTGGATAAAGTTTTAGAAACCCAGACTGTGCCTACTTTACTTAGTGAATTTGATAAACCTGTTAATGAGGATGATATAATTGATTACAACACTGTTTTCATAAATTGTCACTAACGTAAATGGTATGCTCCAACTCCTTCTTTTATTCCAG
>TTN-214,,0,90,3060126,3060215,GTAGGTCATTTGCATATAAAAAAGAATATTCAATGTGGATCATGGACATAACTGTATGTGTTTTTTACAAATATTAATTCATAATCGTAG
>TTN-214,,0,106,3060216,3060321,GTAAATAGATATTTTATTTTTAGATCGGGGAATAGCACATAGCTACTTTGGGGCAACAGGGACTTAAATATGGCACTGCAAACTCATTAACTTTTCTTCTTTGTAG
>TTN-214,,0,98,3060322,3060419,GTAAGGAACAAAACATTTATCATCTAAGGTGATTTGGCAGTATTAACAAATATTAGTTCAGACTATTAACAGTGACTCGTGAGTGCATTTTTTTTCAG
>TTN-214,,0,690,3060420,3061109,GTGAGTTTTGAGCAGCACTGCATCAATGCCAAAAATGAGAGTAGGGGAAATCCCAGAAGGTTGGGATGCCATACAAAAGTCTTATGTGCTACAACTTCTTACCTTTACCTCACTGAAAATGTACAAAAACTTTTTAAGAATGCATCGGTGCTAATGCTTCCTGAGGTAGCTCAACCAAGGATTGTATAATTGTAATTGTCTTGTCTTGTGAGCCTTACCAAATTTGTAATAAAAAAAAAAATTCCCTACTGACTTGGTACCTGCTAAGTACCCAATATGTACCCATTAAGCTAGAAGTGGAAAGTAAATATTTATTTCCCTGGTGGTCACACTTCTTATTCCACTAGAATACCTTAGTTGACCTAATCAGCCATTATTTCCTTGTGTTTATATTAGTTACTATTCTTTACCCTGAATTAAAATCATATTTCTGATAAGCAAACTGGTAGAATCAACACCTCATTTGCCATCTTTTTTCATGTGTACAAACTATGAAGCAGTTTTTCTTATATTGAGTCAAATATTATCATGTATCCTACTTTGCAATTTTCCCTAATATGAAATTAATGTAAGAATAATCCCTAGCATTCAAAACAACTGCAGTTTGTATCCCTGGTCATGGTAAAAATCTTTTGGGTTGGCGAAAGGGTTTTTTGGAAATAACTGATTAACTGTATTTCTTTGTCCCAG
>TTN-214,,0,156,3061110,3061265,GTGAGTACATTCTTGATGATTTCTTACCTAATCTTGTTGCCTGTTTTTGCTTTTAGACCTAGAGTTGAAGTTATGGGGCAAGGCAGGGGTTGGCAATGTGAAGAGAACTGCATAGGTGGCCTGTGTAAGACTGACTCTCTCTTCCAAATGTTGTAG
>TTN-214,,0,338,3061266,3061603,GTAGGTTTTTAATTTGGCATGAGAGTAAATGTGTACTCCTAGTCACTAAAATGGGCTTTGTTGGGGAAAATTTAAATGTTTGTCTTTTTTCATTGAGAATCCTATGCTGCCGGTGTATCTGTCTGATTTTTAAAGGTGCTGCTGAATGTACTGCCTGCTCAGGGTTTTCATGACAGTATTGAAATGAAAATGTATTCAGTTATAGTGTTGAAGTAATCCAGGTTTAATTTAAAGACTAGTATTATACCAGGGGTTTGAATTTTTGAAAGATTATGAGTACTACACAATGAAACGATTATCGACATCACAGTAAAACATCCTATTCTGTTTTCTGACAG
>TTN-214,,0,93,3061604,3061696,GTATCTATTTTTGATTTTTGTCTTATCAAATAGGCCTCTGACCTTAAATCTGCTTGAACTTGATAACATCATAAATAATCTTTTCCAATTCAG
>TTN-214,,0,117,3061697,3061813,GTAAGGAAGGTTCTCATTTTAAAAGGGGATAAACTCTTTGCAGTTACTTTCTTGAAAGAAAAAAATAAAAAAAATGGTGAACAATTTTTTTTTCTGCATCTGTAATGCCATACACAG
>TTN-214,,0,114,3061814,3061927,GTAAGTTTCTCAATCAGCTGATAAAAAAAAAAGGATGCTTATGTCAAACTTGCATTTTGGTGTCATATTTATATACAGGACATATAACATTTTACACCATTATCCTGTCTATAG
>TTN-214,,0,474,3061928,3062401,GTATGCTCAGAATCCCCATCAAGATGTTAAGACAGCAGTATATTCAAATGTTTACTCTTTAGTATTCCTTGGGATTACAGATGATTATATATTACTAAAAAAATTTTAAACTACTTTTACTCATATTTTCTATTACCTCATAATTTGAAAAATTATATAAATTCCATTCAAGGGCACATTTCTTAGTTTACTCTAAAATATTAACCTTCAGGAAGTTTCAAAGTGTTTGATCCCCCAGTATATTATGATAATGACCACTGTCATAGATATTATAATTAGATTGGTATGTTTGGCCCAGTCTAAAGTGTGTGGCAGTTAAAAAGCAATTTTTAATTTATATTGAAGTGCTTTTCAGTTAAATTTCCAAATCACCTTTTCACAATTTAAATAAATTAGTCTCTTCTGTGTAAAATAAACATAGGCTTCTTCTGCTTCTTACCATGATGATACACATGCACTTTGTTCCTAATTCAG
>TTN-214,,0,88,3062402,3062489,GTATTATTTATATAATTTTTGTGGTTATTTCGAAGTTCATATGAACTCCTTTTTGACAAACCTAAACAATGATTTCATTGGCTTGCAG
>TTN-214,,0,196,3062490,3062685,GTAAGTCACTCTTGATGTCTGGGATATATAAATTCTTCTAATATCTGCCTGTGAGCTACGATATGAGAAAATATGAAAAATTCATTACTATTATTTCCTCCTGGCTACATTACTTCTTAATGACTGCCTGCACTTTCAGACTGACTATTGGGTAATAAAAAAAAAAATGAATTTGTTTTCCTTCCTTCTTTTTCAG
>TTN-214,,0,114,3062686,3062799,GTATGCTCTTGCACTTAATCTTTGTGACAATAAGTGCTCTCGCACTTAATTTTTGTGACAGGAGATTATCACCTTTCCTCTGGTTTTCCTAATCATTGTTTATTTTATTTTCAG
>TTN-214,,0,102,3062800,3062901,GTAGAATTTGAATTAATTCATAAAGAATAACTTACACTTGGCTGCAAATTCTTAACTGTGTTTTTTCATTAATGCTAATGAAATGCTTTGTTGTTTCAATAG
>TTN-214,,0,80,3062902,3062981,GTAAGTAGTGCTGATTATACACAAGATATTGTCTAGAACTTGATGAGACTGTGGATATGAATATTTCACTCTTTTCTCAG
>TTN-214,,0,100,3062982,3063081,GTAAGAGCACAAGGTCTTTTATAGTTAATAAAATACCCTTTATTCATGCATTGCATTTTGACATACTCTGTTTTTTGCTCTTTTGAATGATATCTTACAG
>TTN-214,,0,603,3063082,3063684,GTAATCATTCTTTGAAGAAAAACCAGACATTCTTCACATGTAGAGGAAATTAGTTAACTTTGCAGTGCTATTAATAATATAATTGGCTTCATGAACTGGCCACTTGTAAACTAAATGTCACTTCTGATTATGTCTTTCCATAGGAGAAGTAAAACAATTCTAAAGAGATGAAATCGCTAAACGCTTATTAGACTAATTTATACTAGTTTTAGTTAATTGCATGTGAAATACTAATTTAAATAACAGATATTAGCATACCCAAAGAGCATTGAAATGACCACAATTTTTTAATTGCACAGCTTCACATTTTCCCATAGTGTTCTTAACCAGGGATAGTAACATTTTCTGCATTCCCCCCAGCCCTGCAAATAATGTCTGGAAATTTGTGGGGCCATTTTTGCTTGGCACACAGACTTGAGGTAGATACCACTGACATTTAGTAGTTGGGAGCCAAGGATGCTAAATGCTCTGCAGTGTGAATGACACTCCAGCACATCAAAGATTATCCTACCCAAAATACAGATAGCCCCACTTAGAGACAAGTGCATTATTAAAATGCTGATTTTTCAGGATTACTAGAATAATTATCCATTTTTGTAATAG
>TTN-214,,0,103,3063685,3063787,GTAAGTTTGGACATGGATGCACTATGGCTAAGAACTAATAAACCATAGTTTTGTTTTAAGAAGGTGGTTTTCCTGATACTAACATTTTTTTCTTGTTCTTCAG
>TTN-214,,0,113,3063788,3063900,GTAAGTTTTGTTTCATGGAGTTGCCACTTTCCCATTTTGAAATAAATGAAAATAATGTTTTGTCAGTTATTTTCATCAGAATTGAAAACATTTATTGGTTATGATCACTATAG
>TTN-214,,0,299,3063901,3064199,GTGAGTCATTAAAACTACACTTTCCAATGGAAAAAGGTTTTAGTAAAACATAAAAATAAAAAGTTTGGGAGAGAGTTAAAAGAAATGGGACATAGCTTCAGCAAGTTATCCTCAATCATATTTTATCTGCTGGCCATGTAAAAGAAATCACCTGATCTTGTTATTTATTAGCTAATGGAATACAAAGATAGATGTGGGAAAACCACAAATCATGTCAGAGGAGCATGCTCACATTTATATTTTCCATAGCAACCCTTCCCACACAAATTTTTGATTACTGTTCTCTTCTGAAATATTAG
>TTN-214,,0,128,3064200,3064327,GTAAGTTTCCTTTGGCATCTAAAGTTTGCCTTTTTACCATGTACTTTGGTATATAATTACTACAGCTTTTAAAATTGCATTTTTATGTCATACTGGGAAATTTACTTCAAATGTTATTTTTTTATCAG
>TTN-214,,0,96,3064328,3064423,GTAAGTAGTTCCTTAAGAAGAAGGTGGAGTAGAACAAGCTATTGTACATTTTAAAACCATCAGGGAGTTTGATTTGTCTATCTTCATTCATTCTAG
>TTN-214,,0,99,3064424,3064522,GTACTTAACGTTATTGGAATAAAATTATGGATATTTTCTCTATATGGGACTATTTTTTAATCTTTCATGGGCTAATGCATGACTGTTCTCTTTCAACAG
>TTN-214,,0,86,3064523,3064608,GTAAGGAATGTTGCACTGATTTTCACAGGATTTTCCCAAGTGATACTATCTTATTACATTGATTTTTGGCTTTGTTTTGTTTTCAG
>TTN-214,,0,1307,3064609,3065915,GTAAAAGAGAAGGTTTCATTGTGTTTATAGAGTAATGTTTTGCTTCTAGTTATATTATTTACTGAGCTTTATGGCTTCAAACTCCCAACAGTCTCAAAATCTATAGCTAAAGAGTAATAAGAAAAGTAAATCAAAAAACTATTAGCAACATTAAAGATATCATATTTCCTATAATTTCAATGTAATTTGTGGCTGTAAGTATATTAATCATGCATGGTTTCTTGTACTGAAAAACTTGGATCTACAGGGGCTTAATAATAACCTAGAAGTAGTTTAGACATATTATATCTCTCCAGTAGAACACATTGGAAGTCGGGTTTTTAAAACTTACTAGCGTAGTAGTTAAAGAGAATTCAATGTTCTTCTAAAAGATTAGACAATTCCTGAGAATAAATGCCTTAGTCTTCCTCTATATTCAAAAAGTCCCCATACTGGAAGGATAGAGAGGCCCAAAACCAGAAACAGCCTCCAAAGAATAGAAAACCAACCAGAGGGAATCTCCCAGAAATCAATACGAAACACTAAAATTGCACACACAGTAATGCACACTGACATCCCATCTAAGAAAGCAAAGGCTTTGAGGAAGACCCATTCCTCAAGAGACAGAAGAACTTATTCCTTCACCATCACCCCCTGAAAAAAAAAAATACATCCTATATCACTGCTGCAGCTCATCTATGAACGTCCAATATACCACAGGCTGTGCCAGAGGCACCAGAACAGAGCTGAGCTTCCACTCCTTCTGGTTGCAATAACAGTCAACAAGTATGGATTGGGTCTAGTTTTACCACTGAAAGCTTAACTCTTAGTTTGGTCCTTCAGGAAAGAAAACTTCAGCAGCATTACATACATCCTCTTTCCACCATATTTTGAACCCACATGTGAGGCAACATGACTCAAAGTATGTTCATAGACATATCCACTATCTGTTAATAAAAGAAAAAACACTTTGCTCTCAGCTGGTCATTCAAAGCAAAGCTTCACAGACTTACTTTCCTAGTTCAGTAGAATTAGAAGCATCCCCAGTTACAAAGGTAAACAATCTAAAATGTTAAATTAAAAAAGCATACGTGCCCTTGATTTATTTTTCACTGATAATCTTGATGAAAAGTTTGCTAAGAAAAATTCTGTCTACATGAATGTCTATAATTTTGGCAACTGACAAGTTTTAGGAATGATTTTAAATAAGGATGTAAGGTTATGCCAAACAGAAGGCTATTTTTTACATAATTAAGTTGAAGTGAAATATTATTTCTTACATGAATATTTATCTCATGCTAATCATTTTCACTTGCCTCTGGCTAAAG
>TTN-214,,0,118,3065916,3066033,GTGCGGAATCTGAATATAATAATAATTTTAATGCATTTTACAGTGTGCCTTTATCCCATAAGTTGAAAAAAACATCCTTATGACTTTGTTACTGTTTTTCTTTCTCTTCTCTTTGCAG
>TTN-214,,0,88,3066034,3066121,GTAAGTGACTTGCTTTCTTACATCAAAAAGGCATCCAGTGTCTGTTTAAGAATTGCCTTCTCAATATTCTCTGTTGATTCCTTTCCAG
>TTN-214,,0,402,3066122,3066523,GTAAACTCTTCTGAATATTTTCTTATACACATTAAAAGTACATGACTCTGGTTTGATGCCATTTTAATATAACCTTGGAATTTGATAATTAAACTCAAAACCACACACGATAAGCTGTTATTTTGTTATTGTAGTGTTTAGCCCCACACACATAAGGCTCCTTAGTACATAGCGTTTGATACACAGATACTCTTTTAATTGAGATCCACTATCAGGTACAATACATCTACATATTTTTATTTTAAAAAAAGCTTTCTCCTTTTCTCTGTCTTCCCATGTTTTGAGTCTATATATTTATTTCTTCTTACAGTCATCCCTCCCAAAATAAGTTGAATTTTTAAATGAGTGAAAACCAACATAAGTATATTCTCTTCAATAAATTTCTGTTTTTCTAATTTCTAG
>TTN-214,,0,1285,3066524,3067808,GTAAGTATGCTTCCGTTTCTGGGGACTAATTTCTAAAGCACAAAGTCACTAAATGGATAATTCTGCCTTAAATTTCTTATATTTTTCTATGCCAAATTATTTTATTTATTAAAATAAAAAAGGTTCATGTTCACATAGACTATCGGAAGTATATATTTATGTGTGTATACATACATGCACAGATATATACATACACACATACATAAAATCATACAGTTTGTAAACTCTTGGATTAAACCAAATATTTTATGAGGAATCACAATAATAAAGACCTGGACTATAAACTCCTATGTCTTCTGATACTTTAAATAAATTTCTATCTCATTAGATACTGGGGAAATCATCTCTCCCACTAAACAGTCAGACCTTCCAGTAGGAATTCAACAAAAAACAGAATGTTGTTAGCTTTTCTATAATATTATTGAACAAAGATTTAGGATTCTCAGGCATAGTCTGTGAGGTCAAATAAGAGAGAAAAATTCTTCTAAAAGATCTGTGAGCAGATTCGTTCAAAAATTAAAAAATACTGTGGCCATAATAATTCATCCTATTTGCTACATATCTGATTAGATTCTCTATAGAAGAAAAATTCAATTATTTGTTAAAAAGAAAATTTTAAATACTCAAGTGCTATGTGGAGCATATATACCTATATAATGAGGTAGTTATTCATTCATTTGCAAACTAGTATTGAACATGTGCTTTGTGCAAGGATCTATATTAACCACTGGAGGGGGAAAAGTTAAGATTAAAAAGACAAGTACAGTAAAAGAATTTCTGTAATTGTAAAGCACTTTCAGAAAGGTAAAGGATTGTTATGGGATTATTGTAGACACTGATCCTGTCCCTAAAGGGCATTAAGATTAGTTTGTGTTCAAAGGTTTACTAGCTATTGATGGAATCCTTTTTAAATTTTCATATTGTGGCAAATTAAATTTAAATCATGTTTTCAGTAAAGGCTATTGTAGAATTTCTTCAAAGGGATCTCAAAAGTAAAGTAGTTTTTTACCAATCATGTATAAATAGAATGTAAATCTAACAAGATAGGAAGTAGTCTTTCTATTCCCAGTTAGTTGTTTGCTTTCTCTGTTTTTGCATTAATGCTAAAGGAAAATAGACCATTTCCTTTATTTCTCTTCTCTAGAAGGCAACTGTATTTCCTTTTAGCATTTCTATTTTAATATTTTAATAGATTAAAATAATATATGATCATGTGTAGTAAAAGACTCCAGCACTTCATCAGCTTCAAAATCTGATGAAGCTTTTTTTTTTCTTTTGTTATTAG
>TTN-214,,0,131,3067809,3067939,GTACTAGTACTTACTCAGTTTATGTATTCCTCTTTTGATCTTATTATGAAATTGATTAATTTACTGAAGATATTTCAATTACTTTTGACAAATATGAGCTAAATCCTGTTAAATTGTATGTGGTATTACAG
>TTN-214,,0,87,3067940,3068026,GTAGGAAAATAACCATTCTCCTCTTTTTTCCACTGAATCACTATAAGGAGTATTTATACTACAACTGACTGTCTCCTTTTCTAATAG
>TTN-214,,0,94,3068027,3068120,GTAAAAAAATAATAATTAAAATAATTCAGAATATGGTTGACTTCAATATTGCTATGATTTCATTCAATGTATGACTACTATTTTCTTTGTACAG
>TTN-214,,0,93,3068121,3068213,GTAAGAAAGACTTTGAAAGTTGCTACAGAATAAAAACAAATTATTTTTAAGCATTTAAGGAACGTTGCTTATATTGTGATTTACATCCAACAG
>TTN-214,,0,93,3068214,3068306,GTAAGCTTTAAAATCTAAATTTAAAATATCTTCTCAAAATTGAAGTATATTATTATAAACAACGCTTAATACTTCCTTTAATTATTTTTACAG
>TTN-214,,0,1003,3068307,3069309,GTAAGTACCAATGTACTGACAAAGAATGTCCTCCTTACAGCTGCCTTCCTAGGTGTTCAATAATAGTTCACAATTAAAAGAGCTATATCTGTACCTTAGGAAGCTACTATGGCTTGAATGTAGACATGGGCACATTACTTAATTACTCATTCCTTCAATTTCCACAGAATTTTCACATTCCCTTACCTGTTACCTTTTCCCTGTTCAAAGGAGATGATGTCTGTAATTTCCTCGCTGTAATTTTCCTCGCAGTCTGTTTTATTTATCAGAGGCTAAAGCAATTTCTCTGCATGCTCCTCAAAAGGGACAGAAAGTAACCAGTCATTTTCTTAGCAACTGCTGAGACCCATTTATCTTCACAATCAAGTTTTTATTTCTCTATATGAGAAAAGATATATCCATTTTAATGAAGTATATATATATATATATATATATATATATATGGTAATAATTCTTCCTCTGATAATTACCATCACTACTGTTGTGTATTTGTTTATTCTCTCATCTAAGTGTGAAGAAACTGTAGTCACTACCCTCTTTGAATATTTCTGTCCTAAATTTGTGCAAAATGGAAAATTGCTTTCCTTTTATTAACAGTTATATTTCTTAAAAGGGGAATTCACCTTCTTGTGTATCCCTTCATAATTCTGTGTAAATATTAAAGAGAGTATCCCATGATACTCTCCTACTACAATCTCCTCTCTTCCCTTTTGTCAGGATATGAGAATATAATAATACACATCATTACATGCATAATGATGCCAAATAAAGTGAGGCAAGCACAGATACATAGCCACATGTAGATCCAATAAAAGATGCTGACCCCGTGTACCTGCTCCCCAAACTAGCGTAATAGTGTTAAAGACAGAACCATTCTTTATATTGGGCTGAGCTACAAAGTCTGCCTACAGTGGATCCAAACAACTTTATAGTAACTGTGAATTCTACTTTCTATCCCTCAATGCTTTTTGCTCCTAATGACAACTTTTTTTAAATAATCTAG
>TTN-214,,0,108,3069310,3069417,GTAAAGACTGCATGGTTTGGTTAAAATTACTTGTTTTTCTGTTCATAAATAACATTTGGCTTTAAAATCATCTGAGTGATAAAGGGTTCCTTCTTTAAACCATTTTAG
>TTN-214,,0,83,3069418,3069500,GTAAGTAGGAGAACATTTTCACATACAAAGCCATTTTTACTTTTTTTTTAAATTTCTTATAATCAATATGATCTTTTTCACAG
>TTN-214,,0,93,3069501,3069593,GTAAGCCTGGAAACCATTCCTTTTTTTTAAATCTTATTTTCCAAAAGTGCCTTGGAAAAGTCAAGAATACTAACGTATACTGGCTCTTTGCAG
>TTN-214,,0,447,3069594,3070040,GTAGGAAAACTTGGCACTAAGGAAATGCACTATGAATAAACTAAAAAATGTCATAGTTATTCTCAATCCCATTAACTTCTGTCTATACTTTTTGGATTAAGAAATCAGGAAAATAGCATAATTTTAACTCACATTCCAAACATCTGTTAATGTCAGAAATCGAATCAAAAGTTAAGTCATGTTATTACTAATCTTTTGGTTATAAACCCTGGAATGTGGAATAAATAAATCAAGGTTTAATCATTTGACAATAATTTTAAAGCATAACTCCTGCCAAGTTATTCCATTCAGTGTTGCCTGTAATATCTGATCCCTAAAACCTAAACCAGCAACAATTTTCCCAGAGTAAACAGTTAAATAGGCTGCTGGTGATGCTTTAGGAAGCCATTAAAGCAAGAAGCTACAAAGAACTATTCTAATTATAAAATGTCTATGATTTCTCCCCAG
>TTN-214,,0,88,3070041,3070128,GTAATTATCAATCCTTCCTTATGCCATCAGTATTTATGTTTCAGATTGAAGGGGAAAAATCACATTTGTAATTTTCAATTGCTTCCAG
>TTN-214,,0,1728,3070129,3071856,GTAAATACTTTCAATTTGTCTGTGCAACTTTTTAAACCAACATTCTTATTATATTTACACAAAGCTATGCTGTATGCTGTGTAACAAACATTTTGGAAAATAAGAAAAATCACCCATAATCATGTTGAACATTATTAGAATTTTTAAAAATTTCCTCCTTACTTTTTTATTCTATGTGTATTCTGTATGGTGGGTGTAAGTTTACAAATTATATAATTGAGAAAACAGATGCTAACAAGAAGACATGCATCCATGTTTCCAGTGAACCTAAAGAGTGCATGTACACAATTCTCAAATTGCTAGAAGGCCATGAATATGTATTCTGAATCATGGCCCAGAATAAATATGGCTTTTTTATAGAACTTGCCCCCATAGTGTCTATTATGTTGTTATATAGTTTTCATAGAAGCAACTTTCCTTAAACTGTACATGAATGTTTAACAATCTGCAACTTTCCTTAAACTGTACATGAATGTTTAACAATTTGCCAGTGCTGACCATTTCACATCATGAGACTCTACCCCTATCGCTAAATTATCATAATAATGCAAAAACCTGTTTGAAGGGTTTCAGTATTCTAATTGAAGAGAAGCATCATAGTTGGTTATCAATATTGCATTTCTAGTCACTGAATATAGAGTTGAACTCTATGAGGCTTTTTCATGGCTCTCACTGGAGGCTTTAGTCCAGTGATTTGCTCAGAACACGAAGCCTTTCCACTCAGGGCTCTTTCTAAGCATGTCTCTAGGCACAACAATACTCCAGCCACAGTTTTTATGTGAAAATTGCCAGTTCTATGTTGAATATAATTAATATAAGAATGGCATAAGGAAAAATATTTCATTAAGCAGTAGCCCCACAAACTTTCAGGTTAGTTTCAAGCACCTAAAGCTCTTTTGCCTAATGGTTATTACTTTAATTTGAGAACTGGTACATTTCCACGTTAATTATTTGCAACCTCCTCAAAGTCATTCTGAAATTTGGGGCCTCCTATGCTGCTTGTTGATCCACTGGTCATCCAGAAATAAACCATCTCTCTCTCCGTTTCCCCTGCAGAGGAAACTGGACATAGAAACTGACTATGCCACTCTTACCCATCTCTTGTATCCCTCTGCATGCTTGCCTCCCAGCTCCCTCCTGTCCAACTCACAAATTGCTTTTAAAAAGCATTTTTATTTTCCCTTCAGCCTCTACTAAAACCATGGTAACCAATAACTGTTGCAAACCTACTTCATTAACAAATATGGGGCTTGATGCTATGGCTCACACCTGTAATCCCCTGACTTTGGGAGGCCAAGGCAGGTGGATCACTTGAGGTCAGGAGTTCGAGACCAGCCTGACCAACATGGTGAAACCCTGTCTCTACTAAAAATGCAAAAATTAGCCTGGTATGGTGGCACATGCCTGTAGTCCCAGCTACTTGGGAGGCTGAGGCAGGAGAATTGCTTGAACCTGGGAAGCGGAGGTTGCAGTGAGCTGAGATTGTGCCACTGAACTCCAGCCTGGGTGACAGAGCGAGACTCCCATCTCAAAAAAAAAAAAAAAAAAAAAAAGTGGTTGACTGTTTTTGTATTGACTAGATAGCAGAAGGAAAAACTAACTCAATTAGTAGACACAAAACCTTACTTTCTTCAAAACAACATTTTTGTCTCCTTTTAAAAAAACAAGTGTTGAGCATTATCTTTCATTGAAGGCAAACAGCTTGAATTATTTTCTTCTTATTTCCAG
>TTN-214,,0,860,3071857,3072716,GTAAGTAAAAAAAAAAAAATGTATACTTAATCACTTCTTTACTCATTTAGTACAAGACTATGGTGAAAAAATATGTGTATAAATGCCGTACATTTCATTCACTTGACAAGCAGTTATCACACAACTACTCAGTATCTGATTTGGTAGTATTTGGACAGTGATTGTGAAAGAGATTTTACAAATATGTATAATTCATTGAATTTCTTTTTGTTTTTTTTTTTCTTTTTGGTTTTGTTTTGACACATAGTCTTACTGTTACCGAGGCTGGAGTATAGTGTCATGATCTTGGCTCACTGCAACCTCCACCTCTGAGGTTCAAGTGATTCTTGTGTCTCAGTCTCCCGAGTAGCTGGGATTACAGACATGCACCACCATGCCCAGCTAATTTTTCTATTTCTAGTAGAGGCAGGGTTTTGCCATGTTGGCCAGGCTGGTCTCAAACTCCTGGCCTCAAGTGATCCACCTGCCTCGGCCTCCGAAAGTGCTGGCATTACCACTCCTAGTTCATTTATCAAATTTCTTCCATCTATACCTCACAGATTTTTTTTTAATTTCCCACTTAATGGCATTAATAGAAACTGAATTATTTTCCTACTTCTAAAACTACCAATTCTGAAGACCTTTCCTAAATTATTTTGCCTCAACAAACCTCTATTTCCTCATCTGTCAAGTGAAGAAATTCAATTGTATTGGGTCCTTTTTAACTCTAATAGTTTTATGATGAGATCTCTTTTGCTATTTATGGGAGCAGAGAGTTTAATGTTTAAATGCAATCTTCAGAAAAGGAATATTCACTACATCCTACTACATTCTTAATGTGACATTTTTTTCTACCACAATTCCTATACTTATATTCGCAG
>TTN-214,,0,101,3072717,3072817,GTATGTGTCTACTACAATTTATACTTCTGAAACTTGCACATTTGTAGATTTGTAATAAGACATCAATAAAAATGACTTGCCTTTATAATTACAAATTTTAG
>TTN-214,,0,93,3072818,3072910,GTAAGTCTTATTTAGTGGAAAGAATAGATCTTCTGTTCTTTCAAAAGCAGAAATGGCAATAACATTTTGTGCCATGATTTTTTTTTTCTGCAG
>TTN-214,,0,92,3072911,3073002,GTATGCATTATGTTTCTTTTTAGTGATTCAATGCTTGATAAAACTAATATAAAGAAATAAATTTCTAACGCATTTTCCAACATTTGTTACAG
>TTN-214,,0,89,3073003,3073091,GTATAGTATTAATGGATTTATTCAGTTTTCATGTTATCTAACTTTGTTTTCAGCTATATGCTAATTCGTTTTTTACTTTTATTTTTTAG
>TTN-214,,0,114,3073092,3073205,GTGAGTAAAATGCTCTCACTTGTGTTTGCAAGGAAAATAGATGTCTGATTGTATGTGTTTAATTGTAATCTGCATTATGGATCAAATCTGAGTGTTCTGTTCTCTTTATTCTAG
>TTN-214,,0,101,3073206,3073306,GTAAGAATTTTACTACTTAGGCCATTAAAAATAAATTTTGATAATTTTGAGCTCTTATATGGATAAAATTACTTATCAAACTGTTATTTAACACTTTTTAG
>TTN-214,,0,85,3073307,3073391,GTAAGTTGCTTTCTCTGAATACAAAACTATTGTTTGACTGTCTTTAAGAATATTACTTTTTCATCATAACTTCTTCTTTGAAAAG
>TTN-214,,0,94,3073392,3073485,GTAATTTTTGGACTAGCAGTATTACCTTATTTCTTTTTAAAATTATTCATATAGGTGAAAATCAAAATCTAATTTTTTCATGTTTACTTTTCAG
>TTN-214,,0,318,3073486,3073803,GTAGGATGTCCTTGTTTTTTCTGATATTACAGCAACTCTTAATCTCAAGCACAGAAGTATTCGATAAATAAGTTAATGTAACATCTAAATCTGTAACATCCAAACTGTATTTAGCAAATATTTTTCCAAATAGACCTTTTACCAAAATACCTAAAAGGTACAAACAATAGTAGATTCTCATTTTTATGAAGGAAAATAAAGAGGACACTAATTGAAAAATTGGATGACCTATATTTGATTAACTGAGAATAGGCTATATAAAATTACACATTGAAGTATCACTAGTAGTAGTTAACTATATGTATATTTTACTTTCAG
>TTN-214,,0,98,3073804,3073901,GTAAGTCCTTCCCTTAGCATGTGATTCATTCACACTTAATTTCTTATGATTTCCCCACATTCTGAAAAATCAATTAATGACCTTAATGTCATTTGCAG
>TTN-214,,0,98,3073902,3073999,GTGGGTTACTAAAATGCTTCTCCCTCCCACTTCAAAAATGAATTTGTTAATAGGGATGCTGAGGAGACATGTATATCTGATTTTATGATTCTTTACAG
>TTN-214,,0,310,3074000,3074309,GTAAGTATTATGCTTTCTTCCTCCTTTTAACCCCAGTCTCCTATTTTAGCAAGGTCAAGATACTAATACCATTTTAATCCACTTCTGAAAGAGATTTCATTTGTAGAGACCGAAATAGTGTAATAAATATCTATCTCACTCATGAAACACTTTTTTGATCTGTCTCATCTTATATGTTTTGCTTTTAATGTACTGAACTACAGGTTCTATGTACATTGGAGCAAATCCATACTAAAACTCTTATGTACATTAACAAAGGGGATTTGATTAGGTTACCTAGGTAATCTTCTAAATTATGTTTTTCTTCTAG
>TTN-214,,0,1157,3074310,3075466,GTAAGTAGTCTTTGCTTCATTTATGTCATGTGGTAAGTTTATTAGAATTTCTTCTTTTATATGTAGACATTTCTCCCTGAGGAATCTAGCTCTAGAAATTCTTGAAAAACAGTAGAGAACAGTGGCTTTCAAACACATGAGTGGGCCAAAAACACACAGTAAATAAACTTATACAAACACATATATAACTAAAAAACATTTCCTGAAACAATACCCATTTATTATCATGTGCATTCTTATGTTTTCTACCCTATTCTGTGTTTTTAAAAATATTGGCTGTACAACAAACATATGAAGAAAAGCTCATCACCACTGGTCACTAGAGAAATGCAAATCAAAACCACAATGAGATACCATCTCACACCAGTTAGAATGGTGATCACTAAAAAGTCAGGAAACAACAGGTGCTAGAGAGGATGTGGAGAAATAGGAAAGCTTTTACACTGTTGGTGGGAGTGTAAATTAGTTCAACCATTATGGAAGACAGTGTGGCGATTCCTCAAGGATCTAGAACCAGAAATACCATTTGACCCAGCAATCTCATTACTGGGTATATACCCAAAGGATTATAAATCATTCTACTATAAAGACACATGCACATGTATGTTTATTGTGGCACTGTTCACAATAGCAAAGACTTGGAACCAACCCAAATGCCCATCAATGACAGACTGGATAAAGAAAATGTGGCACCACATTTACACCACAGGATACTACGCAGCCATAAAAAAGGATGAGTTCATGTCCTTTGCAGGGACATGGATGAAGCTGGAAACCATCATTCTCAGCAAACACAAGAACAGAAAACCAAACACCACATGTTCTCACTCATAAGTGGGAGCTGAACAATGAAAACACATGGACACAGGGAGGGGAGCATCACACACTGGGGCCTGTCAGGGGTTGGGAGGCTAGGGGAAGGATAGCATTAGGAGAATACCTAATGTAGACGATGTGTTGATGGGTGCAGCAAATCACCATGGCACATGTATACCTATGTAACAAGCCTGCACATTCTGCATATGTATCCCAGAACTTAAAGTATATATTAAAAAAAATTGGTGGTAATACAAGCATTAATTTGCACCAGTATAGCTCTCCACCAGAAGAAACTTATCCACCTTCCCAAAATTAATATCTTTTCATTTTACTTTCAG
>TTN-214,,0,103,3075467,3075569,GTAAGTTAAGTATTAGACAAATGGCCATCTAAATATGAAGCTCAGAAATATTTTTACGTATCAAATCCTTGTTCTTACATTTCTTTCCTCTTGGTTCATGTAG
>TTN-214,,0,90,3075570,3075659,GTATGTTTTTGTGAAGGAGAAAAAAAGTTGTTTTCTTTCTAGTTTGTTACTTAATGTAGAAACTGACATCTTCCTTGTCTTCATCTCCAG
>TTN-214,,0,369,3075660,3076028,GTAAGTTTTGGGGTTTTTTTATTGTTGTTGTTGTTTTAGTATTATGGAGGCACATTTAAATCTCGGAGTCTAAGATTTGGACTCCAAGACACAGAGAGTAGTAGAGATCTGAAGATTACAACTCCCATTTAAGAATATGTTCTATCTCTTACAATGAAGATGACATATTAAAAAAAGAAAAGGACATATAATTTCCTTTAAAGCATACAGCAAGGACTCAAAAGTGCATACTAGTTGGACGGTTATTAAAATGGGATAATTGTCTTCCTGTTGAGCTTGTTACTTAGCAGCAGGGATGATAATGTGAAATATGGAAGTTTAAACTTCTGCTGGTAAGATAAATGGTGAGTGTACCTCTTTTTGTTTTAG
>TTN-214,,0,379,3076029,3076407,GTAAGATTCTGCTGAGTATTATAGGCAAAGATGTAACAGCATTCATGATGGTCATTTTTCCTAATAAAAAACTAAATATACACCTAAGGAAAAAAGGAAAATTAAAATGATGTTTTGTATATAGACACAAACATTATGATTATGGAGAATCATAATAACATGCTAAATTAAAAAGCAAGATACACAACTGTGGCAACTATATAATTTCAATAGTTATTCAATAGTGCAGTTATTATTTGTCTATTAAAAATAAACAAAATGAAATAACACTAAAATTCCATTCTTGAAAGAAGCAGCATATGAATTTCCCACTATTATTAATAAGGATTACATAATATAGCTTTGCATACATTAAGTCCTTTATCTTATTTCTTTCCAG
>TTN-214,,0,347,3076408,3076754,GTAACTAATAAACTTCATTGGAATCCCATATTTTACTTTGGATAATGGGATGTAAATAGGATTTACAGAATAATGTGGGAGAAGACATTCATATTCTAATGTGTATTTCCTATGCACAGAATTATTCTTATGACAGAACCACGTTTTAGAGTTAAAAAGAGCTTTAGAAATCACATATTTCAATTACCTAATTTTACAAGTGAAGAAACTAAGATTCTAAAAAATTAACTAACCTCCTAGGTCATATAGGAAATTGACAATAGAAAGACTGCAGCCCAGGTCTCCAGACCTCTACTCTATACTCATTCCCCATTCCACATATTCACTCTTCTTCCTTATTCCTTCAG
>TTN-214,,0,87,3076755,3076841,GTAGGAACATTTCCCGGTGGTTTTTCATTTTATTTTTTAAAATTATCTTTTAGCCTGGGAAATTAACTTTTCAATCAATTTCTGCAG
>TTN-214,,0,101,3076842,3076942,GTAAGTGTTCATGAACGAGTTCCATATCCTGTGTTAAAAGCAGCATTAAACACCCAGGAAGGAAGTTTTCATGAAAATTTCCTATCATTATTTATTCTCAG
>TTN-214,,0,889,3076943,3077831,GTAAGTATTACCAGGGGGAGTACATAAGGCTTTTCCTATTAATCATATTCTAAGAGGGAGACTAGAACTCCCTTAGGTAGATTAATTTATTAACAAGGTGTAGAGCTGGTAACTCCAAGAGTACTTTTTAGGAGAGCTGGGTGGGTACTTTACGGTATTGTGGAACAGGCAAATCAAATGCACATGATTTGTGGTTTTGAAAAGCTTTTCATATATATAAGAATTTCCTGTCTTCAAAAGACATGAAATGAGAGAATTTTATTGGAATGTAAGAATTTTATTTTAGGAATAAAGAGGCCTTTTAACTAAGTAGTGAGCTATTTACTATTCTTAGGGTTTCTGTTTTCCAATCCACCATCTCCCTAAGTATGTGACTGGTGGGCTCTCCATCTTAATTTCCCTTCTTCTTATTTCTTCTATTTGCTTATCCTCCATGATAATTTCCCCTTTATTTGAATTACTTGATATTATATGTCACCCTCCAGGTACTTTTCTTCCTACTATGAAATAATAAAGAGAGCTAGAATATGTGGCAGAATACCTTCATGGAATATAGAAAGGAAAAAACAAGAATGAAAGGGAGCCAAAAATCAATCGTCTACTTTCCTTTTAATATATGTAGCATTTCAGAGTACATAAGGCTCATGAAAGAGGAGGTACAGATCCTCCGGGGGGAAAACCTGGTTAAGCCTAAAGCATAGTGGAAAATGGAAAGATCAACAATTAGTACAGAACAGAAAAATGATTTTGAGGATTGTATTAAGGAAGTTTTAAAGAACAAGAAATCAGCTCTAGAAAATAAATGTATTTTAGGAGTGACAAGGCCAGTCCCTGGAAATACATTTGACTATTAAATTTTTATTTAACTTCTTCACCCAAAATTAAACAG
>TTN-214,,0,92,3077832,3077923,GTAAGTCTATTTCAAAAAAGAATCATATATATTTTAAAATAGCTTATGTATTTTTTACACATTCATTTCTTATTTACCTACTATTTATCCAG
>TTN-214,,0,90,3077924,3078013,GTAAGCAAATGAACCATCATCCCATCATTTTGAGTTATATCCTTCCTTTGTTATATGGGGCTTACACTTATCATTTCTCCTTTGCTTTAG
>TTN-214,,0,167,3078014,3078180,GTAAGGCTCTATGCACACATCTTCATTTTTCCTTTATTGTCATCGAAAGTGCACTCTTGTGTCCCACTCACTAGCTTATCTAAAAATCCGTTAAAAGCTAGAACTATTTGAAAAAGTTAATCGCCTGGCCTTAAAAATAACAGTAATTTATCTCTGCTATTTTACAG
>TTN-214,,0,90,3078181,3078270,GTAAGTGTCTTAAATTCAGAAGACGTAAAGCAAAACACGGTTTTGAGGAGGCTTCTTATTATAAATCTTGCATTATCTACTTTTTTCTAG
>TTN-214,,0,425,3078271,3078695,GTATTTTGTTTGTTCTTATCCTACAGCTTTTACATCAAGATTCCTCACAAATATTTCCCTGAGAACAGTTGAACATGTGCTTATCGATAACATTATCTGCTTATACAGAAATGTGTTTTTATTTCAGTACATATGGTTAATGTTTAATTTTATTGAAAATATCCTAATGTAATAGTTAATAAAGTATTTCTTAATTATAATATCTATTTTTGTAAGTTAAAATTGTTCACCAAAAAAGACAACAACTATGCATATTCCAAGAGGAAAAAAAAAATGGCACTATGCTTGGGTAATAAAAGTATAGATACTAGCAAGAATGACTACTTGTTCAATATATATGGATATGTATAAATAATTTGGGCAACACATATATATTGTAAAATCAAGCTGCATTTATACTTGATACATCCCTGGGTCTTTTGTAG
>TTN-214,,0,89,3078696,3078784,GTAAGTCATTATATGAAGAAAAACCCAGGTGCATGTTTTACATGAAGAAAACTGGTATTTGTTTGACTGGTTTTGCTTTTATGTTTTAG
>TTN-214,,0,91,3078785,3078875,GTAGGTCCATTTTACTTTTTATGTACTTTTTTTTTTAAAGCAAATTAAGCCTCCTTCCTTTTCTGATTAAAATGTATTTTTTTCTTTGCAG
>TTN-214,,0,91,3078876,3078966,GTATGTAGAGCATGTGAGGGAATTGACATGGAAACATTTATAGCAGAGTTTAGGAAATCATGGATTTCTAATAAATTTGCTTCCTTTTCAG
>TTN-214,,0,112,3078967,3079078,GTTAGTATTTGTCTTTTTCAACACCGTTCATTCCAGAGTGCCAATATTTTATCTAAATTACCCAAAAGCCAAACTCTGAATATATACTTTTGTGTCTTTGTTTCTTTCTCAG
>TTN-214,,0,673,3079079,3079751,GTATGTTTTAAGAATAAGGAAATTCTACATATCCACGTTAATTTTGCTAGAATAGTGTGAGTCATTCTAATTAGTCGTTATTTCATCTTAAATGCTTTTGGGTTCACACCCTTCACACCCCAAACTATTCATACTATGGCACAAAATGGAATCTCTAGTGAAGAGTCTTTCATTGATTAAAAAAACAGAAATTTACGTAGCTAAAATTGGATAATATATGTTGAATTTAAGTATTATTGAATCTAACTGTATATATATGTAGGTATACATGTTTATATATATATATACACAGATTATATATATATAGTATGTGTGTATGACATATATCATATGTGTGTATGTGCGTGTGTACAGAAATTGTATATAAAGTTTTTTAAAAGATTGTTCATCTTGTTCCTCTTTTTTATCCCCATGGTGAATTTGGAGTAAATTTTATCATTTAATCTGGTCATTTTACCCTTAATTTGGATTTGAATGCTATAGCATGTAATGACATAGCTTGTGGGAGCCTTGGTTGGTTCAGAAGCAAAATGGGTTATGTAAAAAGGAAGACTAAAATCAACATAAAAATATGGCCTTCATTTAAAAGTTTTCTTTTGACAATACATGAAGAGTGCACATTTAAAAGTGCTGTAATAATTATTCACTTTCTTTTGATGCTTTGTTTTCTTAG
>TTN-214,,0,105,3079752,3079856,GTATGTCTAATTTTGTGTAGAAGCAAAATTTGAAATTATTTGCATTGATTTATGTTAATTTTCAGAAACACTTTTTCACTTTCACTTTCTATACTCATTTTTCAG
>TTN-214,,0,92,3079857,3079948,GTAAGTTGTCCAACTTTTCAAAGATCCAGGTTTTCTTTTACCATAAATGTGTTATTGTCTGTACTAATCTATAGGATTTCTCTCTTTTGTAG
>TTN-214,,0,108,3079949,3080056,GTACGTATTTGTCATGGGAAGGGCAGTTCTGATAACAAAAATGCAAATCTTACTTCTGCGAAGCAAAATATTATAAGTGCCGCTAATCTGCTTCTCTTATTACCACAG
>TTN-214,,0,1695,3080057,3081751,GTAAGCATGCTTAGCACTTTGAATCAAAATTGCTATTTAACTCAGTATTTCCGCATACCTTTTCCTGGTTCTAATCCTATAGAATAACTTTTACTCTGTGCCTTAATGGGGTTTTTGGAAGAAATTATGGACTAGCTGGGAGTCTGAGGAAAATTCCTTAAATACCTTTCCAGCCCTCTTGACTTGACTGTAAAGTGAGAGATTTAGACCTCAGGATATCTATGGGCCTTTCCAACTTCAACCTTTTATGATTGATTGTATGAGTTGGTGCTTTCATTCTGTTTTAAATTATCAGAGTCAATAATTAAACCATGGTTGAGTTCCTAGAGAATATTGCTCTTAAATAAGCCACAGACTAAACAGAGACTTCATTTTTTGGTTTTTTTTTTTTTGTTTGTTTGTTTGTTTGTTTGTTTTGAGACAGAGTCTCACTCTGTCGCCCAGGCTGTAGTGCAGTGGCACGGTCTTGGTTCACTGCAACTTCCGCCTCCTGGGCTCAAACGATTCTCGTGCCTCAGTCACCTGAGTAGCTGGGATTACAGGCATGCCCCACCACACCCAGCTAATTTTTTGTATTTTTAGTAGGGACGGAGTTTCACCATGTTGGCCAGGCAGGTCTCAACCTCCTGACCTCAGGTGATCCACCCACCTCGGCCTCCCAAAGTGTTGGGATTACAGGTGTGAGCCACCATGCCTGGTCTAAACACAGACTTTGATGATGATAGTATTAGCAGCAGCTAACATTTATTGAGGAATTTTCATGAATTCTTTCCCTTAGTTCTCACAGCCCTCATATTAGCCATCTTATAGAAGGGAAACTGAGGCTGAGAGTGCTTTTGTAACTTCCCCGTTAGGGATGGAGTGGGAATTCAGACAGACAGACTTCAGAGCCCTCTCTATCATGGTTAGTCCAAAATGCGTATTCTTCACCATTCTGGAAAATAAGTGGCACATTCAACTCAACAATGTTTTGAAAATTAAAACGTCATGAGAGTCAGGTATCCTGTGACACTTTACCTAAAAGATCTCCATTTGCTAAGAGAAAATTGAGCCACTGTAGTGTCTGGGCAAAAGTATCCACTTCCATCTTCATGCTGAGAATCTCAGGGCTGTTCATTATTTATGAATCAGGCTTTGTGGATACTGAATCAGTGTTTATGAGAGTATAAAGCAAGTCGAATTTAGTTATCTTTCTTGATAATTCCAAACAGCATGGCAGAAAATCTGTCCAGTAATTATGTAGCTCTGTGGGTAGAGAATTCAGACTTTAAGTGTCTGACATGAACCATCCACACTTGGATATCAGTGAACTGGGATGGGAAAAGAAAAAGAATAGGAGGTGCGTAGAAGAAAAGGAAAGAAAAGCTAAAGTGAAAGGAAATGTTTTAACAGCTTCTTCCATGATGTTCTCACTACCATATCCCATTTCTTCACTGGAATAAAGCAACTAATGGACTTTAAAACACATGTAAAAGGTGCTTAAGTCCCTGCACAACTCACAGTCTTTCTACCCCATCTGAGATAGAAGAGTGGCCTATAAATTTTTAATTTTTAAATAATAATTGCATAGAATTATAATGATGGTGTGTGTGTATAATTTAATAATGGCCAATGACCTTACTTTAAGGTTGGTGCAACTATTTTTTTTTCCATCCTTATAATATTTTAAATATTTCTCATCTGTTTTTCTTGCAG
>TTN-214,,0,112,3081752,3081863,GTAGGTGCTGAATACAGACCACTGTCATATTACATTTGCCTAAAGCTTAGTAATTTTGAACAAGTAGGCTTTAAAGAAGTACTAACATCGTGTTTTGTCCTTTCACTGATAG
>TTN-214,,0,236,3081864,3082099,GTGAGACATGATTTCATTAGAAAACTGAAACGTGAAAAATTTAAAAATAAACTACGCTAACCTGTGCATATGCTTTAATTTTCTTTTATATAACACCTGTCTCATTACCATCCTTTTCACAAGGTGAAAAATATAAAAAATAAAACCAATGTTCTTGGAAAGAATGCGAACATCAAAGGTATAATTTATCAGTAATGTGGATTCTTGTACCTTGTTTTCCCTTCCTTTCTAAATAG
>TTN-214,,0,106,3082100,3082205,GTAAGTGCTCATACCTGCAGCATCTTCACCTGTGTCTTCTATATTCACCTGTGTGACTAAATTGTACATGATTGTGTAATTATTTTATTGTGAATGGCCATTCCAG
>TTN-214,,0,105,3082206,3082310,GTATGTACCTACTGGTTTGATTATGTTTTTTAATAAGCATACTTCCAGGAAATCACTCTTTTTTGCTTTTAAAATTCACTGTATGTATCCATTTTATGTCTACAG
>TTN-214,,0,369,3082311,3082679,GTAAGTGATTATTATTCAAATACATTTAGTTTAGCAATTGAACATATTAGAAACAAATATATCAAGGAATGCTTTTCTTCTCTGCATCACCTTCTTACATATCTTCTTGTCACTAGAGAACTGGTCATGTAAAGCAAGAGGAATTATTTTAAGTCAGTCTAATAAACTAATTTGAAGTTCATTTTAAAGACTATGAAATGGAAAGTTGAAATTAATGACCAATATGAGTTTGGGAGATTGAATAAATTACTTATTATAAAAATTTTACTTATTTATTAAAATTATAGAATAATTGTATTGTTCTTCCATGGATGATTAAGACCTGGTTACAAATGTAATGATGCATTTACCTTCCTTATAATTTTTTAG
>TTN-214,,0,693,3082680,3083372,GTAAGCATTTACAACTTATTTCCAATGAGACTAAGAGCATTCACATTTTTAAAAAACACATTTGGCCCCTGGCCTGTAAAATGGTAACAGAAACAAATTACCCAAGGTTGCTAAGTGGATGAATTATGTCTTTCTACCTTTCAGATGAAAAGAAGAAAAAAATAATTGGCATCAATTATTTTTTCTATTATTTCACTCCATTCCCATATAAAGAGCATGCAGCAAGTGGGAATGAGTTTTTAGCTTTGTAATTTTCGCCACTTAACAGTACATAAAGAAAAGGTTCTCGAGAATAAGTGTCCATCTTTACTGAAGTTATTAAAATACAACATACATCCAACAACACAATCATCCCCTTGCTTGAATGCAGCTGATGGCCTCTTAAAAGAACTTGTGTGACTGTGCAGCAGTATTAGGAAGTACATGATCTGTAAATGTTTCACTTTCCTTTTTACAAAGAGCAATGCAAAATTAAAAACATGACAGGCATTACAAAGGGAATAATAATAGGCAAATATTTAACCCCATAGTCCAAATTCTCAATTATCAATCCTACTTTCAAAATAGGCTTTGGTAGCACAGTAGAAGTCACTACTCTTCCTGGCCTTGTGATATGGCACTACTGAAAAATATATATTTATGTATGTCTTTATTAAGCCAAACTAATACATAGTATTTCTCTTTCTTTTATAG
>TTN-214,,0,116,3083373,3083488,GTACTTTTAAAATAGCTTCTTAATGCTACAATTTATGAACTTGGATTAGAGACATGCCTAGTTGTATTTTAATGGACAAGGAAAAAGAAACTAACTCTAGAAACTTTTTCTTATAG
>TTN-214,,0,96,3083489,3083584,GTAAGTTTGCGTTTTTACTAAGCGGTACTATGTCAAAAGTTTAACCTTCCAAGCAAATGCATCTAATTGATTTGGGGTTTTGTTTTTGTTTTACAG
>TTN-214,,0,101,3083585,3083685,GTAAGAAAAATAAAAATCCTATTTCAAAGTCTCTATTATTAAATGTTTCCCCTGAATTTTATAAAATTGTATTCATACTTAATACCTTTGTTTATATTTAG
>TTN-214,,0,97,3083686,3083782,GTATGTATCACAATTTAAGGGCATATTTGTTTATTATTACTGATTCTAGTAGAACTCAGAGTGGTATATTTTAACCTTATTTTTGCATCCCTTCCAG
>TTN-214,,0,97,3083783,3083879,GTAGGAAATAGTCAACATTCTCCTTTTTAAAATTATCTCAATTTATGTGAAAATAAACTCTCAGATATTCATTCATATCTGTTTTGCCTACTGACAG
>TTN-214,,0,95,3083880,3083974,GTAAGCATGTCAAATGTTCTCACATTTATATAGCATTTTCCAGTGTGGGCAGAAAGAATGATCTTCATCATGGCTTGTCATTACACCTGTTTCAG
>TTN-214,,0,126,3083975,3084100,GTAAGTATTAACACTTTTAAATAATTTGACAGTTGAAATGTAATAGAATCAGGGGGAGAAGGGAGAAGGGCAGTCTTATCAATAGTAATTTTGTGCAATTCTCATCATCCTTATTTTCATAAACAG
>TTN-214,,0,881,3084101,3084981,GTGAGCTCCAAGAATCATACATAAATACAATGCTCCTCAAAACTATATGACAGATAATTTTCCAACACACAATCTCTAAGAATTTTTAGAATTTATGAATGGTCTAGAAAAGCACATGCTTATTTGCATGATCATAAATATAGCTTAAGTCAGAGAACATTTTAACTATTACATCTGTTAAGTTAGCAATTAGAATTGCTAAAAGTTGTACAGCATTTTCCAATTAATGAAAAAATATTCTATCAATATGAAAAGAATCTATTTTATAAATTTTCCTTAGAGAAAAATGCATTGTACTGTAATAACTGAAAAGAAAAATGGCAAAACTCCTTTTAAGAAGAGGTTTAGCAGGAACATACAGTTTCTAGTGGTTTCATAAGTTACTGACAAAGTAATTGTGACAAGAGCTTCAAAAATAAGTGGCAAATCCTTTTACAGAGTCTGAGCCCAAGAACTATAAAGGAATAGTCACTGGGACTGAATTGGGGAAGCTAAGGAAACCAATTCTTGTATTCATTAGAAATGTATTGGTGGCAAGTGATACTAACCCAGTGAAAGATAAGCAACTAAAGAAAAGTCCCTAAGAATGGGTACTTTAAGTAATGAGCTTAGCTAATAGAGAACACACAGTAAAGCTGGCCAAAGAAGTAGGGAAGAAATATCTACTTTCCTAAAGCAATTTAATTCTTAAGATAATAATATTAAATTATAATGTGGCACTCTGTGCTGTCCTATAATATCAGGAGCCCAGTTAATAAAGATTATCTTGGTGAGTGTGGACAAGAGCAATAATGCCTTTGTGAGTCTTGAAAACAAAAAATACAAATCTCAACATTTCCTTATTTGCCTAATATCTGCATCTCACTTTTTAAATTCCACAG
>TTN-214,,0,85,3084982,3085066,GTATTTATCACAGAAGCTTTTAGGTGAATTATTTTCTTCTCACACCTGTCCATGAATTAATTAAATTTTGTCATTAACTTTCCAG
>TTN-214,,0,171,3085067,3085237,GTAAGCATTTTACTTAAAATTGGCTATACAATGAGTAGATCCTCTAAAACAATATAGCTTGACCTATGATTGATCACCTCTCTAGAAAGGAACTATGTTGATTATATTTCCCCAAGAAAAAAAAAGCTATCAGGCAAATAGGAAATATGAATCTTTCATTCTGTTTTTCAG
>TTN-214,,0,119,3085238,3085356,GTATGTACCAAATAGCCAAAAAAAAAAAAAAAGTAAAGTAAAATGAAAACATTCAGAATTCGTAACAATTTACCATAAAAATAATGCTTAAGAATAAATGCCTGATTTCTTTCCCATAG
>TTN-214,,0,98,3085357,3085454,GTAAGGATGTGTGACAAAGATACAAGCAAGTTGATGTTCAGTCACCCAATTTTGATTTGAAGTAAAAATTAATTTCCTGTATTTCTTCTCTTTCATAG
>TTN-214,,0,679,3085455,3086133,GTAAGTCCACAGGCCCTTCCACCACTCTCCCCACCTCTGATTCTGAATGTTAACAAAAAAGAATTTGTTTTTAATATGCCCTAATGTAAATAAAAATAGGTCACAAAATTAACCCTGTGGTCTTTCTAAGGTTTCTAAACCTCCTTTTCTCAGGTTTCTAAACCTCCTTTTCTCAGAGGTTTTCAACACACTTAGGCTTGATTTTTTTTTTAATATCTTCACTCTTATGAAAGAGAAGAGGAGGGAGTTAGGAAGAAAGGAATGGAAGGAAGAAAAGAGAGAAGGGAAGGAGGAAGAGAGGAAAGGAAGGAGGACTGGCAATGTTATAGTGAGAAAAAAATACAGAGTGCATGCTTAATAAATGTAGAATTGAAGAAAATGAGGAACAGCAAGGAAAGTACAAAATTAAACCTCAGCATCATGCAATATACCCATGTAACAAACTGCACATGTACCCCTGAAGCTAAAAGTCAAAAATTTTTAATAAAAATAATTAAATAATTAAATGATTTAAATTAAAATTTACAAATAGTACAAAAGTGAAACTATTGGAAAAATAGTCATGTGCCTTATGTACCTTTTAAAATACCAACCAAAACCTAAGGAAAACACAAATATATGAGTCATTGTTTTAACGTATTCATATTGCCATATCGTGTTAACCTCTGTCTTGCTGCAG
>TTN-214,,0,911,3086134,3087044,GTAAGGACATTTTGTATCAGTCAAATTGATTGAGTTACAATTTATATGTGGGAAAATTCACCTTTTTGAAATATATAGTTCTATGACTTTTGAAAAATGTACTGTTTTGTAATCACCACCACAATCAAAATGTGGAATATTTTTATTACCCCGTAAAGTTCCCTTGTGTCCGTTTGTAATCAGTCCCTTCCCCACCCCAGCTGCTAGCGATTTCTGGCAAATAATTTTTAATATTCTTCTCTGGAGTCAATTTCCACTTCTTTAAGATGAGATTCATAATATATGCTTTCTATCACACTTAAAATTTTAAAACAAGTTAATATTTCTGGAAGCACTTTAAAAACTGCTGATAAATGTAAGATAATAATAGTGATTACAAATGAAGCACATTTAAGAGAAAGGAAAGTGAAAAAATGTTAAGTATTTTTAGCTGATAAAATGAATAAAATTTTCTTTTTTCTTTCTTTTGTTTTTTTGTGTTTTTTTGAGACAGAGTCTCACTCTGTCACCCAGGCTGGAGTGCAGTGGCATGATCTTGGCTCACTGCAACCTCTGTCTCCCAGGTTCAAGCAATTCTTCTGCCTCAGCCTCCTGAGTAGCTGGGATTACAGGTGCCTGCCACCACGCATGGCTAATTTTTATGTTTTTAGTAGAGACGCGGTTTCACCATGTTGGCCAGGCTGGTCTTGAACTAACTCCTGACCTCAAGTATCTGCCCACCTTGGCCTCCCAACTTGCTGTGATTACAGGCATGAGCCACCACACCCAGCCATGAATAAAATTTTCACAAGACAAAAAAACAGGCTAATGTTAACAGTCCGTTTCAACAACTCATTGAATTTGTTAGGTGGCACAGCTAATTTTCAACTTTGCAGCAACTTTAACCAGTATATTCTTATTCTTATTCTCAG
>TTN-214,,0,101,3087045,3087145,GTGAGACATATGATCATTTGCTTTCTGCAATAATTGCCATAGACTTATTTCTTAGTCCCCCTACCCCAAATGCTAAATTGAAACCCTACCTTTTTTTCCAG
>TTN-214,,0,130,3087146,3087275,GTAAGTGCCCTTTCAACCACAAAATTATAAACATTATTTCAGCACTTTTCTGTTTTTAAATGAAAGTCATTGGCTTATAATACTTGGGACTGTATTCTAATACATGTGTGCTTTCCACTTATATTTACAG
>TTN-214,,0,106,3087276,3087381,GTAAGGAATTCAGAAGAAGGGGTTAAATTAAAGAAGCAAGCCATGTTTGGTCCTTTTATTTCACCAGTAAAGCTGACTCCCTTTTCATTATTTTAAAATATTTCAG
>TTN-214,,0,622,3087382,3088003,GTAAGTAGCCTTTGGTTCTCTACTTATGATTTACAAACTAAACAAGTTAAGGCTAATTCCCCCTCTATACTAAGTAGAACCCTGGAAAGCTTTATTGGAGAGCAAGTGTTAAGAAAGAAAAGCAAGTACACACACAGGAAATATGACAAGTTCTACAGGAAACCATTCCAAGCACACAACCTCAGCAGATGTTAGATGGAGTGAACTGAGCACTTTCCTTGAGTAATTCCCTCTAATGCAATGGTTTCTTTTTAAAAATATTTCCCAACAAGATTTGAAAGGTCAACAATTGTATGCCACTTCAATGAACCTAAGTAAGGGCAAGAATACTACAGAATTATAGAGAGAATTTACAGTCCCTTAAAAGCCTATACATTATTAATCCCCTTCCAATCATAAAGAGAAAAAAACACTCTACATAAAATGTGACGATGTGCTCATTGAATCCCTATTTACCATATGATCCTAGGAAAATCACTTCAAAGAGTTTTTAAGAATTAGGCTAATATGTAAATCATGGTATGTGTCAGTAAATAAGGTAAATTCATTCCTGATATACAAGGACAAAGGATTACAGATTGAGTATTAACAGTCACTTAATATTATCTTTCATATTGTTCAG
>TTN-214,,0,98,3088004,3088101,GTATTTTATTTTTATTTTCAGTGCTTTTTATTTTTAAAGAAAAAAAAATCTCAAAAACACACTATGAAAACCACCACAATTGTATTTTCCCCCAACAG
>TTN-214,,0,362,3088102,3088463,GTGAGTACAACTTGATTTCTGTATCTTCCTATGGTAAAGTTCCATCTTTGCATAAAATTCTTTTAAACAGAAAGAAATTTTGAAAGGAAATAGCAAAGATTCAGATAAAGTACAAGTGCCTTTTCTTTCACTTTAATTGAATGTTTGCATATCTAAAAGGAGAAATATATATCCTAACCCCATTGTAAAAATAGAACTTTGGTTTTTGATATGTCTTAGTATAAAGTAACCAATTTCATCTTTCTGGAATAGCTATTTTTTAACAAAATTTTGGACTCATATAACATTCTTTTTTAAAAAAATAAGCTTTAATAAAGCTGCCTGTTTCATCTCATGACTCAAATCTTTTTTTTGTTTAATAG
>TTN-214,,0,132,3088464,3088595,GTAAAAATAAATAAATTATCATCAAGTTGAGGCTAAATGAGTTATTAACTTGGGGGTGGAGGCTATTGCACTTAAACACATACTGTTAGATGTTGCTAAATTATATTCTTTTTTTTTTTTTTTCTGATACAG
>TTN-214,,0,124,3088596,3088719,GTAACCAGTTCTTAAATGTCTCTTTCTTTTATCTTCTAAAATATTTTATCTTCTAAATTCAGCTTCCCAAAAAAAGCTTAAAATGAAATCACTTTTTAAAACACAAATCATTTGCATTCTACAG
>TTN-214,,0,740,3088720,3089459,GTAGGTTGGCTTTTGTTTTTACCCACATTTCTTCAGAAGATAATATTAGGGAAATATTTTCAAACATCCCCCCTTATATACACATACAAGAAAGTATTAAAATAAAATTATTTTCCTAATTCCAGAATACAATTTGTACACCAAAGCAGAAACACACATTTGAAGTTAGCATATGCTTTTCTATGAGCATAAAAAGCAGTTATTAAGTACCTAGTTATATGTGGTATTATATAAGATTCCATAGTGTCAGCCCCTGCTCCCAGGAATATTTAAGAATAAAGTCAGTGAATATACAAAATGGCACTACTTGCCTAAACCTTCACAGTTGCTAATTTTCCAAAGCAGTGCAAAGTTAATTAAAGAACTATTTCTATTTTACCAATTAAAATTAGTTTGCTTTCATTTCAATCTTCTGAAAGATAATTTAATGTTTTGGTTACTCAAAATCTCCCAAATCCACTTATCTCCTAAATCCGTTGACTATTCTTTTCAAGACTTTTTTCCTTAAGTCATATGAATCATCTTTGGCTCAGTTTAGTTTAAGGAATCATTACAGTGATCTCAAAAGTCACACATGATAATTTTCCAAAAGTGGAACTGAGAAAGTATTAGGTATTACCTACATTGCATGAAGAAGTTGACTTTTTTTCTTTTTATGTTTTTCACACGCAGAATCTAGAAGAGTAAAAGGTGGGGGTCTCTTTCTAATTAAGTTTGCCTTACAGAGGTTTCTTTTTTAG
>TTN-214,,0,100,3089460,3089559,GTAAGTTTAATTATGAATATATTATTGAAGAAAAACTAAAATACCATGTCTTCCACATCTGAAGAACTTCAACATTTCTTTTCTTTTTCCTTTGTCTTAG
>TTN-214,,0,525,3089560,3090084,GTAAGTATCTCCTCACCCTTCTTCCTTACATGTTTAAGGCCTTTAGATCGTTTTTTTGCCTCTCTTTCAAGCACAGAAAACTCTAAGAAGCCTTATTAAATTCCATGTGAAAGAGGGACAGCCAACTGATGTGAATTCATTCTTGTAGTCAAACTTTCTTTATAGCTACACAGAAACTTGGATAGATTACATTTCAAAGTAAAGCTACCAACTGCCGTGTAACATTTATTTGCAGGATGCACAATATGTCAATTACTTTCTATATGACTAATCATTTTTCTCCTAGTGATTCCTAGCACCTGCATGTAATGTAATGATAGAAATATAAGGATTCATGTTTTGGAGACATTGAGCTAGCTCTTGACAAATGTATGTATATATGTATTTGCTTATGCTTCAACAGCAAATTGTTTGGGTTATGCTGCTGTGTGTGTGTTGAAGTTTCCATTTCTGTAAGTCAGCGTCATATGTCATCAATTAACCAGATGTCATTGATGTTCACTGTGTATCTGCTATGCTCCACAG
>TTN-214,,0,138,3090085,3090222,GTGAGCAATAAAATTACTGGTAGAGGTAGACAAGCCAAGTAACATGGTGTAGTCTTTAGTACACACAATTCAGTAGAAAGCAAATCTTTATTTTTTTCAGTGATTCTAAGACCTTTTTTTTGTCATTGTTCCATAAAG
>TTN-205,ENSE00001626989,1,138,3090223,3090360,GTTCCAGTTCTGCTGAGACACAACTTCCCCTGGGAAGCCTCCTGACCCATCAAGTCCAGAGTAGATGGTCCTGCCATGTGCACTGTCAGCACCTGCACTGCCCAGCCACGCCCCTGAATATACACAAAGGAATCGCAG
>TTN-205,ENSE00001699844,1,183,3090361,3090543,ATCAAGAGAGAAAAAATAGAAGGAAATTGTAATTACAGGATTGCTGAGCTGGGCTTTCTCCAATAATAACATGATCAAAATAAAATAAAAGAAGTCCTTTTGGCCTCTGACATCACATCCTGGAGTGGATGATTTACCAGTTGGTCATCTGCTGTGCTGCAGGAATGAATGTAGCTACTGTGG
>TTN-205,ENSE00001642796,1,155,3090544,3090698,TATGAAGCAAAATTCTAACGTTCCTAGAAAGTGTTAGACCTGTCAACCTCCAGGAAGGATGAGATCTGCTTCCACACTGCACAGTGTCCAGAAGATCAGGACCATGTGTCACTTGGTTCAAAGATGACTTCTAAGTGGTACCTGGAGATACTGAA
>TTN-205,ENSE00003502146,1,104,3090699,3090802,AGTGCCTAGAAAGATGACAACTCAAGCACCGACGTTTACGCAGCCGTTACAAAGCGTTGTGGTACTGGAGGGTAGTACCGCAACCTTTGAGGCTCACATTAGTG
>TTN-205,ENSE00003807606,1,204,3090803,3091006,GTTTTCCAGTTCCTGAGGTGAGCTGGTTTAGGGATGGCCAGGTGATTTCCACTTCCACTCTGCCCGGCGTGCAGATCTCCTTTAGCGATGGCCGCGCTAAACTGACGATCCCCGCCGTGACTAAAGCCAACAGTGGACGATATTCCCTGAAAGCCACCAATGGATCTGGACAAGCGACTAGTACTGCTGAGCTTCTCGTGAAAG
>TTN-205,ENSE00003810976,1,288,3091007,3091294,CTGAGACAGCACCACCCAACTTCGTTCAACGACTGCAGAGCATGACCGTGAGACAAGGAAGCCAAGTGAGACTCCAAGTGAGAGTGACTGGAATCCCTACACCTGTGGTGAAGTTCTACCGGGATGGAGCCGAAATCCAGAGCTCCCTTGATTTCCAAATTTCACAAGAAGGCGACCTCTACAGCTTACTGATTGCAGAAGCATACCCTGAGGACTCAGGGACCTATTCAGTAAATGCCACCAATAGCGTTGGAAGAGCTACTTCGACTGCTGAATTACTGGTTCAAG
>TTN-205,ENSE00003809662,1,86,3091295,3091380,GTGAAGAAGAAGTACCTGCTAAAAAGACAAAGACAATTGTTTCGACTGCTCAGATCTCAGAATCAAGACAAACCCGAATTGAAAAG
>TTN-205,ENSE00003809782,1,245,3091381,3091625,AAGATTGAAGCCCACTTTGATGCCAGATCAATTGCAACAGTTGAGATGGTCATAGATGGTGCCGCTGGGCAACAGCTGCCACATAAAACACCTCCCAGGATTCCTCCGAAGCCAAAGTCAAGATCCCCAACACCACCGTCTATTGCTGCCAAAGCACAGCTGGCTCGGCAGCAGTCCCCATCGCCCATAAGACACTCCCCTTCCCCGGTCAGACACGTGCGGGCACCGACCCCATCTCCGGTCAG
>TTN-205,ENSE00003805863,1,331,3091626,3091956,GTCCGTGTCTCCAGCAGCAAGAATCTCCACATCCCCCATCAGGTCTGTTAGGTCTCCATTGCTCATGCGTAAGACTCAGGCATCCACCGTGGCCACAGGTCCTGAAGTGCCTCCCCCTTGGAAGCAAGAGGGCTACGTGGCCTCCTCATCTGAGGCTGAGATGAGAGAGACAACGCTGACAACCTCTACTCAGATCAGGACAGAAGAGAGATGGGAAGGGAGATACGGTGTCCAGGAGCAAGTGACCATCAGTGGTGCTGCGGGTGCTGCCGCCAGTGTGTCGGCCAGTGCTAGCTACGCAGCAGAGGCTGTTGCCACTGGTGCTAAAGAG
>TTN-205,ENSE00003803639,1,153,3091957,3092109,GTGAAACAAGATGCTGACAAAAGTGCAGCTGTTGCGACTGTTGTTGCTGCCGTTGATATGGCCAGAGTGAGAGAACCAGTGATCAGCGCTGTAGAGCAGACTGCTCAGAGGACAACCACGACTGCTGTGCACATCCAACCTGCTCAAGAACAG
>TTN-205,ENSE00003810843,1,138,3092110,3092247,GTAAGAAAGGAAGCGGAGAAGACTGCTGTAACTAAGGTAGTAGTGGCCGCCGATAAAGCCAAGGAACAAGAATTAAAATCAAGAACCAAAGAAGTAATTACCACAAAGCAAGAGCAGATGCACGTAACTCATGAGCAG
>TTN-205,ENSE00003803899,1,126,3092248,3092373,ATAAGAAAAGAAACTGAAAAAACATTTGTACCAAAGGTAGTAATTTCCGCAGCTAAAGCCAAAGAACAAGAAACTAGAATTTCTGAAGAAATTACTAAGAAACAGAAACAAGTAACTCAAGAAGCA
>TTN-205,ENSE00003808716,1,138,3092374,3092511,ATAAGACAGGAAACTGAGATAACTGCTGCATCCATGGTGGTAGTTGCCACTGCAAAGTCCACAAAACTAGAAACAGTCCCGGGAGCTCAAGAAGAAACTACCACACAACAAGATCAAATGCACCTAAGTTATGAAAAG
>TTN-205,ENSE00003809802,1,138,3092512,3092649,ATAATGAAGGAAACTAGGAAAACAGTTGTACCTAAAGTCATAGTTGCCACACCCAAAGTCAAAGAACAAGATTTAGTATCAAGAGGTAGAGAAGGCATTACTACCAAAAGAGAACAAGTGCAAATAACTCAGGAGAAG
>TTN-205,ENSE00003805623,1,138,3092650,3092787,ATGAGAAAGGAAGCCGAGAAAACTGCCTTGTCTACAATAGCAGTTGCTACTGCTAAAGCCAAAGAACAAGAAACAATACTGAGAACTAGAGAAACTATGGCTACTAGACAAGAACAAATCCAAGTTACCCATGGAAAG
>TTN-205,ENSE00003801659,1,294,3092788,3093081,GTGGACGTTGGAAAAAAGGCTGAAGCTGTAGCAACAGTTGTTGCTGCAGTAGACCAGGCCCGAGTCAGAGAGCCCAGAGAGCCTGGGCATCTTGAAGAATCCTATGCTCAGCAGACCACTTTGGAGTACGGATATAAGGAACGCATTTCCGCCGCAAAGGTAGCTGAGCCTCCCCAACGTCCAGCCTCAGAACCCCACGTTGTCCCTAAAGCAGTCAAGCCTAGAGTAATCCAGGCTCCTTCTGAGACTCATATCAAAACTACTGATCAAAAGGGAATGCACATATCATCACAG
>TTN-205,ENSE00003804455,1,123,3093082,3093204,ATCAAGAAAACTACAGATCTAACAACGGAAAGATTAGTCCATGTGGATAAACGCCCCCGCACAGCTAGCCCTCACTTTACTGTTTCAAAAATTTCTGTTCCTAAGACAGAACATGGATATGAG
>TTN-205,ENSE00003810306,1,282,3093205,3093486,GCATCAATAGCCGGTAGTGCTATTGCCACATTACAAAAAGAGTTGTCAGCCACATCTTCTGCTCAGAAGATCACCAAATCGGTGAAGGCTCCTACTGTGAAGCCCAGTGAGACTAGAGTAAGGGCAGAGCCCACACCCTTGCCACAGTTCCCCTTCGCTGACACACCAGATACTTACAAGAGTGAAGCTGGCGTTGAGGTGAAAAAGGAAGTAGGGGTGAGCATCACTGGCACCACCGTCCGTGAAGAGCGCTTTGAAGTACTGCACGGACGCGAAGCCAAG
>TTN-205,ENSE00003805296,1,66,3093487,3093552,GTAACAGAAACAGCAAGAGTACCAGCACCTGTTGAAATTCCTGTTACTCCACCAACTTTGGTCTCG
>TTN-205,ENSE00003806123,1,259,3093553,3093811,GGCTTAAAAAATGTGACTGTCATAGAAGGTGAATCTGTCACCTTGGAGTGCCACATCTCTGGATACCCATCCCCGACAGTGACATGGTACAGGGAAGACTACCAAATCGAAAGTTCCATTGACTTCCAGATAACCTTCCAGAGTGGAATTGCTCGTCTTATGATTCGCGAAGCATTTGCGGAAGACAGCGGGCGATTTACTTGCAGTGCTGTAAATGAGGCTGGAACCGTCAGCACATCCTGCTATCTGGCTGTGCAGG
>TTN-205,ENSE00003808554,1,64,3093812,3093875,TGTCAGAAGAATTTGAAAAGGAAACCACAGCCGTGACTGAGAAATTTACTACAGAAGAGAAACG
>TTN-205,ENSE00003804962,1,216,3093876,3094091,CTTTGTTGAGTCAAGAGATGTGGTTATGACTGATACTAGCCTCACAGAGGAACAAGCAGGGCCTGGAGAACCTGCCGCGCCTTACTTTATTACAAAACCAGTGGTCCAGAAACTGGTGGAAGGTGGGAGCGTGGTGTTTGGATGCCAAGTTGGCGGCAACCCAAAGCCCCATGTATACTGGAAAAAATCTGGTGTTCCTCTAACCACTGGATACAG
>TTN-205,ENSE00003804165,1,143,3094092,3094234,ATACAAAGTGAGTTACAACAAACAAACCGGTGAATGCAAGCTGGTGATTTCTATGACTTTTGCTGATGATGCTGGAGAATACACTATTGTTGTTCGCAATAAGCATGGAGAAACTTCTGCATCTGCTTCCTTGCTTGAAGAAG
>TTN-205,ENSE00003802603,1,206,3094235,3094440,CTGATTATGAGTTACTGATGAAGTCCCAGCAAGAAATGCTTTATCAGACACAAGTGACTGCATTTGTTCAAGAACCTAAAGTTGGAGAAACAGCACCTGGATTTGTATACTCTGAGTATGAAAAAGAGTATGAAAAAGAACAAGCCTTAATTAGGAAGAAAATGGCCAAAGATACTGTAGTGGTCAGAACTTATGTAGAAGATCAG
>TTN-205,ENSE00003807963,1,234,3094441,3094674,GAATTCCATATTTCTTCCTTTGAAGAGAGACTTATTAAAGAAATTGAATATAGAATAATAAAGACTACATTAGAAGAACTTCTTGAAGAAGATGGAGAAGAAAAGATGGCAGTTGACATTTCTGAATCTGAAGCTGTTGAATCAGGATTTGATTCAAGAATCAAGAATTATAGAATTCTTGAGGGGATGGGTGTCACTTTTCATTGCAAGATGTCTGGATATCCATTACCAAAG
>TTN-205,ENSE00003808968,1,245,3094675,3094919,ATTGCTTGGTACAAAGATGGCAAGCGCATCAAACATGGAGAAAGATACCAAATGGACTTTCTACAAGATGGCAGAGCTAGTCTGCGTATACCTGTTGTTCTTCCAGAAGATGAAGGAATCTACACTGCATTTGCCAGCAATATTAAAGGAAATGCAATTTGCTCAGGGAAATTGTATGTGGAGCCTGCTGCACCACTTGGAGCTCCGACTTACATTCCCACACTAGAGCCAGTGAGCAGAATCAG
>TTN-205,ENSE00003802614,1,272,3094920,3095191,ATCTCTCTCTCCACGTTCAGTGAGCAGGTCTCCTATACGCATGTCTCCTGCACGGATGTCACCTGCAAGGATGTCTCCTGCACGGATGTCCCCTGCAAGAATGTCCCCTGGACGTAGGCTGGAGGAGACAGATGAGTCACAACTTGAGAGACTATATAAACCAGTCTTTGTGTTAAAACCTGTTTCTTTCAAATGTTTAGAAGGGCAAACTGCCAGATTTGACTTAAAGGTTGTTGGTAGACCTATGCCAGAGACGTTCTGGTTTCATGATG
>TTN-205,ENSE00003811446,1,165,3095192,3095356,GCCAGCAAATTGTCAATGACTATACCCATAAAGTAGTCATTAAAGAAGATGGTACTCAATCACTAATTATTGTCCCTGCCACACCCAGTGATTCTGGGGAATGGACTGTGGTTGCCCAAAACAGGGCAGGCAGATCTTCAATTTCAGTGATTTTAACTGTGGAAG
>TTN-205,ENSE00003805710,1,169,3095357,3095525,CTGTGGAACATCAGGTAAAACCGATGTTTGTAGAAAAACTGAAAAATGTCAATATAAAGGAAGGTTCCCGACTTGAAATGAAAGTCAGAGCTACGGGTAACCCCAACCCTGACATTGTATGGTTGAAAAACAGTGACATCATTGTGCCTCATAAATATCCCAAAATCAG
>TTN-205,ENSE00003809358,1,1694,3095526,3097219,AATTGAAGGAACCAAGGGAGAAGCTGCCCTTAAAATCGATTCCACTGTCAGCCAAGATTCTGCCTGGTATACTGCGACTGCTATTAATAAAGCTGGCAGAGACACTACAAGATGCAAAGTAAATGTTGAAGTTGAGTTTGCAGAGCCTGAGCCAGAGAGAAAGTTAATCATCCCACGGGGGACATATAGAGCAAAGGAGATTGCAGCCCCAGAACTGGAGCCCCTCCATTTGCGATATGGCCAAGAGCAATGGGAAGAAGGTGATCTCTATGACAAAGAGAAACAACAGAAACCATTTTTCAAGAAAAAACTCACTTCCTTAAGACTTAAGCGCTTTGGGCCTGCCCACTTTGAATGCAGGCTAACACCCATTGGTGACCCAACGATGGTGGTGGAGTGGCTCCATGATGGAAAGCCACTTGAAGCAGCCAACAGGCTCCGTATGATCAATGAATTTGGGTACTGCAGCCTTGATTATGGCGTTGCATATTCTAGAGACAGTGGTATCATTACTTGCAGAGCCACTAACAAATATGGAACAGATCACACATCTGCTACCCTTATTGTTAAAGATGAGAAAAGTCTTGTGGAAGAATCCCAATTGCCTGAGGGGAGGAAAGGCTTACAGAGAATTGAAGAATTAGAGAGAATGGCTCATGAAGGTGCACTTACAGGTGTAACAACAGATCAGAAAGAAAAGCAAAAGCCAGACATTGTCTTGTACCCAGAGCCAGTTAGAGTACTTGAAGGGGAGACTGCAAGGTTCCGCTGCAGGGTAACAGGCTACCCTCAGCCCAAAGTCAACTGGTACCTCAATGGACAGCTCATCCGCAAAAGCAAAAGGTTCAGAGTTCGCTATGATGGTATCCATTACCTGGACATCGTGGACTGCAAATCATATGACACAGGTGAAGTGAAGGTCACCGCGGAAAATCCTGAAGGTGTGATAGAGCATAAAGTGAAGCTTGAGATTCAACAGAGGGAAGATTTTAGGTCTGTCCTTAGGAGAGCTCCTGAACCAAGGCCTGAGTTTCACGTACATGAACCAGGAAAGCTTCAGTTTGAAGTACAAAAAGTGGATAGACCTGTTGACACCACTGAAACCAAAGAAGTTGTGAAGTTGAAAAGGGCTGAAAGAATTACCCATGAAAAAGTGCCTGAAGAGTCGGAAGAGCTGCGCAGTAAATTCAAGCGCAGAACAGAAGAGGGCTATTATGAAGCCATTACCGCTGTGGAGCTCAAGTCTCGAAAGAAGGATGAATCCTATGAGGAACTCCTCAGGAAGACAAAAGATGAACTTCTCCACTGGACCAAAGAGTTAACTGAAGAGGAAAAGAAAGCTCTTGCCGAAGAAGGCAAAATCACGATTCCAACTTTTAAACCTGACAAGATTGAACTAAGTCCTAGTATGGAGGCTCCAAAAATCTTCGAAAGAATCCAGAGCCAAACAGTGGGCCAAGGATCTGATGCACACTTCCGGGTCAGAGTCGTGGGGAAACCAGACCCCGAATGTGAATGGTACAAAAATGGTGTCAAAATTGAACGGTCTGACCGGATCTACTGGTACTGGCCCGAAGACAATGTTTGTGAATTGGTCATAAGAGATGTGACTGCTGAGGACTCTGCCAGCATCATGGTAAAAGCCATCAACATAGCTGGAGAAACCTCCAGTCACGCATTCTTACTTGTCCAAG
>TTN-205,ENSE00003809440,1,282,3097220,3097501,CCAAGCAATTGATCACTTTCACACAGGAATTACAAGATGTTGTTGCTAAGGAAAAAGACACTATGGCAACCTTTGAATGTGAAACTTCAGAACCATTTGTCAAAGTGAAATGGTATAAAGATGGTATGGAGGTTCATGAGGGAGATAAATACAGGATGCACTCTGACAGAAAGGTTCACTTCCTCTCCATACTGACCATTGATACGTCTGATGCTGAAGATTACAGCTGTGTACTTGTGGAAGATGAAAATGTCAAAACGACTGCTAAACTTATTGTTGAAG
>TTN-205,ENSE00003802960,1,267,3097502,3097768,GTGCAGTTGTTGAGTTTGTGAAAGAACTTCAGGACATAGAAGTTCCAGAATCATATTCAGGAGAATTAGAGTGCATTGTATCCCCAGAAAATATAGAAGGAAAATGGTATCATAATGATGTGGAGCTTAAATCCAATGGCAAATATACAATTACATCTCGTCGTGGACGTCAGAACCTCACGGTCAAGGATGTAACCAAGGAGGACCAGGGAGAATACAGCTTTGTCATCGACGGGAAAAAGACAACCTGTAAATTAAAGATGAAAC
>TTN-205,ENSE00003804241,1,273,3097769,3098041,CCCGCCCCATTGCTATCCTACAAGGACTTAGTGACCAAAAAGTCTGTGAGGGTGACATTGTTCAGCTTGAAGTTAAAGTCTCCTTGGAAAGTGTGGAAGGCGTCTGGATGAAAGACGGCCAAGAAGTGCAGCCCAGTGACAGGGTTCACATTGTGATAGACAAACAATCTCATATGCTGCTCATTGAAGACATGACTAAGGAAGATGCTGGAAATTACTCTTTCACCATTCCAGCCCTTGGCCTCTCCACCAGTGGGCGTGTCTCTGTCTATA
>TTN-205,ENSE00003806988,1,264,3098042,3098305,GTGTGGACGTGATAACACCTCTAAAAGATGTTAATGTGATTGAAGGCACCAAGGCTGTGCTTGAATGTAAGGTGTCAGTCCCTGATGTGACTTCTGTTAAGTGGTACTTAAATGATGAACAAATCAAGCCTGATGACCGTGTACAGGCCATTGTGAAAGGTACTAAACAGCGACTAGTCATTAACCGAACTCATGCTTCAGACGAAGGACCTTACAAGCTGATAGTTGGCAGAGTTGAAACCAACTGTAATCTCTCTGTAGAAA
>TTN-205,ENSE00003804968,1,261,3098306,3098566,AAATTAAAATTATCAGAGGTCTTCGTGACCTTACCTGTACAGAAACTCAAAATGTGGTGTTTGAGGTTGAGCTGTCCCACTCTGGAATTGATGTCCTGTGGAATTTTAAGGACAAGGAAATCAAGCCCAGTTCTAAATATAAAATTGAAGCACATGGAAAAATATATAAATTGACAGTTCTAAATATGATGAAAGATGATGAAGGAAAATACACATTTTACGCGGGAGAAAATATGACATCTGGAAAACTTACTGTGGCAG
>TTN-205,ENSE00003809850,1,261,3098567,3098827,GTGGGGCCATCTCCAAGCCACTCACAGATCAGACCGTAGCTGAATCCCAGGAAGCTGTGTTTGAATGTGAAGTTGCCAACCCAGATTCCAAAGGCGAATGGTTGAGGGATGGCAAACACCTACCACTGACTAACAACATCAGAAGTGAGTCTGATGGCCACAAAAGGAGACTTATCATTGCTGCCACCAAATTAGATGACATTGGAGAATATACCTACAAGGTGGCCACCTCCAAAACATCTGCCAAACTCAAAGTTGAAG
>TTN-205,ENSE00003806479,1,264,3098828,3099091,CTGTCAAAATTAAGAAGACTCTGAAGAACCTCACAGTGACAGAAACACAGGATGCTGTTTTCACTGTCGAGCTTACACACCCTAATGTCAAAGGTGTCCAGTGGATCAAAAATGGAGTTGTGCTGGAATCCAATGAAAAGTATGCTATCTCTGTCAAAGGAACAATTTACTCTCTGAGGATTAAAAACTGTGCCATCGTGGATGAGTCTGTTTATGGCTTCAGGCTTGGAAGGCTTGGAGCCAGTGCCAGACTGCACGTGGAGA
>TTN-205,ENSE00003804523,1,261,3099092,3099352,CTGTCAAGATCATTAAAAAGCCAAAGGATGTGACAGCCTTGGAAAATGCCACTGTTGCCTTTGAAGTTAGTGTTTCCCATGACACTGTTCCAGTAAAATGGTTCCATAAGAGTGTGGAAATTAAGCCAAGTGACAAACACAGACTGGTCTCAGAAAGGAAAGTCCACAAGCTGATGCTGCAGAACATCTCCCCCTCAGATGCTGGGGAATACACAGCTGTGGTCGGGCAATTGGAATGCAAAGCAAAACTGTTTGTGGAGA
>TTN-205,ENSE00003807378,1,261,3099353,3099613,CATTACATATTACAAAAACCATGAAAAATATCGAGGTGCCTGAGACCAAAACTGCCTCTTTTGAGTGTGAGGTGTCCCACTTCAATGTCCCTTCCATGTGGCTGAAGAATGGTGTGGAAATTGAGATGAGTGAAAAGTTCAAGATAGTTGTGCAGGGAAAACTCCATCAGCTGATCATCATGAACACCAGCACAGAGGACTCGGCAGAATACACATTTGTCTGTGGCAATGACCAAGTCAGTGCCACCCTGACAGTCACCC
>TTN-205,ENSE00003807271,1,261,3099614,3099874,CAATCATGATTACTTCCATGCTGAAAGACATCAACGCTGAAGAAAAAGACACTATTACTTTTGAGGTGACAGTGAACTATGAAGGCATCTCTTACAAATGGTTAAAGAATGGTGTGGAAATCAAATCAACTGACAAGTGCCAGATGAGAACCAAAAAGCTCACACACTCACTGAACATCAGGAATGTTCACTTTGGGGATGCTGCTGACTACACCTTTGTGGCTGGAAAAGCAACATCAACAGCCACACTTTATGTGGAAG
>TTN-205,ENSE00003808172,1,142,3099875,3100016,CTCGTCATATAGAATTTAGGAAACACATTAAGGACATTAAGGTACTGGAGAAGAAGCGAGCCATGTTTGAATGTGAAGTTTCTGAACCTGACATCACTGTACAGTGGATGAAAGATGACCAGGAACTGCAGATCACAGACAG
>TTN-205,ENSE00003808223,1,166,3100017,3100182,AATAAAGATTCAGAAGGAGAAATATGTCCACCGCCTTCTGATCCCATCCACCCGGATGTCTGATGCTGGGAAGTACACAGTGGTGGCAGGAGGCAACGTGTCAACTGCAAAACTCTTTGTAGAAGGCAGAGATGTTCGCATCCGAAGTATTAAAAAGGAGGTTCAG
>TTN-205,ENSE00003810851,1,232,3100183,3100414,GTCATTGAGAAACAGCGTGCTGTTGTTGAATTTGAGGTCAATGAAGACGATGTTGATGCCCACTGGTATAAAGATGGCATTGAAATCAATTTCCAAGTTCAAGAACGACACAAATATGTAGTGGAAAGAAGAATCCACCGAATGTTTATCTCTGAGACCAGACAGAGCGATGCAGGAGAATACACCTTTGTGGCAGGAAGGAACAGGAGTTCTGTCACTCTCTATGTCAATG
>TTN-205,ENSE00003802092,1,285,3100415,3100699,CTCCTGAACCGCCCCAAGTTCTGCAGGAGCTCCAGCCTGTCACTGTGCAGTCTGGCAAGCCTGCCCGCTTCTGTGCCGTGATATCCGGAAGACCACAGCCCAAAATTTCCTGGTACAAGGAAGAGCAGCTGCTTTCCACTGGCTTCAAGTGCAAATTTCTTCATGATGGGCAAGAATACACGCTTTTGCTAATTGAAGCCTTCCCAGAGGATGCGGCAGTCTATACCTGTGAAGCCAAGAATGACTATGGTGTTGCCACAACATCAGCTTCACTCTCAGTGGAAG
>TTN-205,ENSE00003807103,1,126,3100700,3100825,TTCCAGAAGTTGTGTCTCCTGATCAGGAAATGCCTGTTTATCCACCTGCCATCATCACCCCGCTTCAGGACACTGTCACTTCTGAAGGGCAGCCAGCCCGTTTTCAATGCCGGGTTTCTGGAACAG
>TTN-205,ENSE00003801355,1,189,3100826,3101014,ATCTAAAAGTGTCGTGGTACAGCAAAGACAAGAAAATCAAGCCATCTCGGTTCTTTAGAATGACTCAATTTGAAGACACTTATCAACTGGAAATTGCCGAAGCTTATCCAGAAGATGAAGGAACTTACACGTTTGTTGCTAGTAATGCTGTAGGCCAAGTATCAAGCACAGCCAACCTGAGTCTGGAAG
>TTN-205,ENSE00004024281,1,375,3101015,3101389,GATTTAGCAAATTTGAAGAAAATACATCAAACTCCCAATGGCATGTCTCTTTATCAGTTTCATTTAAGAAGGAGCCCCTTGGCCAAAAGCCCAGCTTCATCCAGCCTCTGTCAAGCCTCAGGGTGCACAACGGGGAGACAGTCAGATTTCATGCGAGGGTTTCTGGCATTCCCAAGCCAGAAATCCAATGGTTTCATAACCAGCAGCTAATTCTACCAACAAAAGATGTAGTTTTCCATTTTGAGGAGTCCACAGGCATGGCTTTAATGCTTATAGTTGATGCTTACTCAGAGCATGCTGGGCAGTACTCTTGCAAAGCAGCCAATAGTGCTGGGGAAGCCACTTGTGCAGCTACACTCACAGTGACTCCAAAAG
>TTN-205,ENSE00004024285,1,576,3101390,3101965,TGCAAGCCCTAGATAGGCAAAGTTCTGGGAAAGATGTAAGAGAGTCCACCAAGTCCCAGGCAGTGGCAGATTCCTCTTTCACAAAGGAGGAGAGCAAAATATCTCAAAAGGAAATTAAGTCATTTCAAGGATCATCATATGAATATGAAGTGCAGGTTTTTGAAAGTGTATCTCAAAGTTCCATCCACACAGCTGCATCTGTTCAAGATACACAGTTGTGCCATACTGCATCCCTTTCACAAATTGCAGAAAGCACTGAGCTATCTAAGGAATGTGCTAAAGAGTCCACGGGTGAGGCGCCCAAGATTTTCCTGCATCTTCAGGACGTCACTGTAAAGTGCGGTGACACGGCTCAATTCCTCTGTGTTTTAAAAGATGATTCTTTCATTGATGTAACCTGGACTCACGAAGGTGCAAAGATAGAGGAATCCGAGAGACTGAAACAATCACAAAATGGAAATATTCAGTTTCTTACCATATGTAATGTTCAGCTGGTAGACCAAGGACTATACAGCTGCATTGTACACAATGACTGTGGAGAGAGGACAACGTCAGCAGTACTAAGTGTAGAAGGTG
>TTN-205,ENSE00003810791,1,57,3101966,3102022,CTCCTGAATCAATTTTGCATGAGAGGATTGAACAAGAGATTGAGATGGAAATGAAAG
>TTN-205,ENSE00004024265,1,2781,3102023,3104803,AGTTTTCTAGTTCTTTTCTGTCTGCCGAGGAAGAAGGACTTCATAGCGCCGAACTTCAATTATCTAAAATAAATGAAACACTTGAACTTTTGTCTGAATCTCCAGTTTACCCAACTAAATTTGATTCCGAAAAGGAAGGCACTGGCCCAATTTTCATCAAAGAAGTGTCAAATGCTGATATAAGCATGGGGGATGTGGCTACACTGTCTGTAACTGTCATTGGCATCCCCAAACCTAAAATTCAGTGGTTCTTTAATGGAGTGCTATTAACCCCTTCTGCTGACTACAAATTTGTTTTTGACGGTGATGATCATAGCCTGATCATTCTGTTCACCAAATTGGAGGATGAGGGAGAGTATACATGTATGGCCAGTAATGACTATGGAAAGACAATATGTAGTGCCTATCTAAAAATTAATTCCAAAGGAGAGGGTCACAAAGACACTGAAACAGAATCAGCAGTGGCAAAATCTCTGGAAAAGCTGGGAGGTCCTTGTCCTCCTCACTTCCTTAAGGAGTTAAAACCAATTCGCTGTGCTCAAGGGCTTCCTGCCATCTTTGAGTACACAGTGGTTGGAGAGCCTGCCCCTACTGTTACATGGTTCAAAGAAAACAAGCAGCTTTGCACCAGTGTTTATTACACTATCATTCATAACCCTAATGGCTCTGGAACTTTCATTGTCAATGACCCTCAGAGGGAAGACAGTGGCCTCTATATCTGTAAAGCAGAGAATATGTTGGGTGAGTCCACCTGTGCAGCAGAGCTGCTTGTGCTTCTGGAAGACACAGACATGACTGATACCCCCTGCAAAGCAAAGTCCACACCAGAGGCTCCTGAGGATTTTCCACAGACACCCTTAAAGGGTCCCGCAGTTGAAGCACTTGACTCAGAGCAGGAAATTGCAACGTTTGTAAAAGACACCATTTTGAAAGCTGCTTTAATTACAGAAGAAAACCAGCAACTATCTTATGAGCATATTGCTAAAGCCAATGAATTGAGCAGTCAGCTTCCTTTGGGAGCTCAGGAATTGCAATCCATTTTGGAGCAAGACAAGCTCACTCCTGAAAGCACCAGGGAATTTCTTTGCATCAATGGCAGTATTCACTTTCAGCCTCTCAAGGAACCATCTCCCAACCTACAGCTGCAGATTGTACAGTCCCAGAAAACCTTCTCCAAAGAAGGTATTCTAATGCCTGAAGAGCCTGAGACACAGGCAGTTCTATCAGATACCGAGAAAATCTTCCCAAGTGCCATGTCCATAGAACAAATTAATTCATTAACAGTTGAGCCTCTGAAAACTTTATTAGCTGAACCTGAAGGGAATTATCCACAGTCTTCAATAGAACCTCCAATGCATTCTTATCTAACCTCTGTGGCTGAGGAAGTACTTTCACCAAAAGAAAAGACAGTATCTGACACCAACAGAGAGCAAAGAGTGACTCTTCAAAAGCAAGAGGCACAAAGTGCGCTCATCTTGAGTCAGAGCTTAGCTGAGGGACACGTGGAGAGTCTCCAGAGTCCTGATGTCATGATCTCTCAGGTAAACTATGAGCCCCTAGTCCCTTCAGAACACTCATGCACAGAAGGAGGTAAAATTTTGATAGAAAGTGCAAATCCACTGGAAAATGCAGGGCAAGATTCTGCGGTCAGAATTGAGGAAGGCAAGTCCTTAAGATTTCCACTAGCACTTGAAGAAAAGCAGGTACTGCTCAAAGAAGAGCATTCTGACAACGTGGTGATGCCCCCAGACCAAATCATTGAGTCTAAAAGAGAGCCCGTGGCAATAAAGAAAGTGCAGGAGGTACAGGGAAGGGACCTTCTTTCTAAGGAAAGCTTGCTTTCTGGTATTCCAGAAGAGCAGAGATTAAACCTGAAAATTCAAATCTGCCGGGCTTTGCAAGCAGCCGTGGCCAGCGAGCAGCCAGGTCTTTTCTCTGAGTGGCTAAGAAATATTGAAAAGGTGGAGGTCGAGGCTGTAAACATCACCCAAGAGCCCAGACACATCATGTGCATGTACCTTGTTACTTCGGCAAAGTCTGTAACAGAAGAAGTAACCATCATTATTGAAGATGTTGATCCTCAAATGGCTAACCTGAAAATGGAACTTAGGGATGCTTTGTGTGCTATTATATATGAGGAAATAGACATCCTAACAGCTGAGGGTCCTAGAATTCAGCAAGGAGCCAAAACAAGTTTGCAAGAAGAAATGGATTCTTTTTCAGGTTCACAGAAGGTTGAACCCATTACTGAACCAGAAGTTGAATCTAAATATCTGATCTCAACTGAAGAGGTCAGTTATTTTAACGTGCAAAGTAGGGTTAAATATTTGGATGCCACACCTGTCACTAAAGGGGTTGCTTCAGCTGTTGTCTCTGACGAAAAACAAGATGAGAGTCTGAAACCATCAGAGGAAAAAGAGGAGTCTTCCTCTGAAAGTGGTACTGAGGAGGTTGCTACAGTAAAGATACAGGAAGCTGAGGGTGGCTTAATCAAAGAGGATGGCCCCATGATACATACACCTTTAGTGGACACTGTTTCTGAGGAAGGTGATATTGTACACCTCACAACATCCATAACAAATGCTAAAGAGGTGAATTGGTATTTTGAGAATAAACTGGTGCCTTCAGATGAAAAGTTCAAGTGTTTACAAGATCAAAATACATATACGCTAGTCATCGACAAAGTAAATACCGAAGACCATCAAGGAGAGTATGTCTGTGAGGCCTTGAATGACAGCGGAAAAACAGCAACTTCAGCCAAACTCACTGTAGTAAAAAGAG
>TTN-205,ENSE00003805227,1,279,3104804,3105082,CTGCCCCAGTGATCAAGAGGAAAATCGAACCCCTGGAAGTAGCACTGGGCCACCTAGCCAAATTCACCTGTGAGATCCAAAGTGCTCCCAATGTCCGGTTCCAGTGGTTTAAAGCTGGCCGAGAAATTTATGAGAGTGACAAGTGTTCTATTCGATCTTCAAAGTATATCTCCAGCCTTGAAATCCTGAGAACCCAGGTGGTTGACTGCGGCGAGTATACATGCAAAGCTTCCAATGAGTATGGCAGTGTCAGCTGTACAGCCACACTAACTGTGACAG
>TTN-205,ENSE00003808619,1,564,3105083,3105646,AGGCATATCCACCAACCTTTCTCTCCAGACCTAAGTCCCTTACAACTTTTGTGGGTAAGGCAGCCAAGTTCATCTGCACAGTGACAGGGACTCCTGTGATAGAAACCATTTGGCAGAAAGATGGTGCTGCACTCTCACCTTCACCTAACTGGAGGATTTCCGACGCAGAAAACAAACACATTTTAGAACTCTCAAACCTTACCATTCAAGATAGAGGAGTTTATTCTTGTAAGGCTTCCAACAAGTTTGGAGCAGACATCTGCCAAGCAGAGTTGATCATCATTGATAAGCCACATTTCATTAAAGAATTAGAGCCTGTGCAGTCCGCTATCAATAAGAAGGTCCACCTTGAGTGCCAAGTAGATGAAGACAGAAAAGTCACAGTTACGTGGAGCAAAGATGGGCAAAAACTCCCCCCAGGGAAAGATTATAAGATCTGTTTTGAAGATAAAATAGCAACACTTGAGATTCCTTTGGCCAAACTGAAAGATTCAGGAACCTATGTCTGTACAGCTTCAAATGAGGCTGGAAGCAGCTCCTGCTCAGCCACAGTCACTGTCAGAG
>TTN-205,ENSE00003811334,1,282,3105647,3105928,AGCCACCATCCTTCGTGAAGAAGGTGGATCCCTCTTATTTAATGCTCCCAGGTGAATCAGCACGCCTCCATTGCAAGCTGAAAGGCTCACCTGTGATCCAGGTTACTTGGTTTAAAAATAACAAAGAACTCAGTGAAAGTAACACAGTCCGAATGTATTTTGTCAATTCTGAGGCTATACTTGATATTACGGATGTAAAAGTTGAAGACAGTGGGAGTTACTCATGTGAAGCAGTGAATGACGTCGGCAGTGATAGCTGCAGTACTGAAATAGTTATCAAAG
>TTN-205,ENSE00003807496,1,279,3105929,3106207,AACCTCCTTCTTTCATCAAAACTCTTGAGCCTGCAGACATAGTGAGAGGAACAAATGCTCTACTTCAGTGTGAAGTCTCAGGCACTGGACCATTTGAAATTAGCTGGTTCAAAGACAAGAAACAAATTCGAAGTAGTAAAAAATACAGATTGTTTTCTCAGAAGTCTCTTGTGTGTCTGGAGATCTTTTCGTTTAATAGTGCAGATGTTGGTGAATATGAATGTGTTGTTGCTAATGAAGTCGGCAAGTGTGGCTGCATGGCAACCCACTTACTCAAAG
>TTN-205,ENSE00003806831,1,279,3106208,3106486,AACCTCCAACCTTTGTAAAGAAAGTAGATGATTTGATTGCACTAGGAGGACAAACCGTTACCCTGCAAGCTGCTGTGAGAGGGTCAGAGCCCATTTCTGTCACATGGATGAAAGGTCAAGAGGTCATCAGAGAAGACGGAAAAATCAAAATGAGCTTTTCCAATGGTGTTGCAGTCTTGATAATCCCTGATGTTCAGATTAGTTTTGGAGGCAAATACACGTGCCTGGCTGAAAATGAAGCTGGAAGCCAAACATCTGTTGGGGAATTAATAGTTAAAG
>TTN-205,ENSE00003801788,1,279,3106487,3106765,AACCTGCCAAAATCATTGAGCGAGCAGAACTGATCCAGGTGACAGCAGGAGATCCCGCCACACTGGAGTACACAGTGGCAGGCACGCCAGAACTGAAGCCCAAATGGTACAAAGATGGGAGACCCTTGGTCGCCAGTAAAAAATACCGAATAAGTTTTAAAAACAATGTTGCCCAGCTCAAATTTTATTCAGCTGAGCTGCACGACAGTGGCCAATACACATTTGAGATTTCCAATGAAGTGGGCAGCAGCTCCTGTGAGACTACATTCACTGTATTAG
>TTN-205,ENSE00003804186,1,288,3106766,3107053,ATCGAGACATTGCTCCATTTTTTACCAAACCCTTGCGCAACGTGGATAGTGTTGTTAATGGTACCTGCAGACTGGACTGCAAAATTGCAGGCTCCCTCCCCATGAGGGTGTCCTGGTTTAAGGATGGCAAAGAAATAGCTGCTTCTGACAGATACAGGATAGCATTTGTGGAAGGCACAGCCTCTTTGGAGATCATCAGAGTAGACATGAATGATGCAGGGAATTTCACTTGTCGAGCCACAAATTCCGTGGGAAGCAAAGACAGCAGTGGAGCCCTGATTGTGCAAG
>TTN-205,ENSE00003805178,1,279,3107054,3107332,AACCACCCAGTTTTGTAACTAAACCCGGCTCAAAGGATGTTCTGCCTGGCTCAGCAGTCTGCCTGAAGAGCACTTTCCAAGGATCTACTCCTCTCACAATCAGATGGTTTAAGGGCAACAAAGAGCTGGTTTCTGGTGGAAGCTGCTATATTACCAAAGAAGCTTTAGAGAGTTCCCTGGAACTCTATTTAGTAAAAACCTCTGATTCGGGCACGTACACATGTAAAGTCAGCAATGTCGCTGGAGGGGTGGAATGCAGTGCAAACTTGTTTGTAAAAG
>TTN-205,ENSE00003806856,1,282,3107333,3107614,AACCTGCCACATTTGTTGAAAAGTTAGAGCCATCACAGCTGTTAAAGAAGGGAGATGCCACCCAGCTAGCCTGCAAAGTAACTGGTACCCCTCCAATTAAAATAACATGGTTTGCAAATGATAGAGAAATTAAGGAGAGCAGCAAACACAGAATGTCTTTTGTGGAGTCTACTGCAGTTCTAAGACTGACAGATGTTGGCATCGAAGACAGTGGTGAATATATGTGTGAGGCCCAAAATGAGGCTGGCAGTGACCACTGCAGTAGCATTGTAATAGTCAAAG
>TTN-205,ENSE00003804074,1,279,3107615,3107893,AGTCACCTTATTTTACCAAGGAATTTAAGCCAATTGAAGTCTTAAAGGAGTACGATGTCATGTTGCTGGCTGAGGTGGCAGGCACTCCTCCCTTTGAGATCACTTGGTTCAAAGATAACACAATCCTGCGAAGTGGTAGAAAGTATAAGACTTTCATTCAGGATCATCTGGTTAGCCTGCAGATCCTCAAGTTTGTAGCTGCAGATGCTGGCGAATACCAGTGTCGGGTGACCAATGAGGTGGGCAGCAGCATCTGCAGTGCCAGGGTGACTTTAAGAG
>TTN-205,ENSE00003807057,1,279,3107894,3108172,AACCCCCATCCTTCATAAAGAAGATCGAGAGTACCAGCTCCCTCCGGGGAGGCACAGCTGCCTTCCAGGCCACTCTGAAGGGCTCCTTGCCAATTACGGTGACTTGGCTAAAAGACAGCGATGAAATCACTGAAGACGATAATATAAGAATGACCTTTGAGAACAATGTGGCCAGTTTGTACCTCAGTGGCATTGAAGTCAAGCATGATGGGAAATATGTCTGTCAGGCCAAAAATGATGCAGGAATACAAAGATGTTCTGCATTACTCTCAGTAAAAG
>TTN-205,ENSE00003807032,1,279,3108173,3108451,AACCTGCAACAATCACCGAGGAAGCTGTGTCTATAGATGTCACCCAAGGAGACCCAGCCACTTTGCAGGTTAAATTTTCAGGGACTAAGGAGATTACAGCCAAATGGTTTAAAGATGGCCAAGAACTGACCCTGGGCTCAAAATATAAAATCAGTGTCACTGATACAGTCTCAATACTGAAGATTATTTCTACAGAAAAGAAAGATAGTGGAGAATATACTTTCGAGGTCCAAAATGATGTTGGGAGGAGCAGCTGCAAGGCTAGAATTAATGTATTAG
>TTN-205,ENSE00003810010,1,288,3108452,3108739,ATCTTATCATACCTCCTTCATTCACCAAAAAGCTGAAGAAAATGGACAGCATTAAAGGTTCTTTCATTGATTTAGAATGTATAGTGGCTGGGTCACATCCCATAAGCATCCAGTGGTTCAAAGATGACCAAGAAATATCAGCTAGTGAAAAGTACAAATTCTCTTTTCATGACAATACTGCCTTCTTGGAAATCAGCCAGCTGGAAGGTACAGACAGTGGGACATACACTTGTTCTGCCACAAATAAGGCAGGGCACAACCAATGCAGTGGGCATCTGACAGTCAAAG
>TTN-205,ENSE00003805733,1,279,3108740,3109018,AACCCCCTTACTTTGTGGAAAAGCCACAGTCACAAGATGTCAATCCCAACACAAGGGTACAGTTAAAGGCTCTTGTGGGTGGCACTGCACCCATGACAATAAAGTGGTTTAAAGATAACAAAGAGTTACACTCAGGAGCAGCCCGCTCAGTTTGGAAGGATGACACCTCTACCAGTCTAGAGCTCTTTGCAGCCAAAGCTACCGATTCTGGAACCTACATTTGCCAACTAAGCAATGATGTTGGCACAGCAACCAGCAAAGCCACTCTCTTTGTAAAAG
>TTN-205,ENSE00003805836,1,282,3109019,3109300,AACCTCCTCAATTCATTAAGAAGCCCAGTCCAGTCTTAGTGCTGAGGAATGGACAGTCAACAACATTTGAATGCCAAATAACAGGCACTCCTAAAATCCGAGTGTCTTGGTATCTAGACGGGAATGAAATAACAGCCATTCAGAAACATGGCATTTCCTTCATTGATGGTTTAGCCACTTTCCAGATTTCTGGTGCCAGGGTAGAAAATAGTGGGACTTATGTGTGTGAAGCTCGAAATGACGCAGGCACGGCGAGCTGCAGCATTGAACTCAAAGTGAAAG
>TTN-205,ENSE00003802637,1,279,3109301,3109579,AACCCCCCACCTTTATCAGAGAGCTGAAGCCTGTGGAGGTAGTAAAATATAGTGACGTGGAGCTGGAGTGTGAAGTTACGGGAACACCTCCGTTTGAAGTCACTTGGCTGAAGAATAACAGGGAAATTCGAAGCAGCAAAAAATACACATTGACCGACAGAGTGTCTGTGTTTAACCTCCATATAACCAAGTGTGACCCTTCAGACACTGGGGAATACCAGTGCATTGTATCCAATGAAGGCGGCAGCTGCTCATGCAGTACTAGAGTTGCCCTGAAAG
>TTN-205,ENSE00003809504,1,279,3109580,3109858,AACCACCATCATTCATTAAGAAGATAGAAAATACCACTACTGTTTTGAAAAGTTCTGCCACCTTTCAGAGTACCGTGGCAGGTTCTCCTCCTATTTCTATAACCTGGCTAAAGGATGATCAGATTCTTGATGAAGATGATAATGTCTATATTTCATTTGTGGACAGTGTGGCCACACTTCAAATCAGAAGTGTGGATAATGGACACAGTGGGAGATATACCTGTCAAGCCAAGAATGAGTCAGGAGTTGAGAGGTGTTATGCTTTCCTTTTAGTACAAG
>TTN-205,ENSE00003802968,1,279,3109859,3110137,AACCAGCTCAAATCGTAGAGAAAGCTAAATCAGTTGATGTTACGGAGAAAGATCCCATGACCTTGGAATGTGTTGTGGCTGGAACACCAGAACTCAAAGTGAAATGGCTTAAAGACGGGAAACAAATAGTTCCCAGTAGATACTTTTCAATGAGTTTTGAAAATAACGTGGCCAGTTTTAGAATTCAGTCAGTAATGAAGCAGGACAGCGGTCAGTACACTTTCAAGGTGGAAAATGACTTCGGAAGCAGTAGCTGTGATGCCTACTTAAGAGTGCTAG
>TTN-205,ENSE00003810612,1,288,3110138,3110425,ATCAAAATATTCCTCCATCATTCACCAAAAAATTAACCAAAATGGATAAAGTTCTGGGCTCTTCTATTCATATGGAGTGCAAGGTGTCTGGTTCACTTCCCATTAGTGCTCAGTGGTTTAAGGATGGAAAAGAAATATCTACAAGTGCAAAATACAGACTTGTGTGCCATGAGAGATCTGTGTCTCTGGAAGTTAATAATCTGGAATTAGAAGATACTGCAAATTACACATGCAAAGTGTCAAATGTAGCAGGAGATGATGCATGCAGTGGCATCTTAACTGTGAAAG
>TTN-205,ENSE00003806423,1,279,3110426,3110704,AACCACCAAGCTTCCTAGTGAAACCTGGGCGACAGCAAGCCATACCTGATTCTACAGTGGAATTTAAGGCAATACTAAAAGGAACACCACCATTTAAAATAAAATGGTTTAAGGATGATGTGGAACTTGTCTCAGGTCCTAAATGTTTCATTGGCTTGGAAGGGTCGACTAGCTTCTTAAATCTCTACTCAGTGGATGCTTCTAAGACTGGACAGTATACTTGCCATGTTACCAATGATGTTGGTAGCGACTCTTGTACTACGATGTTGCTTGTGACAG
>TTN-205,ENSE00003805536,1,282,3110705,3110986,AACCACCAAAGTTTGTAAAGAAATTAGAAGCCTCCAAAATTGTGAAAGCAGGTGACTCTTCACGACTTGAATGCAAGATAGCTGGATCCCCAGAAATCAGAGTTGTGTGGTTCCGAAATGAACATGAACTTCCAGCCAGTGATAAGTACAGAATGACTTTCATTGACTCAGTGGCCGTCATACAGATGAACAATCTCAGTACTGAGGACAGTGGAGATTTCATTTGTGAGGCTCAGAATCCCGCTGGCAGCACAAGCTGCAGTACCAAGGTTATAGTAAAAG
>TTN-205,ENSE00003807762,1,279,3110987,3111265,AGCCACCTGTTTTTAGCAGCTTCCCTCCTATAGTAGAAACCCTTAAAAATGCTGAAGTCAGTCTTGAATGTGAACTTTCGGGAACACCACCGTTTGAGGTGGTATGGTACAAAGACAAGCGGCAACTCAGAAGCAGCAAGAAATACAAGATTGCATCCAAAAACTTCCACACAAGTATTCACATTCTCAATGTGGACACTTCAGACATCGGTGAATACCACTGCAAAGCACAGAATGAAGTGGGAAGTGATACTTGTGTTTGTACTGTAAAATTGAAAG
>TTN-205,ENSE00003809887,1,282,3111266,3111547,AACCACCAAGATTTGTCTCCAAACTGAACAGCCTCACTGTTGTAGCCGGAGAGCCTGCTGAATTACAAGCATCCATAGAAGGCGCCCAGCCTATTTTTGTCCAGTGGCTTAAAGAGAAGGAAGAAGTGATTAGAGAAAGTGAAAACATCAGGATTACATTTGTGGAAAATGTTGCAACTCTACAGTTTGCAAAAGCAGAGCCAGCTAATGCTGGAAAGTATATCTGCCAAATCAAGAATGATGGTGGAATGAGGGAGAACATGGCCACACTGATGGTCTTAG
>TTN-205,ENSE00003811356,1,279,3111548,3111826,AGCCCGCAGTCATTGTTGAGAAGGCAGGACCGATGACGGTGACTGTAGGAGAAACGTGCACTCTGGAGTGTAAGGTGGCTGGCACTCCGGAACTCTCTGTTGAATGGTACAAGGATGGAAAGCTGTTGACCAGCAGCCAAAAACACAAATTTAGCTTCTACAACAAAATCTCTTCCTTAAGGATTCTCTCAGTTGAAAGGCAAGATGCAGGCACATACACTTTCCAGGTTCAAAATAATGTTGGGAAAAGCAGCTGCACAGCTGTGGTTGATGTTTCAG
>TTN-205,ENSE00003804298,1,288,3111827,3112114,ACCGAGCAGTTCCTCCCTCTTTCACACGAAGACTGAAAAATACTGGTGGGGTGTTAGGTGCTTCTTGCATCTTGGAATGCAAAGTAGCTGGATCATCACCTATTTCAGTTGCCTGGTTTCATGAGAAAACCAAGATTGTCAGTGGAGCAAAGTACCAAACCACATTTTCAGATAATGTCTGCACATTGCAGTTGAATTCTCTGGATTCCTCAGATATGGGCAATTACACATGCGTGGCTGCTAATGTCGCTGGGTCTGATGAATGTCGTGCAGTGCTAACTGTACAAG
>TTN-205,ENSE00003807700,1,279,3112115,3112393,AACCACCCTCTTTTGTGAAAGAACCTGAACCTTTGGAAGTACTACCAGGCAAAAATGTAACCTTCACAAGCGTTATTAGAGGAACCCCTCCATTCAAAGTCAACTGGTTCAGAGGTGCCAGAGAACTAGTGAAAGGAGACCGGTGCAACATCTATTTTGAAGACACTGTGGCAGAACTGGAATTATTTAATATTGACATATCTCAGAGTGGGGAATACACCTGTGTGGTTTCTAACAACGCTGGCCAAGCATCTTGCACTACCCGTCTCTTTGTGAAAG
>TTN-205,ENSE00003803086,1,279,3112394,3112672,AACCAGCTGCATTTTTGAAGAGATTAAGTGATCATTCTGTAGAACCAGGGAAGTCCATAATTCTGGAGAGCACCTACACTGGAACACTTCCAATTTCTGTCACTTGGAAAAAGGATGGTTTTAACATAACTACCTCTGAAAAATGTAACATAGTCACAACAGAGAAAACTTGTATCCTGGAAATTCTGAATAGCACAAAAAGAGATGCAGGGCAGTATTCCTGCGAGATTGAAAATGAGGCAGGAAGGGATGTTTGTGGAGCTCTGGTATCTACATTAG
>TTN-205,ENSE00003806655,1,279,3112673,3112951,AACCGCCTTATTTTGTTACGGAACTGGAACCTCTGGAGGCAGCAGTTGGAGATTCGGTTTCTTTACAATGCCAAGTTGCTGGGACACCAGAAATTACAGTGTCTTGGTACAAAGGAGATACCAAATTACGGCCAACTCCTGAATACAGGACCTACTTTACAAACAATGTGGCCACACTTGTTTTTAATAAAGTGAACATCAATGACAGTGGAGAGTACACATGCAAAGCAGAAAATAGTATAGGAACTGCTTCTTCTAAGACTGTGTTCAGAATTCAAG
>TTN-205,ENSE00003805355,1,288,3112952,3113239,AGCGCCAACTCCCACCTTCTTTTGCAAGACAATTAAAGGACATTGAACAAACTGTGGGGTTACCTGTTACACTCACTTGTCGATTAAATGGCTCTGCACCCATCCAAGTGTGCTGGTATAGAGATGGAGTACTTTTAAGAGACGATGAAAATCTACAGACTTCATTTGTAGATAATGTGGCAACTTTAAAAATTTTGCAAACTGACTTGAGTCACTCTGGCCAGTACTCTTGCTCAGCTTCCAACCCACTTGGAACAGCATCTTCTAGTGCTAGACTCACAGCAAGAG
>TTN-205,ENSE00003804884,1,288,3113240,3113527,AACCCAAGAAATCTCCCTTCTTTGACATCAAGCCTGTATCTATAGATGTTATTGCTGGAGAAAGTGCTGATTTTGAGTGTCATGTTACTGGTGCTCAACCGATGCGAATCACTTGGTCAAAAGATAACAAGGAGATCCGTCCTGGAGGAAACTATACAATCACATGTGTGGGAAACACTCCTCATTTGAGAATTCTTAAAGTAGGCAAAGGAGACTCTGGTCAATATACTTGCCAAGCAACCAATGATGTTGGCAAAGACATGTGCTCAGCTCAGCTCAGTGTAAAAG
>TTN-205,ENSE00003805805,1,282,3113528,3113809,AACCTCCAAAGTTTGTTAAGAAATTAGAAGCTTCAAAAGTTGCAAAGCAGGGAGAATCCATTCAACTGGAATGTAAAATAAGTGGCTCCCCAGAAATCAAAGTTTCATGGTTCCGAAATGACAGCGAACTTCATGAAAGTTGGAAATACAACATGTCATTCATTAATTCTGTGGCATTGCTTACGATCAATGAAGCTAGTGCTGAAGACAGCGGGGACTACATTTGTGAGGCTCATAATGGTGTTGGTGACGCCAGCTGCAGCACAGCGTTGACAGTGAAAG
>TTN-205,ENSE00003803146,1,279,3113810,3114088,CACCTCCTGTTTTCACCCAGAAGCCTTCTCCAGTAGGAGCTCTTAAAGGTTCTGATGTGATTCTCCAATGTGAAATTTCGGGAACTCCCCCATTTGAAGTAGTATGGGTTAAAGATCGAAAGCAGGTTAGAAACAGCAAGAAATTTAAAATCACTTCAAAACATTTTGATACAAGTCTTCATATCCTTAATCTTGAAGCCTCCGATGTCGGGGAATATCACTGCAAAGCTACTAATGAGGTGGGAAGTGACACGTGTTCTTGCTCTGTCAAGTTCAAAG
>TTN-205,ENSE00003806016,1,282,3114089,3114370,AACCTCCACGATTCGTGAAAAAGCTAAGTGACACCTCAACCCTTATTGGGGATGCTGTTGAGTTACGGGCCATAGTGGAGGGCTTCCAGCCAATTTCTGTTGTCTGGCTGAAAGATAGAGGTGAAGTCATCAGAGAGAGTGAAAATACCAGGATTTCATTCATTGATAACATTGCAACCCTCCAGCTGGGGAGTCCAGAAGCATCTAATTCTGGAAAATATATATGCCAAATCAAAAACGATGCTGGAATGAGAGAATGCTCTGCAGTCTTGACTGTACTAG
>TTN-205,ENSE00003808302,1,279,3114371,3114649,AACCAGCAAGAATCATAGAGAAGCCCGAACCCATGACTGTCACTACTGGAAATCCTTTTGCATTAGAGTGTGTAGTGACTGGAACACCAGAACTCTCAGCCAAGTGGTTCAAAGATGGAAGAGAATTGTCTGCAGACAGCAAACATCACATTACATTCATCAATAAAGTGGCTTCCCTTAAAATCCCCTGTGCCGAAATGAGTGACAAAGGATTATATAGCTTTGAAGTGAAAAACAGTGTTGGCAAAAGTAACTGCACTGTATCCGTCCATGTTTCTG
>TTN-205,ENSE00003802442,1,288,3114650,3114937,ATCGGATTGTGCCTCCTTCCTTCATCCGCAAGCTGAAAGACGTGAATGCCATCCTGGGGGCCTCAGTTGTTTTGGAGTGCCGAGTCTCTGGCTCAGCCCCGATTTCAGTTGGCTGGTTTCAGGATGGAAATGAGATTGTTAGTGGGCCCAAATGTCAGTCCAGCTTTTCGGAAAACGTCTGTACTTTGAATCTGAGCTTGTTGGAGCCCTCCGACACAGGCATATACACGTGTGTGGCTGCCAATGTAGCTGGTTCCGATGAGTGCTCAGCAGTCCTGACTGTGCAAG
>TTN-205,ENSE00003809965,1,279,3114938,3115216,AACCACCATCTTTTGAACAAACCCCTGATTCTGTGGAAGTTTTGCCTGGAATGAGCCTCACATTCACCAGTGTCATCAGAGGCACCCCTCCTTTCAAGGTCAAGTGGTTTAAAGGCAGCAGGGAACTGGTGCCTGGGGAGTCATGCAACATCTCTCTGGAAGATTTTGTCACAGAACTGGAGTTGTTTGAGGTGCAGCCATTAGAAAGTGGAGACTATTCTTGCCTCGTTACAAATGATGCTGGCAGTGCTTCCTGTACCACACATCTTTTTGTGAAAG
>TTN-205,ENSE00003809650,1,279,3115217,3115495,AACCAGCCACCTTTGTGAAAAGATTGGCTGATTTCAGTGTTGAGACAGGAAGCCCCATAGTTCTCGAGGCCACATACACTGGCACACCTCCAATCTCAGTGAGCTGGATAAAGGACGAGTATCTTATTTCACAATCTGAGAGATGCAGTATTACTATGACAGAAAAATCTACCATACTGGAAATTCTTGAGAGCACAATAGAGGATTATGCACAGTACAGCTGCCTGATAGAAAATGAGGCTGGTCAAGATATCTGTGAAGCTCTGGTGTCTGTCTTAG
>TTN-205,ENSE00003810498,1,279,3115496,3115774,AACCACCGTACTTTATTGAACCTCTGGAACATGTGGAAGCAGTCATTGGAGAACCTGCAACTTTACAGTGTAAAGTGGATGGAACTCCAGAAATTAGAATTTCTTGGTATAAAGAACACACAAAGCTACGATCAGCTCCTGCATATAAAATGCAATTCAAAAATAACGTTGCTTCCTTAGTAATCAACAAAGTGGATCACAGTGATGTGGGAGAGTATTCATGCAAGGCAGACAACAGTGTGGGGGCAGTCGCTTCTTCAGCTGTGCTTGTTATCAAAG
>TTN-205,ENSE00003807178,1,288,3115775,3116062,CGCGCAAACTTCCACCTTTCTTTGCAAGAAAACTGAAAGACGTTCATGAGACTCTAGGCTTCCCAGTTGCATTTGAATGCCGCATCAATGGCTCAGAACCTCTTCAAGTGTCTTGGTACAAGGATGGGGTTCTTTTGAAAGATGATGCTAATTTGCAGACATCTTTTGTTCATAATGTAGCAACTCTTCAGATTTTACAAACTGACCAGAGCCACATAGGGCAGTATAATTGCTCTGCTTCTAATCCTCTTGGGACTGCTTCATCCAGTGCCAAGCTCATTCTCTCAG
>TTN-205,ENSE00003808579,1,288,3116063,3116350,AGCATGAAGTGCCTCCTTTCTTTGATCTAAAGCCTGTATCAGTAGATCTTGCTCTTGGAGAAAGTGGTACTTTTAAATGTCATGTAACTGGGACTGCACCAATCAAAATCACTTGGGCCAAAGATAACCGAGAGATTCGCCCTGGAGGCAACTACAAGATGACTTTGGTAGAAAATACTGCCACTCTGACAGTTCTCAAAGTAGGCAAAGGCGATGCCGGGCAGTACACCTGCTATGCAAGCAACATCGCTGGAAAAGACTCTTGTTCTGCTCAGCTGGGTGTACAAG
>TTN-205,ENSE00003801249,1,282,3116351,3116632,AACCACCCAGGTTCATTAAGAAGCTAGAACCTTCAAGAATTGTGAAACAGGATGAATTCACAAGGTATGAATGCAAAATCGGTGGGTCTCCAGAAATCAAAGTTTTATGGTATAAGGACGAGACTGAAATTCAAGAGAGCAGTAAATTCAGAATGTCATTCGTTGACTCGGTGGCTGTGCTGGAAATGCACAATCTCAGTGTTGAAGACAGTGGAGACTACACCTGTGAGGCCCACAATGCAGCAGGCAGTGCCAGCAGCAGCACATCCTTAAAAGTTAAAG
>TTN-205,ENSE00003810208,1,279,3116633,3116911,AACCACCCATTTTCCGCAAAAAGCCTCATCCTATAGAGACACTGAAAGGAGCTGATGTTCACCTTGAATGTGAGCTTCAGGGCACTCCCCCATTTCACGTTTCTTGGTATAAAGACAAGAGAGAACTTAGGAGCGGCAAGAAGTACAAGATAATGTCTGAGAACTTCCTAACCAGTATCCACATCCTGAATGTCGATGCTGCAGACATTGGGGAATATCAGTGTAAAGCCACAAATGATGTGGGAAGCGACACTTGCGTTGGTTCCATCGCTCTCAAAG
>TTN-205,ENSE00003802440,1,282,3116912,3117193,CACCACCAAGATTTGTGAAGAAGCTCAGTGACATATCTACTGTCGTTGGTAAAGAAGTTCAGCTGCAGACTACCATTGAAGGCGCTGAACCCATTTCAGTGGTGTGGTTCAAAGATAAGGGAGAAATCGTTAGAGAAAGTGACAACATATGGATTTCTTATTCAGAAAACATTGCAACCTTACAGTTTTCAAGAGTGGAACCAGCCAATGCTGGAAAATACACTTGTCAGATCAAAAACGATGCTGGGATGCAAGAGTGCTTCGCCACGCTATCCGTTCTCG
>TTN-205,ENSE00003802351,1,279,3117194,3117472,AGCCTGCAACAATTGTAGAAAAGCCAGAATCCATAAAAGTTACCACGGGAGACACCTGTACCTTGGAGTGTACAGTAGCTGGCACCCCTGAACTCAGTACTAAGTGGTTTAAGGATGGAAAAGAGCTAACAAGTGACAACAAATACAAAATAAGCTTCTTCAACAAAGTATCCGGCCTTAAGATCATCAATGTAGCACCGAGTGACAGTGGGGTATACAGTTTTGAGGTGCAGAACCCTGTTGGCAAAGACAGCTGCACAGCTTCATTGCAGGTTTCAG
>TTN-205,ENSE00003807933,1,288,3117473,3117760,ACCGAACCGTTCCTCCTTCATTCACAAGAAAATTGAAAGAGACAAATGGTCTATCCGGCTCCTCAGTTGTAATGGAGTGTAAAGTCTATGGGTCACCTCCAATCTCTGTCTCCTGGTTCCATGAAGGAAATGAGATCAGTAGTGGAAGGAAATACCAGACCACCCTGACAGATAATACTTGTGCTTTAACTGTGAACATGCTGGAAGAATCAGACAGTGGTGACTACACATGTATAGCTACTAATATGGCTGGTTCTGATGAATGTAGTGCTCCTTTGACTGTGAGAG
>TTN-205,ENSE00003804939,1,279,3117761,3118039,AACCACCATCTTTTGTTCAGAAACCTGATCCCATGGATGTTTTAACTGGGACCAATGTAACTTTCACAAGTATCGTAAAAGGAACACCTCCTTTCAGTGTTAGCTGGTTCAAAGGTAGCAGTGAACTAGTACCAGGTGACAGATGCAACGTGTCTTTGGAGGATTCAGTTGCTGAACTGGAGTTGTTCGATGTAGATACATCACAAAGTGGAGAATATACTTGCATAGTTAGCAATGAAGCTGGCAAGGCTTCTTGTACAACACATCTCTACATAAAAG
>TTN-205,ENSE00003810094,1,279,3118040,3118318,CCCCAGCCAAATTTGTGAAGAGGCTGAATGATTACAGCATAGAGAAAGGAAAACCCCTGATCCTAGAGGGTACATTCACTGGAACTCCTCCCATTTCGGTTACCTGGAAGAAAAATGGCATAAATGTAACTCCTTCTCAGAGGTGTAATATAACTACGACTGAAAAATCGGCAATCCTGGAAATTCCAAGTAGCACAGTAGAGGATGCAGGACAATACAACTGCTACATTGAAAATGCCTCTGGAAAAGATTCCTGTTCAGCACAAATACTCATACTAG
>TTN-205,ENSE00003811103,1,279,3118319,3118597,AACCACCGTATTTTGTCAAGCAGTTGGAGCCGGTTAAGGTGTCTGTTGGAGATTCTGCCTCTCTACAATGCCAGCTTGCTGGAACCCCTGAAATTGGGGTATCCTGGTATAAAGGAGATACAAAATTGAGACCCACTACGACTTACAAAATGCATTTTAGGAATAATGTTGCTACACTGGTTTTCAACCAGGTTGATATTAATGATAGTGGAGAATATATCTGCAAAGCTGAAAACAGCGTGGGAGAAGTTTCTGCATCAACTTTCCTTACCGTTCAAG
>TTN-205,ENSE00003801476,1,288,3118598,3118885,AGCAAAAACTTCCACCATCATTTTCTCGACAATTGAGAGATGTTCAAGAAACAGTTGGACTGCCAGTTGTTTTTGATTGTGCCATAAGTGGATCAGAACCTATCTCCGTGTCTTGGTATAAAGACGGCAAGCCATTGAAAGACAGCCCAAATGTACAAACATCATTTTTAGACAATACAGCCACACTCAATATTTTTAAAACTGACCGGAGCCTTGCAGGCCAGTATTCCTGCACAGCTACAAACCCTATAGGCTCTGCTTCTTCCAGTGCCAGGCTCATTCTCACAG
>TTN-205,ENSE00003808430,1,288,3118886,3119173,AGGGGAAGAACCCACCCTTCTTTGACATCCGTCTTGCCCCTGTGGATGCTGTGGTGGGAGAAAGTGCTGACTTTGAGTGCCACGTCACGGGCACACAACCGATAAAGGTCAGCTGGGCCAAAGACAGCAGAGAAATACGAAGTGGCGGAAAGTACCAGATTAGTTATCTGGAAAACAGCGCCCACCTGACAGTCCTCAAAGTAGACAAAGGAGATTCTGGACAATATACCTGCTATGCTGTGAATGAAGTGGGAAAAGACTCTTGCACAGCTCAGCTGAATATAAAAG
>TTN-205,ENSE00003809007,1,291,3119174,3119464,AGCGGCTCATCCCACCAAGTTTCACTAAAAGACTCTCAGAGACAGTAGAAGAAACAGAAGGGAATTCTTTCAAACTTGAGGGACGTGTGGCTGGTTCCCAACCTATAACTGTTGCCTGGTACAAAAATAATATAGAGATACAACCAACTTCTAACTGTGAAATAACATTCAAGAACAACACGTTAGTGCTGCAAGTCAGGAAAGCAGGCATGAACGACGCTGGTTTGTACACATGCAAAGTGTCCAATGATGCAGGCTCTGCTCTGTGCACGTCTTCAATCGTCATCAAAG
>TTN-205,ENSE00003803910,1,288,3119465,3119752,AACCTAAGAAGCCACCTGTATTTGATCAGCACCTTACTCCAGTAACAGTGAGTGAAGGAGAATACGTGCAGCTCAGCTGCCATGTCCAGGGATCTGAGCCAATTAGGATCCAGTGGTTGAAGGCTGGCAGGGAAATAAAGCCTTCAGACAGATGCAGCTTCAGCTTTGCTAGTGGGACAGCTGTACTGGAACTCAGAGATGTGGCTAAAGCAGATTCGGGAGATTATGTGTGTAAAGCTTCAAATGTGGCTGGAAGTGACACTACCAAATCAAAAGTGACCATTAAAG
>TTN-205,ENSE00003804245,1,93,3119753,3119845,ACAAACCAGCTGTGGCCCCAGCAACCAAGAAAGCTGCGGTAGATGGAAGACTCTTTTTTGTGTCAGAACCTCAGAGTATCAGAGTCGTAGAAA
>TTN-205,ENSE00003801649,1,286,3119846,3120131,AAACCACTGCGACCTTCATTGCAAAAGTTGGAGGTGACCCAATCCCAAATGTTAAATGGACAAAAGGGAAGTGGAGACAGCTGAACCAAGGAGGTCGTGTTTTCATCCACCAAAAAGGCGATGAAGCAAAACTGGAGATTAGGGACACCACAAAAACTGATTCTGGGTTATACCGATGCGTGGCATTTAACGAACATGGTGAAATTGAAAGTAATGTTAACTTACAGGTGGATGAAAGGAAGAAACAAGAGAAAATTGAAGGCGATCTTAGAGCAATGCTGAAAAA
>TTN-205,ENSE00003805371,1,184,3120132,3120315,GACTCCAATCTTAAAGAAAGGAGCTGGAGAAGAAGAGGAAATTGATATCATGGAACTTCTCAAAAATGTTGATCCTAAAGAATATGAAAAATATGCCCGCATGTATGGAATCACTGACTTCCGAGGTCTTCTTCAAGCATTTGAACTGCTCAAGCAAAGCCAAGAAGAAGAGACACATAGACTG
>TTN-205,ENSE00003802112,1,90,3120316,3120405,GAAATTGAGGAAATAGAGAGGTCAGAGAGGGACGAAAAGGAATTTGAGGAACTTGTATCATTTATTCAGCAAAGACTGTCACAGACAGAG
>TTN-205,ENSE00003810323,1,268,3120406,3120673,CCTGTCACTCTGATCAAGGACATTGAAAATCAGACAGTTTTGAAAGATAATGATGCTGTCTTTGAAATTGACATTAAAATTAATTATCCAGAAATCAAGCTTTCGTGGTACAAAGGAACTGAAAAACTGGAACCCAGTGATAAATTTGAAATAAGCATTGATGGTGACCGACATACACTCAGAGTCAAAAACTGTCAACTTAAAGACCAGGGCAATTATCGATTGGTTTGTGGTCCACACATCGCTAGCGCTAAACTAACTGTAATTG
>TTN-205,ENSE00003810781,1,261,3120674,3120934,AGCCTGCATGGGAACGGCATCTTCAGGATGTGACTCTGAAAGAAGGCCAGACTTGCACCATGACATGCCAATTTTCTGTACCAAATGTAAAATCTGAATGGTTCAGAAATGGCAGAATCCTTAAACCCCAAGGTAGACATAAAACAGAAGTGGAACACAAAGTCCATAAATTGACCATTGCAGATGTTCGAGCAGAAGACCAGGGTCAGTACACCTGCAAATATGAAGACCTTGAAACTTCAGCAGAACTCAGAATCGAAG
>TTN-205,ENSE00003805599,1,210,3120935,3121144,CTGAACCAATTCAGTTTACAAAGCGCATACAGAACATCGTGGTGAGTGAGCATCAGTCTGCCACCTTTGAGTGTGAAGTGTCCTTTGATGATGCCATTGTAACATGGTACAAAGGACCAACAGAACTGACAGAGAGCCAGAAATACAACTTCAGGAATGATGGCCGCTGCCATTATATGACCATCCACAATGTGACCCCAGACGATGAAG
>TTN-205,ENSE00003809461,1,78,3121145,3121222,GTGTCTACTCGGTCATCGCTCGGCTGGAGCCAAGAGGTGAAGCAAGAAGCACGGCAGAGCTGTACCTAACGACGAAAG
>TTN-205,ENSE00003805821,1,27,3121223,3121249,AAATCAAACTTGAGCTGAAGCCTCCTG
>TTN-205,ENSE00003803485,1,60,3121250,3121309,ATATTCCTGACTCCAGAGTTCCAATCCCAACCATGCCTATCAGAGCAGTGCCACCAGAAG
>TTN-205,ENSE00003803812,1,84,3121310,3121393,AAATCCCTCCTGTGGTTGCTCCTCCTATCCCCCTTTTGCTACCAACACCCGAAGAAAAGAAACCACCACCAAAACGTATTGAAG
>TTN-205,ENSE00003804844,1,72,3121394,3121465,TTACCAAAAAGGCTGTGAAGAAAGATGCCAAAAAAGTTGTTGCAAAGCCCAAAGAGATGACACCACGTGAAG
>TTN-205,ENSE00003810688,1,48,3121466,3121513,AGATTGTCAAGAAGCCTCCACCTCCTACTACCTTAATTCCAGCAAAAG
>TTN-205,ENSE00003806388,1,405,3121514,3121918,CTCCTGAAATCATTGATGTATCCTCTAAAGCTGAAGAAGTAAAAATAATGACTATAACCAGAAAGAAAGAGGTTCAGAAAGAAAAAGAAGCTGTGTATGAGAAAAAGCAAGCAGTCCACAAGGAGAAGAGAGTCTTCATTGAATCTTTCGAAGAACCTTATGACGAACTGGAGGTAGAACCATACACAGAGCCATTTGAACAACCTTATTATGAAGAACCAGATGAAGACTATGAAGAGATTAAGGTAGAAGCTAAAAAAGAAGTTCACGAGGAATGGGAAGAAGATTTTGAAGAAGGGCAAGAATACTATGAAAGGGAAGAAGGCTATGACGAAGGGGAGGAAGAGTGGGAAGAGGCTTACCAAGAAAGGGAAGTAATTCAAGTTCAAAAGGAGGTCTATGAAG
>TTN-205,ENSE00003803093,1,63,3121919,3121981,AATCACATGAGAGAAAAGTTCCAGCCAAAGTACCTGAAAAGAAAGCACCACCACCTCCTAAAG
>TTN-205,ENSE00003802009,1,78,3121982,3122059,TTATAAAGAAGCCAGTAATTGAAAAAATTGAAAAGACTTCTCGAAGAATGGAGGAAGAAAAAGTTCAAGTCACCAAAG
>TTN-205,ENSE00003806356,1,78,3122060,3122137,TACCTGAAGTTTCAAAGAAGATTGTTCCACAAAAACCTTCCCGGACTCCAGTACAGGAAGAAGTTATTGAAGTGAAAG
>TTN-205,ENSE00003803112,1,87,3122138,3122224,TACCAGCTGTGCATACAAAGAAGATGGTTATTTCAGAAGAAAAGATGTTCTTTGCTTCTCACACAGAGGAGGAGGTGTCAGTCACAG
>TTN-205,ENSE00003811115,1,81,3122225,3122305,TCCCCGAGGTACAAAAGGAAATTGTTACTGAAGAGAAAATTCACGTTGCCATTTCCAAAAGGGTTGAACCACCACCTAAAG
>TTN-205,ENSE00003810048,1,84,3122306,3122389,TCCCTGAGCTACCTGAGAAACCAGCTCCAGAAGAAGTGGCCCCTGTTCCTATCCCTAAAAAAGTGGAGCCCCCAGCACCAAAAG
>TTN-205,ENSE00003809302,1,84,3122390,3122473,TTCCTGAGGTTCCCAAGAAACCCGTGCCAGAGGAGAAAAAGCCAGTTCCTGTGCCTAAGAAGGAACCTGCTGCTCCCCCAAAAG
>TTN-205,ENSE00003811271,1,84,3122474,3122557,TCCCAGAGGTGCCAAAGAAACCTGTCCCTGAAGAAAAGATTCCCGTTCCTGTTGCAAAGAAAAAGGAAGCTCCCCCAGCTAAAG
>TTN-205,ENSE00003811169,1,81,3122558,3122638,TTCCTGAAGTACAGAAGGGAGTTGTGACAGAAGAAAAAATAACCATTGTAACTCAAAGAGAGGAATCTCCACCACCAGCAG
>TTN-205,ENSE00003802187,1,84,3122639,3122722,TGCCAGAAATACCAAAGAAGAAAGTTCCTGAAGAAAGGAAACCTGTTCCTCGGAAGGAGGAAGAAGTTCCACCACCACCAAAAG
>TTN-205,ENSE00003810484,1,84,3122723,3122806,TGCCAGCTCTGCCTAAGAAACCCGTCCCAGAGGAGAAAGTTGCAGTGCCAGTTCCTGTCGCTAAGAAAGCTCCTCCTCCCCGAG
>TTN-205,ENSE00003810121,1,102,3122807,3122908,CTGAAGTCTCTAAGAAAACTGTTGTAGAAGAAAAGAGATTTGTTGCTGAAGAAAAACTATCCTTCGCAGTTCCTCAAAGAGTGGAAGTCACGCGGCACGAAG
>TTN-205,ENSE00003805410,1,114,3122909,3123022,TATCTGCAGAGGAGGAATGGAGTTACTCAGAAGAGGAGGAAGGTGTGTCCATTTCAGTTTATAGAGAAGAAGAAAGAGAGGAGGAGGAAGAAGCAGAGGTTACAGAATATGAAG
>TTN-205,ENSE00003801264,1,81,3123023,3123103,TGATGGAAGAGCCTGAGGAATATGTTGTGGAAGAAAAGCTGCACATTATTTCTAAGAGAGTGGAAGCTGAGCCAGCTGAAG
>TTN-205,ENSE00003805756,1,78,3123104,3123181,TGACAGAGAGGCAGGAGAAGAAAATTGTACTGAAACCAAAAATTCCTGCTAAAATAGAGGAGCCTCCACCGGCTAAAG
>TTN-205,ENSE00003808334,1,84,3123182,3123265,TTCCTGAAGCACCTAAGAAAATTGTGCCAGAAAAGAAAGTTCCTGCTCCAGTTCCTAAAAAGGAAAAGGTGCCCCCACCTAAAG
>TTN-205,ENSE00003808052,1,84,3123266,3123349,TGCCAGAAGAGCCAAAGAAACCAGTTCCAGAAAAAAAGGTTCCTCCAAAAGTCATTAAGATGGAAGAACCTCTCCCAGCCAAAG
>TTN-205,ENSE00003803067,1,84,3123350,3123433,TGACTGAGAGGCACATGCAAATTACCCAGGAAGAAAAAGTTCTTGTTGCTGTAACTAAAAAAGAGGCGCCTCCAAAAGCAAGAG
>TTN-205,ENSE00003808806,1,84,3123434,3123517,TGCCAGAGGAACCGAAGAGAGCTGTCCCAGAAGAAAAAGTTCTGAAACTCAAACCTAAAAGAGAGGAGGAACCACCAGCTAAAG
>TTN-205,ENSE00003805330,1,81,3123518,3123598,TGACTGAATTCAGAAAAAGAGTGGTTAAAGAAGAAAAAGTATCAATTGAAGCTCCAAAAAGAGAACCTCAACCCATCAAAG
>TTN-205,ENSE00003807878,1,207,3123599,3123805,AAGTAACTATAATGGAAGAGAAAGAAAGGGCTTATACCCTAGAAGAAGAAGCTGTTTCAGTACAACGGGAAGAAGAATATGAGGAATATGAAGAATATGATTATAAAGAATTTGAGGAGTATGAACCAACAGAAGAATATGACCAATATGAAGAATACGAGGAGCGGGAGTATGAACGATATGAAGAGCATGAAGAATACATCACAG
>TTN-205,ENSE00003806244,1,78,3123806,3123883,AACCAGAGAAGCCTATCCCTGTAAAGCCTGTCCCAGAAGAACCAGTTCCCACAAAACCAAAGGCCCCACCGGCTAAAG
>TTN-205,ENSE00003810594,1,75,3123884,3123958,TGCTGAAGAAAGCTGTCCCTGAAGAAAAAGTACCAGTGCCCATTCCTAAGAAACTCAAACCTCCACCACCCAAAG
>TTN-205,ENSE00003809388,1,93,3123959,3124051,TGCCTGAAGAACCAAAGAAAGTTTTTGAGGAAAAAATACGTATTTCAATTACCAAACGTGAAAAAGAGCAGGTGACTGAACCCGCTGCTAAAG
>TTN-205,ENSE00003807405,1,78,3124052,3124129,TGCCCATGAAGCCCAAGAGGGTTGTCGCAGAAGAAAAAGTACCTGTCCCTAGAAAAGAAGTAGCACCACCTGTTAGAG
>TTN-205,ENSE00003810081,1,162,3124130,3124291,TGCCAGAAGTGCCTAAAGAACTTGAACCAGAAGAGGTTGCCTTTGAAGAGGAAGTTGTAACCCATGTAGAAGAATATCTTGTAGAAGAAGAAGAAGAGTACATTCATGAAGAAGAGGAGTTCATAACTGAGGAAGAAGTGGTGCCAGTGATACCAGTCAAAG
>TTN-205,ENSE00003806496,1,84,3124292,3124375,TGCCTGAGGTACCCAGGAAACCTGTTCCAGAAGAGAAGAAACCTGTTCCTGTTCCCAAGAAGAAGGAAGCTCCACCGGCAAAAG
>TTN-205,ENSE00003802498,1,78,3124376,3124453,TGCCTGAGGTTCCTAAGAAGCCAGAGGAGAAAGTTCCTGTGCTTATTCCTAAAAAGGAGAAGCCTCCGCCAGCAAAAG
>TTN-205,ENSE00003809653,1,84,3124454,3124537,TTCCTGAAGTGCCCAAGAAACCTGTGCCAGAGGAGAAAGTACCAGTACCAGTTCCTAAAAAGGTGGAAGCTCCACCTGCCAAAG
>TTN-205,ENSE00003810862,1,84,3124538,3124621,TGCCAGAGGTACCCAAGAAGCCTGTGCCTGAGAAGAAGGTGCCAGTTCCTGCTCCTAAGAAAGTGGAGGCTCCACCTGCAAAAG
>TTN-205,ENSE00003805059,1,84,3124622,3124705,TGCCAGAGGTGCCCAAGAAGCTCATCCCAGAAGAAAAGAAACCAACACCTGTTCCGAAAAAAGTGGAAGCACCACCACCCAAAG
>TTN-205,ENSE00003801382,1,297,3124706,3125002,TGCCAAAGAAACGTGAACCAGTTCCAGTTCCTGTAGCTCTACCTCAGGAAGAGGAAGTTCTATTTGAAGAAGAAATTGTTCCTGAAGAGGAAGTTCTACCTGAGGAAGAGGAAGTTCTACCTGAGGAAGAGGAAGTTCTACCTGAAGAAGAGGAAGTTCTACCTGAAGAAGAGGAAATTCCACCTGAGGAAGAGGAAGTTCCTCCCGAAGAAGAATATGTACCTGAGGAAGAAGAATTTGTACCTGAAGAAGAAGTCCTTCCAGAAGTTAAACCTAAGGTGCCAGTACCTGCACCAG
>TTN-205,ENSE00004025982,1,87,3125003,3125089,TGCCTGAAGTGCCAAAGAAACCTGTACCAGAGAAGAAAGTCCCTGTTCCCGCCCCTAAAAAAGTGGAACCTCCACCACCACCCAAAG
>TTN-205,ENSE00003805240,1,75,3125090,3125164,TGCCTGAAATTAAGAAGAAAGTGACAGAGAAGAAAGTGGTCATTCCCAAGAAAGAGGAGGCTCCCCCTGCCAAAG
>TTN-205,ENSE00004025997,1,84,3125165,3125248,TGTCTGTGGTACCTAAGAAACCTGAGCCAGAAAAGAAGGTCCCTCCTCCTGGTCTTAAGAAAGCAGTGGCCCCTCCTGCCAAAG
>TTN-205,ENSE00003804875,1,75,3125249,3125323,TTCCTGAGGTGCCTAAGAAGGTGGAAGAAAAACGAATCATTCTCCCTAAAGAAGAGGAAGTTCTACCAGTTGAAG
>TTN-205,ENSE00003801552,1,96,3125324,3125419,TGACTGAGGAGCCTGAAGAAGAGCCTATTTCAGAAGAAGAAATCCCAGAAGAACCACCTAGCATAGAGGAAGTTGAAGAGGTGGCACCACCTAGAG
>TTN-205,ENSE00003804385,1,78,3125420,3125497,TGCCTGAAGTGATTAAGAAAGCAGTACCTGAAGCACCTACTCCTGTTCCTAAAAAAGTGGAGGCACCACCAGCTAAAG
>TTN-205,ENSE00003805135,1,69,3125498,3125566,TGTCAAAGAAAATTCCTGAGGAAAAAGTACCTGTTCCTGTTCAGAAAAAAGAGGCACCCCCAGCCAAAG
>TTN-205,ENSE00003808243,1,75,3125567,3125641,TGCCTGAAGTACCAAAGAAAGTCCCAGAAAAGAAAGTCCTTGTGCCTAAAAAGGAAGCTGTTCCCCCAGCTAAAG
>TTN-205,ENSE00003808353,1,297,3125642,3125938,GGAGAACTGTCCTTGAAGAAAAAGTATCAGTTGCCTTCCGCCAAGAAGTAGTAGTAAAAGAAAGACTAGAATTAGAAGTAGTAGAAGCAGAAGTGGAAGAAATTCCGGAAGAAGAAGAGTTCCATGAAGTTGAAGAATATTTTGAAGAAGGCGAGTTTCATGAAGTAGAAGAATTCATCAAATTAGAACAACATAGAGTTGAAGAAGAACACAGAGTTGAAAAAGTTCATAGGGTAATAGAAGTTTTTGAGGCTGAAGAAGTGGAAGTATTTGAAAAACCAAAAGCTCCACCTAAAG
>TTN-205,ENSE00003807571,1,81,3125939,3126019,GGCCTGAGATATCTGAGAAAATCATCCCTCCAAAAAAACCGCCCACTAAAGTTGTTCCTCGAAAAGAGCCACCAGCTAAAG
>TTN-205,ENSE00003808118,1,78,3126020,3126097,TACCGGAGGTGCCTAAGAAAATTGTGGTAGAAGAAAAAGTACGTGTTCCTGAAGAGCCCAGAGTTCCACCAACTAAAG
>TTN-205,ENSE00004025978,1,84,3126098,3126181,CACCCGAAGTACCCAAGAAAATTGTCCCAGAAGAAAAAGTTCGTGAAGCTGTTCTGAAAAAGCCTGAAGTTCCACCAGCTAAAG
>TTN-205,ENSE00004026002,1,75,3126182,3126256,TTCCTGGGATGCCTAAGAAAAGTGTTCAAGAAGAAAAATCACCTATTGTTATTTCTGAAGACACAGAGATGTACA
>TTN-205,ENSE00004025998,1,84,3126257,3126340,TTTATGAAGCATCTGAAGAAGCAGTCCTAGAAGAAAAAGTACTTGTGACTCAACCTCAAAAGACAAAACCCAAACTAGCAAAAG
>TTN-205,ENSE00004025971,1,84,3126341,3126424,TGCCTGAGCCACCCAAGAAAGTTGTTCCAGAAGACAAAATATATGTGACTATTCCTAAAAAGAGAGAAACACCAGCAACTAAAG
>TTN-205,ENSE00001725280,1,84,3126425,3126508,AACCTGATACAACCAGAGGCATTTTTCCAGAGGTGGAGCCACCTGAGGCTATTCCTGAAATTCCAGAACATCCTCCAACTGAAG
>TTN-205,ENSE00004024308,1,78,3126509,3126586,AGTTTGAAGTCTTCAAGGAAGTCATTCCAGAGGGAGAAACTCCTATTGTTAAAAGAAGAAAAACACCATCACCAACAG
>TTN-205,ENSE00004025995,1,84,3126587,3126670,TGCCTGAATCACCTCGAGAAATTGTCCCTGTAAAGGAAACACCCATGGCTGCTCCCCTTGAAATTGAAATACCTCCCACTAAAG
>TTN-205,ENSE00004024272,1,84,3126671,3126754,CACCAGAAGCTATGAAAGAAGTTGTCCCTGAAATGAAAATATTTGAGGATGTACCTGAAGAGCCAGAAACTCCACGTATGAAAA
>TTN-205,ENSE00004024280,1,75,3126755,3126829,CGCCCGAAGCTCCTCAAGAAATTATTCCTGCCAAGACAGTTCCTTCCAAAAAAAGAGAACCCCCATCAGTTAAAG
>TTN-205,ENSE00004024279,1,84,3126830,3126913,TGCCTGAAGCTCTCCAAGAAATTGTCCCTGAAAAGAAAACGCTTGTGGTTCCTCTCAGAAAGCCTGAAGTCCTTCCTGATGAAG
>TTN-205,ENSE00004024286,1,78,3126914,3126991,TGCCGGAGGCTCTCAGAGAAGTTGTCCCGGAAAAGAAAGTGCATCCTCCCCAAAGGGCTGAAGTTGTACCTGTCAAAG
>TTN-205,ENSE00004024310,1,84,3126992,3127075,TGCACGAAGCTCCCAAAGAGATTATCCCTGAAAAGAAAGTGTCGGTGGTGCCTCCTAAAAAGCCTGAAGTCCCACCTGTTAAAG
>TTN-205,ENSE00004024305,1,84,3127076,3127159,TGCCAGAAGCTTCCAAAGAGGTTATCCGCGAAGAGAAAGTGCCCTTGGCTCCTCCTAAAGAGCCTGAAGTCCCACCTGTTAAAG
>TTN-205,ENSE00004024294,1,84,3127160,3127243,TACCAGAGCCTCCCAAAGAAGTAGTTCCTGAAAAGAAAGCGCCAGTGGCTCCTCCTAAAGAGCCTGAAGTCCCACCTGTTAAAG
>TTN-205,ENSE00004025974,1,84,3127244,3127327,TGCCTGAGGCTCCCAAAGAAGTTGTTCCTGAAAAGAAAGTGCCAGTGCCTCCTCCTAAAAAGCCTGAAGTGCCACCCACAAAAG
>TTN-205,ENSE00004025967,1,84,3127328,3127411,TCCCAGAGGTGCCAAAGGCAGCTGTCCCAGAAAAGAAGTTGCCTGAAGCTATTCCTCCCAAACCGGAAAGTCCTCCCCCTGAAG
>TTN-205,ENSE00003807304,1,90,3127412,3127501,TGCCTGAAGTGCTGCCACCGAAGGAAGTGGTCCCAGAAAAGAAAGTACCGGTGCCTCCTGCCAAAAAGCCAGAAGCTCCACCTCCTAAAG
>TTN-205,ENSE00004026001,1,84,3127502,3127585,TTCCTGAAGCTCCTAAAGAAGTTGTACTTGAAAAGAAAGCATCTGTGGCTGTGCCCAAAAAACCGGAAGCCCCACGTGCAAAAG
>TTN-205,ENSE00004025988,1,84,3127586,3127669,TGCCTGAAGCTGCTCAAGAAGTTGTCCCAGAAAAGAAAATTCCCAAGGCACCAATCAAAAAACCAGAAGCCCCCGCAGTTACAG
>TTN-205,ENSE00004025983,1,81,3127670,3127750,TGCCAGAAGTTCCTCAAGAAGCCACAGAAAAAGAAATTCCCGTGGCTCCACCCAAAAAACCAGAAGCTCCAATTGTCCCAG
>TTN-205,ENSE00004025976,1,81,3127751,3127831,TGCCTGAAGCTCAAGAAGTTGTCCCAGAAAAGAAAGTTCCTAAGGCTCCTCCCACAAAACCAGAAGCCCCACCTGCCACAG
>TTN-205,ENSE00004025986,1,81,3127832,3127912,TGCCTGAAGTCCCACAAGAAATTGTGCCAGAAAAGAAAACACTGGTGCTTCCTAAAAAGCCAGAAGTTCCACCTGTTACAG
>TTN-205,ENSE00004025969,1,84,3127913,3127996,TGCCAGAGGCTCCCAAAGAAGTTGTCCTTGAAAAGAAAGTGCCCTCGGCTCCTCCTAAAAAGCCTGAAGTCCCACCTGTTAAAG
>TTN-205,ENSE00003802745,1,84,3127997,3128080,TGCCTGAGGCTCCCAAAGAAGTTGTTCCTGAAAAGAAAGTGCCAGTGCCTCCTCCTAAAAAGCCTGAAGTGCCACCCACAAAAG
>TTN-205,ENSE00003809569,1,84,3128081,3128164,TCCCAGAGGTGCCAAAGGCAGCTGTCCCAGAAAAGAAGGTGCCTGAAGCTATTCCTCCCAAACCGGAAAGTCCTCCCCCTGAAG
>TTN-205,ENSE00004025984,1,90,3128165,3128254,TGCCTGAAGTGCTGCCACCGAAGGAAGTGGTCCCAGAAAAGAAAGTACCGGTGCCTCCTGCCAAAAAGCCAGAAGCTCCACCTCCTAAAG
>TTN-205,ENSE00004026000,1,84,3128255,3128338,TTCCTGAAGCTCCTAAAGAAGTTGTACTTGAAAAGAAAGCATCTGTGGCTGTGCCCAAAAAACCGGAAGCCCCACGTGCAAAAG
>TTN-205,ENSE00004025966,1,84,3128339,3128422,TGCCTGAAGCTGCTCAAGAAGTTGTCCCAGAAAAGAAAATTCCCAAGGCACCAATCAAAAAACCAGAAGCCCCCGCAGTTACAG
>TTN-205,ENSE00004025973,1,81,3128423,3128503,TGCCAGAAGTTCCTCAAGAAGCCGCAGAAAAAGAAATTCCCGTGGCTCCACCCAAAAAACCAGAAGCTCCGATTGTCCCAG
>TTN-205,ENSE00004025979,1,81,3128504,3128584,TGCCTGAAGCTCAAGAAGTTGTCCCAGAAAAGAAAGTTCCTAAGGCTCCTCCCACAAAACCAGAAGCCCCACCTGCCACAG
>TTN-205,ENSE00004025981,1,81,3128585,3128665,TGCCTGAAGTCCCACAAGAAATTGTGCCAGAAAAGAAAACACTGGTGCTTCCTAAAAAGCCAGAAGTTCCACCTGTTACAG
>TTN-205,ENSE00004025970,1,84,3128666,3128749,TGCCAGAGGCTCCCAAAGAAGTTGTCCTTGAAAAGAAAGTGCCCTCGACTCCTCCTAAAAAGCCTGAAGTCCCACCTGTTAAAG
>TTN-205,ENSE00004025993,1,84,3128750,3128833,TGCCTGAGGCTCCCAAAGAAGTTGTTCCTGAAAAGAAAGTGCCAGTGCCTCCTCCTAAAAAGCCTGAAGTGCCACCCACAAAAG
>TTN-205,ENSE00004025989,1,84,3128834,3128917,TCCCAGAGGTGCCAAAGGCAGCTGTCCCAGAAAAGAAGGTGCCTGAAGCTATTCCTCCCAAACCGGAAAGTCCTCCCCCTGAAG
>TTN-205,ENSE00004025987,1,90,3128918,3129007,TGCCTGAAGTGCTGCCACCGAAGGAAGTGGTCCCAGAAAAGAAAGTACCGGTGCCTCCTGCCAAAAAGCCAGAAGCTCCACCTCCTAAAG
>TTN-205,ENSE00004025975,1,84,3129008,3129091,TTCCTGAAGCTCCTAAAGAAGTTGTACTTGAAAAGAAAGTATCTGTGGCTGTGCCCAAAAAACCGGAAGCCCCACGTGCAAAAG
>TTN-205,ENSE00004026003,1,84,3129092,3129175,TGCCTGAAGCTGCTCAAGAAGTTGTCCCAGAAAAGAAAATTCCCAAGGCACCAATCAAAAAACCAGAAGCCCCCGCAGTTACAG
>TTN-205,ENSE00004025980,1,81,3129176,3129256,TGCCAGAAGTTCCTCAAGAAGCCGCAGAAAAAGAAATTCCCGTGGCTCCACCCAAAAAACCAGAAGCTCCAATTGTCCCAG
>TTN-205,ENSE00004025994,1,81,3129257,3129337,TGCCTGAAGCTCAAGAAGTTGTCCCAGAAAAGAAAGTTCCTAAGGCTCCTCCCACAAAACCAGAAGCCCCACCTGCCACAG
>TTN-205,ENSE00004025996,1,81,3129338,3129418,TGCCTGAAGTCCCACAAGAAATTGTGCCAGAAAAGAAAACACTGGTGCTTCCTAAAAAGCCAGAAGTTCCACCTGTTACAG
>TTN-205,ENSE00004025990,1,84,3129419,3129502,TGCCAGAGGCTCCCAAAGAAGTTGTCCTTGAAAAGAAAGTGCCCTTGGCTCCTCCTAAAAAGCCTGAAGTCCCACCTGTTAAAG
>TTN-205,ENSE00004026004,1,84,3129503,3129586,TGCCAGAGGCTCCCAAAGAAGTTGTTCCTGAAAAGAAAGTGCCAGTGACTCCTCCTAAAAAACCTGAAGTCCCACCTGTTAAAG
>TTN-205,ENSE00004025977,1,84,3129587,3129670,TGCCAGAGGCTCCCATAGAGGTTGTTCCTGAAAAGAAAATGCCCTTGGCTCCTCCTAAAAAGCCTGAAGTCCCTCCTGTTAAAG
>TTN-205,ENSE00004025991,1,84,3129671,3129754,TACCAGAGGCTCCCAAAGAGGTTGTTCCTGAAAAGAAAGTGCCCTCGGCTCCTCCTAAAAAGCCTGAAGTCCCACCTGTTAAAG
>TTN-205,ENSE00003806373,1,84,3129755,3129838,TGCCAGAGGCTCCGAAAGAAGTTGTTCCTGAAAAGAAAGTGCCAGCGGCTCCTCCTAAAAAGCCTGAAGTCACACCTGTTAAAG
>TTN-205,ENSE00003807489,1,84,3129839,3129922,TGCCTGAGGCTCCCAAAGAAGTTGTTCCTGAAAAGAAAGTGCCAGTGCCTCCTCCTAAAAAGCCTGAAGTGCCACCCACAAAAG
>TTN-205,ENSE00003805050,1,84,3129923,3130006,TCCCAGAGGTGCCAAAGGTAGCTGTCCCAGAAAAGAAGGTGCCTGAAGCTATTCCTCCCAAACCGGAAAGTCCTCCCCCTGAAG
>TTN-205,ENSE00003808824,1,84,3130007,3130090,TGTTCGAGGAGCCTGAGGAAGTTGCCCTAGAAGAGCCTCCTGCTGAAGTTGTGGAAGAGCCAGAGCCAGCGGCGCCTCCACAAG
>TTN-205,ENSE00003807203,1,84,3130091,3130174,TGACCGTACCACCTAAGAAACCTGTCCCAGAAAAGAAAGCACCTGCTGTCGTTGCCAAAAAACCTGAACTACCACCAGTGAAAG
>TTN-205,ENSE00003811260,1,84,3130175,3130258,TGCCCGAGGTGCCCAAGGAGGTTGTTCCTGAAAAGAAGGTGCCTCTGGTGGTTCCCAAAAAGCCAGAAGCCCCACCTGCTAAAG
>TTN-205,ENSE00003806229,1,78,3130259,3130336,TGCCTGAAGTTCCAAAAGAAGTTGTTCCAGAAAAGAAAGTAGCTGTTCCCAAAAAGCCAGAAGTCCCACCAGCAAAAG
>TTN-205,ENSE00003807893,1,84,3130337,3130420,TGCCAGAAGTGCCAAAGAAACCTGTCTTGGAAGAGAAACCAGCTGTTCCTGTTCCAGAAAGAGCGGAGTCTCCTCCCCCAGAAG
>TTN-205,ENSE00003809515,1,108,3130421,3130528,TATATGAAGAACCTGAGGAAATTGCTCCTGAAGAGGAAATTGCTCCTGAAGAGGAAAAGCCAGTTCCTGTTGCAGAAGAGGAGGAACCAGAGGTTCCACCTCCAGCAG
>TTN-205,ENSE00003804845,1,78,3130529,3130606,TGCCTGAAGAGCCCAAGAAGATCATCCCAGAGAAGAAAGTTCCTGTCATCAAAAAACCAGAAGCACCGCCTCCTAAAG
>TTN-205,ENSE00004025992,1,78,3130607,3130684,AACCTGAGATGCCAAAGAAAGTTGTTCCAGTGAAGAAGGTCCCAACTGTTAAGAAGCCAGAAACACCAGCAGCTAAAG
>TTN-205,ENSE00004025972,1,84,3130685,3130768,TGCCTGAGGTGCCCAAGAAACTTGTTCCAGTAAAGAAAGAACCTGTGCCTGTTACCAAAAAACCAGAAGTTCTTCCAGAAAAAG
>TTN-205,ENSE00004025968,1,84,3130769,3130852,TGCCCAAAGTGCCTGAGAAAATCATCCCAGAAAAGGAAGTGTCTGTGCCTATCCCTGCAGAGCCAGAAGTTCCACCTGCTGAAG
>TTN-205,ENSE00004025985,1,81,3130853,3130933,TTGAAGAGACTCCTGAGGAAATAATATATGAAGAAAAAGCATCTATAACCATTGGTAGAAAAGAGACTCCCCCTGTTGAAG
>TTN-205,ENSE00004025999,1,75,3130934,3131008,AACGTGAAATTGAAAAGTATATTAAACCTGAAGAGCCCGAACCTGAACCACAGCCTGAAGAAATACCAGTAAAAG
>TTN-205,ENSE00003806702,1,111,3131009,3131119,AACCTGAACCTGAAAAGGTTATTGAGAAGCCAAAACTCAAACCAAGACCCCCACCTCCTCCACCTGCTCCACCTAAGGAAGATGTGAAGGAGAAAATATTCCAACTTAAAG
>TTN-205,ENSE00003809179,1,69,3131120,3131188,CTATTCCAAAGAAGAAAGTTCCTGAAAAACCTCAGGTTCCAGAAAAAGTGGAGCTTACACCTCTGAAAG
>TTN-205,ENSE00003804802,1,81,3131189,3131269,TGCCTGGAGGTGAAAAGAAAGTTCGCAAATTACTTCCGGAACGTAAACCTGAACCAAAGGAAGAAGTTGTTCTGAAAAGCG
>TTN-205,ENSE00003811452,1,75,3131270,3131344,TTCTAAGAAAAAGACCTGAAGAAGAAGAACCTAAAGTAGAACCTAAAAAACTAGAAAAAGTTAAAAAACCTGCAG
>TTN-205,ENSE00003807205,1,90,3131345,3131434,TACCAGAACCACCACCTCCAAAACCTGTTGAAGAGGTTGAAGTACCTACTGTTACAAAAAGGGAAAGGAAGATTCCTGAACCAACAAAAG
>TTN-205,ENSE00003806747,1,63,3131435,3131497,TGCCTGAAATCAAGCCAGCAATACCTCTCCCTGCACCTGAACCGAAACCAAAGCCCGAAGCAG
>TTN-205,ENSE00003810755,1,90,3131498,3131587,AAGTGAAAACAATCAAACCACCTCCTGTGGAACCTGAACCAACCCCCATCGCTGCCCCAGTAACAGTGCCAGTGGTTGGAAAGAAAGCAG
>TTN-205,ENSE00003806122,1,51,3131588,3131638,AAGCCAAAGCACCTAAGGAAGAGGCTGCCAAGCCAAAAGGTCCTATCAAAG
>TTN-205,ENSE00003804858,1,402,3131639,3132040,GTGTACCCAAAAAGACTCCTTCACCAATAGAAGCCGAAAGGAGAAAGTTAAGGCCAGGAAGTGGTGGAGAGAAACCTCCTGATGAAGCCCCGTTCACCTACCAGCTAAAGGCTGTGCCACTGAAGTTTGTGAAAGAAATCAAAGACATCATCTTGACAGAATCAGAGTTCGTTGGCTCTTCAGCAATCTTTGAATGTTTGGTCTCCCCTTCCACTGCAATTACAACCTGGATGAAAGACGGTAGCAATATCCGTGAGAGTCCCAAGCACAGGTTTATTGCAGATGGTAAAGACAGAAAGCTGCACATCATTGATGTTCAACTTTCCGATGCTGGTGAATACACCTGTGTTTTACGTTTGGGAAACAAAGAAAAGACCTCCACGGCTAAACTTGTTGTAGAAG
>TTN-205,ENSE00003803996,1,279,3132041,3132319,AACTTCCTGTGCGTTTTGTAAAAACACTGGAAGAGGAAGTCACAGTGGTCAAAGGACAGCCATTGTACTTGAGCTGCGAGTTAAACAAAGAGCGTGACGTGGTCTGGAGGAAGGATGGCAAGATTGTGGTGGAGAAACCTGGCCGAATTGTGCCAGGCGTCATTGGCTTGATGCGGGCTCTGACCATCAACGATGCAGATGACACAGATGCTGGAACATACACAGTTACTGTGGAAAACGCCAACAACCTGGAGTGTTCATCTTGCGTAAAAGTAGTAG
>TTN-205,ENSE00003807976,1,276,3132320,3132595,AAGTCATTAGAGATTGGCTGGTGAAACCTATACGAGACCAGCATGTGAAACCCAAGGGGACAGCTATTTTTGCCTGTGATATAGCAAAAGATACTCCAAACATTAAGTGGTTCAAAGGATATGATGAAATCCCTGCGGAACCAAATGATAAGACTGAAATACTGAGAGATGGAAATCATCTGTACCTCAAAATTAAGAATGCTATGCCAGAAGATATTGCTGAGTATGCAGTGGAAATTGAAGGAAAAAGATACCCTGCAAAGCTGACACTTGGAG
>TTN-205,ENSE00003804328,1,140,3132596,3132735,AGCGTGAAGTTGAACTGCTTAAACCAATAGAGGACGTTACCATTTATGAGAAAGAAAGTGCAAGCTTTGATGCAGAAATCTCAGAGGCAGACATTCCTGGACAATGGAAACTGAAAGGAGAACTTCTAAGGCCCTCACCT
>TTN-205,ENSE00003802254,1,127,3132736,3132862,ACTTGTGAAATCAAAGCAGAAGGTGGAAAACGCTTCTTAACTTTGCACAAAGTCAAACTGGACCAAGCTGGTGAAGTCCTCTACCAGGCCCTTAATGCAATTACAACTGCCATTTTGACAGTAAAAG
>TTN-205,ENSE00003811410,1,264,3132863,3133126,AAATCGAACTTGACTTTGCTGTGCCCCTGAAGGATGTCACTGTTCCAGAAAGGCGACAGGCTCGATTCGAATGTGTCCTCACCCGAGAGGCAAATGTTATATGGTCCAAAGGACCTGATATAATTAAGTCATCTGACAAATTTGATATCATCGCTGATGGAAAGAAACATATTCTTGTTATTAATGATTCTCAATTTGATGATGAAGGGGTCTATACTGCTGAGGTGGAGGGCAAGAAGACCTCAGCTCGGTTGTTTGTCACAG
>TTN-205,ENSE00003805150,1,267,3133127,3133393,GTATAAGACTGAAATTCATGTCACCTCTTGAAGATCAAACAGTAAAAGAAGGTGAAACAGCAACTTTTGTTTGTGAACTTTCTCATGAAAAAATGCATGTAGTCTGGTTCAAAAATGATGCCAAACTCCATACAAGCAGAACAGTACTCATCTCTTCTGAGGGCAAGACTCACAAATTGGAAATGAAAGAAGTGACATTGGATGATATATCTCAGATAAAAGCTCAAGTCAAGGAGCTGAGCTCCACAGCACAGCTGAAGGTCTTAG
>TTN-205,ENSE00003801907,1,264,3133394,3133657,AGGCCGATCCCTACTTCACTGTGAAATTACATGACAAAACTGCAGTGGAGAAGGATGAGATTACTTTGAAGTGTGAAGTGAGCAAAGATGTACCAGTGAAATGGTTCAAAGATGGTGAAGAGATTGTCCCTTCACCCAAATATTCTATCAAGGCAGATGGCCTGCGCCGCATCTTAAAAATCAAAAAGGCGGACCTTAAAGATAAAGGCGAATATGTGTGTGACTGTGGCACAGACAAGACCAAGGCAAATGTTACTGTTGAGG
>TTN-205,ENSE00003802031,1,140,3133658,3133797,CTCGACTAATAAAAGTGGAAAAGCCTCTGTACGGAGTAGAGGTGTTTGTTGGTGAAACAGCCCACTTTGAAATTGAACTTTCTGAACCTGATGTTCACGGCCAGTGGAAGCTGAAAGGACAGCCTTTGACAGCTTCCCCT
>TTN-205,ENSE00003811443,1,127,3133798,3133924,GACTGTGAAATCATTGAGGATGGAAAGAAGCATATTCTGATCCTTCATAACTGTCAGCTGGGTATGACAGGAGAGGTTTCCTTCCAGGCTGCTAATGCCAAATCTGCAGCCAATCTGAAAGTGAAAG
>TTN-205,ENSE00003811384,1,267,3133925,3134191,AATTGCCTCTTATCTTCATCACACCTCTCAGTGATGTTAAAGTCTTCGAGAAAGATGAGGCTAAGTTTGAGTGTGAAGTATCCAGGGAGCCCAAAACATTCCGTTGGCTAAAAGGAACCCAGGAAATCACAGGTGATGACAGATTTGAGCTTATAAAGGATGGCACTAAGCATTCAATGGTGATCAAGTCAGCTGCTTTTGAAGATGAAGCAAAATACATGTTTGAAGCTGAAGATAAGCACACAAGTGGCAAACTGATCATTGAAG
>TTN-205,ENSE00003801954,1,267,3134192,3134458,GAATCCGGCTCAAATTCCTCACCCCTCTCAAAGATGTAACTGCCAAAGAGAAGGAAAGTGCTGTATTTACTGTGGAGTTATCTCATGATAACATCCGAGTTAAATGGTTCAAGAATGACCAGCGCCTACACACCACCAGGTCGGTCTCAATGCAAGACGAAGGGAAAACTCATTCGATCACATTCAAAGACCTGTCTATTGATGACACCTCCCAAATTAGAGTAGAAGCTATGGGGATGAGTTCAGAAGCTAAACTCACTGTGCTTG
>TTN-205,ENSE00003809996,1,267,3134459,3134725,AGGGAGACCCATATTTTACAGGAAAACTTCAAGATTATACTGGTGTAGAGAAAGATGAAGTTATTCTACAGTGTGAAATTAGCAAAGCAGATGCACCAGTGAAATGGTTTAAGGATGGGAAGGAAATAAAGCCATCCAAAAATGCTGTTATTAAGGCAGATGGCAAGAAACGCATGCTAATCCTAAAGAAAGCCTTGAAATCAGATATTGGACAGTACACCTGTGACTGTGGGACAGATAAGACCTCAGGAAAACTTGACATTGAGG
>TTN-205,ENSE00003804589,1,140,3134726,3134865,ATCGGGAAATTAAACTGGTGCGACCCCTGCACAGTGTGGAGGTGATGGAGACTGAGACAGCACGCTTTGAAACCGAAATCTCTGAAGATGATATCCACGCCAACTGGAAACTCAAGGGAGAGGCCCTACTCCAAACACCT
>TTN-205,ENSE00003805931,1,127,3134866,3134992,GATTGTGAAATTAAGGAAGAAGGCAAAATACACTCCCTTGTTTTGCACAACTGTCGCCTGGACCAGACGGGTGGGGTGGATTTCCAAGCTGCCAATGTTAAATCTAGTGCCCACCTCCGAGTTAAGC
>TTN-205,ENSE00003811344,1,143,3134993,3135135,CACGAGTAATTGGTCTTCTGAGGCCTTTAAAGGATGTCACCGTGACTGCAGGGGAAACAGCCACCTTCGACTGCGAGCTCTCCTACGAAGATATCCCAGTGGAATGGTATCTCAAAGGGAAGAAACTAGAGCCCAGCGATAAG
>TTN-205,ENSE00003802375,1,124,3135136,3135259,GTGGTCCCACGTTCAGAAGGAAAAGTTCATACACTTACTCTGAGGGATGTAAAGTTAGAAGATGCTGGGGAAGTCCAACTAACAGCAAAAGATTTCAAAACTCACGCCAACCTCTTTGTGAAAG
>TTN-205,ENSE00003806733,1,267,3135260,3135526,AACCCCCAGTTGAATTCACTAAGCCTCTTGAGGACCAGACGGTCGAAGAGGGAGCCACTGCAGTGCTGGAGTGTGAAGTCTCCAGAGAAAATGCTAAGGTGAAATGGTTCAAAAATGGGACAGAAATCCTCAAAAGCAAGAAGTATGAAATTGTTGCTGATGGCAGGGTCAGAAAACTTGTTATACATGACTGTACCCCAGAGGATATTAAAACATACACTTGTGATGCTAAGGATTTTAAGACTTCCTGTAACCTGAATGTCGTGC
>TTN-205,ENSE00003807497,1,98,3135527,3135624,CTCCTCATGTGGAATTCTTAAGACCACTCACCGACCTTCAAGTTAGAGAAAAAGAAATGGCTCGATTTGAGTGTGAACTTTCCCGAGAAAATGCTAAG
>TTN-205,ENSE00003802530,1,169,3135625,3135793,GTTAAGTGGTTTAAAGATGGTGCTGAAATTAAAAAGGGCAAAAAATATGACATCATATCCAAGGGAGCAGTGCGCATTCTTGTCATCAACAAATGTCTACTGGATGATGAAGCTGAATATTCCTGTGAAGTAAGGACAGCGAGAACTTCTGGCATGCTGACAGTTCTGG
>TTN-205,ENSE00003811387,1,267,3135794,3136060,AAGAAGAAGCTGTCTTTACCAAAAATCTTGCCAACATTGAAGTTAGTGAAACAGACACTATAAAACTGGTTTGTGAAGTCTCCAAACCTGGCGCAGAAGTGATTTGGTATAAAGGGGATGAGGAGATCATTGAAACAGGAAGATATGAAATACTGACTGAAGGACGGAAGAGAATCCTGGTCATTCAGAACGCTCACCTTGAGGATGCTGGCAACTACAACTGTCGACTCCCAAGCTCTCGAACCGATGGCAAAGTCAAAGTACATG
>TTN-205,ENSE00003802653,1,267,3136061,3136327,AACTGGCTGCTGAATTTATCTCAAAGCCTCAAAACCTTGAAATACTTGAAGGAGAAAAGGCTGAATTTGTCTGCTCTATATCAAAAGAAAGCTTTCCAGTCCAGTGGAAGAGGGATGATAAGACACTTGAATCTGGAGATAAATATGACGTTATTGCTGATGGTAAAAAGAGGGTCCTAGTTGTGAAAGATGCCACATTACAAGATATGGGCACTTACGTTGTCATGGTAGGGGCCGCCAGAGCAGCAGCTCACTTGACAGTCATTG
>TTN-205,ENSE00003802540,1,279,3136328,3136606,AAAAACTCAGGATCGTAGTTCCTCTTAAGGACACCCGGGTGAAGGAACAACAGGAAGTTGTCTTCAACTGTGAAGTCAATACTGAAGGTGCCAAAGCCAAATGGTTCAGAAATGAAGAAGCTATATTTGATAGTTCAAAATACATCATTCTCCAAAAAGACCTAGTCTACACCCTCAGAATTAGAGATGCACACTTAGATGACCAAGCCAACTATAATGTGTCTTTGACCAATCACAGAGGTGAAAATGTTAAAAGTGCAGCCAATCTAATAGTAGAAG
>TTN-205,ENSE00003802874,1,409,3136607,3137015,AGGAAGACCTTAGGATTGTTGAGCCTCTTAAAGATATTGAAACAATGGAGAAGAAATCTGTCACATTCTGGTGCAAGGTGAATCGTCTCAATGTAACACTGAAGTGGACCAAAAATGGTGAAGAAGTGCCTTTTGACAACCGTGTCTCATACAGAGTTGATAAGTACAAGCACATGTTAACCATTAAAGACTGTGGCTTCCCAGATGAAGGTGAATACATTGTCACTGCTGGACAAGATAAATCTGTTGCTGAGCTTCTCATCATAGAAGCCCCGACAGAATTTGTGGAACACTTGGAAGATCAGACAGTCACTGAGTTCGATGACGCTGTCTTCTCCTGCCAGCTCTCCAGAGAGAAAGCCAATGTAAAATGGTACAGAAATGGGAGAGAAATCAAAGAAGGCAAAAA
>TTN-205,ENSE00003804130,1,125,3137016,3137140,ATACAAATTTGAAAAAGATGGAAGTATACACAGACTCATTATAAAAGATTGCAGGCTGGATGATGAGTGTGAATATGCTTGCGGGGTAGAAGACAGGAAGTCTCGTGCTAGACTTTTTGTGGAAG
>TTN-205,ENSE00003807647,1,267,3137141,3137407,AAATTCCTGTTGAGATCATCAGGCCTCCACAAGATATTCTTGAAGCCCCTGGTGCTGATGTTGTCTTTTTAGCAGAACTCAATAAAGATAAGGTGGAAGTCCAATGGCTAAGAAATAACATGGTTGTTGTCCAGGGTGATAAACACCAGATGATGAGTGAAGGAAAGATACATCGACTACAGATTTGTGATATTAAGCCCCGTGACCAGGGTGAATACAGATTTATTGCCAAAGACAAAGAAGCCAGAGCTAAGCTTGAACTGGCAG
>TTN-205,ENSE00003802353,1,270,3137408,3137677,CTGCACCAAAAATCAAGACAGCTGACCAAGACCTTGTGGTTGATGTTGGCAAGCCTCTGACAATGGTGGTGCCATATGATGCCTACCCCAAAGCAGAAGCTGAATGGTTTAAAGAAAATGAACCTTTATCTACAAAAACCATTGATACTACGGCTGAACAAACTTCTTTCAGAATTTTAGAAGCCAAGAAAGGAGACAAAGGGAGGTATAAAATTGTGCTTCAGAACAAACATGGAAAAGCAGAAGGATTCATCAATTTAAAAGTTATTG
>TTN-205,ENSE00003809195,1,303,3137678,3137980,ATGTTCCTGGGCCAGTACGTAACTTAGAAGTGACAGAAACATTTGATGGTGAAGTGAGCCTTGCTTGGGAAGAACCTTTAACTGATGGTGGAAGCAAAATCATAGGTTACGTTGTTGAAAGACGTGACATTAAGAGAAAGACCTGGGTTCTGGCCACAGACCGTGCAGAGAGTTGTGAGTTTACTGTCACTGGTCTACAGAAAGGAGGAGTTGAGTACCTATTCCGTGTGAGTGCAAGAAACAGAGTTGGCACTGGTGAGCCAGTAGAAACTGACAATCCTGTAGAAGCAAGGAGTAAATATG
>TTN-205,ENSE00003803170,1,303,3137981,3138283,ATGTTCCAGGCCCTCCTTTGAATGTAACCATCACTGATGTGAATCGATTTGGTGTCTCACTGACATGGGAACCACCAGAGTATGATGGAGGTGCTGAGATCACAAACTACGTCATTGAATTAAGAGACAAGACTTCTATCAGGTGGGATACTGCCATGACTGTGAGAGCTGAAGACCTGTCTGCAACTGTTACTGATGTGGTAGAAGGACAGGAGTACAGTTTCCGAGTGAGAGCCCAAAATCGAATTGGAGTTGGAAAACCAAGTGCAGCCACACCCTTCGTCAAAGTTGCTGATCCAATTG
>TTN-205,ENSE00003806295,1,188,3138284,3138471,AGAGACCAAGTCCTCCTGTAAACCTAACTTCCTCAGATCAGACTCAGTCATCAGTTCAGCTCAAATGGGAACCTCCTCTGAAAGATGGAGGAAGCCCAATATTAGGCTATATAATTGAGCGATGCGAAGAAGGAAAAGATAATTGGATTCGTTGCAATATGAAACTTGTCCCTGAACTGACTTACAAG
>TTN-205,ENSE00003810732,1,115,3138472,3138586,GTTACCGGATTGGAAAAAGGAAATAAATATTTATATAGAGTATCTGCAGAAAATAAAGCTGGTGTTTCAGATCCATCTGAAATTCTTGGTCCTCTCACCGCTGACGATGCATTTG
>TTN-205,ENSE00003809985,1,285,3138587,3138871,TTGAACCAACAATGGATTTAAGTGCATTTAAAGATGGTCTGGAAGTTATTGTCCCAAATCCTATCACGATCCTGGTTCCAAGTACAGGCTATCCAAGGCCAACTGCAACCTGGTGTTTTGGAGATAAAGTACTAGAAACAGGGGACCGGGTGAAAATGAAGACCTTGTCTGCCTATGCCGAACTTGTCATTTCTCCAAGTGAACGTTCAGACAAGGGCATTTATACACTGAAATTAGAAAACCGTGTGAAAACAATTTCTGGGGAAATTGATGTCAATGTAATTG
>TTN-205,ENSE00003808828,1,152,3138872,3139023,CTCGCCCAAGTGCACCCAAAGAATTGAAATTTGGTGATATAACCAAGGACTCAGTACATTTGACTTGGGAACCACCTGATGATGATGGAGGAAGTCCGTTAACTGGATACGTTGTTGAAAAACGAGAAGTCAGCCGGAAAACATGGACTAAA
>TTN-205,ENSE00003803811,1,148,3139024,3139171,GTTATGGACTTTGTGACTGATCTAGAATTCACAGTTCCTGATCTTGTTCAAGGAAAAGAGTACTTATTTAAAGTTTGTGCTCGTAACAAATGTGGCCCTGGAGAACCTGCATATGTTGATGAACCTGTAAATATGTCAACTCCTGCAA
>TTN-205,ENSE00003803944,1,178,3139172,3139349,CGGTACCTGACCCACCAGAGAATGTTAAATGGAGAGATCGAACAGCCAATAGCATCTTCTTAACATGGGATCCACCTAAAAATGATGGTGGTTCACGCATCAAAGGATATATAGTTGAAAGATGTCCACGTGGTTCTGATAAATGGGTTGCCTGTGGAGAACCTGTTGCAGAAACAAA
>TTN-205,ENSE00003802090,1,122,3139350,3139471,AATGGAAGTGACAGGTCTTGAGGAAGGCAAATGGTATGCCTACCGCGTGAAGGCCTTAAACAGGCAGGGTGCTAGCAAACCAAGCAGACCCACAGAGGAAATCCAGGCTGTGGACACACAAG
>TTN-205,ENSE00003809522,1,288,3139472,3139759,AGGCCCCAGAAATCTTCCTCGATGTGAAGCTCCTTGCTGGTCTCACTGTAAAAGCTGGGACCAAGATTGAACTTCCTGCCACCGTAACCGGAAAACCTGAACCTAAAATAACTTGGACAAAGGCTGATATGATTCTGAAGCAGGACAAAAGAATTACCATTGAAAATGTCCCTAAGAAATCCACAGTGACTATTGTTGATAGTAAGAGAAGTGACACTGGCACATATATCATTGAGGCTGTGAATGTGTGTGGCCGGGCCACTGCTGTGGTGGAAGTGAACGTCTTAG
>TTN-205,ENSE00003804879,1,297,3139760,3140056,ATAAACCCGGACCACCAGCTGCCTTTGACATCACAGATGTAACCAATGAGTCATGTCTTCTAACATGGAACCCACCACGCGATGATGGTGGATCTAAGATCACAAACTATGTTGTGGAGAGACGAGCAACTGATAGTGAAGTGTGGCACAAGCTCTCATCCACCGTCAAGGATACAAACTTCAAGGCCACCAAATTAATCCCCAATAAAGAGTACATCTTCAGAGTTGCTGCAGAAAACATGTATGGTGTTGGTGAACCAGTTCAGGCCTCTCCAATAACAGCCAAATATCAGTTTG
>TTN-205,ENSE00003809410,1,187,3140057,3140243,ATCCACCTGGTCCTCCAACTCGCCTAGAACCTTCTGATATCACTAAAGACGCAGTGACTCTCACATGGTGTGAGCCAGATGATGATGGTGGCAGCCCAATCACAGGATACTGGGTTGAAAGACTGGATCCTGATACAGATAAATGGGTTAGATGCAATAAGATGCCAGTAAAGGACACAACATACAG
>TTN-205,ENSE00003808827,1,116,3140244,3140359,AGTGAAAGGTCTCACTAATAAGAAAAAATACAGATTCCGTGTGTTGGCTGAAAATCTTGCTGGACCTGGAAAACCAAGCAAATCAACTGAACCAATCTTAATAAAGGATCCCATAG
>TTN-205,ENSE00003806136,1,300,3140360,3140659,ATCCTCCATGGCCCCCTGGAAAACCAACTGTAAAAGATGTAGGCAAAACATCAGTAAGGTTGAATTGGACAAAACCAGAACATGATGGAGGTGCAAAGATTGAGTCTTATGTCATTGAAATGCTGAAGACTGGAACAGATGAGTGGGTCAGAGTGGCGGAAGGGGTTCCCACCACTCAGCACTTGCTCCCAGGGCTCATGGAAGGACAGGAATACTCATTCCGAGTTAGAGCTGTGAATAAGGCTGGGGAAAGTGAACCCAGTGAACCCAGTGACCCTGTGCTTTGCCGGGAGAAGCTAT
>TTN-205,ENSE00003804290,1,300,3140660,3140959,ATCCTCCATCACCACCACGCTGGCTTGAAGTTATTAATATCACAAAAAATACAGCAGACCTAAAATGGACAGTTCCTGAGAAAGATGGAGGGTCCCCCATCACCAACTACATTGTGGAAAAGAGAGACGTCAGGCGAAAAGGCTGGCAAACAGTGGATACCACTGTCAAGGACACCAAGTGCACAGTCACCCCACTGACTGAGGGCTCTTTATATGTGTTCCGAGTTGCTGCAGAAAATGCTATAGGACAAAGCGACTACACCGAAATTGAGGACTCTGTGCTGGCCAAAGACACCTTTA
>TTN-205,ENSE00003803723,1,106,3140960,3141065,CCACTCCTGGACCACCCTACGCCCTGGCAGTGGTTGATGTGACAAAACGACATGTTGACCTAAAGTGGGAGCCACCTAAAAATGATGGTGGAAGACCAATACAGAG
>TTN-205,ENSE00003805819,1,197,3141066,3141262,ATATGTCATTGAGAAGAAAGAAAGGTTAGGTACCCGTTGGGTGAAAGCTGGAAAGACTGCAGGACCTGACTGTAACTTCAGAGTAACTGATGTCATCGAAGGAACAGAGGTCCAGTTTCAGGTTCGGGCTGAAAATGAAGCTGGAGTTGGCCACCCAAGTGAACCCACAGAAATCCTATCCATTGAAGATCCAACAA
>TTN-205,ENSE00003806467,1,306,3141263,3141568,GTCCTCCCTCACCACCCCTTGACCTACATGTGACTGATGCTGGGAGAAAACACATTGCCATTGCTTGGAAGCCTCCAGAGAAAAATGGTGGAAGTCCTATCATAGGATACCATGTTGAAATGTGTCCAGTAGGCACTGAGAAATGGATGAGAGTTAATTCTCGCCCAATAAAGGACTTGAAATTCAAGGTTGAAGAAGGTGTTGTTCCTGACAAAGAATATGTCCTGAGAGTGAGAGCAGTCAATGCTATTGGTGTCAGCGAGCCATCTGAAATCTCTGAAAATGTGGTTGCCAAAGACCCAGACT
>TTN-205,ENSE00003808061,1,279,3141569,3141847,GCAAGCCAACAATTGACCTGGAGACTCATGACATTATTGTTATTGAAGGTGAAAAGTTAAGCATTCCTGTTCCCTTCAGAGCTGTCCCAGTTCCAACTGTTAGTTGGCATAAAGATGGCAAAGAAGTTAAAGCAAGTGATAGATTAACAATGAAGAATGATCACATCTCTGCACACCTTGAAGTTCCCAAGAGTGTCCGTGCAGATGCCGGAATTTATACCATTACACTGGAGAATAAGCTCGGCTCAGCAACAGCCTCAATCAATGTCAAAGTCATAG
>TTN-205,ENSE00003811164,1,300,3141848,3142147,GCCTACCTGGACCATGCAAAGATATTAAAGCAAGTGACATTACCAAGAGTTCTTGTAAGTTAACTTGGGAACCTCCAGAATTTGATGGTGGAACCCCAATTCTTCATTATGTCCTGGAGCGCAGAGAAGCTGGGAGGAGAACATATATACCAGTCATGTCTGGTGAGAACAAACTGTCATGGACTGTGAAGGATCTCATACCAAATGGTGAATACTTCTTCCGTGTTAAAGCAGTCAACAAGGTTGGTGGAGGAGAATATATTGAACTGAAAAATCCAGTCATTGCTCAAGATCCAAAGC
>TTN-205,ENSE00003805132,1,303,3142148,3142450,AACCCCCTGATCCACCTGTAGATGTAGAGGTTCATAATCCTACAGCGGAGGCAATGACTATTACATGGAAGCCACCTTTGTATGATGGAGGGAGCAAGATAATGGGCTACATCATAGAGAAGATTGCTAAGGGTGAAGAAAGGTGGAAGAGATGCAATGAACACCTGGTACCAATCCTGACCTATACAGCAAAAGGACTTGAAGAGGGGAAAGAGTACCAATTCCGTGTGCGAGCAGAGAACGCCGCGGGTATTAGTGAACCTTCTCGGGCTACTCCTCCAACCAAAGCTGTAGATCCCATTG
>TTN-205,ENSE00003805056,1,363,3142451,3142813,ATGCCCCCAAAGTCATTCTGAGAACAAGCCTAGAAGTGAAACGAGGTGATGAAATAGCACTTGATGCAAGTATTTCTGGATCACCTTACCCAACTATTACATGGATAAAGGATGAAAATGTTATTGTACCAGAGGAAATTAAGAAGCGTGCAGCACCCTTGGTTAGGAGAAGGAAGGGTGAAGTTCAAGAAGAAGAACCATTTGTCCTGCCTCTGACACAGCGTTTGAGTATTGACAACAGCAAAAAGGGAGAATCTCAGCTACGCGTCCGAGATTCTCTCCGACCTGACCATGGTCTGTATATGATCAAAGTTGAAAATGACCACGGTATTGCAAAAGCTCCTTGTACTGTCAGTGTGTTAG
>TTN-205,ENSE00003811138,1,303,3142814,3143116,ATACACCGGGACCACCAATCAACTTTGTATTTGAAGATATCAGAAAGACCTCAGTCCTTTGTAAATGGGAACCACCCCTTGATGATGGTGGCAGTGAAATCATAAACTACACTTTGGAAAAGAAAGACAAGACAAAACCCGACTCAGAATGGATTGTTGTCACTTCAACACTTAGACATTGCAAATATTCAGTAACAAAACTGATTGAAGGAAAAGAGTACCTCTTCCGTGTAAGAGCTGAAAACAGATTTGGGCCAGGTCCACCATGTGTTTCAAAGCCACTTGTGGCTAAAGATCCATTTG
>TTN-205,ENSE00003809346,1,300,3143117,3143416,GACCACCTGATGCACCAGATAAGCCCATTGTGGAAGATGTTACCAGCAACAGTATGCTAGTGAAATGGAATGAACCAAAAGATAATGGAAGCCCCATTTTGGGTTACTGGCTTGAAAAACGTGAAGTTAACAGTACACATTGGTCTCGTGTCAACAAAAGCCTTCTGAATGCCTTGAAAGCCAATGTAGATGGCTTATTAGAAGGACTCACCTATGTCTTCAGAGTATGTGCTGAAAATGCAGCTGGACCTGGAAAGTTCAGTCCACCTTCAGATCCCAAAACAGCACATGATCCAATCT
>TTN-205,ENSE00003806782,1,297,3143417,3143713,CTCCTCCTGGGCCACCTATCCCAAGAGTCACTGACACAAGCTCTACAACTATTGAACTAGAATGGGAACCCCCAGCTTTCAATGGTGGTGGGGAAATTGTTGGCTATTTTGTTGATAAGCAGTTGGTTGGCACAAATGAATGGTCACGCTGCACAGAGAAGATGATCAAGGTCCGTCAGTACACCGTCAAAGAAATCCGAGAGGGTGCTGATTACAAACTTCGGGTGAGTGCTGTCAATGCCGCAGGGGAAGGACCGCCTGGAGAAACACAACCTGTTACTGTGGCTGAACCACAAG
>TTN-205,ENSE00003804121,1,285,3143714,3143998,AGCCTCCAGCTGTGGAACTGGATGTTTCTGTCAAGGGTGGAATACAAATAATGGCTGGGAAGACTCTTAGAATTCCAGCTGTGGTGACTGGTCGCCCTGTACCTACAAAAGTATGGACCAAAGAAGAAGGGGAGCTGGATAAAGACCGTGTTGTAATAGACAACGTTGGAACCAAATCTGAACTAATTATCAAGGATGCACTGCGAAAAGACCATGGCAGATATGTGATTACAGCTACAAATAGCTGTGGTTCCAAATTTGCAGCAGCCAGGGTAGAAGTTTTTG
>TTN-205,ENSE00003804454,1,294,3143999,3144292,ATGTCCCTGGTCCAGTTCTTGACTTAAAACCTGTTGTAACAAACAGAAAAATGTGTCTACTTAACTGGTCTGATCCAGAAGATGATGGAGGAAGTGAAATAACAGGCTTTATCATTGAAAGAAAAGATGCCAAGATGCATACTTGGAGACAACCAATAGAGACTGAGAGATCTAAATGTGACATCACAGGTCTGCTTGAGGGACAAGAATATAAGTTCCGTGTTATTGCCAAGAACAAGTTTGGCTGTGGCCCTCCTGTTGAAATAGGACCAATTCTTGCAGTTGATCCACTAG
>TTN-205,ENSE00003803420,1,300,3144293,3144592,GTCCTCCAACATCTCCAGAGAGGCTCACATACACTGAAAGGACAAAGTCCACTATCACACTTGACTGGAAAGAGCCCCGCAGTAATGGTGGCAGTCCCATCCAAGGATATATCATTGAAAAACGGCGTCATGACAAACCTGACTTTGAAAGAGTTAACAAGCGACTCTGCCCAACCACATCTTTTCTGGTTGAAAATCTTGATGAACACCAAATGTATGAGTTCCGTGTCAAAGCTGTCAATGAAATTGGTGAAAGTGAACCATCCCTACCTCTTAATGTAGTCATACAAGATGATGAAG
>TTN-205,ENSE00003809028,1,309,3144593,3144901,TGCCTCCAACTATTAAGTTGCGTCTGAGTGTTCGAGGAGACACTATCAAAGTTAAGGCAGGAGAGCCTGTCCACATCCCTGCAGATGTGACAGGCCTTCCAATGCCTAAGATTGAATGGTCCAAAAATGAAACTGTAATTGAAAAACCCACTGATGCACTTCAGATAACCAAGGAAGAGGTATCCCGAAGTGAGGCAAAAACTGAGCTTAGCATTCCCAAAGCGGTCCGGGAGGACAAAGGCACTTACACAGTTACTGCTTCCAATCGCCTTGGCTCAGTGTTCCGAAATGTTCACGTTGAAGTATATG
>TTN-205,ENSE00003801894,1,191,3144902,3145092,ACCGCCCATCCCCACCAAGAAATCTTGCTGTTACTGACATTAAAGCTGAATCTTGCTACTTGACATGGGATGCCCCTCTTGATAATGGTGGCAGTGAAATCACCCATTATGTTATTGACAAACGTGATGCAAGTAGGAAGAAAGCAGAATGGGAGGAAGTCACCAACACTGCTGTAGAGAAAAGATATGGG
>TTN-205,ENSE00003809851,1,430,3145093,3145522,ATCTGGAAACTTATCCCCAATGGTCAGTATGAGTTCCGAGTCAGGGCAGTGAATAAATATGGAATCAGTGATGAGTGCAAATCAGATAAAGTAGTCATTCAAGATCCTTATCGCCTTCCTGGACCTCCAGGAAAACCAAAAGTTTTGGCACGCACCAAAGGATCAATGCTAGTGAGCTGGACTCCTCCTTTGGACAATGGTGGCTCTCCAATTACTGGCTACTGGCTGGAGAAAAGAGAAGAGGGAAGTCCTTATTGGTCACGTGTTAGCCGAGCACCAATAACCAAAGTGGGATTGAAAGGCGTGGAATTTAATGTTCCTCGTTTGCTTGAAGGCGTTAAATACCAGTTCAGAGCCATGGCAATAAATGCTGCAGGAATTGGTCCTCCCAGTGAACCATCAGATCCAGAGGTTGCAGGAGATCCCATAT
>TTN-205,ENSE00003808594,1,309,3145523,3145831,TTCCACCGGGGCCACCTTCTTGCCCAGAAGTTAAAGATAAAACGAAGTCAAGCATCTCACTAGGATGGAAACCTCCAGCCAAAGATGGTGGCAGCCCAATCAAAGGATACATTGTAGAAATGCAAGAAGAAGGTACTACTGACTGGAAAAGAGTAAATGAACCAGACAAACTTATAACTACCTGTGAATGTGTGGTGCCTAATCTGAAAGAGCTCAGGAAGTACAGATTCAGAGTGAAAGCTGTCAATGAAGCTGGTGAATCTGAACCAAGTGATACAACTGGGGAGATCCCTGCCACTGATATTCAAG
>TTN-205,ENSE00003810473,1,149,3145832,3145980,AGGAACCAGAAGTTTTCATTGACATTGGAGCACAGGACTGTCTGGTTTGTAAAGCTGGCTCACAGATTAGGATTCCTGCTGTCATCAAGGGACGCCCAACACCAAAATCATCTTGGGAATTTGATGGAAAGGCAAAGAAAGCAATGAAG
>TTN-205,ENSE00003801625,1,33,3145981,3146013,GATGGAGTTCATGACATACCCGAAGATGCACAG
>TTN-205,ENSE00003802643,1,130,3146014,3146143,CTGGAGACTGCTGAAAACTCCTCAGTAATTATTATTCCGGAGTGTAAACGATCTCATACAGGCAAATACAGCATCACAGCCAAGAATAAAGCAGGACAAAAGACTGCAAATTGCAGAGTTAAAGTCATGG
>TTN-205,ENSE00003804239,1,300,3146144,3146443,ATGTACCAGGCCCACCCAAAGATCTGAAAGTCAGTGATATCACAAGGGGTAGTTGCAGACTTTCATGGAAGATGCCAGACGACGATGGAGGAGACAGGATCAAAGGCTATGTTATTGAGAAGAGGACTATTGATGGAAAAGCCTGGACCAAAGTCAATCCAGACTGTGGAAGCACCACATTTGTAGTGCCTGATCTCCTCTCTGAACAGCAATATTTCTTCCGTGTGCGAGCAGAAAACCGTTTTGGTATTGGCCCACCTGTGGAAACCATTCAGAGGACCACTGCCAGAGATCCGATAT
>TTN-205,ENSE00003806278,1,318,3146444,3146761,ATCCTCCTGATCCTCCTATTAAACTCAAGATTGGCCTCATCACAAAGAACACAGTGCATCTGTCATGGAAACCCCCGAAGAATGATGGGGGCTCCCCTGTTACCCACTATATTGTTGAGTGCCTTGCATGGGACCCTACTGGGACAAAGAAAGAAGCCTGGAGGCAGTGCAATAAGCGTGATGTGGAAGAACTGCAATTTACTGTTGAAGACCTAGTAGAGGGTGGGGAATATGAATTCCGAGTCAAAGCTGTCAATGCTGCAGGAGTCAGCAAGCCTTCAGCCACTGTTGGCCCTGTGACTGTCAAAGACCAGACAT
>TTN-205,ENSE00003801391,1,297,3146762,3147058,GCCCACCATCAATTGATCTAAAAGAATTCATGGAGGTTGAAGAAGGAACCAATGTTAACATTGTGGCCAAAATTAAAGGTGTGCCATTCCCGACACTAACCTGGTTTAAAGCTCCTCCAAAGAAGCCTGATAACAAAGAACCTGTTCTCTATGACACCCATGTCAACAAACTGGTGGTAGATGATACTTGCACTTTAGTTATTCCGCAGTCTCGCAGGAGTGACACTGGCTTATATACCATCACAGCTGTAAATAATCTGGGAACAGCATCAAAGGAGATGAGACTGAATGTCCTGG
>TTN-205,ENSE00003806021,1,300,3147059,3147358,GTCGTCCTGGCCCTCCAGTGGGACCCATAAAATTTGAATCTGTTTCAGCAGATCAAATGACACTATCTTGGTTTCCACCTAAAGATGATGGTGGGTCTAAGATTACAAACTATGTAATTGAGAAAAGAGAAGCTAACAGGAAGACATGGGTCCATGTCTCCAGTGAACCTAAGGAGTGCACGTACACGATTCCCAAATTGCTAGAAGGCCATGAATATGTATTCCGAATCATGGCCCAGAATAAATATGGCATTGGAGAACCTCTTGACAGTGAACCTGAAACAGCAAGAAACCTCTTCT
>TTN-205,ENSE00003803442,1,315,3147359,3147673,CTGTCCCTGGAGCACCAGATAAACCAACAGTTAGCAGCGTGACTCGTAACTCCATGACTGTCAACTGGGAAGAGCCAGAATATGATGGAGGCTCTCCTGTGACAGGGTACTGGCTGGAAATGAAAGACACCACTTCAAAGAGATGGAAGAGAGTTAACCGAGATCCTATCAAAGCCATGACTTTGGGTGTTTCTTATAAAGTGACTGGTCTTATTGAAGGTTCCGACTATCAATTCCGGGTATATGCAATCAATGCTGCTGGCGTGGGTCCAGCAAGTCTGCCATCAGACCCAGCGACTGCTAGAGATCCAATTG
>TTN-205,ENSE00003801787,1,149,3147674,3147822,CCCCTCCTGGTCCTCCATTTCCCAAAGTGACAGATTGGACTAAATCATCTGCAGATCTGGAGTGGTCTCCCCCACTAAAAGATGGTGGATCCAAAGTAACTGGATACATCGTTGAATATAAAGAAGAAGGAAAAGAAGAATGGGAAAAG
>TTN-205,ENSE00003802004,1,151,3147823,3147973,GGTAAAGATAAAGAAGTGAGAGGAACAAAGCTTGTTGTGACAGGATTAAAGGAAGGAGCATTCTACAAATTTAGAGTTAGAGCAGTCAACATTGCTGGCATTGGAGAACCTGGAGAGGTCACAGATGTCATTGAAATGAAGGACAGACTTG
>TTN-205,ENSE00003808790,1,282,3147974,3148255,TTTCACCTGACCTTCAGCTAGATGCCAGTGTCAGAGATAGAATTGTTGTCCATGCTGGAGGGGTGATCCGAATCATTGCCTATGTGTCTGGAAAGCCTCCTCCAACCGTCACCTGGAACATGAATGAAAGAACCTTACCTCAAGAAGCCACCATTGAGACCACAGCCATTAGCTCATCCATGGTCATCAAGAACTGCCAGAGGAGCCATCAAGGCGTCTATTCTCTTCTTGCCAAAAATGAAGCCGGAGAAAGAAAGAAGACAATTATTGTTGATGTATTAG
>TTN-205,ENSE00003807896,1,303,3148256,3148558,ATGTTCCAGGTCCCGTTGGAACACCATTCCTAGCTCACAACCTAACCAATGAGTCCTGCAAACTGACATGGTTTTCTCCAGAAGATGATGGAGGCTCTCCAATCACCAATTATGTCATTGAAAAGCGTGAATCTGACCGCAGAGCATGGACCCCAGTGACATATACAGTTACCCGACAAAATGCTACTGTCCAGGGTCTCATTCAAGGAAAAGCCTACTTTTTCCGAATTGCGGCTGAAAATAGTATTGGCATGGGTCCATTTGTTGAGACATCAGAGGCACTTGTTATCAGAGAGCCAATAA
>TTN-205,ENSE00003801753,1,303,3148559,3148861,CTGTACCAGAGCGTCCTGAAGACCTGGAAGTCAAAGAAGTTACTAAAAATACTGTAACTTTGACTTGGAATCCTCCTAAGTATGATGGTGGGTCAGAAATTATTAACTATGTCCTAGAAAGTCGGCTCATTGGGACTGAGAAGTTCCACAAAGTTACAAATGACAACTTGCTTAGCAGAAAATACACTGTTAAAGGCTTAAAAGAAGGTGATACCTATGAGTACCGTGTCAGTGCTGTCAACATTGTTGGACAAGGCAAACCATCATTTTGCACCAAACCAATTACTTGCAAGGATGAGCTGG
>TTN-205,ENSE00003807039,1,282,3148862,3149143,CACCCCCAACGCTTCACCTCGACTTCAGAGATAAGCTCACGATTCGAGTTGGTGAAGCTTTTGCCCTCACTGGCCGTTACTCAGGCAAACCAAAGCCTAAGGTTTCCTGGTTCAAAGATGAAGCTGATGTGCTGGAAGATGATCGCACTCATATAAAGACTACACCAGCAACACTTGCTTTAGAGAAGATCAAGGCCAAACGTTCAGATTCCGGCAAATACTGTGTGGTTGTGGAGAACAGTACAGGCTCTAGGAAAGGTTTCTGTCAAGTTAATGTTGTTG
>TTN-205,ENSE00003804106,1,300,3149144,3149443,ACCGTCCTGGACCACCAGTAGGACCAGTTAGTTTTGATGAGGTGACCAAAGATTACATGGTTATCTCTTGGAAGCCTCCTTTAGATGATGGAGGCAGTAAAATCACCAATTATATTATTGAGAAGAAGGAAGTGGGTAAAGACGTCTGGATGCCAGTGACATCTGCAAGTGCTAAAACAACATGCAAAGTTTCTAAACTACTTGAAGGAAAAGATTATATTTTCCGGATACATGCTGAAAATCTGTATGGAATAAGTGATCCTCTGGTGTCTGATTCAATGAAAGCCAAAGATCGTTTCA
>TTN-205,ENSE00003801817,1,303,3149444,3149746,GGGTTCCTGATGCACCTGATCAGCCAATTGTTACAGAAGTTACCAAAGACTCTGCATTAGTAACCTGGAATAAGCCACATGATGGAGGAAAACCCATCACAAACTACATCCTGGAAAAGAGAGAAACTATGTCTAAACGATGGGCTAGAGTTACCAAAGATCCTATTCATCCATACACTAAATTTAGGGTTCCTGATCTTCTAGAAGGATGTCAGTATGAATTCCGGGTTTCTGCAGAAAATGAAATTGGTATTGGAGATCCAAGCCCACCATCCAAACCAGTCTTTGCTAAAGATCCAATTG
>TTN-205,ENSE00003810564,1,309,3149747,3150055,CTAAACCAAGTCCACCTGTTAATCCTGAAGCAATAGATACAACATGCAATTCAGTCGATCTAACTTGGCAGCCACCACGTCATGATGGTGGGAGCAAGATTCTGGGTTATATTGTTGAGTACCAGAAAGTTGGAGATGAAGAGTGGAGAAGAGCCAATCACACCCCTGAGTCATGTCCTGAAACTAAATATAAAGTCACCGGTCTTCGGGACGGTCAAACCTATAAGTTTAGAGTGTTAGCAGTCAATGCAGCTGGTGAATCAGATCCAGCTCATGTTCCGGAGCCAGTCCTAGTAAAAGACAGGCTTG
>TTN-205,ENSE00003807476,1,282,3150056,3150337,AACCCCCTGAGTTGATTCTTGATGCCAACATGGCAAGAGAACAACACATTAAAGTTGGTGATACTCTAAGACTTAGTGCCATCATCAAAGGAGTGCCATTCCCAAAAGTAACTTGGAAAAAAGAAGACAGAGATGCTCCAACTAAAGCAAGAATTGATGTGACTCCAGTTGGTAGCAAGCTTGAAATTCGTAATGCTGCCCATGAAGATGGTGGAATTTATTCTTTAACAGTGGAGAATCCAGCTGGTTCAAAAACTGTCTCAGTAAAAGTACTTGTATTAG
>TTN-205,ENSE00003807363,1,300,3150338,3150637,ATAAACCTGGGCCACCTAGAGATCTGGAAGTCAGTGAAATTAGGAAAGATTCATGTTACCTTACTTGGAAAGAACCACTGGATGATGGTGGTTCTGTTATTACCAATTATGTGGTTGAGAGGAGAGATGTTGCCAGCGCCCAGTGGTCACCTCTCTCAGCTACATCAAAGAAAAAGAGTCACTTCGCTAAGCATCTGAATGAAGGCAACCAGTACCTCTTCCGAGTAGCTGCGGAGAACCAGTATGGACGTGGTCCTTTTGTTGAAACACCAAAACCAATCAAGGCTTTGGATCCTCTCC
>TTN-205,ENSE00003808994,1,294,3150638,3150931,ATCCCCCAGGGCCACCCAAGGACCTGCACCATGTAGATGTTGACAAGACTGAAGTCTCCCTAGTCTGGAATAAGCCGGATCGTGATGGTGGTTCTCCAATCACTGGATATTTGGTAGAATATCAAGAAGAAGGCACCCAGGACTGGATTAAATTTAAGACTGTGACAAACTTAGAGTGTGTGGTTACTGGACTACAACAAGGAAAGACCTATAGATTCCGTGTAAAAGCTGAAAACATTGTGGGTCTTGGTCTCCCTGACACAACTATCCCGATAGAATGTCAAGAAAAACTAG
>TTN-205,ENSE00003810188,1,2967,3150932,3153898,TGCCTCCATCCGTGGAGCTAGATGTGAAATTAATTGAAGGTCTTGTGGTAAAGGCTGGAACCACAGTCAGATTCCCTGCTATTATAAGAGGTGTGCCTGTTCCTACTGCAAAGTGGACAACCGATGGGAGTGAGATTAAAACCGATGAGCACTACACAGTTGAAACAGACAACTTCTCATCAGTACTTACCATTAAGAACTGCTTAAGGAGAGACACTGGGGAATATCAAATCACAGTTTCCAATGCAGCCGGTAGCAAAACAGTAGCCGTACATCTTACTGTTCTTGATGTTCCTGGGCCACCAACAGGTCCTATTAATATTCTGGATGTTACTCCTGAACACATGACTATCTCATGGCAGCCACCTAAGGATGATGGAGGAAGCCCTGTGATAAATTATATTGTTGAGAAACAAGATACAAGGAAAGACACGTGGGGTGTTGTCTCTTCCGGAAGCAGTAAGACAAAGCTGAAAATCCCACATCTGCAGAAGGGCTGTGAATATGTTTTCCGAGTTAGAGCAGAGAATAAGATAGGTGTTGGTCCTCCCCTTGACTCCACACCTACTGTTGCTAAGCATAAATTTAGTCCTCCGTCTCCTCCTGGTAAACCAGTGGTTACTGACATTACTGAAAATGCAGCAACAGTGTCTTGGACCCTGCCAAAATCTGATGGTGGCAGTCCAATAACTGGCTACTATATGGAACGTCGAGAAGTAACTGGCAAATGGGTGAGGGTCAACAAAACACCTATCGCTGACCTGAAGTTCAGAGTGACTGGACTCTATGAAGGAAATACATATGAGTTTAGAGTTTTTGCTGAAAATCTTGCAGGACTAAGCAAACCATCCCCAAGTTCTGATCCAATAAAAGCTTGCCGGCCCATCAAACCACCTGGACCACCTATTAATCCTAAACTGAAAGACAAGAGCAGAGAAACAGCTGATTTGGTGTGGACAAAGCCTCTCAGTGATGGTGGTAGCCCCATTCTAGGATATGTAGTGGAATGTCAGAAACCTGGCACAGCACAATGGAACAGGATTAATAAAGATGAACTCATTAGGCAATGTGCCTTTAGGGTACCTGGACTAATTGAAGGAAATGAGTACAGATTCCGTATAAAGGCAGCTAATATTGTAGGAGAGGGTGAGCCAAGAGAACTAGCAGAATCTGTGATTGCAAAAGATATCCTTCATCCTCCAGAAGTAGAACTTGATGTTACTTGTCGTGATGTTATTACCGTGAGAGTAGGCCAAACTATCCGCATTCTAGCTCGAGTCAAAGGCAGACCTGAACCAGACATAACTTGGACTAAGGAAGGCAAAGTATTGGTCCGAGAAAAGAGGGTGGACCTTATTCAGGATCTACCTCGTGTTGAGTTACAAATTAAAGAAGCTGTTAGAGCTGATCATGGCAAGTATATCATCTCAGCTAAGAACAGCAGTGGACATGCCCAAGGTTCAGCCATCGTTAACGTCCTTGACAGACCTGGGCCTTGCCAGAATTTGAAGGTTACCAATGTAACCAAAGAGAACTGTACAATTTCTTGGGAAAACCCACTAGATAATGGTGGCTCAGAAATAACAAACTTCATAGTAGAATATCGCAAACCAAACCAGAAAGGCTGGTCAATTGTTGCATCAGATGTCACTAAACGATTAATCAAGGCCAACCTTTTAGCCAACAATGAATACTATTTCCGAGTTTGTGCAGAGAATAAAGTAGGTGTTGGGCCAACCATCGAAACAAAAACTCCCATTCTGGCTATTAACCCTATTGACAGACCAGGTGAGCCTGAAAACCTTCACATTGCAGATAAAGGAAAGACATTTGTCTATCTAAAGTGGCGGAGGCCTGACTATGATGGTGGCAGTCCAAATCTGTCATATCATGTTGAGAGAAGGCTTAAGGGCTCCGATGACTGGGAAAGAGTGCATAAAGGAAGCATTAAAGAAACTCACTACATGGTTGACAGATGTGTTGAAAACCAGATTTATGAGTTCAGAGTGCAAACAAAGAATGAAGGTGGGGAAAGTGACTGGGTGAAGACAGAGGAAGTTGTTGTGAAAGAAGACTTACAAAAACCAGTACTTGATCTGAAATTAAGTGGGGTCCTAACTGTCAAAGCAGGGGACACCATTAGGCTTGAGGCAGGGGTTAGAGGCAAACCATTCCCAGAAGTTGCATGGACCAAGGACAAAGACGCTACAGACTTAACAAGATCACCAAGGGTCAAGATTGATACCCGTGCTGATTCATCTAAATTTTCTCTTACTAAAGCAAAGCGAAGTGATGGGGGTAAATATGTAGTTACGGCAACTAACACGGCTGGCAGTTTTGTGGCCTATGCCACTGTCAATGTTTTAGATAAGCCTGGTCCTGTGAGAAATCTGAAAATTGTTGATGTGTCCAGTGATAGGTGTACTGTTTGCTGGGATCCACCAGAAGATGATGGTGGCTGTGAAATCCAAAATTATATTCTAGAAAAATGTGAGACAAAGCGAATGGTTTGGTCTACCTATTCTGCTACTGTCTTGACACCTGGTACTACAGTAACACGTCTCATAGAAGGAAATGAATATATTTTCAGAGTCCGTGCAGAAAATAAAATAGGCACAGGGCCTCCAACAGAAAGTAAACCAGTCATAGCCAAAACCAAGTATGATAAACCTGGTCGCCCTGATCCCCCAGAAGTCACTAAAGTAAGCAAAGAAGAGATGACTGTGGTTTGGAATCCACCTGAATATGATGGTGGAAAGTCTATAACTGGATACTTTTTGGAGAAAAAGGAAAAGCATTCAACACGATGGGTCCCTGTCAACAAGAGTGCAATCCCTGAGAGACGTATGAAAGTACAGAATCTCCTCCCAGACCATGAATATCAGTTCCGTGTCAAGGCAGAAAATGAAATTGGAATTGGAGAACCAAGCTTGCCTTCAAGACCGGTGGTGGCAAAAGACCCCATAG
>TTN-205,ENSE00003811401,1,321,3153899,3154219,AGCCACCTGGTCCACCAACCAATTTCAGAGTGGTTGATACAACCAAACATTCCATAACTCTTGGGTGGGGAAAACCAGTCTATGATGGTGGTGCACCGATCATTGGATATGTTGTGGAAATGAGACCAAAAATAGCAGATGCGTCTCCTGATGAAGGCTGGAAACGGTGTAATGCTGCAGCACAGCTTGTACGCAAGGAATTCACTGTTACCAGCTTGGATGAAAACCAGGAATATGAGTTCAGGGTGTGTGCCCAAAACCAAGTTGGTATTGGGCGCCCTGCAGAGCTAAAGGAAGCTATCAAACCTAAAGAAATACTAG
>TTN-205,ENSE00003805661,1,285,3154220,3154504,AACCTCCGGAGATTGATTTGGATGCCAGCATGAGGAAACTGGTCATAGTGAGAGCAGGATGCCCTATTCGTCTCTTTGCTATAGTGAGAGGACGACCAGCCCCTAAAGTCACTTGGCGAAAAGTTGGCATTGATAATGTGGTCAGAAAAGGACAAGTTGATCTGGTTGACACTATGGCCTTCCTTGTCATCCCCAATTCTACCCGTGATGACTCAGGAAAATATTCCTTAACACTTGTGAACCCAGCAGGAGAAAAGGCTGTATTCGTAAATGTCAGAGTATTAG
>TTN-205,ENSE00003804742,1,300,3154505,3154804,ACACTCCTGGGCCTGTGTCTGATTTAAAAGTTTCAGATGTCACTAAAACATCATGCCATGTGTCCTGGGCCCCTCCTGAAAACGACGGTGGGAGCCAAGTGACACATTATATCGTGGAGAAACGTGAGGCAGACAGAAAGACATGGTCGACCGTTACCCCAGAAGTTAAGAAAACAAGCTTCCATGTAACCAATCTTGTCCCTGGGAATGAGTATTACTTCAGAGTAACTGCTGTCAACGAATATGGCCCTGGCGTCCCAACAGATGTCCCAAAACCAGTGCTTGCATCAGATCCTCTAA
>TTN-205,ENSE00003810357,1,303,3154805,3155107,GTGAGCCGGATCCCCCAAGGAAATTAGAAGTGACTGAAATGACCAAGAACAGTGCCACCTTAGCCTGGTTACCTCCCCTACGTGATGGAGGTGCTAAAATCGATGGCTACATCACTAGTTACAGAGAAGAAGAGCAGCCTGCAGATCGCTGGACAGAGTACTCAGTGGTAAAAGATCTGAGCCTTGTTGTCACTGGCCTAAAGGAAGGAAAGAAATACAAATTTAGAGTAGCGGCCAGAAATGCTGTTGGAGTCAGTTTGCCAAGAGAAGCTGAAGGAGTGTATGAAGCCAAAGAACAACTGT
>TTN-205,ENSE00003801707,1,276,3155108,3155383,TGCCACCAAAGATCCTTATGCCAGAGCAAATAACTATCAAAGCTGGGAAAAAACTCCGAATTGAAGCCCATGTGTATGGAAAGCCTCATCCCACCTGTAAATGGAAAAAAGGAGAAGATGAAGTTGTCACATCCAGCCACCTGGCAGTGCATAAAGCAGACAGCTCTTCAATTCTGATCATAAAAGATGTGACTAGGAAAGACAGTGGTTACTACAGCCTCACAGCAGAGAACAGTTCTGGGACAGACACTCAGAAAATCAAAGTTGTAGTCATGG
>TTN-205,ENSE00003810399,1,300,3155384,3155683,ATGCCCCCGGCCCCCCTCAGCCTCCATTTGACATTTCTGATATAGACGCTGATGCTTGCTCCCTGTCATGGCACATCCCTCTGGAGGACGGAGGCAGTAACATCACCAATTATATAGTGGAGAAGTGTGATGTAAGCCGAGGTGACTGGGTCACGGCTCTAGCTTCAGTCACAAAAACTTCCTGCAGGGTTGGAAAGCTGATCCCAGGCCAGGAGTACATCTTCCGGGTCCGTGCTGAAAACCGATTTGGCATTTCAGAGCCTCTCACATCTCCAAAGATGGTTGCGCAGTTCCCATTTG
>TTN-205,ENSE00003810448,1,303,3155684,3155986,GTGTTCCTAGTGAACCAAAGAATGCACGAGTCACCAAAGTCAACAAGGACTGTATTTTTGTTGCTTGGGACAGACCAGATAGTGATGGAGGGAGCCCCATTATTGGTTATCTGATTGAACGCAAGGAAAGAAACAGTTTGCTGTGGGTGAAAGCCAATGATACTCTTGTCCGGTCAACTGAATATCCTTGTGCTGGCCTTGTAGAAGGTCTTGAGTATTCATTCAGAATCTATGCCCTAAACAAAGCTGGATCCAGCCCACCCAGCAAACCCACAGAATATGTAACTGCAAGAATGCCAGTTG
>TTN-205,ENSE00003802505,1,300,3155987,3156286,ATCCTCCTGGGAAACCTGAGGTTATTGATGTCACCAAGAGTACTGTATCTCTGATCTGGGCTCGTCCAAAGCATGATGGAGGCAGTAAAATTATTGGCTATTTCGTAGAAGCTTGCAAACTTCCTGGTGATAAATGGGTACGGTGCAATACTGCACCTCACCAGATTCCCCAGGAAGAGTACACAGCTACTGGCCTAGAAGAGAAAGCTCAGTATCAATTTAGAGCTATTGCCAGGACCGCGGTAAACATTAGCCCACCTTCTGAACCTTCTGATCCAGTGACTATCCTCGCAGAAAATG
>TTN-205,ENSE00003806397,1,288,3156287,3156574,TCCCTCCCAGGATAGACCTGAGTGTGGCTATGAAATCTTTGCTTACTGTGAAAGCTGGAACTAATGTCTGCTTGGATGCTACTGTTTTTGGTAAACCGATGCCAACAGTTTCTTGGAAAAAAGATGGCACACTGCTAAAACCAGCAGAAGGCATAAAGATGGCCATGCAGCGGAATCTGTGCACCTTGGAGCTATTCAGCGTGAACCGGAAGGACTCAGGAGACTATACCATTACTGCTGAAAATTCAAGTGGTTCTAAATCAGCCACCATTAAGCTTAAAGTGTTAG
>TTN-205,ENSE00003807889,1,297,3156575,3156871,ATAAACCGGGTCCTCCAGCATCTGTTAAAATCAACAAAATGTATTCAGATCGTGCTATGCTTTCTTGGGAACCGCCTCTTGAAGATGGAGGCTCAGAAATCACCAACTATATTGTTGACAAACGTGAAACAAGCAGGCCCAACTGGGCTCAAGTCTCTGCAACTGTGCCTATCACCAGCTGCAGCGTGGAGAAACTTATAGAGGGCCATGAGTATCAGTTCCGTATTTGTGCTGAAAATAAATATGGAGTAGGCGATCCAGTCTTCACTGAACCAGCAATTGCCAAAAACCCATATG
>TTN-205,ENSE00003811290,1,303,3156872,3157174,ACCCACCAGGACGCTGTGATCCTCCTGTTATTAGCAACATAACCAAAGATCACATGACAGTCAGCTGGAAGCCACCAGCAGATGATGGGGGCTCACCCATCACTGGCTATTTGCTTGAAAAGCGGGAAACCCAGGCTGTTAACTGGACTAAGGTCAACAGAAAACCTATTATAGAAAGAACATTAAAAGCAACAGGTCTTCAAGAAGGTACCGAATATGAGTTCCGTGTTACAGCTATAAATAAAGCTGGACCAGGCAAACCCAGTGACGCATCCAAGGCCGCTTATGCTCGGGACCCTCAGT
>TTN-205,ENSE00003808853,1,306,3157175,3157480,ATCCTCCTGGCCCACCGGCTTTCCCTAAAGTATATGATACAACTCGCAGCTCTGTGAGTCTATCTTGGGGCAAGCCAGCCTATGACGGCGGCAGCCCTATCATTGGTTATCTCGTTGAAGTAAAACGGGCTGACTCCGATAACTGGGTGAGGTGCAACTTACCACAGAATCTACAGAAAACCCGCTTTGAGGTTACTGGCCTGATGGAAGACACACAATATCAATTCCGTGTGTATGCCGTTAATAAGATTGGATACAGTGACCCCAGTGATGTGCCAGATAAACACTATCCCAAGGACATCTTAA
>TTN-205,ENSE00003807542,1,288,3157481,3157768,TTCCACCTGAGGGAGAACTTGATGCGGACTTAAGGAAGACACTCATATTACGTGCTGGAGTTACTATGAGACTATATGTACCAGTAAAAGGACGCCCACCTCCAAAGATTACTTGGTCTAAACCAAATGTCAATCTAAGAGACAGGATTGGACTGGACATAAAGTCAACTGACTTTGACACTTTCTTGCGCTGTGAAAATGTGAACAAATATGATGCAGGAAAATATATCTTAACCCTGGAGAACAGCTGTGGTAAAAAGGAATATACCATTGTTGTGAAAGTGCTTG
>TTN-205,ENSE00003810775,1,291,3157769,3158059,ATACTCCTGGGCCACCTGTCAATGTGACTGTTAAGGAAATATCCAAAGACTCTGCTTATGTTACCTGGGAGCCTCCCATTATTGATGGCGGAAGCCCCATCATAAACTATGTGGTACAAAAACGTGATGCAGAGAGGAAATCCTGGTCTACAGTGACAACTGAGTGCTCCAAAACAAGCTTCAGAGTAGCTAATTTGGAGGAGGGAAAATCCTACTTCTTCCGAGTGTTTGCTGAAAATGAGTATGGCATTGGTGATCCCGGTGAAACTCGTGATGCTGTCAAAGCTTCCC
>TTN-205,ENSE00003811210,1,288,3158060,3158347,AAACTCCTGGACCAGTTGTGGACCTGAAAGTGAGGTCTGTATCTAAGTCATCCTGTAGCATTGGCTGGAAAAAGCCTCACAGTGATGGTGGAAGTCGGATTATTGGATATGTAGTTGATTTCCTGACTGAAGAAAATAAGTGGCAACGAGTTATGAAATCCTTAAGCCTACAGTACTCTGCAAAAGATTTGACTGAAGGGAAGGAATATACCTTCAGAGTGAGTGCTGAGAATGAAAATGGAGAAGGAACCCCAAGCGAAATCACTGTTGTGGCAAGGGATGATGTTG
>TTN-205,ENSE00003805436,1,588,3158348,3158935,TGGCTCCTGATCTTGACTTAAAGGGTCTACCTGATTTGTGCTACTTGGCTAAAGAAAACAGCAACTTCCGGCTTAAGATCCCCATAAAAGGCAAGCCAGCTCCATCAGTCTCCTGGAAGAAAGGGGAAGATCCTCTAGCAACTGACACTAGAGTCAGTGTTGAGTCATCTGCGGTTAACACAACTCTTATAGTGTACGATTGCCAAAAATCTGATGCTGGAAAATACACAATCACACTTAAGAATGTTGCTGGCACCAAGGAAGGAACTATCTCCATAAAGGTTGTTGGCAAGCCTGGCATCCCCACTGGACCAATCAAATTTGATGAAGTCACAGCAGAAGCCATGACCTTAAAGTGGGCTCCTCCAAAGGATGATGGAGGTTCTGAAATCACCAACTATATCCTAGAGAAGAGGGATTCTGTGAACAACAAGTGGGTGACGTGCGCCTCAGCTGTCCAGAAAACCACCTTTAGAGTAACCAGACTTCATGAGGGCATGGAATATACCTTCAGGGTCAGTGCCGAAAATAAATATGGTGTAGGGGAAGGCCTGAAATCGGAGCCAATTGTTGCGAGACATCCATTTG
>TTN-205,ENSE00003808777,1,105,3158936,3159040,ATGTGCCTGATGCTCCCCCACCTCCCAATATTGTGGATGTCAGACACGATTCAGTATCTCTAACTTGGACTGACCCCAAGAAAACTGGTGGTTCTCCAATTACAG
>TTN-205,ENSE00003806939,1,198,3159041,3159238,GGTATCATCTCGAGTTCAAGGAAAGAAACAGCCTTTTGTGGAAGAGAGCTAACAAGACTCCGATAAGGATGAGAGACTTTAAAGTGACAGGATTAACTGAAGGTCTTGAATATGAATTCCGAGTTATGGCAATCAATTTAGCAGGTGTGGGCAAGCCAAGCCTACCATCAGAGCCTGTTGTGGCACTGGACCCAATTG
>TTN-205,ENSE00003811024,1,297,3159239,3159535,ATCCTCCTGGAAAACCTGAGGTTATTAACATAACAAGGAATTCAGTGACTCTCATTTGGACTGAACCTAAATATGACGGTGGTCATAAGTTAACTGGATATATAGTGGAGAAGCGAGATCTACCTTCGAAGTCTTGGATGAAAGCCAACCATGTTAATGTCCCAGAATGTGCCTTTACTGTAACTGACCTTGTTGAGGGTGGAAAATATGAATTCAGAATTAGAGCAAAGAATACAGCAGGTGCTATCAGTGCTCCATCAGAAAGTACAGAAACCATTATTTGCAAGGATGAATACG
>TTN-205,ENSE00003803896,1,588,3159536,3160123,AGGCACCAACAATTGTCCTTGATCCCACAATAAAAGATGGGCTAACAATTAAAGCAGGGGATACCATTGTTTTGAATGCCATTAGCATTCTTGGCAAACCCCTTCCAAAATCAAGTTGGTCCAAGGCAGGAAAAGACATTAGACCATCAGATATCACTCAGATAACTTCAACCCCAACATCTTCCATGCTTACTATCAAGTATGCCACTAGAAAAGATGCGGGTGAATATACCATCACTGCTACCAATCCTTTTGGCACGAAGGTGGAACATGTGAAGGTAACAGTCCTTGATGTACCTGGTCCCCCAGGTCCTGTTGAAATCAGTAATGTTTCTGCTGAAAAAGCAACACTTACATGGACACCTCCCTTGGAAGATGGCGGCTCACCAATTAAGTCCTATATACTTGAAAAGAGAGAAACCAGCCGACTTTTGTGGACAGTGGTTTCTGAAGATATTCAGTCTTGCAGGCATGTGGCAACCAAACTTATCCAAGGAAATGAGTACATCTTCCGGGTCTCAGCTGTAAACCACTATGGCAAAGGAGAACCTGTACAGTCTGAACCTGTCAAAATGGTAGACAGATTTG
>TTN-205,ENSE00003807419,1,303,3160124,3160426,GTCCCCCTGGCCCTCCTGAAAAACCAGAGGTATCAAATGTCACTAAGAACACTGCCACTGTCAGCTGGAAAAGGCCAGTGGATGATGGTGGCAGCGAAATTACAGGATATCATGTAGAAAGGAGAGAAAAGAAAAGCCTGCGATGGGTGAGAGCAATAAAAACACCAGTTTCCGATCTCAGGTGCAAAGTAACAGGACTGCAAGAAGGAAGCACCTACGAATTCCGTGTCAGTGCAGAAAACAGAGCAGGAATTGGTCCACCCAGTGAGGCTTCAGATTCTGTTCTGATGAAAGATGCAGCAT
>TTN-205,ENSE00003811193,1,17106,3160427,3177532,ATCCTCCAGGACCACCTTCAAATCCGCATGTCACTGATACTACCAAGAAATCTGCTTCTTTGGCATGGGGCAAGCCTCATTATGATGGTGGACTTGAAATCACTGGCTATGTCGTGGAGCATCAAAAAGTAGGAGACGAGGCCTGGATAAAAGATACCACAGGAACCGCCCTCAGAATCACTCAGTTCGTTGTTCCTGATCTTCAGACTAAAGAAAAATACAACTTCAGAATCAGTGCCATCAACGATGCAGGTGTTGGGGAGCCAGCGGTGATTCCAGATGTTGAAATCGTAGAACGGGAGATGGCTCCTGATTTTGAACTAGATGCCGAGCTTCGAAGAACACTTGTTGTTAGAGCAGGACTCAGTATTAGGATATTTGTGCCAATTAAAGGTCGTCCTGCTCCTGAAGTGACATGGACCAAAGATAACATCAACCTGAAAAACCGAGCCAACATTGAAAATACGGAATCATTTACTCTTCTGATTATCCCAGAATGTAACAGATATGATACCGGTAAATTTGTCATGACCATTGAAAACCCGGCTGGGAAGAAAAGTGGCTTTGTGAACGTCAGAGTCTTGGACACGCCAGGCCCAGTCCTCAACCTGCGGCCTACAGACATCACAAAGGACAGTGTCACCCTGCACTGGGACCTCCCTCTGATAGATGGAGGCTCACGTATAACAAACTACATTGTAGAGAAACGTGAAGCAACACGGAAATCTTATTCCACAGCCACCACTAAGTGCCATAAATGCACATATAAAGTTACCGGCTTGTCTGAAGGGTGTGAATATTTCTTCAGAGTGATGGCAGAGAATGAATATGGAATTGGTGAGCCAACAGAAACTACAGAGCCCGTAAAAGCCTCTGAAGCACCATCTCCACCAGACAGCCTTAACATCATGGACATAACTAAGAGCACCGTCAGCCTGGCATGGCCTAAGCCCAAACACGATGGTGGCAGCAAGATCACTGGCTATGTGATTGAAGCCCAAAGAAAAGGCTCTGACCAGTGGACCCACATCACAACCGTGAAAGGGTTAGAATGTGTTGTGAGGAATCTAACTGAAGGAGAGGAATATACCTTCCAAGTGATGGCAGTGAACAGCGCGGGGAGAAGTGCCCCTAGAGAAAGCAGACCCGTCATTGTCAAGGAGCAGACAATGCTTCCAGAGCTGGATCTCCGTGGCATCTATCAGAAACTGGTCATTGCCAAAGCTGGTGACAACATCAAAGTTGAAATTCCAGTGCTCGGTCGACCGAAGCCCACAGTGACATGGAAAAAAGGAGACCAAATTCTTAAACAGACACAGAGAGTTAATTTTGAAACCACAGCGACTTCAACCATTTTAAATATCAATGAGTGTGTCAGAAGTGATAGTGGGCCCTATCCATTAACAGCAAGGAACATTGTAGGAGAGGTTGGTGATGTCATCACCATTCAAGTCCATGATATCCCAGGGCCACCTACTGGACCAATCAAATTTGATGAAGTTTCATCTGATTTTGTAACCTTCTCTTGGGACCCACCTGAGAACGATGGTGGTGTACCAATAAGCAACTATGTAGTGGAAATGCGGCAGACTGACAGTACTACCTGGGTTGAGTTAGCAACCACCGTTATACGTACTACCTATAAAGCCACCCGCCTTACTACTGGATTAGAGTATCAGTTCCGTGTAAAAGCTCAGAATAGATATGGAGTTGGACCAGGCATCACATCAGCATGCATAGTTGCCAACTATCCATTTAAGGTTCCTGGACCTCCTGGTACCCCTCAGGTAACTGCAGTTACCAAGGATTCAATGACAATTAGCTGGCATGAGCCACTTTCTGATGGTGGAAGCCCCATTTTAGGATATCATGTTGAAAGAAAAGAACGAAATGGTATTCTCTGGCAGACTGTGAGCAAAGCTTTAGTACCAGGCAACATTTTCAAATCAAGTGGACTTACAGATGGTATTGCTTATGAGTTCCGGGTGATTGCAGAAAACATGGCAGGCAAAAGTAAGCCAAGCAAGCCATCAGAACCTATGTTGGCTCTGGATCCCATTGACCCACCTGGAAAACCAGTACCTCTAAATATTACAAGACACACAGTAACACTTAAATGGGCTAAGCCTGAATATACTGGGGGCTTTAAAATTACCAGTTATATCGTTGAAAAGAGAGACCTTCCTAATGGACGGTGGCTGAAGGCCAACTTCAGCAACATTTTGGAGAATGAATTTACAGTCAGTGGCCTAACAGAAGATGCTGCATATGAATTCCGTGTGATCGCCAAAAATGCTGCAGGTGCCATCAGTCCACCATCTGAGCCATCTGATGCTATCACTTGCAGGGATGATGTTGAGGCACCAAAGATAAAGGTGGATGTTAAATTTAAGGACACGGTTATATTAAAAGCAGGTGAAGCATTCAGACTGGAAGCTGATGTTTCAGGCCGCCCACCTCCAACAATGGAATGGAGCAAAGATGGAAAAGAGCTGGAAGGCACAGCAAAGTTAGAAATAAAAATTGCAGATTTCTCTACTAATCTGGTAAACAAAGATTCAACAAGAAGGGATAGTGGTGCCTATACCCTTACAGCGACTAATCCTGGTGGCTTTGCTAAACACATTTTCAATGTCAAAGTTCTTGACAGACCAGGCCCACCTGAAGGACCTTTGGCTGTAACTGAAGTGACATCAGAAAAGTGTGTACTATCATGGTTCCCTCCACTGGATGATGGAGGTGCCAAAATTGATCATTACATAGTACAGAAACGTGAAACCAGCAGATTGGCATGGACAAATGTAGCCTCAGAAGTCCAAGTAACAAAGCTAAAGGTCACTAAACTCTTGAAAGGCAATGAATACATATTCCGTGTCATGGCTGTAAATAAATATGGAGTGGGAGAGCCACTGGAATCAGAGCCTGTGCTTGCAGTGAATCCTTATGGACCCCCTGATCCGCCCAAAAACCCTGAAGTGACAACTATTACTAAAGATTCGATGGTTGTCTGCTGGGGACATCCTGATTCTGATGGTGGAAGTGAAATCATCAATTATATTGTGGAACGGCGTGATAAAGCTGGCCAACGCTGGATTAAATGCAACAAAAAAACTCTTACTGATTTAAGATATAAAGTGTCTGGACTGACAGAAGGACATGAATATGAGTTCAGGATTATGGCTGAAAATGCTGCTGGAATTAGTGCACCAAGTCCTACCAGTCCATTTTACAAGGCTTGTGACACTGTGTTTAAACCTGGACCACCAGGTAACCCACGTGTTCTGGATACAAGCAGATCATCCATTTCAATCGCTTGGAATAAACCTATCTATGATGGTGGTTCAGAAATCACTGGGTATATGGTTGAGATTGCCCTGCCAGAGGAAGATGAATGGCAGATTGTCACTCCACCAGCAGGACTCAAGGCAACTTCGTATACTATCACTGGCCTCACAGAGAATCAGGAATATAAGATCCGCATCTATGCCATGAATTCCGAAGGACTTGGGGAACCTGCCCTTGTTCCTGGAACTCCAAAGGCTGAAGACAGAATGCTGCCTCCAGAAATTGAACTGGATGCTGACCTGCGCAAAGTTGTTACTATAAGGGCCTGCTGCACCCTGAGACTTTTTGTTCCCATCAAAGGAAGGCCTGCACCTGAGGTGAAGTGGGCCCGGGACCATGGAGAATCTTTAGATAAAGCTAGCATCGAATCCACAAGCTCTTACACCCTGCTTATTGTTGGAAATGTAAACAGATTTGACAGTGGCAAATATATACTAACTGTAGAAAATAGTTCAGGCAGCAAGTCTGCATTTGTCAATGTTAGAGTTCTCGATACACCAGGCCCCCCACAGGATCTGAAGGTAAAAGAGGTCACTAAGACATCTGTCACACTCACATGGGACCCACCTCTCCTTGATGGAGGTTCAAAAATCAAGAACTATATTGTTGAAAAGCGGGAATCAACAAGAAAAGCATATTCAACTGTTGCAACAAACTGCCACAAGACTTCCTGGAAGGTAGACCAGCTTCAAGAAGGCTGTAGCTACTATTTCAGGGTTCTCGCAGAAAATGAATATGGCATTGGGCTGCCTGCTGAAACCGCAGAATCTGTGAAAGCATCAGAACGACCTCTTCCTCCAGGAAAAATAACTTTGATGGATGTCACAAGAAATAGTGTGTCACTCTCTTGGGAGAAACCAGAGCATGATGGAGGCAGCCGAATTCTAGGCTACATTGTGGAGATGCAGACCAAAGGCAGTGACAAATGGGCCACGTGTGCCACAGTCAAGGTCACTGAAGCCACTATCACTGGATTAATTCAGGGTGAAGAATACTCTTTCCGTGTTTCAGCTCAGAATGAAAAGGGCATCAGTGATCCTAGACAACTGAGTGTGCCAGTGATCGCCAAAGATCTTGTCATTCCACCAGCCTTCAAACTCCTGTTCAATACTTTCACTGTACTGGCAGGTGAAGACCTAAAAGTTGATGTTCCATTCATTGGCCGCCCTACCCCAGCTGTAACCTGGCATAAAGATAATGTACCACTGAAGCAGACAACTAGAGTAAATGCAGAGAGCACAGAAAATAATTCACTACTGACAATAAAGGACGCCTGCCGAGAAGATGTTGGCCATTATGTGGTTAAACTGACTAACTCAGCTGGTGAAGCTATTGAAACCCTTAATGTTATCGTTCTTGACAAACCAGGGCCTCCAACTGGACCAGTTAAAATGGATGAAGTGACAGCTGATAGTATTACTCTTTCCTGGGGCCCACCCAAGTATGATGGTGGAAGTTCTATCAATAATTACATTGTTGAGAAACGGGACACTTCCACAACCACCTGGCAAATTGTATCAGCTACAGTTGCAAGGACAACAATAAAGGCTTGCAGACTGAAGACTGGATGTGAATATCAGTTTAGAATTGCAGCTGAAAACAGATATGGGAAGAGTACCTACCTCAATTCAGAGCCTACTGTAGCCCAATATCCATTCAAAGTTCCTGGTCCTCCTGGCACTCCAGTTGTCACACTGTCCTCCAGGGACAGCATGGAAGTACAATGGAATGAGCCAATCAGTGATGGAGGAAGTAGAGTCATTGGCTATCATCTAGAACGCAAGGAAAGAAATAGCATCCTCTGGGTTAAGTTGAATAAAACACCTATTCCTCAAACCAAGTTTAAGACAACTGGCCTTGAAGAAGGTGTTGAATATGAATTTAGAGTCTCTGCAGAGAACATCGTGGGCATTGGCAAGCCGAGTAAAGTATCAGAATGTTATGTGGCTCGTGACCCATGTGATCCACCAGGACGGCCAGAGGCAATCATTGTCACAAGGAATTCTGTGACTCTTCAGTGGAAGAAACCCACCTATGACGGTGGAAGCAAGATCACTGGTTATATTGTTGAGAAGAAAGAATTACCTGAGGGCCGTTGGATGAAAGCCAGTTTTACAAATATTATTGACACTCATTTTGAAGTAACTGGCCTAGTTGAAGATCACAGATATGAGTTCCGGGTTATAGCCCGAAATGCCGCAGGAGTGTTTAGTGAGCCTTCAGAAAGCACAGGAGCAATAACAGCTAGAGATGAGGTAGATCCACCACGAATAAGTATGGATCCAAAATACAAAGACACAATCGTGGTTCATGCTGGTGAATCATTCAAGGTTGATGCAGATATTTATGGCAAACCAATACCAACCATTCAGTGGATAAAAGGTGATCAGGAGCTTTCAAACACAGCTCGATTAGAAATAAAGAGCACCGACTTTGCCACCAGTCTCAGTGTAAAAGATGCAGTACGTGTCGACAGTGGAAATTACATACTGAAGGCCAAAAATGTTGCAGGAGAAAGATCAGTTACTGTGAATGTCAAGGTTCTTGACAGACCAGGGCCACCTGAAGGACCTGTTGTTATCTCAGGAGTTACAGCAGAAAAATGCACACTAGCTTGGAAACCCCCACTTCAGGATGGTGGGAGTGACATCATAAATTATATTGTGGAAAGGAGAGAAACCAGCCGCTTAGTTTGGACTGTGGTTGATGCCAATGTGCAGACTCTCAGCTGCAAGGTTACTAAGCTTCTTGAAGGCAATGAATATACTTTCCGTATAATGGCAGTAAACAAATATGGTGTTGGTGAACCTCTTGAATCTGAGCCAGTAGTTGCCAAGAATCCATTTGTAGTACCAGATGCACCAAAAGCTCCAGAAGTCACAACAGTGACCAAGGACTCAATGATTGTTGTATGGGAAAGACCAGCATCTGATGGTGGTAGTGAAATTCTTGGATATGTTCTTGAGAAACGGGATAAAGAAGGCATTAGATGGACAAGATGCCATAAGCGTCTGATTGGAGAGTTGCGCCTGAGAGTAACTGGACTCATAGAAAATCACGATTATGAGTTCAGAGTTTCTGCTGAGAATGCTGCTGGACTTAGTGAACCAAGCCCTCCTTCTGCTTACCAAAAGGCTTGTGATCCTATTTATAAACCAGGACCCCCAAACAACCCCAAAGTCATAGACATAACCAGATCTTCAGTATTCCTTTCTTGGAGCAAACCAATATATGATGGTGGCTGTGAAATTCAAGGATACATTGTTGAAAAATGTGATGTGAGTGTTGGTGAATGGACAATGTGCACTCCACCAACAGGAATTAATAAAACAAACATAGAAGTAGAGAAGCTGTTGGAAAAGCATGAATACAACTTCCGTATCTGTGCTATTAATAAAGCTGGAGTTGGAGAACATGCTGACGTCCCTGGACCTATTATAGTTGAAGAAAAATTAGAAGCACCAGACATTGATCTTGACCTAGAACTAAGGAAAATCATAAATATAAGGGCAGGTGGCTCCTTAAGGTTATTTGTTCCTATAAAAGGTCGTCCTACACCAGAAGTTAAATGGGGAAAGGTGGATGGTGAAATCCGAGATGCAGCTATAATTGATGTCACTAGCAGTTTCACCTCTCTTGTTCTTGACAATGTCAACCGATATGATAGTGGAAAATATACGCTTACATTAGAAAACAGCAGTGGAACAAAGTCTGCCTTTGTTACTGTGAGAGTTCTGGACACGCCAAGTCCACCTGTTAACCTGAAAGTCACAGAAATCACCAAAGACTCAGTATCAATTACATGGGAACCTCCTTTGTTGGATGGGGGATCCAAAATAAAAAATTACATTGTTGAGAAACGTGAAGCCACAAGAAAATCATATGCTGCTGTTGTAACTAACTGCCATAAGAATTCTTGGAAAATCGATCAGCTCCAAGAAGGTTGCAGTTATTACTTTAGAGTCACAGCTGAGAATGAGTATGGTATTGGCCTTCCTGCCCAGACTGCTGATCCAATTAAGGTTGCAGAAGTGCCACAACCTCCTGGAAAAATAACTGTGGATGATGTCACCAGAAACAGTGTCTCTCTGAGTTGGACAAAACCTGAACATGATGGTGGCAGTAAAATCATTCAGTATATTGTGGAAATGCAAGCTAAACACAGTGAGAAATGGTCAGAGTGTGCTCGAGTAAAGTCTCTTCAGGCAGTAATTACCAACCTAACTCAAGGGGAAGAATATCTTTTTAGAGTTGTTGCTGTAAATGAAAAGGGGAGAAGTGATCCTCGGTCCCTTGCAGTTCCAATAGTTGCCAAAGATCTGGTAATTGAGCCAGATGTAAAACCTGCATTCAGTAGTTACAGTGTACAGGTTGGCCAAGATTTGAAAATAGAAGTGCCAATTTCTGGACGTCCTAAGCCAACCATTACCTGGACTAAAGATGGTCTCCCACTGAAGCAGACCACAAGAATCAATGTTACCGATTCACTGGATCTCACCACACTCAGTATTAAAGAAACTCATAAGGATGATGGTGGACAATATGGAATCACAGTTGCCAATGTTGTTGGTCAGAAGACAGCATCCATCGAAATTGTAACTCTAGATAAACCTGATCCTCCAAAAGGACCTGTTAAATTTGATGACGTCAGTGCTGAAAGTATTACATTATCTTGGAACCCTCCATTATATACAGGGGGCTGCCAAATCACCAACTACATTGTTCAGAAAAGAGATACAACCACCACAGTATGGGATGTTGTTTCTGCTACTGTTGCTAGAACTACACTCAAAGTGACCAAACTGAAAACTGGTACAGAATACCAATTTAGAATATTTGCCGAAAACAGATATGGACAAAGCTTTGCCTTAGAGTCTGATCCAATTGTAGCTCAATATCCCTACAAAGAACCAGGCCCTCCAGGTACACCATTTGCCACAGCCATTTCCAAAGACTCCATGGTCATACAGTGGCATGAACCAGTCAACAATGGTGGAAGCCCCGTCATAGGTTACCACCTGGAGAGAAAAGAAAGAAACAGTATTTTGTGGACAAAGGTCAACAAAACTATTATTCATGACACCCAATTCAAAGCACAGAATCTTGAAGAAGGCATTGAATATGAATTCAGAGTGTATGCTGAAAATATTGTTGGTGTAGGCAAAGCAAGCAAGAATTCTGAATGCTATGTAGCCAGAGATCCCTGTGACCCACCAGGAACCCCAGAACCAATAATGGTTAAAAGAAATGAAATCACTTTACAGTGGACCAAACCTGTGTATGATGGTGGAAGTATGATTACAGGCTACATTGTAGAGAAACGTGATTTGCCTGATGGTCGTTGGATGAAAGCTAGCTTTACAAATGTCATTGAAACTCAATTTACTGTGTCAGGTCTTACTGAAGATCAAAGATATGAATTCAGAGTCATTGCAAAGAATGCAGCTGGTGCAATAAGTAAACCCTCTGACAGTACTGGACCAATAACTGCCAAGGATGAGGTTGAACTCCCAAGAATTTCAATGGATCCAAAATTCAGAGACACAATTGTGGTAAATGCTGGAGAAACATTCAGACTTGAGGCTGATGTCCATGGAAAGCCCCTACCTACCATTGAGTGGTTAAGAGGAGATAAGGAAATTGAAGAATCTGCTAGATGTGAAATAAAGAACACAGATTTCAAGGCTTTACTTATTGTAAAAGATGCAATTAGAATTGATGGTGGGCAGTATATTTTAAGAGCTTCCAATGTTGCAGGTTCTAAGTCATTCCCAGTAAATGTAAAAGTATTAGATAGACCAGGACCTCCAGAAGGGCCAGTCCAGGTTACTGGAGTCACTTCTGAAAAATGCTCTTTAACATGGTCTCCACCACTTCAAGATGGTGGCAGTGACATTTCTCACTATGTTGTTGAAAAGCGAGAAACCAGTCGACTTGCCTGGACTGTTGTTGCTTCAGAAGTTGTGACCAATTCTCTGAAAGTTACCAAACTCTTAGAAGGTAATGAATATGTTTTCCGTATAATGGCTGTCAACAAATATGGTGTTGGAGAGCCTTTGGAATCTGCACCAGTACTAATGAAAAATCCATTTGTGCTTCCTGGACCACCAAAAAGCTTGGAAGTCACAAATATTGCCAAAGACTCCATGACCGTCTGTTGGAACCGTCCAGATAGTGATGGTGGAAGTGAGATTATTGGTTACATTGTAGAGAAAAGAGACAGAAGTGGCATTCGATGGATAAAATGTAATAAACGCCGCATTACAGATTTGCGTCTAAGAGTGACAGGATTAACAGAAGATCATGAGTATGAATTCAGGGTCTCTGCAGAAAATGCTGCTGGAGTTGGGGAACCAAGTCCAGCTACAGTTTATTATAAAGCCTGTGATCCTGTGTTCAAACCTGGCCCACCTACCAATGCACACATTGTAGACACCACTAAAAATTCAATCACACTTGCCTGGGGTAAACCCATCTATGATGGCGGCAGTGAGATCTTGGGATATGTAGTAGAAATCTGTAAAGCAGATGAAGAAGAATGGCAAATAGTTACTCCACAGACTGGCCTGAGAGTCACTCGATTTGAAATTTCAAAACTCACTGAACACCAAGAGTATAAAATACGAGTCTGTGCCCTCAACAAAGTTGGTTTAGGTGAGGCTACATCAGTTCCTGGTACTGTGAAACCAGAAGATAAACTTGAAGCACCTGAACTTGACCTTGACTCCGAATTAAGAAAAGGAATTGTTGTAAGAGCTGGTGGATCTGCCAGAATTCACATTCCATTCAAAGGTCGTCCAACGCCTGAGATCACTTGGTCTCGAGAGGAAGGTGAATTCACAGATAAGGTCCAAATTGAAAAGGGAGTAAACTATACCCAACTATCAATAGATAACTGTGATAGAAATGATGCTGGAAAATACATTCTTAAGTTGGAAAACAGCAGTGGATCAAAGTCTGCTTTTGTAACTGTGAAAGTTCTTGACACTCCAGGACCACCACAGAATTTGGCAGTCAAAGAAGTGAGAAAAGATTCTGCCTTCCTGGTATGGGAGCCACCCATCATTGATGGAGGGGCAAAGGTCAAGAACTATGTGATTGACAAACGTGAGTCAACCAGAAAAGCGTATGCTAATGTGAGTAGTAAATGCAGCAAAACAAGTTTTAAAGTGGAAAACCTTACAGAAGGAGCCATTTATTACTTCAGAGTCATGGCTGAAAATGAATTTGGAGTTGGTGTTCCAGTGGAAACTGTTGATGCCGTGAAAGCTGCTGAACCTCCTTCCCCACCAGGAAAGGTTACACTCACTGATGTGTCCCAGACCAGTGCATCACTTATGTGGGAGAAACCTGAACATGATGGCGGTAGCAGAGTCCTGGGGTACGTTGTTGAAATGCAGCCCAAAGGAACTGAAAAATGGAGCATTGTGGCTGAATCCAAAGTCTGTAATGCAGTTGTTACTGGTTTGAGTTCTGGACAAGAATATCAGTTCCGTGTCAAGGCTTATAATGAGAAAGGAAAAAGCGATCCAAGAGTGTTGGGTGTTCCTGTCATAGCCAAGGACTTGACTATACAGCCTAGTTTAAAGTTACCATTTAACACATATAGTATCCAAGCTGGAGAAGATCTTAAAATAGAAATTCCAGTTATAGGCCGACCAAGACCTAACATTTCTTGGGTCAAAGATGGTGAGCCTCTTAAACAGACAACAAGAGTAAACGTTGAAGAAACAGCTACCTCAACTGTTTTGCACATTAAAGAAGGTAACAAAGATGACTTTGGAAAATACACCGTAACGGCAACAAATAGTGCAGGCACAGCAACAGAAAATCTCAGTGTTATCGTTTTAGAAAAGCCTGGACCTCCAGTTGGCCCAGTTCGGTTTGATGAAGTTAGTGCAGACTTTGTAGTCATATCTTGGGAACCTCCAGCCTATACTGGTGGCTGCCAAATAAGCAACTACATTGTAGAGAAGCGAGATACAACCACCACCACTTGGCACATGGTATCAGCAACAGTTGCAAGAACAACAATTAAAATAACCAAACTGAAAACAGGCACGGAGTACCAGTTTAGAATTTTTGCTGAAAACAGGTATGGAAAAAGTGCCCCACTGGATTCTAAGGCAGTTATTGTACAATATCCATTTAAAGAACCTGGACCACCTGGAACTCCTTTTGTGACATCAATCTCAAAAGATCAGATGCTTGTGCAATGGCATGAGCCAGTGAATGATGGAGGCACCAAAATTATTGGCTACCATCTTGAACAGAAAGAAAAGAACAGTATTTTATGGGTCAAGTTAAATAAGACCCCCATTCAGGACACCAAATTCAAAACAACTGGGCTTGATGAGGGCCTTGAGTATGAGTTCAAAGTTTCTGCTGAAAATATTGTTGGCATTGGCAAGCCTAGCAAAGTGTCAGAATGCTTTGTTGCTCGTGATCCATGTGACCCACCTGGTCGCCCTGAAGCCATTGTTATTACAAGAAACAATGTCACACTGAAATGGAAGAAACCTGCCTATGATGGTGGTAGCAAAATAACAGGTTATATTGTAGAAAAGAAAGATCTACCTGATGGCCGCTGGATGAAAGCCAGCTTTACCAACGTATTAGAAACTGAATTTACAGTGAGTGGACTTGTAGAAGACCAAAGATATGAATTTAGAGTAATTGCAAGAAATGCAGCTGGAAACTTTAGTGAACCATCTGATAGTAGTGGTGCCATTACTGCAAGAGATGAAATTGATGCACCAAATGCCTCTCTGGATCCAAAATATAAAGATGTCATCGTTGTTCATGCAGGAGAGACTTTTGTTCTTGAAGCCGACATCCGTGGCAAACCTATACCTGATGTTGTTTGGTCAAAAGATGGAAAAGAACTTGAAGAAACAGCTGCTAGAATGGAAATTAAATCTACTATTCAGAAAACAACTCTTGTTGTCAAAGACTGTATACGGACTGATGGAGGACAATATATTCTGAAACTCAGCAATGTTGGTGGTACAAAGTCTATACCCATCACTGTAAAGGTACTTGACAGGCCAGGGCCTCCTGAAGGGCCTCTGAAAGTTACTGGAGTTACTGCGGAAAAATGTTACCTGGCATGGAACCCACCTTTGCAAGATGGTGGTGCTAATATTTCACATTACATCATTGAAAAGAGGGAGACAAGCCGACTCTCTTGGACCCAGGTTTCAACTGAGGTACAGGCCCTTAACTACAAAGTTACTAAACTTCTTCCTGGTAATGAGTACATTTTCCGTGTCATGGCTGTGAATAAATATGGAATTGGAGAGCCCTTGGAATCTGGGCCTGTTACGGCCTGTAATCCTTATAAGCCACCAGGTCCTCCCTCAACACCTGAAGTCTCAGCAATCACCAAAGATTCTATGGTAGTAACATGGGCACGCCCAGTAGACGACGGAGGTACCGAAATTGAGGGCTACATTCTTGAAAAACGAGATAAGGAAGGCGTTAGATGGACCAAGTGCAACAAGAAAACATTAACGGATCTGCGGCTCAGGGTAACTGGTCTTACCGAAGGCCATTCCTATGAATTCAGAGTTGCTGCTGAAAATGCAGCTGGTGTGGGAGAACCTAGTGAGCCATCTGTTTTCTACCGTGCGTGTGATGCCTTGTATCCACCAGGTCCCCCAAGCAATCCAAAAGTGACGGACACTTCCAGATCTTCTGTCTCCCTGGCATGGAGTAAGCCAATTTATGATGGTGGCGCACCTGTTAAAGGCTATGTTGTAGAGGTCAAAGAAGCTGCTGCGGATGAATGGACAACCTGCACTCCACCAACAGGATTACAAGGAAAGCAGTTCACAGTGACCAAGCTTAAAGAAAACACTGAATATAACTTCCGTATTTGTGCCATCAATTCTGAAGGTGTAGGTGAACCTGCAACTCTACCTGGCTCAGTGGTTGCTCAGGAGAGGATAGAGCCACCAGAAATAGAACTCGATGCTGATCTCAGAAAGGTGGTCGTTCTGCGTGCAAGTGCTACTTTACGCTTATTTGTCACTATCAAAGGTCGACCAGAACCCGAAGTTAAATGGGAAAAGGCAGAAGGCATTCTCACTGACAGGGCTCAGATAGAGGTGACCAGCTCATTTACAATGTTGGTGATTGATAATGTTACCAGATTTGACAGTGGTCGGTATAATCTGACATTAGAAAATAATAGTGGCTCCAAAACAGCTTTTGTTAACGTCAGAGTTCTTGACTCACCAAGTGCCCCTGTGAATTTGACCATAAGAGAAGTGAAGAAAGACTCAGTGACGTTGTCCTGGGAACCACCACTTATTGATGGTGGAGCTAAGATTACAAACTACATTGTCGAAAAACGAGAAACTACAAGAAAAGCCTATGCTACCATTACAAATAATTGCACTAAAACTACTTTCAGAATTGAAAATCTACAAGAAGGATGTTCTTACTACTTCCGAGTCTTGGCTTCCAATGAATATGGGATTGGTTTGCCAGCTGAAACAACAGAACCCGTTAAAGTGTCTGAACCACCCCTCCCACCTGGAAGAGTAACTCTTGTTGATGTGACCCGTAATACAGCTACAATTAAGTGGGAGAAACCAGAAAGTGATGGTGGCAGCAAAATTACTGGTTATGTGGTTGAAATGCAGACTAAAGGGAGTGAAAAGTGGAGCACCTGCACACAAGTTAAGACTCTAGAAGCAACTATATCTGGCTTAACTGCAGGAGAAGAGTATGTCTTCAGGGTAGCTGCAGTTAACGAAAAGGGAAGAAGTGATCCAAGACAACTTGGAGTGCCAGTAATTGCAAGGGATATTGAAATAAAGCCTTCAGTTGAGCTTCCTTTCCATACTTTCAATGTAAAGGCTAGAGAACAACTTAAGATTGATGTGCCATTCAAAGGAAGACCTCAAGCTACTGTGAACTGGAGAAAAGATGGTCAGACTCTTAAAGAGACAACTAGAGTCAATGTTTCTTCTTCAAAGACTGTAACATCACTATCTATTAAGGAAGCTTCAAAGGAAGATGTTGGAACTTATGAATTATGTGTTTCAAACAGTGCTGGATCCATAACAGTTCCTATTACTATAATTGTCCTTGACAGACCAGGACCTCCAGGTCCTATACGTATTGATGAGGTTAGTTGTGACAGCATAACCATTTCTTGGAATCCTCCAGAATATGATGGTGGCTGCCAAATTAGCAATTACATTGTTGAAAAGAAAGAAACCACCTCTACAACATGGCACATAGTTTCACAAGCAGTTGCAAGAACATCCATTAAAATAGTTCGCCTGACAACAGGAAGTGAGTATCAGTTCCGTGTTTGTGCAGAAAACCGCTATGGAAAGAGCTCCTACAGTGAATCTTCAGCTGTTGTTGCAGAGTATCCATTCAGTCCCCCAGGTCCTCCTGGTACTCCTAAAGTTGTGCATGCCACAAAATCTACCATGCTTGTAACCTGGCAAGTGCCAGTTAATGATGGAGGAAGTCGAGTAATTGGCTATCATCTTGAGTATAAAGAAAGAAGCAGCATTCTTTGGTCAAAAGCAAATAAAATCCTCATTGCTGATACTCAAATGAAAGTCTCCGGCCTTGATGAAGGACTGATGTATGAGTATCGTGTATATGCTGAAAATATTGCTGGAATTGGTAAATGCAGTAAATCTTGTGAACCAGTCCCTGCAAGAGATCCTTGTGACCCTCCTGGACAACCTGAAGTCACAAATATCACAAGAAAATCAGTGTCACTTAAATGGTCTAAACCACATTATGATGGTGGAGCTAAGATCACAGGATACATTGTTGAACGCAGAGAACTACCAGATGGCCGGTGGCTGAAGTGCAATTATACTAATATACAAGAAACATACTTTGAAGTAACTGAACTTACTGAAGATCAGCGTTATGAATTCCGGGTTTTTGCAAGGAATGCTGCTGACTCAGTTAGTGAGCCATCTGAATCCACTGGGCCTATTATAGTTAAAGATGATGTTGAGCCTCCAAGAGTTATGATGGATGTCAAGTTCCGAGACGTTATTGTTGTCAAAGCTGGAGAGGTCCTTAAGATAAATGCAGACATTGCAGGGCGACCTCTGCCAGTAATTTCCTGGGCCAAGGATGGTATAGAAATTGAAGAAAGAGCAAGAACAGAAATCATCTCAACAGACAATCATACTTTGTTAACAGTTAAAGACTGTATAAGACGAGACACTGGGCAATATGTACTAACACTGAAGAATGTTGCCGGCACTCGGTCTGTGGCCGTTAATTGCAAAGTACTTGATAAGCCTGGTCCACCAGCAGGACCACTTGAAATAAATGGCCTCACTGCTGAGAAATGCTCTCTTTCCTGGGGACGTCCCCAAGAAGATGGTGGTGCAGATATCGACTATTACATCGTAGAAAAACGTGAAACAAGCCACCTTGCATGGACAATATGTGAAGGAGAGTTACAGATGACATCCTGTAAAGTAACCAAGTTACTCAAAGGCAATGAATATATATTTAGAGTAACTGGTGTTAATAAATATGGTGTTGGTGAGCCCCTAGAGAGTGTAGCTATAAAGGCACTAGATCCATTTACAGTTCCAAGTCCACCCACGTCTTTGGAAATTACTTCTGTGACCAAAGAATCTATGACACTTTGCTGGTCAAGACCCGAGAGTGATGGAGGTAGTGAAATATCTGGATATATAATTGAAAGGCGAGAGAAAAATAGCCTAAGATGGGTGCGTGTAAACAAAAAACCAGTTTATGATCTAAGAGTGAAATCAACAGGACTTCGGGAAGGATGTGAATATGAATATCGTGTTTATGCAGAAAATGCTGCTGGCCTAAGTCTTCCAAGTGAAACCTCTCCCTTAATTAGGGCAGAAGATCCAGTGTTCCTACCATCTCCTCCATCCAAACCCAAAATTGTGGACTCAGGCAAGACAACTATAACTATTGCCTGGGTTAAGCCGCTGTTTGATGGTGGGGCCCCGATAACTGGATATACTGTAGAATACAAAAAATCTGATGACACTGACTGGAAAACTTCCATTCAGAGCTTACGAGGGACAGAATATACAATAAGCGGACTAACAACAGGAGCTGAATATGTTTTCAGAGTAAAATCTGTCAATAAGGTTGGTGCTAGTGACCCCAGTGATAGCTCTGACCCTCAGATAGCAAAGGAAAGAGAAGAAGAACCTTTATTTGATATTGACAGTGAAATGAGGAAGACCTTGATTGTCAAGGCTGGTGCCTCATTTACCATGACTGTGCCTTTCCGAGGAAGACCAGTACCCAATGTCTTGTGGAGTAAGCCAGACACTGACCTCCGTACTAGAGCTTATGTTGATACCACAGACTCTCGTACATCACTGACCATTGAAAATGCCAACAGAAATGACTCTGGAAAGTACACATTAACAATTCAGAATGTTTTGAGTGCTGCTTCACTGACCTTAGTTGTCAAAGTTTTAGATACCCCAGGTCCTCCAACCAACATTACTGTGCAAGATGTAACCAAAGAGTCTGCAGTGTTATCCTGGGATGTTCCTGAAAACGATGGTGGAGCACCAGTGAAGAATTACCACATAGAAAAACGTGAGGCCAGCAAGAAAGCATGGGTCTCTGTGACCAACAACTGTAACCGCCTCTCCTACAAAGTTACCAATTTACAAGAAGGAGCTATCTATTACTTCAGAGTCTCTGGAGAAAATGAGTTTGGTGTTGGTATACCAGCTGAAACAAAGGAAGGAGTAAAAATAACAG
>TTN-205,ENSE00003802597,1,297,3177533,3177829,AAAAACCAAGCCCACCTGAAAAACTTGGAGTAACAAGTATATCCAAAGACAGTGTTTCCCTGACCTGGCTGAAGCCTGAACATGATGGCGGAAGCAGAATTGTACACTATGTCGTTGAAGCACTAGAAAAAGGACAGAAAAACTGGGTTAAATGTGCAGTGGCAAAGTCAACCCATCACGTTGTTTCCGGTCTGAGAGAGAATTCTGAATACTTTTTCCGAGTGTTTGCTGAAAATCAAGCTGGCCTGAGTGACCCGAGAGAGCTTCTGCTTCCTGTTCTTATTAAGGAGCAACTAG
>TTN-205,ENSE00003802941,1,588,3177830,3178417,AACCACCTGAAATTGATATGAAGAATTTCCCAAGTCACACTGTATATGTTAGAGCTGGTTCAAACCTTAAAGTTGACATTCCAATCTCTGGAAAACCACTTCCCAAAGTGACCTTATCAAGAGATGGTGTCCCCCTTAAGGCAACCATGAGATTTAATACCGAAATTACTGCTGAGAACCTGACCATCAATCTCAAAGAAAGTGTTACAGCTGACGCTGGGAGATATGAAATCACTGCTGCCAACTCCAGTGGTACAACCAAAGCTTTCATTAACATTGTTGTGCTAGACAGGCCTGGTCCTCCAACTGGCCCTGTTGTTATTAGTGATATAACTGAAGAAAGTGTGACTCTCAAATGGGAGCCACCTAAGTATGACGGTGGAAGTCAAGTTACCAACTACATTCTACTCAAAAGAGAAACAAGTACTGCAGTGTGGACTGAAGTGTCTGCAACAGTTGCAAGAACCATGATGAAAGTCATGAAACTGACCACAGGAGAAGAATACCAATTCCGCATCAAGGCAGAAAACCGCTTTGGCATCAGTGATCATATAGATTCAGCTTGTGTGACTGTCAAACTACCATACA
>TTN-205,ENSE00003808789,1,303,3178418,3178720,CAACACCTGGACCACCATCTACACCATGGGTCACTAATGTTACTCGAGAAAGCATCACTGTGGGCTGGCATGAACCAGTGTCAAATGGAGGCAGTGCAGTCGTAGGCTATCACCTGGAAATGAAAGACAGAAACAGTATTTTATGGCAAAAAGCCAACAAACTGGTCATCCGCACAACTCACTTCAAAGTCACAACAATCAGTGCTGGACTTATTTATGAATTCAGGGTGTATGCAGAAAATGCTGCTGGAGTTGGAAAACCTAGCCATCCTTCTGAACCAGTCTTGGCAATTGATGCTTGTG
>TTN-205,ENSE00003806587,1,297,3178721,3179017,AACCCCCAAGAAATGTTCGTATCACTGATATTTCAAAGAACTCTGTCAGCCTTTCATGGCAACAACCAGCTTTCGATGGAGGTAGCAAGATTACAGGCTACATTGTTGAGAGACGTGACCTTCCAGATGGCAGATGGACCAAGGCCAGCTTCACCAATGTTACTGAAACTCAATTCATCATCTCTGGCTTGACTCAGAATTCCCAGTATGAATTCCGTGTCTTTGCTAGGAATGCTGTTGGTTCCATTAGCAATCCATCTGAGGTTGTAGGGCCCATTACTTGCATCGATTCTTATG
>TTN-205,ENSE00003807681,1,288,3179018,3179305,GTGGTCCTGTAATTGATTTGCCTCTAGAATATACAGAAGTTGTCAAATACAGAGCAGGTACATCTGTGAAGCTCAGAGCTGGCATTTCTGGCAAACCTGCGCCTACTATTGAGTGGTATAAAGATGATAAAGAATTACAAACCAATGCACTGGTGTGTGTTGAAAATACCACGGACCTCGCATCTATACTCATCAAAGATGCCGATCGCCTTAATAGTGGATGCTATGAATTAAAACTAAGGAATGCCATGGGCTCAGCCTCAGCCACCATCAGAGTACAGATCCTTG
>TTN-205,ENSE00003811102,1,300,3179306,3179605,ACAAACCAGGCCCACCTGGTGGACCAATTGAATTTAAGACTGTAACTGCTGAGAAGATCACCCTTCTCTGGCGGCCTCCAGCTGATGATGGTGGTGCAAAAATCACTCACTACATTGTGGAAAAGCGTGAGACAAGCCGCGTTGTGTGGTCTATGGTGTCTGAACATTTGGAAGAGTGCATCATTACAACCACCAAAATTATCAAAGGAAATGAATACATCTTCCGGGTCCGAGCCGTGAACAAATATGGAATTGGCGAGCCACTGGAATCTGATTCCGTTGTAGCCAAGAACGCATTTG
>TTN-205,ENSE00003802386,1,303,3179606,3179908,TTACACCTGGGCCACCAGGCATACCAGAAGTGACAAAGATTACCAAGAATTCGATGACTGTTGTATGGAGCAGGCCAATTGCAGATGGCGGTAGTGATATAAGTGGCTATTTCCTTGAAAAACGAGACAAGAAGAGCCTAGGATGGTTTAAAGTACTAAAAGAGACTATCCGTGACACCAGACAAAAAGTAACAGGACTCACAGAAAACAGTGACTATCAATACAGAGTTTGTGCTGTAAACGCTGCTGGACAGGGTCCATTTTCTGAACCATCTGAATTCTACAAAGCTGCTGATCCTATTG
>TTN-205,ENSE00003809908,1,306,3179909,3180214,ATCCTCCAGGTCCACCTGCTAAGATAAGAATCGCAGATTCAACCAAGTCATCCATCACCCTTGGCTGGAGTAAGCCTGTCTATGATGGGGGCAGTGCTGTTACTGGGTATGTTGTCGAGATAAGACAAGGAGAGGAAGAGGAATGGACTACTGTCTCTACCAAAGGAGAGGTCAGAACTACAGAATATGTGGTATCCAACCTGAAACCTGGAGTCAATTACTACTTCCGGGTATCTGCTGTAAACTGTGCTGGACAAGGAGAACCTATAGAAATGAATGAACCTGTACAAGCTAAAGATATACTTG
>TTN-205,ENSE00003808993,1,1767,3180215,3181981,AGGCACCAGAGATTGACCTGGATGTGGCTCTCAGAACTTCTGTTATTGCCAAAGCTGGTGAAGATGTACAAGTGTTGATTCCCTTTAAAGGCAGACCTCCACCTACTGTCACATGGAGAAAAGATGAGAAGAATCTTGGCAGTGATGCCAGATACAGCATTGAAAACACTGATTCATCCTCATTACTCACCATTCCTCAAGTTACTCGCAATGATACAGGAAAATATATTCTCACAATAGAAAATGGAGTTGGTGAACCTAAGTCTTCAACTGTGAGTGTTAAAGTGCTTGACACACCAGCTGCCTGCCAGAAACTACAGGTTAAACATGTTTCTCGAGGCACAGTCACTTTGCTCTGGGATCCTCCTCTCATTGATGGAGGATCTCCAATAATTAATTATGTCATTGAAAAGAGAGATGCCACCAAGAGAACATGGTCTGTCGTGTCACACAAATGTTCTAGCACATCCTTCAAGCTAATAGATTTGTCGGAGAAGACTCCATTCTTCTTCAGAGTTCTTGCAGAAAATGAAATTGGAATTGGGGAACCCTGTGAAACTACAGAGCCAGTGAAGGCTGCTGAAGTACCAGCTCCTATACGTGATCTCTCAATGAAAGACTCAACAAAGACATCTGTCATCCTCAGCTGGACCAAACCTGACTTTGATGGTGGTAGCGTCATCACAGAATATGTTGTAGAAAGGAAAGGTAAAGGTGAACAGACGTGGTCCCACGCTGGCATAAGTAAGACATGTGAAATTGAGGTTAGCCAACTTAAGGAGCAGTCAGTCCTGGAGTTCAGAGTGTTTGCCAAAAATGAGAAAGGACTGAGTGATCCTGTCACTATTGGGCCAATTACAGTGAAAGAACTTATTATTACACCTGAAGTTGACCTGTCAGATATCCCTGGGGCACAAGTCACTGTGAGAATTGGGCACAATGTGCACCTTGAATTACCTTATAAGGGAAAACCCAAACCATCCATCAGTTGGCTGAAAGATGGCTTGCCACTGAAAGAAAGTGAATTTGTTCGCTTCAGTAAAACTGAAAACAAAATTACTTTGAGTATTAAGAATGCCAAGAAGGAGCATGGAGGAAAATACACTGTTATTCTTGATAATGCAGTGTGTAGAATTGCAGTCCCCATTACAGTCATCACCCTTGGCCCACCATCAAAGCCCAAAGGACCCATTCGATTTGATGAAATCAAGGCTGATAGTGTCATCCTGTCATGGGATGTACCTGAAGATAATGGAGGAGGAGAAATTACTTGTTACAGCATCGAGAAGCGGGAAACTTCACAAACTAACTGGAAGATGGTGTGTTCAAGTGTTGCCAGAACGACTTTCAAAGTTCCTAATCTAGTCAAAGATGCTGAGTACCAGTTTAGAGTGAGAGCAGAAAACAGATACGGAGTCAGCCAACCACTTGTCTCAAGCATTATTGTGGCAAAACACCAGTTCAGGATTCCTGGTCCCCCAGGAAAGCCAGTTATATACAATGTGACTTCTGATGGCATGTCACTAACTTGGGATGCTCCAGTTTATGATGGTGGTTCAGAAGTTACTGGATTCCATGTTGAAAAGAAAGAAAGAAATAGCATCCTCTGGCAAAAAGTTAATACATCACCAATCTCTGGAAGAGAATATAGAGCCACTGGACTGGTAGAAGGTCTGGATTACCAATTCCGTGTATATGCTGAAAATTCTGCTGGCCTAAGCTCACCTAGTGACCCAAGCAAATTTACCTTAGCTGTTTCTCCAGTAG
>TTN-205,ENSE00003811205,1,294,3181982,3182275,ACCCACCTGGCACTCCTGACTACATTGATGTCACCCGGGAAACCATCACACTTAAATGGAACCCACCATTGCGTGATGGAGGCAGTAAGATTGTGGGCTATAGCATTGAGAAACGGCAAGGAAATGAACGCTGGGTGAGATGCAACTTTACTGACGTCAGTGAATGTCAGTACACAGTTACAGGACTCAGTCCTGGGGATCGCTATGAGTTCAGAATAATTGCAAGAAATGCTGTTGGAACTATAAGCCCGCCCTCACAGTCTTCTGGCATTATTATGACAAGAGATGAAAATG
>TTN-205,ENSE00003808021,1,288,3182276,3182563,TTCCACCAATAGTAGAGTTTGGCCCTGAATACTTTGATGGTCTCATTATTAAGTCCGGAGAGAGCCTTAGAATTAAAGCTTTGGTACAAGGAAGACCAGTGCCTCGAGTAACTTGGTTCAAAGATGGAGTGGAAATCGAAAAGAGGATGAATATGGAAATAACCGACGTACTTGGATCCACCAGCCTATTTGTTAGAGATGCTACTCGGGACCATCGTGGTGTATACACAGTGGAAGCCAAAAATGCATCTGGTTCTGCAAAAGCAGAAATTAAAGTGAAAGTACAAG
>TTN-205,ENSE00003804355,1,300,3182564,3182863,ATACACCAGGAAAAGTAGTTGGGCCAATAAGATTCACCAATATTACTGGGGAGAAGATGACTCTGTGGTGGGATGCCCCACTCAATGACGGTTGTGCTCCCATAACCCACTACATCATTGAAAAACGGGAAACCAGCAGACTTGCCTGGGCACTAATTGAGGATAAATGTGAAGCCCAAAGTTACACTGCCATTAAACTAATAAACGGCAATGAATACCAATTCCGTGTTTCTGCAGTTAACAAGTTTGGTGTTGGCAGGCCACTTGATTCTGATCCAGTGGTTGCTCAAATACAATATA
>TTN-205,ENSE00003807046,1,2067,3182864,3184930,CTGTTCCTGATGCCCCTGGCATTCCAGAACCTAGCAACATAACAGGCAACAGCATTACCCTGACATGGGCAAGGCCAGAATCAGATGGTGGCAGTGAAATTCAACAGTATATCCTTGAAAGAAGAGAAAAGAAAAGCACAAGATGGGTAAAAGTGATCAGCAAACGACCAATCTCTGAAACAAGATTCAAAGTCACTGGTCTGACAGAAGGCAATGAGTATGAATTCCATGTCATGGCTGAAAATGCTGCAGGAGTTGGACCTGCAAGTGGCATCTCAAGACTCATTAAATGTAGAGAGCCCGTCAACCCACCAGGTCCTCCCACAGTGGTCAAAGTAACAGACACATCAAAGACAACTGTGAGCTTAGAATGGTCCAAACCAGTGTTTGATGGTGGCATGGAAATAATTGGGTATATTATTGAAATGTGTAAGGCCGACTTAGGAGACTGGCACAAGGTGAATGCAGAGGCATGTGTGAAAACAAGATATACAGTCACTGATCTACAAGCAGGTGAAGAATACAAATTCCGAGTTAGTGCTATCAATGGTGCTGGAAAAGGCGACAGCTGTGAAGTGACTGGCACAATTAAAGCAGTTGACCGGTTAACAGCTCCTGAGTTAGACATAGATGCAAACTTCAAACAGACTCATGTTGTTAGAGCTGGGGCCAGTATTCGCCTCTTCATTGCCTACCAAGGTAGACCTACTCCTACAGCTGTGTGGAGCAAACCAGACTCTAACCTTAGCCTTCGGGCTGATATCCATACAACAGATTCCTTCAGCACCCTCACTGTGGAAAACTGCAACAGAAATGATGCAGGGAAATATACCCTTACTGTGGAAAACAACAGTGGTAGTAAGTCAATCACATTCACCGTGAAAGTGCTAGACACTCCAGGCCCACCTGGCCCAATTACCTTCAAAGATGTGACCCGGGGATCTGCTACATTGATGTGGGATGCCCCTCTTCTTGACGGTGGTGCCCGAATCCATCATTATGTGGTAGAGAAACGAGAGGCAAGTCGCCGTAGTTGGCAGGTTATCAGTGAAAAATGCACTCGTCAGATCTTCAAGGTCAATGACCTGGCCGAAGGTGTTCCGTACTATTTCCGTGTTTCTGCAGTAAATGAGTATGGTGTTGGTGAGCCCTATGAAATGCCAGAACCAATTGTAGCCACAGAACAGCCTGCTCCACCTAGGAGACTTGATGTTGTTGATACTAGCAAATCCTCCGCAGTCTTAGCTTGGCTTAAACCTGACCACGATGGAGGCAGCCGGATCACTGGCTACCTGCTTGAAATGAGACAAAAGGGATCTGACTTCTGGGTTGAAGCTGGTCACACCAAACAGCTAACTTTCACAGTAGAGCGTCTTGTTGAGAAAACTGAATATGAATTCCGTGTGAAGGCCAAGAATGATGCTGGCTATAGTGAACCCAGAGAAGCCTTCTCTTCTGTCATCATTAAGGAGCCTCAAATCGAGCCCACTGCTGACCTCACTGGAATTACCAATCAGCTTATAACTTGCAAAGCAGGAAGCCCATTTACCATTGACGTACCAATCAGTGGTCGTCCTGCCCCCAAAGTAACATGGAAACTGGAAGAAATGAGACTTAAAGAGACAGATCGAGTGAGCATTACAACAACAAAAGACAGAACCACACTGACTGTAAAGGACAGCATGAGAGGTGACTCTGGAAGATACTTCTTGACCCTGGAAAATACAGCTGGTGTTAAAACATTTAGCGTCACAGTTGTGGTCATTGGAAGGCCAGGTCCAGTAACCGGCCCCATTGAGGTCTCATCTGTCTCAGCTGAATCGTGTGTCCTGTCATGGGGAGAACCTAAAGATGGAGGAGGCACTGAAATTACTAATTACATAGTTGAAAAGCGTGAATCGGGTACAACAGCTTGGCAGCTTGTCAATTCCAGTGTCAAGCGCACTCAAATTAAAGTCACTCATCTCACAAAATACATGGAATATTCTTTCCGTGTCAGTTCAGAGAACAGATTTGGTGTCAGCAAACCTCTAGAATCAGCACCAATAATTGCTGAACATCCATTTG
>TTN-205,ENSE00003810611,1,303,3184931,3185233,TCCCACCAAGCGCTCCTACCAGACCTGAGGTCTACCATGTGTCTGCCAATGCCATGTCTATTCGTTGGGAAGAACCCTACCACGATGGTGGCAGTAAAATCATTGGCTACTGGGTTGAGAAGAAAGAACGTAATACAATTCTTTGGGTGAAAGAAAACAAAGTGCCATGCTTAGAGTGCAACTACAAAGTAACTGGTTTAGTAGAAGGACTGGAATATCAGTTCAGAACTTATGCACTCAATGCTGCAGGTGTTAGCAAGGCCAGCGAAGCTTCAAGACCTATAATGGCTCAAAATCCAGTTG
>TTN-205,ENSE00003803222,1,306,3185234,3185539,ATGCACCAGGCAGACCAGAGGTGACAGATGTCACAAGATCAACAGTATCACTGATTTGGTCTGCCCCAGCGTATGATGGAGGCAGCAAGGTTGTGGGCTACATCATAGAGCGTAAGCCAGTCAGTGAGGTAGGAGATGGTCGCTGGCTGAAGTGCAACTACACCATTGTATCTGACAATTTCTTCACCGTGACTGCTCTCAGTGAAGGAGACACTTATGAGTTCCGTGTGTTAGCCAAGAATGCAGCAGGCGTAATTAGCAAAGGGTCTGAATCTACAGGCCCTGTCACTTGCCGAGATGAATACG
>TTN-205,ENSE00003801213,1,291,3185540,3185830,CTCCACCCAAAGCCGAACTGGATGCCCGATTACACGGTGATCTGGTTACCATCAGAGCAGGTTCTGATCTTGTTCTGGATGCTGCAGTTGGTGGCAAACCTGAACCCAAAATTATCTGGACCAAAGGAGACAAGGAGCTAGATCTCTGTGAAAAAGTCTCTTTGCAGTATACTGGCAAACGAGCAACTGCTGTGATCAAGTTCTGTGACAGAAGTGACAGTGGAAAATACACTTTAACAGTGAAAAATGCCAGCGGGACCAAGGCCGTGTCTGTCATGGTCAAAGTGCTTG
>TTN-205,ENSE00003809128,1,297,3185831,3186127,ATTCCCCTGGCCCATGTGGAAAGCTCACCGTCAGCAGAGTAACACAGGAGAAGTGCACTTTAGCCTGGAGCCTTCCGCAGGAAGACGGAGGAGCAGAAATCACTCACTACATCGTGGAAAGACGCGAGACTAGCAGGCTCAACTGGGTGATTGTTGAAGGCGAATGCCCAACCCTATCCTATGTCGTTACCAGGCTCATCAAGAACAATGAGTACATATTCCGAGTGAGGGCAGTAAACAAATATGGCCCTGGTGTGCCTGTTGAATCAGAGCCAATTGTAGCCAGAAACTCATTCA
>TTN-205,ENSE00003803385,1,306,3186128,3186433,CTATTCCATCACCACCCGGCATACCTGAAGAAGTTGGGACTGGCAAAGAGCATATCATCATTCAGTGGACAAAACCTGAATCTGATGGTGGCAATGAAATCAGCAACTACCTAGTAGACAAACGTGAGAAGAAGAGCCTGCGCTGGACACGTGTCAACAAAGACTATGTGGTGTATGATACCAGGCTGAAGGTGACCAGCCTGATGGAGGGTTGTGATTACCAGTTCCGGGTGACCGCAGTGAATGCAGCTGGTAACAGTGAGCCCAGCGAAGCTTCCAACTTCATCTCATGCAGAGAACCATCAT
>TTN-205,ENSE00003807140,1,306,3186434,3186739,ATACCCCTGGACCACCTTCTGCTCCAAGAGTTGTGGATACCACCAAACACAGCATTAGTTTGGCATGGACCAAACCCATGTACGATGGTGGTACTGACATTGTAGGATATGTTCTGGAAATGCAAGAGAAGGACACTGATCAGTGGTACCGAGTGCATACCAATGCCACAATAAGAAATACTGAATTCACTGTGCCAGACCTTAAAATGGGCCAGAAATATTCCTTCAGAGTTGCTGCCGTGAACGTGAAGGGTATGAGCGAATACAGCGAATCAATTGCTGAAATTGAGCCCGTGGAAAGAATAG
>TTN-205,ENSE00003809946,1,282,3186740,3187021,AAATACCAGATCTTGAGCTTGCAGATGATCTAAAGAAGACTGTGACCATCAGGGCTGGGGCCTCCTTGCGCTTGATGGTGTCTGTATCTGGAAGACCACCTCCTGTCATAACGTGGAGCAAGCAGGGCATTGACCTTGCAAGCCGGGCAATTATTGACACCACTGAGAGCTACTCATTGCTAATAGTGGACAAAGTTAATCGGTACGATGCTGGAAAATACACAATTGAAGCTGAAAACCAATCTGGCAAGAAATCAGCAACAGTCCTTGTTAAAGTCTATG
>TTN-205,ENSE00003810384,1,594,3187022,3187615,ATACTCCTGGTCCCTGTCCTTCAGTGAAAGTTAAGGAAGTATCAAGAGATTCTGTGACTATAACTTGGGAAATTCCCACGATTGATGGTGGAGCTCCAGTCAACAATTACATCGTTGAGAAGCGTGAAGCTGCTATGAGAGCATTCAAAACAGTAACTACCAAATGCAGCAAGACACTTTACAGAATTTCTGGACTTGTAGAAGGAACCATGTACTATTTCAGAGTGCTGCCAGAAAATATTTATGGCATTGGAGAACCTTGTGAAACATCTGATGCAGTACTGGTCTCAGAAGTGCCTTTGGTGCCTGCAAAGCTAGAAGTGGTCGATGTCACCAAATCCACTGTTACCCTTGCCTGGGAAAAACCACTCTACGATGGTGGTAGCCGACTCACTGGATATGTTCTCGAGGCCTGCAAAGCTGGCACAGAGAGATGGATGAAGGTTGTCACCTTAAAACCCACAGTCCTAGAGCACACTGTTACTTCCTTAAATGAAGGTGAACAATACTTATTTAGAATAAGGGCACAAAATGAGAAAGGTGTGTCAGAACCAAGAGAGACTGTCACAGCCGTGACTGTACAAGACCTCAGAG
>TTN-205,ENSE00003802641,1,288,3187616,3187903,TGTTGCCAACAATCGATCTTTCTACAATGCCTCAGAAGACCATCCATGTCCCAGCTGGCAGACCAGTAGAGCTGGTGATACCTATTGCTGGCCGTCCACCTCCTGCTGCTTCCTGGTTCTTTGCTGGTTCTAAACTGAGAGAATCAGAGCGTGTCACAGTTGAAACTCACACTAAAGTAGCTAAATTAACCATCCGTGAAACCACTATCAGAGATACTGGAGAATACACACTTGAATTGAAGAATGTTACCGGAACTACTTCAGAAACCATTAAAGTTATCATTCTTG
>TTN-205,ENSE00003806194,1,300,3187904,3188203,ACAAGCCTGGTCCACCAACAGGACCTATTAAGATTGATGAAATTGATGCTACATCAATTACCATTTCCTGGGAACCACCTGAATTGGACGGTGGTGCTCCACTGAGTGGTTATGTGGTAGAACAACGTGACGCTCATCGTCCAGGATGGCTGCCCGTTTCTGAATCAGTGACTAGGTCCACGTTTAAGTTTACCAGACTCACCGAAGGAAATGAGTATGTGTTCCGTGTGGCTGCAACAAACCGCTTCGGGATTGGCTCTTACTTGCAGTCTGAGGTCATAGAGTGTCGCAGCAGCATCC
>TTN-205,ENSE00003805894,1,303,3188204,3188506,GTATTCCTGGACCCCCAGAAACATTACAGATATTTGATGTTTCCCGTGATGGCATGACACTTACTTGGTACCCACCAGAGGATGACGGTGGCTCCCAAGTGACTGGATATATTGTGGAGCGCAAAGAAGTGAGAGCAGATCGATGGGTCCGTGTAAATAAAGTACCTGTGACAATGACACGGTACCGCTCCACTGGCCTTACTGAAGGCTTAGAATATGAACACCGTGTCACAGCCATTAATGCAAGAGGGTCTGGGAAACCAAGTCGTCCTTCCAAACCCATCGTTGCCATGGATCCAATTG
>TTN-205,ENSE00003808643,1,303,3188507,3188809,CTCCTCCAGGAAAGCCACAAAACCCAAGAGTTACTGATACAACAAGGACATCAGTCTCCCTGGCCTGGAGTGTTCCAGAAGATGAAGGAGGATCTAAAGTCACAGGCTACTTGATTGAAATGCAAAAAGTAGATCAACATGAATGGACCAAGTGTAACACCACTCCAACCAAGATTCGAGAGTATACTCTAACACACCTACCTCAGGGTGCAGAATACAGGTTCCGCGTCCTAGCTTGTAATGCTGGTGGACCTGGTGAGCCTGCTGAGGTACCAGGAACAGTCAAAGTCACTGAAATGCTTG
>TTN-205,ENSE00003805779,1,585,3188810,3189394,AATATCCTGATTATGAACTTGATGAAAGATACCAAGAAGGTATCTTTGTAAGGCAAGGTGGCGTCATCAGACTTACCATACCAATCAAAGGAAAACCATTCCCAATATGTAAATGGACCAAGGAAGGCCAGGATATTAGTAAGCGTGCCATGATTGCAACATCTGAAACACACACTGAGCTTGTGATCAAAGAAGCAGACAGGGGTGATTCTGGCACTTATGACCTGGTTCTGGAAAATAAATGTGGCAAGAAGGCTGTCTACATCAAGGTCAGGGTGATAGGAAGTCCCAACAGTCCAGAAGGGCCACTGGAATATGATGACATCCAAGTCCGCTCTGTGAGGGTCAGCTGGAGACCTCCTGCTGATGATGGTGGTGCTGACATCTTAGGCTACATCCTCGAGAGACGAGAAGTGCCTAAAGCCGCCTGGTATACCATTGATTCCAGAGTCCGAGGTACATCTCTGGTGGTAAAAGGCCTCAAAGAGAATGTAGAATACCATTTCCGTGTTTCAGCAGAAAACCAGTTTGGCATAAGCAAACCCTTGAAATCTGAGGAACCAGTCACACCAAAAACACCATTGA
>TTN-205,ENSE00003806836,1,306,3189395,3189700,ATCCTCCAGAACCTCCAAGCAATCCTCCAGAAGTACTCGATGTAACCAAGAGTTCTGTTAGCTTGTCCTGGTCCCGGCCCAAAGATGATGGTGGTTCTAGAGTCACAGGCTACTACATCGAACGCAAAGAGACATCCACTGACAAGTGGGTCAGACACAACAAGACTCAGATCACCACCACAATGTACACTGTCACAGGGCTTGTTCCCGATGCTGAGTATCAGTTCCGCATCATCGCACAGAATGATGTTGGCCTGAGTGAGACCAGCCCTGCTTCTGAACCAGTTGTTTGCAAAGATCCATTTG
>TTN-205,ENSE00003810204,1,300,3189701,3190000,ATAAACCAAGCCAACCAGGAGAACTTGAGATTCTTTCAATATCCAAAGATAGTGTCACTCTACAGTGGGAGAAACCTGAATGTGATGGTGGTAAAGAAATTCTTGGATACTGGGTTGAATATAGACAGTCTGGAGACAGTGCCTGGAAGAAGAGCAATAAGGAACGTATTAAGGACAAGCAATTCACAATAGGAGGTTTGCTGGAAGCTACTGAGTATGAATTCAGGGTTTTTGCTGAGAATGAGACTGGGCTGAGCAGACCTCGCAGAACTGCTATGTCTATAAAGACTAAACTCACAT
>TTN-205,ENSE00003805486,1,576,3190001,3190576,CTGGAGAGGCCCCAGGAATACGCAAAGAAATGAAGGATGTTACCACAAAATTGGGTGAAGCTGCTCAACTCTCATGCCAGATTGTTGGAAGGCCTCTTCCTGACATTAAATGGTACAGATTTGGTAAAGAGCTCATACAAAGCCGGAAATACAAAATGTCTTCAGATGGACGCACACACACTCTTACAGTAATGACAGAGGAACAGGAAGATGAAGGTGTTTATACCTGCATAGCCACCAATGAGGTTGGAGAAGTAGAAACCAGTAGTAAGCTTCTCCTGCAAGCAACACCGCAGTTCCATCCTGGTTACCCACTGAAAGAGAAATATTATGGAGCTGTGGGTTCCACACTTCGGCTTCATGTTATGTACATTGGTCGTCCAGTACCTGCCATGACTTGGTTCCATGGTCAGAAACTTTTGCAAAACTCAGAAAACATTACTATTGAAAACACTGAGCACTATACTCATCTTGTCATGAAGAATGTCCAACGTAAGACTCATGCTGGGAAATACAAAGTCCAGCTCAGCAATGTTTTTGGAACAGTTGATGCCATCCTTGATGTGGAAATACAAG
>TTN-205,ENSE00003801306,1,306,3190577,3190882,ATAAACCAGACAAACCTACAGGACCAATTGTGATCGAAGCTCTATTGAAGAACTCCGCAGTGATCAGCTGGAAACCACCCGCAGATGACGGAGGCTCCTGGATCACCAACTATGTGGTGGAAAAATGTGAGGCCAAGGAGGGGGCTGAATGGCAATTGGTGTCTTCAGCCATCTCAGTGACAACCTGTAGAATTGTGAACCTCACAGAAAATGCTGGCTATTACTTCCGGGTTTCAGCTCAGAACACTTTCGGCATCAGTGACCCTCTAGAAGTGTCCTCAGTTGTGATCATTAAGAGTCCATTTG
>TTN-205,ENSE00003808123,1,594,3190883,3191476,AAAAGCCAGGTGCTCCTGGCAAACCAACTATTACTGCTGTCACAAAAGATTCTTGTGTTGTGGCCTGGAAGCCACCTGCCAGTGATGGAGGTGCAAAGATTAGAAATTACTACCTTGAGAAGCGTGAGAAGAAGCAGAATAAATGGATTTCTGTGACAACAGAAGAAATTCGAGAAACTGTCTTTTCAGTGAAAAACCTTATTGAAGGTCTTGAATACGAGTTTCGTGTGAAATGTGAAAATCTAGGTGGGGAAAGTGAATGGAGTGAAATATCAGAACCCATCACTCCCAAATCTGATGTCCCAATTCAGGCACCACACTTTAAAGAGGAACTGAGAAATCTAAATGTCAGATATCAGAGCAATGCTACCTTGGTCTGCAAAGTGACTGGTCATCCAAAACCTATCGTCAAATGGTACAGACAAGGCAAAGAAATCATTGCAGATGGATTAAAATATAGGATTCAAGAATTTAAGGGTGGCTACCACCAGCTCATCATTGCAAGTGTCACAGATGATGATGCCACAGTTTACCAAGTCAGAGCTACCAACCAAGGGGGATCTGTGTCTGGCACTGCCTCCTTGGAAGTGGAAG
>TTN-205,ENSE00003808212,1,5609,3191477,3197085,TTCCAGCTAAGATACACTTACCTAAAACTCTTGAAGGCATGGGAGCAGTTCATGCTCTCCGAGGTGAAGTGGTCAGCATCAAGATTCCTTTCAGTGGCAAACCAGATCCTGTGATCACCTGGCAGAAAGGACAAGATCTCATTGACAATAATGGCCACTACCAAGTTATTGTCACAAGATCCTTCACATCACTTGTTTTCCCCAATGGGGTAGAGAGAAAAGATGCTGGTTTCTATGTGGTCTGTGCTAAAAACAGATTTGGAATTGATCAGAAGACAGTTGAACTGGATGTGGCTGATGTTCCTGACCCACCCAGAGGAGTCAAAGTTAGTGATGTCTCACGAGATTCTGTCAACTTAACATGGACTGAGCCAGCCTCTGATGGTGGCAGCAAAATCACCAACTACATTGTTGAAAAATGTGCAACTACTGCAGAAAGATGGCTCCGTGTAGGACAGGCCCGAGAAACACGTTATACCGTGATCAACTTATTTGGAAAAACAAGTTACCAGTTCCGGGTAATAGCTGAAAATAAATTTGGTCTGAGCAAGCCTTCAGAGCCTTCAGAACCAACCATAACCAAAGAAGATAAGACCAGAGCTATGAACTATGATGAAGAGGTAGATGAAACCAGGGAAGTCTCCATGACTAAAGCATCTCACTCTTCAACCAAGGAACTCTATGAGAAATATATGATTGCTGAAGATCTTGGGCGTGGTGAGTTTGGAATTGTCCATCGTTGTGTTGAAACATCCTCAAAGAAGACATACATGGCCAAATTTGTTAAAGTCAAAGGGACTGATCAGGTTTTGGTAAAGAAGGAAATTTCCATTCTGAATATTGCTAGGCATAGAAACATCTTACACCTCCATGAATCATTTGAAAGCATGGAAGAATTAGTTATGATCTTTGAGTTTATATCAGGACTTGACATATTTGAGCGCATTAACACAAGTGCTTTTGAACTTAATGAAAGAGAAATTGTAAGTTATGTTCACCAGGTCTGTGAAGCACTTCAGTTTTTACACAGTCATAATATTGGACACTTTGACATTAGACCAGAAAATATCATTTACCAAACCAGAAGAAGCTCTACCATTAAAATCATAGAATTTGGTCAAGCCCGTCAGCTGAAACCAGGGGACAACTTCAGGCTTCTATTCACTGCCCCAGAATACTATGCACCTGAAGTCCACCAGCATGATGTTGTCAGCACAGCCACAGACATGTGGTCACTTGGAACACTGGTATATGTGCTATTGAGTGGTATCAACCCATTCCTGGCTGAAACTAACCAACAGATCATTGAGAATATCATGAATGCTGAATATACTTTCGATGAGGAAGCATTCAAAGAGATTAGCATTGAAGCCATGGATTTTGTTGACCGGTTGTTAGTGAAAGAGAGGAAATCTCGCATGACAGCATCGGAGGCTCTCCAGCACCCATGGTTGAAGCAGAAGATAGAAAGAGTCAGTACTAAAGTTATCAGAACATTAAAACACCGGCGTTATTACCACACCCTGATCAAGAAAGACCTCAACATGGTTGTGTCAGCAGCCCGGATCTCCTGTGGTGGTGCAATTCGATCTCAGAAGGGAGTGAGTGTTGCTAAAGTTAAAGTGGCATCCATTGAAATTGGCCCAGTTTCTGGGCAGATAATGCATGCAGTTGGTGAAGAAGGAGGACATGTCAAATATGTATGCAAAATTGAAAATTATGATCAGTCTACCCAAGTGACTTGGTACTTTGGCGTCCGACAGCTGGAGAACAGTGAGAAATACGAAATCACCTACGAAGATGGAGTGGCCATCCTCTATGTCAAAGACATTACCAAATTAGATGATGGTACCTACAGATGCAAAGTAGTCAATGACTATGGTGAAGACAGTTCTTATGCAGAGCTATTTGTTAAAGGTGTGAGAGAAGTCTATGACTATTACTGCCGTAGAACCATGAAGAAAATTAAGCGCAGAACAGACACAATGAGACTCCTGGAAAGGCCACCAGAATTTACCCTGCCTCTCTATAATAAGACAGCTTATGTAGGTGAAAATGTCCGGTTTGGAGTAACTATAACTGTCCACCCAGAGCCTCATGTAACATGGTATAAATCAGGTCAGAAAATCAAACCAGGTGACAATGACAAGAAGTACACATTTGAGTCAGACAAGGGTCTTTACCAATTAACAATCAACAGTGTCACTACAGATGATGACGCTGAATATACTGTTGTGGCAAGGAACAAATATGGTGAAGACAGCTGTAAAGCAAAGCTGACAGTAACCCTACACCCACCTCCAACAGATAGTACCTTAAGACCCATGTTCAAAAGGTTACTGGCAAATGCAGAATGCCAAGAAGGCCAAAGTGTCTGCTTTGAGATCAGAGTGTCTGGCATCCCCCCACCAACATTAAAATGGGAGAAAGATGGTCAGCCACTGTCCCTCGGGCCTAACATTGAAATTATCCATGAAGGCTTGGATTATTATGCTCTGCACATCAGGGACACTTTGCCTGAAGACACGGGTTATTATAGAGTCACAGCCACTAACACAGCTGGGTCCACCAGCTGCCAGGCTCACCTACAAGTGGAACGCCTGAGGTACAAGAAACAGGAATTCAAGAGTAAGGAGGAGCATGAGCGACACGTACAAAAACAAATTGACAAAACCCTCAGAATGGCTGAAATTCTTTCTGGAACTGAAAGTGTACCACTGACACAGGTAGCTAAAGAGGCTCTGAGAGAAGCTGCTGTCCTTTATAAACCGGCTGTAAGCACCAAGACTGTAAAAGGGGAATTCAGACTTGAGATAGAAGAAAAGAAGGAGGAGAGAAAACTCCGGATGCCTTATGATGTACCAGAGCCACGCAAGTATAAGCAGACTACCATAGAAGAAGACCAACGCATCAAGCAGTTCGTGCCCATGTCTGACATGAAGTGGTATAAAAAGATACGTGATCAGTATGAAATGCCTGGGAAACTTGACAGAGTTGTACAGAAACGACCCAAGCGCATCCGCCTTTCAAGATGGGAACAGTTCTATGTGATGCCTCTTCCACGCATTACAGATCAATACAGACCTAAATGGCGTATTCCTAAACTGTCCCAAGATGATCTTGAGATAGTGAGACCAGCCCGCCGGCGTACACCTTCTCCTGATTATGACTTTTACTACCGACCTAGAAGACGTTCTCTTGGGGACATCTCTGATGAAGAATTACTCCTCCCCATTGATGACTACTTAGCAATGAAAAGAACAGAGGAAGAGAGGCTGCGTCTTGAAGAAGAGCTTGAGTTAGGTTTTTCAGCTTCACCCCCAAGTCGAAGCCCTCCACACTTTGAGCTTTCTAGCCTACGTTACTCTTCACCACAAGCTCATGTCAAGGTGGAGGAAACAAGAAAAGACTTCAGGTATTCAACCTATCACATCCCAACGAAGGCTGAAGCTAGTACAAGTTATGCAGAACTGAGGGAACGGCATGCCCAGGCTGCGTACAGACAGCCAAAGCAACGGCAAAGAATCATGGCTGAGAGGGAGGATGAAGAGTTGCTTCGCCCAGTTACGACCACCCAGCATCTCTCAGAATACAAAAGCGAACTTGACTTCATGTCAAAGGAGGAAAAGTCTAGAAAGAAATCAAGGCGACAAAGAGAAGTGACAGAAATAACAGAAATTGAGGAAGAATACGAAATCTCAAAACATGCTCAAAGAGAATCATCCTCATCTGCGTCTAGACTACTGAGACGACGGCGCTCCCTGTCTCCAACTTATATTGAGTTAATGAGGCCAGTGTCTGAGCTGATCCGGTCACGTCCACAACCGGCTGAGGAATACGAAGATGACACAGAAAGAAGGTCACCTACTCCAGAGAGAACTCGCCCACGATCCCCCAGCCCTGTGTCTAGTGAGAGATCACTCTCGAGATTTGAGAGGTCTGCAAGATTTGATATCTTTTCCAGGTATGAGTCCATGAAAGCTGCTTTAAAAACTCAGAAGACATCAGAAAGGAAGTATGAAGTTTTGAGTCAGCAGCCTTTCACACTGGACCATGCCCCTCGAATCACACTGAGAATGCGCTCGCACAGGGTACCATGTGGCCAAAATACACGTTTTATTTTAAATGTTCAGTCTAAGCCAACTGCCGAGGTTAAATGGTACCACAATGGTGTGGAACTCCAAGAAAGCAGTAAGATTCATTACACCAACACGAGTGGAGTCCTCACCCTGGAAATTCTGGACTGTCATACTGATGACAGTGGAACCTACCGTGCTGTGTGCACCAACTACAAGGGCGAAGCTTCTGACTATGCAACGTTGGACGTGACAGGAGGGGATTATACCACCTATGCTTCCCAACGCAGAGATGAAGAGGTCCCCAGATCTGTTTTCCCTGAGCTGACAAGAACAGAGGCGTATGCTGTTTCATCATTTAAGAAAACATCTGAGATGGAAGCTTCGTCTTCTGTCAGGGAAGTGAAATCACAGATGACGGAGACAAGGGAAAGTCTCTCCTCATATGAACACTCTGCATCTGCAGAAATGAAAAGTGCTGCATTAGAAGAAAAGTCACTGGAAGAAAAATCCACAACCAGAAAGATCAAGACGACTTTGGCAGCAAGAATTCTAACAAAGCCACGGTCCATGACCGTCTACGAGGGCGAGTCTGCAAGGTTTTCTTGTGACACCGATGGTGAGCCGGTACCAACTGTGACCTGGCTGCGTAAAGGACAAGTGCTAAGTACTTCTGCCCGCCACCAAGTGACCACCACAAAGTACAAATCAACCTTTGAGATCTCTTCAGTCCAGGCTTCCGATGAGGGCAATTACAGCGTGGTGGTAGAAAACAGTGAAGGGAAACAAGAAGCAGAGTTCACTCTGACTATTCAAAAGGCCAGGGTAACTGAAAAGGCTGTGACATCACCACCAAGAGTCAAATCCCCAGAGCCTCGGGTGAAATCCCCAGAAGCAGTTAAGTCTCCAAAACGAGTGAAATCTCCAGAACCTTCTCACCCGAAAGCCGTATCACCCACAGAGACAAAACCAACACCAACAGAGAAAGTTCAGCACCTCCCAGTCTCTGCCCCACCAAAGATTACTCAGTTCCTGAAAGCAGAAGCTTCTAAAGAGATTGCAAAACTGACCTGTGTGGTTGAAAGCAGTGTATTAAGGGCAAAAGAGGTCACCTGGTATAAAGATGGCAAGAAACTGAAGGAAAATGGGCATTTCCAGTTTCATTATTCAGCAGATGGTACCTATGAGCTCAAAATCAATAACCTCACTGAATCTGATCAAGGAGAATATGTTTGTGAGATTTCTGGTGAAGGTGGAACGTCTAAAACCAACTTACAATTTATGGGGCAAGCCTTTAAGAGTATCCATGAGAAGGTATCAAAAATATCAGAAACTAAGAAATCAGATCAGAAAACCACTGAGTCAACAGTAACCAGAAAAACTGAACCAAAAGCTCCTGAACCAATTTCCTCAAAACCAGTAATTGTTACTGGGTTGCAGGATACAACTGTTTCTTCAGACAGTGTTGCTAAATTTGCAGTTAAGGCTACTGGAGAACCCCGGCCAACTGCCATCTGGACAAAAGATGGAAAG
>TTN-205,ENSE00003811220,1,157,3197086,3197242,GCCATTACACAAGGAGGTAAATATAAACTCTCTGAAGACAAGGGAGGGTTCTTCTTAGAAATTCATAAGACTGATACTTCTGACAGTGGACTTTATACTTGTACAGTAAAAAATTCAGCTGGATCTGTGTCCTCTAGCTGCAAATTAACAATAAAAG
>TTN-205,ENSE00003801641,1,692,3197243,3197934,CTATAAAAGATACTGAGGCACAGAAAGTCTCTACACAAAAGACTTCTGAAATTACACCTCAGAAGAAAGCTGTTGTCCAAGAGGAAATTTCCCAAAAAGCCCTAAGGTCTGAAGAAATTAAGATGTCAGAGGCAAAATCTCAAGAAAAGTTAGCCCTCAAAGAGGAAGCTTCAAAGGTTCTGATTTCTGAAGAAGTCAAGAAATCAGCAGCAACCTCCCTGGAAAAATCCATTGTCCATGAGGAAATCACTAAAACATCACAGGCATCAGAAGAAGTCAGAACTCATGCTGAGATTAAAGCATTTTCTACTCAGATGAGCATAAACGAAGGTCAAAGACTGGTTTTAAAAGCCAACATTGCTGGTGCCACTGATGTGAAATGGGTACTGAATGGCGTAGAGCTTACCAACTCTGAGGAGTACCGATATGGTGTCTCAGGCAGCGATCAGACCCTAACCATCAAGCAAGCCAGTCACAGAGATGAAGGAATCCTCACCTGCATAAGCAAAACCAAGGAAGGAATCGTCAAGTGTCAGTATGATTTGACACTGAGCAAAGAACTCTCAGATGCTCCAGCCTTCATCTCACAGCCTAGATCTCAAAATATTAATGAAGGACAAAATGTTCTCTTTACTTGTGAAATCAGTGGCGAGCCATCCCCTGAAATCGAATGGTTTAAAAACAACCTGCCA
>TTN-205,ENSE00003801638,1,154,3197935,3198088,ATTTCTATTTCTTCAAATGTCAGCATAAGCCGCTCCAGAAATGTATACTCCCTTGAAATCCGAAATGCATCAGTCAGCGACAGTGGAAAGTACACAATTAAGGCCAAAAATTTCCGTGGCCAGTGTTCAGCTACAGCTTCCTTAATGGTCCTTC
>TTN-205,ENSE00003805382,1,303,3198089,3198391,CTCTAGTTGAAGAACCTTCCAGAGAGGTAGTATTGAGAACAAGTGGTGACACAAGCTTGCAAGGAAGCTTCTCGTCTCAGTCAGTCCAAATGTCTGCCTCCAAGCAGGAGGCCTCCTTCAGCAGTTTCAGCAGCAGCAGTGCTAGCAGCATGACTGAGATGAAATTTGCAAGCATGTCTGCCCAAAGCATGTCCTCCATGCAAGAGTCCTTTGTAGAAATGAGTTCCAGCAGCTTTATGGGAATATCTAATATGACACAACTGGAAAGCTCAACTAGTAAAATGCTTAAAGCAGGCATAAGAG
>TTN-205,ENSE00003809884,1,1319,3198392,3199710,GAATTCCGCCTAAAATTGAAGCTCTTCCATCTGATATCAGCATTGATGAAGGCAAAGTTCTAACAGTAGCCTGTGCTTTCACGGGTGAGCCTACCCCAGAAGTAACATGGTCCTGTGGTGGAAGAAAAATCCACAGTCAAGAACAGGGGAGGTTCCACATTGAAAACACAGATGACCTGACAACCCTGATCATCATGGACGTACAGAAACAAGATGGTGGACTTTATACCCTGAGTTTAGGGAATGAATTTGGATCTGACTCTGCCACTGTGAATATACATATTCGATCCATTTAAGAGGGCCTGTGCCCTTATACTCTACACTCATTCTTAACTTTTCGCAAACGTTTCACACGGACTAATCTTTCTGAACTGTAAATATTTAAAGAAAAAAAAGTAGTTTTGTATCAACCTAAATGAGTCAAAGTTCAAAAATATTCATTTCAATCTTTTCATAATTGTTGACCTAAGAATATAATACATTTGCTAGTGACATGTACATACTGTATATAGCCGGATTAACGGTTATAAAGTTTTGTACCATTTATTTTATGACATTTTACAATGTAAGTTTTGAAACTAACTGTTGGTAGGAGAAAGTTTCTTATGGAACGAATACCCTGCTCAACATTTAATCAATCTTTGTGCCTCAACATACTGTTGATGTCTAAGTATGCCTCAGTGGGTTGAGAAAATCCCCATTGAAGATGTCCTGTCCACCTAAAAGAGAATGATGCTGTGCATATCACTTGATATGTGCACCAATACCTACTGAATCAGAAATGTAAGGCATTGGTGATGTTTGCATTTACCCTCCTGTAAGCAACACTTTAACGTCTTACATTTTCTCTGATGATGTCACACAAAATTATCATGACAAATATTACCAGAGCAAAGTGTAACGGCCAACACTTTGTTCGCTCATTTTACGCTGTCTCTGACATAAGGAGTGCCTGAATAGCTTGGAAAAGTAACATCTCCTGGCCATCCCTTCATTTAACCAAGCTATTCAAGTATTCCTATGCCAGAGCAGTGCCAACTCTTGGAGGTCCCAGAGTGCAGCCAATGCCTTTGTGTGGTAGTTCTAAATTTTAATTGCACCTGAAAAACCTGGGCACCTAAGCAATGAGCCACAGCAAAAAGTAAAGAACAACAACAAAATAAAGCTGTTGTTAAATTTTAAACAATATTACTAATTGCCCAAAATGTCAATTTGATGTAGTTCTTTTCATGCAAGTATAAATTCAATTGTTAGTTATAATTGTTGGACCTCCTTGAGATAGTAACAACAAAATAAAGCAAGCTATCTGCACCTCAAAA
>TTN-205,,0,5169,3199711,3204879,GTTTGAGCATCAGTCTCCTCTGGCTAGGCTGTAAGAACCTTATCAGCAGGATTCATGACAGCCCTGTTGTCATTGTATTGCCAGTACCTAAGACACAGTCACACTCAGTAAACTCTTTTGAATTGAATTGTTGCCAAAGGTAAACAAAGATAAACCTAGCTTGTTTTTCTCCCCTTTTTAGAGGGAGGAGAGGGGAAATGTAAAAAGACAAAGATGATTCTCCCTTCTTATAGACAGGAGTCAATCCGAATCAGGCCCTAACAATGAAGCACTCATGAAAATCTCTCACCTCATCTGCAAAACTTGTGTGAGAACCCTCCAGACCCTCTGGGCTAGACCCTGATTGAAAATTTGAATTTAAAAATAGATGCTGGCTCCACGGACTAAAATAATAGTAAGGAGGAAAGAGGAAAGGTCCAGGATTGTTGTTCCTGGATCAATATTGTTCCAACATTTTAAAGTGTTCCAACATTTTAAAACATATGTACTTAGGCATAAATCATCATCCGGTATGAGGAACTGGATGCCTCCACTCTCTATGACTAAATCCAAACTGTCAAAACCAGAATTTATGTACTTCTTTAGAACACTACGTAAATGATCAATATTTAATTGTAGCTGGGGCTCAGTAGTCTGGGCTGTGAACAGATCTTATTTGAAACCAGTATTTCATACAAACTTGTAAATATAAAGAAAGCCAAATCCAAGAACTTAAGAGTATTTGAATTCCAAATGAAGAAAGGAAAGAATATCTTATTTTGTTCTGCTTTATGTTTGTCTTTATTCATGACCATTTCTTACTAAAAATCACCATCTGAAGCTTTTGAAACTCCTGTTGTATGCACAGCATTTTAAGTGCAGCCATGAAATAAGTTAGTTGAAACAAAATAAAATATCTCCTTCCAGTATGCTCTGATATTGTGTCAATGTAAATGCCAAGGCATGACAGACTGTTTTCCATTTATAATAAGCGGAATCTTGAGTTGCATTGGAAAGCTAAAAGATTTGCGTTGACTTAAATGAAAGTGTCCTTTTTAAAGCAAAAACAATTCATTTTCTCTGTGCTTATCACAGGAGATGAGATTTGAATGTTATCAGTTGTGCATGAATTCAACCTCAAAAACAGGAAGCACACAGCTGTGATTTTGGCCTTTTTCCATGAATCTCCACAGCACTGTTCCTTTTGATGGTGAGAGTTTGTATAACATCATGAACCATCTGAGCATCAGTGCAGGTTGGAGGCATGACCCTCCTCAGGGTGAACAAGCCTTTGTGTTGAGAGTTTGAGCATTTGGCCTGCTCACTCTTCCTTCTGTTCAACAGCAGTTTCATTTGTGTAACCCAGGACATGGCAAATCGGATTCATTGGATCCTCCTTTTTGTACCACAAAATTAACTTCCTATCTTCCTTAAAGAGCAAGAGTGCAGAAATAATTGTATAGACAAGAATGTGTGTGTATTCCCAATTAGCACAATAAAAACTGGGTGAAATCAAAATATATTTTAACCATAGGAGTAGATGAAAAAAATAGATCAAATCCAATTTTTCTTTAAACCAGAACAATAATAGTTACATAACATGAAGTTTTCTATCTGTATTCTCATGGCTGCTTGCCGTGGCTCTTTTTCCATTTAGAATGCATGTAAACATCAATACTTGTAAAATAGCAGCTCCAGAACTAGGTAATAAAATGAAATCCTTTTCCTTTGTCCCATTCAACAACAGTTCTTTTTACAAGAACTTTATTGATTCAAGCATCTACAAAATGGTATTTTTATCTTATGTATGCATTTTAAAAAAACATGCAATAAAATCTTTTGAGTATAAAAAAATCAGTGAAATATAAAGGGACCTACTTTATCCATGGCAAATTGTCTCCAACGCATATTATGCTAATGATGGCAGACAGCCACCTCGCTTTGTAATAAGTATTATGCACACCCACACACAAACAAGCTGTTGGAAAACAGAGTCAGCTGGAAATGCAGACAAGGTAGGAAACCACTTACTTGGCAGGGTCAGAAAGGGGAATATGCCCATTTGCTCCAGAACCGCTCCTCTAGCAGCTGCTGCCGTGCCAACCCTGCAGGGTCAGCCTTTGATTCAAGTGAATGCAGCTCCAGAAGGTGCCTTTTAAAATGCATTTTTATTCATTTCTATTACTCTTACAAGAGTAACAGTATTTCTTATCACATTCTGGTCTGGGTTAGTAGATTAAATAAGAATGCTTCCCCACCCAAAGAACATAATTTCTGGTGAGAAAATGGGGTCTATGGAAAGCTGAAAGATTTGTATGCTATGTTCCACTTAGGGGTGGTGACTGGGGATATGTAAAACTGGAAGGGATAAACTGGCTACGCAACACGGTGAGGACGCTGAGTGTCAGCTTTGGCTTTCAGCTTCTCTGTCTGTGTGAATTTCCTGTGGATTCTGGAAACGTTTTTAGGGAACTCCCCGAGAAGTTAGAGACCACAATAAAATGTTTCTACATGACAATTTTTGTTACCCAGTAAGAGGACTCTACCGGGTTCAGTAGTGTCAAGGTGGACCCTAAATCCATTTCCTGGTGTCTTTAAAGGGAGGCCATGGCAGACACAGAGACACAGAGGAGACACACAGGGAGGAGGCAGTACATGACACGTGACAACAGAGGCAGAGATTGGAGTAATGCAGCTGCTATAAGCCAAGGTGCACCAGAGATTGCAATCGCTGGAAGCTAAAAGAAGTGAGGAAATATATTTCCCTAAAGCCCTTGGACAGAGAATGCTTGTTTTGGCTTAGACTTTGGACTTTTGGATTTCTAGCCTTCTGAACGATGAAAGAATACATTTCTGTTGTTTTAAGCCACCCTCTTTGTGGTGCTTTGTTATGGCAGCCCTAGGAAGCTACTACAATGACCATGTTTTAGAAGAACCAATACAAGTCTCTGGTAATAAAATTCCCAGAGACCATTGCTAGACACCAGCCAGCCTTTCAAACCAGCACTCCTGGGGTGTGCTAGAATACCTCAGCTTCCTTGCTGATTTGAAGGGATCACCCTAGTACATTTCAGTCCATCAGTAACTTTTCATCTTCTATGTGAACATCACCCCCTAAGTGCACTATGGTGCAAAGAGTTCTAGAGGAAGCTGAAATTATTCACAACAGGGGTCGAGGGAGGGGGAAGGAAAGTTGTCTTTAGACATATAACCAAAGTAAGAATATATACAATATAAGGAAGGAGAATAGAGAAGTTCAAAAAATGGGATTACTAACAGTCAAAAATTAGGAAATACATGACCTAAACAGCACTATCAATCTACTTCATCTAATTGACACATAGAATATTCCATCCAACAACAGCAAAATGCACATTCTTCTCATGCTCACGTGGAGCATTTTCCAAGATAGACCACATTCTTGGCCATATATCATCCATTAAAAATTTAAAAGAATAGTAATTATACAAAAGCAGGTTTTCAGACCACAATGGAATGAAACAAGAAATTAATAACAAAGCTCAAAAATCCAGAAATACCTGTAGATTAAACAGCACACTTCTAAATAACATGTAGATCAAAAAAATCTCAATAAGGATTTTTAGATATTTTGAAAAATATGAAATTACCAATATAACTTATCAAAATCTGTGGGATGTAGAAAAATAGTGTGTAGAGGAAAATGTATAGCATTAAATGCATATATTAGAAAGAAAAAAATCTAAAATCATCCTAAGCTGTCACCTTAGGAAACTAGAGAAAGAAAAGTGGTTTAAGCCTATAGCAAGCAGAATAAAAGAAAACTTAAAAACGAGAGTGTAAATCAATGACATTTAAAACAGGAAAATAATAGAGAAAATCAATGAGACCAAAAGCTTGTTCTCTGAGCAGATCAATAAAATTGATATACTTCTAGCCAGGATAACCAAAAGAGAGAAGACACAAATTACTAATAATAGAAATGAAAGAAACTCTAAGCTCACAAATTTGATAACTGAAATGAACTAGATCAATTCCTTGAAAGACAAACTACCAAAACTCACACAAGCAGAAATAGAAAACCTGAAAAGCCCTTTATCTGTTAGAGATATTGAACCAATAATTAACAACTTTCCAAAAAAAGAAAACACAAGGCCCAGATGATTTCACTGGTAAATTACCAAACATTTAAAGGGAAAAAAATAGCCATTCTCCACAGTCTCTTCCAGAAAATAGAAGCAGAGAGAACTCTTTTTAAACTTATTCTCTTGGGTCAGAATTATGCTAATAGTAAAACCAGGTAAAGGTATTACAAGAAATGAAAACTAAAAACCAATATCTCTCATGAATATAATTACAAAAATCCTCAACACAACACTAATAAGTTAAATCTAACAATGGATAAAAAGAATCCCACACAAGACGTGGGATTTGTTCTAGGTATATACGGCTCTTTCAAAATTCACAAATCAATCAGTGAATCCACCACATCCACAGGCAAAAGAAGAAAAATAATGTAATTATGTCAATTGATGCAGAAATAACATTTGACAAAAATCTAATGTGTATTCATGATAATTTTTAAAAACTGTCAGAAAACTAGTAACAGAGGAAACTTCCTCAGCTTGATAAAGAACATTTATAAAAACCTGTAACTAACATCATACTTAAGGACATCCTCTCTTACCACTCTTATTCAATGTTGACTGGAAACACTAACTAGTGAATATGACAAGAAAACATAAAAGTTACTAAGATTTTAAAAGAAAGAAAACTAATTTGATTTACAGATATCATGACTTTCTACCTAGAAAATCCCAAAGAATCTACAAAAAACTCTTGGAACTAATCAGAGTATAGCAAAATCACCAAAGCAGAAGATCTGCAACAACTGCACTCAAGAAAAAGTTGGGAGCTGTCAGTGCAGTGATCAGGCATCTCCAGAGACCATGGCAAAGGCAGGCTGTAAGAAATTGCCCCTTTTCCATATGTTGGTTGCAGACATTATGGAAACCTGAAATCTAGTTGCGACATGTCACACTTGCTTTTTCTTGCACCTTCCTCTGATATTTTGGTGGGGGGTGGGGGGTGGGGGGCAGATTTGGGAGAGGTAAATTACTTGGAGAAGATGATGCTCAACAGAATGAGGGAATACTTGATGTGAAACATAAATCAAATTTGATCATTAACTACCATTGTCGTTATCAACAG
>TTN-205,,0,7632,3204880,3212511,GTATGTACTTTTCTATCAGCAAGGATGGGCCCTGGCTGCTAGTATTATTTCTAAGATTTCTTCTTAGAAACCTAAGCTAAAATATGCCAACCACTGTATTACACCTTTAAAAGTAGTATTTCATAAAGTCATATTTTAGTTTGTTAATTAATTAAATGATAAAATACAAACGGCTATTTTGGCACTTTTAGTTAACTGGAAACTTTTCAATGCAACTAATTGTTTTGTATTGTCTAAATGTTAAGTATAATTATTTTCTTCATTTACATTAAACATTTTCTTGAGAGTAATTTTTGGTCTTATATGTCAATATTCTAAATTATTATGGCATTGTACTTTATTACTTAAAAGAAAACTAACTGATGTACCACAAAAGCCAAGTATTAAACTTGTATTTTATCGAAGGCCTTGTAAATATAGTAGTATAAACAGTAGAGCACTGTAAAGACCCCATCCAGGACTTATAAATGGATATACAAAGTACCTATTATAGGTTTTGTTCAAACCTATGTCAATACATTGTATAATTGCACAAATACTGATTTACTTTGAGAACCCAAAATGGATTATGAACACCATGAAAGATGGCCCAGGTTTAACAGGATGTTCCTGGACAAGTCAGGAGCACAGTCTAAGGTACAGGGGCTGGTCCTCAGTTGCAGCTGACTTTTTTTTTTTTTTTTTTTTTTTTTTTTGACGAAGTCTCACTCTTGTCGCCCAGGCTGGAGTGCAGTGGCGTGATCTTGGCTCACTGAAACCTCTGCCTCCCGGGTTCAAGCGATTCTTCTGCCTCAGCCTCCTGAGTAGCTGGCACAGGTGCACACCACCATGCTGGCTAATTTTTGTGCTTTTAATAGAGATGGTGTTTCTCCATGTTGGCCAGGCTGGTCCCAAACTCTTGACCTCAGGTGATCCGCCTGCCTCAGCCTCCCAAAATGCTGGCGTGAGCCACTGTGCCTGGCCACAGCTGACTTTTTCTTGGCACATGAGTTTCATTCCTCTGTGCTCTGACTCTAATCCATTGTAGGCAAAAATTAAATCAGTTAGCGGAATGATACCATCTCGTAGAGAATCTCAGAATTAGAAAAGCCTATACCATTTCTTTAAATATAAGAAATTGTTGGTTAACTTAATCAAAATTATATAGCAGAGTGTGTTACATGCCATAAGGATCATTGTGAATGAATACAAACTATTTCAAGAGATTTGAATCTTTGCTATACGTGTGTGTGTGTGTGTGTGTGTGTGTGTTTTTCTCTGTATGAGTTCTTGTATGAATTCAGTAATACATAAAATGCCCAGGTGATATATGATGTGATCAGGTTAGAAAAACACCTCATGCTAATGGCGCCAGTGCCATTAGCAACTTATGGCCTAGATTTGATGAAGAAATAAGCTTCTCTCATTTTAACAGTGGTATCATACAGAGAGTTACTTATATGCATGCTCTGGATAAAAGACTCAGCACAATTCCAGTTTTAAAATAGATAATTAAAAATCTGTATATGTCAAACAAGATTTCCAGATAGCTGTTGGAAGGGGGGAAAACATTGTTAAGATAGGTGTACACATATAGCAACCTCAGATATAAATTCATTTAAATTCTTCATTGATAGCAAACCAAAAAGAATTATTTCTAAATAGAACTTTGAAGTTACTTTAATTTTAATGTAATAACAACGTCATAACATCATAAATCTTAGTTGAGAAGCAGCTGTTGGTTTTTTCAATCCATTAGTTATGGTATTTCAAGCTTCCATAAAAGTACTGAATCTAGATCTTTAAAGATGAATTTTTCTAGCTCATATCTTAAGGTTACTAAAGCATACATGATTACTGCGGGAACAAATGTTTTGTGTGTTTATTTCTTTTTTATTGCTAATGGTTTATATGCTAATAATAAAATGTATATTAAGTCTACTAAATACCTGGAAACAACAGAATTTGCTTGCCTGTTTCTTAGCTTTACTGGGAATTCCTTAAAGTATAATTTGACATTAAGTTCCTCTAAAGGTAATAAATTTAATCTGATTATCTCATTCAAACTTTTGCAGATAGAGGATGCTTATTCTTATATAACTATTGACTCAAAATGCACTTAATAAATGAAATTTCTCCAACTCAGAGAAAAAATAATCATGGTGGTTAATATTTAACCACCATTAACGTACACCAATTAAACATCCCATTGCAGAGTAGTGGTTTGTTTTATGGAAGGATAGTAATCAAAGCAAGTTAAGACAGTTTTCTGCAGTCAAATGTACTGGCTTCTCATTGTGCTATATTCCTTTTCATATGTGGACACATGGAGAAATATTTCTTTTTCCACCAATCTGAAACTTTGCAGGTTGGCTCAAACAGACTCCATATACAGTGCAAAGATTACATGGTTATTTTAATAACATTAACAGACATATTTGAAATCAGAGTATAATTGATATTTAAATTATATGACACTGGCTGTACATGTTACTGAAAATAAATTACAATCTTCACTTTTGTTTTAAATTTCTAATGATGGATATGCCTTTATATGTCTGATATAAACATTTCCATTTAGAGATAACATAGATGAGATAAACGGCCCTCCATTGATGTTGCCCTGAGAAACATAGGGCCATCTGAATCCTTTTTAATTGGGTAAATGTAGGCTTTTTGTTGAGGTTATCATGTACCTTTATGCAAGTAAATTGAAATCCTAAATATTGCTCATTAAAATAGTGGAACACTAATTTTATAAAATGTCATGCTTTTGAGCCCATTCTCAATCTTGTATTCATAGAGAAGGGAGCACTTGTTTTAAAGAATTGGAGTATTCTGTATTACTCCTCTTAAAATGTTACTATTTGGAGGAGCTAAAGACCAAAATTCTTTTTTTTTTTTCAGGAGGGATTTTTTTTTTAATTATTATACTTTAAGTTCTAGGGTACATGTTCACAACATGCAGGTTTGTTACATGTGTATACATGTGCCATGCTGCTGTGCTGCACCCATTAACTCGTCATTTACATTAGGTATATCTCCTAATGCTATCCCTCCCCACTCCCCCCACCCCACAACAGGCCCCGGTGTGTGATGTTCCCCTTCCTGTGTCCAAGTGTTCTCATTGTTCAATTCCCACCTATGAGTGAGAACATGCGGTGTTTGGTTTTTTGTCCTTGCGATAGTTTGCTGAGAATGATGGTTTCCAGCTTCATCCATGTCCCTACAAAGGACATGAACTCATCATTTTTTATGGCTGCATAGTATTCCATGTTGTATATGTGCCACATTTTCTTAATCCAGTCTATCATTGATGGACATTTGGGCTGGTTCCAAGTCTTTGCTATTGTGAATAGTGCCACAATAAACATACGTGTGCATGTGTCTTTATAGCAGCATGATTTATAGTCCTTTGGGTATATACCCAGTAATGGGATGGCTGGGTCAAATGGTATTTCTAGTTCTAGATCCTTGAGGAATCACCACAGTCTTCCACAATGGTTGAACTAGTTTACAGTCCCACCAACAGTGTAAAAGTGTTCCTATTTCTCCACATCCTCTCCAGCACCTGTTGTTTCCTAACTTTTTAATGATTGCCATTCTAACTGGTGTGAGATGGTATCTCATTGTGGTTTTGATTTGCATTTCTCTGATGGCCAGTGATGATGAGCATTTTTTCATGTGTAAAAACCTAAATTCTAATCCTAGCTTTGCTACAGAAGAACTCTGAGGATTTAGGCCACTAAAATCTTTGACCCTCATGTTCCTTGCCTGTGAATTATGGTGCAAAATAGACCATTTCTAAATGTGCGTCTAGCTCTCACTGATCTCTAAGGGGTATTAAACACACAGTGTGTTCTTGATTTTCTCATTGGAACAGGCAGGTGATATTGCCAAGCACTTGGTGTTTGGGGCCAAATGATCAAGAGAACAGTCAAGGTTTAGAACAAAATTTAAAGGAAATTTCCTGGGAAGCAGAAGACAGATAAGGTAATAATTTTGTTTGCTCAGAATAGTGTACTTTTTGGCAGTCATAACAAATTCTATTTATTCAATAAAGAAAAAATATAAATATATATATGATTGTAGGACTTCAAATATGGTTCACTAAAAACTTGGTATACCCAAACAAATAATCAGGCTCTTATTCACCCCCAAAAGTCCCAGGCTTAAAGCCCTTTCATGCAGTTGTGGCTTTGTTGAGTGATGAAATAACTGGGAATATAGCTAGTTGATGAAAAATTTATTCCTATGTTAGAAAAAAGAAAGTCAGCATAGATCTTGTCATTCTCTAGACAAATGCAAACCTAGTTTAACATTTGTTTTGTGTCCAGTGAGTATTATAAAAATGCATAGTGGTATAATAGAACATAGAAAATAAAAAGTCACTTTGACATCTTTAACATGTGGAACCTTGAGGAACTTCATAGATAGATACCCTTATAAGACTGTAGCACTCTAAAAAGGGCTATCAAAATGTCCACGCACATGGTACCTGCTTTAATGAAGAGCTCAGTACCAGTTTCAGGCAATTTAAAAATCTTAGCCTTTATTATATAGACATTAAGTCAAATTATTTTTCTATTATGATCCCTTTTGAAATAAGCTTTAACACATTTCTAATGCTTTCTTCAGAACAGCTCATATGAATTAATAACTTTTTAAAAAAATTCTTTCATTTCAATTTAATCTGAAAACTTTAGATCTCATTCTCAGGGAAAAATTACTTTATTGCATGTAAAGTAATTACAAATAGAATATAGTTCACAATTTTCTTCCAAATTAAGCTTGAGCCTCAATAAAAATATTTTTAAATGCCCAACAATATTCAGTTATTATTTGCCATGTTTCTGTTTTCATGGGAAGATATAATATGTTTAATAAAAATACATATCTAAAAGGAGAATCCGATTTGTAAAATTATAAATTCTAGTTTTCAGTCAAAACCACCCTGAGCGTGAACTTATCAGAATCTTGTCTGAGTAACTACAACCCCTCCCCCAACCTTAAAAAAACACACCACAGCCCCACTCTCCACCGGTGTGGCCAAACCAAGGGAAATGAGAAGCAGGAATGTAGCTCACAGGTCAGAGCCAAATACGAAGAGTAAAAATAGTACCTTGAGCTTTCAGAACCACAGATTTTCAAAGTGAGCCAGAGGGCAGAGCAGCAGCTACATTTTCAAACAGAAGTAACTACATCTTTCTAATCAACTGCCGTGTTATGGAACATAAACTGCAGGAAATGATGGCTTAATGTCCTTTTATGTATCAGATAAGCAGGAGGAAGTATCAGTGGTGTGCTTTACTTAGTGAGAGAAGCTTAATAAATATATTTATTTATTTATGTCCTTTAATGCAGTAGAATGCTTTTCAAAAACCATTCAACTTGTGTGTACACTGACCAGAAAATGTTCTATATAAAAAACTGTATTTTGCTTAGGTTTTGAGATGAATGTTTCATGAGATATCTGTATATGTATTAAAATTATTTAAATATGAGGAAAATGTGGTATTTGTGGTGTATTTCTCTAAAGCAGGATTTTTCAACCTTGATACAAGGTTGACATTTGGGACTAGATAATTCTGTGTGTTTGGGGGGTTGTCCTATACACTGTAGGATGTTTAGCAGCATTTATGGGTTCTACCCACTAGATGTCATTAGCACCTCCACCCTCAGATGTAACAACCATGATGTCTCCAAATATTGTCAAATATCCCCTGGCAGAAAATCATCCCTGGTTGAGAACCACTATTTAAGGAAACAAGATAGCATAAGCTTGGTCAAGATTACACACTGGTGTTTTGTCAGTACAATTCAGAAAATAAAATCCAGCAAATAATGTGCTCTTCACAAAGCTATTTTACTGTTTCTTAATTATTGAAACTTTTTCTTATTTTTGTTCTTCTTAAATGGATTAGTTATCCTGGGTAGATTACTAAATAGTTTTAAGTAGTTGAATAAATTTGTTATGAGAGCTAAAATTCCTGACATACCACTGCCCTGACATATCAGCAAAATGATAATGATGATGTTCAATTAAATGTATCAAATAAAAGCCTGCAAAATTCAACAGACTGAAGTCTATATTCTGGAATTTGACAGCAAAAAAAGTTGTGTAGGTTATCATTTTTTGGCAAAAAGGCCCCTAAGTACACTTGCAATCAATGGCTACATGCGTAGTTCCAAATGTCGTCTTTATTACTTCTGTTTAAATCTGTCTCTAGAATAGTCTCCAAGAATGTAGCTTTTTTACTTTGGAAACTCTTACTCAGACAGATCCCCAGTAAAGCTTGGTAATTTAGTAGCTTAAGAACAAGTTCCTCCTTCTGTCTGCCCTTCTTTCTCCCTTATATGTGAGGAAAGTGGAATTTCACAAGATGACTCTATTCAAGAGTCTTGATAAAAGTCGCCTTTACAAATGCTTTTACACTGTTTTGGGGAGTGTAAATTAGTTCAACAATTGTGGAAGACAGTGTGGTGATTCCTCAAAGATCTAGAACCAGAAATACCGTTTGACCCAGCAATCCCATTACTGGGTATATACCCAAAAGAATATAAATCATTCTGTTATAAAGATACATGCCCATGTATGTTCATTGCAGCACTATTTACAATAGCAAAAACATGAAATCAACCCAAACACCCATCAATGATAGACTGGATAAAGAAAATGTGGTACATATACACCATGGAATGCTATGCAGCCATAAAAAGGAATGAGATCATGTCCTTTGCAGGGACATGGATGGAACTAGAAGCCATTATCTTCAGGAAACTAACACAGGAACAGAAAACCAAACACCACATGTTCTCACTTATAAGTGGTAGTTAAACAATGAGAACAGATGGACACAGGGAGGGGAACTACACACCTTGGGGCCTGTTGAGGGTTGGGGGAGGGAGAGCATCAGGATGAATAGCTAATGCATGTGGGGAATAATACTTAGGTGATGGGTTAATAGGTGCAGCAAACCACCATGGCACATGTTTACCTATGTAACAAACCTGCACATCCTGCACATGTATCCTGGAACTTAAAATAAAATTTTAAAAAGTCACCTTTATGGGTTTTGTTTTTGTTTTTACTTTTGCTTTTGGTTTTTCAGTCAGGGGAATTATTGATCATTGCTAGACATTAGGAGGTGGTAAGAATGCAGTAAAAAGAAATTTGACATTGTTTAGAAAGACTTCTGAAAACGAACACATTGAAAATATTGCATATGTGGGCCAGGTGCGGTGGCTCACGCCTGTAATCCCAGCACTTTGGGAGACTGAAGGGAGTGGATCACCTAAGGTCAGGAGTTTGGGACCAGCCTGGCCAACATAGTGAAATCTCGTCTCTACTAAAAATACAAAAATTAGGCAGGCATGGTGGCGGATGCCTGTAATCCCAGCTACTCAGGAGGCTGAGGCAGGAGAATCACTTGAATCTGGGAGGAACAGGTTGCAGTGAGTGGAGATTGTGCCACTGCACTCCAGCCTAGGCAACAGAATGAGACTCCATTGAAAGAAGGGAGGGAGGGAGGGAGGGAGGAAGGAAGGAAGGAAGGGAGGAGGGAGAGAGAAATAGAAAAGAGATAAAGAAAAAGAGAACGAAAATATTACACATGTGTATCTTAGCAACTTCAAATTTCCTTTTCCTTTTAG
>TTN-205,,0,12870,3212512,3225381,GTAGGTCATGTGGTTTTGTCTTTATTTTCAGAAGAATATATTGTGTTTCATAACTCTATGTTTTTCTATATTATCCACAGAAAAAGAGCATGAGTCTTTCTGATTCTAGGAAGTACTTCTGTCCTAAACCAACAGTAGTTTCAGCTAAATTCTTATATTTGAGGCCATGTTCTCAGGTATACAACACATAAATGAATGAAATATTTATTCACAAGACAATATGCACCCTTTTCTCTTAAAGAAATAAACATGTGGCACATTTCAGACAGAAGCTAAACACAAAAGTTTTTGCCCAAAAATACAACACAGGAAACAAAAGTACTAGAAGTATGAAAAAGTACTAGCAAGAACCAGTTGTCCACTTAGGTAAAGGGGCAGGAACTAAAACTCTTTTGTGGAGGTTATCCTGTTTCTAAGTATAAATACTCATATGTGGAAGTATCCATAACCCATGTGAATATTACATATTTTGTTGTCCTTTCTACTTTTAGAGCTATTACTGTAAAATTATAAGTACATTAGAAATCTAATGTGCAGATATAACCTTAATGAGTAACCCAAAGTTCTCATTCCTTATTTCTCTTAGGTGCAGATTTTAATCTCATCCTAGAAAGCTAGAATATGAAAACCAATGATTTACTCAGGGAATGAGCCTGGTCTACCACCCAGGAGCCACGTTTAAAGTTATTGTTTTATTTCCCTCATTCTCTTCTTATTGTAGAATACTCCCTAATTATCCCAAAGTACTTATTTTATTATGGTAAAAAATGGGTCAGAATACATACCTATTAGAATGGCTAAAATCCAAAGCACTGACAAAGCCAAATGCTAGTGAGGATGTGAAGCACCAGGAACTCTCACTCACTGTTGGTGGGAACGCAAAACGGCAGAGCCACTTTGGAAGACAGTTCGGCAGTTTCTTACAAAACTGAACATACTCTTGTCATACAATCCAGGAATTAGTTTCCTTGGCATTTACCCAAATGAGCTGAAAACTTGTGTCCACACAAAACCTGCATGCAGATGTTTATAGCAGCTTTATTCATAATGGCGAAAACTTGGAAGCAAACAAGATGTCCTTTAATAGGTGAATGGATAAACAAACTGAGATACATACATACAGTAGAATCTTAGGCAATAAGAAGTACACGACTAAGGCATGGAAAGACACTAAGGAATCTTAAATGCATATTGCTAAGTGAAAGAAGTTAATCTGAAAAGGCTACATACTGTATGACTCCAACTATATGGTATTCTGAAAAAGAAAACAGTACAGAGACAATAAGAAACCAGTGATTGCCAGGCTTTAGGGAGAGAAGGAAGAAGATGAAGAACAAGTGGAGCACAGAGGATGTTTAGGGCATTGAAACTACTGTGTATGATACTGCAATGGTGGATACATGTCATTAAACATCAATCGAAACCCACAGAATGTCCAAACAACAGTGAACCCTAATGTATATTATGAACTTTAGTAATAATGCATCAATATTGGCTCATCATTTATTACAAAGGCCAGCTTCTGGATGCCAGGACTTACTTTTATCTTTTTCAAAGCTTACTGTTTTTTAAACTTACATATACTCTTACAACAGTTGTTACTCAACTAACCTCTAATGAATGTAGTCTCTGATGGGTTAACAATACAGTTGCCTCTCCCTACTCACATGTTCTGCATCCATGAATTCAACAAAATGCATATCACAAATACTGAAAAAAGAAAAACCCCAAAATAAAAAAAATACAAATAAAAAATACAACATAACTATTTACATAGCACTTACATTGTATTAGGTATTATAAGGAATCTAGAGATGATTTAAAGCATATGTGAAGATCTGCATAGTTTAAATGCAAATACTATGCTATTTTATATAAGCGACTTGAGCATCCACATATTTTGATATCCGCTGGGGGTTAGGGGGTCCTGGAGCCAATCCCACAAGGATACTGAAGGACGACTATACTGCAAGTGTCCCCAAATCACAATCTATCAGCAGAGATGGAGGGAGACAAAGATTCACATTACAGATGATAAGTGTTCCTTCATTTTGACAAAGAATTTGCCAAAGGTGAAACTGTTGCTAAAGCTTCCTCATTTTAAATGGAAGAGTACACATTAACACTTAGATCCAAAGTGAAGGCCTAGAGATGAGCAGTTTTTTGCTGCTGAGATATGGTAATAAGCAATTAGGAAGTCCTGTCCTCTCCAGCCTGCTCCACTCTCATTTCCTTAAAATATGATTCAGGGATTCTGAGAAAGTTGGTCACCAAAAGCTCAAATTGTCATCATATTTATCTGATAAAGTTGTTCATGTCCTTAAGATATATGTTATGGAGCATATCATTAGTTTGCTAGCACTGCCATAAAAATGTACTACAGACTGGGCAACTTAAACTTACTGAAATTTATTTTCTCACAGTCCTGAAGACTTGAAGTTCGAAGATTAAAGTGCCAACAGAGCTCATTTCTTCTGAGGCTTCTCTCCTTCACTTCCATCTTCCTCCTGTCTCCACATGGCCTTTCCTCTGTTCCTGTTTTGTCTTAATCTCTTGTTCTTTTTTTTTTTCTTTATTTTTGGAGATAGAATCTCACTCTGTCACCCAGGCTGGAGTGCAGTGTTGTGATCATGGCTCACTGCAGCCTCAATCTCCCAGGTTCAAGTGATCCTCCCACCTCAGCCTCCTGAGTAGCTGGGTCTACAGGTGAACGCCACCATGCCCAGGATTTTTTGTTTTTGTTTTTCTTTTTTAAGACAGACAAGATCTTGCTATGTTGCCCAGCCTGGTGTTGAACTCCTGGGCTCCAGCGATCTGCCCACCTCCATCTCTCAAAGTGTTGGGATTACAGGCATGAGCTACTGTTCCTGGTCCTATCTCTTGTTGTTATAAGGACACCAGTCGTATTGGGTTAGGGCCCACCCTAATGAGCTCATTTTAACTTAATCATCTCTTTAAAGACCTAATCTCAAAACACTGTCACAGTGTGAGGCACTAGGAGTTAGAATTTCAACATATGAATTTTGGAGGGTTCACATTTTAGCCCATACCAAGGAGCTACTATGTGTCGATCGTTGTTCTAGTCAGTGCTGCAAAAAGGCAATGGGCTGGGCAAAATCAAAACAGGACCAAAAAGCCAGGAGTGGAGGATAATAGATTCAGTCAGTATCTTGGGTGATGTAGGGCTCCCAAGACTAGCTGAAGATTTAAATCAGAGAAATTATGTGAAATTTTTATCATGGAGTGCTTATTGGGCTTTGAGGTGGACTTGGATTGGAGGCAGAAATGAACGGTTAAGAGGCTAAATCCAATAGAATAAGTGAGAAATAAGGACCTGGAAACGGTAGTAGCAATAAACAAGTTTACAAAGATTCAAGCTATTTTTAGGTGGTAGAATTAAAAGAATTTATTGACATCTCAGAGGCAGGTAATAAGGAGAAGGAAGCATTAAGAAAAATTCCCAGAGTTCTCACTTAGGTGATTGAATAGATTGTGATGTTATTAACTCAGATGGAAAAATCCAGGAGAAGGACAGATTTATAAGGAGTCTAATCTGGGTGTTTTAAGTCTGAGATTCTCTTGGAGATAGCCAGTAAGAGTGAAATGTAAGTCTGGAACATGCGAGCGATGAATAGGGCAGAGATAATCATCTTGAAGTGATCAGAATGTAGTTGAAGCCTTGAAAGGAGATGAGCTAACCCCGGGAAAACACAAGAGTAAGAAGAGGTAGAACCTGATGAAGACCAACAGGAGGAGAACTGCTCATGAATAAGTCAGAACTGTATGAGTCCAGAGAGGCTGGTGCCATGGAATTCAAGTTTGGAGAGAGCTTCTAGAAAGATGAAGTATAAAAGTTAGTAGGTGAACTGGTGAAAGTGATGGGATGTAGAAAAAATGTATCTTGGGTGATTCTTCCTGGCTGTTTTATCAAAAAGCCAAGGCCAAAGGAAGACATAGCCTGAGAAATAGTTCAAGTTTAGTGCTATGAACTCATTGACTTTTCAGTCACTCAACACAAATAGTTGTCCTTTAAGTGAATTTATTTGAAGAGTTTCCTAACACATCACTTACTATTATGCATTATGAAAATACAATTTTTAAGTATCCACTGGATTAATAAGTGACAACCAAAAATGTTGCAAAAAAAAAAAAAAAACTCTGCCTATTGGATTTGGAAATAAGAAAGGCAGTGGAAAACACAATATGAATAGTGCAAGAACAATGAGAAAAGAAGCTGAAAGAGGGTTCAGAAAGAATAGGTGTCTCAGTCTATTCAGGCTGCTGTAGCAACTTACCTTACCCTAGGTAATTTATAAACAATAGAAATTTATTGCTTACATTTCTGGAGGCTGGGAAGTTCAAGATCAAGCCACCAACAGATTGTATATCTAACAAGGGCACTTTTCTCATAGAAAAGGCCTTCTTGCTATGACCTCACATAGCAGAAGAGAAAAAGGAGCTCTTTCAAGCCTCTTTCATAAGGGTACAAATCCCATTCATGAGGGCAAAACCCTCATAACCTAATCACTTGCCAAAGGCCCCATCTCTTAAAACCATCACCTTTGGGGTTAGATTTCAACATGAATTTTGGAAGGAAACAAACATTTAGACCATAACAATAAGAAATAAAGAAATTAATACAGCAATAAGCTCAGTTATAATTAAATGGGAAAACAATGTATCAAGTAGAGTGGCTGGTAAGGGGAAGAAGCTTCTAGATAGGAGAAGTTAAACATATTATATGGAATAGTGTGTGTCTTGGAAGAAACAAGAGTAGAAGGATCCTGAATATTGGTCTAGCCTTGAAGAGTAATAGACCCATTTTCCCCTGACACTGGAGGAAGACAGATAAGCATATGTATATGGTTATAGAGTAAATGTTTACGCTCTACTCATGATAATACTGATGAAAAGAGATGTATCTTTAACTTCTCTGTTGATGTTAGAAGAGAAGCAACTCCACAGAAGAAAGACCTGAAGAGGGCAAGACCCAAAGTATGGTCACAGAGGTAAGGTGCTGAAGTGGGAAAGAAGAAATGAATGCCATTTCAGACCTGCCAGGCAGGAACTGTGTGGCTAAAGGTGTAGAAAGGGCTATTCAAATAACAACAATAACCAGCAATAGCTTCCACATTGAGCATTTGTTATAAAATGTGCTATGAAAAAAAATACTAGTATGTAAAACTATTTGTAAAAATAAAAAATCAAATAAGAACTTACAAAATCTAGTTAATGAAAACCAAAACAACAGTAAAGGAGAATATTCACTACGAAGAAGTGAGTATTCCCATTTTACAAGGAAGAAATGAAGCTTCAATGATTAATCCAGGGTCATTTTGCTAATAACTGGTGCATCTGGGATTTGATCCAAAGTCGGTCTGATTTAGAAACTGTGCTATCCATCATTTTCCTCTAGTGTGGTTACACATGGATGTGGGAGTCCCTCAGGGTGTTGGCAAGGCTTACACTAGGGGTTCTGATGCTGATGTCTTCAGGAAATGTTGAGAAGGCCTTTGAAGAAAACACCCTGAAAGCCTGGAGAAGATAGGTAGAAAGTGGTAGCTAAAGAATCTTTAGCTTCAAAGGAAGAATAGACTTTGTTTAGAAATAAAAAAGTAAACTTCTGGAGGTGATAATGGAAGCTGGAGAAAAATCAGCACTTGGCTGTGTGGGCACTGAGTAGTTTCCTTTACTTTAAAAAAACAAAGATTAACCTTTGTTTTTTGAGACTGTAGAGCTTTGAGGGCCATTTTTAGATTTTTGTCCCACAGAGACTGTTTCAGTTTTGGAAAATCCATCCCTGAGCTTGTCAGACGCATTGAAATATACCAATCTCAAGTGCAGTTGACTAGTTGACATATCTTCTTTTGTAGGTATTTGATAAATATCCATTATTTTCATTGTTGCAGATTTCTTTTTGTATTTCAAAGCAAAACTTATTTTTCAGCTCCCAAACATGTTTTTGGCCCTGAAAGAGCCCTTAATCCCTGTCCCCAGGTGCCGTGTCTGCAGTGGTTACTGGAAAAAATGAGCCTGGTTGCCTCCCTTCAGCATGTGTAAAGCTTGATATTTGACAGCAGTATCACCTCCAATGAGCATTTGCTGGTGGTTAGATCTAATCAGGTTTATAGATTCCTGCCACAGGCCTTCAGAAGTCCAACTTATTTCTTTTTTAAGATTCCAGTATTTCTTGGGCTTTGCTTTAATCCACATATAAGTGTCATGTCACCTTCTGAGGGCCTTCAGGGAAGGACGTGACATGTGCTTTATTCCATGAGCTCACTTTTGGACTTCTCAAAGATTTCTTAGAAAATACTATCTTGTATATTTTATCAGGTAGTCAGAGATAATTGAGCAAATCAATACTACCAAGCACAGAAATTATTTTCTTAGTGTCATGCCTGGCAGCAGCAAACAAACAAAATGCCTACCATGTGTCAGATTCTCATGGTCCTGGACACTGTCACGTTCATTCTGTCATTTAATATTCCTAATAACTCTTTGAAGTCGAGATAATAATCTCCAATTTGCAACTGACAAATCTGAGACAGAGATTCAAGTGAGTTGCCTAAACCCAGGTAGAATAGGAGAGAAATTCCAAGTGCCCCTAACAGCAGTGCTACTGAGACATTCAAGACTTTAATTTTTTTATCTTTCTTACTTTGGTAAAAATATCTTACGTGTCTGAAATAATCTTTTTGTATTCGATGTGGTGTTAAATGCATCTGTGACTATTCGTACACTTGTAAATAGTTGTGGAAACCTAATTTGATCTTGCTTCTAAAGAAATTATAACTGGATGTAGAAAAAAATGGGACAATAAGTCTTTTAAATTGTAAGCAACAATTTCTTGCCTCCCACATTCCCAGTGTAGCTTTTTCCGCCTCTATAACTCAAAGAACACGACTGTCTTCCATTAGAATAAATTGTTTTTGTCAGCACGCTTTTCCCTGTGCACTTCTTGAATTTGCTTTTCTATTTCCTTGTTTAAAAATAGCTCCATGATGAGCCTATATTTCAGCTTTGATATATTTTATGAGTGGAAAGGAAATTACAGATATTATATCACTTAATATTACTGTGTTAACAAAAATGTAAACTCTTAGAGGGCAGGTATTTTTGTGTGTTGTGTGCATTGCTATGATCTCTGTGCCTAAACTGTGTTTAATACAATAAAAGAACACACAAAAAAATTTAATCAGTCATAAGATACATTAGTTTTACTCTCTTCTAGTATCCTTGCATTGGCCTTCAAAACTGTACCCATTTCTCGAATAACTCCCAGTAAGTCCTTCCTTTGTAAATGGTCCTATATAAGGTAAACAAAGTCTGACTATGTAGTTGGAGTTACTGCCTGAGTTTTACATATATCCTAGACTTGGTCTCAGTCACAGATTAATGAGCATTCACTAAGAGTTGATGTAGACCATGATCTCTAAGAGCACAATAATTCTAACTGTCTTTTCTTGGTCAGCTCTGCCTAGCCATCACTAGCACAATGCCCAGCACAAAGTCACCACTCAGTAGATATTTGTCAAATCAATAAATAATGACAGAATCCAAAATCGTAATAATTTATCCCAGTGCTCAGCACTGACTATATGTTTAATAAATATTTATTGAATTTCATTGAATATTGTGCTTAAAGAGAGAATCATGCCATGCATTCCAAATTAAGTAGGCATTACATTTGAATTATCAGCTGTTTGGGATTATCTGTGTGGCTCCTCCCCACTGTTAGGGTGGTAAATTGAGATCTTACTCCATCAGCAAACTCCCCAAATCTGCCTAGTATTTGGTTTCCACAAGACTAGTTTACTAATTCTAACGATGGCATATTTAATTTTAAAACTAATGCATACCATGATATCATATACTGTCCATTACTATTCCAATAATAAGAACTCTTTTTCAGAGCAGCATATTAGTTATTTACTAACTGGTCCCTTCTTTCCTTTTCTTTCTTCTTTTTTCTTTTGTTCATTCATTTTTTTCTTTTCTTAATTCTGAATGTCACATAAACATATAAAGGCCTAAAGGCAAGGATCTTGACAATATTGCAAGGTGTATTAGGGTTCTCTAGAGGGACAGAACTAATATGTATATAGGGAAGAATATATACATACATATATATATTTATATAAAGGGAAGTTTGTTAAGTATTAATTCACACAATCACAAGGTCCCACAATATGCTGTCTGCAAGCTGAGGAGCAAGGAGAGACAGTCCAAGCCCCAAAACTGAAGAACTTGGAGTCCGATGTTCGAGGGCAGGAAGCATCCAGCTCGGGAGAAAGATGTAGGCTGGCAGGCAGGGTCTAGAAAAGTCTAAGAACAGTGACTAGACAATCAGCTTAAGAGGACAGACACTTGACTTTATGTTTATAACATATGGTCCATCTTCTTGGCTCTTGAGTTACCTGAATTGCATCATGTCAAGATGACGCAGGCTTCCAGATTATAGTCACTTCTTCCCTCTAGTTCCCGTAAGAATTAAAATGATTTGACTTTAGTTCCAACAAACATAACGTAACATTAATGTGCTTCACATTAGGTCAAATGAGTCTAAAAATACACACACGCACACTACATACCCACACACAAATATGCACAAACGTATCTTAAATAGATAGCCAATTGGTGAACACTCCAAAACAGAAAGATCATACATTTCTAGTGTTTCTTTGCCTTATGACTGGCAGATTCTTTGTAACACAAATCTCTCAGTGGGAATAATTTTCAAAGTATATAATATGAAACCAGTTGTTTCTGAATAAAGCAATCAAATAGAATTATAGCAGATGCCATCTATGGGGGTGGAAATGGTGCCACCAATACAGATACCACCACTTAAGTAAAGGAGAAAAATGTTTAAATAAGTACATGGCGTCATCTTGTTAACATAACTATACTACATTAGTTGTCAGTAAATTTAAACTGTTAAACATTAACATATTAATCACTATATAAATAAATACAAGATATGAAATACTCAAGAAATTGAAAAGTTTAATGCATGGCCAAATTCTTCCATAACAGGGAATATTTTTATTACAGACATAAAGAAATTTAACTTAAATTAAAAATTTTAGTCTCTTTTATTGATAAAAGTCTCTTTCCATTATCAACAAGACAATTTTCCTCCCTCTAAGTAGAGTTTCACAAATCTCTCAGCTGAGTCATTATAAAGATCTTTTGGTGTGCTCTTTTTTATTTGAAATATCTCTTGCTTGAAATTAAATTCAGTCCTAAAATAGCAACTATATCACCTCCTATCCACTTCCCATTAGTAACAGCAAACTCCAGAGATTAGCAGAACAGCATTCATGTGTCTGGAAAAGGAACCTTATGGATGATTTAAGCATAAGACCTGGCTACTTACTAAGGAGCAGTACACACATATTTGTAAATATTAATGCCAGACAAAAATGAAATCTGACAAAGGTGAAATCATTGTACTGTACAGACTAACCTAAGCAGAGTTCCAATTTTGCCTTTCAACATTATATCTTGCAGGGTTGTATAAGCAATAAGCTCATTAACATCAGTGTAACTGTCCCCGAAATACAAGTGGATTCTGGAGAATGTAGGTAGTACAAATGAGCTCTCTTCAACGTTAAGGTTTATAGCAACTGATTCTTCAGAGAACATGAAGCCTTATGCTTGAGATAAATTTCCTCATCTGCTGTCATGATTGACAGGTCCATTTGGTTTGTTTTATGGGGGAAGGGAACAGGACTGGGGCCTGACTCAGGGCACAGTCCTCAGGTTTGGGGCTCTTTTGTATGACTGCCCACAAGTGCTATCTACTGTCACACCTCTTTAAACCTGCATTTTCGGATTTTAACATCAGCAACCAATGCTCTTCTCTGAGCCTCAACACAGTTATTCTTTAAATACAGTTCTATTTCCTTGGTGAAGTCTCCTTTGAGGTACTAAATTTAGCACTGTCAATCAGAAGAACAGGTGGTATGTGACACTACCAAATAGGTCCTCTCCCATCATGCTTTCCTAAGACAGCCAATCACCCAGGGCCCTGCCTAAGGATGTGGGGCTGTCAGCAGATCTGGTGAATATAAGGGCAGGCCAGACCCTGGCTCTTGAGCAGTCGTGCATTCCCAGCCTCGCCTCGGGTGTAGGGATTGCATAGAAAAGCAAAACTACACAGTCTTGACTGTGTAGTTTTGTTTTTAGGATTAGAGGCTCACCGATTCATGTCGGAGATGGTCAGAAAAACCAACTCTCCATAGGACGTCGTTTCAGAAGCAACCTTGGGCTTAGTCCCACCCTTTTTAGGCACTCTTGAGAAATCAGGTGAGCAGCAACTTTTCTTATTTTAATAGTAGAGTCACTTTCTTATTGATCTCTGGCTCTGGATTATTTGTGTGTGCTAAATGCCTATGTACAAGTGTTTGTATGACTATTTCTTGCCAGTGCTGACCCATTATTTAAATCTGCTTGTTAAATTCTATTTTAAAATGTCTGAACATTTTTCCTTAAAAAGTTGAAAGCTTTATTATATCAGCTAAATGATTCCATGATTCAAATTGTTTAAGTTCACTTAATATTCTAAAAGTTGAGGTCTGAAATGTTGAGAGAAATGTTTACTTCTTTTCTAGACTCTCTTTGCCTGTTGAGAATGTTCAAGGTTATATTACTCAATGATAAAGTTAAGCACACCAAGAATAGCTCTGATAAAATGCATGTGGTATCAGCTACACCCTGATGACTTTTTAAGGGAATCAACTGCTGAGGTATCAGTTGCAGGACAGTGACAGAACACTTGCCTGCTGTCAGTCAACCTTGGAGAGTTTAGGAGAGTTTATTTTAAGAGCATGACATTTTAGACGCATACCTTCAGCCCCAGTTAGACAAAGGCCTGTGAAGAGCAAGTGCTAAGGCAATAAAATTTACCTAGACAATAGGAATGTAAGATCAATTTAAGCTGGTTAATTGCAACATAGTTGGAGATTTGGAATAAAATGATATAATTGTTTTCTAAAATATTCAGAATCTCTTCATGCATTTTAACTCAGCACACAGTCCAATTATATATTTTGAGATAAATGTTGACACTAAGAAGGGTAAGAAATAATGTTTAAAGGAAAGGTTTCTTACTTCTAAATACACTTTGATTTCTCATCTTCCTAGAATTTGATTACTAATTGTCAATGCCTGTAAATACATAGATATATAATTAGGTATTCTATGTCTAAGAGGACAGCTATTTTTAGATATACTAACTTATAAACAGACAAAGTTAGACACAGAAAGTTGTTCATCCCAAAGATAATATGCTACAAAAAGGAGTTTCTGACAAAAAAAATTTATGAAAGCTTTTGGATATTATCTGATTTTTCCAAATATAAATTTTATTGTCTCAGAGAATGCTGGTTTCATTTTTTTAACTAAGTAGAAGGTTACAGTAAGGAACAGAATTATCACTAAGAAGATTATTGCTCCATGAAGTTTTAGTAAACAAAGAATTTAATGAAAAATAGTAATGAAGTGATTGACAATTCAGAAATGTTCTATTTCAGAACAGAATAGTCATGTTGAATAATTAGGTATTTATGCATCAGAAAATTCTTCACATAATGTCTCTGAAACTGATAGGCAAAGTACTTTCTTGCACTTAACAAAATGACTTAACTGCAAATTTTATATTCGTTTCTTTGATGTTGAATATTTTACTTTATGAAAGCATAGGCCTTTTCACTTCATCTACATTTTACACCAGCCTTCCATTATTCAAAGTTTGCAAATTGTTCCATATTAAGAACTCAAGCCAGCATTTTTCTTTCAGAACTATAATAAACTTTGGCCTGTTCACTAAAATTTAAATTTTTCTGAATATTTACTTCAGCAGTAACAACATTTACTGCACAGTTACAGTATGAAGAAATGTTAAGAAATAGAAAGCACCGTATGCCGTCTACAAAAAGCTTGCATATTTGATAAGGCTTGCCAAAGCTTCTCCAGTCAGGAAAGAGATTACAAAGTTCAGATTTTTACTTCTGGCAACTATTTTAAGTAATCAGATAATGTCTGAATCAATGTCAACTTTATAAATATAGAGTGAACGAAAAATATTGGGGAGAAGGAAAATTTTTAAAATAATTTTCACTTACTAAGCTGATGCAGAGGTTTATTTATTTTAATTTTTTTTTTTTTTTTTTTTTGAGACAGAGTCTCATTCTGTCACCCAGGCTGGAGTGTGGTGGCACCATCTTTGCTCACTGCAACCTCCACCTCCTGGGTTTAAGCAATTCTCATGCCTCAGCCTCCCAAGTAGCTGGGACTACAGACATGGGCCACCACGCCTGGCTAATTTTTGTATTTGTAGTAGAGACAGGGGTTTCACCATGTTAGCCAAACTGGTCTCAAACTCCTGACCTCAAGTAATCCTCCCGCCTCGGCCTCCTAAAGTGCTGGGATTACCAGCATGAGCCACCACGCCAGGCCCAGAGGTTTATTTTACATTTATCACATGTCTTGTCTCTCTAATTACACTTCACTAACCCTGCATTGCTGTGGTTTTCTTCTTCAACTCTGAACCTGGTTTTCCACCATTGGTAAGACTGTATATTCCCTCTTTGACCACTAGGGTTCATTCCTTGTTCTGTTTGGCTAATACTTTTTTCCATTTCCCCTTACACTTGCTACTTTGGGTTAGGCTTTAAGTCAACTCAATGATGAACTATGCAAAACTGTTCAAGCCACAAAAGAGAAGACCTGCCCATCACTCTAGGCCCACAGATGACCTATGGAGCAATCCATTTGGAGAAACGTGTGTCTCTGCTATCTGCAAAGCAGCTCCAGAGTGACCCTTAGCTGGGACACCCTAATTTATTTTCTCTTCTTTTTCAG
>TTN-205,,0,2210,3225382,3227591,GTAAGCTCACACATTCACACTTTTGTTTTTTTTTCCTTTGCCTCCTCTCCAGTAAGTTAACGTTGCTGCAGGACTTGACGCCAAGTTTAAGCCCTGCTTTCACTTCGGAAAATTAGTCCAACACTATGGAAAGGTCATTTTAAGGGTATACCATTCACAGAGTACTGACAAAATCTGACAATATAATGGCTTGAAATGTTTTATTCATATTTATTATTCCACAAAGCAAAAATAATTAGTGTTGGATTAAAATTGCCGTTAGAATCCAGCAACTAAATAGGACCAAATTTAGTCATTCTATATTTGGGCTCAGCTGCAGAGCCAGACTGGAAGCCAAGAACTCAAGCCCAATAGAAGCCAGCCACAGAGCCATGGGGTAGGCAGTCTGGGCTGCCTGCTCTGGACACCTGAACTTCAGTTGGTTCACACGCAAAATAACAGTGCATCTAATTTTCCTCAGAGGCAGAGCTGTTCAGTAATTAACCAACTCCTCATTATTTTATTATTTTATTTTCAATCTTTATTGAGTGATTCTAATGAATTAAAAGACTTTCCAATCGTTTTGAAATGACAGAAAATAATATGCTTCTCGGGTGTCTCTATTTAAAAGGAAGCAAACACTAACCCTAGAATTTTATCTGAAAGGAAGTTCATCTCTTTTTTGCCTTCTTTTTCTTCCTCATAACTCAGTTTATGGATGGTTCAAAAAAATGCATGGTATCATCTTATGAAAAAATGGAGAGTAGTGTATGAACTATATTGTAAATAATTTTAAAATTAATCAATATTTTCTCTTTCTGTAGTATTGTAACGAGCCATGTAAGATGGATACGGATTAAAAAAAATCATGCTTAATTCTTAATTTAGTGCACTTCCATGGTTCATTGCCCACTTCTTTTTTAAAATTTTATGGCTTATAATAAAGATATAAAATAAAATTTCTTTTTTTCTCTTTTTTTCTATTATATGCACCAATCTTATTCATAACTGGATAATACTTTCTTTTACATTGTACAAATATCATATAATCATTGCTTATTTTCTATTGTACATATATAGACCAATGAAATTCCCTTTTCATTGGTCTATATATGTACAATAGAAAATAAGTCTTACCGACTTCCAAATAATTTACCTATTTATCTGGTAACACTCAGTAACTTCTGAACTGAGCAGAACACATATGACTTCAGTGGGAATTTGCCTCCTTGAGAAGTAGTGGAATCTGGCTACTTCATATCTTCTTGTTCCTTCAAACTATATGCAAATAAATTATTACAAAGACACTACTGAAAATATCCAATACCCATAAATCAGTCCAATAAACTATTTAATTGGCCATAGTGGGAGATGGGCTAATGTATAAACAACAAAATAGACTTTCTCTAGATTATCTTTACCTACCAGCGTAAGTAGATAGAGCATCAACCTTTATGCCAAGTGTGAAATAAATCATGCCCTGAATGTGCCTCGTACATTCTCAATGTACAGAGTTTTAATATATTTAAAACATCAAACCATGGACATGTAGTTCTTGGCTCTACAATTTATGGCAGATAAAGAGAATTTGGCTTTCTACCTGCAATTCCAATGATCCATGTTGTTCTGGAAGACTAGGTTTGGATTAGTCTCTTATGAGAAATTGCTTGTCCATGTTACAATGTTTTTACTGATTGCACTTGTGAAAGCAGAAGAGTCCAAGAAGACAGTGTCCCTGTAACCACAGAGGAGGGAGGAGGGCATGCCTCCTGGGCTTGTCAGGCAGAAACTGGAGATCAGTTTGCTGCTTTTGTTCTTCACTTGCTCTCAAAGAGGACAACAATCACTCTTTATTTCAAATTTTCCTTGGTTCTTCATTTTTATAAGTCCCTTTCATGATTTTAATGTTGTCTATTAAATTGCATCAGATAGAGCCCTAGGCAGGCAGGCAGGAGATGGAAATTCTAGTCCCCTCTGTGTCACTGCTAGCTGAAGGACCTTGGAAAAATCATTAGGCCTCTTTTGGTCTCAGTTTCCTCCCTTCCTGCCTTCCTAATGGTCTGCAGGTTTACACACTGATCATGCAACTGTAGGGTTTTCCCTATCATTAAGTGGCATTCCATGCTGGAAAGCTTTTACAGATTCGGACAAGGCAGTGAACATGATGGGACAGAGCAGAGGACTTTGTGGTGCCCATTCAAACATAAAGGTGAATTGTTCTTGCTCTTCAG
>TTN-205,,0,1455,3227592,3229046,GTAGGCTGCTGGGGACCTGCCAATCCTCTGCTCCCCCAGAGGACATCTCCAGCAAATTGGGAAAGGAGTCCAGAAAAAGCTATGGGCAGAGGTAGATGCAGCTCTTAAACTACAGAAGGGTCTACTGGAGGCTGAATTATTTATAACCAAGTTGTTTGCCTTTTGGAATTTAATTTTCCTCTAGAGTACATCGTAAAAGTGACTGAGAATCAGTTTCTCAATACACATATTAAACACTCAAAAGTATGTTAAGGAAATATTAAAAATCATGTTTCTCAGCAAGTAGAAAAGCTTGGAGCCTTGTTTATAAGTCCTTTAAGGAATAAGACATATTCTCCAGGGAAGTGTGAATCTCCAGGAATTCACACTTTAACAAGCATCCAGATAATTCTGATGCCGGTAGTCTACAGACCACCCATTTAAGAGGCATGTAAACATACCCAGAAGAAAATAAATGCTTGTTTATTATTCAAATGCATGACACTGTTTCCCCAGAAAACTTATCACCAATCTTAGTGGCCTCTGTTGTTTTTCTCTATCCTTTACTACCTAGTGAGACATTAGTATACAGAATATTGCATGCCTTTACATGTTTTATAACAATATCTTACATGAGCTACGTAAAGTTACATATGCTTATCCAATAAACTTTACCTTCAATGATGTTCAATTATAGGGCTATAATTGACCTAAGCAGAAACCACATCAAGTAACATCAGGTAGAACTTTAGCATGCACCCAGAAAATTCACAAATGGAAAATGCACAGGGTTGGCAGCACCTGCTGTTGTTTATTACTCAAAATCATGTCAAAGTTAATTCCACTCACTCCTCACACTTATAAAAAATTTCCTTCAACATAACCAAAAAAATCCCCTTTCTGTAACACAATTAAAATGAAGTAATGTTATTATTGGGATTAACGTTTTAAATGCAAGTAAATATTTGGGTTATTTGAATACCTATCAAGTTGGAGAAGGTTTAGAATTTTAAAAATTAAATTAAAAATGTAATGATTCTTTAAGTAACAGGTACACCCATCGTAGCAACCACTGGAATTCATTTTAATGCAACTTACTGGAATATGCAACATGGCTTTCACATATTAATAGAGCGCTAGATGTGAGGTAGAGGGGGAAGTACCAGAAAGATTCTCAAGAAATGTTATAACAAAATCTAGAGCTTTTATTTAAAACAAAGAAACAAAAGGTGGTGGCCTAAACTGCTCAGCAAAACAAAGCAAATAAAATAAAATATGGTGGTGAGAAAGCCTTCTGTAATCTCCTGGCTCCCATTCTTGCTGTCATTGCTGGGTGAGCTGGGTTCAAGGACATTCAAGGATGTTTAGATTGGCGAGTCATCACCTGGTTTTGGAATTGGAGCTGTGATTATTTAAAAATACCTTGTAGGGAGCACCCTGGCTCTCACTCTTGACTTTGTTCTCTTGTCCCCGCAG
>TTN-205,,0,484,3229047,3229530,GTACGTGCTGGAGGTTGAGGAACAGAGAGAAGGGGAGAGAGCTGGTTTGTGTCTAAATGGGGCCAAGCGTCCACTTGCCACCTCTCACAGCCCTGGGAAGAATGCTGTGAGCTGATATAAAAGCTGGCTTTTCGACACCCATGAAAAGTCCCTGAGATTCTAGTCAGGAGCGCAGAATAGAAGCAATCTGTGCTTATGAATCTCATTATAAACTGGAAAGGGTTTCAATTAAGTGATCTACATTTCCAAATTATTGGCAAATAATGAAATTTTAAAAAATCATTCTAAGTAAATTTTTATCTTGTAATGAACATTTTCTATTTTTAAACCTAATTTATATTCATGCAAAATCCAAAACTTTCTGCAATTTTCTCCATTGGGATATCCAGAAAATCTTTTTGACTTTGTAGTCAGAATTAACAGAATCTCTTTTAAAATGGGTCATTGTGCCCCCTCCCAAACATTCATCTTTCCCTTCCCACAG
>TTN-205,,0,93,3229531,3229623,GTATTTTTCTATACTGTTGGTTTTCAAGCCTTTCAGGCTGTTGCGTCCCCAGCTATTCCTCCTCAACGTGGGCTTTGTTTTAATCTTTTACAG
>TTN-205,,0,4234,3229624,3233857,GTAAAGCTGCCATAGAGAGAGCAGATTATTGCACATTTTGGAACTAGGTTTTGAAACGAGAAAGATTCCCTTGTCCCCCTCGCAGGGCATGCGACGCGGAGAGTGGTTCGCTTCTTCAGTGTCCCGCTGCTCAAACCTCTAGGGGAGCATACAAACGGGCAGGTTGTGGGGCTCCGTGTTCCTCTGGACATCCAGCCGCTTGTGTGTCTGCCTACTAGGGTCTCAGGGGTTTTTATAGGCATAGGGTGTGGGCGTGGCAGGTCAGGGTGATCTTGGGAAATGCAACATTTGGGCGGGAAGGCAGGAGTGTTTGTCCTCACCTAGGTCCATGGGCACAGGCCTCGCTAGGGACCACGCACTTCTCTTCCCAGCACTTCCCTGCCCTCCTCCCGTGTAAGTTTCATGCACTCAAAAATGTAGCAGGTGACAAAGGAGGTAAACCAAGAAGTTACTGAATATGATTTTCACAAATCCTCACTGTCCACAGGTAAATTGAAGACCCTTATAAACTTCTGAATTCTTATTTATATTTCATGTAATAAATATCTACTTTAGGGGCCAAAATATGGCACAGTGAAAGGAGAAGAGCACAGAAGTTAGAGTTCAAAGCCCTAAGGACAAATCAGCCTGATCACTTAACAGTTTGATTTAGGGCAATAAGTATAAATAATAAAATAATTGTTATTATATATGGATCACTTCCTCTATCAGATTGGAACTATACATACATTATCTCATTAAATGTTCACAACCTGTAAGAATTATTATCCTCAATGTTATTGATAGGTAACTGGAATTAAAGAAGTTAAGCAGTTTATTTAAGGTTTCAGTTGTGTCATCTGTAAATTAAAGAGAGTCACAATAAGAATGATCTCAAGCTGCATTTTGGGGCTTCAATGAGATAATTAGTTGAAAGTGCCTTGTAAATAGAAAATAATTATGCCAATATTCTTATATTCAGATGGTAAGTAAAACCTTTTAAATATTTTGCATATGCTTGTGTTATTTTATCTAGAAAATAAAATGGACTTCTATGCTTACTTAATATGGAAGTATTTTAGAAGGTGATCATGTATCATGATCAGGGCTCAGAAATTATATAATCAAGTGTAAATTGTCCACAACAGTTTTGAAAGTTTGGGATTTAGTTTATCATGATGAAACTTTTAATATGATGAAATGAAAAATGTACAAAATTTGAGCAAAGAAGTGTTTATTGATCAATTTAAATGAAATAAAAAACACATGGATGTTCCCTGCCAAGAAAATTTTTTATAAAAGAATAATAAGGAGATAGTTGACCTAAATAATATTCAAACATACTGTAAAGTTACTATAATCAGAACAGTATGGTATTGGTAAATGAATAGAAAAATACACCAGGGGAACAAAACAGAGAGTCCAGAAAGAGATCCAAGTATAATAGATCCAAGTATATAGGGAATTCAAAAAGCAAAGTGGCCTTTCAATTCAGGGGAGGGAGAGGTATTTTAATAAAGAATGCTGGTCCAATTAGCTATCCATCTGGAAGCAAACAAACATAAACCTCTGCCTCTCACTATTTACAGAATAAATTTCAGCTTGATTAAATAGTTAAAAAATGAAAAAAAAAGAGAAGACAATCTGCAAAAGCATTTATGGGTGAAAGCTTTTAAAAAGACAGTTACAGATTCAACTACATAAAAATCAACATGTATGTATGGCAAAAGCAAAAAGTCATTTCTAAACCAAACAGCACTTGTGAAAAAATTTTAAGACCTTTCTCCTCCTCAAGGTACTTCATTGCCTCTGCCATAAAAGTATCACAATAAACATAAAATGGCTACAAGGTAGACAACACCAGCCTAGAAACAGTATATAACATACAAAATTACGTAAGCTTATGCTGGATAAGACCCATAAACAAGCAAAATATTGAAATGGATTAAAAGAAATGGATCTGGGGGAATGTTTGCAACACTTACGACAAATAACCAATAAATGCACTAAATGCATTAAAAATCATCCACAAATTAATTTTTAAAGGAAAAAAATGCAACACAAAAAAAGACAAAAGATACAAAAAAGTATTTAACATAAGAGGCAATGTAAAAGTCCAATAAACATGTGAAAAAAAATGCTAGATGTTTTCCAATTTTTATTGTTTTAGCCACAAAAATGTAAAGATATTGGCAAACACTAACATGAAACCTTGAACAAAAAGCTTACTTTAAAAAACATGTCTAGCAGTCGAATAAAAAAAAATGTTCAGTCTCAGGCTAAATCCAAGTTTGCACACCATGAAATCACAACACAAGCCAAATGCAATTTCTTGAGGAGATAACAACCTAACTATATTTTAAAACCCAAGCCTAAGGGTCATTTAGAATCATGGAGTGTCCCTGATCCCATGGAGCATTTTGACCATCTTAGCAGTTTTGAAAGTTCATTAATAACCATCCAAATTGCCCCAAAATTTTGCTTTCCAATAATTAAGAAATAAAATGCCAATTTGCAGAGAAAATAATGGTTATCAAAGATAGACTGCTTCCTAAATATCTCATAGTTTAATCTTGATTTTTGTTGTAGAGTAAGGCAAACATATTTCATTGAATAAGGTGCATTGTATCTCGCTGTGACCAGGTGATTATTTTTTGTTGTAAGTACAGAAATAAGCACTCTCCTATAATGACCAAAATTACAATGATTTTCACAGTTATGGGCTTACCTGTGTCCTGCTGTTAATCAGTCATGTCATGCTAATCATGTCTTTAACTCTTTTTGAATTAAACCCATTTACTAAGTACAGCAAGAACAAGGCACAGGGTGAAACTTAAAAGCACATGTCTCTTTGCTTTTCTTCAGTTAGTGGAAACCACACATTATTCTAACTTGGTTTTTGTTATATTTCAAAGGCAGTCATGTTCAGAAAAGAGGCTTATTCCCTAGATTTCCCTTTAGTTTGATTACAACTTCATTTACAAAATGTAAATGGATTTTCACACAAAAAAAGCCATTCTTCGAGAAAATAAACATTTCTTCGTGAAACTGGTTAATGTTGTAATGTACTGTTAGGGTACTCTGTAAGTTAGAGAAAATATCAACTGTACCTTGAGCTTAATTAGAATAATCATTTCATGTATGATCAGTGTAAGCTAAATATCCTAGATAGTGACAAGATGCATTTATAAACATTTTCTTATATGCAGAATTAATAAAATGCAATGATAGGGCAATACTGCCACCTAGAGAGGAAAATGTAATAAGCCTTATTAAGAATTAAATCAGTTCTGAAAAAAATTTTACCTTACAATAGTTGGCCAATCCCCAGAATTATTGCTATAGATCAGAAATAGTCTTTTTTGGCCATCAGTGCTGGGATTTAGCACCCAAATTCTTCAACTGATGCTACTTGCACTTTGGATACACCTAAAAAGCAAACAATGAAAACTATTCTGGAAGAAGCAACTTTATCAATTTACCCAAAAATCACAGAATCATTAGTTTTTAAGTTAGTCAATTCCCACAATAACTCTAAAGATATTTAAAATAAGTCCAGAGTGCAATACAAGGGGGGCGAGTGTAAACAAATATGGAGGAAATTAAAAGTAGCTGTCCACAAACACTTCGGCTAAAGCAGCAATTTGCAAAGTGCACTGCACAACCTGTACCCAGCAACATGCTGCAGAAAGCTTCCTGAGGATGTGTCCCCCTGTCCTGGAAATTCACAAGGCATACTGACATAGTAAAGGCTGTGGGAAGTCCTGCAGGGGAAAAAAAAAAATGGCTTAAGCTGCTTAGTCAAGAGTGGCACAAGCATTTTGATTACAGAAACCTTTCTTCTTATAACACCTATTTGACATCCTCTAACCCCCCCAGAATTGGAATACAGAGATGAATTTGGAATACAGAGGTTGCTGGATTTGACATGTCTTTCCTTTGGCTGCATATTAAAGAAGTAGCTTTTTCTGTTGTGATTTTTTTTTTTTTTTAATGTGAGAAGGTGCAAGGCACAAAATCTCCAGCTTATTTGGAATTAAAGCTGATTCTCTTACAGGGTTACAGCAGATAAGAATAGGTTTATTGAGATTTAAAACAAATTACTTCCAAGTACATTATTTACCCTCTGAATGGGTTATGGAGGCACACATTTTAAAACTCTGCCTTAAAGCACTTCCAGCTTTTCATCTCATGATTCACATCCAGTTACCCCTCCTTGCTTTGACATTCTTGACCTCTGCCTTTTGGTTTTCAG
>TTN-205,,0,370,3233858,3234227,GTACTGTCAGAATGGTTTTGTTTTTCCTTATTTCACATTCTAGTTTCTCCAACTGGATTTCTGCCATGAAACTCAGTCTGTATAAATTGGAGGAAAAATGCATATGAACATAAAAATATAGCAGCAACTGAAGACCAAATTCAGTAGTCATGCTTTGTAAAACCATTTTTAATTAGGACAAAAGCTCCAATCTGTGAAGTTTCCATAATATACAGGTTTTAATGATACAGTCTCTGTATTTCTTGGCAATAATAAATGCTTATGTATGAGTGTATTTTGCTCTAGGTGGCTCAGTTTTCCAGTATGCTTTTTTATTTTCTACTGGGCATGTCATTTAAAAAAGTAATCTACTTGGTCATTTCTAATCTAG
>TTN-205,,0,857,3234228,3235084,GTACGTGCGAGGCTGCCATGGGGCACCCGCAGAGCCACGTCCTTCAGTGCACATTAACTCAACCACCATCCACTGAGCTTGGCATGCAGCTGTGCTCAATTCATTCTGAAGACAGCCTTGAGCCCAGCAGGGCCCAGACTTTTAGAACTTTCTGAGCAAAAGGTGGTCGGAGATGTCAAAGGTGTTGACAATGTGAGTATCACAAGAGCAGAGTAGGCCAGAAATACCTGGGCTATATGAGCAGGCAAAAGTCAACTATGGTATTCAAGGTAGGAAGGCAAAGAGTGGCCAGAGAAACAGAGACCAGTCAATTCCAGAGCTCAGTCACTGCACACACTGGATGTGGAAACTACTATTTCAGGGAAGGCATTACATTTCTCTAAGTTTCCCCAAAGGACTTTTGTTTTTACTTTTCTCAAAACAAACATGACACTTGATTCATAGCTGGAACAGTGTCATAAATCCAGGATAATGTCCCACCTCGCATTTGAATAGATTTTCTGTTACAGTTTAAAATCATTCCAGCTTTCCTCCTTATCCTCTTGTGTGACATTTATGTCTAAATCCTGACAGATTATTGTAACTTTTTTTTCTTTTCTGAGACAGAGTCTCGCTCTGTCACCCAGGCTAGAGTGCAGTGGCATGACCTCCGCTCACTGCAGCCTCCGCCTCCTGGGTTTAAGTGATTCTTGTGCCTCAGTCTCGTGAGTAGCTGGGATTACAGGTGTGCGCCACCACACCCAGCTAATTTTTGTATTTTTTAGTAGAGGATTTCACCATGTTGGCGAGGCTGGTCTTGAACTAATTTTTATGTAAGATGCATTAAGGTGTTTTCTTCCTTTCTCTATGAAAAGCAG
>TTN-205,,0,1206,3235085,3236290,GTGAAAATGGGTTTGTATTTTAAATTCACTGAGGTTCTTACAGGGGTCAACACAGATAATCACCTTTACCATGAAGAGTGTTGTTCCTTGGGCCACATGGTTGTTAGCATACTAATAAGATCCCCTTGTTGTATGTGTAAATTTCTGGGTACTGGATACCAAAGTTTGGTAGTGTCCCTGAATGCTCCCCTTGTGAGTATGAAAAAGAACTCTGTGAACATACACCAGGAGTAGAAACAGGGGTCTCATCACATTGATCTGGGGATGCACTAAGTATAAGACTATAGGGAGAGGACAGATGGCTAAAACCAGGAGGAAGAAATAGATGCTGAGGCAGGAATGGGGAAAAGTGGAGGAGACACTGAACTCACTTTGCTTTAGAAATCTTAGCAACTGCTTCCTGGCTCCTTCGGAAGACATTTGCACATGAGTTTGAAGTGGAATGGACAGCATGGCTTTAACAAGCCAAATGACCAGAAAAGGTGAAAAGGACAGCCCCATGGTTGGCGGCATTTGGGGACAGATTGGAAAATGCCAGTTAGTAGAGCTCTTGGCCAGTGGAACCAGTTGGCAGTTGGGTGGTTTGAGAAGATGAATTTCAAGTCCCTTTCAGCCTTGAGATCCTGTGTTTCAGTGATGAGATATTTGAGAATGGCAAAGAGGCAAATAGAGAAAACTGTCCCCCTACATACGCATATACCTTAGGTGCCCAGATGGAAACAGCATTCTTCACAGTATTTAGGAAAACTGACAAAACAAAAATATTGTATAAATGCAGATTATAAATTATCCATGCTTGATTTCTCACATGTAAAATAAAAAGATCAGACAAAATTACTTCTAAAGTCTTCCATTCTGATATATATTCTAAGATTACCTTTAGATGACAGAATTAGTACAGAATAATATTGCCATAGATCTATTTGTAAACATTGGAAGTCATTTTAAAGAAGACTACAATTCTGCTGTTCAAAACAAAGTGTTGAATTCAACTTTGTTTTCTCTAAGCAGCCTACATAATTTACAGTTTAAGGAGAGAAAGAGCATGATCTTATTTATGAACATGGGATTATTTATTTTATTTAGTGACATCTGCAGAAAAGGGATTTTACATCTTCAAATTCCTATGTTGTTATATTTAATAAACACCATATTATTTCATTGGGCATCAGGAAATAAAGTTTTTTCTTAAATCATTCTTTGCAG
>TTN-205,,0,1226,3236291,3237516,GTAAGTCTGATTTTCTAAATATTTTGTAGTTTGTTGACAATATCACATTACAGCCAGCTGCAGGTAGCTTATAGTCAAAACCCTTAAATGGAGAAGTCTTTGGTTGTATATTTTTTGTTATTGTTCCTCTATGTCTAGTATTGAAACTCAGGATGGAAATTATGTTCACATTGCACTATTTTCCACTCACTTGATCAGTTTTCAGGAGATTGTCTACAGAACAGTTTAGGGCACATCTATGAACTTTCTAGAACATACATAAATGGATGATAGATATCATGCCAGTCCAGTTACCCACCGGGACAGTTGGTTTCTTCGTGCATAGCCTAAGCCCTCAGTCACTTAGATTGTAATGCACAAACTTTACATGCACACACACATGCACACACACACACACACACACACACATATACACATACATCAGCCATAAACACCCCGAATAAATAGCAAGGGAAAGTGAGGATATGCCAGACATCGGAGAAAGCAAATACTTCCTCAAAAAAAAAAATTCCTTCAATTCACGGTTGATAAACAGTGACCTAGAAGCATTTGCTGCTGTTGTGCCGTAGAGCTGTGTGAGGACAATCTCAGTGTCACTAAAATCCACATCTCTCCCGTATGTGAAATCAAACCTTTAAGTGTCAGGAGAGAGGCATTTATCTTGAATTCTTCCATGTCAAAGAGGGCGCCTGTGCTCATCCTCCTTGAACTCAAGCTCTTTGCTGATCTTAGAGCTACTTTCTTTAAAGGTCCAGTTGAGAACCTTGTACACTTAAAAGGCTGACCAGAGGCTGCTGACTGAATTTCCCTCTCCTTACTGTGAGTGAGACATTTTGAAAGCAGCAAGAACCCTACTTAGGATAATCAAAGGCATAGAAATCCCCATTGCCATTGCAATGCTGGTGACTGGCAAGTTCAGCTGGCCTATGGTTTTCCAGCCACTTGTCAGCAGCCACCCACCGGGTTCCCTAACACGTTGACATGTCTCAAGATGAGATATGTTCAGTTCTAGGACAATTTGCTAAGGCGCATGTGGGCAGAAAAGAAGCCCATTCCTCAGGAAAGCAGTCTATGTATTAAGCACAAGTGTAGGCCCCTGAAATGGAAATCTGACATTTTATCGTTCACCACTAAGCATCCTGTATTTTCCTGAGTGTTTCAAGGATGTCTTCCCATTGCTTTTGTATCTTTTGAAACTCAAATCTTTATTTTACTCTAAACATCAG
>TTN-205,,0,592,3237517,3238108,GTGATGACTTCCTGCCAATGTGAAAGTCACTCTTGCACCATTTCATTTGCAAATCACCTACATTTTCATCATGGATCTTAATCATCACTTCTTCACTTCCACCTCTTCTTATAATGCAAATAGAAAATTTCTTTTCCCACACAGCTACCTTTCACTGTCAATTCATTCCTAACTTTCAGACTTTCTTTGGCTTGTTACTAATATAATATAATAATTCACTTTAATATCTTCCTATTGAAGCAGATGTCCGTAAACAAGTCAATTCATAATACAAAAAATTATGTGCTATTTACAGTGCTACTGAAATGTCTCAGAGATTGCAGTTTTAAAAAATGTGAAAAGTACAAAATAGCACTCATTAGTCTTTTATTGCTAATCACATTTTTTTCTTTTAAACTGGACTTATTGTTTTGATATTTTTGCCAGTGAAACAGTATGGATGATCAAAGTAACTCAAATGATATATTTTAGTGCAATTAAAATTTCCTTGAATAGGAAGAAATTTTGCCTCCTTTCTTTTTGACTTACGTTTCTTTTATTAAAGATTTATGGAATTTAATGACTATTTTCTTACTTTCTTTTGTATGATCAG
>TTN-205,,0,480,3238109,3238588,GTGAATACAGATATTTGAGCTGTGAAAAGTTCATCTTTAAACTAATTTCTAGTAAACTATTAACTACAATATGGTATGAATTATTAATCTGTATTTGCCTTTTAAAATCCCTAACTAAAAACAAAATGGTAAATATGAGACTGATTATCATTAATTTTATCTGCACATTTGATTTTCATCCATCTGTAACATTTATAATTCATTTTATTCACCATTATTCTTTGCATGAAGATTAGCATTTTTTAGCTTAATTTTTAAAAAGTGACACAGGGACTCATCTAGAGGTTTTTTAATAGCTAACATTTCTAAGTTTTGTGATTCTCAGTCAGTATATGTAGACATTGCCGGTGAAAGTTTATTTCTCTTGTGTATTTAACCCTGAATAACCATCTTGCATCCCCATGAGGAAGGGGGAAGGGTCATACTATGTGTGTTTGAAGCCCTGTTCAACTTAAATCTTGATTTTACTGTAATAATCAG
>TTN-205,,0,3218,3238589,3241806,GTGACTATTGTTGTTCCAAGTGTGAAATCCCCTATTATAATACATTAATACCACATATCATGTGAAATTCCTTATTGTAATACATTAATATCAAGTCTCTGAATTTCTTATGTATGAGTCACTATTAACCAAATTTATTTTTTAGACAATTAAATAATTGGAAACTAAAAAAATTTATTATTGTTAATATTACTACATATCCCTTTCTCCACTTATCTCTTCACCATTATTGTCAACATTTTATTAACATCTGGGAATCTTCCAGAAGTTGATTAAAATTGCATGCAGGCTAATTTTAAGAGGCCCATGAACATTTTTTAAAAACACGGAAGATGTATAAGTAAATGATGACTCTTACTCACTGTCAAGAAGATGTGTGTTTTGAAGGGTCATAAATTCAGTATATTATGTTATGGAGTATGACTTATTTCAGTAAATTACCCATAATTTTCTTTGTATGAAACTTTATCTTTTTTCCCTCCTGTAAATATCAGAGGAGAAGATAAGCTGAAAAAATTATAATGCATGCTGTAGCAGCTCCCACTAAAGCTAAACAAGATGCATATTAAAATCTAGAGAAGGAAGTATCCAAACAGAACAATTACACATAAGCCATGAAAAGATTACCGTATCTATTTGTAGCTATGAAATATCCATGAATTAAACTGTTTCCCATGACTCTGTCATTTACTCCAAATGAGCCATTTACCTAATTGTATTCTTTATTGCTAATATACCACTTGAAAATTAGCAACTAAAGTTTTTCCATTTCATTAGCAGGATGGCCTGAATCCTATTTGTATTTCCCTCAGTGTCATTTTCTGACTCTACATCTTTTTTTTCTAAGATATGATTTAAGATAAACTTTTTAAACCTTTACTCAAATCTAACATTTAATGGCATATCAGCCTTTCAGAAGTCTCATAAATGACAGAAATTCCACTATGCAACATACTTCATGAGTGATTAACTTTTTACTTTTGTTTCCATTCAAATTTTGTCATGAATTGACTATCTTGTTTTTGTTAAAAATTAGCTAAGGATGGAAGCTGAGAAAATGTTTATACCTGAAGTAGTAGTTACCACTGCAAAATCTGCTGAACCAGCCACACCGCCAATGACTAGAGAAGGATTCACTATTAAACAAAAACAAATACATCTTTTTCGAGAAGAGATGAAAACTGATGCTATGGAGGTGAAAAGTATTGTTTCATCCCATTTCATCATCAACTCTCATAACTTTTCATCCGTCGTGAATTGTGCTTCTAGTGTTCCATCTAATTGTTTAACTGATCAATAAAACAATAGAGATGGTTAGATTCAGTCCATCCTCCAGTTGAACAGTGAGCATTTCTAGTAGTGAAAAGTCAGACCAAATAATACTCTTCTTTATGTCTCCTAAATTTATTCTCAGCATTTAACTCGTATGAATTGGAGTATTCTAGTCCAATTTGTCTTCCTGCTTCTCTAGGTTACAAACATGTGAGAGATATCAAAGTCCACTAAGAAATAAAAGCGGTTACCAGCATACTCATTTGTAGTCCACCAATAAGTGTGTGTATATAAATCTGATATACAATAATTCAAGGAAAAAACAGACAGATGCTTCCTCAATTTAAAATATTTTACCATGATTAAGATTTTTCCATATGTTTAAAATCAAGAACAAAATTTAAATATTTCAGTTGTGTGATATTTAGTCATATGACAGTTTCTTTGACAGTTTCTTTTATCATTGTTAAAATAAAATTAAGACTTAAGCTGACTACTTCATAGCAGACTGGCTAAAAGGTTCAAATGAGATATAGTGGAAATGTGATCACACTACAATCAAAATAATATTTATTTATTTAGTGTTATCTGTCGAAGATGTTAACATTTTAAAATGTCTATACAATTAAAGTCAGCTCATTGCCAATATAGTTTTTAAAAAAGAAAAAAATAAATGGACAAACTTAACTCACCTAAGCCTCATGTGTATTTTATGTTTTTTTCTGAGATGATGCAATCTAAAGTGAAGATGGTATTTGCAGTCCTTCGAGGCAGATGAAATTGTTTGTGTCTTCCTAAAAGGAAGCCCTGGATAAAGCCCATGATCACTAAAGACCCAATTCCATCTCAGAAAAATCTCATTTATATCTTGAATGGTTCAGAGAATAATTTTTAAAGATATGCAGGTAGCATAGTTGAAGAATGTTTCTGATGCATTCTAGATTCTATTCACAGGTATAGAAAACTGAATATTAATAAAATTTTCCAATCTTACTTTTAAAATGCACTTTTAAAATGTACTTTTAAAATGAACATGGCTATGTGATTTTTGAGGTATGCTGTTTCCAAGTATCACATAGAATCATAATATCTAAGCCACATCAGCTAGTTTGCCTTCTTTAAAAGAGAACCTCCTCTGCAAATTGTATTTCCATTAATGTTCATCAGACTCAGAAACGAGAAAATAATATTTGTTTCATTCTTTGCTTTAACTCTCCATAATAATGAAAGTAAATTAAACTTCAATGTGAAAGGTTGTTCTCTTGAATCCAAACATGATAACACTTTCATTTTAATCACAATATTTTTATTTGCACGGGGTTCTCTTTGTCATCTGTGTGTTTTAAGAAAGGTATTTTCTGATAGATTAAACAATCTTACCCTTAGGGAATCATAAGTAAATTCATATGCTCACTCTGTGTTTGTGAGCTTTCATGTTATGTCCGATTTGCATGCAACCATATAACTCTGTAGTCACTGATTTTTCTGGACAGGATGATGACGGTATTTGAGTGCACTTATATCATCACTGTCACTGCATTAATACCAGACTAAATGGTCAACAAGATAATAAAAATAATCAGTGAAAAGAACCAGCTCCAAAATTCTGATTTTCCAATTGCTGATTGATTGTCTGCCTGGAAAAATTCTAGAAAATTTCAAAATCTTCTTGTGATTTTATGTTCATATTGTGATTGTCCTATGTTGTGTATATGTGATTTAATGTCTAGTATAATTAAGTAGGTGTACAGAGAGTATATCTAAATAGATGTCTGTACAATATAATAATCAATGAAATAGTCCCTAAAAGTGTTTCTGAGATACATTTCTAGACACGTTAACACTGCTGTATAATGTGGACGCCATCTGCCTGTCCTGATGCCCAGGAGATATTCCAGCCTGATCTCGATATTCCTATGTATTAATTCTGGAAACCTTGTCTCCAG
>TTN-205,,0,105,3241807,3241911,GTGAGTCTATACCTGCTGATTTTTCACCTTGTTCATGGTAAAGCAAGCCTCACTGCTGTGGTCATCTGGTGATCAATGGTATCACTGAGTTTCATTTCAATGCAG
>TTN-205,,0,1268,3241912,3243179,GTAAGAAGTTACAGAGCATGATACAGAAATGTTTAAAGGAAATAAGTATCTAACCTGTGAAACAGAGCATCTCTGGGGTAGGCCAATGGAGGATTCTTTTTTGGTGATGTGTGTGTGCGTGTGTTTGCATTCACAGTGGGCCCAGACACCCTAAAGATTTGGTTTCTGAAACTCGCCCAGGGGAGTGAGCCTAGAGTCACAAGTGGTTATCTTATACCTCTGAGGAGAGACAAATCCACACAGGCTTCTCTCTAGTTCACATTTCAGGGACAGCTCAAACTCAATTGTTTTGATTACTATTGTTCTAATGATTTTGTGAAAGGTAGTGTGTTACACAGCATAGTTTTACTTATGCTGTGAGACATTTCAGAGTAACTTAACTGTGAATGTGTTTCAATAATAAAGACAGACATTGAGAAATCATATATTTATATACTCAATATAGCAAGATGGAGAGGTGGTACTGTATGGTGGTCGGGTTGGATTGTGGAATCAAATAGCTCTGGATTAGTGCCCTATCTTCTCCCTTATAATCTCTGTCATCAGGAGAAAGTAAGCATACATGTAAAATGCAAGTAAAAAGGACATAAAAACCTGCAGTTGTCAGCATGTAATAAATCCTTGATATTAGTCACTATTGTTATTATACACATCCAAGAAATAGAACCCAAACCTTCTATGCCTTCAAAGAACTGTAAGTTACATATAATGCCTATATTTGATTTAGTCCCAAATTACAAAACAAATAACCATAGACCACAACAGAATAAAAGCAGTAAGGAAACCTTTAAAATATTTTTTCTGAATGTCTTCATGTTTACCTTTCACATAGATTTGTGGCTAAAACCCAAATGTACTATTGCAAAGTAGTTCTTAGGCATTTACCAACAATTTCAATAATTTCTTAATTTTGAATCTCCCACTGTGGTATTTTCAAAAGTGGCATTCATCGGAATGGTTAAGTGAAAATTCGTGACTAAGCTTTAGAAGATCCTGTCCTTTTATGATAAAAGCTGTAAAATAAGGAGTTCTGAATACAACTCTTTAAAAAAGATATTTTAAAATTTGTTTTACAAACTAACAGGCATGACAAGGAGCTTTATAATTGGCTTATCTCTAAATGACTTTTCATTAACTGTGTGATAATGAGTGCTAATGAGAACATTAAAGAACAGACCTTATAGAAAATAGGCTCAGACTCAGTCCAAGAGGGCTAGCCATCGGAGGATGGTTAAATGACTTTATTTTCTGACTCTGTTTCCATGTAG
>TTN-205,,0,284,3243180,3243463,GTTGGTCACTGGTTACCCGCTGTTACATGGTCCACTCCCATTGAGCAGGGCCAGGTGGTTGGCTAGTTTGTACTGAAAAGTAGCCAGTGGAGTCTTGCCTTTCTCCTTTGCCATACTAAGACTTGATTTTTATGGAGCATAGTATGGGTCAGAGATCATTTTCTCAAATTATTTTTATAATTATTTTTATATTTTTATAATTATATAATGTTGCATGAGCTAAGAGTTTATGAGATTTCCCTTAATTTCATGAGCATTTTGTAATATAATTTGTAAAAATCTAG
>TTN-205,,0,655,3243464,3244118,GTGAGTAAAGAAGTTGATAATGCTGGACCCTATTCATATCTCCTCAAATCATTTTAATACACGTTTGCAAAGATCAGTTTCTCAAATTAATACAAAAATGACATTAGTGAGCTTACAGATGCTCATTTTAAGACCGTATTTGGTCTGGAAGACCATATTTGACCATATTTGGCAAGGAAGAAGGGAATTCTATGTGGTACATCATTCATGGATTCAAAAGATTTAATGAGCTTCTAATATGCAGAAGGCATTATTGCAGGAGCTGTGCAGACATAAAGACCAATCCATCCCTCTTTGAAATATTTTCTTTGCCATCAGAGAAAATGTACACAAACAAGCATAATAAAATATATAAGGTGATAAACATCACAACAGAAGGAGAATCCATGGGAGGCATAGATTCATTCCAGTTGGTGATACCATGGCAAAGCTTTGTTGAATAGGTAGCATTTGCTATTGAGCCTTACAGCTCTTTACTAATATATTAGTATATTATATAAATATTAGTTTCTCTACTACTATTTCTGGAGTCCTGATTAAAAGGCCATTTTGTGGCAGTTGAAATGCATAAGTTCAAACTCTACATTTGTTACAAAACAGAAGTGATTAATGAATATGCACACGTATCATTATTTATTTTTTCTCCTCTCTTCAG
>TTN-205,,0,203,3244119,3244321,GTTAGTGGCCACCCTCCCACAGTCCTAATGCACATGCCATCACTTTCATCTGACACTCTTTTCCACAATATGGTTTCTGTGCACCTTGAAATGATGTCCCTTTTTGGAACTTGGGGGGAGATTATATGGTCAATTTAACTGTCAGTGCTAAGCAGGGGTCACTAAACATCTCATCTCAATGAGAAACTTTTGTCTTCTTTTAG
>TTN-205,,0,111,3244322,3244432,GTAAAATATTTTGCTAATTAGTAGCTGTTCTAGTACCATTTTGACTTTCAGCCCCACCAGTATTGGCAAATTGCAACCCGGAAGCTAATATGAGGGGAATTCTCTTTCCAG
>TTN-205,,0,948,3244433,3245380,GTATTTTGATGGCTGAATATAGAGTTCTCTGTGACTTGTATAATACGTGCATGAAGCCTAGAGTAGAATTTACTCACCCCACCGACCCTGAGCATAGGCTCTTTCATTGTGGAGCCTTCTTAGTTTGTTTTGAGGTATTTTTACATTTTTTTTGTGCAAAGTCTTCCTAAGAAATAAAGCTATGTGACAAAAGTGGATGGAAGATATATTTCTTTACATTATAGTTTAATTCATTGAGTTTGTGAAAGTAGAGAAAATATGGATTTTCACACAAACACACCCACACACACACACACACACACACACTTCCAGAAAAGATTTGAGACAATTTTCAATAAAAACATGTAATAACTAAGTGACTAAAAGATAGAAGAATAGCCATGTAATGAAGAAGAAAGCTAGTTATGCACAAAAATCTATGCTAGTAATTTTTCTTCAATTCAATATAAAATTTAGCTCTGAATATTTTGCAATTTAAGATAAAAAGAGCAACCTGGTAATCTAAAAATGTAGGTGCCGTACCTTCATAATAATAAATATAATGTACCAGAGAGTTAATACTGAAATATTTGAAGGAATTTATTGTTTTAATTATTCATTTGATCTCTGAATGAAATAATGAGAAAAATAACGAACAAAGAGAAAATACCTGTTGTTTAAGTGACCTGATCATTTGCTAACATAAACACTGAAAACCACTTAATTTCATGACTGATTCTAGCAATAAATATTCTTTAAAATGAATATTTTAACTTATTTGGCCCTAATTACTCATGTTCTTGCATTTTTCTCAATTTTCAGCAATCTTATAATCTATTGTGGAGCTTAGTCATATGTTTAGGGTCATTGAATTTTATACCACAGATCCACTCACAGATAAGTCCAATTATTTTACCCACAGAAGAGTTGTTGATAACTGATTTTTAAATTTTGTACATTTACATAAAG
>TTN-205,,0,915,3245381,3246295,GTAAGTGCAACTCCAGTTTCTATGTGCATGATAAGAACTGAAATACAAGGAGATAGCAGTGCTGTCCGTTTGCTGAAAAACCTGTTGCCACTTACTGGTTCTGATACTTTGCCCCAGTGTCTTTGCCTCAGTTGTATGGAAAATGTTTTAGACCACATGGCCTCAAAAACTATACTGTCATTAAACTTCTGAGGTTCTAGCAATAGTTTCTTTTTGTTGTATTTGTTTCTAGGCATATCATGCCTCTGAAAATGCAGAGATTCTAAATCCGGTTGCCTTCCAGGCCCAGGCAGGTAACAGTGAGCTCAATGAAAACAGTAGCAAACTGGAGAGTAGGTGCCCTGCCTCAAAGAGACAGTAGCTGTGTTGTTGCCAGGCATGCACCAGGCTGTTACCAGGCTCAGTGTTGCTAGAGCTCCTGATATCTTAAAGAAAACCTGGAAGTCAGGATTTTCAATGTTTATAACTTGAAAACAAATGTAACAGCTTTCATGCTAGACTGTTCACATTTACAGTGAACTGGCTCACACTCTGTTTCACTTGACCTACACAGTATCCCTTAGAGGAAATTACAATATTATCTTCATTTAGCAGATAAAGCACTCAATATTCAGGAAGGTAAATGAATTGTTAAAAGACACACAGCAAATTAGGAAGTCCTCCGTGGTAGATCCCCCCAAAACTGACTGCTAATATAAAATTCTTTCTACAATTGTAATGGCTGGTTGGATTTGTTAGTGTTAGTTTGGTTTCCAAATTCCATCTAGAAAATATTGAGCACTTCAATAGTAGATATTTGGAAAATTTGGTTTTTGGTTATCAACTTTCCCCAGTGTAGAGTTTACCTGAATGCATAGTGGTATGACTGTTTTCTAATAAGAGCATTAAAAATTAACTGATGTTCTTAACTCTTAG
>TTN-205,,0,537,3246296,3246832,GTGAGTATAAAAGTAATGACCAACCAAACAATTTCATAAATTATACTTTCCTTTTTTTATTTGATATTTTCATTTTCAAGTGATGAGCTCGGGGTTAGACAGCTATTAGAAGGTCCAAGTTCACTGTTGCTAAGTTTCCTTAATCTTCATGGTATGTTGCACCTGTGAGTTTAGAAATAGAGATTACATATAGGCCATAAATGTGACTTTAAAAATAGGGCTTATAATATATTAAGGAAAACACCAATATTAGCACAGCTGAGTTCATTCATGCCAAGATCTCTTCATCTGTGTGATAAGCTAATGTAACCTCTAACCCAAATCTAACTCCTGCTTTTGGAATACCTTTCTACCCAAGATGCCACAACATTCACTGGGAAAGATGACCATAATGCAGATTAAAACAAACAAACCAAAAAGTCCTCTAGATTCTTCTCCCAGCTAAAAACTTCAACAGTCTAGCTCAGATACATCTCCTTAAATAATTTATATCAGTAAGGATATGTATTTTTAACAGACCATAATCTTTTTGCATAG
>TTN-205,,0,110,3246833,3246942,GTAAAATATAAACATTTATCATAGCTCCTTGCCACAGTAAAGATACAAATTGGTTAAAATATAACTATTTGATGTAAATTTTATTCATACATGCATGGTATTCTTTGCAG
>TTN-205,,0,898,3246943,3247840,GTAAGACTTGTAATAATTTGGGTTATTTAGTATGTAAATTGTTTTCAAAACATCAAATAGTAGCAAATTGCTATTGTGTAAGAAGAAAATCGAGGGCTAAAATGGCACAGAAACTTACCATTGGCAACACCAACAATTGCCAGAAGTTTTTATTTCTTGCCCCTGTGTAAGATGAGCAAAGAATTTTCATCAGTGTAACATACTGTTTATTTTCCTAGTGCTATAGCTAATATCACAATAGCTCTTATTTGACACCTGATTTTTACATATGTAAATTTATACAACAGCCCTGCAATAAAAAGATGACTATTATTGGTTTGGAAATAGGAACACTGAGGCCCTGGGAATCTATGAAAATTGTCTTAATTCATCCAGCCTGTAAGCGGTGGTGCCAGCATTCAAACTCCAAGTCAGTCTGGCTGCAATGTGTAGATGGAGTCTTGTTTTGCTTTGTTTTGTTTCCAAATTCATTTCTATGTTTTCCTCCTCTGAGATAAAGAATGTGTATTTTTTATTTTTCCATAAATGTATTCATTGGTTTACTTATCCAACCAACATTTATTAGGATGTTTTAGTAGTTAAATCAAAAAAGTCTAGTGACTGATTAAATCCAAGTGGTAAGGAAAAGAGAGTATTGAGGATTATTCCAAGATTTTTGAGCCTGGGTACCTGGATATACTGAATGACTACCAGCTAAAATTGAGAATATAGGAAAAACATAGTTGTGGGGGCAACAATAATATATTCTATTTTAGATCTGAATGAGTTTGAGGTGCCTTCTAATACGTGCAAGAAGTAAATTCTAAAATAACATGAATAATGAATAAGACAAAATGAAGTTTGTTTTGCTGAGTTTTCTTTATGCCTCACGAAAGTATTGTGTGTCTTTGTTTTGCAG
>TTN-205,,0,119,3247841,3247959,GTAAGCGTGATAAGTTTTTGCTCATGAATCATAAAAACACAAAAACAAGCTTATGTATGCATCTAACAATTTTTAAAAACTATTTTAAAATCTACTTTCTTTTAAACATATTTTCACAG
>TTN-205,,0,102,3247960,3248061,GTAAAATGAGATAAAATAAAAATAAATGAATTTTCTTATCACTTGGGTTATAAACAGGTATTTCAGCCTTACTCCCTCTAAATCATGACCTTTCTCTTTCAG
>TTN-205,,0,99,3248062,3248160,GTAAGTATGGAAATAATAAAGCTAAGCTCATTATACAAATCCAATAACCAGGGAAGCTATACCACTATATTGATTATTCCCTCCCCCAACTTTTTATAG
>TTN-205,,0,153,3248161,3248313,GTAATTTGCATGTCTTTCCTTTGATGGACCTGTCTTTGTATTCAAGAATATCCATGAGTGTGTTTACTTTTATTTTCTTTCCCCATTCCTCAGGTTGAGAATTTAATTTAATATAATGTGCTCTCCCCTTTTTCCCCCACCTTTTTCTTGTAG
>TTN-205,,0,447,3248314,3248760,GTATTCAACAACGAAGGATTTCATTGTTTACCTAAGCTCTAAAGTCACCCTTAGCATGTGGTAAAATTAGCTATGCAATTTTTCTTTCATGAAACAATTATTTGGAAATTGACTATAAGTTTCATAGCCAGAATCATAAATTTATGTTCGTAATTAAGAATGTTAACAATTTGACCATTTGGATTTTTTAAAGTAGTATTATCTTGATTTTTAGCTTTTAAGTTTTTTATTGAAGCATAATTCTTTACTTTCAAAAATATTTAAAAATTAAAATAAAATAACTGCTTCTTATTGAAAATTTATCTCTCAGCCCATCAGCGGGTAGATATTAAGAATACACCTGATAGTATGGGGGAGATAAAAGACATACAAGACATCATCTCTATCCTAAGTCTAGATGCATACCTCTCCAAAAAAATTGATTTATCTTTCTGTTATACACTTCAG
>TTN-205,,0,96,3248761,3248856,GTAAGTCCTCCCATTCCTGTCAGCCTGCAGTGAGCATCATTATGGTTTATTGATAAAAAATGATCATAACATTCTTTTTCTCCCCATATTTCACAG
>TTN-205,,0,112,3248857,3248968,GTGAGTCCTAATTATAAAATTTTATGTTTACACTATTAAGCAACATAAAGAACTTCAAGGAGCAGACAATTTCAACAAAATTCATTCATCTTGTGTGTGTATGATTTTGCAG
>TTN-205,,0,92,3248969,3249060,GTAAGGATTATTCTACCTATCTAATAATTACTTTAAGCATTCTACTTTCCCAGTGTAACAATAACCAAGAGATTATTTTATTTTTTCCCCAG
>TTN-205,,0,1637,3249061,3250697,GTTGGTATATTTATTAACCTAAATTCTTACGAGGAGTGATTGTTATTTTAAGAAATTATTATTCATTTCCCCCAAAATTCCTTTCAGTTTCCCACTTCCATGCCTCTGCTTATGCTGTTCCCAAAGCCAATAGTACTTGCAACACCATTCCCACCAGCCTAAATTACAAATGTTCTTCTAGGCCTACCTCAAACGTCACCTTCTCCATTAAACCTTCCTTAATCTCTCCATTTGTATATGATCTCTTCCTCATCCAACCCCAGGATCACTTTATATGTGCCTCTTTCCTAGTGTTTATTATGCACTTGTCTTATTCCCCATTTCCTCTTTCAATATCAGTGTATAAACTCCTGAAATCTGGAATTCTATTTGTATATTCCAATATATTGCAAATGACAGATAATCAATTGGTGTTTGCTGTATTGAGCTTTATTTAAACTTCCTTACTCTAAAGAATTATTTCCTTTTTTAGCCATTCTTGCTTCTTTAGCCTTTGTGCCTTTTATTTTCTTCCTACTTTTTAATGAAATCAATAAATATTTTCAAAATACAGCTTAATGTAACTGTATTTCTTATGATATCATGTAGAAATAAGACCATCATTCAGTAGAATTTCTTAGCTTTACAATGAAGAATAAAAAATGTAAATCAATTGCCAGAAAAAACTAGAAGTCATCATTAATTTGTTTGGTTCATTACAGTTTAAATTTTGAGGAGTTGAGATGTTACATTCAGATCGTGTTGTCCATTACATCTAGTATTGAAGCAAGTCATATGGTAATGATTTGTCTTATTTGGTATGAAAGTTTCATGGTTTATACTTACTTACGTTATAAGATTTCTTCAGAGATCGGACCATGAAAAGACTTGTAAAACAAAATTTCAGATTCAGCATTTTTATACATTTAATATAAATTACATGTTTTAAATGTGTGGAAACAGGAATAAACTATGAACTCCTCTGTGATTTCACCCAGTGTTTTTAAAGTACCTACCATTGGTCAGACACTTGTAGAAACTCAGGACACAAAACTAAATAAGAAATGATTTTTTTCTTGAGAAATTCATAATTTAGAGAGGACAGATACATAAGCAACTAGCTTGTTAAAGCAGTAATTATTTCTGCTAATGGATGATAAGAGTGGAGGCAATGGGGTGAAACTTCATAGAATGGGCGACATTTGCCAACACAGTGATTTTTAATATATAGAAATCCTCAATGTAGTAGAAACATTGATGACTCGTACATTTTGTTTAGCAAATTTTTATGTAGTCAAAATATCAGATTCCCAGGAAATAATCATTAAAAGACCAAGTAAAATGCTTTTGAAGAAGAAGGAATTGGGTTAGAGACTATCCTGGTGGTATACTGTTCTAAGAATTTCCTATTAATTCAACAGTTATTTTTTCTTCACAAAACTTTTCTGATTCCAGTATTTCTCCTAATTATCAGTTATGCATACTTAGAATAAGGGATTTCTTTGGTACCTTCTCAATATGGGTAAAAACAATCATAGACATTTCATGATTTCAAAATCATGTTCTTAAATTTGATATTTTATATTTACTTCTGCAAAGATTTTCCCATTGTGTGAATATGTTTAAAGGACTCATACTGTACATCTCTTGTTCCAAAG
>TTN-205,,0,535,3250698,3251232,GCAAGTAACATAGGATTTGTCCTTTTCAAATCATATTACAATCTTGATCGTTATCGTTTTAAAAGACAAACGATATGGCCATTTTGGATACCATAAATTTTCATTTCATAAAGTCATTCTAGATCCTCTAAACCTTCCTGAGACACATTCCACAAGGTACAAAATTGCTTATCAAATGCGTTTATGCAAAAAAGCCATTTCTTAGGTTAAAGCTCTGTGAAACAGCTAAATCAGACACTGATTCTCCATTCGTCTTTCACCCTTCTCCAATCAGTCTATTATGCTGCTAATACATAGCTATGCAAACTTCATACTACTAAAGCATAGAAAAATCATTTCACGATGTACATGTCCAGTTGGATCCCAGGTTCCCCTAAATAATCTCAGGTGTTTTTTAAAACAGAGGTGCTGCATAACTGTAAAATGTTTGGTAGCCATTCTTTTGCAGGGTGAGTAAGCAATGATCTTGTTCAGGACTTCTTTTCCTTGATGATGTCATCTATATTTTCTAACCCAATCATAAATTTGTCTTTAG
>TTN-205,,0,91,3251233,3251323,GTAAGTTGATTTAGAAACACTTTTCAAGCAGTCAGCCCATGGTTACCATTAAGTTAACCCTATCACTGAATTGCTCCAATTTTCCTCTTAG
>TTN-205,,0,120,3251324,3251443,GTAAGTATCAGGCAGCCCCCTACAGCCCTTTCCTTAATGAACCCCATGTATCTATTTGTTTGGTTTCATCTACTTTTTAAACAAATTGTATTAACTGAAGTGCTCTTTGATTTTACCAAG
>TTN-205,,0,745,3251444,3252188,GTAAGTTAAAAAATATATATATATATATACACATATATATAAAATATCAAATATTCAGTAGATTCATTGATATTCTATATCCTACACTTTGCTGACCACTCAAAAATCCTTGATTGGGTGGGCAGGGTGGCTCAAGCCTGTAATCCCAGCACTTTGGGAGGCCAAGGCAGGAGAATCACTTGAGATCAAGATTTTGAGACCAGGCTGGGAAATACAATGAGATCCTGCCTCTAGCAAAGACAAAAGGAAAAAAAAAAATTAGCTGGGCATGGTGGCACACACTTGTAGTCCCAGCTACTCAGGAGGCTGAGGTGGGAAGATCGCTTGGGCCCAGAAGGCCAAGGCTGCAGTGAGCCACAATCACGGCACTGCACTGCAGCCTGGGCGACAAAGTGAGAACCTGCCTCAAAAAATAAAGAAAAAAAATTGTTAATTGAAACATCTAGTATGTGGTTACACTGAGTAAAGCACTAGTATCTCCACCTGGATAAAATGTTCCAGTTAGAGTAGCATTGAAAGGCTACCTGGAAAGATGCCTCAGTGTCTATCACTTGATCTTTCTGTTCCTCTGTGAGTTGGCACTGTCCTGTATAGTACATGGAAGGTATCAAAGCTTATATCTCTAAACTGTAATCTCCTCAACAGACGCACTAAAAACATTCCAAATTTTTATTCTGCACCTGTTATAACCCACATCATATTTACGTAAAGTCTCCTTGGGTGTTTTTTCTTTTCTCCTTTGCAG
>TTN-205,,0,517,3252189,3252705,GTATGGTTTCATACATATTAGATCCATAGAAAAAATGTCATACATGCTTTATAAAATTTAGTGTATCAATTAATGAATGGATAAATAAAATGTGGGATAGCCATACGATGGGATATCATTCAGCAATAAAAAGGAAGCACTACGATATGCTACAACATGGATGAACCTTTAAAACTTTATGCTAAGTGAAAGAAGCCAGAGACCATACAAAGACCACATATTGTATGATTCCATTTATATGAAATGTCCAAGATACACAAATCTATAGAGATGTAGATTGGTGGTTGCTTAGGTCTACAGGGGAGACAATAGAAAAGTCCTTGGGGTGATGGCTAAGGGTTACATGATTTCTTCTTGGGGAATGAGAATGTTCTAAAATTATGGTGATGGCTACACAATGATGAATACATGGAAATTCATTGAATTGTATACTTTAAATTGGTGGATTGTACAGTATGTGAATTATATCTCAATAAAGCTGTTAAAAATGTTAATTTTTCTACATGCTATTTTCCAG
>TTN-205,,0,89,3252706,3252794,GTCAGTTGTTTTGTCTTGCTACATTCCAGTAATTCCCAGTTTCCTCTGAATCACCATACGGTAAACTCGAATTTCCATTTCATCCATAG
>TTN-205,,0,1146,3252795,3253940,GTATTGTCTACATACTAAATGTTTTGAAAAATCATCAGTAGTCCATAATCTATCATTTTATATTTTAATGTTTCCCTTTTACATTTTCTAACCACCATCCTTTAAAGAATTAAATCAGCTCATTCTTACTTGGCTTAGACTCTCTTATGCTGACCTCAATTTAGTCACAGTTTCCACTCAGGGAATAAGGGTGTCCCTAGCAGCTGTCTAAATACGTTAATTAAAGCAGCTGTAGAAATTTCACTGTCTAATAAATGGCTGCTTGCCAAGCAGCACCAACCAGAAAAGAATTAAAATGTAAATCGTGAGGTTCACACATCAATTAGAATTAAGGAAATTTAGAACAAGGTGATATTTTCTCAGAAGGTTTCTATCTGTGGAGAGGCAAGTGTCAAGGAACTTAGTGGCTAGAAATACTTTCTGTGAAGTCTAAGAGAAAGCCCTGTCCAAGCCGTGCTGGGTTCCTGGCAAGGATGCTGGGCACTCTTGCTGTCGGCTGCATTTACAGAGCTTGTCCTCATAAGTGTCCACCATCCCAAATGATATAATGGAGGAAACATGTCTAGAGAAATACCAGTTGAGTTCAGCTTTATCATATTGCTCATCCAAAGAAAACCAGGCTTTACAGACTGTGGACTATAATGAAAAAGGCTTCAATGAGGACTCAGATAACCTGGAGATGTCTTCCATCATTTATTTGCCAATTCTGAACCTCAGTGTTCTCACTCTTAAAATGAGGATAATAATTCCTACCTAGCCCACAAAGTTATTATTCATATAAAATGAAATCAAATTAAGTAATAACTTTTTAGACAATAAAAAGCCCCCAAAGGTAAAGCATCATTATATCCCTTATTAGTAAATAAGAAGCAAACATTTAAGGATGAAATAATTGTCTCTTTGGGGCAGCTCCTTTCCTCCATGCAGCTGTAAACACAATTCTCTACAAGAGAAGTTTATGTACCATTTGTCCAATACTAGGCAGGAAAAATTAGAGAGTGCTATAATCAGCCAACTTATTACATTATAATATATTGGTTTCACATGCCATTCATTGACCAGTTTTAGAAATTGATTAACTGGGAGGAAACCAGAGCTTCAAGTTTTTGTTGTTGTTGTTGTTTTTTTATGTTGTTCCATCAACAG
>TTN-205,,0,1569,3253941,3255509,GTATGTAGGGACAGATTTCAGCATATTTTGTGGATCCATCAGAAATAATCCTCCTGTTTAAGTCACTAAATTCTTGTAACTTGAAGGAAATTTCTAAAGAACCTATGGTATTCATGTGGTTCCAGCTACATTTTTTTTCACATTATATCTATGGAAAAGGGAGGGCAGCTGTTAAAAGACCTATTGAGAAGTTATTTTCAGAAAGCACCTGATGGCCAGATCCTCATCTGGTTGCTCAAAACTATTGAACACCCATTGGGTGTCCATTTTCATATACCCCAGATGAGCTTCTAGATTCGCTGTTAAACTATTTTAGTTCTCTGCCCTCTGCCTGAACTGCTCAAGTCCTAGCAGCACTACCAAGTGAAAGGGGTGTTTCCAGCCTCTGATATGGAGTGCCTGGGAGAACTCAAAAGTCCTCTTTGAGACCCTGGAAGGCCTAGAGAGCCTCAGGCAATGTGGAACTCGATCCTCTCTACCCCAAGCTCTAAGAACAGGGGCTCTTACTTTGGACAGGGAATTCCACATGCTACCAAGCACTCCTGAGGAGCCTCTGAGCAGTCCCCAGGGAAGTGCTGTTAAACCTCTGCTCTCCTCATTAGAAATCTTAAGGCTGAATCTCAAGCTGACCTTGTTTTGAGTCTAACCTAGATGCAAGAGAAAAATGGAACCTCCCTTCCTATTCTCATCCTAGGCCATATCTCTTTGAATAAAATACCCCTGAGGCAGATGCAGGAACTCCAGGGGTAATCTCAAGATTCACAAAGATGAACCATATCGCCAGCATTCCCTAGGTTCCTAGAAGACCAAATGGTCATGGCATCCAGTTCTTATTATCTCTGTATTAGTAGTGGAGAAACTGAGGCACAGAAAAGTAAAGATCTTTTCTATGATAGTGTCAGAAACCAGCCTCACAGAAGTCATTTCTTCTAATTTCTGGGTTCCATGAACTAACCAGGTCCCCTCACTCATCACAGCACTGAGAATATGCTTTAGTTAGCAAAACAGGAAAGCTGAATTTGTTAAGTCTACCTAATGGCATTTAACTAGATCTGAAATAGTGTTAATTCAGTCATTCATTCAATACTTACTGATTGCATTTTACTGGCACTGGTACATAACAAAATGACTATGACATAAACACAAATACTTGCAAAACAAACAAACTGGAATGATATGAGCCTCTTCACCACATGATTTGTCCAAATGAATTTTAAAAATAGGTAGCACACGGAAGTTATTGTATAATTCATTCAGGTGTCCATCGCTAAGCCCCCACCACAAACAGAAACTGGGATAATCAGGTTAACTCGGCACTCTCAGCATGCCCCCCAAATATCAAAAATATCTTTCTGAAGCTATTCCCTCTGCATGTGGACAAATTCCAAGTGCTTTCTTCATTCTTAGCACAAAGAATGTTCTAATATTCTGAGGCAAGTAAAAATACCACAATTCCAAAATTTTGTCTCTGGATGTATAACTAGCCAGCAACAAATTAATGTAGAGTTTTGCATGCTCTCTTGTGTTTTTACACTTTTTCATGGGCTATTTGTCAACATTTACTCCTAG
>TTN-205,,0,224,3255510,3255733,GTAGGAATGCCTCGCTACTTCCAGCTGAAAATAAAACCTAAGAAGCAGGCTTTTGTCCTTTCCCAGTGCATTTAAAAATACAATTTGGAGCTCATAAAAGTAGATTGCTACCCAACTTTGAAAGCACTCTGCAGTGAAATAAATTAAGATAAACCTACATGCTCCCTTCTGTGAGGTCTCTATGGTGACTTAATCATGACAAATCTTGTGGTTTCTTTCTTTAG
>TTN-205,,0,5004,3255734,3260737,GTAGGTTTAAGAACAAAAGGTGTCATTGCCAATACTTACAAATAATTACATGGGAAAAACATTCTGTCAGCTTCTCCTCCATCACAAACATCTCTCATGCATAATTTGAAGCTTAATGGAAATCTAACAGAAAACTTATTTCAATTATTAAATTAAGAATTAGATAAGTGTTTTTCACTATTTTGTGCCCTTAATAATGGTTGTTTATGTTATGTTATGTGTTCTTTATCACAATAAAAAAATTAGTGTTTTTCACTAATATTAAAAAAGGTCATGTTCCCTTTATGATTGTAGCTGCACTTTAATTTCTTCATTGATAAAATACAATGACAAAACTAAAATTATTAGATTATAATAGCATCTACATATAATTCAAAAGAATAATACATTTATATAAGACATTATTCAGTCTATGGACAATGCTTGTGTGAAAGGTATCCTTTGGAAGACAATATCCTATAGTGGTCAAAAGTCGGGGCTTCATTGTCAAAGATGCTGAATTTGAATCTTGCCTTCAATATATATCATGTCTCTCGTTCTCCTTCTGTCATGAATACATTGAGTATATGATTGCATTCAATCCTAGAAAATATATTTTATGAGGCTAGGAATTCCGTTTTAGTGCCTAGAATTTGGCATCTGAAAAATAGTACCTGCTAGAAGGTAAGCTCTATGAAAACAAGAGTGGATGGTTGCCCCAGAATATCACCTGATACATAGTAGATACTCCATAAGTAATTGTTGACTGGACTAATTAATGATGGTTAAATGACTGTTACCAAACACTTAAGATTATTATCAAGATTAAGTTAGGTAACTCAAGTCAGCACATAGCACAGTGCTCATCATACAGTAATCAATCAGAGTTAGCTGCTACCATTTTTAATTGGGGCATGCTTCTCAAGTACCACCAGCCAATTTCCTCATCCCAGGAATCTGATCTTGGTAGAATGAGACAATATATGTGGAACCACTTCAAGTCATAACTGATTGTCTATAATCACAATTATTTGAGAGTTTCCCAGCCAAAGGGAAACTCTCAAAGCTTGGGCATCTCCCAGCCCTCTTATTAGGCTGATGCAAAAGTAATTGCAAAGTTGTATTGTTTTGTTTATTATGCTTCTCCCATTAGTTTATAATCCAATCTCTACCTTGTCAAGATTTATTTTTCTCAACAGGTTAGTACTTCAGTTGGTCTTCTGACCCAATTATTTCCTCCTCAGGAATGGAGATGGTGATCTAGAAATCTAATAGACCTATTTGATTTTATGAGCATAATTAAAAGATATAATGTATGTAAAGCACCTATAGGCATGGCTGCCAGGTAACTGGGGCTCAATACATTCATTTTATTATAGCCATAGAGAGGAATTATATAAACATCAATGTTTAGTATTGTATGGCCAGTATGGACAAATACCATAGACTGTATATTTGAGGGATAGTGTTCAAGAAATGCTAAATATTAATAAATGAGGACTGATTTGATAATATCCTACTAACACAATAATACAAAATATATTTTAAAAGCAAGTTCATTAAAGCTACACTAAATAATTTATCCATTTATTTAATTTTTAGAGGAATTTTTTAATATAAACATATATGTACATCATTCAAAGTAGTAATATTTGTCTTAACTATATTGGTATAGTGCTTTTAAGTCTATAACATATTAACATATGGTAGTATTGCCTTTAAAGTGTTGTAGAAATACACCTGAAGCACTCTACAAGACACCAATTGGGGTAGAAAGAGAAAAATTTCACTATCTTTTCTGCATAACCAATGTCTTTAAAAAGGTTTGAATAGGCTTTGTAAACTGAGAAGATCATTAACTTCCTATGTGTGGTAATATCTGTACACATATAGTGGTTTTAGCATCCTCTTATAAATTTGTTTTCTATATGAAAGAAATTAAATTCATTAAATAGAATGACCCTTCAAAAACTTGCCAACTCACATAGTTTCATACCACTGGGACTAAAAATATTTACAGAACTTCCTCTGGCCAGGTATTGCCTTAAGTAAGTGTAGCCCTGCTTTCCACAAATTGGAAAGAAATTGGGAGTCTTCAGAAGCTCCCATGTTCTTGGGGGTTGTAATACTTTCTGAAGCATGAAACGTGGCCCTGAGCAACCAGGTGCTGTTTCTAACAGCGAAAATGTTACCTATTGAAGGTCTCCAGTGCCACCTACTGGTAGAGGAGTAATTTGGAAAAGCAGAATCTTAAAATGTAAAAAAGCTATTTTTTTGCTGTTTATTCTACAGATGATGAGTCAGTGTCATTTGGAGGCTTACAGAGTGACAGCTAGCTAAACAGAAATGATGAATAATTAGTTTAACAATGATATTGTCTGTTATTCATTTAAGCATCTGTGCAATTTTAATTCTACCATTTATTGTTTCCCTGCTATTGAGATATTACCCTAGGTGCTGGGGTGCAGATCTTGCTCTTGCCTTTAAGGAGCTTGACATGTAGGTGAGGAGATGCATGCACACAACTATATCCCAAGGTTGTAAGTGCTATTAACAGGCCCACGTACTCATCATTCTCTGTCTGGGAGAGAGCCAGAGAAAGATGTGTGAACTGAGCATTGAAAAATATGTAGGATCATTGAACACAGTGGCATCCTATGATGAGAAAACAACATCTCCAAGTCATCAAAACTTGCAATAATGCTTCATGTGCTAGAAGCAAGTGGTTTAAGTACAGTTGGAAAGTGATATCATGAGTGGGTAAGAAGGCTGGATAATACAGCAAAGGCCGTGCTAAAGTTTTTGGTATTCTATGCTGAAGATTTTGGAATTGATCTTGTTTACATTTAGGAGACACTGCAGGATTTTTAAGCCCCTGGGTACCATGATCAGGTTTACTTTTTAGAAGTGATACTGTGATAGGGAAAGAAGGGATGGACAGATGTGGGAGGCAAGACTGGCAGTCAGGAACTGGAGAGAGATTATTACAATAGGCCTGGAGAGCGTGGATGAGGCCCTCAGCCAGGGCAGTCAGGAGAGACAAGTGGGGTATTGCAGAAGTAGTAATATGGGAGAAGAATGGCCTCAAAGAAGACACGAGAGGCTAATGAGTAACGCAGATCATGGCATCACAGCCACAAGCACCAAGTCCACTACCAAGAAAAGTTTTACCTGTTAACTCACTTATTGTGTGCAGTTCATGTCCAGTGGCAGTTCATGTGTATCCTGGTGCCTCATTCAGTTCACCAAAGGAAGAAGCTGTCAGTAGAAATAAGCAGAGAACCTTGTAAGAGGATGTACCATTGATGATCTCACACACACACACACACACACACACACACACACACACCCCTTCACACAAACTAAATAGGGGTGGTGTTTCATGTTATATCACATGGCACTGTCTTTTGGCGTGTTATTGAAGACAACGTTGCTTCCATCTGTGATGTTAGATATTCTTGCTATAATGACTGACTTGTGCCAGTGGCTTATAAAGCCCTTCCATGTGTGTTATATCATTTAATTCTCACAGCAATTATATGCAACGAATAGCCCATAAATTATTACGCATGCCATTTTACAAATGAAAAGACTAATCCAGAAAGCTTAAATGACATTTCCAAGGCCACACAGCTGACAAGTTGTAGTGTCAAGATTTCATTTTCTTTATATGTATATATTTTGATGGAGTCTTGCTCTGTCACCAGGCTGGAGATCTCGGCTCACTGCAACCTCCCCCTCCCGGGTTCAAGCTATTCTCCTGCCTGAGCCTCCTGAATAGCTGGGATTATAGGTGTGTGCCACCACACCTGGCTAATTTTTGTATTTTCAGGAGAGACTAGGTTTCACCACGTTCGTCAGGCTGTTCTCGAACTCCTGACCTCGTGATCTGCCCGCCTCAGCCTCCCAAAGTGCTGGGATTACAGGTGTGAAGCACCGCGCCTGGCCAGGATTTCATCTTCTACTTTACCTTACTATCTAAGGAACTGAACAGATTTGTTACTCTAAGAGGAGAACCTGCCATTTATACACATCTACCATCATGGGCAGGAGAGTAACTTTTATAGACAAGTATTGGCATTAAAATGCAGACAAATGCTAGATGATTGGACTATTAGAAGATCATCTTGGATGGTTTTGAGACCAAGAAGTGGTATAGTGACTGTGCTCCAAAAACAAGATGGCTTTGATTTTGGCTATTCAAACAGTTAACTAAAATTAAAGTGCATATCACCTACAATTATTACAACACAATAACCTGCTACTTTACTGTAATTTGGGTTTTTACTTTCTATTATTTTAAGATGGTTCAAATCCTTATATAGAAATAGCTAGCTTTATTATAATGTCTTATAACTGCCACTCTGAAAAGAGTCAAATGTATCTAAGATGCTCAAATACCATAATAAATCACCCTCTTTATTTAAAAAATTATTTTCTCTACAATTATTTGTGCCATATATACTGCGTACTGAAACCTTTTGCTCATTAGTAACAAAGATAGAGATTTTTTTTCTACAGCCTTCAAAGGTATCTATTTTAGACTTTTCATATCTTGATCTTCTCAGCTCTCTTTTTGATTGATTTTTCTGCAAACCAAAAGTGGAGATTTTTCTCATTTCCTGTCCCAGAAGGCAACTACAAGCCCAGATCAAACCTTTCCTGATGACTCTTCTTAGGACTGTCTTTTTCTCAAAGTCACTGAATATGTCAAAATCTTGTCTCTGCTTCCACTGCATGACATGCAAATGTCTAAAGAGAATGTAACTGAAGTTCTATCATTTTAAACATTACAACCAGTTCAACCTTAGGACAAGCTATATTTTTCTATCATTACATTTCCTTCTTGAAGATGAAAGGAAATCATTTAACAATAGTAGATATGGCATGCCCAGAGAAAAGTATCATGTTATTAAGTCAAATATGAAATGTAGGCACTAGTATTATTAACATTGTGTTTGCAGGTAAATTGTAAAAATCCACTCATTTTTGTGGTTGAAGTATCTCTTTTCTTTTGTGTCGCAG
>TTN-205,,0,1067,3260738,3261804,GTAAAGTAAAACAACTTTCAGAACCCCATTTAAATATAGATCGAATCTTAACAATGTCTGTAACAATTACTCAAGAGTTCATGTAAATCATTGTTGTTCCTACCATTCTCTTCTAATTCAACTAATTATTTCCCTGTTATATGCCATGGTCTCGCCTCTCCTTTACCACTTTTCATTGTGAATCATAGACCATCACGTTTCATTTGGCCCCGCTTTTTCTCTGTAACAATTTGTAATGTATTGCTGCTGTCACCAGCTGTCATGCTTCCTAATCAGCATGAATCAGAAGGGGGCGAAATATGCTGCATAAATAGGTAGATTTGTTTTCTCAATTGGCTAAGATAAAAATTAAATTTTAAAAACATCTAAGAGTGTTATCATCCTCCTATCATGCTGACACAATTTTGATTTCACAAAAGCTAGACCGTTTCAGGTCTGTACACCAGCGAGCTATATTCATCCTCCTCTCAAGAATGTCTTAGTGTTAAGAAGTCCAGTCCTAAAGTGGTTTAACATTTCTGTTAGTTGGGGCTCTTAAATTGTAATCAGAAACACTTCCTCAGTAACATGGGGAATTTGATTCAAACAAGGATAGCATTTTTATATAGTGGTACTATTTTTCCTGAGCAAATATAGTCTATGTAGTATTAAGTACATACAAATACATAAGGATTTAGAGAAACTATTTTTTTCTTAACCTTATGCATTAACTGTAACTAGATGTTTTTTTAAATAATGAATTTAAAGTGGTTTAAAATTAAAAAGTTGACTTTACAACAAGAGGAAGAAAGAAAAGAATATCCAAAACCCTGTTGGGTACTCCACTATTGCCTTCATGAACAATGTAGTGAAGTTCCTTAGCCCATTCATGTCTCAGCTTGCTTCTCTGGGAAATGGAAGTGAACTTGTGTGACTTCGAGTCAATAGTGACATACAAGGACAAGGCAGTAGGAGTGGACTGAATTCTAGTCCATTATTGAAATTTGTGACAAATCTGTAGACAACTCCAAATGAGTTCTGGTTTCAGTGCAAGGTAAGACATTAAAAATTGGTATGCTTCTTTTCAG
>TTN-205,,0,744,3261805,3262548,GTAAAGCCCATCTTGCTTCAAGGACTTTGATTTGCTGTATACCTCTCAGTCCCACTGTTACTAATGAGAGTCTCTGCTGTTTGTTTTATTGCATACTGTGGTCAGTCCATAACTTACTAATAAAATAACATGCAATAACTCCCGCTAGGTCCTCAATTATGGGTTAACCTACATACTTTAAATTTCACTGAAGTATGTGTTCTATGCACTAGAGAACCAATAATTATTTTATTAGGCACCACCTTTGCTTGGCTTCTTTACTCTTCTAAGCAATATTGTATCATTGCATCATTAAATGATCTATTTGCTGATTATTACTTACTGTACTTAAAGTAAGTACAGTATTACTTACTGTACTTAAAGTAAGTACAGTATTACTTACTGTACTTAAAGCATACAGTGGACGGAGAGCAAATGCTAACCCAAATACAGTCAGCTAGAGGGAGAGAGAGAAAGACAGACTGGGTCACTTTGGATAGCTGAAATGACAACAGAAAGAAGGAACCAGATACTGCATGGCATCTGCATGAGTCTTCATCAACCACTCAGCACTGAATCACCAGGAATGAATTTTCTTTTGTGTGATCCTGACATCTAGATCATATTGCATCTGGCATGCTGCTTTCAAGTGACAACTACGTCTTTCATCTTCATCTTCCATGCCATTTTGTGTTACTAACATGGGCAAGTGACAAAGCTTAGATCTTAATATTCTTTTCTTTTTCTTGTCACTTGATTATACAG
>TTN-205,,0,3041,3262549,3265589,GTTAATTGATTTTTAGCTATGACTTGCTTCATTTCATCCTCATCGCTTTATGCAGCTTTTCTGCCATGCAAATTCAATCGACGAATATATTAATTAGAATATCTCTAAATTAGCACCCTATTCATAAGTGACTTCTGAAAGTCAGCCAAGTCATTGGCCATGATTATCCTGAAAATTTAACTTACCAGTCTAGATTCAGAAAGTTTAATTTTTAAACGTAGGTTCGGGAAGCAAAGGTTTATTTCCTATGTGCTGCATTTTCTAATATTTACCAACGCACTACCAAGAAAGTGTAGCAAAGTTAAAATGTTGTATTCTGAGAAGTACTTATTGGGTATTTATTATTGTGCCAGATACTGTGGTAAATTTCAGTTTAATTGTTTTAATAGCAAGAGGTTCAACAATTCTTATCTCCTCTTTATTTTCACATCTGGAGGTTCTAGTTGTTTACAAAGGGGCCATGAAAATAGAAAATTGGGACCAAGTACAGTGACTCATGCCTGTAATCCCAGCACTTTGGGAGGCCGAGGCAGCCAGATCACTTGAGGTCAGGAGTTTGAGACCAGCCTGGCTAATATGGTGAAACCCCATCTCTACTAAAAATACAAAAATTAGCCAGGCATGTTGGATGTTGGTGCATGCCTGTAATCCCAACTACTCAGGAGGCTGAGGCCAGGAGAATCGCTTGAACCCAGGAGGCAGAGGTTGCAGTGAGCCGAAATAGGGTCACTGTACTCCAGCCTGGGCAACAGAACTAGACTCCATCTCCAAAAAAGAAAAATAGAAAATTGAAAATTGGGCACTGAAAATAACAAAGCTCTCTCTGGACCAAAATTAGAAGTCTCTAGATATTTCTCCATAAATGATGCTGCTTTTACAGGCTTAAAATCCTCCTGGAATTGTATAATTTTCTCATGGCAAGATCACAATTTTTGTCGTTATTGGGCTTGATTCTCCATTATGTCTGGAAGAGCAGGAATAAACTTGTCTGGGCAAGTAATAACTTCTTCCTCTTATCCATGGACTTTCCTTTTGGATATTAATGAAATGAGAAAAATATTTTTCAGGTGCCATAAGCCTGTGTTGTGTGCCCGTAGTCAAAACAGCTTCACTGAGTCTCATGGAAGGAAGCTGGTGGAATAAATTCAGGCATCTCCAGGGGTCTGTGGAAAGCTCTGGCCTCAAGTTCCTCCCTGATCCTGGCCATAGTGGTGTTAGGGATGAAAAGGGGGCAATGCAGTGCTATGTAGGTGCACAGCCATCTCTGCACAGAATTTTGAAACAGTGGCCTTTCTTCCTACCCAGTACAGAGAATACAGTTTATTGATTCATATAATGTATCCGCAACACCTACTCACCAAAAAGAGGTCTTATTCTTTCTTAATGAGATTTTGTTCTATAGCTATCTCTCATTCTGTCACCGTAGCCTACAAAGGCAATATCTCAAGAACTGAGGTCTAGTTATGTAAATTAGATAGAAAATTCCACCAGCCAGAGAGTTGACCCTCAATTTCACTACAGCTGCTGGCTAGCACAGTAATCACACAGAGTCACTATTTATTTGGAGGTGTTGTCTACAAGTCCTGTAGGTGACAGTGTGACAATTTTTTCAGTAATGTAATTGGGAGTTGGCTGTGTTGTGAAGGTGGGAGAAATGTAGATCTCTTAACTCACTTCCTAAAGAATCTAGTGCTATAGTGCGGTGTTTGACTGTCATATTCCCAGAATTGATTTGAACTCGGCTCTTTTGCCCTAGGATCTCCAGTTCATTCAGTTCCAATTGATAATATTATTAAAGTGTTCTTGAAGCAAAAGAATTTTTTTGAACATCCAACTGCCTTACTTGTACCTAAGAAAGTTGAAAGATAAGACATTTTTAGATGTTTGAAGAGTGAAAGATCAGGCACAGTTGTCTAATTATTTGACATAGGCCAGTCTTTATATGTTCCTTTTTTATTTTGGCTTAATAAGTTCATATAGGCTACAGAGTTATCCACCAAGATCAAGTAGGAATGTCAAACCCCTGGAAGTCTTTTTGAATACAGTTATTATGTGCATAATAAACATAAACATATCATATATAAGTTTCATGACTAACATGCTGCCTTTCCTTCTCATCCTAATGACATTCCATCTTCTCCACATTCAGCATGTTTTTCATTCTTACAAACACAGCTAATTTATGCCTTTCCCTAACTTTATTCTTACCTAGCAAAAGAATCGCAAGCCAGAGCACTTACAAAAATTACTCTGGGTTCTGACACTAAAAGTATTAAAACACTCAGAGAGTCACAAATTAAAACAACCCGTGAAGTAAAAAGAGAATCGTCAAAGAAAACATCAAGTTTGTCATTAACTTCATGCCAAAAACCGTAAGAAACTGAGAACAAGGGAATAAAGTCTACTGACAGGATACCACGTGGACTGAAGACTGAGAGTGATACGAGAGCCCCAGCCTTTCCCAAGGAGCTGCCCTAGATATGACTGTGTCTAAAAGCTGTGCATATTCCTTGTGGAATAAAAACAGTTTTGATAAGTCTTTGTTTTGTTTCTTAATATGTAATTTGGACTTCATGTAGTTCAAAGTTTGAAAGGTGATTCAAATCAAAGGAGTGTTTACTAGCAGGAAAAACTGAGAATAGCCCTCTGCTAAAGTAGCAATTTAGAAAATGCATGTTCTTTCTAAATGTGATTTCATCTCTTAGCAAGTGTTTAGTCAATAGGACATTTTTTAGAAAATAATATTCCTTCGGTTTGTAGATTGCTTTCTGCATGCATGTAAAGGCATGGGGAATTATAGAACTAAAAGTGGAAATTTCATGAAGAACCTAAAATAAAAATGTTTTAAATCTTTCTGTCAACATTGTCATGTGTTTTATCAGCTCAATAGTTTGTTTGGCATGGACTTTTTGGTAAATTTGGGGAATGTAGTTTTCTGTTGTTATAATAAAAAGAAAACTTTAATCATACAAGTCATGAATTGATGCAGAAAATATATGCAATTAATCACTAAAATCTCTTTATATGTTTTTCTATTTTAG
>TTN-205,,0,11202,3265590,3276791,GTATTGTTATAATGGATGTGAGATTTAAGTAGAAATTCTAAAGGATTAATAGGATCCTTGAGTTGCCTTCTTTCTCTTAGTATTATTGAGAAAAAAATGACATAGATATACAAATATATCTCTTAGAGTATATATTACTATGTCGCATGCTTGGTTTAGAATTTTGATGGTTACATGCATTTCACAGTAATTTATTGTAAGTTAATTTAAAATTTTGTATTTAAAATTTATCAGCCAAATTCAACTTTATGTTTGCAGTCATTTCCAAAAGTGTATATTAGGAGAAGTTGTCATCTTAATGCATGAAATCATGAAGTAGAAGTTTGTTTTCAAAATCACGGTGAATTACATTGAAAATAGACAATAACCTAGCTGTCATTCTCAGAATGCAATGTCATGAATGAATTATGATTGAAATGCTACTTTACTGAGGTTGTGTGAAAACATTACATTCCCATCTGGTTTACACTTCATTCACATATATCATTTTAACATTGATATGTCTCTTACACTGGCTTGCAGATAGCTGCCTTATGTGATCCTTATTGCCTGCTTTTCTTTGCATAACATTGTGACTTTATGGCTGTATTAGTTCGAATAAACGCCTTCTCATTTTATTTTAGCTAATTATTTATGGTTATAGTTCTTGTATATACTCTTTAAATAGTTGATTCTCAAAAATATAATAATTTAATCTACAATCAAAAGAATCAGAAAGGGCGTTTATTCCACTCTCTGCAAGTCAGGTAAGATTTTCCACTTAGCCATCAAAAGAACAAAGTTTTCCTGCTCTCAAAACAAATATGCACAGGAACATGTTATTTTGAAATGCATTTTTGCTTGTTCAAGAAGAAATTTCAACAGTTTGAAGAAAAGACCAGACAACGAACGATTTTCGTGTCAGAATCTTTTAAACAGAGCATGGTGTTGCGTTTATTCGAACAAATATGGTGAGTGAATTTTTCTATGGATTTGTGAGATCTGTAGCATGCAATTTATTTCATTTCCTATTTTGCAATTTTATTTACTTTCAACTTTTTCAAGTTCTATGGAAAATAGTAAAGGTTTTTTTTTTTTTTTCCAGAATTATTCTCTGAGGGGGAATCTGAACATTCAGAAAGGGATACACGTGACGCCTTTTCAGATTCTGAAGACATAGACCACAAATCCATGGCTGCTAAAAGATATGCAAGTAGAATATCATCTACAAGCTCCTGGCCTGAATATTTTAAGCCTTCTTTTACCCAGAAACTTACATTTAAATATGTTTTAGAGGGTGAACCGGTTGTTTTTACATGTAGATTAATTGCCTGTCCAACTCCAGAAATGACTTGGTTTCATAACAATCGGCCCATCCCAACAGGTCTTCGTCGGATTATAAAAGCTGAGAGTGATTTACACCATCACTCTTCCAGCTTAGAGATTAAAAGGGTCCAAGACAGAGATTCTGGAAGTTATAGGTTACTAGCAATTAATAGTGAAGGGTCTGCAGAATCAACTGCATCATTGCTTGTTATCCAAAAAGGGCAAGATGAGAAATATTTAGAATTTCTGAAAAGAGCAGAACGGACACATGAAAATGTGGAGGCTTTAGTTGAAAGGGGAGAAGATAGGATAAAGGTTGACCTGAGGTTTACTGGCTCTCCCTTTAACAAAAAACAAGATGTGGAACAAAAGGGAATGATGAGAACTATACATTTTAAGACAATGAGTTCTGCCAAGAAAACAGATTACATGTATGATGAAGAATATTTAGAAAGTAAATCTGACATAAGAGGTTGGCTTAATGTAGGTGAAAGTTTCCTGGACAAGGAGACCAAAGTGAAGTTGCAACGTTTAAGGGAGGCTAGAAAAACATTAATGGAGAAAAAGAAATTATCTCTTTTAGATACGTCTTCTGAAATAAGCTCAAGAACTTTGAGAAGTGAAGCTAGTGATAAAGATATTCTGTTCTCTAGAGAGGACATGAAAATCAGATCTATGTCTGATCTAGCTGAAAGTTATAAGGTAGATCATTCAGCTGAGAGTATTGTGCAAAATCCACATGCCCTTTCTAATCAAATGGATCAAAATATAGAATCTGAGGAACTTCCCACAAGCTTTCAAACTATTGTTGATGAAGAAATTTTCCAGACTGAAATAAGAATGAGCCAAGAAGCACTGGTAAAGGAAAGTCTACCAAAAGACCATTTATATGGTGAAATTCTAGTAAATGAAAATACCCAAGCAAGAGGACAGCTGGAAGAAATTATGGCCAATACTACAATTGGAGAGTCATCCACATATATCACTAATGTATGTGAGAAGGAGGAAGTATATGAGACTCCTGAAAATGTGTCTCAAGCTATTACACCACATGCCAGCGAATCTTTTGGTACACTTGTAAATGTTGAAGAAAGTGAAGAAATAGCTAGTGAAAGAATAAAAAAGGATGATTTGAGAGAATTACAACTCTCTGCTTCTACACGAATTGATGAATTCAAAACCGAACAGAAGGAAGAAAACATGAGATTTTTTGAAAATTCTTTTCGAAAACGCCCACAACGTTGCCCACCTTCATTTCTTCAAGAAATTGAATCTCAAGAAGTTTATGAAGGTGACAGTTGTAATTTTGTGTGTCATTTTCAAGGATATCCTCAACCTATAGTGACGTGGTATAACAATGACATGCCAATCCCACGTAATCAAAACTTTATCATTCATTCGTTGGAAAACTATTCAATATTAACTCTTTCATCTGTTCATCATCAGAATGAAGGTTCTATTACTTGTGTGCTATTTAACCAATATGGAACAGTAAAAACAACCAGTATGCTTAAAGTGAAAGCAAAACAAAAACATGATGTCAAAGCACATAAAGTCCCAGTGTTCCATGACTACTTGGATGAGGAAGAAGAGTTAGCATTGGTGTTTGACCAAGCAAAAGGCGCCCATCCATCTATGAGTCAAGAGGGCCAAACAAATCTTCATTTGTTAAAAACTAACCCACCAGTTCCTCCCTCTGGAGACACAGAATTGCTTTCCTTTCCTGTAGAAATTCAGGTAACAGCAGCTACTCCTATCCCAGAACAGGATAAAGAGTCTAAAGAAGTGTTTCAAACTGAGGAGCTGGAACCTAAAGCAATGCCTCAAGATCAAGTTACTCAATCACCAAAACACAGATTTGTATTTTTGTCTGATATTACTAATGAACCACCAAAAATGTTACAAGAAATGCCAAAGCATGCCAGGTGTAGAGAAGGGGATTCCATCATTCTTGAATGTTTAATATCTGGTGAGCCCCAGCCAGTTGTAACATGGTTTCAAAATGGAGTCCTTTTAAAGCAGAACCAGAAGTTTCAGTTTGAAGAAGTTAATTGTAGCCACCAATTATATATTAAGGATGTTAATTCTCAAGATTCTGGAAAATATAAATGTGTTGCTGAAAACAATTCAGGGGCAGTTGAAAGTGTTTCAGATCTAACAGTGGAGCCTGTCACTTATAGAGAAAATAGTCAATTCGAAAATATTGGTGAAATTTATGGAAAATATTCCAGAGATCAGCAACTGCAAGACCAGGGAGAATCTGTAAGGGCACATTTTTATGATTATCCAGCTGGTCCCTTTACTCCCTGGACAAATGTAAAAGAATATTCAGTAAGGGACTATTTTCAAAGCCTTGAGACTATTGAGCAAATAGACCAGAAAGAGCAGGTGCGTTGCATACCTTCTAGAGAAAAAATTCCCAGATTTGTGCATGGTGCTTCAAGAACCATAAAAATCAGCAAGCCCATCAGGGCTGAATTCATACAATGTCAGGCTGAAGGGAAAGAGAGACATGTAAGTGAAAAATCAAAGCTGCACCAAGCAGAGGGTACTGTTTATCCATTTGTTGATGATTTCAGTGATGTCACTATTAAGAAAGAAATAAGAAATAATTTTGGAAAACTTGGTAGATCAGAAAAGGAAAATGTACAAGAATGTGCCCAAAGTGACTATTTACCAAATATTCACTCTGAGAGAATTTCTGACAGTTACAATACAAAAGATTCATCTGCCATTGTATATGAAGAATCCCTTGGTGAAGAGATACACTACCCGGGGAAAAAGGTGAAGCATAGAATTATCGAATTTGAAAAATTACATGTAGAAAAAGGAGTTCTAGAAAAAAGACCTACCAGAACATCAATTGTTAATCCTCCTCAAAAGAAGATTGATGACAAAGCCTTTTCATTAAAGCAAAGAGAATCAAGATCAAGCAATCTAAATGCAAATATGTATCAGGCAGAGAAAATGTCTCCAAATACTGAATCAGATTCATCTAACATTGCAATAAATTTAAAGCTGCTTTCCTCTCAAACTCATAAAGAATTTGACGCACAAGAAAGGGAACAACAGGAAAAAATAAGTCTTATAGATAAACCTGCAATTTCTAAAAGAGCTGAACATGAATCACCTATTACATTTGACTTAAAGCAGTTTCACACTCAAATAAAACACACAGATGTGAAATTCCAAGAATTAGATAGTGGTCAACCAGAAGAAGCTTATTTTAAAATCCAACATCCTGCTGACACTGAGAACATTGTATTTGATCTAAAACAAATGTATTCTCATATAGGAGATCCAGCTCTGGAGTTCCAAGGGCAAGAAACTAGGGAACAGCAGGAAATACATTATAAAGAAAAAATTCCTAGCCCTGAAACGTTACAACCTGACACACACAATATCTCTAAAAGTGTGCAAAATAATGTATTTGCCAGTCAAGAAATTTCTTCCAGTCAAGAGCTTTCAAATAGAACTATGGTGGAGAAAAGTAGTATTGATGAAAATTCCATTTCTTTAGAAAAAGAAGTCCGACATGTACAGGAACAAAACTTAGACATTTTAAAAACTGATCTTTCTCTTAAATCCTTTTCTGAAGAAATCTATAGTGAATCATGTGCCCTACTTCCAACCTCATCTGCAGATATAGAAGAAACTGATCTTTCTGAGAAAAGTTGTCCTCTAGAAAATGGAGGCAGAAGTTCCATCTCACATTTGAAAAAAGCAGCAAGTGAGGAAAAGCCTTTAGGGGTTGGTGAAATGGAAGAAGAATGCACTCTAGAACCAGAGTTGGCAGCATTTCCAAAGCAGGATGGTGGGACACAGGAATATACAGATGCCACTTTGGAAGACCACAGAGGTGATGTTCAGGAAGCTGACACACTCCATAGACAGCTCTCCCTGAGTCAGTGCTTCCCACTCTTGATGACTGAAGAACAACAGAATCCAGGTGAACAAATAAGTACAAACATTCATGCCTCTGGAGAAGAAAAATGTTATGAAGAAGTTCAAGTTCAGAATGAAGCTTCTTTCTCCACTTTAGAAGGAGAAATGATAGAAACTAGTTTTTCTCAAAATATTCCTAAATTAGATGAGGCACATACCACTGAGGCAGCAGAATCTGAGACCTCCCTAACACAATATTTACTTGCTGCTGGAAAGCGTGAGGTTCCTGAAACTAAAGACACCAGAGACCAGGCAAAGCTTGTCCAGAGTGAATCAATCACTTCAATGGAGGTGGAAGAAGTAACTTTCAACACTGTGTATGAATACTACAACCAGAAACAGGAATCACTAGGTCGTCCACTTTCTCCTGAGTCTGACATTTCCATTGGTGTGGGAAGTACAACCAGTGAAGAAATATCTGAGTTAGATCAGTTTTATACCCCACCATCATCTGTTGAATATTTTGAATCTCCAAAGTCCCCTGACTTATATTTTAATCCTTCAGATATAACTAAACAATCCTCAATACATTCAGGAGGTGAGACAGTTGAAAGATATTCCACACCTTTAGGGGAAGTTGCTGAAAGATATTCAACACCTTCCGAAGGTGAGGTAGGAGAAAGATACTCCACACCCCCAGGGGAGACACTAGAGAGATACTCCACACCTCCAGGAGAGACTCTAGAGAGATACTCCACACCCCCAGGAGAGACTCTAGAGAGATATTCCACACCCCCAGGAGAGACTCTGGAGAGATACTCCACACCCCCAGGAGAGACTCTAGAGCGATATTCCACACCCCCAGGGGAGGCACTAGAGAGATATTCTATTCCTACTGGAGGACCAAACCCCACTGGTACTTTTAAAACATATCCATCAAAAATAGAAAGGGAAGACGGTACACCAAATGAGCATTTCTACACACCTACAGAAGAGAGGGGTTCAGCTTATGAAATATGGCGTTCCGATTCATTTGGTACACCCAATGAAGCCATTGAGCCAAAAGACAATGAAATGCCTCCATCTTTTATTGAACCTCTGACCAAAAGGAAGGTATATGAAAACACAACACTAGGCTTCATTGTTGAAGTTGAAGGTCTTCCAGTTCCTGGTGTGAAATGGTATCGAAATAAATCTTTACTAGAGCCAGATGAAAGAATCAAAATGGAAAGAGTGGGTAATGTGTGTTCACTGGAAATTTCTAACATTCAAAAAGGAGAAGGGGGAGAGTACATGTGTCATGCTGTAAACATCATAGGGGAAGCAAAGAGCTTTGCAAATGTAGACATAATGCCCCAGGAAGAAAGAGTGGTGGCACTACCACCTCCAGTAACACATCAGCATGTCATGGAGTTTGATTTGGAACACACCACATCATCAAGAACACCTTCTCCTCAAGAAATTGTCCTGGAAGTTGAATTAAGTGAAAAAGACGTTAAAGAATTTGAGAAGCAGGTGAAAATAGTGACAGTTCCCGAATTTACTCCTGACCATAAAAGTATGATTGTGAGTCTAGATGTTCTTCCATTTAATTTTGTAGATCCAAATATGGATTCAAGGGAGGGAGAAGACAAAGAACTAAAAATTGATTTAGAAGTATTTGAAATGCCTCCTCGCTTTATAATGCCTATTTGTGATTTTAAAATTCCAGAAAATTCAGATGCTGTATTCAAATGTTCAGTCATAGGGATCCCGACTCCCGAAGTTAAGTGGTATAAAGAATATATGTGTATTGAGCCAGATAATATTAAATACGTGATTAGCGAGGAGAAGGGAAGTCACACTCTTAAAATTCGAAATGTCTGTCTTTCTGATAGTGCAACATACAGGTGCAGAGCTGTGAATTGTGTAGGAGAGGCTATCTGTCGGGGATTCCTCACCATGGGAGATTCTGAAATATTTGCTGTGATAGCAAAGAAAAGCAAAGTGACTTTAAGCAGTTTAATGGAAGAATTGGTCTTAAAGAGCAACTACACAGACAGTTTTTTTGAATTTCAGGTGGTGGAAGGGCCTCCCAGGTTTATCAAAGGTATTTCTGACTGTTATGCACCAATAGGTACAGCAGCATATTTTCAGTGCTTAGTTCGTGGCTCTCCAAGACCCACGGTTTACTGGTACAAAGATGGAAAATTAGTCCAAGGAAGAAGGTTCACTGTTGAGGAAAGTGGCACAGGGTTCCATAACCTGTTTATAACAAGCTTAGTAAAGAGTGATGAAGGAGAGTATAGGTGTGTAGCTACAAACAAATCAGGAATGGCTGAGAGCTTTGCAGCACTCACCTTAACTTAAAATGTAATGTTTTAGTGCCTCAGTAATTATTAGCATTGATCTGAGTGCTTTCATATTTTCCAAATTATGTGGATCTAATAAACTTCCAAACAGGTCCACCATATTTGAATTCATTACCTTGGAGACCCCTAAAGAAATAATCTCTATGTAGAAATCTCATCTTTGTAATACATGTAAATATTTTGTTATCTGAACTGTGGAATCATCACTTGTGTCAATCATGCTGTGTAATATCAAACACAATTAAATCTCTCCTTGGCTACCTAATTGTTTGTACTTCTATTTACCCTCATGCCTCCTCCACAAAGTGTTTCAGTGGAATGGACTCTCTTTTAGCAGATAAACCATATATGCAAAAGTACAATGTAAAAGTGGAGACCATATCAGATGACCACGCAGACAAATTGGTAAGGGCAAATCTCTCTGCTCCCATTCTAAGTTATTTTTGGAATTTTAACCCCTTTGCATCCAAACTCATGTTTATTTACTTTGACTTAGAATAGGCAAAACAAACAACAAAAACCAGCTTCTCCCAATTGGCAACTAACTCTATAATCTGTTTGACATTTCAATCTTAATATATTAACTTCATCTCTTTTAAAAATGTTTTCGTTATTAATATTCCTCTTCATAAGTGCTTTAATTCTCACTGGCTTCAAGGGACCAATTGTGCTCTTTGTGGGCAGGGTTCACCTAGACATTTGCAAAATAAGCAAATAGATCTTTCCACTTTTGGAGATACCTTATTTTTCTCCATTTTTGAGATGACATCAAGTGTAAAATGCAGCAATAATTTAGTATTGGCCTGGGGAAAAAAGGGAAACTATCATATTGTGTTTACATATAGATTTTAAAACTGTATTCTGATTTCAGAATCTTTAAAATTTAAAAAAAGGTGGGATATTTTTAGAATTGAGACAATATGGTAATTTGTATTTCAGATTATATATAAATAACAAGATAACAAGCTTTCCTATCAGTTTCACTGAATTTCATCTTTAAAACGAATATAGCTTAATAAGCATTCAATTTTTATTGTGATGTTTATGTTTCTAAAGTAACTCTTTAATTTTGTCTTTTAAAATTAAAATAACAGTAAATTAACATACTCCTTAATATCTTACCTATATACTAATGTGGACCCAAGTCTTCTCATATAAGACTCGACAAATATAAAAAATTCTGAAAATGAAGGGTAGGACCAAAAGACCTTAGAGGTGATCATTCAACAATACAATTCTGTGTTAAGCTAATAGTAATTATTCTTAATACAATTTAGAATAAACTTTAATTTTGTAACAAAGGACGAGAGAAATAATATTACAATGAAAGATAAATTTTATCTCCCTCCACCTCTTAAATTACTTATTGTTACTTAATGGCTACATTTGTCACCTGCATTTAGCAATATTTAAGTACCATTATCATATTTAAAATGCTAATTTTAATTAGAAATGTAAACAATTTAAATTTAATTTTCAAAAGAATTCATATCCAATTATGTTTATTATGTTTCTTTCATCTATCAGTCTTTATTCTCAACATGGGAATTCTCTAACAGCTATCCAAATTAAAGAAGCAATAGAGACAATGTACAGAAAATAGGCAGAGCAGCCAGGCCTCCCCTGCCTCCCTCACAAAAAAAATTTTGAATTATCTGTTTGAGCCACCATAACTCATCAGCATAGATACACTATTGTAGAACAATCATTCCTGTTCCAACCAGTGAGCACACAATATCTGTGATAATAATTATAGACATAATGTAATATATCACATCACAAATTCCTGAAATAAAACTAATTCTATAGATTAGGAACTTAGAGATTTATTCTGCACTTAGTCACATAATGGATGTTAAAATTAACGAGAAACTCAGATTGAGGCAAACATGACAAGCATGCTTTACTCAAACATCATACAGCACAGCAACAGTTCAAACCTTGTTTCTTAAAAAAAGAGAAAGAGAGAAATAGAAAAATGTTTTTATGTCCTACTGGATTTCAGGAAGAGCTGAAAAACACTCTTATTCATATAGTAAAGAGGGCTTTGTTTGGTTTTGCTCATTAGAATTCTGTAATTCTGTTAGTTTCAAGTATGGTGAGCTTGAGTATACGCAGAATAACAGTGACTGAATAAAGAAAAGTAAGCCTTGGCTTACTTTAATTGTCATAGATAATGAAATGGAATTTTTTATTTTCTGACTCAATGGCACGTAACATAAAACCCCAAAATATTAATTTCTCTGATTCTGGATAAAGAATTTATTGTATTGCACATAGTTGAGTTTAGACAATTAATAGCTGCTACCACAACATGTAATTTTTTAAACTATGCCTTTCAAGTTTCAGCACATTTGAATTTCATTTACTATCCTTTTTATGGCTAATAATACCATGGCTTGAAGTAAAATATTTGCAAATAGTTCAACATAGTAGTGAGTAAGGGTATTTTAACTGTATTCACATTCACTCCCTTTACAGATATTTTGTGAGTTCAAGTGAAGGGAAAGGTAACGCGAATTATGTATTGTAGATTAAATGCGAAGTTAAGTGATCACCATTAATATGTAAAATTATCAATGGTTTTATGGTTTACTTAAAATAATAAATACCTGAATATGTATTCTGCATGCTATAGATGAGTTTCTCCAGTATTTTTACAGCCAGCAGACACTTGAGTCCTGTCTTCTAATGCTTATATGCTAGAACAGAAAGGAATTAAGGTGTAAGTCTATTTCATGTGATGCAAGTGAAGTCACCAAATAAAATCATAAAACTGCCTTTTGCTAAGGCAATAAAACTACTAATAACAGGCCTGTTCTACATAGCTAAGAGGTTTAATAAAAAATCGAATTCCTTGTTTAAAATTACATGTCTTTCATCCTGTCATCCAGGATACTGTTTAAAGAGTCTCTGTTATGCACTGCTTTGTTTCTTGCTCAGTGGTTCTGTATAGGTTTTCTTATACAATAAAATACAATGAACTTTTAATATTGGAGTTGTTTTCTCTTATTTTTGATTATCTTATTTTCTTGGCTAATGCCTTATTACAAAGGCTTTGTTCAAGTAATATGGTGATTTACATAGATGAAAGAAGGCCTGCATTTCTAGAAACTGAAAACAGTGGTTCTCTTACAAATCCAAATTAAACATTTCCTGTAGCCTCTTATTTTTAATAATGACTTTAGAGGCAGTAATTAGAACATCAATGGTTTATTTTGGAAATAATCAGTCTTTAACAAAGAAGATTATTCTTAACCTCAAGAAAACTCTAAATATAAATAACAATTCTGGATCTTTTTAGAAGTTGATTTAAATAATGCTGGATTATTATAACTATTTAATTAGCAGTTTTTCAAACTTTAAAATTGGAATTATATCTCAAGAAAAACTCATGAGAGCATTTTTAAAACATGAACTCTATCACAGATGAAGTGGATCAAAAATTGCTTTTGTACAGTATCTATAATTTTGCATAATTTTATATGTTAAGCTAAGAAAAATTTAGAAATGTGCTTTTTGATACATTAATCTTGGAATAATCTAATCATTCCAGGAATAAAGCAGAAGAAGGCCATCAACTGGTGTCTAATTCTTTGATTTCTATTTTTATATTAAATAAAATTTTATAGTAAAATAATAATCATTTTTCCCCATACAG
>TTN-205,,0,780,3276792,3277571,GTTGGATTTTAAGGATAAAATAGATCAAATGCTAACATTCACTGGATTGTAATGATTTAGCTTGCATCACTTAAATTTTCACTTATCTGCCACTTCCAGAATGTAATTTATTTAGAGTAAGAATGAAATCACAGACATAATCATGGTTATGAACTCACCTTTTCCCTTACTGCCCTGTTGGGTGCTATGCTATCATATCCATGGTACTATTTATTTTAAAAATAAAACATATTTTCATATGTTTCATAATACCAATAGATAAGCTTTTAGTTAATTTTCATATGAAGATAACTTTCATAATATGTAATAAAAAGTATCAGTGAACACCTAGCCACTCTGAAATCACTGGTCTCACCCTTAGATTTAAAATAACCATGATTAGTTGTCTGTTTCTTTTTTCTGTTTATTTTTTGTTGTTGTTTCACTTCATCACTTTATTTAGTATATCATGTTTCTTCACATTATTTTCAGTGTTCCCATTCAGCATGGTATATTTAAAGAATATATCATGTTGTTATGCATATAATCCAATAGCATCACATTTTTTCACAATTCACTGCAAAGCAATGATTGAATAGGTTTTTTTTAAAAAAAGCTTATTGTCTTCTTTTGCCTTCAATGATCTTTCTCATTTTCCAGTCACTTGCCTTAAACTGCTGTAATCCATCTCACCAATTTCAACTGTTTTACTCCATTAACAGCAACAAAAGTTAGAAGAAAAACAAAAATGTCATATGCCTGATAAGGAGGCATGTTAATGGACTCTACTTCCCTTTGCAG
>TTN-205,,0,2007,3277572,3279578,GTAAATGCCATACATTGGCACAGATGTTGTCACTTCATTTCATATTGTTGTCCTTTTTGCTTTCTGTACATGTGTGGGAAATGCTTGTATTACCAACTGGAGAGACCAACAACCAAGACAGTAACATGGTAGGTAGGTACTGCAGAGCCTATATGGGATAAGAAATCATTATTTACAGTCACATTTCTACTACTGACCAAAGAAAAAATAATTTATTATTTGAGAACAAAGTTAAGTAATCAAATGAGCTCAGCTTGGCCCTTCATATAAAACATATCAGGACAGTTTGGTGCCACTAAAAAAAAATAATGTCTCAATGTATTTAAAAATTTTAAATCAAATAACCAATTAAGAACAGAATTACAAACTTAAAAAAGTCAGTGTCTAAGTCTAAAATTAAATCCTAATGTAAGACAGGGAGCTAGTATAGGACTGAAAACTAGGATTCTCTCTAGGCATTTTTACTAATTTAAAAATAAGACGGCTGGGCACGGTGGCTCACGCTTGTAATCCCAGCACTTTGGGAGGCCAAGGCAGGCGGATCACAAGGTCAGGAGATCGAGACCATCCTGGCTAACACAGTGAAACCCGATCTCTACTAAAAATATAAAAAATTAGCCAGGCGTGGTGTCACGCACCTGTAGTCCCAGCTACTTGGGAGGCTGAGGCAGGAGAATTGCTTGAAGCCAGGAGGCAGAGGTTGCAGTAAGCCAGGATTGCACCACTGCTCTCCAGCCTGGGCAACATAGCGAGACTCCACCTAAAAAAAAAAAAAGAAAGAAAGAAAATAAGACAACTACACAAATATCCTATTCCCAATTTTCTAATTGATATGTAGGGTGACTTTCAAATAGTTAACACTCATCAAATACTTGAATGCCTTCATTAACCAAAATATTAGTAGCAAGCTTTTCTTCCTTTCTTCCTACCTTCTTTCCTTCCTTCCTTCCTTCCCTCCTTCCCTCCCTCCTCTCTATCTTTCTTTCTTTCTTTTCTTTCTTTCCCTCTTCCCAAGAGAAAGTGTGAGTATGAACTGTGGTTTGAGGACAGGGGTAGAGGTACAGTCAAGCCATACTTGGACTGTTGGGGAAGGCTGTCCCTTGGTCTTCTTTGTCAATGAGAATATCAAGGGGAAGGGCAAATGCAGCACATCTCTTGAATGTGAAAACGATGAGGTTCCCTATAGCTTCCTCTTCTCTACAATCCTTTTACGTGATCCTAAGAAAAACCCAGGCCCATGATGACCCAACCAGTGCTTTTCACTCTGGTCAAAATGTCTCCATAAAACCAAGTACATGATATTATTCATACTGACGCGTTTGGAAGTTTCTTTACTCAAATTAGGTCAATTTAGGAATGCGACTAATATTGAAGCTTCAGATAATAAGAGGAAAGGATAAGGAGGATGACTTAAAAAAATTAAAAAGAGAGGTTCTGAAAGTCTGGCTTCAAGATGCAGAATGGAAAGGGGAAGTTGCTGCTATTAAATATTTTTACAAGTTTGAGTTGGCCTAGAGGATGCATTCATAGTTAAGCCATATAAGAATTTCCAGGCAGTTGACATGAGGGTTAGAAAGACATTACAAAACTACTTCAATCTTCTTATCACTTAATATCCCTACTCTTCAGAAGAGTCAAATACATTTTCTTTATCTTCCTTACATAATCTTCTAATTTGCAGAATTAAAGTATCAGCTCAATAGCTTATCAAATAATTAAACAAGCAGCCACTAAAATGGACAAATCTTTAGTAATGTTACTTAATAAAGGAACGCTTGTCTTTTCTTTGATAGAGACAAGTAAAGTGATGTCTTGCTCCCTTATAAAGAACACTCTCATCCCTTTCCTTTGACAATCTTTTGTTCTTATTAACACATTACTCCATTTTAAATTATGGCTCATGTCTATCTAAAGACTTAACTCATCTTTTCTCTGTCTTGGAATATATAATTACAGCAAGTGCTTTGGTGGGGACTAAATGTAATGCTGGAAAAATTTCTTTTGCAG
>TTN-205,,0,522,3279579,3280100,GTAAGAAACGTGTGAATGTATTTTCTAGTCCCTTCTCTGCAAGGAATCCTCAGTAGAAAAACTGTTGGCAAACAATTCAGTCAGTACACTTTGTTATTAAAATAATGTCATTCAGCAAACATTATGGTTTGGGAAAGTCCTGGCATTGTTTGATTTTATTTTTTTAATCCTCTTCAAAGTTCACTTAACTTTTGTTCTTTTAAATTGTCTGCTATTAACAAAGCTTGCTTAAAATTTCTTCTAAGAAAAAACTCCAAGTGTCTGAGCAATTCTTAACTATCTTCTTTTATAAAATTCTTCTTTGTGTAGGTAGTCTGTTTATTGTTGTTTTATTTTAAATCAAGAGACTGGGAAAGTGTCTTAGAATGATAGGAACCTATTAAATGCACCACAGCTTTTACAGAAATTTTGTGGAGATATTTTATGTGTGTTGGGTCTCTTTGTTGTATATGTCTACTTTTCTTTTGCGGAGTTTATGTTTCAGATATCTTCTCCTTTTTCTTTTTTGTAAACTTCATGTAG
>TTN-205,,0,100,3280101,3280200,GTTTGTTTACTGAGTTTCCATCCAGTATTTTTCTGAGAAAAGATTTCCCTTTTAATTACTTATTACCCATTACTTACACAATGCTTTCATGCTTTTGTAG
>TTN-205,,0,435,3280201,3280635,GTTAGTGCTTGAAAAACTAATGTCTCTTTAATAAATTGTCAAACTAGCTTTCTTACCCCATGGAAGAAAAACTGGTACTTTCTTCTCTTGTCCTATCCTTTAAATTTGTTTTGTCTTGGTTTGACCTGGGACCTTGGGAACAAAGTCAGTAACTTTCACCTGGTCTTTTTCCCGAGACTAGTGTAAATATCTATTATCTGATAACAAAAGGGAATAATAAGCCATTTTGTCAGCTGACAAACATGTATCATCTATGCCTCTGTCTCTTGGATGGAATTATAATTATTCTTAACTTTTATTTCTTCTTCTAATTAACACTATGAAATAGTAGTATTGGGACAAGATAAATATAATCTTGAAAAAACTCTTAAATATAGATGGTGTTGAAAGTGTTTGGGAATTGATATGTTTTATATGCTCTCTTTCCTTAACTAG
>TTN-205,,0,96,3280636,3280731,GTTTGTGTAGGAACATTTAAACCTCAAATTGCTATTTAGAATTAAAGTGAAACCCTAACAAGCATTTAGGGTGCTAACTATTTCATACCATTGTAG
>TTN-205,,0,117,3280732,3280848,GTTAGTATTTTTAGAAAATGATGCTACATATGCATTTGAAACCCAACAAATGGCCTAAAGTCAATCACTGAGCACTCTTCTATATTGACCTTTTCTCCCTTCTTGTGCAACACACAG
>TTN-205,,0,115,3280849,3280963,GTTGGCTGGAGACTTTGCATTTTATCCTTATTAAAGATTATGTTCAAATTAAGTCATCTTCCCTTAGATCAACCCTCTTAACTCTTTGAAATTCTTTCTTATACCCCTTCTTCAG
>TTN-205,,0,92,3280964,3281055,GTTTGCATTGTTTTCTTGACATCTTTGTGCTAACCTTGTTATAAATTCTTTCCTCTTTCTCACATTTCTTAATAACTTCCTTCCTTCCACAG
>TTN-205,,0,94,3281056,3281149,GTTTGTGTTCACTTTGCCTCTTGTGTTGCCAAAGTTATGGCCCATGGCACAGACCCCTCCTCCCTTAATGCAAATCATTCCTTTTTTACTGTAG
>TTN-205,,0,109,3281150,3281258,GTTAGTGTTGGTTCCAGTGAGGGACTGGCTTTTCTGAAGAGTCAATTCTTTTTTTTAAGCCACTTTTGCTATAGGGATAATATTGATTGAGAATTCATTCTTCTGTTAG
>TTN-205,,0,101,3281259,3281359,GTTGGTTCAGAACGTTTGCCTTGGGTTTGAGGAAGAAATGCAGATGTAAGCCTTTCAGCAGGGTAATGCACAACCCACATCTATCCCTTTGTTTTCTACAG
>TTN-205,,0,132,3281360,3281491,GTTGGTATTGTTCTTCTACAGAGAGGATTGGGCATTTCCATGCTCCTTCTTCCCTTAAAATTTAAAAAAAAAAACAAAAACAAATTAGTAGATTGACCTTTTTTTGTTGTTGTTTGCTTTTTCATTGAATAG
>TTN-205,,0,133,3281492,3281624,GTTGGCAAATTTTATTTCCACTTATCAAGAACTTACAAAATATTTTTGTTTCATTTCTAAATTTTCACCTTTATTGCTAAGTTATAAAATAAAACTTCCTATTTTCTTTTGCTTGTTTTTTCTTTCACCTCAG
>TTN-205,,0,147,3281625,3281771,GTCTGGTCTCTACATCTCCTCACTTTCTTGCTTGTCTAGATTTTCTTGCCTGGGGTGGGCCGGGGCGGGGGACGCTTAAGACAGCAGTTTTGCCCAGTGACCTGTTTTTAAAAATATTCAACATCACAATTCTTTTTCCATCTTTAG
>TTN-205,,0,97,3281772,3281868,GTTCGTGAATGGAATCTATTCTCCATTTTGGCTGTGCTGCCTGATAAGTTTGGGGTCTTCCCTTGAGTAAGCTACTGTCTTCCTTTTGAATCTTTAG
>TTN-205,,0,118,3281869,3281986,GTCAGTTATACAAGAAGCAGCCTATCAAATAAAAATTCTGTAACGCTTTTAAATCTTATCATTATGGGTAGGAGTTACAATATGTTTCTTCTTTTCACACTCTCTTATTTAATCACAG
>TTN-205,,0,112,3281987,3282098,GTTTGTAAGCTATTCTCTTTCAAAGATAGTCTATAGCGACAGTTTCATTAGCAGACATTATTTCTAGTGGAGTTACCAATGTAACTCATCCACATTTTCATTTTTACTACAG
>TTN-205,,0,102,3282099,3282200,GTTTGTATCTTCACCCCAGTCAGCTTCCCTTATTTATAGTATGTCCTTTGTAAACAAATAGCAAGAGATTAATGGATGTGTTTTGCTGTTTGCATTGGACAG
>TTN-205,,0,246,3282201,3282446,GTTAGAATTTCTTTACCTCTTCTTGATTCTTCCTTGCGAATGCTTCTTAAATGTATCACTCTTGCCTTTGTATCCTTTAGAGCTAAAATCTCTATGATTCTGGTTCTTTAGATACATATTCATTGTGTTCAAGAAATATTCAGCCATTGCCTCTTTCCAAGAGTGTTTTCTTAAATGTCCATAAAACTGTCACAATAATTCAACTGCAAGCAATTTAATTAAATATATCTCTCTTAAAATCTATAG
>TTN-205,,0,213,3282447,3282659,GTGTGCAAATTTGATTCCTTTATGTTTCTGTCTGACTGTGTCTTTGGTTCTCTGTATTCAGTTACAATGTCTCTAAACAATCAAGAAAGTAGTATTCTTTCTAACATAGTAAACAGTATTTGCTCATGTTTTTCTCTTGCCTGTATACTATCTAATTTAACTATTGTTATTTATTTCTGTTCCCTGATACTCTCCTCTTTCCTGACTCTTTAG
>TTN-205,,0,1043,3282660,3283702,GTAGACATCTTGTTCTTGTGTTTCTCATTAAATGAAAACCACCTTCTCCCCTGGGTATTATAGCTCTTTATTCATTTACTATCATTTTAGTTTCCATTTGAGATCATAGAATATTTTTCTGAGCTAGTATTATTTCCCTTTTTAGATGGTTTCCTTCTTGAATTTTGCTTACATGTAACTAGTCATTATGAAATATTTTTGTTATTCCAGTGTCATAATTCTGATTACCTCAACACATTTGCCAAACATCAAACGTGATGTTTCAAAACTGCACAAAAAAATGAAGTAGGCATTTTAAAATTAGTCTTTTGCTTTCAATCAACTTACAGATATATCATTCTCACTATAATCTATATCATTAATAACAAGCACTTTTACTATATCTATGCAAAGTGAAAGCAATACAGGTTTTAAACTTATGTTTAAAACAGGACAATAATATTTTTTCCTTCTCTCTCAAGGATCACTTCCTATCCTTTAAAAATTATATGACTATACCTTGGTACAAATAGTATCTGTGTTTTTTTGCTGCAATTTTCCAGTGCTTTTTTTTTTTGTCACAAAGGCCAAGTTTGTCTTGTTTTAAGACAATTATTGCAGTAATCATTTGCTGAAATGGAAGACTTAGATCACGGATGTTGTGATGACTTCCAAGTGTCTGTTATAGAACATATACAAAAAAAATCATCCTTGAAATTAGAATTCCATACTTCATGCAAATCATTATTTATTGCTATACTTGCTTGTTTGCAATTTTTGTATCAATCTTTGTAGCCTAAGATACATCAGTAAGGTGTAGTAGATAGAATGTTGAACTGTTCAGTAACGACATCTAGGATCTATCTGGGTTCTCTGCCCATCTAGCTGGTTATCTTGTGAAGGCAAATGGCTTCTGAGGCTGTTATCCCATGAGAGTGTTAGTGCTGGACTCTACTTACCCATTAGAATATCTTAAACCTTTCTTCCAATTTAAAGACAAATAAAAAATTTTCATTTTGTGAAATTCAGTAGCCCAATTCATGAGAAATTCTTGTTTTTTGCAG
>TTN-205,,0,118,3283703,3283820,GTAAATATAGTTCATCCACATGGCAGAAATGTCATAAATGTGCAAAATCCTACTTTTTTCACTCTCGCATGATCTGGACAATCTTTTCAACAATTTCCATCCATCTTTTCCTGTTCAG
>TTN-205,,0,829,3283821,3284649,GTTGGTACAATAGCCCACGATAGAAACTGGTGCCAAATGCTGGAATGAATTACTAAGAGTTACTGGCAGATTCTTTTTCTGAGTTTCTTCTAGAACTATATTTATCCTCATCTATTTGAAAGGTCTAGAGGAAAGACATAGTTGATCTTTCAAACACTCTTTTCTGTTTCTGTGATTCTAACAAAAATTAGACATCTGTTTTATTGTTTAATAACTACCTGTCTATATCAATTAGCAGATACAATCATGACTCTCTTTGATTAAGCATGAAAGAATACAGAGCCCAGCATGTGCTACAAGAGTAATTGTTAAAACTAACAAGAACTCCAAAGGTTGGCATTTGATAGCAAAGCTTCCACATAAAATTAATGACAATTAAACAATTGTTTGAATAACAACTTTCAAAGAATTGTCTTTAGCACCTTAAGGTAGAGCAAAAATACCAAGTAATTCACAATAACCTGTAGACTTTGATCTACAGAGGGTCAAGTGGAAATCAATATATACTATCTAATGCACATTGTTTAAATTGTTTTGAAGTTGAGTCATGCACGAACATATATTTCTTAAGAATAATTGCTACATAAGACGACAGCAAGAGTGGTGGGAAAAACAAAAAATAAAGAAAAAACTGAAAAGAAAAAATATTAAAATAAAAAATAGCTATAATTCTATGACTGCATGTAATTATGGAATCACACTTTAAAGTCGAGAGAGAGAGCACCCTAACATAACCATCTCACTGGGAGAAACAATCTTAGTGAATGTGATAGTAGAGACAGAGTAAAGATCCCAGACTTTGACAGATGGATATCACGTTTTATTTCAG
>TTN-205,,0,116,3284650,3284765,GTTAGTTCTGCTGTTTTCTTCTGGTTGCTTATGCAAATTCCTTTTACAAGTTTCCTTCTTTCAAGTCTCTTCTATTCTTTCAAATCATGATGAGTCTCTTACCTTTCCTCACACAG
>TTN-205,,0,159,3284766,3284924,GTCAGTAGACAGTCAAACTTGTAAGGAATTTCTTACAAATTCCTCTTCAGGTGCACATCTATGTTGACAAACATTTGAAAGTGCTCTAATGTTTTATTCAAAATTGCAACTCCATCTGAAGCTTACAGGATCTTTTAATTGTTCTCCATGTCTATATAG
>TTN-205,,0,93,3284925,3285017,GTTTGCTCAAGTGGATTCACTTTTTCTGTTTTCTGTATACCGACATCCTTGTGTTTTTCTTGTGTTTAACTGCTGTGCTTTGTCACTTACTAG
>TTN-205,,0,108,3285018,3285125,GTGTGTTGTCTTATTGTCTCTTAAATCATTTGCATTCTTCTAACATGTAGCATAGTTTCTTTGATATTCATTAATTCCAGTTGCTAACTGTGAGCCTTTCTTCCTTAG
>TTN-205,,0,112,3285126,3285237,GTGATGATATTTTACAAATTAAAAAAATTCTTTTTTCCTTAACTCTTGTATCTTTATGGTGAACTTCTCATTTCATCTCCTAACACCTTAAGTATTACATGTCTCCCTACAG
>TTN-205,,0,124,3285238,3285361,GTTTGTTCACACGTCACTCTTTTTCTTTGCAAACTGTGGCTTCATATTTCATTGTCAAAGTAGAAACGACCAATGGCAAAAAAACAAACAAAAAATACACATTGCCTTTCTTCTCATCCTCCAG
>TTN-205,,0,644,3285362,3286005,GTATCATTCCATGACTTTTGACAATATTTGTTCCTTACCATATTTGCATAATTGTCTTATAAAAGTTTCTTTGGTTTTTAAATGTTTGAGAGAAACTAACTGGACATGTTAGAATTTGTGTATTAGTGTTGGAGGCAACATTAATCAAAGTTGTGTTTTCTCTTTATATTGTTCTTTACATTAGTGTAACTCTAAGTGTAATCTTATCAAAAAGTATTGTTTAATTGAAATTTGTTAAATGTTGTTTTAACTATCTAGTCCATTTTTTAATGCTTTCTTGTTATATGGCATTCTGATTTATCATTACTAAATGTTGATCAAATACATCTATAATACATTAACTTTTATGTTTTAACTTACATAGTCAAACTAAAAAAAAGAATCAACTAAATTCTCTATTAAAAATGCACATGTACCCTAAAACTTAAAGTATAATAATAATAAATTTTAAAAAACTAAAAAAAAAATGTTATGAGATTATTTAACTTAAAAGATAACTTATTTTACTGTAAAATCCTCAGAAAGTATATTCTTAATAACAAACCAGTTTAAATATAAATTTATGGGATCTTCAGCTACAAAAACAAGCTCTTTTAACATGTATAATAAATATCCCTTACTGACTGTTTTGTTTGGTTTACTAG
>TTN-205,,0,257,3286006,3286262,GTTAGACACACTAAGCTTCTTTGTTTCTTTATTCTCCTCTGATTTGGGCTCTTAGCAAAGTTATGAGTTCCAAAATAAAAGGATAATTAAGGTTATTTGGTTGCAATTCTTCAACAAGTTTTAATGAATTGTCATTTCTTGTGTCAGCATGTATTGTCATATGATCACACCAGTCACTCTTCAAGGTTCTAGATTTAATTTTTTTTTCCTTTATAGTAAGCAAGTGTTCTCATTGTTTATCTCCTTTTTTCTGGTAG
>TTN-205,,0,120,3286263,3286382,GTTTGTATACATGGACACAAAAATATATGCCCCTTCCTCCTATCTGTTCTTGCCTAACTAATAACTTGTGTGGCCATGATTCTCACATTTTTTCCTCTAACCACAAATTTCTTTCATCAG
>TTN-205,,0,150,3286383,3286532,GTTAGTAGCAAAGCACAGCCAGAGAAAAAATCAATTTACTTGATCCATGATCATTTTCCTCAAATATTCCTCTTATCCAGTAATTCAGTGATTGCACTCTTGAGTTTGAAAGGTTACTTTGTTTTCAATGCAAAATACTTCTTCTTTTAG
>TTN-205,,0,102,3286533,3286634,GTGAGTAGAATGAGATTTTTATGAATATACAATATTTCCAGGGGGTGGAGGGGCACAGAATAAAACTTCTCTTTAAACGCAAAACTACCCTTCCCCACATAG
>TTN-205,,0,190,3286635,3286824,GTCAGTGTGCAAGGATAAAGCTGCTGCTTCTCTAACACCTCTTTCATGTGGACGTGGTGCCTGCCTTCCCTGGAGTTTCTTTATTTTGTCTTCATGTTTAGTCTTAGCTCCCTTTTTTTAAGGAGCAAAAGCACTTCTCACTTGGATTTCTTTCTTCTCTTTATCTCCCCTTCCGCCTTGCAATATCTAG
>TTN-205,,0,94,3286825,3286918,GTTTGCTCTTTCCCCCAATATATACATCTTTTAAAATTTCTCTTAAGTCTTCATTAGAAGGCAAGAATTTTACCCACATGTTTTCTCCTTATAG
>TTN-205,,0,100,3286919,3287018,GTGTGTTGACAGCTACCTCTTTTTATTGCTCTCTTTCTTTTCAAACATCCTCTTTTACATGGCATGACTGACTTGCTGACTACCATCCTTTGTACCATAG
>TTN-205,,0,132,3287019,3287150,GTGATGGTGTTGTTTAACCTAGTGTGTGTGAACAGATTCATTTTCTTAAAAACGTTAAAACTTTTATGAATTGAAATATGTTGTGGATGCCTTCTCACCTGTAAATAAGGATTATCTGTAACTTCTTTACAG
>TTN-205,,0,140,3287151,3287290,GTGAGTAACTCACAGTACCCTCTTCATTGTAAAGCAGCTTCACTGCTCCAGGCCACCAAAAGGCTGGTGCCATTTAGTTTCTGCTCTGTATGTGAGAGCATGGAAATAAAAATCACCATGTTGGTCTTCATTCTTTTCAG
>TTN-205,,0,1320,3287291,3288610,GTACTTGTTAGAGTGAAGGAGCAAGATCTCTTTTACATTTTCAGTATCTTAAAATATAGGAGGGTGGGTGTGCTTGAGAGAGAGCTATGTTTAGGACCAGGGTCTAGTGATGAAAATGGATCAAGTGGATCAAGGACCTTCCAAATGGAGACAAGTATTTTTTAATTACTTTAAAAAAAAAATTTAAAACTAGGAAAACATGGACCAAAAGTCCATTTTAAGAGACTAAAAATAGAGACTAGAGAGAGATAACCGAAACTCTACAAAATTGCAAGAAAATCCTAGTTTGAAAGACGGTATCATAGGACAAAAGCGAAGTTATTGCAAATGACTTTTTTCCCACAGTACTTAGTAAATGAATGGATTTTGTCCCTCTAAGGCATAGCAAAGAGCCAAACTATCAAGCCCTTCAAGGAGAATTCAGATGAGAATGATAAGTTCAACTTACTTTCCTCCACTAGCCCCACTTAAATAATAGTGGAGGTCAGGGGCTGGGGAGTAAGTAGATCAGTATCTGCTATTATGGAAGGCAGTCATGTGTTTCTGCCACATGTTTATCGCTGCTACTGTCAGAAATTAAATAGTTCACTCAATGGACTGCTAGTCTAGTCCATTAGAGTATTTTTAAGGGTTTTTGTAGTGGTGGTTTATAAATATCTTGAAATTAAAATATAATTAGATTTAGCAGCCCATTTGCTCTATGACATATAGCTAATCACTTTTACTTCCCTATGCCTGAATTTTTTGCTTCAGTTAATGAGGAAATCATTACTCTCACACACTTCAAAGGAAAATTATGAAGGTTGAGGAAATACCCATTTAACACCTAAAAGAGGAAAATGGCATTTTAAAAATATTAAGATATCTGACCCACTTTGCCATTCCGGCTCTTCATGCTATGTAACTGATAGCATTGCAGCCTTAGGAAATAGTTCTCCACTGGTTCATATACAAGACAGTAATCAAATTCTCATTCCCCGTGGACCTCAGAGGGCTTCCACTGACAGATACATGCTATTATCTCTGATCTTGGCACTAGAGAAGGGACTCTTTTGCTGGGGAGAGGATGGCACAATAAAGAGTAATGTCTTTTTCTCCTTCTTTTAGTAATAATACTTGATGTGGATGCTTACAAAAACAAGCATATTTTATTTTAGAAATTTTCTATTTAGGTTTCATTTAACTCTTCTTCCTTGAACTGCATAAATTTGTTTTCCAGAGCTAAAGACCTCTCTAGCAAAGATTATTTTTTCCACCTCATCTTGAATTATATGCATCTGTTCCATCCCTTACCCTGTGTTTTTCCTCTTGGTTCCATAG
>TTN-205,,0,228,3288611,3288838,GTCAGCGCTCTCCCCACCTGTGTGTTTTTCACATTAGCCTCCTCTTTAATTGTCCTCTTAACTTCCTGTTTGACTCTTCAACGATGTTTTAAAATAGGGAAAGGACACAACAAAGAATTGAAAGTGTTTTTTTCACTCTCTATCTCTCTGATGGAGTGGAAGATTGATTCTTACTTTTAACTATATACTTACAGAATACATCCGTATTTTCCTTTTTTCCAATTTTAG
>TTN-205,,0,412,3288839,3289250,GTTAGATGGACTGCATTCACTTCTGCTCACTACTTCCCTTCTAATTGTAATACTCTGTTGCCCCCTCCACCCCAGCCCAGTCTTATCACTAGCAGCCTATTCCACTTTCCCTTTGTTTCCTCTCCAAGTCCTTTTCTGTTTAGTCTGCTTCCCTTTTCCAAATCCTACTGAATATCCTTTTAGATAATGTTGTAATTAGGTTTTGATTGGATTAAGAAAGCTGGAGTAGATGAGATATTCAACTTTCCTACTGAATACAAACTTTAATGTGTCCCTGCTCGCATCCACCAAAAATGCCTCTTAAATGGAAATAACACATTATCACTAGTTTGATTCCCGGCATTCACGATTTGAGCAAAATGCTGTCAGTCTCACAAATTTTAAAACCCAGGCTTTCCTCCTTTTTCATCAG
>TTN-205,,0,116,3289251,3289366,GTTAGTAAAAAGATGATGTTATCACAGATACAAGGCACACACTCACCAGGATCTGTATTTTCTTTAGTTTTTCAATTTGAGTTTAAAATATGGATATCTTTTACATTTCATTCCAG
>TTN-205,,0,524,3289367,3289890,GTTGGTTGATTTCTTGGGCTTTTCCTTCATCATTATAATAATGTAGTTCCTGATTTTCATAAATGTATATGGGTTGTTACATCTTCTATAGGATAACATGAGTCCGACATCTTCTGAATCAGCAAATTCAGAGGCAATACCATCTGTAGAATTAGAAGAAAACCATGTTCAAAAGTTATATCCCTTTCTTTTTGAGGAATTTCCAAAATGATGATAGGAATGAAAAATAGTCCCTGGATAAGGTTAAAGCAGTCTTCATTTATGCTGAAATAATTCACCACATAATTCTTCACGGCAAAGAGAGAACAAAATCCCTAGCAAGTCAACCATCACATTCTGCCCACTGATTCTCCAAGCTTTTGATAGTGTGAACCCATAGAGGAGTTTTTAATACCGTCACAAAAGAGCCAAATGGATCTAGGGATAGTCCATCAAAAAGACAGTTCTCTCTTCAAGTCATTTTATAATTGTTGTCCTTTGTTTTTTTTGTTTTGTTTTGTTTTGTTTTGTTTTGTATCATTCAG
>TTN-205,,0,109,3289891,3289999,GTCAGTTTACAAAACAGTAAAATGAATTGCATTTCATAGTTTATTAAGCATGTTTGTCATAACAATTCACAAATACTAAACCTTTTCTGATATGTGCTTTTGTGTTTAG
>TTN-205,,0,103,3290000,3290102,GTTTGTCAGACTGCTCTTCTAGATTTATACGATTAGTAATTAGATGTGTCTTTGTCTGTATGTATATGTGTTTGATTTTATATTTTCAATTTGGTCACTTTAG
>TTN-205,,0,92,3290103,3290194,GTTTGTCATGATTGCACATTTTTATCTTTGTATACAATCGATGATCTGGCATGTCTCCTTCATGACTGATTGATTATCTCTCTTGGCTGCAG
>TTN-205,,0,594,3290195,3290788,GTGATTGCAATATTTTTAAAGTGAACGAATTTGTGTTTCTTTTGAACAAGATTTAAAATGTCTGGGGAGGCCTATTTTTTAGGAAAATCTTTCCAAAGGCTTAAAATTCTGCTTAAGTAATCCTATTTACAGTTAGTGGCTTATCTTTTTCTATGGATTCTACAGAGAGATAATATGACTAAATCTTTAATTGGAAGGATTATGCAATCATTTGCTTCTATAATTAAATCTTTTTTAAAAAGTGACCATATATTTTTAAATTCCACCCCGTAAGTATCTCATGCAAATTGCTAGAAGGCAGTCTTTAAAATTACAGGAATCTGCTGCTTGCCCAGAGACATGCCTTCAGCCAACCAATTGCTTTATTGGTTTTCATACTGTTTTGCACCTACTGTGCATTAGGGTTGGTCTCAGAGTGATACTTTTGCTCCAGAAATCTATATGCTTTTCTTTATCTCCAAGTTAATTCAAGAGACATTAATAATTCCTGATTTTTAATAGAAATTGCATATATACGTGCGTTTGTATATATATAATTGTGAGAAGAGCATTTAGTAAATTAAAGTATTTGTTACTTTTATTCTGTTCCTACAG
>TTN-205,,0,139,3290789,3290927,GTTTGTGGATTCTTAAACTTTCATTTCTAGAATTAAAGTATTATAATCAAATATGAACTTAGGGAGAAATTTCTATTTCAGTAAACTGACATGGTCCAGATATTGAGCCTGAAACCTTGTCTTTCTGCTCTACTATTAG
>TTN-205,,0,778,3290928,3291705,GTATCGTTTATTTTGCAAGTGGTCCAACAAAAGTGTAATCATTTTGTAGTATAGCCTGAAGGTGTCGTTTTTATGATGATGAATGCAATTTAGGACATTTTTAAACAAATGAAAAGAAAATGTTTAAGAGGAAATAAGTTTATCTAGAGAAGAAGTCATTTTTTAAATCTGTATTTCTTTCTTTCCTCGAGACAGGATCTCATTCTGTCGCACAGGCTGGAGTACAGTGGCGTGATCTCAGTTCACTGCAACCTCTGCCTCCTGGGTTCAAGTGATTCTTGTGCCTCAGCCTCCTGAGTAGCTGGGATTACAGGCGCCTGCCACCATGACCAACTAATTTTTGTATTTTTTGGTAGAAACGGGGTTTCACCATGTTGGCCAGGTTGGTCTGGAGCTCCTGACCTCAAGTGATCCACCCGCCTTGGCCTCCCAAAGTGCTGGGATTACAGGCATGAGCCACCACACCCAGCTTATAATCTATATTTCTAAAACTTTATATATTCCCTATGATACTGAGACTACCCCTTCTTTTTACAAATTTGTGATTCTCTAAATGGCCATGAGTTACTTCTTATCATCCACCTTGTAAGTCAAAGAACAGTTTAGAATAAGCTCGTAGAAGGAGGCTGAAATGTTTAGGAACATATTCTGATATAGTGTATTTAGTTGGTTAGCCTTGATTTTTAACTAAAAATATGAGGGTTTTTTTTCTTGAAAAGCTTCATATTAGTAATCTGCTTCTAGCTTCTACTTCATATATCCTTGCAATTTCTTATAG
>TTN-205,,0,1752,3291706,3293457,GTGAGTTATCCTCACAGCCCCAACCTGTTGTGTTTTTCTTCACTGCCTGTTATATATCCATGAGCATTTCTTATGATATCTTGACCAAGTAAGTTATAACAAATATAAATACACATTATTTAACTGTGTATTTATCACTCCATATGTTTACTAAAAATATAAATTATTGTAATTTAATTATGTGGCTTCCCGAAGGAGGTGTCATTTAACGGACTAATATCTTAGGTTTCTAAATCATATCCTAAAATTCCTTTAGGTAGTTAGAAGTTTCAGCGTACTCTGAAATGTGTGCATATGTGACATATATTTTTATGAAGCACATTTGTTTTGAAATTTTTTTAATGTTCATCACCAAATATCACATTAACTTGACTATTATTGAGTTATATATTATATCACAGTCTGAAACTTTCTCCTTTCCAAGTGTATTTCTAAAGGATTATTGTTTAATGTATATTGCCCAAAGCGTTTGACCTGCAAACAAATATTAATCCCAGACAAAAGGGTAACATTTGCCCAAAAAGAAAAATAATGGGTAGAAAACATTGCATATCATTATGGAAGACATATTTAAATACACAATCATCGCTTGAGAAAATGAAATAGACCATGTTGTTTAAGGATATCTTTATCTGTTTCTCTTCACTGTAATGGCTTCCAGTAATTACAACATAGCTTCATCAAAATCACATTAAAAACTAACCTCCTAGAGCAGCCTGGAATTAATTACCAACTCTTATGATCTGGTTAGTTATCTCACAGTGCACAGGTAGTAAGTTATTATTAATAGGCTGATATCACTAATAAGTAAATATCACTGAGTTGTCTTAAAATTCCAGTTTCACCACTCATTTTGTGGAATTTAGATGCATTTAGTTTTAAAACACATTTTATAAAATGAAAAATATATACTTAGCAGTGGCTTATCTTCATGATTTACACTCATGATGGTTTTACCATGGGCAGATAAATGCTTTCTATAGAATTCTGAAGCTATTTATAAAATGTTTTTAAAGGATAGACATCAGAAGTTTTAATCTTTGCAATAACAAAAAAAATGGCCTTATTCTTTCTAGGTACAGGTCTCAGAACCATTGAACAAAATCATTACATAATACTGAGTTGTACATTGCCTTCCTATCATGTTACTCATCAATGTCTTCATCATTGGTCTTCAGTTAAACACTGAGCCTCAACTCCTAATTCCCTTGGGCTAAGATTGGATTTTAAATGCTACTGTGGCTGCATTTAATAGCTAAAGATGAACATCAGAGAAAATCACATATAAATATGTGGGCTCATGTATTACTCAAATGCTAGCTTTCTTTCCTAGAGGGTAGCAATCATTGCCGCTGGAGATAAGCAGAATTCCCAAATAAGCCCTTCATTTTCAGGGTTCAGCAAAAACACCGCTGTACACAGGTTTGAGAGAATTAATAGTGTGCTATATGGCAAAGAAGTTCATAGTAACTGCCAATGTCTGCAGTGCTTAGTAAGGACACAGAGGCTGGGGCAATTTGTGGGCAGCATGTGATGTGTTCTTTGCTTGTTTTTAAACCTTTATCTTTTTAAAAAATCCAACAAATTTAAACTATTGTCTTTAGAGAGGAATAAACCAGGCACATAATTCTGTCCTACTACAGCAACAGTGTTACCTGTTAGAGGCCAGTTTTTCTCTTTATTTGTTTCTCTTGTGGAATTTAATACTTTTTTGCCTTTATGTTCCTCATGAAAATACCTTTTCAATTCCAG
>TTN-205,,0,571,3293458,3294028,GTACAGACACCTCAAAAGTATTATGCAGCTCAAGCCAGCAACCACTCATGTTTATTTGCTTATTATGATTTCCCTAGAAATGGAATTAGATTTTTAGAAATATCAGTTGTTGCTCATCTGCAATTTGTAGGCTCCTTATTATAATTGAAATATTAGGTAATTTAACAGAAATAATGTCAATACAAAGTATCTGAAATTACTACAAGTTTACCACCCTATTTCTTGAACTTCTTTTCACCATATCCATTAAGATGTAATTAACGCAGTTCCAAAAATGATGCTATAATAATGCGATAGAAAGTAGGCTGTTGTGATACACCTGGAAAAAATAAAACCAAGTCTAAAAATATTGACACTACTAATATGATTATAGTTCAACCTTTGATAGCTATCATTAGCATAAATGTCTGAGAAGCTGCTTTATCTTCTGTAACCCACCCTTACATAGAAAGAGAATTCTGCAGTACTTACTTATCAAACTGCCAACCTCCTAAGGCTTATTTTACAAAGGGGGATATGTATTGTAATTCTGAGGTGATTGTAGTAACAAAACATGTAAATGTTTTTTCAG
>TTN-205,,0,122,3294029,3294150,GTAAGTGCACTTCATGAGAAGTACATCTTCATCTATCTTATACCTTTTACTTATGATTTAATTTTGGAAGAACTGATTTTAGAAAATTAAATTTTTATTCACTTGTTTTCATTATTCCTTAG
>TTN-205,,0,1096,3294151,3295246,GTGAGTTCAATAAAAACCACAAATCGTACAATCAGCCCTCCATATAAGTGGGTTCCGCATCCACAGTCAACCAGCCCCAGTGGAAAGTATTAAAGAACAAAAAATTTAAAAATACAAATAAACAATACAGCATAACAACCATTTACACAGCACTTACATTGTATTAGATATTATAAGTAATCTAGAGATGAAGCATATGGGAGGATGTGCATAGGTTACATGCAAATACTATGCCATTTTGCATCAGGGACTTGAGCATCTGGCCACAGGCCTCCTGAAGCCAATCTCCCAGGCATAGAGAGGGATGACTGTAATGTCCCATTCACAAAAAGAATCTCTCAAGAGTCATGGGCCATCCATCTCAAGATTCAGATTGTTAAAGAACATAGGCATATAGACATTTTCACAGAAGCAGATAAGCAAATACACAACATCTGGGTGTTCTTGTTTCATTAGAATCAATTTCCGAATTTAAGAGAAAGTTTTAAGAATGAGGTGAATGTCTATTAAGATTTTTAAACAAAAAGAAATGGCCTATAAAGAAACCCCAGTATTGTCTGTGCCTAGGTATGAAACTTTTTTTCTATATATGATTTCTTATGTTATGAATGGTTCTCTAAAACAACTGTTTTAAACATTTTCCATAATTATCATTCATTTCAATATGGTTCATTTTTCAACATAATTATTAAATTAAATCCACACTCAATTTCCACACATCGTTTCCGTGATATGTATACTATTCTATTATTAAAGTTTTCCATTGCTATTATTATTTTTTCTGATATTATAATTCATTAGCTAGGCTCTTTGGTTATAAAGTTTACAGAAATACTTCTATTATCCTTTCCCTTCTTAAAATTTTCATTCCTACATCTATATTTTATTACAATGGTCCTAATCCATCTGATCTTAATCGACTCCATCTCCAAACCCACATTTTTAAATTGTTTCACAGCTAACATGGTAAAATTAATATTTATTGAATAAAGAACATAGAAAACCTTAATGAAGTATATAATCTTTGAATGATGATAGACAATTAAAAATAAGTAGAAGACAGGTGTTTTATCCTTACTTTTTAAATTTTATTTAG
>TTN-205,,0,207,3295247,3295453,GTATGCTCCTTCATATATAGCATCATGCTAAAAAAGTCACATTTAAAACATCTCACATATTCCCTTTGAATTACCAGAATCCTATAGTTATATGACGTCATTTAATATGACCTAACCAGCATCCAGAATGGAAGCTGAATATAGTCATGCGTCCTCTAAATCAAATTTTGTTTCATCTGTAATGCCTATCATTTTTGTTCTTCTCAG
>TTN-205,,0,99,3295454,3295552,GTAAAAAGAATTATGTTGATAATAAAATGAACAAGTTATTATTGAGTATTATTATAAGGGAAGGAGTAACAAATGTGTTTTAATTCTTTATTCTCCTAG
>TTN-205,,0,102,3295553,3295654,GTAAGTTAGAAAAGGCTTATGAAATACTTGTGAGATTTAAATTACTGTTGAGCACATCTGCGTGTGATATTGAACAAAATGCGTGTTGTATCACATGAACAG
>TTN-205,,0,1483,3295655,3297137,GTGCGTGAAACACTATGGAGTCCTTGTGGGTACAGCATAGGTCAATGGCAAATGTTGTGCAGGACCCCTGCAACCCTACCTGTAGACACACACCAAAGTGGTCATGTGTTCTTATTTCCCAACACACGTTCTCATAGTATTCATCTCAAAGTTCATACAAAAGCACAAGGGAAATATTCAAATGAGTGTCAGTTCTTTTGCATCGTTCTTTTAGATTTTAATCTAGTCTAAGACATAATCTTTAACAGTTATTTCTGTCTAAAGTCTAAATTTCATGATTCTCATATCTAGGATTGTAGAAAGAAAGCTAGGAAAGGACAAGATCTCATAGATGTAAATCTGGAGGATCTTGGCTAGGAATTGATATTTTGTTTATAGGACTTAGTCTGACTTTCTCTGTACAAAATTATATAGATAACATAAACATGTCATGTGCAATTAGCAACTATTTTTCAAAAATATTTATTTCATTTTCAGATCATGTTTCAACCTTCTGAATCTCTGAAATTAAGTGAAATCTCAGAATTTAGGAGTAACAACATTCATTTCCTAATTGATTATACACATTTTCCAAAGACACCCTCAAACTGTATTGAGAAAAATTTTGGCTATGATAATAGCATCTGCTTTCAGCTATTGGTGCCCATTCGTAGTTGCTGAAACACAAATATATGACATTGGATTTACATAAGCATGTCAACTTTTCTGACTTACCTTACAATGAATATCAGTGACTGGTTGTATTTTAAATGGTTTTCAAATTAAAGGGCCAGCTGCAAGTACTAATTATTTTTTAAATAATTGATATTTTTAATATAATTCTTTAGTAAATAGAGCTCACCAGAGTACTGTGATTTCTAAGACTTTATGGTACTGTTATACATATAAGACCCTCCCCTCCAGCCTCTTCTAGAAAGCACTCCTGCCATCCACACACATACTTTGTTTGTGCCCATATGTACTTAGCAGATTTCTGAACTCTAAAATTTTTCTTTTTGAAATTTAGAAGTGCAGATTTCCGATTGCGTTTGAAATTATTTTACAGGAAAAGTTATACATATTAGATAAACAATTATAGATCCTGAATAGCAAAAATTATTTTACTGAGGCAAGAAAGAATTTCACAGAGGAATAAGTTGTAGAGTACAATCAAGTTTGTGTTCCCTAACACTTTTAAAATTTAATTTGACTTTGGGTCATTAGCTCTCTTTAGTATGTTCTTTATATAAATATTTTAAGAACTCACAATAATTTCTTTACACTTTGCTACATTCGACCAGCATGAATACACTTAAGAATTGGGATACTTTTTTGTTAGTGATGCAAAGAAGAGTGCATTTCTTCTCATTTTGGATTTTTGAACTTTTCTTGCTATTTTATAACTGGGTACAAAGATGGAGATTTTAAGTATCTGAGGTAAAAGCAAGTAAAAGAAATTCCTCTCTATATAATCTAACTTTGAACCCTCTTTGTACTTAAACAG
>TTN-205,,0,208,3297138,3297345,GTGATTTCATTGACAGTTTTCCAGTGAATGTATAATTTAAGCCTCGTCTGTTTTCTGTATTTCTACCCTGTATGCGCTCATGCTCTCATTCTATCTAGAATGCTTTTTTAGAAAAGACAAGTGTAAATAAACACATACGTATATTGAAGTAAAGAAGTGTTATTTGCAACATATCAGAAAACAAAAGTTGGATGATTTTTCACCCTAG
>TTN-205,,0,101,3297346,3297446,GTGAGGTAGCGCCATCAGAAAGCCACCCTGCCATCTTCGAAACACGTAGCCTACCTATACCATTCTGAACACAAAAATATCATTTTTTTTTTATTTTGCAG
>TTN-205,,0,452,3297447,3297898,GTAAGTTGTTTTGTAAAAATCAATCCTTGCTTACAATAAATTTGGCATAATTTTGTAAATCACAGAAGCCAAACTAAAATGTATAAGATATCTTTCTCTTTTGGGTAAAATATTTTTCAATAAAACTGTTATGCAGTAGAATTACTTTCAGTCAAATAATAAAATGTTAAACCTTGTGAGTCTGGCAAATTAGAGATAATAAGGTCTCACTCAGCTGATGCTAGAATCATGTTAAATAGAATAGCCACAGAATGAAACAAATTTTGACAGTGAACAAAACTTACCTGCGTGGTTGCATACAAAAGAATACTAATATTATTTTGTCTGTATATTAGATTCTGCCATTAGATATGCCTGACATATCTCAGGATCTAATAAATCAAACACACCTTAGTTTTCTAATAAATAGCTTGTTCTCAGTCTCTCTATGCTTATTACATGTCCCTTTCCAG
>TTN-205,,0,324,3297899,3298222,GTAAGACCCAGAACCTCAACATCTGAGCTTGGAGCAGCAATATTCTAGCACTAGGAATCTGTACGAAATTTTATACCAGCGACCAAACTGCAGCAGAGTCAGAACAAAACCTTCCATGTCATATTCTTCAGTGAGCAATTAGAAATTAAAGTAAAAAAAAAAAGTAGTTCCAGTTATAAATAAATGCTACTTTTATTTGTTCCGACTGATGAATTCGTACTATAATACCTATGAAGTACTGAAAGAAATGCATGAGACTTTTCATTATATTTTACGCAAAATAAGAAACTAAAACATGTTACTAACGGCATTTATTTTCTTCAG
>TTN-205,,0,2205,3298223,3300427,GTATTATACCTCATCTACCTAGATGTCGAAATAAGAATTTCACTCTGCTGACCCGAAAAATGTTGCTTAATACAACGCATTGGCCCTCTAGTGGTCAAGAGGTGGAATTGCCTTTCAAAATGTAAATTACTTTCTCAAAGTATTAGCTAACTAAATGTGTAAGTTATGTGCTTAAAACTCTGAAAATCATCAAACAAAATACTATTTTGGTATTAAAATATTTTATTTTAATGAAATTACTGAAACATTAATAGAGAACTAATTTAATGTTTCATATTTTCCTAACTACTATGTATAACAAAAAGAATAATGGAACCAATTTCTAGTGCAGCTTATAGAAATAAACCATAGTAGTTTACAGCCAAATTGCAAATTATAGCTTGTGGCTTTTCTCAATTTATAGTATTAACTACTCTTAAAAATTTACTATTTTGTCACATAAAATATGATTTAGAATACTTATGAAATATTTGACTTCTTTTGTACCTAAGGCATGATCTCACCAATAAAGAGATCTTAAGTGTTCCAAGGAATTGCTCCTCTCAAATACTCAGTAGAGAAGTTGTAGTATTTGTGTCCCAAAGCTTCTCAACTAAATTAGACAACAGATTTCCTGGGACTTTCTGGAGTTATAGGGAGTTCAGAAATGCTGTCAGAATTCTCCCAGCATGGTCAGAAAAAATTCTGTATGTCAAAATCACATTTTTCTATAGCTAAGTCACTACTACTGTATTAGATTCAAGGGGTGGAAATGGTAGGCCCTTAACACCCGCTATAATTGGCATTAAACGCTTGACCTATTTTTCAGCCAGCCTTAGAGGAAATTCAATTAGAAACTTCCAATTTTGTGACTAATGCAACCTCATTAACAAAGAGAAGCATTTTTATGATTCATACGAACATAAGCATTTTATCTAGCTGTGAGAACAGAGAGGAACAAGAATCAACAATCATAAATTGGATTTCCATTTCTATTTCTGTTGTCAAAAATAATAACTTATGTTAATGAATGATTTGTTCTTTGACTGGTAGTATCAACATGGCTAAGTTTGGTACTCACTGTGAAACTTGAGAAGTTAAATAATGTTTTAAAAATTAAAAAAGAGGCCTGGCGCGGTGGCTCACGCTTGTAATCCCAGCACTTTGGGAGGCCGAGGTGGGCGGATCACGAGGTCAGGAGATCGAGACCACGATGAAACCGCGTCTCTACTAAAAATACAAAAAATTAGCCGGGCGTGGTGGTGGGCACCTGTAGTCCCAGCTACTCAGAGAGGCTGAGGCAGGAGAATGGCGTGAACCCGGGAGGCGGAGCTTGCAATGAGCCGAGATCGAGCCACTGCACTCCAGCCTGGGTGACAGAGTGAGACTCCGTCTCAAAAAAAAAAAAAAAAAAAAATTAAAAAAGAGTGGGCTGGGCGCGGTGGCTCACGCCTGTAATCCCAGCACTTTGGGAGGCCGAGGCGGGCGGATCACAAGGTCAGGAGATCGAGACCATCTTGGCTAACACGGTGAAACCCCGTCTCTACTAAAAATACAAAAAATTAGCCGGGCGCGGTGGCGGGCGCCTGTAGTCCCAGCTACTCGGGAGGCTGAGGCAGGAGAATGGTGTGGACCTGGGAGGCGGAGCTTGCAGTGAGCCGAGATTGCGCCACTGCAATCCGGCCTGGGCTAAACAGCGGGACTCCGTCTCAAAAAAAAAAAAAAAAAAAAAAAAAAAAAAAAAAAAAAAAAAAAAAGAGTGTTATTTATTCATGAATACAAAAGGCCATAATCAAGTATGATTAGGAACCGTGGTTAAGGTATAACAGCTGCACAACAAAGGACTTTAAACCCACTTGTTACTCTTCCTCCTAACATATTTGTGTTCGTCCCTAAGGATGAAGCAAAGATGAAAATGTGTACTTTACTATTTATGATATCACTTAGATTCACACTCCATGTTCTGAAAACTTTAACTCTCAGCAGACATAAAATCAGTGAAGATGTAAGATCACAGTACATTTTCTATATCCCTCCAAAACAATTTTTTTGCATCTAGTCCTAGATCTTTCCAAAACAAATATCTTGTAGTAATATGCAGAATCTCGCTACTATCAACATATGGAAAAATAAAATATTTCAATAAAATTCCTAGTTTCCTGAAAGCATTTTAGTTACTTACACCAGAAATATTTTTTCTTTTTTTTTCTTTTTTTTTTTTTTTAG
>TTN-205,,0,1674,3300428,3302101,GTATTATAATTAATCAAAAAGCAGTCTTAACACTTTTTTCTTGGCCAAAACTTTTAAATTCTAAACAGTGGAGGGTGAAGGAAGGGTAAGAGTTTGCAATCACAAAATGGTACCTCTCCCTTCACTCACTTTCGCCCTCGTCTTTGACTCAGTCCTCACTCTCTCAACTCCTTTTTTCCCCCTTTTCTCTTTCCTGTCCTCCTGAGCCCCTGGGAACCAATGACAACACCAGTGTATTCTGGTTATTTCTGGATGAAAATTTAAAGAAGGTCTTGCCCAGAAATCCAACAGCTATTCTTTTTTTTTCTTTTTTATTTTATTGTAAATTGACTATTTACTATTGTGTATATATTTATGGGGTACAAAGTGATGTTATGATCTGTGAATACAATATGGAATAATTAAATCAAGCCAATTAACATATCCATCACCTCAAATACTTAACATTTTTGTGGTGAGAATATTTGAAATTTACTCTTAGCGATTTTGAAATGTACAGTACACTATTATTAACTATATTCACCACTCTGTGCAACAGATCTCAAGAAAAGCCATGTTTCTTCTGTCTAAGATTTTGTACCCTTTGACCAACATTTCCCCATTCCCTCAAATCCCCAGCCTCTGTAACCATCATTCTACTCTTTATGAATTCAACTTTTTTAGTTCCACATCTAAGTGAGAACTTACAGTCTTTGTCTTTCTGTGCCTGGCTTATTTCACTTAGCATAATCTCCAGTTCTATCCATGTTGTCACAAATGACAAAATTCCCTTTTTTTATAAGGCTGAATAGTATTCCATTGTGTATTTATATACCACCTTTTCCTTATGTATTCATCCATTGATGGACACTTAGGGTGTTTCCATAACTTGGTCTTTGTGAATAATGCTGCAATGAACATGGAAGTACCCAACAGCTGGTCTTGATAAAGTCACATCAATGTAAGATCAAGGGTTGCTGCTAATTTTAAGAGGTTGCTGCAACCCACCTCAGTATCTTTCCTGATTTAGGTGATCTAAATATCAATATTTGAAGAAAAAATACTTTATGAAGGAGGATCAATTCAAATCACTTTAACTTTCAATATATCCTCGAAGATTTTTAGGAAAACAGTTGGATAACTAAATTTAAACAAATAGTTTTAACTCATTTGACTAAGATTAGAGTACAGCAACCTCCATAAAGAAGGAAAATATGGAAACACAAGGCATCATTCATCATTCAGACTTTTCTGAGTGGTCATTTGTGAAACATCATGGAATAAGAGGACACTCAAAAAGCATGGATATTTCATGAACTTCATAGTTAATAATTGAAAAAGTCTAATGTGTTATTTTTAGCATTGGACATATTAAACATTCTCTTCATGCTTAATGTTAACTTATTAGAAATCAATCTAAACTAGAACCAATTTAAATGATCTTAAATCAATCTAAACTAGAATCAAACTTTGGCCTTTTGCATGTTTGATTTTTGTTAATATGGCCTTGCATAGCATTTCTAATGAGCTAGATTTGGAAATTATAGAAGCATTATTATGATTCCTGGAAGGGCTGGTGTATGAGTAGTAGTCATAGCTCCTACAAACAACTAACAATGATGTGGAGGATTAGTAAACATTAATAATAATGTAATCTAAAAATAAACACACATTTTTATGTTTTTAAACTCCCAG
>TTN-205,,0,851,3302102,3302952,GTAAATAAAGATAAATTATTTTTATTCTGTTTATTCCTGAGATTTGCACTTCTGCTAACTATTCTTATTTTAAATATTAGGCTTCCAACTTATTGAAAGTTGTGGAGTCTCCTCTGCTGTGTTAAATTTAGCATTAGAAATGATGGCTATTTCATATTGCCCCTTTCCCAGGAAAACAAACCCAGGCAGATGTTTATGCTGCCTCTGTGCAATGGTCTCAGAGAAAGAAGAAGTGAGGGCTAGAAAGGAAGGGCCATTCCTTATTTTTTTATTGTAGTTAACACAAATGTTAAGAGTCATATAAATAATGAGAGCCCTTAAGAACTTTAAAAATCTGTTATCTAAAAGTACCTAATTAACTTGGTTACATAATTTTAAATGTTGTTTTTATGAAACTGACTAAGGGATCATATGCAATAGTCAAAAACCTAGGTTTAAAATTAGAAATGTTTTTGAAATAATAATCAGAACTTTTTAAAAAGGTTAACTGTATAAATATGAAATATAAATTCCATGAACTTATCGAATATTAAAACTATTCCACTGGAAGAAACTAGGGGTTCTGCAAACTGGAGCTCTCATGGAATAATAGAAGGTGTGTCCATTTGATAATATTTATTGAATCCATTTTTTCATACTGGAAAAATCCTCAAATCAAGAGTAGAATGCATCTTGATACTCTACTATGTTCCATAGTCAAAAATTTAAATGGAACCAATACAAAAAAAAAAAACAAATTATCAATAAAATAGATCTGAAATACTGATGTTGTTTAACTAGGTAGATTTTTGTTTAGTGAAGCAGTTGGATGGATAGAATTAATATGCTAATAGTATCTTTATCTATTTTAG
>TTN-205,,0,454,3302953,3303406,GTATGTATAAACTGAATGACTTGTTTCCCTCTTTTCTTCATTTTTGCTCAGTTCATTAAATTTTCAATGCTATGAACCTGATTTGCAGTTTATGTGAAATAGTTAAAATGATCTTAGATTTTTTTAAGGTTAGAAATCTTTTAAAAGTTATTTTCCTCAGAGTTACTTTCATGCTTTGACATTACAAGCTAAATCATTTAGTCTTATTACTAACACTAAATTCCAAGTGCTAATTTCTAATGCAGAAGTTCAAGTTTTACTTTTACTGCCTTGTTGCATCTCTGCTTGATCCTGCTTCAAATCCTAGCACTAAGAATTGTGTTGGTAATAACGATCCCAAATATAATACTTCACACGATTATATATTATCCTTACCTTATCTCATTTGCAATTAACAACCTAAGAGAACTTACCTATTTAAGCATCCCTTCTTATTCCTGTGTTTTTATTTCAG
>TTN-205,,0,441,3303407,3303847,GTAAGTAATTAGAAATATTTAAATAGACTAGAGCATCAACATCATTATCATGGCTTGTTTGGCAGCAATGTATAAATCAGCAGTTCAATCCAATAGGCACAACTTCTTCTCTAAGCTTTATTGTGAATGATTTTTTTTTCTTAAAATTTCTATCTAATTGATTTCATTAAAAAATCAAAAGATGATAAAAATTGTAATGGTAAACTTAAATATAACCAAAATATGTTAAGTACAGAAACTTGTACCCAGAGTTCAAAGTTGTGCGTAAAGGTCAAAGAAAAAAAAACCGAACTCATCTCTCTCTTTAAAAAATGATACATGTATCTGCATATACACTTATAGGTGTGTATAAACACATATACACAGAGAGAGAGAGATAGAGAGAGAGAGAATTTTAATAGGAATTCTAAAAGTACTGCAATTTCTCTAAAATGCTTGCAG
>TTN-205,,0,152,3303848,3303999,GTATTATTTAAAACATTCCTAGCACCCATGTACACAAGTAATATGTTTACTGATCTATACTCACATTAGTTATTTATATAATCAAATACTTTTAAATTTTGTGCAAAGCAATATTCTTCAAAATACAAATATATTTGTACATATTTTTAAAG
>TTN-205,,0,590,3304000,3304589,GTATACATCTTTGTGTTTCAGCTACAAGTTCAAAATTTTTTTATTTATGTGTATGGACATGTGTACATATATTGCTAAGTAACTCACAAATCTGAAACGACCAAAAACAGCACATTTTTACATAATACAAATTTTATGTTGAGTTGCACATATGTTTAATTTAAATAGTAACATTATCTACTTTGTTTCTAGTTCTGCTTAAAAATTACATTTTTTTATTATAAAGAAGGTTTGTGTTTAATTAGTAGTTTGCTAACTTCACTATGCAATGCATTCCATTGCATATAATATTCCCTGTCCTCTTATTTATAGAAATAGACCCTAACAGATTTGGAAAAGCACAACATTGTGTGTGAAGAAGTTGTGTCTATTTGATTCTCATTTAAGAATGTTTGATGAAGGCTGCATGCATTGTTTGTCCCTATAGATCAAAACATGATTTGTTTTCTTGTCAATACTGAATTTGTTCTCAAGCTACCATATTAACCCACTCATTCTGTGTCTAAATACTTGAGTATAAAATCCATGTGTTTGATCTGATGTCTTGTACTAAAAAAAAGGAATACTAATGTGAAATACTCTCTTTAAAG
>TTN-205,,0,232,3304590,3304821,GTATAAGGCAAACTGGAATGTGGGGGCTCAAATGGAAGGGTTTTAGGCAGATTTTTATCCCTCTTGTTGTCTAATTTGTGATCGTGTAGACATTTCTGTCTCCTTGTAAATTCTGTCATCTTTTTCATTTCATGTTTGTCTCTGTTTTCATTTTTATTTTAATGTTCTTTGTAAATTACAATTACCACCCACAACATGGCATATCAGTAATTAAAATGTACATTTTTTTAAG
>TTN-205,,0,1028,3304822,3305849,GTATTAGTAATTCATTCTAAGTTTAAACTCTTTTAATAAAAATTAGTACAAATACCATAGTAAAACATTTATGTTAGTATTAAATAATAGATTTAGTCACAGTGTGCATACCTATAGCCACTATGTACAAAGGATGTGATGGGGGACGGGAAGAACCATGAGGAAGGCACAGGGGGAAAAAAGTGAAAATTATGGGAGGCTCCATTCCCTGCTTCAGAGAGTTTGCAATCTCGTAACCTGTTACTTGGAAATACAGTGTCCTGGAGCCAGTTCATGCTAGCTCACCAGAGCCTATGGTTACATTTTCAGGAATTTTGCCAGTCAGTAGTTTAACACCACCATTATTAAAAATTAGATTATGTAAATTTACAGTCCAATAAAGTATATTTTTAAATATTAATAAATACTCAAAACTCCTATTTTACTGCATTTTGTTCTTATCTGTGTTTCTGAGATTGTTTCCATCTTTGTGTCTGTGTGGTGGAAATGCCATATAATGTACTACTGCACATCTCTTTCCAACTCCAGGACAATGACATCACCTTGACAGCCAGGGTGGGAGGGAGTGTTTATACCACCTTGGAAATCGGAAATCTGCAAGCACTATAGATCAAGGCTCCACCCCCTCCATCCCACCCAAATTGTTAAACATTTAAGACACAAAAAAATCTAATGCAATTGTATTTATGAAACTGCTTTATAAAAGTAAAGGTTACAAAAAAAAAAACTAACTTCATAGTTATCGATGTTCATAAAAAGCTGGTTTCTGAGGAACTGACACAGGCACCTCCGAGGGAGGATTGCTCCTACCTGTTCCTGACAAAGTAGAGGCTTCTGCAGTTAAAGGTGACAGCAGTCACATTTTCTAATTAGCCATTCAGCCATCTTCATTTACTCTCATTTCTAAAGCATAATTTTCTTGCATTCAGTTGGTATAAAAAGGGAATCTCTATTTAATTCTAAGTCTTACAACAACATATGCCTTGTCAAATGCACACTTTCTCAAAAATGGCACTTTTCTTTTAAAG
>TTN-205,,0,397,3305850,3306246,GTAGAATAATATTTGTGAAAAAAATAATTCTTAGCATCCATCTTGTATCTTTTTCTATAAGATCTGTGTATTAACAAAATAGCATCTGTAAACCATCTATAATATATTTAATTCTGTGTATATTGATTTCATTTATTTGTGGTGATGTGTTATACAAGTATTGGTAACATTTCTAAACTCCAGATCACGCTAACTGGGTCTTTGTCTGCTTGTGTAATGTATGTAATGTCTATATGGTGTTGAGGTATTTAGCTTTCATTTCTACCACAAGTAGGCATATTTAAATTACTTCCTAATTCTCACACTGTTAGTGAAGATTTATGCTTTAATGTAATCTTAGATGTCTCAGAAGGTGACTAGAATATTCCACATTATTTCAACAATTGTATCTTTAAAG
>TTN-205,,0,2119,3306247,3308365,GTACGCCAGAGCCAATGATGGGGAGACTCTTTGCTCCAAGTGCCAGCCTTTTGCTTTCTACGATCTTCATATGTACTATGCTGCCTTTGTCTTTTGTCTCTTTTACATTCTTCTTGTGTTTTTACTGTTTGTCAGCTTCCGTGCCATGCTCTTGACATACTTTATTTATTATACTGAATATTCCTAAGACATCACCAAAAAGTATTGTTAAAGGAAGTAACTATGTCAAACTGCTATCTTACATTTTTAATATCTTCCCTCTTTTAGAGAAAGAGGAAATGTTTGTGAAACTTGTTTTCTACTGACATGTTTCTAGGAAAAAACCTTTCATCCTTCATAAATGTAACTTTTTCTTAATAAAAGCAGTTTCATGCATTATGAAGAGGTGGAGACAGGCAATGACAACTGGAGAGTGTCTGGCAGAACTGAATGTTAATTACATAAAGACGTACATAGTACCACGCTTCTTAAAAGTCAATAGTGGCGAGTCTTCAATAGTGGGGAACATACAGATTTTTTGAAGTTTACTTTCACCATTTTCTTGAGACCTTAACTGAGCTTCAGTATTTGCCATAAATGTTTCCGTTATCTAATTAGCTAGTCAAAGTACCTTTCACAGAGGTATGTTTGAATGAAAATGTGCTGCTGTGGTATATCACAAATCCCTTGCTTTGGTTTGTTTGGGATTTTTTTGGCGATAAAAGGCACTATCTTATTGAAGCACTGAAGCTACAATTGCACGCATCCATTCAGTTATAGAGAGACTCAGCAAGAATTCAACATTATCCAATTTAGGAGAAACCAGACCTAACTAAAATAGTACATTTTGAATAGTGTTCCCTTGGCCTGACTTTGCAATGTTTCTATTTTCTTCCTGAATCAAATATGCTTCTCTCTTTCTCAAACTCTTGGCTCTTTCAAAATTCTTTTGATTATCTAACCATTAAATACAAAGGTCATGTTAGTAAAACCAATACTAATACTAAAGCTACTTGAGACAGATCGTCTTAGATAAATTAAATCCATTGTTATTATGTACTACATTTCCCCATACAAAGCATAAAGAACCTTTTCTATATACTATCTGAACATTCTTGACTGTTTGTGTAATCACTAATTCGTTTTCAGCAAAGTCATATATGTCTTCTAAAGGAGACACAGAGGCATCTCTCATTTACTCATAAAAACAAATACACATAGTATAATAGCACGTATATATATATAAATACTGCATGTATATATAGCATAACATATACATATATAAATTAACAGCTATATAATTGCACCAAAATATTACAAATGCACGTGCAGAGGTGCAGGGATTCACAAAAGCTGCCAATATTGTATTTAAAATGAGAACAATTATTGCCAATAATGCATGCTGTTAAAATTCATCTTCCAATTAAAAAGTCAACATTATCCATTCTTAGAATAGATAAATCAAATACACTGTAAACATTTTTTAGGTTGAAAACCCTGTTCAAAACTCTAGAGCCCCTTAGAAAAAAAAAGCACAAATACACATACCCACAAAATTCTGCACACAAAGCTCTGTAAAGTCATTAACACATGGGTATCAGATTGAGAGACCTACTCTAGAGTGTTTCCTGAGTTTTGAATTCACTACAGGCACACCCCCCAAAAATGAGAGGAGAAATGTGGGGAAGAGAAGTAAGTTACACATATTCAACTATTCTAAGACTTCTTAGTCTTAGTCTAAAATAGTCTTAGATAAACTAAAGCCATTGTTATTAAGTACTCCATTTCTCAATACAAAGCGTAAAGAAGTTTTCTATATACCATATCCACATTCTTGATTGTTTGTGTCATCACTAATTTGTTTTTAGCAAGGTCATACAATATATAAAGGATGAATTCTGTGCACAACTTTGTTACATAACTCATTTTTGCCTAAATGCCTCTAAAACATTATTTGTGATATTTATCACATTGTGATCCTTGGAATAGTATAGTTAGTTTAATTTTCTGGATAATTTTGCTGATGCATAGATAATCCATAACAACATTAATGTACTACATAAAGATTTGTGCATGTGCCTATGTTCTTTCATAAAAGTGATATATGTCTGAACTAACATTGTGTTTCAAAAACTTTAAG
>TTN-205,,0,217,3308366,3308582,GTACAGTGGCTTTCGACGTAAAGCCCTATCTTTTATCTTTGATACAAAATATGTTGTGTTTAATTATCTGTTCATTGAGTTAGTTTAATTCTAAATGAATGTTTTGTGGTGAGAACTGAACAAAAGTGTCTGTCCACCCGTCTGCTTTCTTAAAAAAAATAACTGTGCATAGCTACTTTAGAAAATATAAAGTCAATTCTAAAAATGTCTCTTCAAG
>TTN-205,,0,141,3308583,3308723,GTACTTAATCCCATCTCCATGAAATAACCTTGTCTTTCCTTCAAGCCTCTTTAATTGCATGTCTTCTTTAATTGCCACTTCTATGTTGCTCATTTATTTGGCCTTTTTGACAAATTTTAAAATTCAATACTATCCTTTAAG
>TTN-205,,0,153,3308724,3308876,GTATTGTTTCTCCATCTTCCCAAGAACTGTCTTTATGTTCCAGTGATTTTGTTAGTTTTGTGATATGAGTGCACTGTGGGTGTATTTCTTTGTTTTGCACTGGGCTTCAATGAGATCACATTAAATTTCTAAAAGTGCATAATGTCTCTAAAG
>TTN-205,,0,274,3308877,3309150,GTAGGATTTGCCTCAATCCTCTGACAAAAAAAAAAAAAAAAAAAAAAAATCTTCGAGTGTGTTAAATTCTTGCTTTTTCCATCTGGTCTGTGCTTATACTGATCCATTGTCTCACTTGCAGTGAAACTTTTGTGTTTATGTCCTTGTGATATGTAACTTGTTTTCCCATTTTGCTAGTCAAAGTGGTGTACTGTGCAACTCTTCCCCAAATTCTAGAAAGTGAGAATTGTTAAAATTCTTGATTTTAAACTTCAACTTTAACACTTTCTTAAAG
>TTN-205,,0,452,3309151,3309602,GTATATAATCGGAAGTCAGGGGATAAATGAGTTTGTGTGTGTTTCCTCAAAGTCTCTTCTTCTTCCACATGTGATTGTTTACTTTAGAACATGTCCTCATCAGTTATTTCTCCTTATGTTGGTATTAGAATGTGTCTACCTTTTGTAGCCTTCTGGGACTGAGTCTTTTGTGTCTATGTTGGCCTTGAATCATTCGAAGGAAGTGGATGAGTCCCGAAAATGTTATAATTTTGAAAGTGGCCACACTTGGACATAACTCAAGTATCATTCTCAGTCTTGGGCTGTACTTGCCCTCATCTTAAATTAGCTTCCTCCTTCTTATAGTGAGGAAGTACCATGAAGCTATGTCCTAAGCAGATAGAAGAACAGTTATCCATCTGTAGTGACCACATGGCTGTATATACATCTGTATCTCAGCAGGCTGAATTTAAATGAAACCTTATCTTTTAAAG
>TTN-205,,0,2512,3309603,3312114,GTAAACAATGCAAATAAGCTAGAGATGATCTGGGGTTTTGATGAGGTGTTTTCTTTCACAAATTGTCTACAGACCAATGAAAAGAGACAGAAAAAAGTGACACAAATTCAGTGAACATCTACCAGTCTCATTAAATGAATATTTTGATCAAAACACAAGATTCAGGAGGATTATACTAGATTAGAGAAATCCAGTGTATTTCTTCTGCATCCCTTCTTACTTGCCTACATAGAATAAAAGAGGCTTCATATTTATATATAATTAATCAGGGCAGGTATCTCCATATACATATATCCTTTCATTAAACAGGACTTGGCTTCAGCATGGTGGGCTGGCATAAGCTTTACCTTAGTAGCCTAATGCCTAATTGGTGTTTCTCAAACATTGCTTGTACCACAATCCACAGACAGAAATATATTTTATATTATAATCCTTTAATTTTTTTATTCTAGGCATTTAAAAAATACAAGTTATAATCCATTAAGTCAATTGCAGAAGTCACTATAATGTCTTAAAATGTTTTAAAATGAGCAAGAAAATATATTACCTCATTACATTCCAGGAGTCAATGCCATATTTGTGAGTCTGAAGCCCTGAACACATAAGGCTTTCCTGTATTTTACATATGGAGAAAACCATTGTGTTATATATGGGATCAGACTGACTTGTTACTCAGATCTTTTCATACCTATAATGCTAATTATCTATAGTTTCTTAAGGACAGAACCAACAAACTATTCCATTGGGATATTTTTTCAATGAATTAAGGCAGCACCAGGTTTCCAACTAAAATCCAGCATTCTGGCTAGAGCCATGTGGCCAAAAGAACTTTCCTAAGAAAGTTCCTAAGGTCTGCTTTTAAAGAGAAATCAATAAGCTCCTTAACCAAACTAACTCTCTCCCCAGTGAGAAGATGAGTAGAATTGAAGTACATTTAGATGTCCCAAGTATCTGTTTTTATCTGTCTAATAAAAGATGGCACACCATGCCCCTTTTTTCACTTGGAACAAAAGCCCATGTAAAAATCCAAGGTGCCATAGTCTTAGTGGAATGCCTTGGAATAGGCCAAGATGGGACATGACTCCCAGGAGGAAATCCATTAACTCTGTTGTGCTTCCTGGAAGAGGCCATGATGGTGGACATAAGTCAGGAAGCTGGTAGATTTGAAGACGACTCCATCTTTTCTAAAAGTGTTTGTAAAACCAAACATAGTCTGATTTCAACTTTTGACACTATAAACTTCCTGTAGTACTCCAGACTCTAGTTAAAAGGAGAAACACTGTGATTATTTTTATGTTCTCATTATGCCCCAAAGATGGGTGGCTTGTTAGGTTTACTTTCAGCGTAAGGAGCAGATATGTTTTTAACCAGACACTTCTATTCCTTATTTAACTTTGACCAGGCATGGTGGCTCATGCCTATAATCCCAGTGCTTTGGGAGGCTGAGAAGGGAGGATTGCTTGAGCACAGGAGTTCAAGACCAGCCTATGCAACATAGCAAGCCCCATTCTACAAAAATTAAAAAAACAGCTAGGCATGGTGGCATGCACCTCTAGTCCCAGCTACTCAGGAGGCTGATGCAGGAGGATCATTTGAACCCAGGAGTTCGAGGTTACAGTGAGCTGTGATTACACCACTGCATTTTAGCCTGGGCAACAAAGCAAGACATTGTCTTAAAAAAAATTAAAACTGGCCGGGCGCGGTGGCTCACGCCTGTAATCCCAGCACTTTGGGAGGCCGAGGCGGGTGGATCACGAGGTCAGGAGATCGAGACCATCCCGGCTAAAACGGTGAAACCCCGTCTCTACTAAAAATACAAAAAATTAGCCGGGCGTAGTGGCGGGCGCCTGTAGTCCCAGCTACTTGGGAGGCTGAGGCAGGAGAATGGCGTGAACCCGGGAGGCGGAGCTTGCAGTGAGCCGAGATCCCGCCACTGCACTCCAGCCTGGGCGACAGAGCGAGACTCCGTCTCAAAAAAAAAAAAAAAAAAAAAAAAATTAAAACTGTATACACTTAGGCTCAAAAATCATGTGAAGCCTCCTGCCTCTTCTACCATACCTGCCCCACAAAACTGGCGGGGAAAACAATATGGAATATTATCTTACAATTCACTTAAATCCTCAAGTATGTTTCTGCCCTGTGGCCTTCAAATCTACAGTGCTCTGCTATTTGTGAAACTCATCTTCAAATTCTTCTGTTCTTATTAACTCAGCTATTATAATCGTTTCTTGTCCCGTACTTGTCCTGTCGTTGCTGTGGATATAAGCATTATTATCTGTATGACACATTTGAAAATTAAGTTAATGAAACCTATTTCCCATTTCCCATACTCTTCATTAACGCATGTGCTTTGATTAAAATGCTCTTTGAGTATTTTAAATAGGAACAAGCAGGGGTTTGGCAAGGGTTAAACTTTTGCTATTTTGATTACTCTTTGAAGTGATAAATTAAAGCTAAAAATAAACATGAAAAACACTGTAATTTATCTTCTTTAAAACTGCTGTCTTTAAAG
>TTN-205,,0,187,3312115,3312301,GTATGCTGACTCTTTAATTAGTTTTATCCCTATGTTAGCTTGTCTCCTTCTTTATGTTTCCTTATAGCTAATTTGTCATCCATATTGCAAATATTGATAAATATCATGTCTAATAAAAAGATCCCTTACACTTTTATCGAAAAGAAATCTAGACATTTCTACAAACATATTTTATAATCTTTTCAAG
>TTN-205,,0,263,3312302,3312564,GTATGATTTCTTTCAAAGAAATGCAACACTATTTATTTTAATGTATATAATAATACCTTCACATTTGCATAACTGTCTTATGCATAACAATTTGCATAACTGTCTACGTTTTGTCAGAACACATGTATGAACGTATTTACTGAGTATAGTCATTAACGTTTGTATATATGTGCAATCTTTTCAAAAAGTGAATGCTAAGCCCCACAACTGTGTCACTTCATATGTAAGGCAAACTCATATTCTTAAACCTAATCTTTCTAAAG
>TTN-205,,0,156,3312565,3312720,GTATATTGGATTTTATTTTATTCTCAAGACTGTCTTTTTTTAATCTTAAATTGATACATTCTTCAGATTTTTTAAACATTAACCAGAAAATAAGTGTGCCTGTGTTTAGTGTTTTCCATATCGTATGTTTGATGGTATTGCCTGGTATCTTTTAAG
>TTN-205,,0,252,3312721,3312972,GTAAACAAACCTCCCCAGCAGAAAAACTAGGAACATATGGCTTGTCTTTCTTTCTCTCTGCTGCTGTTCTTTGGGTCATACTGTTTATATGTTGGTGGGTGACAATGGTGTCTTTGGGTAGAGTATTACTTGTGATGTTTTTGTGTGTGTGCCTTGTAAATTCTTCTATTCTAAAATCACAGTACTTTCTGGCTAGTATATTTTTTACGTCCACTTTGATATAACTCCCTAATCCTAAAATTATCTTTTAAG
>TTN-205,,0,247,3312973,3313219,GTACATCCGCCCTTCCATTATGCACAATATTGTACTTGCCCTACTCTCTTTACCAAATACACTGGTTATGGGGGCTGGTTTTTGTTGTTGTTGTTGTTGTTGATGTTGTTGTTGTTGTTACAGTTGTTGTTTTATGTTTGAAATAATGAAAATGTCAAGTGTTTATGTTTGGGCTACTACTTTATGGCTGCCTTTTTGTGGTTTGAAAGAGGGAAACAATACTTTAAAGTGAAATCTCTCTTTAAAG
>TTN-205,,0,707,3313220,3313926,GTATACTGACTCTTAAAAAAAAAAAAAAAATCAAAATAAGCATCCAGACACTAAAACTAATCTAGTGGAATAGGTTCCATTAGAAAAAAAAAGACATAGTATAAAGTAAGCAATATAAGTTTGTTAATGCATATCACTTCAAAACTAAACATTTTTGATAACAGAAAGTACTTTTTTCTTAAAAAAAAGTGAGGCTTCTTCTAAACGTATGTGAATAATTTTCCTTAATCTGTATTTGTCTTCTAATGTCTTTTCCATATACTAAACTCATCTGCCTAGATGCTTGCTTTATGTGGCAATCTCTGATGAAATTTTTAATTTTTTCAATTCTGAATTTTCTACATTGTACCAATAGAGCTAAGGAAAATGTCTTAGAAGTGAGGTGAAGAAACTATTCATGTAACATAGGTTTCTGTCTAATGCTTCTACTTAGTTTGATAGTCATTATTTATGCTGTTTAGTTGTCTTTTTAAACTTTTATAAATACTACTTGATTTTCCTAAAATTATTCAATGTCTTTGACGTACTTCATATGTATATTAGAGTAAGTTTATTTCCAAGTCTATTGATTTTCTTGCTTTTTAAATGAAAGTTTAATCAGGCACTGTTATGGTTGTCTTTGTCCTTGAATTGTTTGAACAAAATTTCTCTTCACACACACATTTTCAGAATCTTGCAATTCACTTTTAATAATTACTCCTTTAAAG
>TTN-205,,0,307,3313927,3314233,GTATATTGAACTTTGATTAAGTAATGTGAGGCATGAAACTATCTGGCTCTTTGCCTTCTAGTTCCCAATCTGACTCCTATACTTTATTAGCTTATTGTTGATTAAGGGCAGGGTATATAACATTTGAAATCACAATTGCTAAATATACTCTATGATACCTTGACTGGCCAAAAAAGAACAGTCAGGGTCTCCCATAATCAGTGCATGAAACAAACGCAAAAGAATAAAATCAAAGCACATTGTTACTATCAGTCATCCTTAAAAGTGCTTTAAAGTAAAGTGCTGCCTGTTGTTAATATTGTTTCAG
>TTN-205,,0,958,3314234,3315191,GTATGAGCAAAACTGCAAACTCAAAACCACACTAAATATGTGCACACTCAAACAAGATAAAACAAGATAAATCATAACAAGATAAAAATTTGGATACCCAAAGAAATTTGGAAAGAACTTTGTTTCATTTCGCAAATGCGGAATTTTCTTCTTTGATAACTTCTAGAAAAAATTTTAAAAACCCTCTATAAATCTTAAGGTTATTGTTAGACTTTTGTTCCGGGAATAATCTAATACCCCCCTCATTTTTGCTCGTATGCAAAATAGCAAATGTCCCTAAGTTTCTTTTTCAAAAAGGTTACAAGTTTATCTTCAAGTGCCCGTGATCATTCTAGTACATGGTTAAAAATTTCTGAACATCCTTTATTCTAAAACTTGCTATTACGGAGTATGATAGGCTATTGAGAAAATGTATTTACCCACAGGGTTCCCATTATCAAAACTTGACAATGACTGCTTCAAAAGTTAAGATAGAGATGTAAGCTAACACAAGCTGTTGTGTTTTACCTAATGAAGGTCAAATTTGTTGGCATATAGTTTGGGCTTCAAATTGTTTATTTTACTCAAAGAATAAATCTCTATTGAAATTTTGAAATGAATCAATCTTATTTCACTTATTCAGTCTCTGATGTTTCATAGCCCAACTTTGAGAACATTCTACATAGTCTTACTGATAGCTTTAAAAAAACCATATTATAGGGGAGTTTCAGCCAGGAATTTATCTACCTGAAATGAAATGAGAATTTTAATATGTAAGAATTACCTAATTAAAGAAAATAGCAAGAAGGAAAGGGCAATATGAGCTTGTTCTGCTTGGATCTCTGATTCTTGCCTACTTCAATAGGCTATGGCTATACTGTAGATAAAAGATATTATTTCAATTATTTGATTCCTTTTAAGAAATGTTTAAACTTATATTCTAAGTCTAACATGAAATACCTTGTATGTACTTTTAAAG
>TTN-205,,0,210,3315192,3315401,GTAGAGTGAAAAAAACATTATTACCTGTAAGAGATCTTTGTTTCCTCCATGTCTGTCCTACTATAAAAATATATGTAAAAGTGGCAGTGTACAAATTATGTGTGTGTTTGGGAATATTATGTTGTATTTGTCTTTCTTAACTTTTTGTTCTTGCTAGCCTTGAGAAACCTGTTTCAATTTTTAAAATCTCTTAATATTGATATTTTGAAG
>TTN-205,,0,204,3315402,3315605,GTACATTACTGAGTAATAATCACCAAAAACAACTTTGTTATGTATGTTCTAAAATCATGTCTTCCTAGCCCGTCTGATGGTCTGTGTTTTTGCTGAGTAGGATGTTCTTGTCCTGATTCTTACATTTCAGTTTTTTATGTGTATTTATTACATAGTATTCAAGGAGTTGGTTTTAATGCTCTTTAATAATTAATATCTTTAAAG
>TTN-205,,0,747,3315606,3316352,GTATAATGATTTCCTTCCTCGATTGTGATCTTTTCTGATGCCTCTTTTGAAATTAATGTAACTATGATTCATTTCATTTTGTTGTTTCATGTCTTTTAAATTAGTTGTCAGCAGAATGTTGGATGTAAAAATGTGTAAATACAGGATAAGAAGATAATGCCTTTAAAAGGAAAAATTATTTCTAAATACATCCATAGCCTGTTAGCCAGTGGCTGTGTCCTGCCACATGGCTACAATACATATAAAATAGAATGTTTGGGTTTAAAATCAGTGACCGTTTGGCATATTCCTGATTTACCTAAATGATGTAATGATACCATAATATTCACCAAGCTTTGGTAACTGTTTATTCATTCTAAATTCATTTTGAAGATTTTTTTTAAAGCTAACCAGTTTCCAGTCATTTTCCCCCTGATTCATACTAAGTATGAAGTATACTAATTGAGAAGTAAATTTCACTTTTCAGGAAGGATATTTCTTTCAAGCAGAGATATTTGAACACTAAACCTCATTTCACATTTGGGCTCTGCTACTTCATGTTTACTTGGGTACTTCTGTGTACTTGTATTTATATGAAGCTCAGAATCCTTTCCACAGAGAGTATATAGTTTCTTAAAGATGAACAATCGCATATGTATCTCATTAAAGGAAGATACATTATTCTATCTGCTTAAAGTACAGCAAAACAAGCATTGGCTGGGTGGCCTTTTACTGACAATAAAATTTCCTTATACTTCATATTTCAAG
>TTN-205,,0,198,3316353,3316550,GTACCTAATGGCACTCATTTTAATGTTTTGTTCGTCTTTTGCTGTTGAATTCCTCTTCAGTTCTGTGTGTGAAAACTTCTTTTGTGGGAAAAGTAAATCTTGTCCTTTCTTCTGTTATAAATGGGCCTGTGTTTCTAAGGTGTCTTAATTTTGTTGAGTCATTGGCAAATGTCCAACTTAAAGATAATATCTTTAAAG
>TTN-205,,0,211,3316551,3316761,GTAGATGATGCCTCCTGCAAAGGGCTGTGCAACAGCATCTTTGGAGTTTGGGGGTCTGATTTGGTCAGATTCTGGGGGTTATTGGCAGCACCAATGATTGCTTACTTTAAAGCAGATATTTTTAGATGCTGAAATATGATTTCTACAGGTGCTTTTCACATTTTATTTCTTTCCTGCAAAATTTCCAACATTCTTAATAATATCTTTAAAG
>TTN-205,,0,182,3316762,3316943,GTACACCACCATTCATTGACGGGTATCTAAGAGACTTCATCTGCCTAGAAATAGTTAACTTTCTTCTGAGTTCAAAACCTTGTGTGTGTGTCACTGTCCGTTGTTAAAAAACATTAGCTGTGTTTTATATGGATGTGTTGTTACTAGTAGTTAGAACTTAACAATAAACAATATCTTTAAAG
>TTN-205,,0,508,3316944,3317451,GTACATCCTTATAATCCATCAGTGGAATAGCATGATAATTCACCCATGCAGCATAACTTGGTGAGCCATAGCAGATCTTTCCCCATGACAATATTAACAACATTAATGCCATGACAAGCGCCTCTCAACTGGCCACAGGAGCAGTTTACCCGGTATTCATCTCTGAATTTTACCATCAAATTATGCTTATGCTCAATGGTTGGCTCCTCCTCTTTAGTGGAAAGTTCTTCAAGTAAAATACATTCCTTTTGCATATCAAAATGGACAAAACCATCATTTACCAGGCATTGTGTCTTGTCTTTATCACCAGTCCACGTTTTTTTCGGTGTTTTTTATTTTAATTTTTGTGTATTTTCTGGCCTTTGTTTTGTGGCTATTATAATTTTCAGTCTTAAAGTGAAATTGATAGAATATCTATGCTGCTTCAGTTAAGGCCTTACATTGCCAGCCTTAAAATCTTAGCTATGGGTAAAAAATGTGACACTAACTCTATTTGATATCTTTGAAG
>TTN-205,,0,249,3317452,3317700,GTACATGAACTTGCAATGTTGCAATATTTTTATTTCACATTTGCATATGGGTAAAAATTAATTGGTTTAATTCTGTACTCTTTGGGATGCAACTCTTTAGAGAAAATTAAATATTTTATTTTAAAAATAAAATGCTTCTTGGAATACCTTTGTCATACTTTTATTACCTTATCTTAATCTTTTGAAACTATGCTTGGAATCAGTATTTTTATGTCGTATAAAATTTTTCTCTAAATCATTTCGTTAAAG
>TTN-205,,0,205,3317701,3317905,GTACATAATTTCATCACTTAGAGTACTTGGGGGAAAAAACTCACATCTATGTATACTCACATACAAATTTCCCCATTACATTGTACATTTTTAAAGTGTCTATCTGGTTAGAAATATGTCAGATATTTTGTGATTCTTTTTCATATCTATTGCTCTAAGACATTTTAAAAGAACATATTCCTAAATATAAATAATATCTTTAAAG
>TTN-205,,0,207,3317906,3318112,GTACATTAATCTGTAACAGAGCCATGGTAAAAGACAAAACTAACTGGTGTTATACAGCCTTACTAATTATAATTAATGCTTAGTATTTATGTTGATAATAATTGATGCTTTGTGATCACAGAATATTTGCCTTTCATAAGCTTCTTCATTGTTGTGAATATTTTACATAAAAGTGATGTTTGTACCCTTGAATAAATATCTTTAAAG
>TTN-205,,0,333,3318113,3318445,GTATAGCAGCTCTTCTTGGAATCATCAAGGCCTCTTTTGTGTTGAATTCTGCTTTCCCATCCTTTTGTTCATCTCCAGTTTTATCTATAATCCTTTACCCTCTGTGATTGACCACCTAAATCTTAGAAAACATTCCAGACATGTGTGTTCTTATTGTGTATCTGCCTTGTGTATCTGTCTATTGTAAATTATCTAAATGTCTTTTCAAATCACATATTATGTTTACATGTTTGTGGTCTTATCCTCACGTGTCTCTTTCATATATATATATATATATATATATATGACCATGTATATGTGGTTTTTAATGCCTTCAAATGAAATGTTTTTAAG
>TTN-205,,0,1205,3318446,3319650,GTACACCTCCCCAAAGTGAATACACATTGTTCACCCATAGCTTGGTCACATAAATTATGATGAAACTGGGTTTTAGGAAAATTATATTTACAAAATGGATAATCACACAGTTACATATTTACTTCTAACGATGTTCAGGAACACTGATATCTACTTTTTTCACTGATACAAAGCAGTATTCAAGAACAAAGATGAAAGGAAGCATTGTCCCAGAACTGATACAAAAGTTCTGATTTCATATCATTTGATTAAACATCATAGTTTTCATGGAGATATATTTAAATATATATGAATAAGTATACTATATATTTAAATGTATTGAAAACTATTATGAATAAATATTCTTAAATTTCTTCCTTCAACCATTTATATTAAATGCCTTTTTAACACCAGGCTAAAAAGAAAAAAAGATGAATGTATTTATCAAAACACAGAATAATAGTTATGTCTTCTAATACATATATATAAAGGGCAGCCCAACAGGTTTTGATTTTAGCGTTGACTTTACACCTTGTTGTATTACTCTCAGCGAGTCCTTTAACCAACCTGAGCCTGAAGTTATTTTCCTGTAAATTGGGGATGCTAATATCAGTCTTAATGGGCTCAGCTATTATGGTGAGAATTAAATAAAGTAAGGTATTAAAGTAGTCTATCATTGAATGAATAGTATCCAGATTTAACATATTCAATCAGCTCATAGTACAGGACAGAATTAATATATTTGTGCTTTAAAGCTCAATAATATTTTCTACAAAAGATGCTGGCATGGCTGCTTAAAATCAGCATAACCCTCGCATCAGGCCATATAGTTATATAATCAAATGAAATAGTAAAGCTGATCTTTTATTGGATATCAACGATTCAGAAATACTTTCTAGACAATAAATTACTAGTGAAATTTAAATGTATGAAATGATATTAGGTTGGTGCAAAAGTAATTGCGGTTTTTAGCATTAAAAGTAATGTCAAAACCGCAATTATTTTTGCACCACCCTAATAGCATCTGTCCTCTGATAATGACATATGCTGCTGGTCCCTTGCTTTACAAATCCCAATTACATTATAATATCTGGGCTCCCAACTAACATGACAGACCTGTCTTGAGCGACTGTTAACACATTGGTCTTTCTGGGTGTGGGGTCTTCTTGGTTTCTCTTTTTTTGTCCTTCAAAATAAATCCTTATCATGAAATGATGTCTTTAAAG
>TTN-205,,0,166,3319651,3319816,GTATTGCTATTCCGAAGTAAATTAGACTATGCCATTTCCTTCCTTCTCCTATAAAAGTCAAAATGTCCTGTTTCCGTATTTGTTAATACAACTTATATTACTGCTGTGTCTACTTGTCTTTGTGTGTGTGAAACTGAACTTATAAAATAAAATAATATTTTTAAAG
>TTN-205,,0,557,3319817,3320373,GTACATCATCCCATAACAGGGATATGTTTGCTGCACCGATGTTGAACTGTGGTTCTATCCACACAGGACACTCAACATAAATGTGTGCATTGTATGGTCTGTCATTCACATTCGTCATTTCTGACTCTTTTGCACCCAAGTTTGTGTTGTGTCCATTTTTTCACTTGGTGTTGGTGTGCTTTACATCGTTTCTCTATGTATGTTGTTTCTAAAAAATAAAAATATATCTTTAAAGAGCCAAAAATAACTAAGGAACTAGTCCCTGAAATACCCATTTCTTCATACCCATTTCTTCCTACAAAAAAAAAAAAGACAAAAGAAAAAAGAAATAGAGGCTCCAGCAGTAAAAAGTAGAATTTCTCTTTAATAAACCCTAAATCTTAAACCACAAACCTTTTTATTCTTTTCTCATTAACCGATTCTGTGAAATGTCAATGTTTCATCTTGTGTATGTGCCTTGTGATATTTACTCTCTTATGTTGGAAACTGGAAACGTGGTCTTTATTCTTCTTTGGTTCTTGCATTTTAAGTGTCTAAAATAATCAATGTCTCTCAAG
>TTN-205,,0,629,3320374,3321002,GTAGATAACTTTCTAAGAAAATAACATTTCAAAGTCATCCTTGTCTTATTATTGTCTAATATTTGAAGTAGGTAAATGTAAAATTTACCCCAGGAAATCAACATATTCAGATTCTAAAATAAATTATTATTAACCTAATAGAAATTGGGCAGGCAAATTAATATTATTTGAATCTCTTTGCATGTTCAGCCTGTTTGTCTGTTTGCTATTTGTTTTATTTTAATTAGAATTCATGAAGGGAAACTGTATTTGCTGTGGGAAATTTTTCATCAAATGACTTAGTAGGCAACTGTAAAATAAGCTTATCCAAGAGAAATTCCAGTTAAGCCTGAGTAACTGGTGCAGAAAATCTGATTTCTACCCCAAGTGGCTGTTTGACTTCAAACAAGTCTTTCATTAAAAAAAAAACAATAATAATTTTTTTATTATTATAAATTATCTGAAGTCCTTTCCAGTTCACAAATGCTGGGATATGCCTAACATATTTTGAAGACCCAGTAGAGATTTTTTAAGGACTAGTGAGTTTACACAAGCGTTTCGAAGGCTGAGCAGTTTTCAGATATTATCACTGTAGTCTAATATTCAAAATAATTATAAAAATAATTTACAAAATAATAATCTTTTTAAAG
>TTN-205,,0,603,3321003,3321605,GTATAACCGCTTTTAAGGATTGAACATTTAAAATTCCTGGTGTTCCAAATCTTTCTCAGTAGCTAAATCTAAGATTCACCAGTATGCTTTTCTTATATCGTATCCATGATAAAGTGAAGATTAATTATTCCTGGCACCTGAATCTATGTGTCCTTTTTTTACCCTAAATTTTTCTACAACATCTGCAATACAACTAAGAATGAGAGATTACTATTTTGTTATTGGCGATTGAATTTTTTTCTGACCAGGCCCTACTATAATAGTTTCTCCTAGATTTCAATCCTTAATTTTGTTTTTAATATTAATATGGGGGGAATCTATTTCTCTGGTGAAAGTGTTCATTTTTTAAGAAAAATCTTTAATTTACTATTCCTGAAGAGTGTGATAATATTTTGCATAATTGGTATTACATTTGCTTATAGGATTTCTAAGTAATATCCTTTACACCTCTAGGGTTCCTACTCCACATTTATTATTACCATTTAGGTTGCTAATATCTTTTAAAAATAAGTCAATGTTTTGTGATATTTATTTATTGGTATATGGGTGGTGTTCTGCTCATCACATGCCACTTTTCAAAATGTTCATAAAATTTCTTTTAAG
>TTN-205,,0,929,3321606,3322534,GTATATCAAATCCTCATTATTAATATCTTTAACTTCCCATTAATTTTCTTTCTTAAAAGCAACATTTTCTTTTTTGACTGCCTTCTTATAATCATTTAGATAGTGAACTGATTAAGGACCAGTAAAAATATAACTCATTCCATTTCTTTAATCTTTTCTAGGATGTTAACGAATAATTGTGTGCATGTGTTTACGTATGAATTATTCTAGAAGCTTCTTAACTGAGAATTTTAATATATTAGTATGTCTCTATATACTTATACACATAGCAATGGATCCCTCTTCCCCACATTTTAGATTTTATTCCATAAGTGGAACGGAGTTTTCTTCTGTGTTATAATAATTATTTTACTATATTTATTATTTTATGGAACAAACCTAATGCTTGGATAATAACTATTTTAAAGAGCCTCACGTCCCTTTTGTAATGTTTAGCCCAAGCATTCAAGGTTATTACAAAATGTCTACTTTTCCCTGCTTCCTAATTCACTTAATGCTTCAGACAGTGCTCTTAAGCAGTTAGATTATGCTGTCCCTGTCATAGTAGACTCCTCAGCTAATAGAAGAGTGCACAGCAGAAAGTGAGGCCAGTGTCAGGGCTTAAATACTCTACAATGGTAATCACTTCAAAAAAGTCTTCATCAAGTTAAAAATAGTAAAAGTGAGTCCATATTGGTAATCCCTGTTATTAAAAGAAAAAAAAAAGAATGGCACAGGTACTTTGTGGACATTTCTTCTTCTATAGGAATGTTAGAACAAATGAGTGATTTGAGAAAGTATCTTTATTGCCTCTAAAATGGATGTCCCACAGTACAGAGTGACTTCTGAAAAACTTTAATTATTGTAATGTTGGCGTTGTCTCTGGTGTTTTTATTTCATGTGTGTTATTGAACATTCTCAGCTAACTAAAACACCTAATATCTTTAAAG
>TTN-205,,0,153,3322535,3322687,GTACATCTTCTCTTTTAAACCTGACTTCCTCTTCTGTCTTTTTTCGTTAAGACTTTTATGTTTCATGTCTCTGTGTCTTGATTGTTTTTGATGATTTTTGTCTATGAAAGCTTGCTCTCGACAGTCCTAAATATTAAAACTGTATCTTTAAAG
>TTN-205,,0,139,3322688,3322826,GTATTTTTGGAAAGATCCTGGATTTTCGTGTATTGTTGCATGCAATCCTTTATTCAGTTTTAAAAATATATATTTTGAATGTACATCTTTATTTCTTCAGTGTTTAAAAAAATAAGTCTTAAAATAGATGCTCTTTCAG
>TTN-205,,0,800,3322827,3323626,GTATAGGGAATTCTTCAAATACTACAAATTCTTATATCTTGCTCTAACTTTCCTTTGAAAGTAAATTTTGTGTTCAGTTTGGAAGATTAGAAACCCCATGAAATACTTTAAACATGAGTTTAAACTAGTTGACACAAAGATTAATATCTCTTAACCACACGGAGTATAATTTTAGTAGATGATAGTAATATTTGATATCTACTTATCTAAGGAGGTCACTGTATGAATTTGGGGATTATTTTTTAAATCTGACTAAGAATGTTACACAATTGTTACAGGTACCAAAATAACTGACCAGTGTCATTGGTTAAGTGAAAAAGAAACTCCTCAGTTCACTGAGGAATTTACATGTTCAGGCAAAATAATCACTGCTTTAACATTTTAGTCAACTGTTCACAAACTGAGAAATACTTACCAAAAGCTTTTGCCAGTTTATGATACTTTCATTAGAGAAACAACATTAAGGAAGTGAAGTATTGTTAATGGCACCTGTATTCTAGCATACTGTGAAGACAAGCCATAGCACAAATAAGTTATCTGCAATACCACTCTAGATCTTGCACAAATTAACAATATATGTGTAATATGAAGGAATGTGTGTGTGTGTGTGTTTAGCATATATAGCAAATTACAATATACATGATATTTAGCAAATCAAATCTCTTTTGGAAATAAGTGTGTTATAAATTAAAAAAATATAGATAAAGAATTTTGTGACCCCTCATTGTACTAACGTTAGTAGTAGTGCTCCAAAATACTTCAAGAGTTCATTCTAAACCAAAATACTAATATCTTTGAAG
>TTN-205,,0,794,3323627,3324420,GTATCTTCTTTGTGAAAAATTACTACTTAACTTTACATACAATAGCACCTTGGTTGCTTTATAAGCACAAGTTTGCATTCCACTTGATGTCTTTCTTCTGTATTTCTTGTTTCTGACATGTCTAAAACAAACTAATATCTTTAAAGCAGCTGAGGGTCCAAGGGAAGTTCTACCAAAAAAAGACAGTCACTGTTGTTATACCTAAAACAACCAAAGCAAATATCTCTAGTAACCAAATAGTGAGCCCAAATTTCCTCCTTTGGTGCTATTTGGTTATATATTCACTAACATGCTTACTGATAAACACATGTTTTTCTATTTATTATTAATTATATTAACCTGGCAAATATAAATACATAGTGAATATGTGTTTAATGTTCTTGCTTTGTTCATTTTTGCAAATCTCTTAAATTTCACAATAGAAATAAAAACAGTATCTAATAAATAATATAAACTTATTTCTTTAAAGTCTCTGAAGCATGTGCGTAAGTTATCACTGAAGAGAAGGTAGCAACTCTTCCACAAAAACAAACAGTAATAGCACCAGCTGAAGGTGTACTGTTAATTTTTCTTCTCAAGTTCTTACCATTCTAACATGGGAAATTTCCCTGGATTTTTGTTATTATATATTTTTTAAATTCAATGCATTTGAAATACTGTAATGTATTTGATAAAGTGTTGTCTGCATTTTATATTGTTGCTGTGTTCTGTTCTGTGTTTATATCTCTCATGCTCTGCTTGTTAAAAAATTGTATATTTAAAAATAAAAGAAATTATTACTATTATCTTTAAAG
>TTN-205,,0,542,3324421,3324962,GTAACTGGCTTTTCTCATTCATCATTAATATAAAATCCTTTTTTATTCACTTACTATGTAAGAGAGACCTTTCTCTTCTCAATGCCACAAGATGGCTATGAATGACATAAACTTCAATTTATGTTCTATAACATAATCCTGCCTTTTGAGGCAATGTTTTAGGCGTAAAGACATAAGCCCAAAGTTATCATTTGTATTGATCCTCTTATTTAATAACTAAATAATATTGATCCCTCAACTTCTCTTTCAAAAATAATTCATTTTGGAAGCTCTTCTGAAGTAGCTCTGGAAAAAAAAAAGTGTGCTCTAAATGGCAATAGAAAATGATACTATCTCCAAAGAGCAAAGTGTTTCTGATATAATGAATCAAGAACTCATCGACAAAGCAATTCAGAGAAATGCAATGACTACATTTGACTTATAGTTGACTTATAATTGAGGGGTTTTTGGCGTTCATCTTGTTAGATGCCCCTTCTAGGCTTGCTATGTTTACACCCAACTATAATGTTCTGAAAAAATAAGATAAATAAATATCTTTAAAG
>TTN-205,,0,144,3324963,3325106,GTATACAGTGATGCTAATCAGAACATGAAATAATTCTTGGTTTAGTTTTTCATGGTTTAAAGTGAATGTGTGTGACATTAAATCCTTGTATTTCGTATCTTATATTTGTTATCTGTAACAATTAATATACTAATATCTTTAAAG
>TTN-205,,0,1651,3325107,3326757,GTGAGTGTAGAAAAATTAGTGGTTCTTTTTCGTTTCATTTATGTCCTTAAATTCACTATGTTTGTCTTTTTAGCTTTGAAAAGTAAATATACTAAACTCTTATAAAAGCCTAACATGCCACAAATATATGACTCAAATAATCTTAGTGTCTATTATCCTCAGACAAGTTATATTTCCTCACCAATTTAAAAAAGAAATACTCTACTTATCAGAGTGTATGATTTCAGAAAAGTCAGTTGTCTTGTTAAATTTTCCTAACCTATTCTGTATACAAGTGTCTTTTGCTTTGAAGCAATTTATTTTCTCAGATCATGAAGTAACTTAACTCCATAATATTTTAATTGGATTTTATAAAATCAAAATGTTTCACCATTATTTTTTTTTTTACTCTTGATAACCATAATTGGAAACATTTTGGCAAAACTGCTCAAAGGACCCTAGGTTTACAAGGCCACTCAAACCTCAAAAGAATTCTCACGACCTTTTTTTTTGGGGGGGGGTTTCATACAAAATTAGGTTTAAATAATTTGAATTATGAAATAATCCAAATAGTAAAATATTGTGAATAGAATACTGTTCAACAACCTGAATAGTAAAAGTGACAGTAGTCAAAATATTCTTCCTTTTTTTTTTTTTTTTGAGATGGAATCTCACTCTGCTGCACCCAGGCTGCAGTGCAGTGGCACGATCTTGGCTCACTGCAACCTCCGTCTCCTGGGTTCAAGCTATTCTCCTGCCCCAGCCTCCCGAGTGGCTGGGATTACAGGTGCCTACCACCAGGCCCGGCTAATTTTGTGTATTTTTAGTAGAGACAGGGTTTTACCATGTTGGTCAGGCTGGTCTCAAACTCCTGACCTCAGGTGACCCGCCCACCTCAGCCTCCCAAAGTGCTGGGATTACAGGCATGAGCCACTACACCAGACCCGCTTCCATTTTTTTTAATCTAAAAAATTTCCTGTTGAAACTCAACTTTCTTGTTGTTCATCCTGTTATACTAAGTTGGGATAAAATAATATAATCACTTCCTCCTTTGAATATCCTTTCTATTCTTGACTTTAGTTATTGTTTTCAGACAGTTTTTCTTTCTAAAGGCTGGAGAAATTTTTGTTGTCTTTATTTGCCTTATTTTCTAAGTATTTAATTTTTTTAATTTTCTGCCTCCAAACCCTAAATGGCTTTTACATTCATATTAAACTGTGAAACCATATATTAGATGTGATTTGAAAATATAGATAATGAGGCTTCTAGAAAGGGAAAAGACTTACATGAATTTCTAGTAGGTCAAATATCGGAGAATTCTCAATGTGCAATTCAGCATCTTCCCTGTTCTTTATAGACAAATCCATTAAAAATAAGACCAATAGGACAATTTTACCAATAACTTTCTTAAGGCAAAATGAAGAATTATATAGTCCTTGCCTGAACAATTCCTCCATTTTATTATCATCATCATAGAGAAATGCTTAGAGTCTTACATCATGAAACTGGGAGTGAGGCTATCCCCAGCCAATGCATTCTAGCCACTAATTTGCCTCTATGTGCTACTATTAATTTTGGTGATGAATGTGGTATTATATATTATATTTTTCTTAATACACTTCTTTATCCACCTTGAAACATCCTAATTATTTAAATACTAATATCTTTAAAG
>TTN-205,,0,112,3326758,3326869,GTATATAACACCAATGATCCACTCTGAAGAAAAATTATTTTTTGGCCCCTTTTAAAAAGCTCAATATTTTTCTTCACCATTTATAAATATAACTATACTCATATCTTTTAAG
>TTN-205,,0,122,3326870,3326991,GTATATTTCAAATACATCAAACCCAGATGAGTATCTTTAGCTTTATGACTCAAACATTGCATGCTTTTTATAATTTACTGTTTTTACAACTTTTAAATGTAAACCTACTAATATCTTTAAAG
>TTN-205,,0,334,3326992,3327325,GTATAATTCTCTAGTTAGGAAAATCTAAAGAAGAAAATATACTGTCTTCAGTCTGCAAAATATTTAATGTTTAATATACATTCTCACAACCTCTAATGTTAAAATACTGTGTTTAAAGGATCTGATATACCCACAACAAAGAATGACCTATGACTTGCCCCCAAGAAAGTCAAGTCCCACACATATAATATACAAAGATAAAATATTAGAACAAAAATAACATTTCTAACATAAAGATATCTGAAATGATATTAACATATCTAACTTTCTTAGTATGTCATGTCTTTATGCCTTTGCCTTTTCTCAATTAAAAAAAATACTAATATCTTTAAAG
>TTN-205,,0,1032,3327326,3328357,GTACAAGTTGGAAGAAAGTCACCTTTTTAATCTCATGTTTGCAGTTGTACTTAACACATGTAAAAATACTAATATCTTTTAAGCCAAAGTGGCTACAGTGGAAATCATTTCAGAGATGGATCCCCCAAGTAGAAGCTCAACCAAATGTATTCATGTCCCAGTGAGTCACTCAAGAGACAACAGAGGGAAAAAATACCTTTAGCTTATACACATGAAAGATAGTTGAGTCAGTGTATTTTTATGAGGACTCCAAAGAAAATATATATACACATATTATGATCAAAACATGTCTTAAAGAAAATATTAATTCAGTGTGAAGCTGATCTGTAATATCTCTACAAGATTAGAGCACCTGAGACCCTCCCAGAATATCCTCCAACCTAGGGAAAAATAATTCCAGTTAAAGCTGGAAATCTCCCCTCCATGTTCATTTGCTCCTCTCATAGCCTATCTTTTATTTTTCAAGCATCATTTTTTTTCATTTTGAATATCTTTAGATAAGTCAAAACATGAAAAAGCTTTAAAACCTCCAGAACAATAATTTCATCATAACACCCATGGTATTCTGTAATTTGAAGAATATCTGAATATTTTGATATTTTTTCTCAGTCTGGAATCTTTTGGTTGTTCTCCTCTCTCCTAAACTTGAAAAACACTCACCTTTTTAAGGTGCCTGAGGTGTGAATACAAAAAAATGCCGACCTAGATTTTTCGAAGTGGCTGTAATTTGTTTTTCTCAACATAATAGCTAGAGGTATAGCATTAATTATAATCAATGTTTCCACTTTCCATGATCTAGTTTTCTATGCATCTACCATTCCAAGAAATAAAATTACTAATACTGATAGTGCCTGAGGTGACCAAGAAAACAGCCGCTTATAACCAAATACTCACACTGCTACAAAAGATCCGATTCTGGGGGCGGGGAGTGGGAGAAGGTTCCCATCTGGAATGTTCTGTATGTGCAGTTAAGATGGGAACTCTTTACTCCTCTTCATAACTCCAAAGTACAATGCATTCATATCTTTAAAG
>TTN-205,,0,247,3328358,3328604,GTATCGTTCATCCTGCCATTCCTTCCTTCATTTATTAGAGTGCTTAGCATGTACAGGGTGCTAGGGAACTGGAGAATAATAAACAAAGACAATTAATATGTGGTTCCTCTCCTCAAGATTGTATACCTCCTCAGATTCTTTAAAGGAATCATCTTTTTAGCCATAAATATCACTTTGGTTCAGCTCATTTAATTAATGTCTCCACTGATCCTTTTAACCTCTAACCATAATACTAATATCTTCAAAG
>TTN-205,,0,450,3328605,3329054,GTACGTTACCTCTGAACAAATGTGGAAGAAGAAATTATCTGTCCTCTGCTCTTAAAACTATGGTTTCTTCCTAATACTCTTCATAAATTCTAAATATAAACATACTAATATCTTTTAAGTGTCTGAGGTTCCACAGGAAGTTTCCTCTAAAAAGAAATTATTTATGGCTGTTTCTGCCAAAACAGAAAACACTCCTGCTGGAAGTATTCATTCAACAAATCCTTTATAATGAGAGTGTAGAGTGTCGCGAGAGCTCTGTGAGGTTCTGGAGGAGGGGGAGCACCTCCTCTCAAGGATCCACTAACCCCTTAAAAGACTTAGCCTATTGGTGGAACAAAGGGAGGATGGAGGAAAGAGAAGAAAATGTGGTTATATTTCCTAACTTATTGTGGTTACTGTTTTCCATTAATCATTTTAACTCTTAAATGTGAATTGCTAATATCTTTCAAG
>TTN-205,,0,114,3329055,3329168,GTACAAGTCACCATGCTCTCAGGGTCAAGAACTAGCTCTTGTAGTTTTGAGAATATTTTTGCTATTCCTAGTTATCTGCATAACACTAAACATAAAACTACTAATTTCTTAAAG
>TTN-205,,0,116,3329169,3329284,GTATATCTTGCTGGAAGCTTAGAGGGGTGGGAACATGTCTTTTCTTGTATAAATGTTTTTCCTGATTGTGTTGATTCTTGTAACTTCTAAATGTAAAATTATTAATATCTTCAAAG
>TTN-205,,0,361,3329285,3329645,GTACATTCTTAACTGTCTTTTTATGGTGGGATAGTGGGTGGGGCGATAGAAAGGACCACCTTTCTAGTTTTGAAAATTATTTTGATGTGTACATGTGAATCATGTCTGTGTTGACTCTTGCAACTCAAGTGTAAATGTATTAATATCTTCAAACTGCCTGAAGCTCCCAAAGAAATGGCTACCAAAAAGAAAATACCGGAAGTTCCTCCTCTAAAACCTGAAACACCACCTATTATGGGAACTTGTTACCACTGATCTCAGCTCAGGAGAAAAAAATAGCTCTTTTGTTCTTGAAAATGTCTTTGTATCTATCTAGTAATCTCTGTATTTTCTGAGTGTAAAAATACTAATATCTTTCAAG
>TTN-205,,0,112,3329646,3329757,GTATTTGTCACTGACTTTAGGCTTCAGAAGACCTAATTCTTCTGCTCTTGACAATATTTTTTTCTAGCGGTCTTCATAACACCTAAATGTAATTTCACTAATATCTTTCAAG
>TTN-205,,0,108,3329758,3329865,GTAGTTGCCACTGACCTTAGGCTTCAGATCTCATTCTTTTGCTCTTGAAGATATTTTTTCCAGTGGTCTTCATAACTTCTGAATGTAATTTTGCTAATATCTTTTAAG
>TTN-205,,0,110,3329866,3329975,GTATTTGTCACTGATTTTAGGCTTCAGATGATGTATCTCTTCTGCTCTGGAAAATATTTTTCTAGTGGTCTTCATAATGCCTAAATGTAATTTCACTAATATCTTTCAAG
>TTN-205,,0,83,3329976,3330058,GTAGACACCCTCTTGTTGCTGTGTTTGATATTGTTTGTTTGTCTTTACTTTGTCTAATAATGAAAATACTAATATCTTTAAAG
>TTN-205,,0,210,3330059,3330268,GTAATGCCAAAGCTATACAAACTATAGGAGAAAAATAACTGTTATTTTAACTAGGAAATTACATGTTAAAAATCCTACTACATAAAGATGATATAATTCTAAAGAAAACAAATGTCAATCGCTATCCAAAATATCTTGGTGGGTGTTTATATGCAAAAGGCATCCATCATTTTCACCTTTTCTAAACACAAATTACAAATATCTTTGAAG
>TTN-205,,0,153,3330269,3330421,GTAGGTATCATTACACATTGTCAGTCGGGGGGCCCTGGGGAAAGACTGCATAGAAGTGTCCGCCGATCTCACAAGTTGTATTTGCTTGGGTAAATGTGGAGTCGATATTCCCCCTTTATAGCTTCTAACTAAAAGATACTAATATCTTCAAAG
>TTN-205,,0,112,3330422,3330533,GTATTTATTCCCTCTCCTCTGCTAAGAAAAACTTATCGTCTGTACCCCTCACAATCACTGTAATATATACCTTCACCATTCATAAATTATAAAAATACTAATATCTTTCAAG
>TTN-205,,0,114,3330534,3330647,GTACATGTCAGCTCAACCTTATCCTGCAGAAGAAATCTCTCTTCCATTCCTGAAAACAATTTTAGTCCATTCCTCTTCATTAACCTAAGTATAAAACTACTAATATCTTTCAAG
>TTN-205,,0,115,3330648,3330762,GTACACTTTAGCCCTGACTTCATTCTGCAGAAGAGATATCTCCTCTCCTACTGTAAACAATTTTAGCCCATTTCTCTTCATTAACTTAAGTCTAAAACTACTAATATCTTTCAAG
>TTN-205,,0,113,3330763,3330875,GTATTTTTTACCCCTGTCCTTTTTCTGCAGAAGAAATATCTCTTCTGATCTTAGAAATATTTTACTCCATTTGTCTCATTAACCTAAGTGAAAAACTACTAATATCTTTCAAG
>TTN-205,,0,105,3330876,3330980,GTACTTGTCATTTGACCTTAAGCTTCAGAAGATCCAATTCCTCTGCTGTATATTTTGCTAGTAGTCTCCATAGCTCCACATGTAACTTTACTAATATCTTTTAAG
>TTN-205,,0,2503,3330981,3333483,GTATTTGTCACTGATTTTAGGCTTCAGATGATCTATCTCTTGTGCTCTGGAAAATATTTTTCTTTTTATATATATATATATTTTTATTATACTTTAAGTTCTAGGGTACATGTGCACAACGTGCAGGTTGTTACGTATGTATACATGTGCCATGTTGGTGTGCTGCACCCACTAACTCGTCATTTACATTAGGTATGTCTCCTAATGCTATCCCTCCCCCATCCCCCCACCTCACAACACACTCCGGTGTGTGGTGTCCCCCTTCCTGTATCCATGTGTTCTCATTGTTCAATTCCCACCTATGAATGAGAACATGCAATGTTTGGTTTTTTATCCTTGTGATAGTTTGCCAAGAATGATGGTTTCCAGTTTCATCCATGTCCCTACAAAGGACATGAACTCATCATTTTTTATGGCTGCATAGTATTCCATGGAGTATATGTGGAACATTTTCTTAATCCAGTCTATCATTGATGGACATTTGGGTTGGTTCCAAGTCTTTGCTAATATGAATAGTGCCGCAATAAACATACGTGTGCACGTGTCTTTATAGCAGCATGATTTATAATCCTTTGGGTATATACCCAGTAATGGGATGGCTGGGTCAAATGGTATTTCTAGTTCTAGATCCCTGAGGAATCGCCACACTGACTTCCACAATGGTTGAACTAGTTTACAGTCCCAGCAACATTGTAAAAGTGTTCCTATTGCTCCACATCCTCTCCAGCGCCTGTCGTTTCCTGACTTTTTAATGATCACCATTCTAACTGGTGTGAGATGGTATCTCATTGTGGTTTTGATTTGCATTTCTCTGATGGCCAGTGATGATGAGCATTTTTTCTTGTGTATTTTGGCTGCATAAATGTCTTTTTTTGAGAAGTGTCTGTTTGTATCCTTCGCCCACTTGTTGATGGGGTTGTTTTTTTCTTACACGTTTGTTTGAGTTCATTGTAGATTCTGGATATTAGCCCTTCGTCAGATGAGTAGATTGCAAAAATTTTCTCCCATTCTGTGGGTTGCCTGTTCATTCTGATGGTAGTTTCCTTTGCTGTGCAGAAGCTCTTTAGTTTAATTCGATCCTATCTGTCAATTTTGGCTTTTGTTACCATTGCTTTTGGTATTTTAGACATGAAGTCCTTGCCCATGCCTATGTCCTGAATGGTATTGCCTAGGTTTTCTTCTAGGGTTTTTATGGTTTTAGGTCTAACATTTAAGTCTTTACTCCATCTTGAATTAATTTTTGTGTAAGGTGTAAGGAAGGGATCCAATTTCAGCTTTCTACATATGGCTAGCCAGTTTTCCCAGCACCATTTGCTAAATAGGGAACCCTTTCCCCATTTCTTGTTTTTGTCAGGTTTGTCAAAGATCAGATGGTTGCAGATGTGTGGTATTATTCTGAGGGCTCTGTTCTGTTCCATTGGTCTATATCTCTGTTTTGGTACCAGTACCATGCTGTTTTGGTTACTGTAGCCTTGTAATACAGTAGCGTGACGCCTCCAGCTTTGTTCTTTTGGCTTAGGATTGACTTGGCAATGTGGGCTCTTTTTTGGTTCCATATGAACTTTAAAGTAGTTTTTTCCAATTCTGTGAAGAGAGTCATTGATAGCTTGACGGAGATGGCATTGAATCTATAAATTACCTTGGGCAGTATGGCCATTTTCACGGTATTAGTTCTTCCTATCCATGAGCATGGAATGTTCTTCCATTTGTGTCCTCTTTTATTTCGTTGAGCAGTGGTTTGTAGTTCTCCTTGAAGAGGTCCTTCACATCCCTTGTAAGTTGGATTCCTAGGTATTTTATTCTCTTTGAAGCAACTGTGAATGGGAGGTCACTCACGATTTGGCTCTCTGTTTGTCTGTTATTGGTGCATAAGAATGCTTGTGATCTTTGCACATTGATTTTGTATCCTGAGACTTTGCTGAAGTTGCTTATCAGCTTAAGGAGATTTTGGGCTGAGACGATGGGGTTTTCTAGATATACAATCATGCCATCTGCAAACAGGGACAATTTGACTTCCTCTTTTCCTTATTGAATACCCTTTATTTCTTTCTCCTGCCTGATTGCCCTGGCCAGAACTTCCAACACTATGTTGAATAGGAGTGGTGAGAGAGGGCATCCCTGTCTTGTGCCAGTTTTCAAAGGGAATGCTTCCAGTTTTTGCCCATTCAGTATGATACTGGCTGTGGGTTTGTCATAAATAGCTCTTATTATTTTGAGATACGTCCCATCAATACCTAATTTATTGAGAGTCTTTAGCATGAAGGGCTGTTGAATTTTGTCAAAGGCCCTTTCTGCATCTATTGAGATAATCATGTGGTTTTTGTCGTTGGTTCTGTTTATATGATGGATTACGTTTATTGATTTTTGTATGTTGAATCAGCCTTCCATCCCAGGGATGAAGCCCACTTGATCATGGTGGATAAGCTTTTTGATGTGCTGCTGGAAAATATTTTTCTAGTGGTCTTCATAATGCCTAAATGTAATTTCACTAATATCTTTCAAG
>TTN-205,,0,83,3333484,3333566,GTAGACACCCTCTTGTTGCTGTGTTTGATATTGTTTGTTTGTCTTTACTTTGTCTAATAATGAAAATACTAATATCTTTAAAG
>TTN-205,,0,210,3333567,3333776,GTAATGCCAAAGCTATACAAACTATAGGAGAAAAATAACTGTTATTTTAACTAGGAAATTACATGTTAAAAATCCTACTACATAAAGATGATATAATTCTAAAGAAAACAAATGTCAATCACTATCCAAAATATCTTGGTGGGTGTTTATATGCAAAAGGCATCCATCGTTTTCACCTTTTCTAAACACAAATTACAAATATCTTTGAAG
>TTN-205,,0,153,3333777,3333929,GTAGGTATCATTACACATTGTCAGTCGGGGGGCCCTGGGGAAAGACTGTATAGAAGTGTCCGCCGATCTCACAAGTTGTATTTGCTTGGGTAAATGTGGAGTCGATATTCCCCCTTTATAGCTTCTAACTAAAAGATACTAATATCTTCAAAG
>TTN-205,,0,112,3333930,3334041,GTATTTATTCCCTCTCCTCTGCTAAGAAAAACTTATCGTCTGTACCCCTCACAATCACTGTAATATATACCTTCACCATTCATAAATTATAAAAATACTAATATCTTTCAAG
>TTN-205,,0,114,3334042,3334155,GTACATGTCAGCTCAACCTTATCCTGCAGAAGAAATCTCTCTTCCATTCCTGAAAACAATTTTAGTCCATTCCTCTTCATTAACCTAAGTATAAAACTACTAATATCTTTCAAG
>TTN-205,,0,115,3334156,3334270,GTACACTTTAGCCCTGACTTCATTCTGCAGAAGAGATATCTCCTCTCCTACTGTAAACAATTTTAGCCCATTTCTCTTCATTAACTTAAGTCTAAAACTACTAATATCTTTCAAG
>TTN-205,,0,113,3334271,3334383,GTATTTTTTACCCCTGTCCTTTTTCTGCAGAAGAAATATCTCTTCTGATCTTAGAAATATTTTACTCCATTTGTCTCATTAACCTAAGTGAAAAACTACTAATATCTTTCAAG
>TTN-205,,0,105,3334384,3334488,GTACTTGTCATTTGACCTTAAGCTTCAGAAGATCCAATTCCTCTGCTGTATATTTTGCTAGTAGTCTCCATAGCTCCACATGTAACTTTACTAATATCTTTTAAG
>TTN-205,,0,2502,3334489,3336990,GTATTTGTCACTGATTTTAGGCTTCAGATGATCTATCTCTTGTGCTCTGGAAAATATTTTTCTTTTTATATATATATATATTTTTATTATACTTTAAGTTCTAGGGTACATGTGCACAACGTGCAGGTTGTTACGTATGTATACATGTGCCATGTTGGTGTGCTGCACCCACTAACTCGTCATTTACATTAGGTATGTCTCCTAATGCTATCCCTCCCCCATCCCCCCACCTCACAACACACTCCGGTGTGTGGTGTCCCCCTTCCTGTATCCATGTGTTCTCATTGTTCAATTCCCACCTATGAATGAGAACATGCAATGTTTGGTTTTTTATCCTTGTGATAGTTTGCCAAGAATGATGGTTTCCAGTTTCATCCATGTCCCTACAAAGGACATGAACTCATCATTTTTTATGGCTGCATAGTATTCCATGGAGTATATGTGGAACATTTTCTTAATCCAGTCTATCATTGATGGACATTTGGGTTGGTTCCAAGTCTTTGCTAATATGAATAGTGCCGCAATAAACATACGTGTGCACGTGTCTTTATAGCAGCATGATTTATAATCCTTTGGGTATATACCCAGTAATGGGATGGCTGGGTCAAATGGTATTTCTAGTTCTAGATCCCTGAGGAATCGCCACACTGACTTCCACAATGGTTGAACTAGTTTACAGTCCCAGCAACATTGTAAAAGTGTTCCTATTGCTCCACATCCTCTCCAGCGCCTGTCGTTTCCTGACTTTTTAATGATCACCATTCTAACTGGTGTGAGATGGTATCTCATTGTGGTTTTGATTTGCATTTCTCTGATGGCCAGTGATGATGAGCATTTTTTCTTGTGTATTTTGGCTGCATAAATGTCTTTTTTTGAGAAGTGTCTGTTTGTATCCTTCGCCCACTTGTTGATGGGGTTGTTTTTTTCTTACACGTTTGTTTGAGTTCATTGTAGATTCTGGATATTAGCCCTTCGTCAGATGAGTAGATTGCAAAAATTTTCTCCCATTCTGTGGGTTGCCTGTTCATTCTGATGGTAGTACCTTTGCTGTGCAGAAGCTCTTTAGTTTAATTCGATCCTATCTGTCAATTTTGGCTTTTGTTACCATTGCTTTTGGTATTTTAGACATGAAGTCCTTGCCCATGCCTATGTCCTGAATGGTATTGCCTAGGTTTTCTTCTAGGGTTTTTATGGTTTTAGGTCTAACATTTAAGTCTTTACTCCATCTTGAATTAATTTTTGTGTAAGGTGTAAGGAAGGGATCCAATTTCAGCTTTCTACATATGGCTAGCCAGTTTTCCCAGCACCATTTGCTAAATAGGGAACCCTTTCCCCATTTCTTGTTTTTGTCAGGTTTGTCAAAGATCAGATGGTTGCAGATGTGTGGTATTATTCTGAGGGCTCTGTTCTGTTCCATTGGTCTATATCTCTGTTTTGGTACCAGTACCATGCTGTTTTGGTTACTGTAGCCTTGTAATACAGTAGCGTGACGCCTCCAGCTTTGTTCTTTTGGCTTAGGATTGACTTGGCAATGTGGGCTCTTTTTTGGTTCCATATGAACTTTAAAGTAGTTTTTTCCAATTCTGTGAAGAGAGTCATTGATAGCTTGACGGAGATGGCATTGAATCTATAAATTACCTTGGGCAGTATGGCCATTTTCACGGTATTAGTTCTTCCTATCCATGAGCATGGAATGTTCTTCCATTTGTGTCCTCTTTTATTTCGTTGAGCAGTGGTTTGTAGTTCTCCTTGAAGAGGTCCTTCACATCCCTTGTAAGTTGGATTCCTAGGTATTTTATTCTCTTTGAAGCAACTGTGAATGGGAGGTCACTCACGATTTGGCTCTCTGTTTGTCTGTTATTGGTGCATAAGAATGCTTGTGATCTTTGCACATTGATTTTGTATCCTGAGACTTTGCTGAAGTTGCTTATCAGCTTAAGGAGATTTTGGGCTGAGACGATGGGGTTTTCTAGATATACAATCATGCCATCTGCAAACAGGGACAATTTGACTTCCTCTTTTCCTTATTGAATACCCTTTATTTCTTTCTCCTGCCTGATTGCCCTGGCCAGAACTTCCAACACTATGTTGAATAGGAGTGGTGAGAGAGGGCATCCCTGTCTTGTGCCAGTTTTCAAAGGGAATGCTTCCAGTTTTTGCCCATTCAGTATGATACTGGCTGTGGGTTTGTCATAAATAGCTCTTATTATTTTGAGATATGTCCCATCAATACCTAATTTATTGAGAGTCTTTAGCATGAAGGGCTGTTGAATTTTGTCAAAGGCCCTTTCTGCATCTATTGAGATAATCACGTGGTTTTTGTCGTTGGTTCTGTTTATATGATGGATTACGTTTATTGATTTTTGTATGTTGAATCAGCCTTCCATCCCAGGGATGAAGCCCACTTGATCATGGTGGATAAGCTTTTTGATGTGCTGCTGGAAAATATTTTTCTAGTGGTCTTCATAATGCCTAAATGTAATTTCACTAATATCTTTCAAG
>TTN-205,,0,83,3336991,3337073,GTAGACACCCTCTTGTTGCTGTGTTTGATATTGTTTGTTTGTCTTTACTTTGTCTAATAATGAAAATACTAATATCTTTAAAG
>TTN-205,,0,210,3337074,3337283,GTAATGCCAAAGCTATACAAACTATAGGAGAAAAATAACTGTTATTTTAACTAGGAAATTACATGTTAAAAATCCTACTACATAAAGATGATATAATTCTAAAGAAAACAAATGTCAATCACTATCCAAAATATCTTGGTGGGTGTTTATATGCAAAAGGCATCCATCATTTTCACCTTTTCTAAACACAAATTACAAATATCTTTGAAG
>TTN-205,,0,153,3337284,3337436,GTAGGTATCATTACACATTGTCAGTCGGGGGGCCCTGGGGAAAGACTGTATAGAAGTGTCCGCCGATCTCACAAGTTGTATTTGCTTGGGTAAATGTGGAGTCGATATTCCCCCTTTATAGCTTCTAACTAAAAGATACTAATATCTTCAAAG
>TTN-205,,0,112,3337437,3337548,GTATTTATTCCCTCTCCTCTGCTAAGAATAACTTACTGTCTGTACCCCTCACAATCACTGTAATATATACCTTCGCCATTCATAAATTATAAAAATACTAATATCTTTCAAG
>TTN-205,,0,114,3337549,3337662,GTACATGTCAGCTCAACCTTATCCTGCAGAAGAAATCTCTCTTCCATTCCTGAAAACAATTTTAGTCCATTCCTCTTCATTAACCTAAGTATAAAACTACTAATATCTTTCAAG
>TTN-205,,0,115,3337663,3337777,GTACACTTTAGCCCTGACTTCATTCTGCAGAAGAGATATCTCCTCTCCTACTGTAAACAATTTTAGCCCATTTCTCTTCATTAACTTAAGTCTAAAACTACTAATATCTTTCAAG
>TTN-205,,0,113,3337778,3337890,GTATTTTTTACCCCTGTCCTTTTTCTGCAGAAGAAATATCTCTTCTGATCTTAGAAATATTTTACTCCATTTGTCTCATTAACCTAAGTGAAAAACTACTAATATCTTTCAAG
>TTN-205,,0,105,3337891,3337995,GTACTTGTCATTTGACCTTAAGCTTCAGAAGATCCAATTCCTCTGCTGTATATTTTGCTAGTAGTCTCCATAGCTCTACATGTAACTTTACTAATATCTTTTAAG
>TTN-205,,0,113,3337996,3338108,GTATTTGTCACTGACCTTAGGCTTCAGATGATCTAATTCTTTTGCAGTTGAAGACATTTTGTTCCAGTGGTCTTCATAACCCCTAAATGTAATTTTACCTAATATCTTTTAAG
>TTN-205,,0,109,3338109,3338217,GTATTTGTCACTGGCTTTAGGCTTCAGAAGACTGAACTCTTCATTTCTTGAAAATACTTTTCTAGTGGTCTTCAAACTTCTAAATGTAATTTCACTAATATCTTTTAAG
>TTN-205,,0,111,3338218,3338328,GTATTTGTCACTGGCTTTAGGCTTCAGAAGATCAAACTCCTCTATTCTTGAAAATATTTTTTCTAGTGGTCTTCATAACCCCTAAATGTAATTTCACTAATATCTTTTAAG
>TTN-205,,0,111,3338329,3338439,GTATTTGTCATTGAGTTTAAGCGTCAGAAGATCTATCTCTTCTACTCTTGAAAATATTTTTCCTAATGGTCTTCATAACTTCTAAATGTAATTTCACTAATATCTTTTAAG
>TTN-205,,0,110,3338440,3338549,GTATTTGTCACTGATTTTAGGCTTCAGATGATCAAACTCTTCTGCTCTGGAAAGTATTTTTCTAGTGGTCTTCATAATGCCTAAATGTAATTTCACTATTATCTTTCAAG
>TTN-205,,0,84,3338550,3338633,GTAGACACCCTCATGGTGCTGTGTTTGATATTGTTTGTTTGTCTTTACTTTGTCTAACAATGAAAATAATAATATCTTTTAAAG
>TTN-205,,0,128,3338634,3338761,GTAATAATGAAACTATTCAAATTAGTGTTTTTTAAAAAAATCTTTCCTTAGTGTTGTAAAAACATTTTTTTGCAAACTATCTCAGTTTTAGTCAATTCTGGCATTAAAATGAGCTCATGTCTTTAAAG
>TTN-205,,0,134,3338762,3338895,GTACATGGCAAGAAAGCTGCTAGGACACCTCGGCCACTCTTTCCCCTTCCTGCCCTGATAATTCTGGGTGCTCTGAGCTTTTGTCTTGTTTCTCAATCTTCGTTCTTTCTAAAACATACCTTCTAATTCTTTAG
>TTN-205,,0,129,3338896,3339024,GTATTCCTCACTGCCACTAACTCCCTAACAAAAAACTTTCTTTGAAGTGTCATATTCTACTGTTCTGCTTCATGATTTTCACATTTCATTGAAACCATGAGCTTAAACAACTACTAATATCTTTTATAG
>TTN-205,,0,132,3339025,3339156,GTATATGTGGCTGTCCACTGTTTGATGGGGGCGGATGGAGCCCCCAGCTTCTAAAAGGGTTTTGTTCTGTGTAAATGTGATGAATGTTTACTGGTGATTGTTTCTAATGTTAAAATACTAATATATTTGAAG
>TTN-205,,0,408,3339157,3339564,GTACATGTCACTAATGAGATTCTGCAGAAAAGCACTCACCCTTGTCTAATAAGTCACCTATTATCAAACCTTTTGTTTGCGAGTCCTCTTAAATTTGCAACTACAAAACTGTCATTCTGGATTTTTAGGGTCTGAATACTTTTTAATAATTTTTTCATTGACTTTAAAAAGTGATATATTTACTTATTACAAGCATTGGAAAAGTTTACTAACTTGGTTCTTTTATTCTTAATAGGCCATATTTTCCTCCCCACTATATGAGGGTCCAAAGACAGATCACTGACCTTATTGTGAAATTTGTTCTTGGATCTGTCCCTGGGTTATTTGAGCAAAATGTGAAGTCGATGTGGTATAAATTTAATATACTTCTCAACTACTCATAAGAAAAATGAATTAATATCTTTAAAG
>TTN-205,,0,479,3339565,3340043,GTACACGTGAGACCGGTGATTAATGACCTTGCCACTTGCGACTATTTCTAATTTAAGCTTTGTTCTTCTTCCTTCCTAACTCATTATTTCTTGGTCATTTTCTAACCTTTAATTATTTGTCTTAATTCATCATTCTAAATTAGCTCCAATCTCAAATCTATTTTGGGTTATTGGTCCACAGTATCTACATAAGTCATAGTAAGCTATATTAAACAAAGCTTCTCCAATGTACATAGAAAGTAAGGCAGGAGAACTAATGATTATAAATGACATTAAACACTAAAAGGGCTTTGCAAGCATTTGAATCAATAGACAAAGAAGTCAGTGCAAATGAGATAGATTTTATCTAAACAAAAATAAGAGAAGGTATCAATTGAAACAAAGGAAGAAATCAAGATTACTATTTATCGTGTTTAGTGTTTGTCCATCTTAGAATATTGTTCCATACATTGAAATAAAATTAACTAATATCTTTAAAG
>TTN-205,,0,269,3340044,3340312,GTACAAAGCAGAATCCACTGTATGGGAAAATACAGTCATTTCATTTTTCATGTCTATATATCTTCCTTAAGGCAAAATATCAGTCTTGTATCTTGTTGCCTGAAATCTGACTACATTAAGAACAAAAGTTATTTCTACACATAAAACTTTGGACCCACAGAATTTGGTCCCACATATACCAAGAAATATGTGTGGTTTTTAATTCATTCATTAGCATTAAATTTTTCATTGTAATCACCTAATTCTAAAAGAAATTCCTATTATTCAAG
>TTN-205,,0,185,3340313,3340497,GTACTCATGTTAAAATGAATACTTCATTTTTGTGGTGTCTACAATTTTACACTCTTCTTATTGTGTGTTGTGTTGTATTATATGTTTGTTAACTCTTACCTATATGTTACAGTGTTGAATAAACTTGTATGTATATCTTACATCTCACAACTTTGTATTATTAAATGCTACTGATATCTTTAAAG
>TTN-205,,0,222,3340498,3340719,GTATTCACTTCATCGTTGGCATCATAAAAAAGAAAGTATTCTGATATCTTAAAGTGGAATCCAATAAGTTGTCCTCATTGTTGTTGCATAACTAAGGACAAAAATTTCCTTATTTTGCTTTCATTAATTTTAATGCTGCTCCAATAAATACAGGTTTTTTATTCTTAATATTTTAAAATGTTTTTAAATACTATTTTTAAAACAAAACTAATATCTTCAAAG
>TTN-205,,0,1783,3340720,3342502,GTACCTACCATGAAGAAAAAATAGATTTCTCTAACTGCTATTTAAGCATGTTAATAATAGGTCTTAGAGAAAAACATACTGAATGTGAATTTATGTTAAAACCATATTGCACAGAAAAAAGGGAAATAATGAAGGGAAAAAAATGAAACAGACAAGCAGGAGTGAAAAAATGAGTGGGATTCAGTTGTGCTGTGATATATCACATGGCTACAACTAGTAGAAAAGAACCTTCTCTCATTCAATGTGTAAAACAGCTCAATTCAACATATTTTGTTGAATGTTGACCATTAACAAGACATCATATTAGAAAAATTAAGGCCTGATTCTGTCTTCAAATAAGTTAAATCTGGTGAGAGGATAGAAAGATAACAGGACTCTAATACAGACAGGAAGTGATTACACATAGCAAGTGAATACAAAAGGGCTGCAGAAACACACGGCAAGAAAAGATTAAGTTCAGGCAGAGGCATCATGGGAAGCTGTGTTAAACTGAATTTAAATTTTGATGGACTTTTACATGTAGAAATTGAGGAAATAAGGCCGGATGTGGTGGCTCACGCCTGTCATCCCAACACTTGGGGAGGCCAAGGTGGGTGGATCACTTGAGGTCAGGAGTTCAAGACCAGCCTGGCCAACATGGTGAAACCCCGTCTCTACTAAAAATACAAAAATTAGCTGGGGGTGGTGATATGTGCCTGTAATCCCAGCTACTTGGGAGGCTGAGGCAGGAGAATTGCTTGAACCCAGGAGGCAGAGGTTGCAGTGAGCTGAGATAATGCCACTGCACTCCAGCTTGGGTGACAGAGTGAGCCTCTGTCTCAAAAAAATTAAAAAAAAGAAATTGAGGACATGATATCCCATGGAAAGGGAAGAGCATATTGAAAGGCACAGAGATAGAAGGGTCTAGAATGTTCAAGGATTGTCAAGTAAACTTATGTCAAGTAAACTCAATTTGAGTATGGATTGGCTGTGGAATGTCTTGAAAGATAATACCAGATATAAAGATGGGGTCATATTTTGGAGTACTTCAAATGCCAGTAAAAGGCTTGTACTTTTTTCTGTAGGCAATAGGAAGCTTCAAAGATTTTGAAGCAGGCTTACATATTAATAGGATTTGGGCTTTAGAAAGATAACTGGCAGCAATTTCAGCTACTAAATAGTAAAGACCCATTGCAATTATTTAAGGTCTTTAAGAGTTGGACAAGATCCGTGGCGGCAGAAATGGAAAGGGGGACTGGGTTTGAAAGAGATGGAGACTTAGTGGCCTCTGACCATTATCAAAACCATTAGGGAAATTGAGGAGCCCAAGATCATTGTAAGGTTTAAAGCTAGATGGCCAAAAGAATGGTTCATTGGGTCTCTGAACTAACGTTAGAGGAAAATGGTAGATGTGCTTTTCACCTTTAAAGCATAAAAGTTGGGAGTGTGTATCAGGAGCTTAAGAAAGAGATCAGGCCTAGAGATGTAGATCTTAAAGTCATTCACATGTAAATAAGAATTGAGTGTGCAGGAACAATTACTCAGAAAATGTAGAGCAAATTTTTTTAAGTGTCAAAGTTAGACCACCTTCATTTAAGTGTACACAGAGGACTAGAAGCAAATGAAGAAAGCTGAGAAGATTCATATATAAAATTAGGATGTCCAAAATGGTGCCATGTCTCAGAAGCCATTTTCCCCATGAAATCTAAGATGAAGCTCTTGCCCCTGCATTCTTTGCCTGCTCTTTAGACAATCTTGCATGTCTTCTAAATTCTTAATAGTAAACAAAATCATATCTTTAAAG
>TTN-205,,0,236,3342503,3342738,GTACACGGCTTCTCCATAAATCTTGGAAAGATGACAATTGTCTTCATCCTCTTGCTTTGATTGTAGATGAATCTTACGTATTTGTCTGTCTGTATTGAAGTTATTGATATTTGGGGGGTCATCTGAATAATCTGTTATAGAGTGTTACTTAATGTAACTAGGTTGATATGTTAGAATAGTAGTTGCAGTATTCTGTTCTAAATATAGTCTAAAATAAAATACTATGTTTTTTAAAG
>TTN-205,,0,504,3342739,3343242,GTATATATATATATATATATATACATTTTTTTAATCTCCTGAAGATTCCTGTTAGAATTACAAAAGCATTTACAGGACAATATTCCTTCTTGAAATTATATACAAGAGCAGTCTAGCATGTTTGACTGCTTTATTTTTGAAATAGTTACACTTCTTTTAAGTTAGAATCTTTAATTTAGTTACTGTTGTTGGTAATTACAATTTCCAAAAGGTACAGTTTACTGAAGCAAAATGGAATAATTGCCTTGGATCCTCAAATGATAACACGGTATCAAATTTTAAAAGTCATCTCATTTGCCATCAATATACATTGAATAATCTAATTAATAGGCAGTTCAAGTAAAAGAACTTTTTCTTATACGTGAATTTTTCTATACATGAATTTGTATGAATTGTATATTTTTATTTTGTGACTGTAATCTTTGCATCAATGTGAAATTTGTATGAGTCTTTTTGAAGAACTTTACATTGCAACCTCATCTCCTTTGTCAACATTCTTTAAAG
>TTN-205,,0,454,3343243,3343696,GTATTCAATCCAGTGGACTTAAATCTTCTTTATCATATTCTTTCTCTTGAAATGTATATGGTTTATGTTGTTGTACATATGTAGTATGTCTGTTCCCATTTGTATGTAAAGTATTCTTTGTTGTAAATGTGAGCCTCATTCTTAGGTTTCCATGTAACTTGTACTGTTTCTCTCATGTCAACTGTGGCTTGTCTGGATGCTTTGTTTGTTGTTGTTATTGGTGCCTTTGCTGTATTTCTCATCATCTTTGTAAAGGGTTGATATTTTTATGTTTTATGTTCTGTGTTTTATGTTGGATACTGGTATTACGTACCTTAAAAAGTAAACTTTGTACTTCATATATATATATATATATATATATATATATATATATATATATAATTTCTATTAAATATACTACATATCCACATGCTAACATATACATATACTAACACCTCTGAAATACTCTTTCAAG
>TTN-205,,0,1303,3343697,3344999,GTAAAAAATGCCACTTCCAAAGTTTTATTAGCCTGCTTCAAACTTCTATCCAGCCATCTGAAATGATGCTTGCAAGAAATGTATGACTTTTAGAAGTGTGTACTTTCAGACATGATTGTACTGTGAGATTGCATAGAGCTGTCTCTTCTGCTGCCCCATGGTTCCTGGGTTGCTTGTCATGCCATGCCTGCTGCTGCAAAAGTCAGAAAGTACATTGATAGCGTCATCCGGGATATCTGAATGCAGGCACTGTCCAATTAACTTTCTTTTGTGGAGTGGGGAGAAAGAGTTTTCTGATTTCAAAGCCTGATTGCTATACATATCATTGCGATCTTATGCTTAAGGAATGTATAAGAAATCCTTGCAAGATATTTTTAATATTGCAGTAACACATTTACATAAAAGCCAAAACTTTGTTCTTAAAGAATTGCATGTGCTTTTAAATATATTACAAGTAATATAGTTATGATTTCCAGTAGCTGATATGTGCCTATATATCATGAAAGGAAAGCATATGAATGACTTGTTACAGTTCCCCCATCTCTTTTTTTTTCTTGCAACTTAAAGAAGTGTTCTGTGTGGTTCTCAGGGGAGCTGGAAAGAGTGGTTATGAAGACATTTGGTATCCAGCATTTATTATTAAACTTCCCTTCCCCCTTCTTATATTTTGATTTTTCTATGAATTGACACAATGTTACTTAATTTTAAAAATATCAGTTTCTTTAAAAGCTGAAATAAACTGGCAGAAACATATTATTCTTATTTTAATAAAAAGTTGTCTTGTGACGTCATATGATTCCCCAATCTAAAATTATCTAGATATAATCTTAGATATGCACTTTCCCTATACAGACCTATGTATCTTCAAACCACAGTCTTCCAGCATAAGACATTGCTGCTGGTGATTCTTGCCCTCTACAACCCTCATAGCCATTAGGGGGACCTTCTGGCACCTCTTGAAAGGCCACCCATCTGTTAATTGACACTCCATGAAGACACACACATAAATACATTTCCCTTAATGTAAAATATATGCTTAAAGGAAAATTTCTTCCTCCTGCCAATAACAAAAATTGTCTTCTTTTTCTGCTGGTCTTTAATTAACTACTGAACTTTGGAGTAAAACTGCAGTCTGTTTTCATGGTTCGAATGCTGCTTGTATGTTCTTTGAAGGCTGTTCTTGGCTGTTATTAATGCTTTCTGGTTATAAGCAAAGCTTGGTTTTGATTCTTGGAGTAGAAAGTTAATCACTTGCTTCAGATTAAATATACAAATAACAAAAGTAAAATCATATTCTTTAAAG
>TTN-205,,0,2230,3345000,3347229,GTATTTCACAGGCTGAAAAATACATACTTATGTAGTACCCCTTTACCTGACTCCTTGCTCTTTCTGCCTCCATCGAATGTTCTGTCTCTCTTTTTCAATGATCAGAGAGTAGTCCCATTCATTTCTTATATTTCTGTGGCTTTTATGGTCCTGGCTCATGAGTGTTGCTTCCTTTGTCTCCCATCCATTTCATACATGTATAGACATGGTCTATCTTTGTCTCATCTACATATGTCTTCTTGCATTTTCCTAAACTTAAAAATAACAAATTTTACTGGTTAGCCAAAATTGATATCAAGAGACATATGAGATTAAAATGCTGAGAGCTAGTAGTAAACTGTTTTGACATTTCACCTGACATAAAAATTTTAGCCAATGTAATAAGCACTAAAAATAAGTCCTATCTTCCTTTTATATTATTAAGGTTATTTGTAGGGATTTCCTTAGGACTTTCATGTCACTCTCTTCTCACTGGCTCTAAGTCATTCTCTGAGGGGTACGGAACTCACATTTCAGAAAAATTTCCTTATTACTGTAGGTAATTTTTCAAAATGTATTTTTCTGTAAACAATATTTTCCCTAATAAGGTCTCATCTAAAATTAGACCCTAAAGAAAACTAAATGAATTATAAGAGTCTAGAAAACATCTATCAAAAATAAACATAATTTTTCTAATGGGTAGTAGTGTTCTGTTCAAGTAATCAACACATTCAGACCTAGAAATTAAGACTGTTTCTGGTCACTCTGAAATTTTGGGGAAAAAAGTCACCCATATAAATATACATTTCCTGATTTCATAAAGAGGCAATTACAAAATAATGTTATCATGGATATTGATCATAAACATTAAAATAGCATATAATCACATATAATGACTTTAAAAATAATAGCTACAATGTTGGGTTCTCAAACATCAATAAGATTTTTAAAATCAAATAATAATATAAAAAATGCACAGATATATTTTCACTATGTTCATTATATCAGTAAAGAAAATCTATATTATGCCTCCTCACTTTACATTAATTAGATGCATGTGCTTCCTTCTGGGTTTGAGCAATAAAAATAGTTATTAAGAAGATTGGTACCTCTAAAATAGTATTGAAGGCCAACACAATTTATCCTGGATAAAATACGTAATGTTTAACTTTAAAATTTTTACTTAAAATATTTGACATTAAAAAAATGATTATTCAAAACGAAATACATATTTGCCTATTGTAGGTTTAAATTTTTGAAATAAGAGTTAAGCAGTTATCTTTATCACATAAAAAACCATTTAATGAATTGCAAATATCTTGTTTAAAGCCCTAAATAGGAAGTTTTATAGAAATATCTAAAAATTCAGATTCCTAATAGCAAATAGTTACACAATACAAATAAATACTGTTTTAAATTAGATTTTAATTGACATTAGTAGAGAGGAAAATGGTTTAATAATCACCACGTGTTCCTTTCTTTCACCATTCAAATCTATGAGGGCCATAATAGCAAAAGAGGCTGCTCTATAAAATAGCATCATCCACCATGCTCAGTATTCACTGTAGACGCAACAGGAAATTTTGAATTCCTTGCGTTCCTTAATTTGAATGAATTTAAGAACATTTTCTTATTCATGAAAAACGAGCTTCCAACACCAGCTTTGAAATTTTATAATTCTATAATTTTAAATATTTTATCCAGCATTATTTCAAAAAGGAAATCTTAAGAAAGGCTACTCTTCTTCTGTTCAGAAAGTGAGATATGGCCCTTCCCCAGCATCAAAGTCACAAACCGGAACTCTTGGCCACCTTCTTCCCTCAGTGGAGAAGACTGAATGATGGCACTAACACTTGCCAGTATCATTTTCATACATTTAGTGGTTGGGTAGATAACATCGTAGATTTGGACAATCTACAATTGCAGTTTGGGACAAAGATGCTGTCAAGAACCCTGTAATTTGATGAAAGATTCATAAAGTCAGTATGGAGCAACATCCTCTACATGCATTTAAAATGAATACATTTGCCTGCAGTTAATGGAGTTGAATTTCATCACAAGGCTGTATAGATATTTGCAGAGGAGATAACTTGAAATGTATCATTTAAACTTAAATTCTGTGGTATTTATATGCAGCGAAAATTGTTACTTAATGCACTACAGTTAACTAGTTTTAGGAGAGACATTTTTCTTGTTGAAATTCCGTTTTTATATAAATTCACTTCAAAATTTGAAATCATATTCTTTTAAG
>TTN-205,,0,921,3347230,3348150,GTATAGTATTTTTCAACCATTCTGTCAGCGTTAAGTATATTTTAAAAATGAACTTGAAAGCTTACAAAATGTTTCTGTCCTTTGGTTTTCTTTGAATTGGTTCGCTATTTATCAAAATTTGTTTGTAGTTTCATTGAAAATTAAGAAAAATGTCATTTCCAGATCTTTTTTTTTAAAAAAAAAAGACAGAAATTTTGTGAGCATTCACAGTATTTTGAAATTTAAAATGTTAATAGACATAACTAAGTTGATAATATTCTAAACTAACAACAACTATGACTGCCATTTTCATAACCAAATTATGTAGTAAAGTACACTAAACCTATTAAATACCTTACATGAAACTACTTTAGCTTAAATTCAATATTCAGTTTTAAAGTGTGACACAGGATCACCACAACTAATAAATAACATTTTTAAAAAACTGAACATTTCTTTCTGACTAATAAAATATTAAAGAATGAGAAACAAGATAGTCAAATGAAGAATTAAGTTCTAACATTGTCTTCACATAGAATTACTGATTTTTAGGCTACATTTCTTCAGATATCTCTGCTTAAGTAAACTTTCTACTTATTTACATACTCATTAAATCATTAACATTTAATTATTATTATAATTCGTTGCTATTCAAATTATTCATTTTGTGTTGGAGCTGTTTCTCCCACAGACTTGTCTCAGAATAGACCCTCTATCTAGATAGAAACAAAGTAACTTTGAGTGCTATTATAATTGACAACCTTTGATTTTAAAAAAAACAAAACAAAAAACACTTTCGGTGTAAATGCTTACTTTCCAGAGTGCTAGGTAGCATGCTTTTTTTCATTTTCCTTGCTTTGTACATTATTTGCATTTGTCAAGCTTATTCAACATCTTCATTAGTTTGTCTTGGTTTACATATAAACCTTTTTGTCTTTAAAG
>TTN-205,,0,610,3348151,3348760,GTAGGAATCTCAGTGACAATTTGTAAGATTATCTTTTAACAAAATGGACATTTAACAAAAGGTTTATCTTGTAAACATAAATGAAGTTAGATGTAAACATGGCTTCATATTTCATCTGTGATGTAGTCTCTGTTTTCCATTGTCTGCTTTCTGTTTAAATATTTTTATAGTAATTCCCAAATCCATTCATGTATTTCCCTGCACTTCATTCTTATCATTACTTTGCAACTTAAGTTCTTCCAGTAGAAATGACTGAAATAATCAAGTGGCTATTCATGGGAGGGTGTCAGCAAAGGTTTCATAATCTGGGGGCTTTTAAATGGGTTGGTTTTTATCATTAGCCTATTCTCAAAGGGCAAAATTATTGGGAACTATTATAGAAGTGATTTAGAAGGAGAGAGCTAAGGGGAGTGGAAGATAAGTGGATGGAATAAAAGGAAGAAAAATAAATGGAAGCAGAGTCAAGAAAATAAAATAGAAATTACTTGATAAACTATAAGGTTTTTTAAAAAACCATCCATAGAGTTTTTGAAAAATAAATTGATATTTCAGATGAGGTGCTTCCTAAATATTCAAATATTAACACTGAAAAAATAATCTTATCTTAAAG
>TTN-205,,0,430,3348761,3349190,GTACAAATCTACTGTCATTCTTAGTTGTCTCTAAAAATGCAAATATGTATCATTTAAAATATCATTACACTGACATCAAGATTTGAACACATGACCTTAATCTGTTAATCACATATGGCTTAATTTTCTTTACCATCTCACTCTCCTATGCAATTGGCTAATGATTACTCAGTTGCTAAATAAGTTACCTGAAAAAAAATTGTATTTATGGGCAATGAGATAAATAACAACATTAAAACCAAGAACATTGCCTTACTATATTTTCCAAATATTTTGTTTAAAATGAAAACTAATCAAATACTTGATTTGATAATTATATGTATATAAATTCTAATATCTTCCAAGATACGTGGGCTTAATTTTAGTTTTGACTTTGTGAAAAACTTCAAAAATCCTGTAATAATCTGCCCTCTACTCTAAATTATTTCAG
>TTN-205,,0,259,3349191,3349449,GTGAGCAAGCTTATCCTCAATGTCAACAGCATATTCTTTCTGTATTCACACACATAACATGTACTTAATAAAAGATAGTAGGTGAAAGTCAGTATGTATCAAATGATTTCTAACGTCTCAAAATGCTTAATATACTATTCTCTTAAAAACTAGTTATTTGAAGATTTCAAAATTATATCAGAAGAGGCAAATAAGCTACCAAATAAGTTTTTAGGAAGTGACAAATTGATACACTAATGCAATGGACTTCTCTCTACAG
>TTN-205,,0,2279,3349450,3351728,GTATTTATCCTGTAGCTTTCTTTTTGCTAGTTTGTTTTGGTGACTTAATAAAAGTATTCACACTTGATTAAAATTCAAGCCCTGTTTATGCTGCAACATAGGTATCATTTCAACTTCGGAGGTTTATGGTAAGTTTCTACCTTTTCTTCATGTGATATCCTTTATCCACCTTGTCTCTTGCCCAGTGGGTGAATATTGTGCCTTAACTGGAATGTACGTTCCTGGGTTGCACCATTTCTTTCATATGCTTTGGAGATTAAGTAATGAATATGTTTGGGGCTGATAAAAACTAAGGAGACAGGCAGAGACCCTGTAAGGGTATACATATAAGAATCCCATGAAGCTTCAAATTTCCCTTATACCCTATTGGAACAATTTCTCTTTTTTAAAAAAGTGTGTATATTGGGATAATGTAAAAGTTCTGGAAATGGATAGTGTTGATGGTTGTACAATATTGTGAATGTATTTCATGCAACTGAATTGAATACTTAAAAATGGCTAAAATGGTAAATTTTATGTTAGGTATATTTTACCACAATAAGAAAGAAAAAGAAAAAAGAGACTCCATATTTCAGTCTTTTAATCTGTATAAGGAATTAGATCAATAATAATTTTCTTAAATGTTCTAACTTAATGATATAGGTATCTCAAGTCCAAACTTAAAGCACCTATTAATTGTATATGAACTATTTAGTATAGTTCATCATTTAAGTGATAATTTGAGATATAATTGATCAAAACTGATTTGATGTGTAATTGATAGTCATTGATAAACATACACATCCTGACTATTTGCCCTTTGGCTCACTATCTGGGTGATGAGATCACTCATATCCCAGACCTCAGCATCATGAAATATATCCACATAACAAAACTGCACATGCATCCCATGAGTTTAAAATAAAAGTTGAAATTATTTTTTTAAAAAAGAAACAACAAAACCAAAAATAAAACAAAGTAAATTTAAAGCGGGGGCGGTGGTGGTGGGGTGGGGAGAAGGCATGTATTGATAATTTTCTAAGATGTGAAGAATCTAAGATATTCAATATAATGCCTTGACAATTTGTTCCTATGGAAAAATGATCATCTCCACTGATAAAGCACAAAATAAAAAATTCAGGGTGAATTTAAAAAAAAAAAAAGAGAACTATTTGTTACATTCCACAGTGAGATGTGCATAGGCCCCGGGAATAACATTTAGAAATGTCCATAATAGTTTGACAGAGAAATTTTTTAATTTAATTTTCTGAACCTAATAATAAAAATTGGCTTATATCTTTAATAAATCAATAAATAAAACTATTTGGAAAAATTATATTATTTTAGATTATTAATTCAATAATTAGTCATTTTATATTTGTTTATATATTTTTATATAAATTATTTAGAAATTTTTTTATTTAAAATTATCTCAAAATATTTGGACATTACCATGTTTAATGACATAAAAAAATACACTATATTCTTTTGACTGTAGTTTAATTTTTAATATTTGTGTTATATTTTGTTGCTGATGTTTATGATTTGGGCATATTCTTTTAAACTTTTATAATGTCAACGTAGTACTTTTATTATTCAGAAAAAGGTGATGAACTGCTCTTGTCTAATTAAGTATGTATAAAAATAAAGCTATTCTCAGTTATCCTGGGGGCTGAAGCTAGAGAACTCATTCCACAGTTTATACTGTCCCTGTATTAATAATGGAATCAAACTCTAAATGTCAGAACTCTCTTGCTTCTGCCTTACTTCATTGTCTAAAGGAAATCTTCAAAGAAACTCATGCATGTGTGGTACATGGACTCTTTTTCCTTAGTCTTCCCTGGATTTGTTTGTCTGCCCAATTTAGACATAAAAAGAAAGGCTTTTGGTAACCTCTCAGCCATTTCCCTTTTCCCTACACTGATTTATTGACAAAACCTTATTTCCTTGGTTCACATAATCAGGACTTACATAAACATATAAAATATTTTGCACAGCTAGGCAGGAGCAAAACTTTTCCTCACAAGGCAACAGTAAGCCTTCCAAAAATGGGAAGATAATAAGGCACTTGCTGAAAGAAGTTGTTAATCCTAAATATGTTGGCAGTTTAGCTTGAGCTCTTCAGTCTCAGAATATGCCTTCCTGGAAATGTGATTATCCATAGAAGTCATATAAATGAAACCAATTTCTCTTTATGCGTTAATATTTATAATGGAGCATGACTCACCCTCCATGGTTTACTATTAAACATGAAATAAGTCCGAAAAGTGTTTAAATGCTGAGTTTTATTTTTATTTCAG
>TTN-205,,0,569,3351729,3352297,GTGAAATTCATTTTTCTAGTACTTGCATTGTAACCTTCCACTCTGAATTTCCAAAGTTCATATTCAAGGGGAAAAAAATTTCAAAATTCATAACAATTTTTATTTTTTCTAATTGATTCTACTAAAACTAGCATGTTTTCTGATATTTCAAATAATACTTTTAGTATTATGCAAGGAGATATATATATATATATATATATATATATATATATATATATATATCCAACTATATTTTAGCATAGTGAATCCCATAAGTTCTTAGCTTCATTTTTCATATGCATGGTATTTATACATGGCAGATAAAATAATTAGACATTAATCTGGCTATTTTATACTTCAGATTAAAACTTGAGAAAAGGGACATTTATTATTCATGGATTCCTTATACCATCTCATTTTCCTGCCTGAAACAAGGCAGTATAAACTCAATTGGCCTTTCAATTGCCTGGTCTTTAGTTTTCTCGTCTTCTAATTGCTTTACGGCTGGTTTTATCCAGCAGGCAGCCAAGTATGAACTTTCTGACTCCTAAGGAGATGCCAAATCAACTTTTTATTTTACTTTGAATTAG
>TTN-205,,0,156,3352298,3352453,GTAATTTCTAGTCTTCTGAACATAATCTATATTAAACTTTAATGTAACAAACCTTAGTAGCAACTTGCATTGTAGTTTTACAAAACCTCTTATTTCCAAGTTTTATTTCATTGAAAATATTGTATTTATTGAAATATATACTGAAATTCTCCATAG
>TTN-205,,0,247,3352454,3352700,GTTAGTACTTTCCTGGGAGATTTCGTTCTGCTTATTGTTACACTAAGAAAATGGAAGAAAGGACCTCGTTTCCCAGTATTACAATATCAGAAATCTTGTACCTAAGAGGGGAATAACAATATATCCTACAGTGGATTAATTATGCCCAGTATTGTGAAATTTTTCCTATTCCTGAAATTTACTAAGGAAGCTATGTATATTACTTGTTCAGACCTTAATCATTTTTTCTGATCTTATTTTCATATAG
>TTN-205,,0,135,3352701,3352835,GTATAAAATCTTACCTTTTATTCAAATTATAAGTTTTGCGTATGTGTAAAGCCAAATAACACACCAAAACACATAAAAGCAAAGCATCGTTGGGTTGTCTAAAGCATTATGTTACTTCATCCCTGACCAATACAG
>TTN-205,,0,315,3352836,3353150,GTGAGTAATTTCACATTTTAAATTGTTAGTCATATAAAATAACCACATCCAATATTCAGGATCTATATCCTAGATTCGGGTTGCTTTAATAATAATGGAGTTAATGGAGTCTTCTAAAGTCTCCAAGAAGGAAAGAAATTTTACGTATCATTTGGGGACAACTTGAACAATTTGTGTAAAATGTTATGACAGGGAATTCTCTGCTTACTTTTATTAGTAGTAATTTTTAAAACTCTATAGAAATTTGTATCTGAAACACTTCTCCTATAGGGAATTTATCTCTTTCAAATGGTTACTAAAACTATTGTTTTTCAG
>TTN-205,,0,93,3353151,3353243,GTATGGGGCTTTTAGAATTTGGGGAGGGGTCTCAACTTTATTTCACTTCCCTGTGCATTCTGAAAAGCCTCATTCTTAATGTCTGATTTTCAG
>TTN-205,,0,282,3353244,3353525,GTAAGCGAGCTAATGAGATCTGTGACATCCCATAAAGGCATGCAAATATATGACTTTAAAGATAGGACGCCAAGTTCTAAAAGCTGTGATAATGCATCACTAATTAACTTTCACAGTGTTACCAAAACAACCCCCCTTAATTTGTTTTTAGTGGAGCTCTATTTGGAAAGATGAATAAATAAGTGCCATGTGAAATGGGTCCCTTTTACTCAGGCAGATTAGAATGGAATCTTTCTGAAGGTGAATTGTGTTTCTGAGGCATTATCTATGCTTGCATTTCAG
>TTN-205,,0,140,3353526,3353665,GTAAATGTAACCAAGTATAACCAGATAGCCAGTTTCTGAATCATGGGAGTGGGGAGTAATAAAATATTTTGCAACCTTTTACTCTTTAATAAACTTTAATTTTCACATTCTTCTAATTTTATGCTAAATGTCTTTTACAG
>TTN-205,,0,86,3353666,3353751,GTGAGTTGCTCAACAATGTAAAATTTACCCTATCTGAATCTGCAGTTTATTAGTTCAGTCATGCTAACAAAACTGTATCATTTCAG
>TTN-205,,0,142,3353752,3353893,GTAAGTCAAGATTAGCTAATTATATAGGAGAGGGGTTGCTTGGTTGTGTAGGGTGAAAAAAGGCATAAAATATCTTGATGATTTGTAGGAATAACTATATAAATGATGTTCTTTCTTTCCTTCTAACCCTCACTCCAAACAG
>TTN-205,,0,125,3353894,3354018,GTATGCTCTACTTGTCAGCCACGTTTTTGTATTTTCTCTGCAAGACTTCCTGATACACCCCTGCATTGATCAAGGGTCATCAATGGAAACGTATTCTGACTTCATCCACTGTCCACTTCTTTCAG
>TTN-205,,0,112,3354019,3354130,GTAAATAGTTTTATCAAATAGTCCACCCCAAAATCATTTTTTTTGCCTTTAGTTTTATATTTCTTCTTTAAAGTGCTTCAATTAATAAGTTCTTTCTTTTTTTTCTTGATAG
>TTN-205,,0,846,3354131,3354976,GTAAGTGCTTTTTAAATTTTAATTTTACTGCATTAAATTCAACAGAAATTTGTGGAGTATCTATTCTATAAAATAGTCTTCTAAGTGTTATATTGCATGAAAGCAGCCCAACTCCTTAAGAAGCTATCACATATGTAATCAGGCTTATTTCTAAAACACTTTACCTTCATTACTATAAGTTAATGAAGATTCTAGCTTACACCCACAAAATAGCCAATTAAAAGCCAACTTAAAATTCTTCATTAATTATTGAGCCCTGTCATGTTTAAAATAGGAGTATATAAATACTTTCTATCTCTTCATTTTATCAAAATTATTTCAGAGGAATGTTTTTCAAGTTTCCCATAAGAGAAGATATTACATAATTTACATTAATAAGCCTCATTGTTTTTCTTGGCCACCTAATATCAACAAGATTAAACATGAAGGCTAACATATATAGACATGATTAAAGGCAAACTATTAATTGATTAAGAAAAACTAACAATGTGAACCTGAAAGCTTAAAAGTAAACTAGACATAATAGAGTTGCTAAGAATTAGAAATTTACCCAAATAATGGAGGAACACAAAATTGTATTTGAAGCTAAATTTCAGTCTTTTTAGCTACTGTTAATAAAATGTTTCAAAATTCAATATGAATGGATTAGATCTTGATAAATCCCACACACTGATTCCCTTCCTAATATTTAGAGAACTTTTGAACATAAACAGGTTAAATGATTGAACACTTGACACAATTTTAAAAGATACTCAGAACTCTGTGAGTTGTGTCTTAAACTTTCCAAGAGATTGTCATTTCCCTAAGGTGATTAATAAAAGCTTTTCACTTATACTTTACTTGCAG
>TTN-205,,0,90,3354977,3355066,GTAAGGAAATTTCCATGAGTTTCACTCTTGAAGCATTGGGGTTATTTGTGCCAGAGGCTAATGACCCATGCTGGCCCTTCACTTTTCTAG
>TTN-205,,0,436,3355067,3355502,GTAAGGCTATTTCTGAACTTGTCAACACCTAAAGGAGCTGTGTGAATTAGAAAAGAACAGGTGAAAGTCAGAGTGGATGCAGGACATTTAAAACATGATAGCAGTTTCTCTATCAGACCCTAAGCCAAAGAGAGATGTCAGGGTCTATGAATGGGCTCAGACTGGCACACTTGCATTACTTTTGATCCAGCAGAGTGAGTATAAGGTTGTAGATACTCTGTGATGCTGCTAGTTGGCTCAGAATTATACAGCTAAAATAAATGTGGCTTTCCTCTTAGTACTTGTAAGCTTTACTTCCTAAAAAAAGAGCTCAAAGTTATATAAAGTTTCATCACCATTTATTTGTTGCATTCCTTTAATTAAGATAATCTATCCTTAGAACAAAATTTCAAAGAAAATTATTTTCTATGAAAGTTTTTCTGTTTTGTTGGTACAG
>TTN-205,,0,797,3355503,3356299,GTAAGTATTGTATATTTTTCAGGGAAATTAAATAAACACTTTTTCAGAAAATGAATGTGAGTGAAATTAATTGGACCTATTTTATTAGTTAGAAAATATTATTAAAACACAAAAACTGGCTCTCTTGTATTTGCCACTTTGACATTCCAATACAGAAGTGGTTCAAATCGTAAAGTTTTGGAAATTTTGTTGACCTTGCCATTTGAACAAAAGAAAATTTAGCAAATCAGATTTTCCTGCTCTGTAGTCCTCTCATTGAAAGTAGATACACATACAATGAGAATCTAACTCAGAACCCTTAAAGACCACTTCCCTCAAGTGGCTGTGCAACTAGAGCACCAGAAAGACAAGCTTTGCTGTGTGGGCATTTTAGATTCAAGAAAGAAGGTGGGAAGCATTAGGCTAACGTTTCTGGAAGGTGCAAAGTGTTTGATGGATAGGGACAGCCTCTGATTGAGGGCCCCTTGTCCTCTCCCAATCAGAGTCTTAGTTATTTTGGAAGTCACATACCTTATGTAGCAAGAAGAACTTGACGCCTGGCAGAGAGACAGATGCAGCACAGATTTCTCGCTGACCTTGTACGTCAGAACGAAAGGGCCCCTACATATACTCGCTCTCTGGCTACCAGCTCTCCCCTTCTCAGCGCCGTGGGGCCACGTTCACGTGGGAGTTAAAATAGTGGCCAGTCCTGTGGCTTCTTGAAGAAAGCAACCATGAAGATTCATATCTAAGTCTCTATTTATTCTTTTGGGATTACAAAATGAGTAACGCAAAGCTGTTTCTTCCCTCTCGAAAAG
>TTN-205,,0,3904,3356300,3360203,GTAAAAAGCAGGCATGCCTTGTCTTTCCCGTTCTTTTTCTGGAGTTCTTCCACCTTCACTTGTATGTTCCTTATTCTTTGCTCTTTCTAATGTCTCTTCCTCTGTCTTTGCCTTTCTCTTTCCGCCTTTAGCCTGATTTCTGCTGAAACTGTAAAGCCAATTTTTTGCATTTTTTCTTAGGTTTAACCTGATGATTTTTTTATTGAAATTGAAATAAATTTAAAGTATGATCATGTTTTAGTTTTTTGAAGAAAAGACAAGACTCATTGACTATGAATGATAGTTTGATTAACCAGAAGGCAGGAAGGATCAAAAAGGCTTTCTGATTGCACGCTCTGCAGCCATGGTGCACATTAAGTTTTAAGACTAACGCTCTCCATCCTATTTAGTGTTCTGCATATAAGGGGATTAAGAGGAGAAGACTGAAATTCCATTTCGGGCAGTTGATCAAGTAGTTGAGATAACTTCTGGGCAGATTTGCTCTTCAAGCATTTCTCCAAAGCTATTTTTAACCTTCAAGTGCTCTGGGCTGTGCGATATCTGGAATGCAAGTGGACTATTTAAAGTGCAACTGATGGTACTGACAAGAAAGAAGGGCTCTGTGGTTATCCACATATGTGGATGAAATATTTTTTTTAAGCTTTGGTAAATAACTAGCTCCTGCTTTTAGCTTTTACTAACATTCTTTATGCCCAAGATTTTACCCATAAGTAAAAACTAAGGGATTATTCAGATAGGCCCACAATACAATTTGCCTAAATTGATCTATATGTTTTGTCCCCAGAAACAACATATGTCTTTAAATTATCTTGACAATCCATCATTAATTTTGAATTCTTAAAATAAAATATATGGAATATGTCCAGCCTGGGTTGGAAATAAAGCACAGGACAGTACATTGTTCTGTGACATATTCCCCCAATATTTCAGAAATACTATTAAATGTGCTATAAAGATCTCAACAAAAATCAAACTTTGAAGACTTAAAGGAATATAATTAAAAAGTGATTCAGTTTAACAAAAAGCCACAGCATTGACTGAAGTATTTGAAAGCAATGCCTTCAAGTAACTGCTTTGAAACAAACAAACAAACAACAACAACAACAACAAAACTAGTATTCCACTAAAGTGATTACAGGGTAATTCACCAGCAGTCATCTGATAGGTAACGCCTGCCTGTTATACAGATAATAAGATCTTCTTGGTCTCCTTTTCCAGTGACCAGAAAAAGCAGCAGTACATTCCATTTGTAGCATGGGAATTAAGTTACATATCACAAAACCTTCCTTACAATGAGGTCTTCTAAATATTGAACTGAGGGAGGCACCTCTACCTTCAAGCTTATTGTTTGAAAAAATATATTTTGCCTATCATGCATGATTTAATTAACTTCATGTCTAAAGGCAGAGAATTGGTTGCTTTTTCAAGATTCTTTCTAGATCTGCAAATTCATGATTTATATATAGGAACACTGCTTAAAGACAAATGATATTATTTTTTCATTACCAAATATCTTTTTGTCATAGTAAGAGCTTCTTATTAAAAGATCAGTCTCAGTTCTAATACAAAAACTGCACTATTTTAATTCAAATGTAGACTCCTAAAAATCTTATTCACATTTTATTTTTAAAAAATTCTCATTGTAACTAAAATTTTTTCTAGGGTTAGAAAGGATCAGTTTACTATAATTCTATAGGGCCCCTTTACATCTCTTTTGGCATAGGAATTTTAATCCTTTACTCTAGGCACCCGAAATACCTTAGCCTTTTGTGAACTTGCTCTTGCATTACTTAAATGTCTCTTTTCAAAAAGAACTTAAATATAAACTTTGAAGTAATAAAATCATTTTGTTACATGTGGCAGATTTTGTTTAAATTAAGTCTGTCAGAACAAACTTGCTCTTGTCAATGTAATTCCGAACTTTAATACTCATTTTATGTAAAAATTTTCGCCTTCAAAACTACAATAACCAAACAAGCAAAAACAAGCTGTAGGAATAGGAAATATGAAGAGAAACTTGTAGACATGAGTTGTTTGCATTTTTTCTTTGTTGTTGTAGTTGTTTTTGGCTGTCAGTTTAAGAAAGGACTGCCAAGTTCCAAATGGCATTTGATAATTTTAAAGTTAAATTTTAAATTTGATAAAATTAAAGTTTAAATACAAAACTTTAATAGTTTTGTCATGGTCATAAGCCTACCGTATTATATTAATATGCTTCCACTATAAATAAATATTTTTAAAATCTCTAACATTATTCTTACAATCTACTGCAAAATCTTCAACATTCATTTCATTGGTTTATTTTTATAAGGCACCTACCAGTTTTCCTTTTTTTTCTTTTAACATAGTGGAGGTAGATTGTATACAAGCTGTTTATTGAGACATACTGCATTCTGAGCAGTGTCCTAGAGTAGCTACAGAGGAACTCAGATGATAAAGCAACATAATATTAATAGATAAAATATATCTGTGGGTGGGTTAGAAACTGAGACACCTTTTCAAATAGCCAAAAGTTGCATGCCAAAATTTATACTGAAATGTTATTAAAAAAACAAATTTTTCCCATTTCAGCACCATGCCCTCGGATAAGTAGCTCTGTTCCAAGGGCATATTTAACTACCCCCTCCTAGCTGTTATTTTTCCTTATTATGTTTTTTGGCCACTCTCAATTATTAAGATAATTATGTGACTAACCATGCCCAGTTCTTAATTAAAGAAAACACTTTTAGATGAAACCTTATTTCTGATTCTTTTCTTTACACTAGCATAACAAATAGTTCCACTGGTGAAAAACTTTACATTATTTTTAACGCTAAGTAAACTCTTAAGCAGTGCAAAATCAGTCTGGATGACAGGGCACAGCTTCTTAGGAATTTTATATCATAGAACTGGAAGAACCCCCAAGTCTCTTATCTTTGCTGTCAGAATGACCCCTATCTGTCGCACCATTGACATCTGATTTTCCCATTCCTGATGCTTAGACACATGAAAAAGGAAGAAGAGTCCAACTTTCATTTGCAGTTTTGAACAAAATTAATAGGTTGTACAAATTATTTAATCACAGGTTTAATTGGTTTGCAAAATAAGTTTAATTGCTAAAATAAATGGGAAGAAGAGTTATAGCTTGTTGTTGCATGGCAAACACCTTACATACAGAACATAAGGTTTACTTTTAGCTTGCCATAGCTGATATTTTCTTTCATCCTTTCATGAATTCGCTTTTCTAAGTTCTTCCTTTATATGTATATAAGCCCAGGGGCAGAATGGGGGCACACATATATATACACATATACGTATATACTATATGTGCTGTATATCTACGCATATGCAAAAAAGACCACAAATGTAAACAGAAACTGGCCTGGGCAATTTCAATGTGAAAGGCCACCTAGTAATTATATAAAGGTAACTATGAAACCCTAAAATTTTCTTGAAAGATCCCAAACTGCATAGTATTCCATGGTGTATATGTGCCACATTTTCTTAATCCGGTCTATCATTGTTGGACATTTGGGTTGGTTCCAAGTCTTTGCTATTGTGAATAATGCCACAATAAACATACGTGTGCATGTGTCTTTACAGCAGCATGATTTATAGTCCTTATACCCAATGCTAGATGATGAGTTAGTGGGTGCAGGGCACCAGCATGGCACATGTATACATATGTAACTAACCTGCACATTGTGCACATGTACCCTAAAACTTAAAGTATAATAATAATAAATAAATTTAAAAAAAAGATCCCAAACTATTGGTTGAAATGATTTTTGAATGCATACGTGCTAAATAGATGATTATAAAACAACTTGGAAAGCTCTATTTCCATTTATTTTTATCTAAATGAATTAAATGCACCCATATACTAGATTGCTGTTTCATGTATTCTTTTTTTAAAAACAACTAG
>TTN-205,,0,541,3360204,3360744,GTAATTACAAGGCTTATTTTAAAAACATGTATAAGGCAGAGGCTCATGAACAATGCCAACTCTCAATTATCTTTATATGATGAGTACTATAGATGTTTAAAATCAACCAAATAATCAAAAGTCTGATTTTACTTTTTAGCATAACAAAATAATTCACAGACTATCTTTTTAAAGAGCCAAAATTGACTAGCATAGGTTTTACTTCCTCCTTCCATCTCTATTGTTTTTATTGCACATCCTAGATTTTCAAAAGCCAGCTGGAGGAAGAATTATTATCAAGCTAGGTATCCATCACTTTATTAACCAAGAGTTGGCTGTTATTTCCTTAATGTTTCCTAGTTTTTAAAAATGATTTTCCTCTTGTCTGTACAAATAATGATAAAATATCATTTTTAGAGGAAAATGTCTGAGTGTAATCAAAACTTGAAAATAAAACTTAGGACAGAACAAAGCCCTGGAGATGGCAGGGGAAAGTTGAGAAGGTACCAAAACTCTTGGAGAAGGAAAGGAGTACCTTGGCTAATGAGTATGATTCTTTCAG
>TTN-205,,0,1697,3360745,3362441,GTAAGTATTCTTCTTACAAAGGACTTTTCATTTGCAATTCTTTAATAACTACAACAACAAAACAACACAACACTTTTTGCATGCCCTTCTTGGCCTAACTGCATTTCTTGGCAACTTCTAGTATTGACACTGACCTAACCTGATCCTTTATGTGTTTAAAGAAAAAAAGAAAAGAAAAGTCTTATTCTATGTCTGGTCTGATTAATGATGGAGCAATCACTTTTCCCTATGCTTCTTTTCTCTCACTGAGTAGTGAGTAGATGTGCTCTTTGTCTACATGGGGTCAGCCTACTGTATGGATATCCTGATATGGATGAGGAGAAACTGAATTTTAAAGATAAGTAGGGAGTCCTAATTTTAAAAACAAAGTAAAAGTGATTTCCATGTGGAAGGAAAATGAATTTTCAGGTGTGGGGAACAACTAGAAAATGAGCATGAAATTTCAGTCTGAATAGGAGCATACTAGAGATCTGCTGTAATATGACAAAGCACATTCACATGATTCAATCTCTGAGAATAAGAATGGATAAGAAGATGGAGTGAGGCCCTGGATCTTTTGAGTCCTGGACTCTTTGAATGAAGAGAACTCTAATGGTTTTTAACATTACTTCTTCCTCTGGTGAAAAATGTAATGTCTTTTTTCAAAATGCCACATACTAGCTTATTTGTTTCATTCATTCCTTTGTCCAGTGATGACATTTTTCTGCAAATTTTTTGTGCAATATTTGTTTGTTTGGTTTGGTTGCTTCCCATCTGTCAACAGCTACAACCTAGTGACTCTGTGCTTCATGCATCTTGTACCATGTTTTTCTTACCACTTTGTGGTTGCTCTGCTCAAGCTTATGTCAAAGTAGCTTCTTGGGTCTCCTTCTTCACCTTGACATCTACCTTCACTCCAAGAAGGCTCAGCTGCAAGGAGCATATTTTCAAACCTATTAGACAGCATTTGTCTCAGAATCTTATTGCTCAAGAATGGTCATCTTGGGAAGGACTCACAGGGAGCTCTGAAAGAAGGAAGGGCAAGGGGGCAGCTCCCTAATCCTATACACCAGCTGAATTAATTCTACAGATGAATGAAATAACAGATGTAAAATCCTAATCACCCTCCCATACAAAACACATTGCTTTATTGCACTAATAGATGTTATGCCTGACTTATATGTGACGTCTTCAAAGCTGATTTTTTTAAAAAGCTAAATGTATGTTTCAATTACAGCCTCATGCCTCTTAGCCATACACAAGGCTGGCCATAGTGCTTCACGTGTTCTATCTTTGAATTCTGCTAATTTCTCAAAGATTGTGCTAAGTGCCTTAAATAAGACAATGTTTCTTTGCCACTGGTGTCTGAAGTTTCCTTTGACATTATCTTTCAAGTCTGGTGCAGTGCAAATGAAGATTTTTCCTCCAGCTATTATTCAAAAGAACTGAGATGGCTCCCTAGTATATATACTGTACACACACACATGCACACTAGTTGAACATATAGAATGCCACATAATTTTATGTAAACTAAAGAGATATCTAAAAAGCAAAGCATCATACCTGATGGGCAGCTTCAAGTGATTTCAAAGTCAGTTGTAGTCTATTAAGATGGAAAATCCCTAAAAAAGAGTCACTTTTTCTTAATGTATACTATGGTAATGTCAGAGTAAATTTCCAGAAACCTCATTTTGAATTCTGATGACATTCTCTTACAG
>TTN-205,,0,661,3362442,3363102,GTCTGTGACTGTATACCTGTCATCTTGTACTGTCAAATAACTTTATATTTACTTTTGGTCTAGCCAAAATGGAAAAAAAAAAGTTAGTCACAACTTCTCTGGTCACCACTTTACTTTTAAAGATAATTGTAGTATAAAATGTATTCTTGACTTTAATTGCTCTCTTTTTAGTATTATTAATTTACTATTACTTGAAAAACACTGGACTCACAATCAGGAGATTTAGATATTAGTTTGAACCATATGAAAGTGCTGTTTTCTTAGATCAGAAAGTCAAATATCAGCAATTATATTTCTTTCAACTAAGTACCTCCTGTTGCTATTAACTACCATTGGCAAGTTTCTTCAAGTCTGAGCCTTAGTTTACACATCCAAGAAGTTAGTCTGCATAATGTCTAAGGCTCACTATAGCTCTAAACTTATATGATCCCATTGTTTTTAATAACTGATAATAGTATCACAGCAGCTAACTTAACAGTAATTGGTAAGATTGTTCTTGCTTTTGGGGTTTGTTTATATTTGTGTCTGCCACCTTGGTTCTTCTTCACACTATGAAGTCTTGTTGGTTGCTTTCAGAAAAACTCAGGATCATAGTTTTTCTTAAGGACACCTGTGTGAAGGAACAACAAGAAAACTGATAATCTATTTATCTTAAATATAG
>TTN-205,,0,98,3363103,3363200,GTAAGAGTAAAGTCATTCTTTGTGAAGTATATGTGTTGGGAAAAAATAATAATTTCCAGCTTAACTCAATGTGGTTTTTGTTTTTTCAATGCTTGCAG
>TTN-205,,0,106,3363201,3363306,GTATGAAAACTACAGTGAATAATCTTTTATTTCTAACAATTCACACTTGCTAGATTTAAAGTACAAAGACATATGTTTCTAATATCTTGTAACTTTTTCTTCCCAG
>TTN-205,,0,108,3363307,3363414,GTAAGTTTGTTCTTGCTTTTAGGGTTTTTTGTTTGTTTGTTTGTTTTGTATTTGTATTTACCACTTTGATCATTATTCATACTATAAAGTCTTGTCGGTTGCTTTCAG
>TTN-205,,0,89,3363415,3363503,GTAAGTAATTTATATACCACTAGAGATTTTTTCATCAGTTTCTGTTATAAAAATAATTAAAATCAACATATTTTTCTCCTTTACAACAG
>TTN-205,,0,104,3363504,3363607,GTAAGCAAGATCTTTTTATTCTCTATTTCTGTAGCTATATATACACTTTTGACAATTTAGTGGCCATCATTGCAAGCTAACTGATAATCCAATGTCTCCTTTAG
>TTN-205,,0,100,3363608,3363707,GTACATATTAAGTGAAAAAACAATTCTAATGTTACCAATTTTTTAAAATTGTTAATCAAAATGTAAACATATTTGTATTTATTTCACATTTTCTTTCCAG
>TTN-205,,0,767,3363708,3364474,GTCAGTCCCTTTATTTTAAAATATCCTTCCAATATCACAGAGTTTAGATTTCAGATTTCACAGTTATTTAATGAGGTAATCCTTGTGAGGGTCTTTCATTTCTAGCAAGCCCTACCCACATGTTAACAACTCTAATTTTGCTCACTACAAAGTAAGTGTCTTGAGTAAGAGGAAATTAATAGCAATAATCTTTACATGCCAGAGCCTTGGACAGTTGCTAGTACATGATGACTATTTATGAACTTAGGCTACAACTAAGCTATCACCCTGAGAGTCTTGGCAAATCTAAAGACGGTCTTATACTCTCCTACTTTACAAACCCCTGTGTGCCTTTTAGGTATGTTCTCATCCTGACCCAGGACATCCTTATACACTGTCCTTATGAAAAAGCCATTAGTGTACCTCTCATTCATAAGAAAAAAGTTTCTCTGATTTATTGAACTAAGTATGCAGTGCCTACTCTATCAAAAAACAAAACAAAACATGTTTTGCACTACACTGAGTCCTATGTTACTATTTTTGGCAAGGAATGCATGTCTTATGATTTTATGCCATTCTCAATCCTCTACTCTCCAATCTAATTTGCACGCACAACAACAACAAAAAGCTATGAGAACTCTAAGCCACTTAGTTTTCTCTGCTATAAAGTTACTGTAGCTTACTTCCAAGGTTATGTAACCAATATTTTCTAATAAATGCATAATAACATGATGTAGCTTGGCTACGTTTAATAGTCGAAAGCGTTCACATGTTATCTTTCTCACTAG
>TTN-205,,0,92,3364475,3364566,GTAAGCCCTTGGGTCTCTCAGACTTAATTGGCAAAGCACAATTTAAAAGCAAGACAGCACACTAAAAAAATTCCTCTATATGTGAATTTCAG
>TTN-205,,0,107,3364567,3364673,GTAAGAAGTTTTAAGTAAATTCAAGTTAGCTTTTAAGTAAATTGCAGTCTTTGCCTTCATCATCGTTACCCCAAACTCATATTTTCTTCTTCTGTGGTGAAATCCAG
>TTN-205,,0,266,3364674,3364939,GTAAGCCCATCAAAAAAGGGAAATAATTACTGCATGAAATCCAGATATTAGGCCTATCAATTAAAATAAATCAAGTTAAATGAAAGTTAATAAAAAGGTAGAATATCATAAAAATTTGGATAAAGTTTTAGAAACCCAGACTGTGCCTACTTTACTTAGTGAATTTGATAAACCTGTTAATGAGGATGATATAATTGATTACAACACTGTTTTCATAAATTGTCACTAACGTAAATGGTATGCTCCAACTCCTTCTTTTATTCCAG
>TTN-205,,0,90,3364940,3365029,GTAGGTCATTTGCATATAAAAAAGAATATTCAATGTGGATCATGGACATAACTGTATGTGTTTTTTACAAATATTAATTCATAATCGTAG
>TTN-205,,0,106,3365030,3365135,GTAAATAGATATTTTATTTTTAGATCGGGGAATAGCACATAGCTACTTTGGGGCAACAGGGACTTAAATATGGCACTGCAAACTCATTAACTTTTCTTCTTTGTAG
>TTN-205,,0,98,3365136,3365233,GTAAGGAACAAAACATTTATCATCTAAGGTGATTTGGCAGTATTAACAAATATTAGTTCAGACTATTAACAGTGACTCGTGAGTGCATTTTTTTTCAG
>TTN-205,,0,690,3365234,3365923,GTGAGTTTTGAGCAGCACTGCATCAATGCCAAAAATGAGAGTAGGGGAAATCCCAGAAGGTTGGGATGCCATACAAAAGTCTTATGTGCTACAACTTCTTACCTTTACCTCACTGAAAATGTACAAAAACTTTTTAAGAATGCATCGGTGCTAATGCTTCCTGAGGTAGCTCAACCAAGGATTGTATAATTGTAATTGTCTTGTCTTGTGAGCCTTACCAAATTTGTAATAAAAAAAAAAATTCCCTACTGACTTGGTACCTGCTAAGTACCCAATATGTACCCATTAAGCTAGAAGTGGAAAGTAAATATTTATTTCCCTGGTGGTCACACTTCTTATTCCACTAGAATACCTTAGTTGACCTAATCAGCCATTATTTCCTTGTGTTTATATTAGTTACTATTCTTTACCCTGAATTAAAATCATATTTCTGATAAGCAAACTGGTAGAATCAACACCTCATTTGCCATCTTTTTTCATGTGTACAAACTATGAAGCAGTTTTTCTTATATTGAGTCAAATATTATCATGTATCCTACTTTGCAATTTTCCCTAATATGAAATTAATGTAAGAATAATCCCTAGCATTCAAAACAACTGCAGTTTGTATCCCTGGTCATGGTAAAAATCTTTTGGGTTGGCGAAAGGGTTTTTTGGAAATAACTGATTAACTGTATTTCTTTGTCCCAG
>TTN-205,,0,156,3365924,3366079,GTGAGTACATTCTTGATGATTTCTTACCTAATCTTGTTGCCTGTTTTTGCTTTTAGACCTAGAGTTGAAGTTATGGGGCAAGGCAGGGGTTGGCAATGTGAAGAGAACTGCATAGGTGGCCTGTGTAAGACTGACTCTCTCTTCCAAATGTTGTAG
>TTN-205,,0,338,3366080,3366417,GTAGGTTTTTAATTTGGCATGAGAGTAAATGTGTACTCCTAGTCACTAAAATGGGCTTTGTTGGGGAAAATTTAAATGTTTGTCTTTTTTCATTGAGAATCCTATGCTGCCGGTGTATCTGTCTGATTTTTAAAGGTGCTGCTGAATGTACTGCCTGCTCAGGGTTTTCATGACAGTATTGAAATGAAAATGTATTCAGTTATAGTGTTGAAGTAATCCAGGTTTAATTTAAAGACTAGTATTATACCAGGGGTTTGAATTTTTGAAAGATTATGAGTACTACACAATGAAACGATTATCGACATCACAGTAAAACATCCTATTCTGTTTTCTGACAG
>TTN-205,,0,93,3366418,3366510,GTATCTATTTTTGATTTTTGTCTTATCAAATAGGCCTCTGACCTTAAATCTGCTTGAACTTGATAACATCATAAATAATCTTTTCCAATTCAG
>TTN-205,,0,117,3366511,3366627,GTAAGGAAGGTTCTCATTTTAAAAGGGGATAAACTCTTTGCAGTTACTTTCTTGAAAGAAAAAAATAAAAAAAATGGTGAACAATTTTTTTTTCTGCATCTGTAATGCCATACACAG
>TTN-205,,0,114,3366628,3366741,GTAAGTTTCTCAATCAGCTGATAAAAAAAAAAGGATGCTTATGTCAAACTTGCATTTTGGTGTCATATTTATATACAGGACATATAACATTTTACACCATTATCCTGTCTATAG
>TTN-205,,0,474,3366742,3367215,GTATGCTCAGAATCCCCATCAAGATGTTAAGACAGCAGTATATTCAAATGTTTACTCTTTAGTATTCCTTGGGATTACAGATGATTATATATTACTAAAAAAATTTTAAACTACTTTTACTCATATTTTCTATTACCTCATAATTTGAAAAATTATATAAATTCCATTCAAGGGCACATTTCTTAGTTTACTCTAAAATATTAACCTTCAGGAAGTTTCAAAGTGTTTGATCCCCCAGTATATTATGATAATGACCACTGTCATAGATATTATAATTAGATTGGTATGTTTGGCCCAGTCTAAAGTGTGTGGCAGTTAAAAAGCAATTTTTAATTTATATTGAAGTGCTTTTCAGTTAAATTTCCAAATCACCTTTTCACAATTTAAATAAATTAGTCTCTTCTGTGTAAAATAAACATAGGCTTCTTCTGCTTCTTACCATGATGATACACATGCACTTTGTTCCTAATTCAG
>TTN-205,,0,88,3367216,3367303,GTATTATTTATATAATTTTTGTGGTTATTTCGAAGTTCATATGAACTCCTTTTTGACAAACCTAAACAATGATTTCATTGGCTTGCAG
>TTN-205,,0,196,3367304,3367499,GTAAGTCACTCTTGATGTCTGGGATATATAAATTCTTCTAATATCTGCCTGTGAGCTACGATATGAGAAAATATGAAAAATTCATTACTATTATTTCCTCCTGGCTACATTACTTCTTAATGACTGCCTGCACTTTCAGACTGACTATTGGGTAATAAAAAAAAAAATGAATTTGTTTTCCTTCCTTCTTTTTCAG
>TTN-205,,0,114,3367500,3367613,GTATGCTCTTGCACTTAATCTTTGTGACAATAAGTGCTCTCGCACTTAATTTTTGTGACAGGAGATTATCACCTTTCCTCTGGTTTTCCTAATCATTGTTTATTTTATTTTCAG
>TTN-205,,0,102,3367614,3367715,GTAGAATTTGAATTAATTCATAAAGAATAACTTACACTTGGCTGCAAATTCTTAACTGTGTTTTTTCATTAATGCTAATGAAATGCTTTGTTGTTTCAATAG
>TTN-205,,0,80,3367716,3367795,GTAAGTAGTGCTGATTATACACAAGATATTGTCTAGAACTTGATGAGACTGTGGATATGAATATTTCACTCTTTTCTCAG
>TTN-205,,0,100,3367796,3367895,GTAAGAGCACAAGGTCTTTTATAGTTAATAAAATACCCTTTATTCATGCATTGCATTTTGACATACTCTGTTTTTTGCTCTTTTGAATGATATCTTACAG
>TTN-205,,0,603,3367896,3368498,GTAATCATTCTTTGAAGAAAAACCAGACATTCTTCACATGTAGAGGAAATTAGTTAACTTTGCAGTGCTATTAATAATATAATTGGCTTCATGAACTGGCCACTTGTAAACTAAATGTCACTTCTGATTATGTCTTTCCATAGGAGAAGTAAAACAATTCTAAAGAGATGAAATCGCTAAACGCTTATTAGACTAATTTATACTAGTTTTAGTTAATTGCATGTGAAATACTAATTTAAATAACAGATATTAGCATACCCAAAGAGCATTGAAATGACCACAATTTTTTAATTGCACAGCTTCACATTTTCCCATAGTGTTCTTAACCAGGGATAGTAACATTTTCTGCATTCCCCCCAGCCCTGCAAATAATGTCTGGAAATTTGTGGGGCCATTTTTGCTTGGCACACAGACTTGAGGTAGATACCACTGACATTTAGTAGTTGGGAGCCAAGGATGCTAAATGCTCTGCAGTGTGAATGACACTCCAGCACATCAAAGATTATCCTACCCAAAATACAGATAGCCCCACTTAGAGACAAGTGCATTATTAAAATGCTGATTTTTCAGGATTACTAGAATAATTATCCATTTTTGTAATAG
>TTN-205,,0,103,3368499,3368601,GTAAGTTTGGACATGGATGCACTATGGCTAAGAACTAATAAACCATAGTTTTGTTTTAAGAAGGTGGTTTTCCTGATACTAACATTTTTTTCTTGTTCTTCAG
>TTN-205,,0,113,3368602,3368714,GTAAGTTTTGTTTCATGGAGTTGCCACTTTCCCATTTTGAAATAAATGAAAATAATGTTTTGTCAGTTATTTTCATCAGAATTGAAAACATTTATTGGTTATGATCACTATAG
>TTN-205,,0,299,3368715,3369013,GTGAGTCATTAAAACTACACTTTCCAATGGAAAAAGGTTTTAGTAAAACATAAAAATAAAAAGTTTGGGAGAGAGTTAAAAGAAATGGGACATAGCTTCAGCAAGTTATCCTCAATCATATTTTATCTGCTGGCCATGTAAAAGAAATCACCTGATCTTGTTATTTATTAGCTAATGGAATACAAAGATAGATGTGGGAAAACCACAAATCATGTCAGAGGAGCATGCTCACATTTATATTTTCCATAGCAACCCTTCCCACACAAATTTTTGATTACTGTTCTCTTCTGAAATATTAG
>TTN-205,,0,128,3369014,3369141,GTAAGTTTCCTTTGGCATCTAAAGTTTGCCTTTTTACCATGTACTTTGGTATATAATTACTACAGCTTTTAAAATTGCATTTTTATGTCATACTGGGAAATTTACTTCAAATGTTATTTTTTTATCAG
>TTN-205,,0,96,3369142,3369237,GTAAGTAGTTCCTTAAGAAGAAGGTGGAGTAGAACAAGCTATTGTACATTTTAAAACCATCAGGGAGTTTGATTTGTCTATCTTCATTCATTCTAG
>TTN-205,,0,99,3369238,3369336,GTACTTAACGTTATTGGAATAAAATTATGGATATTTTCTCTATATGGGACTATTTTTTAATCTTTCATGGGCTAATGCATGACTGTTCTCTTTCAACAG
>TTN-205,,0,86,3369337,3369422,GTAAGGAATGTTGCACTGATTTTCACAGGATTTTCCCAAGTGATACTATCTTATTACATTGATTTTTGGCTTTGTTTTGTTTTCAG
>TTN-205,,0,1307,3369423,3370729,GTAAAAGAGAAGGTTTCATTGTGTTTATAGAGTAATGTTTTGCTTCTAGTTATATTATTTACTGAGCTTTATGGCTTCAAACTCCCAACAGTCTCAAAATCTATAGCTAAAGAGTAATAAGAAAAGTAAATCAAAAAACTATTAGCAACATTAAAGATATCATATTTCCTATAATTTCAATGTAATTTGTGGCTGTAAGTATATTAATCATGCATGGTTTCTTGTACTGAAAAACTTGGATCTACAGGGGCTTAATAATAACCTAGAAGTAGTTTAGACATATTATATCTCTCCAGTAGAACACATTGGAAGTCGGGTTTTTAAAACTTACTAGCGTAGTAGTTAAAGAGAATTCAATGTTCTTCTAAAAGATTAGACAATTCCTGAGAATAAATGCCTTAGTCTTCCTCTATATTCAAAAAGTCCCCATACTGGAAGGATAGAGAGGCCCAAAACCAGAAACAGCCTCCAAAGAATAGAAAACCAACCAGAGGGAATCTCCCAGAAATCAATACGAAACACTAAAATTGCACACACAGTAATGCACACTGACATCCCATCTAAGAAAGCAAAGGCTTTGAGGAAGACCCATTCCTCAAGAGACAGAAGAACTTATTCCTTCACCATCACCCCCTGAAAAAAAAAAATACATCCTATATCACTGCTGCAGCTCATCTATGAACGTCCAATATACCACAGGCTGTGCCAGAGGCACCAGAACAGAGCTGAGCTTCCACTCCTTCTGGTTGCAATAACAGTCAACAAGTATGGATTGGGTCTAGTTTTACCACTGAAAGCTTAACTCTTAGTTTGGTCCTTCAGGAAAGAAAACTTCAGCAGCATTACATACATCCTCTTTCCACCATATTTTGAACCCACATGTGAGGCAACATGACTCAAAGTATGTTCATAGACATATCCACTATCTGTTAATAAAAGAAAAAACACTTTGCTCTCAGCTGGTCATTCAAAGCAAAGCTTCACAGACTTACTTTCCTAGTTCAGTAGAATTAGAAGCATCCCCAGTTACAAAGGTAAACAATCTAAAATGTTAAATTAAAAAAGCATACGTGCCCTTGATTTATTTTTCACTGATAATCTTGATGAAAAGTTTGCTAAGAAAAATTCTGTCTACATGAATGTCTATAATTTTGGCAACTGACAAGTTTTAGGAATGATTTTAAATAAGGATGTAAGGTTATGCCAAACAGAAGGCTATTTTTTACATAATTAAGTTGAAGTGAAATATTATTTCTTACATGAATATTTATCTCATGCTAATCATTTTCACTTGCCTCTGGCTAAAG
>TTN-205,,0,118,3370730,3370847,GTGCGGAATCTGAATATAATAATAATTTTAATGCATTTTACAGTGTGCCTTTATCCCATAAGTTGAAAAAAACATCCTTATGACTTTGTTACTGTTTTTCTTTCTCTTCTCTTTGCAG
>TTN-205,,0,88,3370848,3370935,GTAAGTGACTTGCTTTCTTACATCAAAAAGGCATCCAGTGTCTGTTTAAGAATTGCCTTCTCAATATTCTCTGTTGATTCCTTTCCAG
>TTN-205,,0,402,3370936,3371337,GTAAACTCTTCTGAATATTTTCTTATACACATTAAAAGTACATGACTCTGGTTTGATGCCATTTTAATATAACCTTGGAATTTGATAATTAAACTCAAAACCACACACGATAAGCTGTTATTTTGTTATTGTAGTGTTTAGCCCCACACACATAAGGCTCCTTAGTACATAGCGTTTGATACACAGATACTCTTTTAATTGAGATCCACTATCAGGTACAATACATCTACATATTTTTATTTTAAAAAAAGCTTTCTCCTTTTCTCTGTCTTCCCATGTTTTGAGTCTATATATTTATTTCTTCTTACAGTCATCCCTCCCAAAATAAGTTGAATTTTTAAATGAGTGAAAACCAACATAAGTATATTCTCTTCAATAAATTTCTGTTTTTCTAATTTCTAG
>TTN-205,,0,1285,3371338,3372622,GTAAGTATGCTTCCGTTTCTGGGGACTAATTTCTAAAGCACAAAGTCACTAAATGGATAATTCTGCCTTAAATTTCTTATATTTTTCTATGCCAAATTATTTTATTTATTAAAATAAAAAAGGTTCATGTTCACATAGACTATCGGAAGTATATATTTATGTGTGTATACATACATGCACAGATATATACATACACACATACATAAAATCATACAGTTTGTAAACTCTTGGATTAAACCAAATATTTTATGAGGAATCACAATAATAAAGACCTGGACTATAAACTCCTATGTCTTCTGATACTTTAAATAAATTTCTATCTCATTAGATACTGGGGAAATCATCTCTCCCACTAAACAGTCAGACCTTCCAGTAGGAATTCAACAAAAAACAGAATGTTGTTAGCTTTTCTATAATATTATTGAACAAAGATTTAGGATTCTCAGGCATAGTCTGTGAGGTCAAATAAGAGAGAAAAATTCTTCTAAAAGATCTGTGAGCAGATTCGTTCAAAAATTAAAAAATACTGTGGCCATAATAATTCATCCTATTTGCTACATATCTGATTAGATTCTCTATAGAAGAAAAATTCAATTATTTGTTAAAAAGAAAATTTTAAATACTCAAGTGCTATGTGGAGCATATATACCTATATAATGAGGTAGTTATTCATTCATTTGCAAACTAGTATTGAACATGTGCTTTGTGCAAGGATCTATATTAACCACTGGAGGGGGAAAAGTTAAGATTAAAAAGACAAGTACAGTAAAAGAATTTCTGTAATTGTAAAGCACTTTCAGAAAGGTAAAGGATTGTTATGGGATTATTGTAGACACTGATCCTGTCCCTAAAGGGCATTAAGATTAGTTTGTGTTCAAAGGTTTACTAGCTATTGATGGAATCCTTTTTAAATTTTCATATTGTGGCAAATTAAATTTAAATCATGTTTTCAGTAAAGGCTATTGTAGAATTTCTTCAAAGGGATCTCAAAAGTAAAGTAGTTTTTTACCAATCATGTATAAATAGAATGTAAATCTAACAAGATAGGAAGTAGTCTTTCTATTCCCAGTTAGTTGTTTGCTTTCTCTGTTTTTGCATTAATGCTAAAGGAAAATAGACCATTTCCTTTATTTCTCTTCTCTAGAAGGCAACTGTATTTCCTTTTAGCATTTCTATTTTAATATTTTAATAGATTAAAATAATATATGATCATGTGTAGTAAAAGACTCCAGCACTTCATCAGCTTCAAAATCTGATGAAGCTTTTTTTTTTCTTTTGTTATTAG
>TTN-205,,0,131,3372623,3372753,GTACTAGTACTTACTCAGTTTATGTATTCCTCTTTTGATCTTATTATGAAATTGATTAATTTACTGAAGATATTTCAATTACTTTTGACAAATATGAGCTAAATCCTGTTAAATTGTATGTGGTATTACAG
>TTN-205,,0,87,3372754,3372840,GTAGGAAAATAACCATTCTCCTCTTTTTTCCACTGAATCACTATAAGGAGTATTTATACTACAACTGACTGTCTCCTTTTCTAATAG
>TTN-205,,0,94,3372841,3372934,GTAAAAAAATAATAATTAAAATAATTCAGAATATGGTTGACTTCAATATTGCTATGATTTCATTCAATGTATGACTACTATTTTCTTTGTACAG
>TTN-205,,0,93,3372935,3373027,GTAAGAAAGACTTTGAAAGTTGCTACAGAATAAAAACAAATTATTTTTAAGCATTTAAGGAACGTTGCTTATATTGTGATTTACATCCAACAG
>TTN-205,,0,93,3373028,3373120,GTAAGCTTTAAAATCTAAATTTAAAATATCTTCTCAAAATTGAAGTATATTATTATAAACAACGCTTAATACTTCCTTTAATTATTTTTACAG
>TTN-205,,0,1003,3373121,3374123,GTAAGTACCAATGTACTGACAAAGAATGTCCTCCTTACAGCTGCCTTCCTAGGTGTTCAATAATAGTTCACAATTAAAAGAGCTATATCTGTACCTTAGGAAGCTACTATGGCTTGAATGTAGACATGGGCACATTACTTAATTACTCATTCCTTCAATTTCCACAGAATTTTCACATTCCCTTACCTGTTACCTTTTCCCTGTTCAAAGGAGATGATGTCTGTAATTTCCTCGCTGTAATTTTCCTCGCAGTCTGTTTTATTTATCAGAGGCTAAAGCAATTTCTCTGCATGCTCCTCAAAAGGGACAGAAAGTAACCAGTCATTTTCTTAGCAACTGCTGAGACCCATTTATCTTCACAATCAAGTTTTTATTTCTCTATATGAGAAAAGATATATCCATTTTAATGAAGTATATATATATATATATATATATATATATATGGTAATAATTCTTCCTCTGATAATTACCATCACTACTGTTGTGTATTTGTTTATTCTCTCATCTAAGTGTGAAGAAACTGTAGTCACTACCCTCTTTGAATATTTCTGTCCTAAATTTGTGCAAAATGGAAAATTGCTTTCCTTTTATTAACAGTTATATTTCTTAAAAGGGGAATTCACCTTCTTGTGTATCCCTTCATAATTCTGTGTAAATATTAAAGAGAGTATCCCATGATACTCTCCTACTACAATCTCCTCTCTTCCCTTTTGTCAGGATATGAGAATATAATAATACACATCATTACATGCATAATGATGCCAAATAAAGTGAGGCAAGCACAGATACATAGCCACATGTAGATCCAATAAAAGATGCTGACCCCGTGTACCTGCTCCCCAAACTAGCGTAATAGTGTTAAAGACAGAACCATTCTTTATATTGGGCTGAGCTACAAAGTCTGCCTACAGTGGATCCAAACAACTTTATAGTAACTGTGAATTCTACTTTCTATCCCTCAATGCTTTTTGCTCCTAATGACAACTTTTTTTAAATAATCTAG
>TTN-205,,0,108,3374124,3374231,GTAAAGACTGCATGGTTTGGTTAAAATTACTTGTTTTTCTGTTCATAAATAACATTTGGCTTTAAAATCATCTGAGTGATAAAGGGTTCCTTCTTTAAACCATTTTAG
>TTN-205,,0,83,3374232,3374314,GTAAGTAGGAGAACATTTTCACATACAAAGCCATTTTTACTTTTTTTTTAAATTTCTTATAATCAATATGATCTTTTTCACAG
>TTN-205,,0,93,3374315,3374407,GTAAGCCTGGAAACCATTCCTTTTTTTTAAATCTTATTTTCCAAAAGTGCCTTGGAAAAGTCAAGAATACTAACGTATACTGGCTCTTTGCAG
>TTN-205,,0,447,3374408,3374854,GTAGGAAAACTTGGCACTAAGGAAATGCACTATGAATAAACTAAAAAATGTCATAGTTATTCTCAATCCCATTAACTTCTGTCTATACTTTTTGGATTAAGAAATCAGGAAAATAGCATAATTTTAACTCACATTCCAAACATCTGTTAATGTCAGAAATCGAATCAAAAGTTAAGTCATGTTATTACTAATCTTTTGGTTATAAACCCTGGAATGTGGAATAAATAAATCAAGGTTTAATCATTTGACAATAATTTTAAAGCATAACTCCTGCCAAGTTATTCCATTCAGTGTTGCCTGTAATATCTGATCCCTAAAACCTAAACCAGCAACAATTTTCCCAGAGTAAACAGTTAAATAGGCTGCTGGTGATGCTTTAGGAAGCCATTAAAGCAAGAAGCTACAAAGAACTATTCTAATTATAAAATGTCTATGATTTCTCCCCAG
>TTN-205,,0,88,3374855,3374942,GTAATTATCAATCCTTCCTTATGCCATCAGTATTTATGTTTCAGATTGAAGGGGAAAAATCACATTTGTAATTTTCAATTGCTTCCAG
>TTN-205,,0,1728,3374943,3376670,GTAAATACTTTCAATTTGTCTGTGCAACTTTTTAAACCAACATTCTTATTATATTTACACAAAGCTATGCTGTATGCTGTGTAACAAACATTTTGGAAAATAAGAAAAATCACCCATAATCATGTTGAACATTATTAGAATTTTTAAAAATTTCCTCCTTACTTTTTTATTCTATGTGTATTCTGTATGGTGGGTGTAAGTTTACAAATTATATAATTGAGAAAACAGATGCTAACAAGAAGACATGCATCCATGTTTCCAGTGAACCTAAAGAGTGCATGTACACAATTCTCAAATTGCTAGAAGGCCATGAATATGTATTCTGAATCATGGCCCAGAATAAATATGGCTTTTTTATAGAACTTGCCCCCATAGTGTCTATTATGTTGTTATATAGTTTTCATAGAAGCAACTTTCCTTAAACTGTACATGAATGTTTAACAATCTGCAACTTTCCTTAAACTGTACATGAATGTTTAACAATTTGCCAGTGCTGACCATTTCACATCATGAGACTCTACCCCTATCGCTAAATTATCATAATAATGCAAAAACCTGTTTGAAGGGTTTCAGTATTCTAATTGAAGAGAAGCATCATAGTTGGTTATCAATATTGCATTTCTAGTCACTGAATATAGAGTTGAACTCTATGAGGCTTTTTCATGGCTCTCACTGGAGGCTTTAGTCCAGTGATTTGCTCAGAACACGAAGCCTTTCCACTCAGGGCTCTTTCTAAGCATGTCTCTAGGCACAACAATACTCCAGCCACAGTTTTTATGTGAAAATTGCCAGTTCTATGTTGAATATAATTAATATAAGAATGGCATAAGGAAAAATATTTCATTAAGCAGTAGCCCCACAAACTTTCAGGTTAGTTTCAAGCACCTAAAGCTCTTTTGCCTAATGGTTATTACTTTAATTTGAGAACTGGTACATTTCCACGTTAATTATTTGCAACCTCCTCAAAGTCATTCTGAAATTTGGGGCCTCCTATGCTGCTTGTTGATCCACTGGTCATCCAGAAATAAACCATCTCTCTCTCCGTTTCCCCTGCAGAGGAAACTGGACATAGAAACTGACTATGCCACTCTTACCCATCTCTTGTATCCCTCTGCATGCTTGCCTCCCAGCTCCCTCCTGTCCAACTCACAAATTGCTTTTAAAAAGCATTTTTATTTTCCCTTCAGCCTCTACTAAAACCATGGTAACCAATAACTGTTGCAAACCTACTTCATTAACAAATATGGGGCTTGATGCTATGGCTCACACCTGTAATCCCCTGACTTTGGGAGGCCAAGGCAGGTGGATCACTTGAGGTCAGGAGTTCGAGACCAGCCTGACCAACATGGTGAAACCCTGTCTCTACTAAAAATGCAAAAATTAGCCTGGTATGGTGGCACATGCCTGTAGTCCCAGCTACTTGGGAGGCTGAGGCAGGAGAATTGCTTGAACCTGGGAAGCGGAGGTTGCAGTGAGCTGAGATTGTGCCACTGAACTCCAGCCTGGGTGACAGAGCGAGACTCCCATCTCAAAAAAAAAAAAAAAAAAAAAAAGTGGTTGACTGTTTTTGTATTGACTAGATAGCAGAAGGAAAAACTAACTCAATTAGTAGACACAAAACCTTACTTTCTTCAAAACAACATTTTTGTCTCCTTTTAAAAAAACAAGTGTTGAGCATTATCTTTCATTGAAGGCAAACAGCTTGAATTATTTTCTTCTTATTTCCAG
>TTN-205,,0,860,3376671,3377530,GTAAGTAAAAAAAAAAAAATGTATACTTAATCACTTCTTTACTCATTTAGTACAAGACTATGGTGAAAAAATATGTGTATAAATGCCGTACATTTCATTCACTTGACAAGCAGTTATCACACAACTACTCAGTATCTGATTTGGTAGTATTTGGACAGTGATTGTGAAAGAGATTTTACAAATATGTATAATTCATTGAATTTCTTTTTGTTTTTTTTTTTCTTTTTGGTTTTGTTTTGACACATAGTCTTACTGTTACCGAGGCTGGAGTATAGTGTCATGATCTTGGCTCACTGCAACCTCCACCTCTGAGGTTCAAGTGATTCTTGTGTCTCAGTCTCCCGAGTAGCTGGGATTACAGACATGCACCACCATGCCCAGCTAATTTTTCTATTTCTAGTAGAGGCAGGGTTTTGCCATGTTGGCCAGGCTGGTCTCAAACTCCTGGCCTCAAGTGATCCACCTGCCTCGGCCTCCGAAAGTGCTGGCATTACCACTCCTAGTTCATTTATCAAATTTCTTCCATCTATACCTCACAGATTTTTTTTTAATTTCCCACTTAATGGCATTAATAGAAACTGAATTATTTTCCTACTTCTAAAACTACCAATTCTGAAGACCTTTCCTAAATTATTTTGCCTCAACAAACCTCTATTTCCTCATCTGTCAAGTGAAGAAATTCAATTGTATTGGGTCCTTTTTAACTCTAATAGTTTTATGATGAGATCTCTTTTGCTATTTATGGGAGCAGAGAGTTTAATGTTTAAATGCAATCTTCAGAAAAGGAATATTCACTACATCCTACTACATTCTTAATGTGACATTTTTTTCTACCACAATTCCTATACTTATATTCGCAG
>TTN-205,,0,101,3377531,3377631,GTATGTGTCTACTACAATTTATACTTCTGAAACTTGCACATTTGTAGATTTGTAATAAGACATCAATAAAAATGACTTGCCTTTATAATTACAAATTTTAG
>TTN-205,,0,93,3377632,3377724,GTAAGTCTTATTTAGTGGAAAGAATAGATCTTCTGTTCTTTCAAAAGCAGAAATGGCAATAACATTTTGTGCCATGATTTTTTTTTTCTGCAG
>TTN-205,,0,92,3377725,3377816,GTATGCATTATGTTTCTTTTTAGTGATTCAATGCTTGATAAAACTAATATAAAGAAATAAATTTCTAACGCATTTTCCAACATTTGTTACAG
>TTN-205,,0,89,3377817,3377905,GTATAGTATTAATGGATTTATTCAGTTTTCATGTTATCTAACTTTGTTTTCAGCTATATGCTAATTCGTTTTTTACTTTTATTTTTTAG
>TTN-205,,0,114,3377906,3378019,GTGAGTAAAATGCTCTCACTTGTGTTTGCAAGGAAAATAGATGTCTGATTGTATGTGTTTAATTGTAATCTGCATTATGGATCAAATCTGAGTGTTCTGTTCTCTTTATTCTAG
>TTN-205,,0,101,3378020,3378120,GTAAGAATTTTACTACTTAGGCCATTAAAAATAAATTTTGATAATTTTGAGCTCTTATATGGATAAAATTACTTATCAAACTGTTATTTAACACTTTTTAG
>TTN-205,,0,85,3378121,3378205,GTAAGTTGCTTTCTCTGAATACAAAACTATTGTTTGACTGTCTTTAAGAATATTACTTTTTCATCATAACTTCTTCTTTGAAAAG
>TTN-205,,0,94,3378206,3378299,GTAATTTTTGGACTAGCAGTATTACCTTATTTCTTTTTAAAATTATTCATATAGGTGAAAATCAAAATCTAATTTTTTCATGTTTACTTTTCAG
>TTN-205,,0,318,3378300,3378617,GTAGGATGTCCTTGTTTTTTCTGATATTACAGCAACTCTTAATCTCAAGCACAGAAGTATTCGATAAATAAGTTAATGTAACATCTAAATCTGTAACATCCAAACTGTATTTAGCAAATATTTTTCCAAATAGACCTTTTACCAAAATACCTAAAAGGTACAAACAATAGTAGATTCTCATTTTTATGAAGGAAAATAAAGAGGACACTAATTGAAAAATTGGATGACCTATATTTGATTAACTGAGAATAGGCTATATAAAATTACACATTGAAGTATCACTAGTAGTAGTTAACTATATGTATATTTTACTTTCAG
>TTN-205,,0,98,3378618,3378715,GTAAGTCCTTCCCTTAGCATGTGATTCATTCACACTTAATTTCTTATGATTTCCCCACATTCTGAAAAATCAATTAATGACCTTAATGTCATTTGCAG
>TTN-205,,0,98,3378716,3378813,GTGGGTTACTAAAATGCTTCTCCCTCCCACTTCAAAAATGAATTTGTTAATAGGGATGCTGAGGAGACATGTATATCTGATTTTATGATTCTTTACAG
>TTN-205,,0,310,3378814,3379123,GTAAGTATTATGCTTTCTTCCTCCTTTTAACCCCAGTCTCCTATTTTAGCAAGGTCAAGATACTAATACCATTTTAATCCACTTCTGAAAGAGATTTCATTTGTAGAGACCGAAATAGTGTAATAAATATCTATCTCACTCATGAAACACTTTTTTGATCTGTCTCATCTTATATGTTTTGCTTTTAATGTACTGAACTACAGGTTCTATGTACATTGGAGCAAATCCATACTAAAACTCTTATGTACATTAACAAAGGGGATTTGATTAGGTTACCTAGGTAATCTTCTAAATTATGTTTTTCTTCTAG
>TTN-205,,0,1157,3379124,3380280,GTAAGTAGTCTTTGCTTCATTTATGTCATGTGGTAAGTTTATTAGAATTTCTTCTTTTATATGTAGACATTTCTCCCTGAGGAATCTAGCTCTAGAAATTCTTGAAAAACAGTAGAGAACAGTGGCTTTCAAACACATGAGTGGGCCAAAAACACACAGTAAATAAACTTATACAAACACATATATAACTAAAAAACATTTCCTGAAACAATACCCATTTATTATCATGTGCATTCTTATGTTTTCTACCCTATTCTGTGTTTTTAAAAATATTGGCTGTACAACAAACATATGAAGAAAAGCTCATCACCACTGGTCACTAGAGAAATGCAAATCAAAACCACAATGAGATACCATCTCACACCAGTTAGAATGGTGATCACTAAAAAGTCAGGAAACAACAGGTGCTAGAGAGGATGTGGAGAAATAGGAAAGCTTTTACACTGTTGGTGGGAGTGTAAATTAGTTCAACCATTATGGAAGACAGTGTGGCGATTCCTCAAGGATCTAGAACCAGAAATACCATTTGACCCAGCAATCTCATTACTGGGTATATACCCAAAGGATTATAAATCATTCTACTATAAAGACACATGCACATGTATGTTTATTGTGGCACTGTTCACAATAGCAAAGACTTGGAACCAACCCAAATGCCCATCAATGACAGACTGGATAAAGAAAATGTGGCACCACATTTACACCACAGGATACTACGCAGCCATAAAAAAGGATGAGTTCATGTCCTTTGCAGGGACATGGATGAAGCTGGAAACCATCATTCTCAGCAAACACAAGAACAGAAAACCAAACACCACATGTTCTCACTCATAAGTGGGAGCTGAACAATGAAAACACATGGACACAGGGAGGGGAGCATCACACACTGGGGCCTGTCAGGGGTTGGGAGGCTAGGGGAAGGATAGCATTAGGAGAATACCTAATGTAGACGATGTGTTGATGGGTGCAGCAAATCACCATGGCACATGTATACCTATGTAACAAGCCTGCACATTCTGCATATGTATCCCAGAACTTAAAGTATATATTAAAAAAAATTGGTGGTAATACAAGCATTAATTTGCACCAGTATAGCTCTCCACCAGAAGAAACTTATCCACCTTCCCAAAATTAATATCTTTTCATTTTACTTTCAG
>TTN-205,,0,103,3380281,3380383,GTAAGTTAAGTATTAGACAAATGGCCATCTAAATATGAAGCTCAGAAATATTTTTACGTATCAAATCCTTGTTCTTACATTTCTTTCCTCTTGGTTCATGTAG
>TTN-205,,0,90,3380384,3380473,GTATGTTTTTGTGAAGGAGAAAAAAAGTTGTTTTCTTTCTAGTTTGTTACTTAATGTAGAAACTGACATCTTCCTTGTCTTCATCTCCAG
>TTN-205,,0,369,3380474,3380842,GTAAGTTTTGGGGTTTTTTTATTGTTGTTGTTGTTTTAGTATTATGGAGGCACATTTAAATCTCGGAGTCTAAGATTTGGACTCCAAGACACAGAGAGTAGTAGAGATCTGAAGATTACAACTCCCATTTAAGAATATGTTCTATCTCTTACAATGAAGATGACATATTAAAAAAAGAAAAGGACATATAATTTCCTTTAAAGCATACAGCAAGGACTCAAAAGTGCATACTAGTTGGACGGTTATTAAAATGGGATAATTGTCTTCCTGTTGAGCTTGTTACTTAGCAGCAGGGATGATAATGTGAAATATGGAAGTTTAAACTTCTGCTGGTAAGATAAATGGTGAGTGTACCTCTTTTTGTTTTAG
>TTN-205,,0,379,3380843,3381221,GTAAGATTCTGCTGAGTATTATAGGCAAAGATGTAACAGCATTCATGATGGTCATTTTTCCTAATAAAAAACTAAATATACACCTAAGGAAAAAAGGAAAATTAAAATGATGTTTTGTATATAGACACAAACATTATGATTATGGAGAATCATAATAACATGCTAAATTAAAAAGCAAGATACACAACTGTGGCAACTATATAATTTCAATAGTTATTCAATAGTGCAGTTATTATTTGTCTATTAAAAATAAACAAAATGAAATAACACTAAAATTCCATTCTTGAAAGAAGCAGCATATGAATTTCCCACTATTATTAATAAGGATTACATAATATAGCTTTGCATACATTAAGTCCTTTATCTTATTTCTTTCCAG
>TTN-205,,0,347,3381222,3381568,GTAACTAATAAACTTCATTGGAATCCCATATTTTACTTTGGATAATGGGATGTAAATAGGATTTACAGAATAATGTGGGAGAAGACATTCATATTCTAATGTGTATTTCCTATGCACAGAATTATTCTTATGACAGAACCACGTTTTAGAGTTAAAAAGAGCTTTAGAAATCACATATTTCAATTACCTAATTTTACAAGTGAAGAAACTAAGATTCTAAAAAATTAACTAACCTCCTAGGTCATATAGGAAATTGACAATAGAAAGACTGCAGCCCAGGTCTCCAGACCTCTACTCTATACTCATTCCCCATTCCACATATTCACTCTTCTTCCTTATTCCTTCAG
>TTN-205,,0,87,3381569,3381655,GTAGGAACATTTCCCGGTGGTTTTTCATTTTATTTTTTAAAATTATCTTTTAGCCTGGGAAATTAACTTTTCAATCAATTTCTGCAG
>TTN-205,,0,101,3381656,3381756,GTAAGTGTTCATGAACGAGTTCCATATCCTGTGTTAAAAGCAGCATTAAACACCCAGGAAGGAAGTTTTCATGAAAATTTCCTATCATTATTTATTCTCAG
>TTN-205,,0,889,3381757,3382645,GTAAGTATTACCAGGGGGAGTACATAAGGCTTTTCCTATTAATCATATTCTAAGAGGGAGACTAGAACTCCCTTAGGTAGATTAATTTATTAACAAGGTGTAGAGCTGGTAACTCCAAGAGTACTTTTTAGGAGAGCTGGGTGGGTACTTTACGGTATTGTGGAACAGGCAAATCAAATGCACATGATTTGTGGTTTTGAAAAGCTTTTCATATATATAAGAATTTCCTGTCTTCAAAAGACATGAAATGAGAGAATTTTATTGGAATGTAAGAATTTTATTTTAGGAATAAAGAGGCCTTTTAACTAAGTAGTGAGCTATTTACTATTCTTAGGGTTTCTGTTTTCCAATCCACCATCTCCCTAAGTATGTGACTGGTGGGCTCTCCATCTTAATTTCCCTTCTTCTTATTTCTTCTATTTGCTTATCCTCCATGATAATTTCCCCTTTATTTGAATTACTTGATATTATATGTCACCCTCCAGGTACTTTTCTTCCTACTATGAAATAATAAAGAGAGCTAGAATATGTGGCAGAATACCTTCATGGAATATAGAAAGGAAAAAACAAGAATGAAAGGGAGCCAAAAATCAATCGTCTACTTTCCTTTTAATATATGTAGCATTTCAGAGTACATAAGGCTCATGAAAGAGGAGGTACAGATCCTCCGGGGGGAAAACCTGGTTAAGCCTAAAGCATAGTGGAAAATGGAAAGATCAACAATTAGTACAGAACAGAAAAATGATTTTGAGGATTGTATTAAGGAAGTTTTAAAGAACAAGAAATCAGCTCTAGAAAATAAATGTATTTTAGGAGTGACAAGGCCAGTCCCTGGAAATACATTTGACTATTAAATTTTTATTTAACTTCTTCACCCAAAATTAAACAG
>TTN-205,,0,92,3382646,3382737,GTAAGTCTATTTCAAAAAAGAATCATATATATTTTAAAATAGCTTATGTATTTTTTACACATTCATTTCTTATTTACCTACTATTTATCCAG
>TTN-205,,0,90,3382738,3382827,GTAAGCAAATGAACCATCATCCCATCATTTTGAGTTATATCCTTCCTTTGTTATATGGGGCTTACACTTATCATTTCTCCTTTGCTTTAG
>TTN-205,,0,167,3382828,3382994,GTAAGGCTCTATGCACACATCTTCATTTTTCCTTTATTGTCATCGAAAGTGCACTCTTGTGTCCCACTCACTAGCTTATCTAAAAATCCGTTAAAAGCTAGAACTATTTGAAAAAGTTAATCGCCTGGCCTTAAAAATAACAGTAATTTATCTCTGCTATTTTACAG
>TTN-205,,0,90,3382995,3383084,GTAAGTGTCTTAAATTCAGAAGACGTAAAGCAAAACACGGTTTTGAGGAGGCTTCTTATTATAAATCTTGCATTATCTACTTTTTTCTAG
>TTN-205,,0,425,3383085,3383509,GTATTTTGTTTGTTCTTATCCTACAGCTTTTACATCAAGATTCCTCACAAATATTTCCCTGAGAACAGTTGAACATGTGCTTATCGATAACATTATCTGCTTATACAGAAATGTGTTTTTATTTCAGTACATATGGTTAATGTTTAATTTTATTGAAAATATCCTAATGTAATAGTTAATAAAGTATTTCTTAATTATAATATCTATTTTTGTAAGTTAAAATTGTTCACCAAAAAAGACAACAACTATGCATATTCCAAGAGGAAAAAAAAAATGGCACTATGCTTGGGTAATAAAAGTATAGATACTAGCAAGAATGACTACTTGTTCAATATATATGGATATGTATAAATAATTTGGGCAACACATATATATTGTAAAATCAAGCTGCATTTATACTTGATACATCCCTGGGTCTTTTGTAG
>TTN-205,,0,89,3383510,3383598,GTAAGTCATTATATGAAGAAAAACCCAGGTGCATGTTTTACATGAAGAAAACTGGTATTTGTTTGACTGGTTTTGCTTTTATGTTTTAG
>TTN-205,,0,91,3383599,3383689,GTAGGTCCATTTTACTTTTTATGTACTTTTTTTTTTAAAGCAAATTAAGCCTCCTTCCTTTTCTGATTAAAATGTATTTTTTTCTTTGCAG
>TTN-205,,0,91,3383690,3383780,GTATGTAGAGCATGTGAGGGAATTGACATGGAAACATTTATAGCAGAGTTTAGGAAATCATGGATTTCTAATAAATTTGCTTCCTTTTCAG
>TTN-205,,0,112,3383781,3383892,GTTAGTATTTGTCTTTTTCAACACCGTTCATTCCAGAGTGCCAATATTTTATCTAAATTACCCAAAAGCCAAACTCTGAATATATACTTTTGTGTCTTTGTTTCTTTCTCAG
>TTN-205,,0,673,3383893,3384565,GTATGTTTTAAGAATAAGGAAATTCTACATATCCACGTTAATTTTGCTAGAATAGTGTGAGTCATTCTAATTAGTCGTTATTTCATCTTAAATGCTTTTGGGTTCACACCCTTCACACCCCAAACTATTCATACTATGGCACAAAATGGAATCTCTAGTGAAGAGTCTTTCATTGATTAAAAAAACAGAAATTTACGTAGCTAAAATTGGATAATATATGTTGAATTTAAGTATTATTGAATCTAACTGTATATATATGTAGGTATACATGTTTATATATATATATACACAGATTATATATATATAGTATGTGTGTATGACATATATCATATGTGTGTATGTGCGTGTGTACAGAAATTGTATATAAAGTTTTTTAAAAGATTGTTCATCTTGTTCCTCTTTTTTATCCCCATGGTGAATTTGGAGTAAATTTTATCATTTAATCTGGTCATTTTACCCTTAATTTGGATTTGAATGCTATAGCATGTAATGACATAGCTTGTGGGAGCCTTGGTTGGTTCAGAAGCAAAATGGGTTATGTAAAAAGGAAGACTAAAATCAACATAAAAATATGGCCTTCATTTAAAAGTTTTCTTTTGACAATACATGAAGAGTGCACATTTAAAAGTGCTGTAATAATTATTCACTTTCTTTTGATGCTTTGTTTTCTTAG
>TTN-205,,0,105,3384566,3384670,GTATGTCTAATTTTGTGTAGAAGCAAAATTTGAAATTATTTGCATTGATTTATGTTAATTTTCAGAAACACTTTTTCACTTTCACTTTCTATACTCATTTTTCAG
>TTN-205,,0,92,3384671,3384762,GTAAGTTGTCCAACTTTTCAAAGATCCAGGTTTTCTTTTACCATAAATGTGTTATTGTCTGTACTAATCTATAGGATTTCTCTCTTTTGTAG
>TTN-205,,0,108,3384763,3384870,GTACGTATTTGTCATGGGAAGGGCAGTTCTGATAACAAAAATGCAAATCTTACTTCTGCGAAGCAAAATATTATAAGTGCCGCTAATCTGCTTCTCTTATTACCACAG
>TTN-205,,0,1695,3384871,3386565,GTAAGCATGCTTAGCACTTTGAATCAAAATTGCTATTTAACTCAGTATTTCCGCATACCTTTTCCTGGTTCTAATCCTATAGAATAACTTTTACTCTGTGCCTTAATGGGGTTTTTGGAAGAAATTATGGACTAGCTGGGAGTCTGAGGAAAATTCCTTAAATACCTTTCCAGCCCTCTTGACTTGACTGTAAAGTGAGAGATTTAGACCTCAGGATATCTATGGGCCTTTCCAACTTCAACCTTTTATGATTGATTGTATGAGTTGGTGCTTTCATTCTGTTTTAAATTATCAGAGTCAATAATTAAACCATGGTTGAGTTCCTAGAGAATATTGCTCTTAAATAAGCCACAGACTAAACAGAGACTTCATTTTTTGGTTTTTTTTTTTTTGTTTGTTTGTTTGTTTGTTTGTTTTGAGACAGAGTCTCACTCTGTCGCCCAGGCTGTAGTGCAGTGGCACGGTCTTGGTTCACTGCAACTTCCGCCTCCTGGGCTCAAACGATTCTCGTGCCTCAGTCACCTGAGTAGCTGGGATTACAGGCATGCCCCACCACACCCAGCTAATTTTTTGTATTTTTAGTAGGGACGGAGTTTCACCATGTTGGCCAGGCAGGTCTCAACCTCCTGACCTCAGGTGATCCACCCACCTCGGCCTCCCAAAGTGTTGGGATTACAGGTGTGAGCCACCATGCCTGGTCTAAACACAGACTTTGATGATGATAGTATTAGCAGCAGCTAACATTTATTGAGGAATTTTCATGAATTCTTTCCCTTAGTTCTCACAGCCCTCATATTAGCCATCTTATAGAAGGGAAACTGAGGCTGAGAGTGCTTTTGTAACTTCCCCGTTAGGGATGGAGTGGGAATTCAGACAGACAGACTTCAGAGCCCTCTCTATCATGGTTAGTCCAAAATGCGTATTCTTCACCATTCTGGAAAATAAGTGGCACATTCAACTCAACAATGTTTTGAAAATTAAAACGTCATGAGAGTCAGGTATCCTGTGACACTTTACCTAAAAGATCTCCATTTGCTAAGAGAAAATTGAGCCACTGTAGTGTCTGGGCAAAAGTATCCACTTCCATCTTCATGCTGAGAATCTCAGGGCTGTTCATTATTTATGAATCAGGCTTTGTGGATACTGAATCAGTGTTTATGAGAGTATAAAGCAAGTCGAATTTAGTTATCTTTCTTGATAATTCCAAACAGCATGGCAGAAAATCTGTCCAGTAATTATGTAGCTCTGTGGGTAGAGAATTCAGACTTTAAGTGTCTGACATGAACCATCCACACTTGGATATCAGTGAACTGGGATGGGAAAAGAAAAAGAATAGGAGGTGCGTAGAAGAAAAGGAAAGAAAAGCTAAAGTGAAAGGAAATGTTTTAACAGCTTCTTCCATGATGTTCTCACTACCATATCCCATTTCTTCACTGGAATAAAGCAACTAATGGACTTTAAAACACATGTAAAAGGTGCTTAAGTCCCTGCACAACTCACAGTCTTTCTACCCCATCTGAGATAGAAGAGTGGCCTATAAATTTTTAATTTTTAAATAATAATTGCATAGAATTATAATGATGGTGTGTGTGTATAATTTAATAATGGCCAATGACCTTACTTTAAGGTTGGTGCAACTATTTTTTTTTCCATCCTTATAATATTTTAAATATTTCTCATCTGTTTTTCTTGCAG
>TTN-205,,0,112,3386566,3386677,GTAGGTGCTGAATACAGACCACTGTCATATTACATTTGCCTAAAGCTTAGTAATTTTGAACAAGTAGGCTTTAAAGAAGTACTAACATCGTGTTTTGTCCTTTCACTGATAG
>TTN-205,,0,236,3386678,3386913,GTGAGACATGATTTCATTAGAAAACTGAAACGTGAAAAATTTAAAAATAAACTACGCTAACCTGTGCATATGCTTTAATTTTCTTTTATATAACACCTGTCTCATTACCATCCTTTTCACAAGGTGAAAAATATAAAAAATAAAACCAATGTTCTTGGAAAGAATGCGAACATCAAAGGTATAATTTATCAGTAATGTGGATTCTTGTACCTTGTTTTCCCTTCCTTTCTAAATAG
>TTN-205,,0,106,3386914,3387019,GTAAGTGCTCATACCTGCAGCATCTTCACCTGTGTCTTCTATATTCACCTGTGTGACTAAATTGTACATGATTGTGTAATTATTTTATTGTGAATGGCCATTCCAG
>TTN-205,,0,105,3387020,3387124,GTATGTACCTACTGGTTTGATTATGTTTTTTAATAAGCATACTTCCAGGAAATCACTCTTTTTTGCTTTTAAAATTCACTGTATGTATCCATTTTATGTCTACAG
>TTN-205,,0,369,3387125,3387493,GTAAGTGATTATTATTCAAATACATTTAGTTTAGCAATTGAACATATTAGAAACAAATATATCAAGGAATGCTTTTCTTCTCTGCATCACCTTCTTACATATCTTCTTGTCACTAGAGAACTGGTCATGTAAAGCAAGAGGAATTATTTTAAGTCAGTCTAATAAACTAATTTGAAGTTCATTTTAAAGACTATGAAATGGAAAGTTGAAATTAATGACCAATATGAGTTTGGGAGATTGAATAAATTACTTATTATAAAAATTTTACTTATTTATTAAAATTATAGAATAATTGTATTGTTCTTCCATGGATGATTAAGACCTGGTTACAAATGTAATGATGCATTTACCTTCCTTATAATTTTTTAG
>TTN-205,,0,693,3387494,3388186,GTAAGCATTTACAACTTATTTCCAATGAGACTAAGAGCATTCACATTTTTAAAAAACACATTTGGCCCCTGGCCTGTAAAATGGTAACAGAAACAAATTACCCAAGGTTGCTAAGTGGATGAATTATGTCTTTCTACCTTTCAGATGAAAAGAAGAAAAAAATAATTGGCATCAATTATTTTTTCTATTATTTCACTCCATTCCCATATAAAGAGCATGCAGCAAGTGGGAATGAGTTTTTAGCTTTGTAATTTTCGCCACTTAACAGTACATAAAGAAAAGGTTCTCGAGAATAAGTGTCCATCTTTACTGAAGTTATTAAAATACAACATACATCCAACAACACAATCATCCCCTTGCTTGAATGCAGCTGATGGCCTCTTAAAAGAACTTGTGTGACTGTGCAGCAGTATTAGGAAGTACATGATCTGTAAATGTTTCACTTTCCTTTTTACAAAGAGCAATGCAAAATTAAAAACATGACAGGCATTACAAAGGGAATAATAATAGGCAAATATTTAACCCCATAGTCCAAATTCTCAATTATCAATCCTACTTTCAAAATAGGCTTTGGTAGCACAGTAGAAGTCACTACTCTTCCTGGCCTTGTGATATGGCACTACTGAAAAATATATATTTATGTATGTCTTTATTAAGCCAAACTAATACATAGTATTTCTCTTTCTTTTATAG
>TTN-205,,0,116,3388187,3388302,GTACTTTTAAAATAGCTTCTTAATGCTACAATTTATGAACTTGGATTAGAGACATGCCTAGTTGTATTTTAATGGACAAGGAAAAAGAAACTAACTCTAGAAACTTTTTCTTATAG
>TTN-205,,0,96,3388303,3388398,GTAAGTTTGCGTTTTTACTAAGCGGTACTATGTCAAAAGTTTAACCTTCCAAGCAAATGCATCTAATTGATTTGGGGTTTTGTTTTTGTTTTACAG
>TTN-205,,0,101,3388399,3388499,GTAAGAAAAATAAAAATCCTATTTCAAAGTCTCTATTATTAAATGTTTCCCCTGAATTTTATAAAATTGTATTCATACTTAATACCTTTGTTTATATTTAG
>TTN-205,,0,97,3388500,3388596,GTATGTATCACAATTTAAGGGCATATTTGTTTATTATTACTGATTCTAGTAGAACTCAGAGTGGTATATTTTAACCTTATTTTTGCATCCCTTCCAG
>TTN-205,,0,97,3388597,3388693,GTAGGAAATAGTCAACATTCTCCTTTTTAAAATTATCTCAATTTATGTGAAAATAAACTCTCAGATATTCATTCATATCTGTTTTGCCTACTGACAG
>TTN-205,,0,95,3388694,3388788,GTAAGCATGTCAAATGTTCTCACATTTATATAGCATTTTCCAGTGTGGGCAGAAAGAATGATCTTCATCATGGCTTGTCATTACACCTGTTTCAG
>TTN-205,,0,126,3388789,3388914,GTAAGTATTAACACTTTTAAATAATTTGACAGTTGAAATGTAATAGAATCAGGGGGAGAAGGGAGAAGGGCAGTCTTATCAATAGTAATTTTGTGCAATTCTCATCATCCTTATTTTCATAAACAG
>TTN-205,,0,881,3388915,3389795,GTGAGCTCCAAGAATCATACATAAATACAATGCTCCTCAAAACTATATGACAGATAATTTTCCAACACACAATCTCTAAGAATTTTTAGAATTTATGAATGGTCTAGAAAAGCACATGCTTATTTGCATGATCATAAATATAGCTTAAGTCAGAGAACATTTTAACTATTACATCTGTTAAGTTAGCAATTAGAATTGCTAAAAGTTGTACAGCATTTTCCAATTAATGAAAAAATATTCTATCAATATGAAAAGAATCTATTTTATAAATTTTCCTTAGAGAAAAATGCATTGTACTGTAATAACTGAAAAGAAAAATGGCAAAACTCCTTTTAAGAAGAGGTTTAGCAGGAACATACAGTTTCTAGTGGTTTCATAAGTTACTGACAAAGTAATTGTGACAAGAGCTTCAAAAATAAGTGGCAAATCCTTTTACAGAGTCTGAGCCCAAGAACTATAAAGGAATAGTCACTGGGACTGAATTGGGGAAGCTAAGGAAACCAATTCTTGTATTCATTAGAAATGTATTGGTGGCAAGTGATACTAACCCAGTGAAAGATAAGCAACTAAAGAAAAGTCCCTAAGAATGGGTACTTTAAGTAATGAGCTTAGCTAATAGAGAACACACAGTAAAGCTGGCCAAAGAAGTAGGGAAGAAATATCTACTTTCCTAAAGCAATTTAATTCTTAAGATAATAATATTAAATTATAATGTGGCACTCTGTGCTGTCCTATAATATCAGGAGCCCAGTTAATAAAGATTATCTTGGTGAGTGTGGACAAGAGCAATAATGCCTTTGTGAGTCTTGAAAACAAAAAATACAAATCTCAACATTTCCTTATTTGCCTAATATCTGCATCTCACTTTTTAAATTCCACAG
>TTN-205,,0,85,3389796,3389880,GTATTTATCACAGAAGCTTTTAGGTGAATTATTTTCTTCTCACACCTGTCCATGAATTAATTAAATTTTGTCATTAACTTTCCAG
>TTN-205,,0,171,3389881,3390051,GTAAGCATTTTACTTAAAATTGGCTATACAATGAGTAGATCCTCTAAAACAATATAGCTTGACCTATGATTGATCACCTCTCTAGAAAGGAACTATGTTGATTATATTTCCCCAAGAAAAAAAAAGCTATCAGGCAAATAGGAAATATGAATCTTTCATTCTGTTTTTCAG
>TTN-205,,0,119,3390052,3390170,GTATGTACCAAATAGCCAAAAAAAAAAAAAAAGTAAAGTAAAATGAAAACATTCAGAATTCGTAACAATTTACCATAAAAATAATGCTTAAGAATAAATGCCTGATTTCTTTCCCATAG
>TTN-205,,0,98,3390171,3390268,GTAAGGATGTGTGACAAAGATACAAGCAAGTTGATGTTCAGTCACCCAATTTTGATTTGAAGTAAAAATTAATTTCCTGTATTTCTTCTCTTTCATAG
>TTN-205,,0,679,3390269,3390947,GTAAGTCCACAGGCCCTTCCACCACTCTCCCCACCTCTGATTCTGAATGTTAACAAAAAAGAATTTGTTTTTAATATGCCCTAATGTAAATAAAAATAGGTCACAAAATTAACCCTGTGGTCTTTCTAAGGTTTCTAAACCTCCTTTTCTCAGGTTTCTAAACCTCCTTTTCTCAGAGGTTTTCAACACACTTAGGCTTGATTTTTTTTTTAATATCTTCACTCTTATGAAAGAGAAGAGGAGGGAGTTAGGAAGAAAGGAATGGAAGGAAGAAAAGAGAGAAGGGAAGGAGGAAGAGAGGAAAGGAAGGAGGACTGGCAATGTTATAGTGAGAAAAAAATACAGAGTGCATGCTTAATAAATGTAGAATTGAAGAAAATGAGGAACAGCAAGGAAAGTACAAAATTAAACCTCAGCATCATGCAATATACCCATGTAACAAACTGCACATGTACCCCTGAAGCTAAAAGTCAAAAATTTTTAATAAAAATAATTAAATAATTAAATGATTTAAATTAAAATTTACAAATAGTACAAAAGTGAAACTATTGGAAAAATAGTCATGTGCCTTATGTACCTTTTAAAATACCAACCAAAACCTAAGGAAAACACAAATATATGAGTCATTGTTTTAACGTATTCATATTGCCATATCGTGTTAACCTCTGTCTTGCTGCAG
>TTN-205,,0,911,3390948,3391858,GTAAGGACATTTTGTATCAGTCAAATTGATTGAGTTACAATTTATATGTGGGAAAATTCACCTTTTTGAAATATATAGTTCTATGACTTTTGAAAAATGTACTGTTTTGTAATCACCACCACAATCAAAATGTGGAATATTTTTATTACCCCGTAAAGTTCCCTTGTGTCCGTTTGTAATCAGTCCCTTCCCCACCCCAGCTGCTAGCGATTTCTGGCAAATAATTTTTAATATTCTTCTCTGGAGTCAATTTCCACTTCTTTAAGATGAGATTCATAATATATGCTTTCTATCACACTTAAAATTTTAAAACAAGTTAATATTTCTGGAAGCACTTTAAAAACTGCTGATAAATGTAAGATAATAATAGTGATTACAAATGAAGCACATTTAAGAGAAAGGAAAGTGAAAAAATGTTAAGTATTTTTAGCTGATAAAATGAATAAAATTTTCTTTTTTCTTTCTTTTGTTTTTTTGTGTTTTTTTGAGACAGAGTCTCACTCTGTCACCCAGGCTGGAGTGCAGTGGCATGATCTTGGCTCACTGCAACCTCTGTCTCCCAGGTTCAAGCAATTCTTCTGCCTCAGCCTCCTGAGTAGCTGGGATTACAGGTGCCTGCCACCACGCATGGCTAATTTTTATGTTTTTAGTAGAGACGCGGTTTCACCATGTTGGCCAGGCTGGTCTTGAACTAACTCCTGACCTCAAGTATCTGCCCACCTTGGCCTCCCAACTTGCTGTGATTACAGGCATGAGCCACCACACCCAGCCATGAATAAAATTTTCACAAGACAAAAAAACAGGCTAATGTTAACAGTCCGTTTCAACAACTCATTGAATTTGTTAGGTGGCACAGCTAATTTTCAACTTTGCAGCAACTTTAACCAGTATATTCTTATTCTTATTCTCAG
>TTN-205,,0,101,3391859,3391959,GTGAGACATATGATCATTTGCTTTCTGCAATAATTGCCATAGACTTATTTCTTAGTCCCCCTACCCCAAATGCTAAATTGAAACCCTACCTTTTTTTCCAG
>TTN-205,,0,130,3391960,3392089,GTAAGTGCCCTTTCAACCACAAAATTATAAACATTATTTCAGCACTTTTCTGTTTTTAAATGAAAGTCATTGGCTTATAATACTTGGGACTGTATTCTAATACATGTGTGCTTTCCACTTATATTTACAG
>TTN-205,,0,106,3392090,3392195,GTAAGGAATTCAGAAGAAGGGGTTAAATTAAAGAAGCAAGCCATGTTTGGTCCTTTTATTTCACCAGTAAAGCTGACTCCCTTTTCATTATTTTAAAATATTTCAG
>TTN-205,,0,622,3392196,3392817,GTAAGTAGCCTTTGGTTCTCTACTTATGATTTACAAACTAAACAAGTTAAGGCTAATTCCCCCTCTATACTAAGTAGAACCCTGGAAAGCTTTATTGGAGAGCAAGTGTTAAGAAAGAAAAGCAAGTACACACACAGGAAATATGACAAGTTCTACAGGAAACCATTCCAAGCACACAACCTCAGCAGATGTTAGATGGAGTGAACTGAGCACTTTCCTTGAGTAATTCCCTCTAATGCAATGGTTTCTTTTTAAAAATATTTCCCAACAAGATTTGAAAGGTCAACAATTGTATGCCACTTCAATGAACCTAAGTAAGGGCAAGAATACTACAGAATTATAGAGAGAATTTACAGTCCCTTAAAAGCCTATACATTATTAATCCCCTTCCAATCATAAAGAGAAAAAAACACTCTACATAAAATGTGACGATGTGCTCATTGAATCCCTATTTACCATATGATCCTAGGAAAATCACTTCAAAGAGTTTTTAAGAATTAGGCTAATATGTAAATCATGGTATGTGTCAGTAAATAAGGTAAATTCATTCCTGATATACAAGGACAAAGGATTACAGATTGAGTATTAACAGTCACTTAATATTATCTTTCATATTGTTCAG
>TTN-205,,0,98,3392818,3392915,GTATTTTATTTTTATTTTCAGTGCTTTTTATTTTTAAAGAAAAAAAAATCTCAAAAACACACTATGAAAACCACCACAATTGTATTTTCCCCCAACAG
>TTN-205,,0,362,3392916,3393277,GTGAGTACAACTTGATTTCTGTATCTTCCTATGGTAAAGTTCCATCTTTGCATAAAATTCTTTTAAACAGAAAGAAATTTTGAAAGGAAATAGCAAAGATTCAGATAAAGTACAAGTGCCTTTTCTTTCACTTTAATTGAATGTTTGCATATCTAAAAGGAGAAATATATATCCTAACCCCATTGTAAAAATAGAACTTTGGTTTTTGATATGTCTTAGTATAAAGTAACCAATTTCATCTTTCTGGAATAGCTATTTTTTAACAAAATTTTGGACTCATATAACATTCTTTTTTAAAAAAATAAGCTTTAATAAAGCTGCCTGTTTCATCTCATGACTCAAATCTTTTTTTTGTTTAATAG
>TTN-205,,0,132,3393278,3393409,GTAAAAATAAATAAATTATCATCAAGTTGAGGCTAAATGAGTTATTAACTTGGGGGTGGAGGCTATTGCACTTAAACACATACTGTTAGATGTTGCTAAATTATATTCTTTTTTTTTTTTTTTCTGATACAG
>TTN-205,,0,124,3393410,3393533,GTAACCAGTTCTTAAATGTCTCTTTCTTTTATCTTCTAAAATATTTTATCTTCTAAATTCAGCTTCCCAAAAAAAGCTTAAAATGAAATCACTTTTTAAAACACAAATCATTTGCATTCTACAG
>TTN-205,,0,740,3393534,3394273,GTAGGTTGGCTTTTGTTTTTACCCACATTTCTTCAGAAGATAATATTAGGGAAATATTTTCAAACATCCCCCCTTATATACACATACAAGAAAGTATTAAAATAAAATTATTTTCCTAATTCCAGAATACAATTTGTACACCAAAGCAGAAACACACATTTGAAGTTAGCATATGCTTTTCTATGAGCATAAAAAGCAGTTATTAAGTACCTAGTTATATGTGGTATTATATAAGATTCCATAGTGTCAGCCCCTGCTCCCAGGAATATTTAAGAATAAAGTCAGTGAATATACAAAATGGCACTACTTGCCTAAACCTTCACAGTTGCTAATTTTCCAAAGCAGTGCAAAGTTAATTAAAGAACTATTTCTATTTTACCAATTAAAATTAGTTTGCTTTCATTTCAATCTTCTGAAAGATAATTTAATGTTTTGGTTACTCAAAATCTCCCAAATCCACTTATCTCCTAAATCCGTTGACTATTCTTTTCAAGACTTTTTTCCTTAAGTCATATGAATCATCTTTGGCTCAGTTTAGTTTAAGGAATCATTACAGTGATCTCAAAAGTCACACATGATAATTTTCCAAAAGTGGAACTGAGAAAGTATTAGGTATTACCTACATTGCATGAAGAAGTTGACTTTTTTTCTTTTTATGTTTTTCACACGCAGAATCTAGAAGAGTAAAAGGTGGGGGTCTCTTTCTAATTAAGTTTGCCTTACAGAGGTTTCTTTTTTAG
>TTN-205,,0,100,3394274,3394373,GTAAGTTTAATTATGAATATATTATTGAAGAAAAACTAAAATACCATGTCTTCCACATCTGAAGAACTTCAACATTTCTTTTCTTTTTCCTTTGTCTTAG
>TTN-205,,0,525,3394374,3394898,GTAAGTATCTCCTCACCCTTCTTCCTTACATGTTTAAGGCCTTTAGATCGTTTTTTTGCCTCTCTTTCAAGCACAGAAAACTCTAAGAAGCCTTATTAAATTCCATGTGAAAGAGGGACAGCCAACTGATGTGAATTCATTCTTGTAGTCAAACTTTCTTTATAGCTACACAGAAACTTGGATAGATTACATTTCAAAGTAAAGCTACCAACTGCCGTGTAACATTTATTTGCAGGATGCACAATATGTCAATTACTTTCTATATGACTAATCATTTTTCTCCTAGTGATTCCTAGCACCTGCATGTAATGTAATGATAGAAATATAAGGATTCATGTTTTGGAGACATTGAGCTAGCTCTTGACAAATGTATGTATATATGTATTTGCTTATGCTTCAACAGCAAATTGTTTGGGTTATGCTGCTGTGTGTGTGTTGAAGTTTCCATTTCTGTAAGTCAGCGTCATATGTCATCAATTAACCAGATGTCATTGATGTTCACTGTGTATCTGCTATGCTCCACAG
>TTN-205,,0,138,3394899,3395036,GTGAGCAATAAAATTACTGGTAGAGGTAGACAAGCCAAGTAACATGGTGTAGTCTTTAGTACACACAATTCAGTAGAAAGCAAATCTTTATTTTTTTCAGTGATTCTAAGACCTTTTTTTTGTCATTGTTCCATAAAG
>TTN-204,ENSE00001465556,1,212,3395037,3395248,GAGCAGTCGTGCATTCCCAGCCTCGCCTCGGGTGTAGGGATTGCATAGAAAAGCAAAACTACACAGTCTTGACTGTGTAGTTTTGTTTTTAGGATTAGAGGCTCACCGATTCATGTCGGAGATGGTCAGAAAAACCAACTCTCCATAGGACGTCGTTTCAGAAGCAACCTTGGGCTTAGTCCCACCCTTTTTAGGCACTCTTGAGAAATCAG
>TTN-204,ENSE00003502146,1,104,3395249,3395352,AGTGCCTAGAAAGATGACAACTCAAGCACCGACGTTTACGCAGCCGTTACAAAGCGTTGTGGTACTGGAGGGTAGTACCGCAACCTTTGAGGCTCACATTAGTG
>TTN-204,ENSE00003807606,1,204,3395353,3395556,GTTTTCCAGTTCCTGAGGTGAGCTGGTTTAGGGATGGCCAGGTGATTTCCACTTCCACTCTGCCCGGCGTGCAGATCTCCTTTAGCGATGGCCGCGCTAAACTGACGATCCCCGCCGTGACTAAAGCCAACAGTGGACGATATTCCCTGAAAGCCACCAATGGATCTGGACAAGCGACTAGTACTGCTGAGCTTCTCGTGAAAG
>TTN-204,ENSE00003810976,1,288,3395557,3395844,CTGAGACAGCACCACCCAACTTCGTTCAACGACTGCAGAGCATGACCGTGAGACAAGGAAGCCAAGTGAGACTCCAAGTGAGAGTGACTGGAATCCCTACACCTGTGGTGAAGTTCTACCGGGATGGAGCCGAAATCCAGAGCTCCCTTGATTTCCAAATTTCACAAGAAGGCGACCTCTACAGCTTACTGATTGCAGAAGCATACCCTGAGGACTCAGGGACCTATTCAGTAAATGCCACCAATAGCGTTGGAAGAGCTACTTCGACTGCTGAATTACTGGTTCAAG
>TTN-204,ENSE00003809662,1,86,3395845,3395930,GTGAAGAAGAAGTACCTGCTAAAAAGACAAAGACAATTGTTTCGACTGCTCAGATCTCAGAATCAAGACAAACCCGAATTGAAAAG
>TTN-204,ENSE00003809782,1,245,3395931,3396175,AAGATTGAAGCCCACTTTGATGCCAGATCAATTGCAACAGTTGAGATGGTCATAGATGGTGCCGCTGGGCAACAGCTGCCACATAAAACACCTCCCAGGATTCCTCCGAAGCCAAAGTCAAGATCCCCAACACCACCGTCTATTGCTGCCAAAGCACAGCTGGCTCGGCAGCAGTCCCCATCGCCCATAAGACACTCCCCTTCCCCGGTCAGACACGTGCGGGCACCGACCCCATCTCCGGTCAG
>TTN-204,ENSE00003805863,1,331,3396176,3396506,GTCCGTGTCTCCAGCAGCAAGAATCTCCACATCCCCCATCAGGTCTGTTAGGTCTCCATTGCTCATGCGTAAGACTCAGGCATCCACCGTGGCCACAGGTCCTGAAGTGCCTCCCCCTTGGAAGCAAGAGGGCTACGTGGCCTCCTCATCTGAGGCTGAGATGAGAGAGACAACGCTGACAACCTCTACTCAGATCAGGACAGAAGAGAGATGGGAAGGGAGATACGGTGTCCAGGAGCAAGTGACCATCAGTGGTGCTGCGGGTGCTGCCGCCAGTGTGTCGGCCAGTGCTAGCTACGCAGCAGAGGCTGTTGCCACTGGTGCTAAAGAG
>TTN-204,ENSE00003803639,1,153,3396507,3396659,GTGAAACAAGATGCTGACAAAAGTGCAGCTGTTGCGACTGTTGTTGCTGCCGTTGATATGGCCAGAGTGAGAGAACCAGTGATCAGCGCTGTAGAGCAGACTGCTCAGAGGACAACCACGACTGCTGTGCACATCCAACCTGCTCAAGAACAG
>TTN-204,ENSE00003810843,1,138,3396660,3396797,GTAAGAAAGGAAGCGGAGAAGACTGCTGTAACTAAGGTAGTAGTGGCCGCCGATAAAGCCAAGGAACAAGAATTAAAATCAAGAACCAAAGAAGTAATTACCACAAAGCAAGAGCAGATGCACGTAACTCATGAGCAG
>TTN-204,ENSE00003803899,1,126,3396798,3396923,ATAAGAAAAGAAACTGAAAAAACATTTGTACCAAAGGTAGTAATTTCCGCAGCTAAAGCCAAAGAACAAGAAACTAGAATTTCTGAAGAAATTACTAAGAAACAGAAACAAGTAACTCAAGAAGCA
>TTN-204,ENSE00003808716,1,138,3396924,3397061,ATAAGACAGGAAACTGAGATAACTGCTGCATCCATGGTGGTAGTTGCCACTGCAAAGTCCACAAAACTAGAAACAGTCCCGGGAGCTCAAGAAGAAACTACCACACAACAAGATCAAATGCACCTAAGTTATGAAAAG
>TTN-204,ENSE00003809802,1,138,3397062,3397199,ATAATGAAGGAAACTAGGAAAACAGTTGTACCTAAAGTCATAGTTGCCACACCCAAAGTCAAAGAACAAGATTTAGTATCAAGAGGTAGAGAAGGCATTACTACCAAAAGAGAACAAGTGCAAATAACTCAGGAGAAG
>TTN-204,ENSE00003805623,1,138,3397200,3397337,ATGAGAAAGGAAGCCGAGAAAACTGCCTTGTCTACAATAGCAGTTGCTACTGCTAAAGCCAAAGAACAAGAAACAATACTGAGAACTAGAGAAACTATGGCTACTAGACAAGAACAAATCCAAGTTACCCATGGAAAG
>TTN-204,ENSE00003801659,1,294,3397338,3397631,GTGGACGTTGGAAAAAAGGCTGAAGCTGTAGCAACAGTTGTTGCTGCAGTAGACCAGGCCCGAGTCAGAGAGCCCAGAGAGCCTGGGCATCTTGAAGAATCCTATGCTCAGCAGACCACTTTGGAGTACGGATATAAGGAACGCATTTCCGCCGCAAAGGTAGCTGAGCCTCCCCAACGTCCAGCCTCAGAACCCCACGTTGTCCCTAAAGCAGTCAAGCCTAGAGTAATCCAGGCTCCTTCTGAGACTCATATCAAAACTACTGATCAAAAGGGAATGCACATATCATCACAG
>TTN-204,ENSE00003804455,1,123,3397632,3397754,ATCAAGAAAACTACAGATCTAACAACGGAAAGATTAGTCCATGTGGATAAACGCCCCCGCACAGCTAGCCCTCACTTTACTGTTTCAAAAATTTCTGTTCCTAAGACAGAACATGGATATGAG
>TTN-204,ENSE00003810306,1,282,3397755,3398036,GCATCAATAGCCGGTAGTGCTATTGCCACATTACAAAAAGAGTTGTCAGCCACATCTTCTGCTCAGAAGATCACCAAATCGGTGAAGGCTCCTACTGTGAAGCCCAGTGAGACTAGAGTAAGGGCAGAGCCCACACCCTTGCCACAGTTCCCCTTCGCTGACACACCAGATACTTACAAGAGTGAAGCTGGCGTTGAGGTGAAAAAGGAAGTAGGGGTGAGCATCACTGGCACCACCGTCCGTGAAGAGCGCTTTGAAGTACTGCACGGACGCGAAGCCAAG
>TTN-204,ENSE00003805296,1,66,3398037,3398102,GTAACAGAAACAGCAAGAGTACCAGCACCTGTTGAAATTCCTGTTACTCCACCAACTTTGGTCTCG
>TTN-204,ENSE00003806123,1,259,3398103,3398361,GGCTTAAAAAATGTGACTGTCATAGAAGGTGAATCTGTCACCTTGGAGTGCCACATCTCTGGATACCCATCCCCGACAGTGACATGGTACAGGGAAGACTACCAAATCGAAAGTTCCATTGACTTCCAGATAACCTTCCAGAGTGGAATTGCTCGTCTTATGATTCGCGAAGCATTTGCGGAAGACAGCGGGCGATTTACTTGCAGTGCTGTAAATGAGGCTGGAACCGTCAGCACATCCTGCTATCTGGCTGTGCAGG
>TTN-204,ENSE00003808554,1,64,3398362,3398425,TGTCAGAAGAATTTGAAAAGGAAACCACAGCCGTGACTGAGAAATTTACTACAGAAGAGAAACG
>TTN-204,ENSE00003804962,1,216,3398426,3398641,CTTTGTTGAGTCAAGAGATGTGGTTATGACTGATACTAGCCTCACAGAGGAACAAGCAGGGCCTGGAGAACCTGCCGCGCCTTACTTTATTACAAAACCAGTGGTCCAGAAACTGGTGGAAGGTGGGAGCGTGGTGTTTGGATGCCAAGTTGGCGGCAACCCAAAGCCCCATGTATACTGGAAAAAATCTGGTGTTCCTCTAACCACTGGATACAG
>TTN-204,ENSE00003804165,1,143,3398642,3398784,ATACAAAGTGAGTTACAACAAACAAACCGGTGAATGCAAGCTGGTGATTTCTATGACTTTTGCTGATGATGCTGGAGAATACACTATTGTTGTTCGCAATAAGCATGGAGAAACTTCTGCATCTGCTTCCTTGCTTGAAGAAG
>TTN-204,ENSE00003802603,1,206,3398785,3398990,CTGATTATGAGTTACTGATGAAGTCCCAGCAAGAAATGCTTTATCAGACACAAGTGACTGCATTTGTTCAAGAACCTAAAGTTGGAGAAACAGCACCTGGATTTGTATACTCTGAGTATGAAAAAGAGTATGAAAAAGAACAAGCCTTAATTAGGAAGAAAATGGCCAAAGATACTGTAGTGGTCAGAACTTATGTAGAAGATCAG
>TTN-204,ENSE00003807963,1,234,3398991,3399224,GAATTCCATATTTCTTCCTTTGAAGAGAGACTTATTAAAGAAATTGAATATAGAATAATAAAGACTACATTAGAAGAACTTCTTGAAGAAGATGGAGAAGAAAAGATGGCAGTTGACATTTCTGAATCTGAAGCTGTTGAATCAGGATTTGATTCAAGAATCAAGAATTATAGAATTCTTGAGGGGATGGGTGTCACTTTTCATTGCAAGATGTCTGGATATCCATTACCAAAG
>TTN-204,ENSE00003808968,1,245,3399225,3399469,ATTGCTTGGTACAAAGATGGCAAGCGCATCAAACATGGAGAAAGATACCAAATGGACTTTCTACAAGATGGCAGAGCTAGTCTGCGTATACCTGTTGTTCTTCCAGAAGATGAAGGAATCTACACTGCATTTGCCAGCAATATTAAAGGAAATGCAATTTGCTCAGGGAAATTGTATGTGGAGCCTGCTGCACCACTTGGAGCTCCGACTTACATTCCCACACTAGAGCCAGTGAGCAGAATCAG
>TTN-204,ENSE00003802614,1,272,3399470,3399741,ATCTCTCTCTCCACGTTCAGTGAGCAGGTCTCCTATACGCATGTCTCCTGCACGGATGTCACCTGCAAGGATGTCTCCTGCACGGATGTCCCCTGCAAGAATGTCCCCTGGACGTAGGCTGGAGGAGACAGATGAGTCACAACTTGAGAGACTATATAAACCAGTCTTTGTGTTAAAACCTGTTTCTTTCAAATGTTTAGAAGGGCAAACTGCCAGATTTGACTTAAAGGTTGTTGGTAGACCTATGCCAGAGACGTTCTGGTTTCATGATG
>TTN-204,ENSE00003811446,1,165,3399742,3399906,GCCAGCAAATTGTCAATGACTATACCCATAAAGTAGTCATTAAAGAAGATGGTACTCAATCACTAATTATTGTCCCTGCCACACCCAGTGATTCTGGGGAATGGACTGTGGTTGCCCAAAACAGGGCAGGCAGATCTTCAATTTCAGTGATTTTAACTGTGGAAG
>TTN-204,ENSE00003805710,1,169,3399907,3400075,CTGTGGAACATCAGGTAAAACCGATGTTTGTAGAAAAACTGAAAAATGTCAATATAAAGGAAGGTTCCCGACTTGAAATGAAAGTCAGAGCTACGGGTAACCCCAACCCTGACATTGTATGGTTGAAAAACAGTGACATCATTGTGCCTCATAAATATCCCAAAATCAG
>TTN-204,ENSE00003809358,1,1694,3400076,3401769,AATTGAAGGAACCAAGGGAGAAGCTGCCCTTAAAATCGATTCCACTGTCAGCCAAGATTCTGCCTGGTATACTGCGACTGCTATTAATAAAGCTGGCAGAGACACTACAAGATGCAAAGTAAATGTTGAAGTTGAGTTTGCAGAGCCTGAGCCAGAGAGAAAGTTAATCATCCCACGGGGGACATATAGAGCAAAGGAGATTGCAGCCCCAGAACTGGAGCCCCTCCATTTGCGATATGGCCAAGAGCAATGGGAAGAAGGTGATCTCTATGACAAAGAGAAACAACAGAAACCATTTTTCAAGAAAAAACTCACTTCCTTAAGACTTAAGCGCTTTGGGCCTGCCCACTTTGAATGCAGGCTAACACCCATTGGTGACCCAACGATGGTGGTGGAGTGGCTCCATGATGGAAAGCCACTTGAAGCAGCCAACAGGCTCCGTATGATCAATGAATTTGGGTACTGCAGCCTTGATTATGGCGTTGCATATTCTAGAGACAGTGGTATCATTACTTGCAGAGCCACTAACAAATATGGAACAGATCACACATCTGCTACCCTTATTGTTAAAGATGAGAAAAGTCTTGTGGAAGAATCCCAATTGCCTGAGGGGAGGAAAGGCTTACAGAGAATTGAAGAATTAGAGAGAATGGCTCATGAAGGTGCACTTACAGGTGTAACAACAGATCAGAAAGAAAAGCAAAAGCCAGACATTGTCTTGTACCCAGAGCCAGTTAGAGTACTTGAAGGGGAGACTGCAAGGTTCCGCTGCAGGGTAACAGGCTACCCTCAGCCCAAAGTCAACTGGTACCTCAATGGACAGCTCATCCGCAAAAGCAAAAGGTTCAGAGTTCGCTATGATGGTATCCATTACCTGGACATCGTGGACTGCAAATCATATGACACAGGTGAAGTGAAGGTCACCGCGGAAAATCCTGAAGGTGTGATAGAGCATAAAGTGAAGCTTGAGATTCAACAGAGGGAAGATTTTAGGTCTGTCCTTAGGAGAGCTCCTGAACCAAGGCCTGAGTTTCACGTACATGAACCAGGAAAGCTTCAGTTTGAAGTACAAAAAGTGGATAGACCTGTTGACACCACTGAAACCAAAGAAGTTGTGAAGTTGAAAAGGGCTGAAAGAATTACCCATGAAAAAGTGCCTGAAGAGTCGGAAGAGCTGCGCAGTAAATTCAAGCGCAGAACAGAAGAGGGCTATTATGAAGCCATTACCGCTGTGGAGCTCAAGTCTCGAAAGAAGGATGAATCCTATGAGGAACTCCTCAGGAAGACAAAAGATGAACTTCTCCACTGGACCAAAGAGTTAACTGAAGAGGAAAAGAAAGCTCTTGCCGAAGAAGGCAAAATCACGATTCCAACTTTTAAACCTGACAAGATTGAACTAAGTCCTAGTATGGAGGCTCCAAAAATCTTCGAAAGAATCCAGAGCCAAACAGTGGGCCAAGGATCTGATGCACACTTCCGGGTCAGAGTCGTGGGGAAACCAGACCCCGAATGTGAATGGTACAAAAATGGTGTCAAAATTGAACGGTCTGACCGGATCTACTGGTACTGGCCCGAAGACAATGTTTGTGAATTGGTCATAAGAGATGTGACTGCTGAGGACTCTGCCAGCATCATGGTAAAAGCCATCAACATAGCTGGAGAAACCTCCAGTCACGCATTCTTACTTGTCCAAG
>TTN-204,ENSE00003809440,1,282,3401770,3402051,CCAAGCAATTGATCACTTTCACACAGGAATTACAAGATGTTGTTGCTAAGGAAAAAGACACTATGGCAACCTTTGAATGTGAAACTTCAGAACCATTTGTCAAAGTGAAATGGTATAAAGATGGTATGGAGGTTCATGAGGGAGATAAATACAGGATGCACTCTGACAGAAAGGTTCACTTCCTCTCCATACTGACCATTGATACGTCTGATGCTGAAGATTACAGCTGTGTACTTGTGGAAGATGAAAATGTCAAAACGACTGCTAAACTTATTGTTGAAG
>TTN-204,ENSE00003802960,1,267,3402052,3402318,GTGCAGTTGTTGAGTTTGTGAAAGAACTTCAGGACATAGAAGTTCCAGAATCATATTCAGGAGAATTAGAGTGCATTGTATCCCCAGAAAATATAGAAGGAAAATGGTATCATAATGATGTGGAGCTTAAATCCAATGGCAAATATACAATTACATCTCGTCGTGGACGTCAGAACCTCACGGTCAAGGATGTAACCAAGGAGGACCAGGGAGAATACAGCTTTGTCATCGACGGGAAAAAGACAACCTGTAAATTAAAGATGAAAC
>TTN-204,ENSE00003804241,1,273,3402319,3402591,CCCGCCCCATTGCTATCCTACAAGGACTTAGTGACCAAAAAGTCTGTGAGGGTGACATTGTTCAGCTTGAAGTTAAAGTCTCCTTGGAAAGTGTGGAAGGCGTCTGGATGAAAGACGGCCAAGAAGTGCAGCCCAGTGACAGGGTTCACATTGTGATAGACAAACAATCTCATATGCTGCTCATTGAAGACATGACTAAGGAAGATGCTGGAAATTACTCTTTCACCATTCCAGCCCTTGGCCTCTCCACCAGTGGGCGTGTCTCTGTCTATA
>TTN-204,ENSE00003806988,1,264,3402592,3402855,GTGTGGACGTGATAACACCTCTAAAAGATGTTAATGTGATTGAAGGCACCAAGGCTGTGCTTGAATGTAAGGTGTCAGTCCCTGATGTGACTTCTGTTAAGTGGTACTTAAATGATGAACAAATCAAGCCTGATGACCGTGTACAGGCCATTGTGAAAGGTACTAAACAGCGACTAGTCATTAACCGAACTCATGCTTCAGACGAAGGACCTTACAAGCTGATAGTTGGCAGAGTTGAAACCAACTGTAATCTCTCTGTAGAAA
>TTN-204,ENSE00003804968,1,261,3402856,3403116,AAATTAAAATTATCAGAGGTCTTCGTGACCTTACCTGTACAGAAACTCAAAATGTGGTGTTTGAGGTTGAGCTGTCCCACTCTGGAATTGATGTCCTGTGGAATTTTAAGGACAAGGAAATCAAGCCCAGTTCTAAATATAAAATTGAAGCACATGGAAAAATATATAAATTGACAGTTCTAAATATGATGAAAGATGATGAAGGAAAATACACATTTTACGCGGGAGAAAATATGACATCTGGAAAACTTACTGTGGCAG
>TTN-204,ENSE00003809850,1,261,3403117,3403377,GTGGGGCCATCTCCAAGCCACTCACAGATCAGACCGTAGCTGAATCCCAGGAAGCTGTGTTTGAATGTGAAGTTGCCAACCCAGATTCCAAAGGCGAATGGTTGAGGGATGGCAAACACCTACCACTGACTAACAACATCAGAAGTGAGTCTGATGGCCACAAAAGGAGACTTATCATTGCTGCCACCAAATTAGATGACATTGGAGAATATACCTACAAGGTGGCCACCTCCAAAACATCTGCCAAACTCAAAGTTGAAG
>TTN-204,ENSE00003806479,1,264,3403378,3403641,CTGTCAAAATTAAGAAGACTCTGAAGAACCTCACAGTGACAGAAACACAGGATGCTGTTTTCACTGTCGAGCTTACACACCCTAATGTCAAAGGTGTCCAGTGGATCAAAAATGGAGTTGTGCTGGAATCCAATGAAAAGTATGCTATCTCTGTCAAAGGAACAATTTACTCTCTGAGGATTAAAAACTGTGCCATCGTGGATGAGTCTGTTTATGGCTTCAGGCTTGGAAGGCTTGGAGCCAGTGCCAGACTGCACGTGGAGA
>TTN-204,ENSE00003804523,1,261,3403642,3403902,CTGTCAAGATCATTAAAAAGCCAAAGGATGTGACAGCCTTGGAAAATGCCACTGTTGCCTTTGAAGTTAGTGTTTCCCATGACACTGTTCCAGTAAAATGGTTCCATAAGAGTGTGGAAATTAAGCCAAGTGACAAACACAGACTGGTCTCAGAAAGGAAAGTCCACAAGCTGATGCTGCAGAACATCTCCCCCTCAGATGCTGGGGAATACACAGCTGTGGTCGGGCAATTGGAATGCAAAGCAAAACTGTTTGTGGAGA
>TTN-204,ENSE00003807378,1,261,3403903,3404163,CATTACATATTACAAAAACCATGAAAAATATCGAGGTGCCTGAGACCAAAACTGCCTCTTTTGAGTGTGAGGTGTCCCACTTCAATGTCCCTTCCATGTGGCTGAAGAATGGTGTGGAAATTGAGATGAGTGAAAAGTTCAAGATAGTTGTGCAGGGAAAACTCCATCAGCTGATCATCATGAACACCAGCACAGAGGACTCGGCAGAATACACATTTGTCTGTGGCAATGACCAAGTCAGTGCCACCCTGACAGTCACCC
>TTN-204,ENSE00003807271,1,261,3404164,3404424,CAATCATGATTACTTCCATGCTGAAAGACATCAACGCTGAAGAAAAAGACACTATTACTTTTGAGGTGACAGTGAACTATGAAGGCATCTCTTACAAATGGTTAAAGAATGGTGTGGAAATCAAATCAACTGACAAGTGCCAGATGAGAACCAAAAAGCTCACACACTCACTGAACATCAGGAATGTTCACTTTGGGGATGCTGCTGACTACACCTTTGTGGCTGGAAAAGCAACATCAACAGCCACACTTTATGTGGAAG
>TTN-204,ENSE00003808172,1,142,3404425,3404566,CTCGTCATATAGAATTTAGGAAACACATTAAGGACATTAAGGTACTGGAGAAGAAGCGAGCCATGTTTGAATGTGAAGTTTCTGAACCTGACATCACTGTACAGTGGATGAAAGATGACCAGGAACTGCAGATCACAGACAG
>TTN-204,ENSE00003808223,1,166,3404567,3404732,AATAAAGATTCAGAAGGAGAAATATGTCCACCGCCTTCTGATCCCATCCACCCGGATGTCTGATGCTGGGAAGTACACAGTGGTGGCAGGAGGCAACGTGTCAACTGCAAAACTCTTTGTAGAAGGCAGAGATGTTCGCATCCGAAGTATTAAAAAGGAGGTTCAG
>TTN-204,ENSE00003810851,1,232,3404733,3404964,GTCATTGAGAAACAGCGTGCTGTTGTTGAATTTGAGGTCAATGAAGACGATGTTGATGCCCACTGGTATAAAGATGGCATTGAAATCAATTTCCAAGTTCAAGAACGACACAAATATGTAGTGGAAAGAAGAATCCACCGAATGTTTATCTCTGAGACCAGACAGAGCGATGCAGGAGAATACACCTTTGTGGCAGGAAGGAACAGGAGTTCTGTCACTCTCTATGTCAATG
>TTN-204,ENSE00003802092,1,285,3404965,3405249,CTCCTGAACCGCCCCAAGTTCTGCAGGAGCTCCAGCCTGTCACTGTGCAGTCTGGCAAGCCTGCCCGCTTCTGTGCCGTGATATCCGGAAGACCACAGCCCAAAATTTCCTGGTACAAGGAAGAGCAGCTGCTTTCCACTGGCTTCAAGTGCAAATTTCTTCATGATGGGCAAGAATACACGCTTTTGCTAATTGAAGCCTTCCCAGAGGATGCGGCAGTCTATACCTGTGAAGCCAAGAATGACTATGGTGTTGCCACAACATCAGCTTCACTCTCAGTGGAAG
>TTN-204,ENSE00003807103,1,126,3405250,3405375,TTCCAGAAGTTGTGTCTCCTGATCAGGAAATGCCTGTTTATCCACCTGCCATCATCACCCCGCTTCAGGACACTGTCACTTCTGAAGGGCAGCCAGCCCGTTTTCAATGCCGGGTTTCTGGAACAG
>TTN-204,ENSE00003801355,1,189,3405376,3405564,ATCTAAAAGTGTCGTGGTACAGCAAAGACAAGAAAATCAAGCCATCTCGGTTCTTTAGAATGACTCAATTTGAAGACACTTATCAACTGGAAATTGCCGAAGCTTATCCAGAAGATGAAGGAACTTACACGTTTGTTGCTAGTAATGCTGTAGGCCAAGTATCAAGCACAGCCAACCTGAGTCTGGAAG
>TTN-204,ENSE00003810791,1,57,3405565,3405621,CTCCTGAATCAATTTTGCATGAGAGGATTGAACAAGAGATTGAGATGGAAATGAAAG
>TTN-204,ENSE00001339816,1,7635,3405622,3413256,AATTATTCTCTGAGGGGGAATCTGAACATTCAGAAAGGGATACACGTGACGCCTTTTCAGATTCTGAAGACATAGACCACAAATCCATGGCTGCTAAAAGATATGCAAGTAGAATATCATCTACAAGCTCCTGGCCTGAATATTTTAAGCCTTCTTTTACCCAGAAACTTACATTTAAATATGTTTTAGAGGGTGAACCGGTTGTTTTTACATGTAGATTAATTGCCTGTCCAACTCCAGAAATGACTTGGTTTCATAACAATCGGCCCATCCCAACAGGTCTTCGTCGGATTATAAAAGCTGAGAGTGATTTACACCATCACTCTTCCAGCTTAGAGATTAAAAGGGTCCAAGACAGAGATTCTGGAAGTTATAGGTTACTAGCAATTAATAGTGAAGGGTCTGCAGAATCAACTGCATCATTGCTTGTTATCCAAAAAGGGCAAGATGAGAAATATTTAGAATTTCTGAAAAGAGCAGAACGGACACATGAAAATGTGGAGGCTTTAGTTGAAAGGGGAGAAGATAGGATAAAGGTTGACCTGAGGTTTACTGGCTCTCCCTTTAACAAAAAACAAGATGTGGAACAAAAGGGAATGATGAGAACTATACATTTTAAGACAATGAGTTCTGCCAAGAAAACAGATTACATGTATGATGAAGAATATTTAGAAAGTAAATCTGACATAAGAGGTTGGCTTAATGTAGGTGAAAGTTTCCTGGACAAGGAGACCAAAGTGAAGTTGCAACGTTTAAGGGAGGCTAGAAAAACATTAATGGAGAAAAAGAAATTATCTCTTTTAGATACGTCTTCTGAAATAAGCTCAAGAACTTTGAGAAGTGAAGCTAGTGATAAAGATATTCTGTTCTCTAGAGAGGACATGAAAATCAGATCTATGTCTGATCTAGCTGAAAGTTATAAGGTAGATCATTCAGCTGAGAGTATTGTGCAAAATCCACATGCCCTTTCTAATCAAATGGATCAAAATATAGAATCTGAGGAACTTCCCACAAGCTTTCAAACTATTGTTGATGAAGAAATTTTCCAGACTGAAATAAGAATGAGCCAAGAAGCACTGGTAAAGGAAAGTCTACCAAAAGACCATTTATATGGTGAAATTCTAGTAAATGAAAATACCCAAGCAAGAGGACAGCTGGAAGAAATTATGGCCAATACTACAATTGGAGAGTCATCCACATATATCACTAATGTATGTGAGAAGGAGGAAGTATATGAGACTCCTGAAAATGTGTCTCAAGCTATTACACCACATGCCAGCGAATCTTTTGGTACACTTGTAAATGTTGAAGAAAGTGAAGAAATAGCTAGTGAAAGAATAAAAAAGGATGATTTGAGAGAATTACAACTCTCTGCTTCTACACGAATTGATGAATTCAAAACCGAACAGAAGGAAGAAAACATGAGATTTTTTGAAAATTCTTTTCGAAAACGCCCACAACGTTGCCCACCTTCATTTCTTCAAGAAATTGAATCTCAAGAAGTTTATGAAGGTGACAGTTGTAATTTTGTGTGTCATTTTCAAGGATATCCTCAACCTATAGTGACGTGGTATAACAATGACATGCCAATCCCACGTAATCAAAACTTTATCATTCATTCGTTGGAAAACTATTCAATATTAACTCTTTCATCTGTTCATCATCAGAATGAAGGTTCTATTACTTGTGTGCTATTTAACCAATATGGAACAGTAAAAACAACCAGTATGCTTAAAGTGAAAGCAAAACAAAAACATGATGTCAAAGCACATAAAGTCCCAGTGTTCCATGACTACTTGGATGAGGAAGAAGAGTTAGCATTGGTGTTTGACCAAGCAAAAGGCGCCCATCCATCTATGAGTCAAGAGGGCCAAACAAATCTTCATTTGTTAAAAACTAACCCACCAGTTCCTCCCTCTGGAGACACAGAATTGCTTTCCTTTCCTGTAGAAATTCAGGTAACAGCAGCTACTCCTATCCCAGAACAGGATAAAGAGTCTAAAGAAGTGTTTCAAACTGAGGAGCTGGAACCTAAAGCAATGCCTCAAGATCAAGTTACTCAATCACCAAAACACAGATTTGTATTTTTGTCTGATATTACTAATGAACCACCAAAAATGTTACAAGAAATGCCAAAGCATGCCAGGTGTAGAGAAGGGGATTCCATCATTCTTGAATGTTTAATATCTGGTGAGCCCCAGCCAGTTGTAACATGGTTTCAAAATGGAGTCCTTTTAAAGCAGAACCAGAAGTTTCAGTTTGAAGAAGTTAATTGTAGCCACCAATTATATATTAAGGATGTTAATTCTCAAGATTCTGGAAAATATAAATGTGTTGCTGAAAACAATTCAGGGGCAGTTGAAAGTGTTTCAGATCTAACAGTGGAGCCTGTCACTTATAGAGAAAATAGTCAATTCGAAAATATTGGTGAAATTTATGGAAAATATTCCAGAGATCAGCAACTGCAAGACCAGGGAGAATCTGTAAGGGCACATTTTTATGATTATCCAGCTGGTCCCTTTACTCCCTGGACAAATGTAAAAGAATATTCAGTAAGGGACTATTTTCAAAGCCTTGAGACTATTGAGCAAATAGACCAGAAAGAGCAGGTGCGTTGCATACCTTCTAGAGAAAAAATTCCCAGATTTGTGCATGGTGCTTCAAGAACCATAAAAATCAGCAAGCCCATCAGGGCTGAATTCATACAATGTCAGGCTGAAGGGAAAGAGAGACATGTAAGTGAAAAATCAAAGCTGCACCAAGCAGAGGGTACTGTTTATCCATTTGTTGATGATTTCAGTGATGTCACTATTAAGAAAGAAATAAGAAATAATTTTGGAAAACTTGGTAGATCAGAAAAGGAAAATGTACAAGAATGTGCCCAAAGTGACTATTTACCAAATATTCACTCTGAGAGAATTTCTGACAGTTACAATACAAAAGATTCATCTGCCATTGTATATGAAGAATCCCTTGGTGAAGAGATACACTACCCGGGGAAAAAGGTGAAGCATAGAATTATCGAATTTGAAAAATTACATGTAGAAAAAGGAGTTCTAGAAAAAAGACCTACCAGAACATCAATTGTTAATCCTCCTCAAAAGAAGATTGATGACAAAGCCTTTTCATTAAAGCAAAGAGAATCAAGATCAAGCAATCTAAATGCAAATATGTATCAGGCAGAGAAAATGTCTCCAAATACTGAATCAGATTCATCTAACATTGCAATAAATTTAAAGCTGCTTTCCTCTCAAACTCATAAAGAATTTGACGCACAAGAAAGGGAACAACAGGAAAAAATAAGTCTTATAGATAAACCTGCAATTTCTAAAAGAGCTGAACATGAATCACCTATTACATTTGACTTAAAGCAGTTTCACACTCAAATAAAACACACAGATGTGAAATTCCAAGAATTAGATAGTGGTCAACCAGAAGAAGCTTATTTTAAAATCCAACATCCTGCTGACACTGAGAACATTGTATTTGATCTAAAACAAATGTATTCTCATATAGGAGATCCAGCTCTGGAGTTCCAAGGGCAAGAAACTAGGGAACAGCAGGAAATACATTATAAAGAAAAAATTCCTAGCCCTGAAACGTTACAACCTGACACACACAATATCTCTAAAAGTGTGCAAAATAATGTATTTGCCAGTCAAGAAATTTCTTCCAGTCAAGAGCTTTCAAATAGAACTATGGTGGAGAAAAGTAGTATTGATGAAAATTCCATTTCTTTAGAAAAAGAAGTCCGACATGTACAGGAACAAAACTTAGACATTTTAAAAACTGATCTTTCTCTTAAATCCTTTTCTGAAGAAATCTATAGTGAATCATGTGCCCTACTTCCAACCTCATCTGCAGATATAGAAGAAACTGATCTTTCTGAGAAAAGTTGTCCTCTAGAAAATGGAGGCAGAAGTTCCATCTCACATTTGAAAAAAGCAGCAAGTGAGGAAAAGCCTTTAGGGGTTGGTGAAATGGAAGAAGAATGCACTCTAGAACCAGAGTTGGCAGCATTTCCAAAGCAGGATGGTGGGACACAGGAATATACAGATGCCACTTTGGAAGACCACAGAGGTGATGTTCAGGAAGCTGACACACTCCATAGACAGCTCTCCCTGAGTCAGTGCTTCCCACTCTTGATGACTGAAGAACAACAGAATCCAGGTGAACAAATAAGTACAAACATTCATGCCTCTGGAGAAGAAAAATGTTATGAAGAAGTTCAAGTTCAGAATGAAGCTTCTTTCTCCACTTTAGAAGGAGAAATGATAGAAACTAGTTTTTCTCAAAATATTCCTAAATTAGATGAGGCACATACCACTGAGGCAGCAGAATCTGAGACCTCCCTAACACAATATTTACTTGCTGCTGGAAAGCGTGAGGTTCCTGAAACTAAAGACACCAGAGACCAGGCAAAGCTTGTCCAGAGTGAATCAATCACTTCAATGGAGGTGGAAGAAGTAACTTTCAACACTGTGTATGAATACTACAACCAGAAACAGGAATCACTAGGTCGTCCACTTTCTCCTGAGTCTGACATTTCCATTGGTGTGGGAAGTACAACCAGTGAAGAAATATCTGAGTTAGATCAGTTTTATACCCCACCATCATCTGTTGAATATTTTGAATCTCCAAAGTCCCCTGACTTATATTTTAATCCTTCAGATATAACTAAACAATCCTCAATACATTCAGGAGGTGAGACAGTTGAAAGATATTCCACACCTTTAGGGGAAGTTGCTGAAAGATATTCAACACCTTCCGAAGGTGAGGTAGGAGAAAGATACTCCACACCCCCAGGGGAGACACTAGAGAGATACTCCACACCTCCAGGAGAGACTCTAGAGAGATACTCCACACCCCCAGGAGAGACTCTAGAGAGATATTCCACACCCCCAGGAGAGACTCTGGAGAGATACTCCACACCCCCAGGAGAGACTCTAGAGCGATATTCCACACCCCCAGGGGAGGCACTAGAGAGATATTCTATTCCTACTGGAGGACCAAACCCCACTGGTACTTTTAAAACATATCCATCAAAAATAGAAAGGGAAGACGGTACACCAAATGAGCATTTCTACACACCTACAGAAGAGAGGGGTTCAGCTTATGAAATATGGCGTTCCGATTCATTTGGTACACCCAATGAAGCCATTGAGCCAAAAGACAATGAAATGCCTCCATCTTTTATTGAACCTCTGACCAAAAGGAAGGTATATGAAAACACAACACTAGGCTTCATTGTTGAAGTTGAAGGTCTTCCAGTTCCTGGTGTGAAATGGTATCGAAATAAATCTTTACTAGAGCCAGATGAAAGAATCAAAATGGAAAGAGTGGGTAATGTGTGTTCACTGGAAATTTCTAACATTCAAAAAGGAGAAGGGGGAGAGTACATGTGTCATGCTGTAAACATCATAGGGGAAGCAAAGAGCTTTGCAAATGTAGACATAATGCCCCAGGAAGAAAGAGTGGTGGCACTACCACCTCCAGTAACACATCAGCATGTCATGGAGTTTGATTTGGAACACACCACATCATCAAGAACACCTTCTCCTCAAGAAATTGTCCTGGAAGTTGAATTAAGTGAAAAAGACGTTAAAGAATTTGAGAAGCAGGTGAAAATAGTGACAGTTCCCGAATTTACTCCTGACCATAAAAGTATGATTGTGAGTCTAGATGTTCTTCCATTTAATTTTGTAGATCCAAATATGGATTCAAGGGAGGGAGAAGACAAAGAACTAAAAATTGATTTAGAAGTATTTGAAATGCCTCCTCGCTTTATAATGCCTATTTGTGATTTTAAAATTCCAGAAAATTCAGATGCTGTATTCAAATGTTCAGTCATAGGGATCCCGACTCCCGAAGTTAAGTGGTATAAAGAATATATGTGTATTGAGCCAGATAATATTAAATACGTGATTAGCGAGGAGAAGGGAAGTCACACTCTTAAAATTCGAAATGTCTGTCTTTCTGATAGTGCAACATACAGGTGCAGAGCTGTGAATTGTGTAGGAGAGGCTATCTGTCGGGGATTCCTCACCATGGGAGATTCTGAAATATTTGCTGTGATAGCAAAGAAAAGCAAAGTGACTTTAAGCAGTTTAATGGAAGAATTGGTCTTAAAGAGCAACTACACAGACAGTTTTTTTGAATTTCAGGTGGTGGAAGGGCCTCCCAGGTTTATCAAAGGTATTTCTGACTGTTATGCACCAATAGGTACAGCAGCATATTTTCAGTGCTTAGTTCGTGGCTCTCCAAGACCCACGGTTTACTGGTACAAAGATGGAAAATTAGTCCAAGGAAGAAGGTTCACTGTTGAGGAAAGTGGCACAGGGTTCCATAACCTGTTTATAACAAGCTTAGTAAAGAGTGATGAAGGAGAGTATAGGTGTGTAGCTACAAACAAATCAGGAATGGCTGAGAGCTTTGCAGCACTCACCTTAACTTAAAATGTAATGTTTTAGTGCCTCAGTAATTATTAGCATTGATCTGAGTGCTTTCATATTTTCCAAATTATGTGGATCTAATAAACTTCCAAACAGGTCCACCATATTTGAATTCATTACCTTGGAGACCCCTAAAGAAATAATCTCTATGTAGAAATCTCATCTTTGTAATACATGTAAATATTTTGTTATCTGAACTGTGGAATCATCACTTGTGTCAATCATGCTGTGTAATATCAAACACAATTAAATCTCTCCTTGGCTACCTAATTGTTTGTACTTCTATTTACCCTCATGCCTCCTCCACAAAGTGTTTCAGTGGAATGGACTCTCTTTTAGCAGATAAACCATATATGCAAAAGTACAATGTAAAAGTGGAGACCATATCAGATGACCACGCAGACAAATTGGTAAGGGCAAATCTCTCTGCTCCCATTCTAAGTTATTTTTGGAATTTTAACCCCTTTGCATCCAAACTCATGTTTATTTACTTTGACTTAGAATAGGCAAAACAAACAACAAAAACCAGCTTCTCCCAATTGGCAACTAACTCTATAATCTGTTTGACATTTCAATCTTAATATATTAACTTCATCTCTTTTAAAAATGTTTTCGTTATTAATATTCCTCTTCATAAGTGCTTTAATTCTCACTGGCTTCAAGGGACCAATTGTGCTCTTTGTGGGCAGGGTTCACCTAGACATTTGCAAAATAAGCAAATAGATCTTTCCACTTTTGGAGATACCTTATTTTTCTCCATTTTTGAGATGACATCAAGTGTAAAATGCAGCAATAATTTAGTATTGGCCTGGGGAAAAAAGGGAAACTATCATATTGTGTTTACATATAGATTTTAAAACTGTATTCTGATTTCAGAATCTTTAAAATTTAAAAAAAGGTGGGATATTTTTAGAATTGAGACAATATGGTAATTTGTATTTCAGATTATATATAAATAACAAGATAACAAGCTTTCCTATCAGTTTCACTGAATTTCATCTTTAAAACGAATATAGCTTAATAAGCATTCAATTTTTATTGTGATGTTTATGTTTCTAAAGTAACTCTTTAATTTTGTCTTTTAAAATTAAAATAACAGTAAATTAACATACTCCTTAATATCTTACCTATATACTAATGTGGACCCAAGTCTTCTCATATAAGACTCGACAAATATAAAAAA
>TTN-204,,0,2556,3413257,3415812,GTGAGCAGCAACTTTTCTTATTTTAATAGTAGAGTCACTTTCTTATTGATCTCTGGCTCTGGATTATTTGTGTGTGCTAAATGCCTATGTACAAGTGTTTGTATGACTATTTCTTGCCAGTGCTGACCCATTATTTAAATCTGCTTGTTAAATTCTATTTTAAAATGTCTGAACATTTTTCCTTAAAAAGTTGAAAGCTTTATTATATCAGCTAAATGATTCCATGATTCAAATTGTTTAAGTTCACTTAATATTCTAAAAGTTGAGGTCTGAAATGTTGAGAGAAATGTTTACTTCTTTTCTAGACTCTCTTTGCCTGTTGAGAATGTTCAAGGTTATATTACTCAATGATAAAGTTAAGCACACCAAGAATAGCTCTGATAAAATGCATGTGGTATCAGCTACACCCTGATGACTTTTTAAGGGAATCAACTGCTGAGGTATCAGTTGCAGGACAGTGACAGAACACTTGCCTGCTGTCAGTCAACCTTGGAGAGTTTAGGAGAGTTTATTTTAAGAGCATGACATTTTAGACGCATACCTTCAGCCCCAGTTAGACAAAGGCCTGTGAAGAGCAAGTGCTAAGGCAATAAAATTTACCTAGACAATAGGAATGTAAGATCAATTTAAGCTGGTTAATTGCAACATAGTTGGAGATTTGGAATAAAATGATATAATTGTTTTCTAAAATATTCAGAATCTCTTCATGCATTTTAACTCAGCACACAGTCCAATTATATATTTTGAGATAAATGTTGACACTAAGAAGGGTAAGAAATAATGTTTAAAGGAAAGGTTTCTTACTTCTAAATACACTTTGATTTCTCATCTTCCTAGAATTTGATTACTAATTGTCAATGCCTGTAAATACATAGATATATAATTAGGTATTCTATGTCTAAGAGGACAGCTATTTTTAGATATACTAACTTATAAACAGACAAAGTTAGACACAGAAAGTTGTTCATCCCAAAGATAATATGCTACAAAAAGGAGTTTCTGACAAAAAAAATTTATGAAAGCTTTTGGATATTATCTGATTTTTCCAAATATAAATTTTATTGTCTCAGAGAATGCTGGTTTCATTTTTTTAACTAAGTAGAAGGTTACAGTAAGGAACAGAATTATCACTAAGAAGATTATTGCTCCATGAAGTTTTAGTAAACAAAGAATTTAATGAAAAATAGTAATGAAGTGATTGACAATTCAGAAATGTTCTATTTCAGAACAGAATAGTCATGTTGAATAATTAGGTATTTATGCATCAGAAAATTCTTCACATAATGTCTCTGAAACTGATAGGCAAAGTACTTTCTTGCACTTAACAAAATGACTTAACTGCAAATTTTATATTCGTTTCTTTGATGTTGAATATTTTACTTTATGAAAGCATAGGCCTTTTCACTTCATCTACATTTTACACCAGCCTTCCATTATTCAAAGTTTGCAAATTGTTCCATATTAAGAACTCAAGCCAGCATTTTTCTTTCAGAACTATAATAAACTTTGGCCTGTTCACTAAAATTTAAATTTTTCTGAATATTTACTTCAGCAGTAACAACATTTACTGCACAGTTACAGTATGAAGAAATGTTAAGAAATAGAAAGCACCGTATGCCGTCTACAAAAAGCTTGCATATTTGATAAGGCTTGCCAAAGCTTCTCCAGTCAGGAAAGAGATTACAAAGTTCAGATTTTTACTTCTGGCAACTATTTTAAGTAATCAGATAATGTCTGAATCAATGTCAACTTTATAAATATAGAGTGAACGAAAAATATTGGGGAGAAGGAAAATTTTTAAAATAATTTTCACTTACTAAGCTGATGCAGAGGTTTATTTATTTTAATTTTTTTTTTTTTTTTTTTTTGAGACAGAGTCTCATTCTGTCACCCAGGCTGGAGTGTGGTGGCACCATCTTTGCTCACTGCAACCTCCACCTCCTGGGTTTAAGCAATTCTCATGCCTCAGCCTCCCAAGTAGCTGGGACTACAGACATGGGCCACCACGCCTGGCTAATTTTTGTATTTGTAGTAGAGACAGGGGTTTCACCATGTTAGCCAAACTGGTCTCAAACTCCTGACCTCAAGTAATCCTCCCGCCTCGGCCTCCTAAAGTGCTGGGATTACCAGCATGAGCCACCACGCCAGGCCCAGAGGTTTATTTTACATTTATCACATGTCTTGTCTCTCTAATTACACTTCACTAACCCTGCATTGCTGTGGTTTTCTTCTTCAACTCTGAACCTGGTTTTCCACCATTGGTAAGACTGTATATTCCCTCTTTGACCACTAGGGTTCATTCCTTGTTCTGTTTGGCTAATACTTTTTTCCATTTCCCCTTACACTTGCTACTTTGGGTTAGGCTTTAAGTCAACTCAATGATGAACTATGCAAAACTGTTCAAGCCACAAAAGAGAAGACCTGCCCATCACTCTAGGCCCACAGATGACCTATGGAGCAATCCATTTGGAGAAACGTGTGTCTCTGCTATCTGCAAAGCAGCTCCAGAGTGACCCTTAGCTGGGACACCCTAATTTATTTTCTCTTCTTTTTCAG
>TTN-204,,0,2210,3415813,3418022,GTAAGCTCACACATTCACACTTTTGTTTTTTTTTCCTTTGCCTCCTCTCCAGTAAGTTAACGTTGCTGCAGGACTTGACGCCAAGTTTAAGCCCTGCTTTCACTTCGGAAAATTAGTCCAACACTATGGAAAGGTCATTTTAAGGGTATACCATTCACAGAGTACTGACAAAATCTGACAATATAATGGCTTGAAATGTTTTATTCATATTTATTATTCCACAAAGCAAAAATAATTAGTGTTGGATTAAAATTGCCGTTAGAATCCAGCAACTAAATAGGACCAAATTTAGTCATTCTATATTTGGGCTCAGCTGCAGAGCCAGACTGGAAGCCAAGAACTCAAGCCCAATAGAAGCCAGCCACAGAGCCATGGGGTAGGCAGTCTGGGCTGCCTGCTCTGGACACCTGAACTTCAGTTGGTTCACACGCAAAATAACAGTGCATCTAATTTTCCTCAGAGGCAGAGCTGTTCAGTAATTAACCAACTCCTCATTATTTTATTATTTTATTTTCAATCTTTATTGAGTGATTCTAATGAATTAAAAGACTTTCCAATCGTTTTGAAATGACAGAAAATAATATGCTTCTCGGGTGTCTCTATTTAAAAGGAAGCAAACACTAACCCTAGAATTTTATCTGAAAGGAAGTTCATCTCTTTTTTGCCTTCTTTTTCTTCCTCATAACTCAGTTTATGGATGGTTCAAAAAAATGCATGGTATCATCTTATGAAAAAATGGAGAGTAGTGTATGAACTATATTGTAAATAATTTTAAAATTAATCAATATTTTCTCTTTCTGTAGTATTGTAACGAGCCATGTAAGATGGATACGGATTAAAAAAAATCATGCTTAATTCTTAATTTAGTGCACTTCCATGGTTCATTGCCCACTTCTTTTTTAAAATTTTATGGCTTATAATAAAGATATAAAATAAAATTTCTTTTTTTCTCTTTTTTTCTATTATATGCACCAATCTTATTCATAACTGGATAATACTTTCTTTTACATTGTACAAATATCATATAATCATTGCTTATTTTCTATTGTACATATATAGACCAATGAAATTCCCTTTTCATTGGTCTATATATGTACAATAGAAAATAAGTCTTACCGACTTCCAAATAATTTACCTATTTATCTGGTAACACTCAGTAACTTCTGAACTGAGCAGAACACATATGACTTCAGTGGGAATTTGCCTCCTTGAGAAGTAGTGGAATCTGGCTACTTCATATCTTCTTGTTCCTTCAAACTATATGCAAATAAATTATTACAAAGACACTACTGAAAATATCCAATACCCATAAATCAGTCCAATAAACTATTTAATTGGCCATAGTGGGAGATGGGCTAATGTATAAACAACAAAATAGACTTTCTCTAGATTATCTTTACCTACCAGCGTAAGTAGATAGAGCATCAACCTTTATGCCAAGTGTGAAATAAATCATGCCCTGAATGTGCCTCGTACATTCTCAATGTACAGAGTTTTAATATATTTAAAACATCAAACCATGGACATGTAGTTCTTGGCTCTACAATTTATGGCAGATAAAGAGAATTTGGCTTTCTACCTGCAATTCCAATGATCCATGTTGTTCTGGAAGACTAGGTTTGGATTAGTCTCTTATGAGAAATTGCTTGTCCATGTTACAATGTTTTTACTGATTGCACTTGTGAAAGCAGAAGAGTCCAAGAAGACAGTGTCCCTGTAACCACAGAGGAGGGAGGAGGGCATGCCTCCTGGGCTTGTCAGGCAGAAACTGGAGATCAGTTTGCTGCTTTTGTTCTTCACTTGCTCTCAAAGAGGACAACAATCACTCTTTATTTCAAATTTTCCTTGGTTCTTCATTTTTATAAGTCCCTTTCATGATTTTAATGTTGTCTATTAAATTGCATCAGATAGAGCCCTAGGCAGGCAGGCAGGAGATGGAAATTCTAGTCCCCTCTGTGTCACTGCTAGCTGAAGGACCTTGGAAAAATCATTAGGCCTCTTTTGGTCTCAGTTTCCTCCCTTCCTGCCTTCCTAATGGTCTGCAGGTTTACACACTGATCATGCAACTGTAGGGTTTTCCCTATCATTAAGTGGCATTCCATGCTGGAAAGCTTTTACAGATTCGGACAAGGCAGTGAACATGATGGGACAGAGCAGAGGACTTTGTGGTGCCCATTCAAACATAAAGGTGAATTGTTCTTGCTCTTCAG
>TTN-204,,0,1455,3418023,3419477,GTAGGCTGCTGGGGACCTGCCAATCCTCTGCTCCCCCAGAGGACATCTCCAGCAAATTGGGAAAGGAGTCCAGAAAAAGCTATGGGCAGAGGTAGATGCAGCTCTTAAACTACAGAAGGGTCTACTGGAGGCTGAATTATTTATAACCAAGTTGTTTGCCTTTTGGAATTTAATTTTCCTCTAGAGTACATCGTAAAAGTGACTGAGAATCAGTTTCTCAATACACATATTAAACACTCAAAAGTATGTTAAGGAAATATTAAAAATCATGTTTCTCAGCAAGTAGAAAAGCTTGGAGCCTTGTTTATAAGTCCTTTAAGGAATAAGACATATTCTCCAGGGAAGTGTGAATCTCCAGGAATTCACACTTTAACAAGCATCCAGATAATTCTGATGCCGGTAGTCTACAGACCACCCATTTAAGAGGCATGTAAACATACCCAGAAGAAAATAAATGCTTGTTTATTATTCAAATGCATGACACTGTTTCCCCAGAAAACTTATCACCAATCTTAGTGGCCTCTGTTGTTTTTCTCTATCCTTTACTACCTAGTGAGACATTAGTATACAGAATATTGCATGCCTTTACATGTTTTATAACAATATCTTACATGAGCTACGTAAAGTTACATATGCTTATCCAATAAACTTTACCTTCAATGATGTTCAATTATAGGGCTATAATTGACCTAAGCAGAAACCACATCAAGTAACATCAGGTAGAACTTTAGCATGCACCCAGAAAATTCACAAATGGAAAATGCACAGGGTTGGCAGCACCTGCTGTTGTTTATTACTCAAAATCATGTCAAAGTTAATTCCACTCACTCCTCACACTTATAAAAAATTTCCTTCAACATAACCAAAAAAATCCCCTTTCTGTAACACAATTAAAATGAAGTAATGTTATTATTGGGATTAACGTTTTAAATGCAAGTAAATATTTGGGTTATTTGAATACCTATCAAGTTGGAGAAGGTTTAGAATTTTAAAAATTAAATTAAAAATGTAATGATTCTTTAAGTAACAGGTACACCCATCGTAGCAACCACTGGAATTCATTTTAATGCAACTTACTGGAATATGCAACATGGCTTTCACATATTAATAGAGCGCTAGATGTGAGGTAGAGGGGGAAGTACCAGAAAGATTCTCAAGAAATGTTATAACAAAATCTAGAGCTTTTATTTAAAACAAAGAAACAAAAGGTGGTGGCCTAAACTGCTCAGCAAAACAAAGCAAATAAAATAAAATATGGTGGTGAGAAAGCCTTCTGTAATCTCCTGGCTCCCATTCTTGCTGTCATTGCTGGGTGAGCTGGGTTCAAGGACATTCAAGGATGTTTAGATTGGCGAGTCATCACCTGGTTTTGGAATTGGAGCTGTGATTATTTAAAAATACCTTGTAGGGAGCACCCTGGCTCTCACTCTTGACTTTGTTCTCTTGTCCCCGCAG
>TTN-204,,0,484,3419478,3419961,GTACGTGCTGGAGGTTGAGGAACAGAGAGAAGGGGAGAGAGCTGGTTTGTGTCTAAATGGGGCCAAGCGTCCACTTGCCACCTCTCACAGCCCTGGGAAGAATGCTGTGAGCTGATATAAAAGCTGGCTTTTCGACACCCATGAAAAGTCCCTGAGATTCTAGTCAGGAGCGCAGAATAGAAGCAATCTGTGCTTATGAATCTCATTATAAACTGGAAAGGGTTTCAATTAAGTGATCTACATTTCCAAATTATTGGCAAATAATGAAATTTTAAAAAATCATTCTAAGTAAATTTTTATCTTGTAATGAACATTTTCTATTTTTAAACCTAATTTATATTCATGCAAAATCCAAAACTTTCTGCAATTTTCTCCATTGGGATATCCAGAAAATCTTTTTGACTTTGTAGTCAGAATTAACAGAATCTCTTTTAAAATGGGTCATTGTGCCCCCTCCCAAACATTCATCTTTCCCTTCCCACAG
>TTN-204,,0,93,3419962,3420054,GTATTTTTCTATACTGTTGGTTTTCAAGCCTTTCAGGCTGTTGCGTCCCCAGCTATTCCTCCTCAACGTGGGCTTTGTTTTAATCTTTTACAG
>TTN-204,,0,4234,3420055,3424288,GTAAAGCTGCCATAGAGAGAGCAGATTATTGCACATTTTGGAACTAGGTTTTGAAACGAGAAAGATTCCCTTGTCCCCCTCGCAGGGCATGCGACGCGGAGAGTGGTTCGCTTCTTCAGTGTCCCGCTGCTCAAACCTCTAGGGGAGCATACAAACGGGCAGGTTGTGGGGCTCCGTGTTCCTCTGGACATCCAGCCGCTTGTGTGTCTGCCTACTAGGGTCTCAGGGGTTTTTATAGGCATAGGGTGTGGGCGTGGCAGGTCAGGGTGATCTTGGGAAATGCAACATTTGGGCGGGAAGGCAGGAGTGTTTGTCCTCACCTAGGTCCATGGGCACAGGCCTCGCTAGGGACCACGCACTTCTCTTCCCAGCACTTCCCTGCCCTCCTCCCGTGTAAGTTTCATGCACTCAAAAATGTAGCAGGTGACAAAGGAGGTAAACCAAGAAGTTACTGAATATGATTTTCACAAATCCTCACTGTCCACAGGTAAATTGAAGACCCTTATAAACTTCTGAATTCTTATTTATATTTCATGTAATAAATATCTACTTTAGGGGCCAAAATATGGCACAGTGAAAGGAGAAGAGCACAGAAGTTAGAGTTCAAAGCCCTAAGGACAAATCAGCCTGATCACTTAACAGTTTGATTTAGGGCAATAAGTATAAATAATAAAATAATTGTTATTATATATGGATCACTTCCTCTATCAGATTGGAACTATACATACATTATCTCATTAAATGTTCACAACCTGTAAGAATTATTATCCTCAATGTTATTGATAGGTAACTGGAATTAAAGAAGTTAAGCAGTTTATTTAAGGTTTCAGTTGTGTCATCTGTAAATTAAAGAGAGTCACAATAAGAATGATCTCAAGCTGCATTTTGGGGCTTCAATGAGATAATTAGTTGAAAGTGCCTTGTAAATAGAAAATAATTATGCCAATATTCTTATATTCAGATGGTAAGTAAAACCTTTTAAATATTTTGCATATGCTTGTGTTATTTTATCTAGAAAATAAAATGGACTTCTATGCTTACTTAATATGGAAGTATTTTAGAAGGTGATCATGTATCATGATCAGGGCTCAGAAATTATATAATCAAGTGTAAATTGTCCACAACAGTTTTGAAAGTTTGGGATTTAGTTTATCATGATGAAACTTTTAATATGATGAAATGAAAAATGTACAAAATTTGAGCAAAGAAGTGTTTATTGATCAATTTAAATGAAATAAAAAACACATGGATGTTCCCTGCCAAGAAAATTTTTTATAAAAGAATAATAAGGAGATAGTTGACCTAAATAATATTCAAACATACTGTAAAGTTACTATAATCAGAACAGTATGGTATTGGTAAATGAATAGAAAAATACACCAGGGGAACAAAACAGAGAGTCCAGAAAGAGATCCAAGTATAATAGATCCAAGTATATAGGGAATTCAAAAAGCAAAGTGGCCTTTCAATTCAGGGGAGGGAGAGGTATTTTAATAAAGAATGCTGGTCCAATTAGCTATCCATCTGGAAGCAAACAAACATAAACCTCTGCCTCTCACTATTTACAGAATAAATTTCAGCTTGATTAAATAGTTAAAAAATGAAAAAAAAAGAGAAGACAATCTGCAAAAGCATTTATGGGTGAAAGCTTTTAAAAAGACAGTTACAGATTCAACTACATAAAAATCAACATGTATGTATGGCAAAAGCAAAAAGTCATTTCTAAACCAAACAGCACTTGTGAAAAAATTTTAAGACCTTTCTCCTCCTCAAGGTACTTCATTGCCTCTGCCATAAAAGTATCACAATAAACATAAAATGGCTACAAGGTAGACAACACCAGCCTAGAAACAGTATATAACATACAAAATTACGTAAGCTTATGCTGGATAAGACCCATAAACAAGCAAAATATTGAAATGGATTAAAAGAAATGGATCTGGGGGAATGTTTGCAACACTTACGACAAATAACCAATAAATGCACTAAATGCATTAAAAATCATCCACAAATTAATTTTTAAAGGAAAAAAATGCAACACAAAAAAAGACAAAAGATACAAAAAAGTATTTAACATAAGAGGCAATGTAAAAGTCCAATAAACATGTGAAAAAAAATGCTAGATGTTTTCCAATTTTTATTGTTTTAGCCACAAAAATGTAAAGATATTGGCAAACACTAACATGAAACCTTGAACAAAAAGCTTACTTTAAAAAACATGTCTAGCAGTCGAATAAAAAAAAATGTTCAGTCTCAGGCTAAATCCAAGTTTGCACACCATGAAATCACAACACAAGCCAAATGCAATTTCTTGAGGAGATAACAACCTAACTATATTTTAAAACCCAAGCCTAAGGGTCATTTAGAATCATGGAGTGTCCCTGATCCCATGGAGCATTTTGACCATCTTAGCAGTTTTGAAAGTTCATTAATAACCATCCAAATTGCCCCAAAATTTTGCTTTCCAATAATTAAGAAATAAAATGCCAATTTGCAGAGAAAATAATGGTTATCAAAGATAGACTGCTTCCTAAATATCTCATAGTTTAATCTTGATTTTTGTTGTAGAGTAAGGCAAACATATTTCATTGAATAAGGTGCATTGTATCTCGCTGTGACCAGGTGATTATTTTTTGTTGTAAGTACAGAAATAAGCACTCTCCTATAATGACCAAAATTACAATGATTTTCACAGTTATGGGCTTACCTGTGTCCTGCTGTTAATCAGTCATGTCATGCTAATCATGTCTTTAACTCTTTTTGAATTAAACCCATTTACTAAGTACAGCAAGAACAAGGCACAGGGTGAAACTTAAAAGCACATGTCTCTTTGCTTTTCTTCAGTTAGTGGAAACCACACATTATTCTAACTTGGTTTTTGTTATATTTCAAAGGCAGTCATGTTCAGAAAAGAGGCTTATTCCCTAGATTTCCCTTTAGTTTGATTACAACTTCATTTACAAAATGTAAATGGATTTTCACACAAAAAAAGCCATTCTTCGAGAAAATAAACATTTCTTCGTGAAACTGGTTAATGTTGTAATGTACTGTTAGGGTACTCTGTAAGTTAGAGAAAATATCAACTGTACCTTGAGCTTAATTAGAATAATCATTTCATGTATGATCAGTGTAAGCTAAATATCCTAGATAGTGACAAGATGCATTTATAAACATTTTCTTATATGCAGAATTAATAAAATGCAATGATAGGGCAATACTGCCACCTAGAGAGGAAAATGTAATAAGCCTTATTAAGAATTAAATCAGTTCTGAAAAAAATTTTACCTTACAATAGTTGGCCAATCCCCAGAATTATTGCTATAGATCAGAAATAGTCTTTTTTGGCCATCAGTGCTGGGATTTAGCACCCAAATTCTTCAACTGATGCTACTTGCACTTTGGATACACCTAAAAAGCAAACAATGAAAACTATTCTGGAAGAAGCAACTTTATCAATTTACCCAAAAATCACAGAATCATTAGTTTTTAAGTTAGTCAATTCCCACAATAACTCTAAAGATATTTAAAATAAGTCCAGAGTGCAATACAAGGGGGGCGAGTGTAAACAAATATGGAGGAAATTAAAAGTAGCTGTCCACAAACACTTCGGCTAAAGCAGCAATTTGCAAAGTGCACTGCACAACCTGTACCCAGCAACATGCTGCAGAAAGCTTCCTGAGGATGTGTCCCCCTGTCCTGGAAATTCACAAGGCATACTGACATAGTAAAGGCTGTGGGAAGTCCTGCAGGGGAAAAAAAAAAATGGCTTAAGCTGCTTAGTCAAGAGTGGCACAAGCATTTTGATTACAGAAACCTTTCTTCTTATAACACCTATTTGACATCCTCTAACCCCCCCAGAATTGGAATACAGAGATGAATTTGGAATACAGAGGTTGCTGGATTTGACATGTCTTTCCTTTGGCTGCATATTAAAGAAGTAGCTTTTTCTGTTGTGATTTTTTTTTTTTTTTAATGTGAGAAGGTGCAAGGCACAAAATCTCCAGCTTATTTGGAATTAAAGCTGATTCTCTTACAGGGTTACAGCAGATAAGAATAGGTTTATTGAGATTTAAAACAAATTACTTCCAAGTACATTATTTACCCTCTGAATGGGTTATGGAGGCACACATTTTAAAACTCTGCCTTAAAGCACTTCCAGCTTTTCATCTCATGATTCACATCCAGTTACCCCTCCTTGCTTTGACATTCTTGACCTCTGCCTTTTGGTTTTCAG
>TTN-204,,0,370,3424289,3424658,GTACTGTCAGAATGGTTTTGTTTTTCCTTATTTCACATTCTAGTTTCTCCAACTGGATTTCTGCCATGAAACTCAGTCTGTATAAATTGGAGGAAAAATGCATATGAACATAAAAATATAGCAGCAACTGAAGACCAAATTCAGTAGTCATGCTTTGTAAAACCATTTTTAATTAGGACAAAAGCTCCAATCTGTGAAGTTTCCATAATATACAGGTTTTAATGATACAGTCTCTGTATTTCTTGGCAATAATAAATGCTTATGTATGAGTGTATTTTGCTCTAGGTGGCTCAGTTTTCCAGTATGCTTTTTTATTTTCTACTGGGCATGTCATTTAAAAAAGTAATCTACTTGGTCATTTCTAATCTAG
>TTN-204,,0,857,3424659,3425515,GTACGTGCGAGGCTGCCATGGGGCACCCGCAGAGCCACGTCCTTCAGTGCACATTAACTCAACCACCATCCACTGAGCTTGGCATGCAGCTGTGCTCAATTCATTCTGAAGACAGCCTTGAGCCCAGCAGGGCCCAGACTTTTAGAACTTTCTGAGCAAAAGGTGGTCGGAGATGTCAAAGGTGTTGACAATGTGAGTATCACAAGAGCAGAGTAGGCCAGAAATACCTGGGCTATATGAGCAGGCAAAAGTCAACTATGGTATTCAAGGTAGGAAGGCAAAGAGTGGCCAGAGAAACAGAGACCAGTCAATTCCAGAGCTCAGTCACTGCACACACTGGATGTGGAAACTACTATTTCAGGGAAGGCATTACATTTCTCTAAGTTTCCCCAAAGGACTTTTGTTTTTACTTTTCTCAAAACAAACATGACACTTGATTCATAGCTGGAACAGTGTCATAAATCCAGGATAATGTCCCACCTCGCATTTGAATAGATTTTCTGTTACAGTTTAAAATCATTCCAGCTTTCCTCCTTATCCTCTTGTGTGACATTTATGTCTAAATCCTGACAGATTATTGTAACTTTTTTTTCTTTTCTGAGACAGAGTCTCGCTCTGTCACCCAGGCTAGAGTGCAGTGGCATGACCTCCGCTCACTGCAGCCTCCGCCTCCTGGGTTTAAGTGATTCTTGTGCCTCAGTCTCGTGAGTAGCTGGGATTACAGGTGTGCGCCACCACACCCAGCTAATTTTTGTATTTTTTAGTAGAGGATTTCACCATGTTGGCGAGGCTGGTCTTGAACTAATTTTTATGTAAGATGCATTAAGGTGTTTTCTTCCTTTCTCTATGAAAAGCAG
>TTN-204,,0,1206,3425516,3426721,GTGAAAATGGGTTTGTATTTTAAATTCACTGAGGTTCTTACAGGGGTCAACACAGATAATCACCTTTACCATGAAGAGTGTTGTTCCTTGGGCCACATGGTTGTTAGCATACTAATAAGATCCCCTTGTTGTATGTGTAAATTTCTGGGTACTGGATACCAAAGTTTGGTAGTGTCCCTGAATGCTCCCCTTGTGAGTATGAAAAAGAACTCTGTGAACATACACCAGGAGTAGAAACAGGGGTCTCATCACATTGATCTGGGGATGCACTAAGTATAAGACTATAGGGAGAGGACAGATGGCTAAAACCAGGAGGAAGAAATAGATGCTGAGGCAGGAATGGGGAAAAGTGGAGGAGACACTGAACTCACTTTGCTTTAGAAATCTTAGCAACTGCTTCCTGGCTCCTTCGGAAGACATTTGCACATGAGTTTGAAGTGGAATGGACAGCATGGCTTTAACAAGCCAAATGACCAGAAAAGGTGAAAAGGACAGCCCCATGGTTGGCGGCATTTGGGGACAGATTGGAAAATGCCAGTTAGTAGAGCTCTTGGCCAGTGGAACCAGTTGGCAGTTGGGTGGTTTGAGAAGATGAATTTCAAGTCCCTTTCAGCCTTGAGATCCTGTGTTTCAGTGATGAGATATTTGAGAATGGCAAAGAGGCAAATAGAGAAAACTGTCCCCCTACATACGCATATACCTTAGGTGCCCAGATGGAAACAGCATTCTTCACAGTATTTAGGAAAACTGACAAAACAAAAATATTGTATAAATGCAGATTATAAATTATCCATGCTTGATTTCTCACATGTAAAATAAAAAGATCAGACAAAATTACTTCTAAAGTCTTCCATTCTGATATATATTCTAAGATTACCTTTAGATGACAGAATTAGTACAGAATAATATTGCCATAGATCTATTTGTAAACATTGGAAGTCATTTTAAAGAAGACTACAATTCTGCTGTTCAAAACAAAGTGTTGAATTCAACTTTGTTTTCTCTAAGCAGCCTACATAATTTACAGTTTAAGGAGAGAAAGAGCATGATCTTATTTATGAACATGGGATTATTTATTTTATTTAGTGACATCTGCAGAAAAGGGATTTTACATCTTCAAATTCCTATGTTGTTATATTTAATAAACACCATATTATTTCATTGGGCATCAGGAAATAAAGTTTTTTCTTAAATCATTCTTTGCAG
>TTN-204,,0,1226,3426722,3427947,GTAAGTCTGATTTTCTAAATATTTTGTAGTTTGTTGACAATATCACATTACAGCCAGCTGCAGGTAGCTTATAGTCAAAACCCTTAAATGGAGAAGTCTTTGGTTGTATATTTTTTGTTATTGTTCCTCTATGTCTAGTATTGAAACTCAGGATGGAAATTATGTTCACATTGCACTATTTTCCACTCACTTGATCAGTTTTCAGGAGATTGTCTACAGAACAGTTTAGGGCACATCTATGAACTTTCTAGAACATACATAAATGGATGATAGATATCATGCCAGTCCAGTTACCCACCGGGACAGTTGGTTTCTTCGTGCATAGCCTAAGCCCTCAGTCACTTAGATTGTAATGCACAAACTTTACATGCACACACACATGCACACACACACACACACACACACACATATACACATACATCAGCCATAAACACCCCGAATAAATAGCAAGGGAAAGTGAGGATATGCCAGACATCGGAGAAAGCAAATACTTCCTCAAAAAAAAAAATTCCTTCAATTCACGGTTGATAAACAGTGACCTAGAAGCATTTGCTGCTGTTGTGCCGTAGAGCTGTGTGAGGACAATCTCAGTGTCACTAAAATCCACATCTCTCCCGTATGTGAAATCAAACCTTTAAGTGTCAGGAGAGAGGCATTTATCTTGAATTCTTCCATGTCAAAGAGGGCGCCTGTGCTCATCCTCCTTGAACTCAAGCTCTTTGCTGATCTTAGAGCTACTTTCTTTAAAGGTCCAGTTGAGAACCTTGTACACTTAAAAGGCTGACCAGAGGCTGCTGACTGAATTTCCCTCTCCTTACTGTGAGTGAGACATTTTGAAAGCAGCAAGAACCCTACTTAGGATAATCAAAGGCATAGAAATCCCCATTGCCATTGCAATGCTGGTGACTGGCAAGTTCAGCTGGCCTATGGTTTTCCAGCCACTTGTCAGCAGCCACCCACCGGGTTCCCTAACACGTTGACATGTCTCAAGATGAGATATGTTCAGTTCTAGGACAATTTGCTAAGGCGCATGTGGGCAGAAAAGAAGCCCATTCCTCAGGAAAGCAGTCTATGTATTAAGCACAAGTGTAGGCCCCTGAAATGGAAATCTGACATTTTATCGTTCACCACTAAGCATCCTGTATTTTCCTGAGTGTTTCAAGGATGTCTTCCCATTGCTTTTGTATCTTTTGAAACTCAAATCTTTATTTTACTCTAAACATCAG
>TTN-204,,0,592,3427948,3428539,GTGATGACTTCCTGCCAATGTGAAAGTCACTCTTGCACCATTTCATTTGCAAATCACCTACATTTTCATCATGGATCTTAATCATCACTTCTTCACTTCCACCTCTTCTTATAATGCAAATAGAAAATTTCTTTTCCCACACAGCTACCTTTCACTGTCAATTCATTCCTAACTTTCAGACTTTCTTTGGCTTGTTACTAATATAATATAATAATTCACTTTAATATCTTCCTATTGAAGCAGATGTCCGTAAACAAGTCAATTCATAATACAAAAAATTATGTGCTATTTACAGTGCTACTGAAATGTCTCAGAGATTGCAGTTTTAAAAAATGTGAAAAGTACAAAATAGCACTCATTAGTCTTTTATTGCTAATCACATTTTTTTCTTTTAAACTGGACTTATTGTTTTGATATTTTTGCCAGTGAAACAGTATGGATGATCAAAGTAACTCAAATGATATATTTTAGTGCAATTAAAATTTCCTTGAATAGGAAGAAATTTTGCCTCCTTTCTTTTTGACTTACGTTTCTTTTATTAAAGATTTATGGAATTTAATGACTATTTTCTTACTTTCTTTTGTATGATCAG
>TTN-204,,0,480,3428540,3429019,GTGAATACAGATATTTGAGCTGTGAAAAGTTCATCTTTAAACTAATTTCTAGTAAACTATTAACTACAATATGGTATGAATTATTAATCTGTATTTGCCTTTTAAAATCCCTAACTAAAAACAAAATGGTAAATATGAGACTGATTATCATTAATTTTATCTGCACATTTGATTTTCATCCATCTGTAACATTTATAATTCATTTTATTCACCATTATTCTTTGCATGAAGATTAGCATTTTTTAGCTTAATTTTTAAAAAGTGACACAGGGACTCATCTAGAGGTTTTTTAATAGCTAACATTTCTAAGTTTTGTGATTCTCAGTCAGTATATGTAGACATTGCCGGTGAAAGTTTATTTCTCTTGTGTATTTAACCCTGAATAACCATCTTGCATCCCCATGAGGAAGGGGGAAGGGTCATACTATGTGTGTTTGAAGCCCTGTTCAACTTAAATCTTGATTTTACTGTAATAATCAG
>TTN-204,,0,3218,3429020,3432237,GTGACTATTGTTGTTCCAAGTGTGAAATCCCCTATTATAATACATTAATACCACATATCATGTGAAATTCCTTATTGTAATACATTAATATCAAGTCTCTGAATTTCTTATGTATGAGTCACTATTAACCAAATTTATTTTTTAGACAATTAAATAATTGGAAACTAAAAAAATTTATTATTGTTAATATTACTACATATCCCTTTCTCCACTTATCTCTTCACCATTATTGTCAACATTTTATTAACATCTGGGAATCTTCCAGAAGTTGATTAAAATTGCATGCAGGCTAATTTTAAGAGGCCCATGAACATTTTTTAAAAACACGGAAGATGTATAAGTAAATGATGACTCTTACTCACTGTCAAGAAGATGTGTGTTTTGAAGGGTCATAAATTCAGTATATTATGTTATGGAGTATGACTTATTTCAGTAAATTACCCATAATTTTCTTTGTATGAAACTTTATCTTTTTTCCCTCCTGTAAATATCAGAGGAGAAGATAAGCTGAAAAAATTATAATGCATGCTGTAGCAGCTCCCACTAAAGCTAAACAAGATGCATATTAAAATCTAGAGAAGGAAGTATCCAAACAGAACAATTACACATAAGCCATGAAAAGATTACCGTATCTATTTGTAGCTATGAAATATCCATGAATTAAACTGTTTCCCATGACTCTGTCATTTACTCCAAATGAGCCATTTACCTAATTGTATTCTTTATTGCTAATATACCACTTGAAAATTAGCAACTAAAGTTTTTCCATTTCATTAGCAGGATGGCCTGAATCCTATTTGTATTTCCCTCAGTGTCATTTTCTGACTCTACATCTTTTTTTTCTAAGATATGATTTAAGATAAACTTTTTAAACCTTTACTCAAATCTAACATTTAATGGCATATCAGCCTTTCAGAAGTCTCATAAATGACAGAAATTCCACTATGCAACATACTTCATGAGTGATTAACTTTTTACTTTTGTTTCCATTCAAATTTTGTCATGAATTGACTATCTTGTTTTTGTTAAAAATTAGCTAAGGATGGAAGCTGAGAAAATGTTTATACCTGAAGTAGTAGTTACCACTGCAAAATCTGCTGAACCAGCCACACCGCCAATGACTAGAGAAGGATTCACTATTAAACAAAAACAAATACATCTTTTTCGAGAAGAGATGAAAACTGATGCTATGGAGGTGAAAAGTATTGTTTCATCCCATTTCATCATCAACTCTCATAACTTTTCATCCGTCGTGAATTGTGCTTCTAGTGTTCCATCTAATTGTTTAACTGATCAATAAAACAATAGAGATGGTTAGATTCAGTCCATCCTCCAGTTGAACAGTGAGCATTTCTAGTAGTGAAAAGTCAGACCAAATAATACTCTTCTTTATGTCTCCTAAATTTATTCTCAGCATTTAACTCGTATGAATTGGAGTATTCTAGTCCAATTTGTCTTCCTGCTTCTCTAGGTTACAAACATGTGAGAGATATCAAAGTCCACTAAGAAATAAAAGCGGTTACCAGCATACTCATTTGTAGTCCACCAATAAGTGTGTGTATATAAATCTGATATACAATAATTCAAGGAAAAAACAGACAGATGCTTCCTCAATTTAAAATATTTTACCATGATTAAGATTTTTCCATATGTTTAAAATCAAGAACAAAATTTAAATATTTCAGTTGTGTGATATTTAGTCATATGACAGTTTCTTTGACAGTTTCTTTTATCATTGTTAAAATAAAATTAAGACTTAAGCTGACTACTTCATAGCAGACTGGCTAAAAGGTTCAAATGAGATATAGTGGAAATGTGATCACACTACAATCAAAATAATATTTATTTATTTAGTGTTATCTGTCGAAGATGTTAACATTTTAAAATGTCTATACAATTAAAGTCAGCTCATTGCCAATATAGTTTTTAAAAAAGAAAAAAATAAATGGACAAACTTAACTCACCTAAGCCTCATGTGTATTTTATGTTTTTTTCTGAGATGATGCAATCTAAAGTGAAGATGGTATTTGCAGTCCTTCGAGGCAGATGAAATTGTTTGTGTCTTCCTAAAAGGAAGCCCTGGATAAAGCCCATGATCACTAAAGACCCAATTCCATCTCAGAAAAATCTCATTTATATCTTGAATGGTTCAGAGAATAATTTTTAAAGATATGCAGGTAGCATAGTTGAAGAATGTTTCTGATGCATTCTAGATTCTATTCACAGGTATAGAAAACTGAATATTAATAAAATTTTCCAATCTTACTTTTAAAATGCACTTTTAAAATGTACTTTTAAAATGAACATGGCTATGTGATTTTTGAGGTATGCTGTTTCCAAGTATCACATAGAATCATAATATCTAAGCCACATCAGCTAGTTTGCCTTCTTTAAAAGAGAACCTCCTCTGCAAATTGTATTTCCATTAATGTTCATCAGACTCAGAAACGAGAAAATAATATTTGTTTCATTCTTTGCTTTAACTCTCCATAATAATGAAAGTAAATTAAACTTCAATGTGAAAGGTTGTTCTCTTGAATCCAAACATGATAACACTTTCATTTTAATCACAATATTTTTATTTGCACGGGGTTCTCTTTGTCATCTGTGTGTTTTAAGAAAGGTATTTTCTGATAGATTAAACAATCTTACCCTTAGGGAATCATAAGTAAATTCATATGCTCACTCTGTGTTTGTGAGCTTTCATGTTATGTCCGATTTGCATGCAACCATATAACTCTGTAGTCACTGATTTTTCTGGACAGGATGATGACGGTATTTGAGTGCACTTATATCATCACTGTCACTGCATTAATACCAGACTAAATGGTCAACAAGATAATAAAAATAATCAGTGAAAAGAACCAGCTCCAAAATTCTGATTTTCCAATTGCTGATTGATTGTCTGCCTGGAAAAATTCTAGAAAATTTCAAAATCTTCTTGTGATTTTATGTTCATATTGTGATTGTCCTATGTTGTGTATATGTGATTTAATGTCTAGTATAATTAAGTAGGTGTACAGAGAGTATATCTAAATAGATGTCTGTACAATATAATAATCAATGAAATAGTCCCTAAAAGTGTTTCTGAGATACATTTCTAGACACGTTAACACTGCTGTATAATGTGGACGCCATCTGCCTGTCCTGATGCCCAGGAGATATTCCAGCCTGATCTCGATATTCCTATGTATTAATTCTGGAAACCTTGTCTCCAG
>TTN-204,,0,105,3432238,3432342,GTGAGTCTATACCTGCTGATTTTTCACCTTGTTCATGGTAAAGCAAGCCTCACTGCTGTGGTCATCTGGTGATCAATGGTATCACTGAGTTTCATTTCAATGCAG
>TTN-204,,0,1268,3432343,3433610,GTAAGAAGTTACAGAGCATGATACAGAAATGTTTAAAGGAAATAAGTATCTAACCTGTGAAACAGAGCATCTCTGGGGTAGGCCAATGGAGGATTCTTTTTTGGTGATGTGTGTGTGCGTGTGTTTGCATTCACAGTGGGCCCAGACACCCTAAAGATTTGGTTTCTGAAACTCGCCCAGGGGAGTGAGCCTAGAGTCACAAGTGGTTATCTTATACCTCTGAGGAGAGACAAATCCACACAGGCTTCTCTCTAGTTCACATTTCAGGGACAGCTCAAACTCAATTGTTTTGATTACTATTGTTCTAATGATTTTGTGAAAGGTAGTGTGTTACACAGCATAGTTTTACTTATGCTGTGAGACATTTCAGAGTAACTTAACTGTGAATGTGTTTCAATAATAAAGACAGACATTGAGAAATCATATATTTATATACTCAATATAGCAAGATGGAGAGGTGGTACTGTATGGTGGTCGGGTTGGATTGTGGAATCAAATAGCTCTGGATTAGTGCCCTATCTTCTCCCTTATAATCTCTGTCATCAGGAGAAAGTAAGCATACATGTAAAATGCAAGTAAAAAGGACATAAAAACCTGCAGTTGTCAGCATGTAATAAATCCTTGATATTAGTCACTATTGTTATTATACACATCCAAGAAATAGAACCCAAACCTTCTATGCCTTCAAAGAACTGTAAGTTACATATAATGCCTATATTTGATTTAGTCCCAAATTACAAAACAAATAACCATAGACCACAACAGAATAAAAGCAGTAAGGAAACCTTTAAAATATTTTTTCTGAATGTCTTCATGTTTACCTTTCACATAGATTTGTGGCTAAAACCCAAATGTACTATTGCAAAGTAGTTCTTAGGCATTTACCAACAATTTCAATAATTTCTTAATTTTGAATCTCCCACTGTGGTATTTTCAAAAGTGGCATTCATCGGAATGGTTAAGTGAAAATTCGTGACTAAGCTTTAGAAGATCCTGTCCTTTTATGATAAAAGCTGTAAAATAAGGAGTTCTGAATACAACTCTTTAAAAAAGATATTTTAAAATTTGTTTTACAAACTAACAGGCATGACAAGGAGCTTTATAATTGGCTTATCTCTAAATGACTTTTCATTAACTGTGTGATAATGAGTGCTAATGAGAACATTAAAGAACAGACCTTATAGAAAATAGGCTCAGACTCAGTCCAAGAGGGCTAGCCATCGGAGGATGGTTAAATGACTTTATTTTCTGACTCTGTTTCCATGTAG
>TTN-204,,0,284,3433611,3433894,GTTGGTCACTGGTTACCCGCTGTTACATGGTCCACTCCCATTGAGCAGGGCCAGGTGGTTGGCTAGTTTGTACTGAAAAGTAGCCAGTGGAGTCTTGCCTTTCTCCTTTGCCATACTAAGACTTGATTTTTATGGAGCATAGTATGGGTCAGAGATCATTTTCTCAAATTATTTTTATAATTATTTTTATATTTTTATAATTATATAATGTTGCATGAGCTAAGAGTTTATGAGATTTCCCTTAATTTCATGAGCATTTTGTAATATAATTTGTAAAAATCTAG
>TTN-204,,0,655,3433895,3434549,GTGAGTAAAGAAGTTGATAATGCTGGACCCTATTCATATCTCCTCAAATCATTTTAATACACGTTTGCAAAGATCAGTTTCTCAAATTAATACAAAAATGACATTAGTGAGCTTACAGATGCTCATTTTAAGACCGTATTTGGTCTGGAAGACCATATTTGACCATATTTGGCAAGGAAGAAGGGAATTCTATGTGGTACATCATTCATGGATTCAAAAGATTTAATGAGCTTCTAATATGCAGAAGGCATTATTGCAGGAGCTGTGCAGACATAAAGACCAATCCATCCCTCTTTGAAATATTTTCTTTGCCATCAGAGAAAATGTACACAAACAAGCATAATAAAATATATAAGGTGATAAACATCACAACAGAAGGAGAATCCATGGGAGGCATAGATTCATTCCAGTTGGTGATACCATGGCAAAGCTTTGTTGAATAGGTAGCATTTGCTATTGAGCCTTACAGCTCTTTACTAATATATTAGTATATTATATAAATATTAGTTTCTCTACTACTATTTCTGGAGTCCTGATTAAAAGGCCATTTTGTGGCAGTTGAAATGCATAAGTTCAAACTCTACATTTGTTACAAAACAGAAGTGATTAATGAATATGCACACGTATCATTATTTATTTTTTCTCCTCTCTTCAG
>TTN-204,,0,203,3434550,3434752,GTTAGTGGCCACCCTCCCACAGTCCTAATGCACATGCCATCACTTTCATCTGACACTCTTTTCCACAATATGGTTTCTGTGCACCTTGAAATGATGTCCCTTTTTGGAACTTGGGGGGAGATTATATGGTCAATTTAACTGTCAGTGCTAAGCAGGGGTCACTAAACATCTCATCTCAATGAGAAACTTTTGTCTTCTTTTAG
>TTN-204,,0,111,3434753,3434863,GTAAAATATTTTGCTAATTAGTAGCTGTTCTAGTACCATTTTGACTTTCAGCCCCACCAGTATTGGCAAATTGCAACCCGGAAGCTAATATGAGGGGAATTCTCTTTCCAG
>TTN-204,,0,948,3434864,3435811,GTATTTTGATGGCTGAATATAGAGTTCTCTGTGACTTGTATAATACGTGCATGAAGCCTAGAGTAGAATTTACTCACCCCACCGACCCTGAGCATAGGCTCTTTCATTGTGGAGCCTTCTTAGTTTGTTTTGAGGTATTTTTACATTTTTTTTGTGCAAAGTCTTCCTAAGAAATAAAGCTATGTGACAAAAGTGGATGGAAGATATATTTCTTTACATTATAGTTTAATTCATTGAGTTTGTGAAAGTAGAGAAAATATGGATTTTCACACAAACACACCCACACACACACACACACACACACACTTCCAGAAAAGATTTGAGACAATTTTCAATAAAAACATGTAATAACTAAGTGACTAAAAGATAGAAGAATAGCCATGTAATGAAGAAGAAAGCTAGTTATGCACAAAAATCTATGCTAGTAATTTTTCTTCAATTCAATATAAAATTTAGCTCTGAATATTTTGCAATTTAAGATAAAAAGAGCAACCTGGTAATCTAAAAATGTAGGTGCCGTACCTTCATAATAATAAATATAATGTACCAGAGAGTTAATACTGAAATATTTGAAGGAATTTATTGTTTTAATTATTCATTTGATCTCTGAATGAAATAATGAGAAAAATAACGAACAAAGAGAAAATACCTGTTGTTTAAGTGACCTGATCATTTGCTAACATAAACACTGAAAACCACTTAATTTCATGACTGATTCTAGCAATAAATATTCTTTAAAATGAATATTTTAACTTATTTGGCCCTAATTACTCATGTTCTTGCATTTTTCTCAATTTTCAGCAATCTTATAATCTATTGTGGAGCTTAGTCATATGTTTAGGGTCATTGAATTTTATACCACAGATCCACTCACAGATAAGTCCAATTATTTTACCCACAGAAGAGTTGTTGATAACTGATTTTTAAATTTTGTACATTTACATAAAG
>TTN-204,,0,915,3435812,3436726,GTAAGTGCAACTCCAGTTTCTATGTGCATGATAAGAACTGAAATACAAGGAGATAGCAGTGCTGTCCGTTTGCTGAAAAACCTGTTGCCACTTACTGGTTCTGATACTTTGCCCCAGTGTCTTTGCCTCAGTTGTATGGAAAATGTTTTAGACCACATGGCCTCAAAAACTATACTGTCATTAAACTTCTGAGGTTCTAGCAATAGTTTCTTTTTGTTGTATTTGTTTCTAGGCATATCATGCCTCTGAAAATGCAGAGATTCTAAATCCGGTTGCCTTCCAGGCCCAGGCAGGTAACAGTGAGCTCAATGAAAACAGTAGCAAACTGGAGAGTAGGTGCCCTGCCTCAAAGAGACAGTAGCTGTGTTGTTGCCAGGCATGCACCAGGCTGTTACCAGGCTCAGTGTTGCTAGAGCTCCTGATATCTTAAAGAAAACCTGGAAGTCAGGATTTTCAATGTTTATAACTTGAAAACAAATGTAACAGCTTTCATGCTAGACTGTTCACATTTACAGTGAACTGGCTCACACTCTGTTTCACTTGACCTACACAGTATCCCTTAGAGGAAATTACAATATTATCTTCATTTAGCAGATAAAGCACTCAATATTCAGGAAGGTAAATGAATTGTTAAAAGACACACAGCAAATTAGGAAGTCCTCCGTGGTAGATCCCCCCAAAACTGACTGCTAATATAAAATTCTTTCTACAATTGTAATGGCTGGTTGGATTTGTTAGTGTTAGTTTGGTTTCCAAATTCCATCTAGAAAATATTGAGCACTTCAATAGTAGATATTTGGAAAATTTGGTTTTTGGTTATCAACTTTCCCCAGTGTAGAGTTTACCTGAATGCATAGTGGTATGACTGTTTTCTAATAAGAGCATTAAAAATTAACTGATGTTCTTAACTCTTAG
>TTN-204,,0,537,3436727,3437263,GTGAGTATAAAAGTAATGACCAACCAAACAATTTCATAAATTATACTTTCCTTTTTTTATTTGATATTTTCATTTTCAAGTGATGAGCTCGGGGTTAGACAGCTATTAGAAGGTCCAAGTTCACTGTTGCTAAGTTTCCTTAATCTTCATGGTATGTTGCACCTGTGAGTTTAGAAATAGAGATTACATATAGGCCATAAATGTGACTTTAAAAATAGGGCTTATAATATATTAAGGAAAACACCAATATTAGCACAGCTGAGTTCATTCATGCCAAGATCTCTTCATCTGTGTGATAAGCTAATGTAACCTCTAACCCAAATCTAACTCCTGCTTTTGGAATACCTTTCTACCCAAGATGCCACAACATTCACTGGGAAAGATGACCATAATGCAGATTAAAACAAACAAACCAAAAAGTCCTCTAGATTCTTCTCCCAGCTAAAAACTTCAACAGTCTAGCTCAGATACATCTCCTTAAATAATTTATATCAGTAAGGATATGTATTTTTAACAGACCATAATCTTTTTGCATAG
>TTN-204,,0,110,3437264,3437373,GTAAAATATAAACATTTATCATAGCTCCTTGCCACAGTAAAGATACAAATTGGTTAAAATATAACTATTTGATGTAAATTTTATTCATACATGCATGGTATTCTTTGCAG
>TTN-204,,0,898,3437374,3438271,GTAAGACTTGTAATAATTTGGGTTATTTAGTATGTAAATTGTTTTCAAAACATCAAATAGTAGCAAATTGCTATTGTGTAAGAAGAAAATCGAGGGCTAAAATGGCACAGAAACTTACCATTGGCAACACCAACAATTGCCAGAAGTTTTTATTTCTTGCCCCTGTGTAAGATGAGCAAAGAATTTTCATCAGTGTAACATACTGTTTATTTTCCTAGTGCTATAGCTAATATCACAATAGCTCTTATTTGACACCTGATTTTTACATATGTAAATTTATACAACAGCCCTGCAATAAAAAGATGACTATTATTGGTTTGGAAATAGGAACACTGAGGCCCTGGGAATCTATGAAAATTGTCTTAATTCATCCAGCCTGTAAGCGGTGGTGCCAGCATTCAAACTCCAAGTCAGTCTGGCTGCAATGTGTAGATGGAGTCTTGTTTTGCTTTGTTTTGTTTCCAAATTCATTTCTATGTTTTCCTCCTCTGAGATAAAGAATGTGTATTTTTTATTTTTCCATAAATGTATTCATTGGTTTACTTATCCAACCAACATTTATTAGGATGTTTTAGTAGTTAAATCAAAAAAGTCTAGTGACTGATTAAATCCAAGTGGTAAGGAAAAGAGAGTATTGAGGATTATTCCAAGATTTTTGAGCCTGGGTACCTGGATATACTGAATGACTACCAGCTAAAATTGAGAATATAGGAAAAACATAGTTGTGGGGGCAACAATAATATATTCTATTTTAGATCTGAATGAGTTTGAGGTGCCTTCTAATACGTGCAAGAAGTAAATTCTAAAATAACATGAATAATGAATAAGACAAAATGAAGTTTGTTTTGCTGAGTTTTCTTTATGCCTCACGAAAGTATTGTGTGTCTTTGTTTTGCAG
>TTN-204,,0,119,3438272,3438390,GTAAGCGTGATAAGTTTTTGCTCATGAATCATAAAAACACAAAAACAAGCTTATGTATGCATCTAACAATTTTTAAAAACTATTTTAAAATCTACTTTCTTTTAAACATATTTTCACAG
>TTN-204,,0,102,3438391,3438492,GTAAAATGAGATAAAATAAAAATAAATGAATTTTCTTATCACTTGGGTTATAAACAGGTATTTCAGCCTTACTCCCTCTAAATCATGACCTTTCTCTTTCAG
>TTN-204,,0,99,3438493,3438591,GTAAGTATGGAAATAATAAAGCTAAGCTCATTATACAAATCCAATAACCAGGGAAGCTATACCACTATATTGATTATTCCCTCCCCCAACTTTTTATAG
>TTN-204,,0,153,3438592,3438744,GTAATTTGCATGTCTTTCCTTTGATGGACCTGTCTTTGTATTCAAGAATATCCATGAGTGTGTTTACTTTTATTTTCTTTCCCCATTCCTCAGGTTGAGAATTTAATTTAATATAATGTGCTCTCCCCTTTTTCCCCCACCTTTTTCTTGTAG
>TTN-204,,0,447,3438745,3439191,GTATTCAACAACGAAGGATTTCATTGTTTACCTAAGCTCTAAAGTCACCCTTAGCATGTGGTAAAATTAGCTATGCAATTTTTCTTTCATGAAACAATTATTTGGAAATTGACTATAAGTTTCATAGCCAGAATCATAAATTTATGTTCGTAATTAAGAATGTTAACAATTTGACCATTTGGATTTTTTAAAGTAGTATTATCTTGATTTTTAGCTTTTAAGTTTTTTATTGAAGCATAATTCTTTACTTTCAAAAATATTTAAAAATTAAAATAAAATAACTGCTTCTTATTGAAAATTTATCTCTCAGCCCATCAGCGGGTAGATATTAAGAATACACCTGATAGTATGGGGGAGATAAAAGACATACAAGACATCATCTCTATCCTAAGTCTAGATGCATACCTCTCCAAAAAAATTGATTTATCTTTCTGTTATACACTTCAG
>TTN-204,,0,96,3439192,3439287,GTAAGTCCTCCCATTCCTGTCAGCCTGCAGTGAGCATCATTATGGTTTATTGATAAAAAATGATCATAACATTCTTTTTCTCCCCATATTTCACAG
>TTN-204,,0,112,3439288,3439399,GTGAGTCCTAATTATAAAATTTTATGTTTACACTATTAAGCAACATAAAGAACTTCAAGGAGCAGACAATTTCAACAAAATTCATTCATCTTGTGTGTGTATGATTTTGCAG
>TTN-204,,0,92,3439400,3439491,GTAAGGATTATTCTACCTATCTAATAATTACTTTAAGCATTCTACTTTCCCAGTGTAACAATAACCAAGAGATTATTTTATTTTTTCCCCAG
>TTN-204,,0,1637,3439492,3441128,GTTGGTATATTTATTAACCTAAATTCTTACGAGGAGTGATTGTTATTTTAAGAAATTATTATTCATTTCCCCCAAAATTCCTTTCAGTTTCCCACTTCCATGCCTCTGCTTATGCTGTTCCCAAAGCCAATAGTACTTGCAACACCATTCCCACCAGCCTAAATTACAAATGTTCTTCTAGGCCTACCTCAAACGTCACCTTCTCCATTAAACCTTCCTTAATCTCTCCATTTGTATATGATCTCTTCCTCATCCAACCCCAGGATCACTTTATATGTGCCTCTTTCCTAGTGTTTATTATGCACTTGTCTTATTCCCCATTTCCTCTTTCAATATCAGTGTATAAACTCCTGAAATCTGGAATTCTATTTGTATATTCCAATATATTGCAAATGACAGATAATCAATTGGTGTTTGCTGTATTGAGCTTTATTTAAACTTCCTTACTCTAAAGAATTATTTCCTTTTTTAGCCATTCTTGCTTCTTTAGCCTTTGTGCCTTTTATTTTCTTCCTACTTTTTAATGAAATCAATAAATATTTTCAAAATACAGCTTAATGTAACTGTATTTCTTATGATATCATGTAGAAATAAGACCATCATTCAGTAGAATTTCTTAGCTTTACAATGAAGAATAAAAAATGTAAATCAATTGCCAGAAAAAACTAGAAGTCATCATTAATTTGTTTGGTTCATTACAGTTTAAATTTTGAGGAGTTGAGATGTTACATTCAGATCGTGTTGTCCATTACATCTAGTATTGAAGCAAGTCATATGGTAATGATTTGTCTTATTTGGTATGAAAGTTTCATGGTTTATACTTACTTACGTTATAAGATTTCTTCAGAGATCGGACCATGAAAAGACTTGTAAAACAAAATTTCAGATTCAGCATTTTTATACATTTAATATAAATTACATGTTTTAAATGTGTGGAAACAGGAATAAACTATGAACTCCTCTGTGATTTCACCCAGTGTTTTTAAAGTACCTACCATTGGTCAGACACTTGTAGAAACTCAGGACACAAAACTAAATAAGAAATGATTTTTTTCTTGAGAAATTCATAATTTAGAGAGGACAGATACATAAGCAACTAGCTTGTTAAAGCAGTAATTATTTCTGCTAATGGATGATAAGAGTGGAGGCAATGGGGTGAAACTTCATAGAATGGGCGACATTTGCCAACACAGTGATTTTTAATATATAGAAATCCTCAATGTAGTAGAAACATTGATGACTCGTACATTTTGTTTAGCAAATTTTTATGTAGTCAAAATATCAGATTCCCAGGAAATAATCATTAAAAGACCAAGTAAAATGCTTTTGAAGAAGAAGGAATTGGGTTAGAGACTATCCTGGTGGTATACTGTTCTAAGAATTTCCTATTAATTCAACAGTTATTTTTTCTTCACAAAACTTTTCTGATTCCAGTATTTCTCCTAATTATCAGTTATGCATACTTAGAATAAGGGATTTCTTTGGTACCTTCTCAATATGGGTAAAAACAATCATAGACATTTCATGATTTCAAAATCATGTTCTTAAATTTGATATTTTATATTTACTTCTGCAAAGATTTTCCCATTGTGTGAATATGTTTAAAGGACTCATACTGTACATCTCTTGTTCCAAAG
>TTN-204,,0,535,3441129,3441663,GCAAGTAACATAGGATTTGTCCTTTTCAAATCATATTACAATCTTGATCGTTATCGTTTTAAAAGACAAACGATATGGCCATTTTGGATACCATAAATTTTCATTTCATAAAGTCATTCTAGATCCTCTAAACCTTCCTGAGACACATTCCACAAGGTACAAAATTGCTTATCAAATGCGTTTATGCAAAAAAGCCATTTCTTAGGTTAAAGCTCTGTGAAACAGCTAAATCAGACACTGATTCTCCATTCGTCTTTCACCCTTCTCCAATCAGTCTATTATGCTGCTAATACATAGCTATGCAAACTTCATACTACTAAAGCATAGAAAAATCATTTCACGATGTACATGTCCAGTTGGATCCCAGGTTCCCCTAAATAATCTCAGGTGTTTTTTAAAACAGAGGTGCTGCATAACTGTAAAATGTTTGGTAGCCATTCTTTTGCAGGGTGAGTAAGCAATGATCTTGTTCAGGACTTCTTTTCCTTGATGATGTCATCTATATTTTCTAACCCAATCATAAATTTGTCTTTAG
>TTN-204,,0,91,3441664,3441754,GTAAGTTGATTTAGAAACACTTTTCAAGCAGTCAGCCCATGGTTACCATTAAGTTAACCCTATCACTGAATTGCTCCAATTTTCCTCTTAG
>TTN-204,,0,120,3441755,3441874,GTAAGTATCAGGCAGCCCCCTACAGCCCTTTCCTTAATGAACCCCATGTATCTATTTGTTTGGTTTCATCTACTTTTTAAACAAATTGTATTAACTGAAGTGCTCTTTGATTTTACCAAG
>TTN-204,,0,745,3441875,3442619,GTAAGTTAAAAAATATATATATATATATACACATATATATAAAATATCAAATATTCAGTAGATTCATTGATATTCTATATCCTACACTTTGCTGACCACTCAAAAATCCTTGATTGGGTGGGCAGGGTGGCTCAAGCCTGTAATCCCAGCACTTTGGGAGGCCAAGGCAGGAGAATCACTTGAGATCAAGATTTTGAGACCAGGCTGGGAAATACAATGAGATCCTGCCTCTAGCAAAGACAAAAGGAAAAAAAAAAATTAGCTGGGCATGGTGGCACACACTTGTAGTCCCAGCTACTCAGGAGGCTGAGGTGGGAAGATCGCTTGGGCCCAGAAGGCCAAGGCTGCAGTGAGCCACAATCACGGCACTGCACTGCAGCCTGGGCGACAAAGTGAGAACCTGCCTCAAAAAATAAAGAAAAAAAATTGTTAATTGAAACATCTAGTATGTGGTTACACTGAGTAAAGCACTAGTATCTCCACCTGGATAAAATGTTCCAGTTAGAGTAGCATTGAAAGGCTACCTGGAAAGATGCCTCAGTGTCTATCACTTGATCTTTCTGTTCCTCTGTGAGTTGGCACTGTCCTGTATAGTACATGGAAGGTATCAAAGCTTATATCTCTAAACTGTAATCTCCTCAACAGACGCACTAAAAACATTCCAAATTTTTATTCTGCACCTGTTATAACCCACATCATATTTACGTAAAGTCTCCTTGGGTGTTTTTTCTTTTCTCCTTTGCAG
>TTN-204,,0,517,3442620,3443136,GTATGGTTTCATACATATTAGATCCATAGAAAAAATGTCATACATGCTTTATAAAATTTAGTGTATCAATTAATGAATGGATAAATAAAATGTGGGATAGCCATACGATGGGATATCATTCAGCAATAAAAAGGAAGCACTACGATATGCTACAACATGGATGAACCTTTAAAACTTTATGCTAAGTGAAAGAAGCCAGAGACCATACAAAGACCACATATTGTATGATTCCATTTATATGAAATGTCCAAGATACACAAATCTATAGAGATGTAGATTGGTGGTTGCTTAGGTCTACAGGGGAGACAATAGAAAAGTCCTTGGGGTGATGGCTAAGGGTTACATGATTTCTTCTTGGGGAATGAGAATGTTCTAAAATTATGGTGATGGCTACACAATGATGAATACATGGAAATTCATTGAATTGTATACTTTAAATTGGTGGATTGTACAGTATGTGAATTATATCTCAATAAAGCTGTTAAAAATGTTAATTTTTCTACATGCTATTTTCCAG
>TTN-204,,0,89,3443137,3443225,GTCAGTTGTTTTGTCTTGCTACATTCCAGTAATTCCCAGTTTCCTCTGAATCACCATACGGTAAACTCGAATTTCCATTTCATCCATAG
>TTN-204,,0,1146,3443226,3444371,GTATTGTCTACATACTAAATGTTTTGAAAAATCATCAGTAGTCCATAATCTATCATTTTATATTTTAATGTTTCCCTTTTACATTTTCTAACCACCATCCTTTAAAGAATTAAATCAGCTCATTCTTACTTGGCTTAGACTCTCTTATGCTGACCTCAATTTAGTCACAGTTTCCACTCAGGGAATAAGGGTGTCCCTAGCAGCTGTCTAAATACGTTAATTAAAGCAGCTGTAGAAATTTCACTGTCTAATAAATGGCTGCTTGCCAAGCAGCACCAACCAGAAAAGAATTAAAATGTAAATCGTGAGGTTCACACATCAATTAGAATTAAGGAAATTTAGAACAAGGTGATATTTTCTCAGAAGGTTTCTATCTGTGGAGAGGCAAGTGTCAAGGAACTTAGTGGCTAGAAATACTTTCTGTGAAGTCTAAGAGAAAGCCCTGTCCAAGCCGTGCTGGGTTCCTGGCAAGGATGCTGGGCACTCTTGCTGTCGGCTGCATTTACAGAGCTTGTCCTCATAAGTGTCCACCATCCCAAATGATATAATGGAGGAAACATGTCTAGAGAAATACCAGTTGAGTTCAGCTTTATCATATTGCTCATCCAAAGAAAACCAGGCTTTACAGACTGTGGACTATAATGAAAAAGGCTTCAATGAGGACTCAGATAACCTGGAGATGTCTTCCATCATTTATTTGCCAATTCTGAACCTCAGTGTTCTCACTCTTAAAATGAGGATAATAATTCCTACCTAGCCCACAAAGTTATTATTCATATAAAATGAAATCAAATTAAGTAATAACTTTTTAGACAATAAAAAGCCCCCAAAGGTAAAGCATCATTATATCCCTTATTAGTAAATAAGAAGCAAACATTTAAGGATGAAATAATTGTCTCTTTGGGGCAGCTCCTTTCCTCCATGCAGCTGTAAACACAATTCTCTACAAGAGAAGTTTATGTACCATTTGTCCAATACTAGGCAGGAAAAATTAGAGAGTGCTATAATCAGCCAACTTATTACATTATAATATATTGGTTTCACATGCCATTCATTGACCAGTTTTAGAAATTGATTAACTGGGAGGAAACCAGAGCTTCAAGTTTTTGTTGTTGTTGTTGTTTTTTTATGTTGTTCCATCAACAG
>TTN-204,,0,1569,3444372,3445940,GTATGTAGGGACAGATTTCAGCATATTTTGTGGATCCATCAGAAATAATCCTCCTGTTTAAGTCACTAAATTCTTGTAACTTGAAGGAAATTTCTAAAGAACCTATGGTATTCATGTGGTTCCAGCTACATTTTTTTTCACATTATATCTATGGAAAAGGGAGGGCAGCTGTTAAAAGACCTATTGAGAAGTTATTTTCAGAAAGCACCTGATGGCCAGATCCTCATCTGGTTGCTCAAAACTATTGAACACCCATTGGGTGTCCATTTTCATATACCCCAGATGAGCTTCTAGATTCGCTGTTAAACTATTTTAGTTCTCTGCCCTCTGCCTGAACTGCTCAAGTCCTAGCAGCACTACCAAGTGAAAGGGGTGTTTCCAGCCTCTGATATGGAGTGCCTGGGAGAACTCAAAAGTCCTCTTTGAGACCCTGGAAGGCCTAGAGAGCCTCAGGCAATGTGGAACTCGATCCTCTCTACCCCAAGCTCTAAGAACAGGGGCTCTTACTTTGGACAGGGAATTCCACATGCTACCAAGCACTCCTGAGGAGCCTCTGAGCAGTCCCCAGGGAAGTGCTGTTAAACCTCTGCTCTCCTCATTAGAAATCTTAAGGCTGAATCTCAAGCTGACCTTGTTTTGAGTCTAACCTAGATGCAAGAGAAAAATGGAACCTCCCTTCCTATTCTCATCCTAGGCCATATCTCTTTGAATAAAATACCCCTGAGGCAGATGCAGGAACTCCAGGGGTAATCTCAAGATTCACAAAGATGAACCATATCGCCAGCATTCCCTAGGTTCCTAGAAGACCAAATGGTCATGGCATCCAGTTCTTATTATCTCTGTATTAGTAGTGGAGAAACTGAGGCACAGAAAAGTAAAGATCTTTTCTATGATAGTGTCAGAAACCAGCCTCACAGAAGTCATTTCTTCTAATTTCTGGGTTCCATGAACTAACCAGGTCCCCTCACTCATCACAGCACTGAGAATATGCTTTAGTTAGCAAAACAGGAAAGCTGAATTTGTTAAGTCTACCTAATGGCATTTAACTAGATCTGAAATAGTGTTAATTCAGTCATTCATTCAATACTTACTGATTGCATTTTACTGGCACTGGTACATAACAAAATGACTATGACATAAACACAAATACTTGCAAAACAAACAAACTGGAATGATATGAGCCTCTTCACCACATGATTTGTCCAAATGAATTTTAAAAATAGGTAGCACACGGAAGTTATTGTATAATTCATTCAGGTGTCCATCGCTAAGCCCCCACCACAAACAGAAACTGGGATAATCAGGTTAACTCGGCACTCTCAGCATGCCCCCCAAATATCAAAAATATCTTTCTGAAGCTATTCCCTCTGCATGTGGACAAATTCCAAGTGCTTTCTTCATTCTTAGCACAAAGAATGTTCTAATATTCTGAGGCAAGTAAAAATACCACAATTCCAAAATTTTGTCTCTGGATGTATAACTAGCCAGCAACAAATTAATGTAGAGTTTTGCATGCTCTCTTGTGTTTTTACACTTTTTCATGGGCTATTTGTCAACATTTACTCCTAG
>TTN-204,,0,224,3445941,3446164,GTAGGAATGCCTCGCTACTTCCAGCTGAAAATAAAACCTAAGAAGCAGGCTTTTGTCCTTTCCCAGTGCATTTAAAAATACAATTTGGAGCTCATAAAAGTAGATTGCTACCCAACTTTGAAAGCACTCTGCAGTGAAATAAATTAAGATAAACCTACATGCTCCCTTCTGTGAGGTCTCTATGGTGACTTAATCATGACAAATCTTGTGGTTTCTTTCTTTAG
>TTN-204,,0,5004,3446165,3451168,GTAGGTTTAAGAACAAAAGGTGTCATTGCCAATACTTACAAATAATTACATGGGAAAAACATTCTGTCAGCTTCTCCTCCATCACAAACATCTCTCATGCATAATTTGAAGCTTAATGGAAATCTAACAGAAAACTTATTTCAATTATTAAATTAAGAATTAGATAAGTGTTTTTCACTATTTTGTGCCCTTAATAATGGTTGTTTATGTTATGTTATGTGTTCTTTATCACAATAAAAAAATTAGTGTTTTTCACTAATATTAAAAAAGGTCATGTTCCCTTTATGATTGTAGCTGCACTTTAATTTCTTCATTGATAAAATACAATGACAAAACTAAAATTATTAGATTATAATAGCATCTACATATAATTCAAAAGAATAATACATTTATATAAGACATTATTCAGTCTATGGACAATGCTTGTGTGAAAGGTATCCTTTGGAAGACAATATCCTATAGTGGTCAAAAGTCGGGGCTTCATTGTCAAAGATGCTGAATTTGAATCTTGCCTTCAATATATATCATGTCTCTCGTTCTCCTTCTGTCATGAATACATTGAGTATATGATTGCATTCAATCCTAGAAAATATATTTTATGAGGCTAGGAATTCCGTTTTAGTGCCTAGAATTTGGCATCTGAAAAATAGTACCTGCTAGAAGGTAAGCTCTATGAAAACAAGAGTGGATGGTTGCCCCAGAATATCACCTGATACATAGTAGATACTCCATAAGTAATTGTTGACTGGACTAATTAATGATGGTTAAATGACTGTTACCAAACACTTAAGATTATTATCAAGATTAAGTTAGGTAACTCAAGTCAGCACATAGCACAGTGCTCATCATACAGTAATCAATCAGAGTTAGCTGCTACCATTTTTAATTGGGGCATGCTTCTCAAGTACCACCAGCCAATTTCCTCATCCCAGGAATCTGATCTTGGTAGAATGAGACAATATATGTGGAACCACTTCAAGTCATAACTGATTGTCTATAATCACAATTATTTGAGAGTTTCCCAGCCAAAGGGAAACTCTCAAAGCTTGGGCATCTCCCAGCCCTCTTATTAGGCTGATGCAAAAGTAATTGCAAAGTTGTATTGTTTTGTTTATTATGCTTCTCCCATTAGTTTATAATCCAATCTCTACCTTGTCAAGATTTATTTTTCTCAACAGGTTAGTACTTCAGTTGGTCTTCTGACCCAATTATTTCCTCCTCAGGAATGGAGATGGTGATCTAGAAATCTAATAGACCTATTTGATTTTATGAGCATAATTAAAAGATATAATGTATGTAAAGCACCTATAGGCATGGCTGCCAGGTAACTGGGGCTCAATACATTCATTTTATTATAGCCATAGAGAGGAATTATATAAACATCAATGTTTAGTATTGTATGGCCAGTATGGACAAATACCATAGACTGTATATTTGAGGGATAGTGTTCAAGAAATGCTAAATATTAATAAATGAGGACTGATTTGATAATATCCTACTAACACAATAATACAAAATATATTTTAAAAGCAAGTTCATTAAAGCTACACTAAATAATTTATCCATTTATTTAATTTTTAGAGGAATTTTTTAATATAAACATATATGTACATCATTCAAAGTAGTAATATTTGTCTTAACTATATTGGTATAGTGCTTTTAAGTCTATAACATATTAACATATGGTAGTATTGCCTTTAAAGTGTTGTAGAAATACACCTGAAGCACTCTACAAGACACCAATTGGGGTAGAAAGAGAAAAATTTCACTATCTTTTCTGCATAACCAATGTCTTTAAAAAGGTTTGAATAGGCTTTGTAAACTGAGAAGATCATTAACTTCCTATGTGTGGTAATATCTGTACACATATAGTGGTTTTAGCATCCTCTTATAAATTTGTTTTCTATATGAAAGAAATTAAATTCATTAAATAGAATGACCCTTCAAAAACTTGCCAACTCACATAGTTTCATACCACTGGGACTAAAAATATTTACAGAACTTCCTCTGGCCAGGTATTGCCTTAAGTAAGTGTAGCCCTGCTTTCCACAAATTGGAAAGAAATTGGGAGTCTTCAGAAGCTCCCATGTTCTTGGGGGTTGTAATACTTTCTGAAGCATGAAACGTGGCCCTGAGCAACCAGGTGCTGTTTCTAACAGCGAAAATGTTACCTATTGAAGGTCTCCAGTGCCACCTACTGGTAGAGGAGTAATTTGGAAAAGCAGAATCTTAAAATGTAAAAAAGCTATTTTTTTGCTGTTTATTCTACAGATGATGAGTCAGTGTCATTTGGAGGCTTACAGAGTGACAGCTAGCTAAACAGAAATGATGAATAATTAGTTTAACAATGATATTGTCTGTTATTCATTTAAGCATCTGTGCAATTTTAATTCTACCATTTATTGTTTCCCTGCTATTGAGATATTACCCTAGGTGCTGGGGTGCAGATCTTGCTCTTGCCTTTAAGGAGCTTGACATGTAGGTGAGGAGATGCATGCACACAACTATATCCCAAGGTTGTAAGTGCTATTAACAGGCCCACGTACTCATCATTCTCTGTCTGGGAGAGAGCCAGAGAAAGATGTGTGAACTGAGCATTGAAAAATATGTAGGATCATTGAACACAGTGGCATCCTATGATGAGAAAACAACATCTCCAAGTCATCAAAACTTGCAATAATGCTTCATGTGCTAGAAGCAAGTGGTTTAAGTACAGTTGGAAAGTGATATCATGAGTGGGTAAGAAGGCTGGATAATACAGCAAAGGCCGTGCTAAAGTTTTTGGTATTCTATGCTGAAGATTTTGGAATTGATCTTGTTTACATTTAGGAGACACTGCAGGATTTTTAAGCCCCTGGGTACCATGATCAGGTTTACTTTTTAGAAGTGATACTGTGATAGGGAAAGAAGGGATGGACAGATGTGGGAGGCAAGACTGGCAGTCAGGAACTGGAGAGAGATTATTACAATAGGCCTGGAGAGCGTGGATGAGGCCCTCAGCCAGGGCAGTCAGGAGAGACAAGTGGGGTATTGCAGAAGTAGTAATATGGGAGAAGAATGGCCTCAAAGAAGACACGAGAGGCTAATGAGTAACGCAGATCATGGCATCACAGCCACAAGCACCAAGTCCACTACCAAGAAAAGTTTTACCTGTTAACTCACTTATTGTGTGCAGTTCATGTCCAGTGGCAGTTCATGTGTATCCTGGTGCCTCATTCAGTTCACCAAAGGAAGAAGCTGTCAGTAGAAATAAGCAGAGAACCTTGTAAGAGGATGTACCATTGATGATCTCACACACACACACACACACACACACACACACACACACCCCTTCACACAAACTAAATAGGGGTGGTGTTTCATGTTATATCACATGGCACTGTCTTTTGGCGTGTTATTGAAGACAACGTTGCTTCCATCTGTGATGTTAGATATTCTTGCTATAATGACTGACTTGTGCCAGTGGCTTATAAAGCCCTTCCATGTGTGTTATATCATTTAATTCTCACAGCAATTATATGCAACGAATAGCCCATAAATTATTACGCATGCCATTTTACAAATGAAAAGACTAATCCAGAAAGCTTAAATGACATTTCCAAGGCCACACAGCTGACAAGTTGTAGTGTCAAGATTTCATTTTCTTTATATGTATATATTTTGATGGAGTCTTGCTCTGTCACCAGGCTGGAGATCTCGGCTCACTGCAACCTCCCCCTCCCGGGTTCAAGCTATTCTCCTGCCTGAGCCTCCTGAATAGCTGGGATTATAGGTGTGTGCCACCACACCTGGCTAATTTTTGTATTTTCAGGAGAGACTAGGTTTCACCACGTTCGTCAGGCTGTTCTCGAACTCCTGACCTCGTGATCTGCCCGCCTCAGCCTCCCAAAGTGCTGGGATTACAGGTGTGAAGCACCGCGCCTGGCCAGGATTTCATCTTCTACTTTACCTTACTATCTAAGGAACTGAACAGATTTGTTACTCTAAGAGGAGAACCTGCCATTTATACACATCTACCATCATGGGCAGGAGAGTAACTTTTATAGACAAGTATTGGCATTAAAATGCAGACAAATGCTAGATGATTGGACTATTAGAAGATCATCTTGGATGGTTTTGAGACCAAGAAGTGGTATAGTGACTGTGCTCCAAAAACAAGATGGCTTTGATTTTGGCTATTCAAACAGTTAACTAAAATTAAAGTGCATATCACCTACAATTATTACAACACAATAACCTGCTACTTTACTGTAATTTGGGTTTTTACTTTCTATTATTTTAAGATGGTTCAAATCCTTATATAGAAATAGCTAGCTTTATTATAATGTCTTATAACTGCCACTCTGAAAAGAGTCAAATGTATCTAAGATGCTCAAATACCATAATAAATCACCCTCTTTATTTAAAAAATTATTTTCTCTACAATTATTTGTGCCATATATACTGCGTACTGAAACCTTTTGCTCATTAGTAACAAAGATAGAGATTTTTTTTCTACAGCCTTCAAAGGTATCTATTTTAGACTTTTCATATCTTGATCTTCTCAGCTCTCTTTTTGATTGATTTTTCTGCAAACCAAAAGTGGAGATTTTTCTCATTTCCTGTCCCAGAAGGCAACTACAAGCCCAGATCAAACCTTTCCTGATGACTCTTCTTAGGACTGTCTTTTTCTCAAAGTCACTGAATATGTCAAAATCTTGTCTCTGCTTCCACTGCATGACATGCAAATGTCTAAAGAGAATGTAACTGAAGTTCTATCATTTTAAACATTACAACCAGTTCAACCTTAGGACAAGCTATATTTTTCTATCATTACATTTCCTTCTTGAAGATGAAAGGAAATCATTTAACAATAGTAGATATGGCATGCCCAGAGAAAAGTATCATGTTATTAAGTCAAATATGAAATGTAGGCACTAGTATTATTAACATTGTGTTTGCAGGTAAATTGTAAAAATCCACTCATTTTTGTGGTTGAAGTATCTCTTTTCTTTTGTGTCGCAG
>TTN-204,,0,5803,3451169,3456971,GTAAAGTAAAACAACTTTCAGAACCCCATTTAAATATAGATCGAATCTTAACAATGTCTGTAACAATTACTCAAGAGTTCATGTAAATCATTGTTGTTCCTACCATTCTCTTCTAATTCAACTAATTATTTCCCTGTTATATGCCATGGTCTCGCCTCTCCTTTACCACTTTTCATTGTGAATCATAGACCATCACGTTTCATTTGGCCCCGCTTTTTCTCTGTAACAATTTGTAATGTATTGCTGCTGTCACCAGCTGTCATGCTTCCTAATCAGCATGAATCAGAAGGGGGCGAAATATGCTGCATAAATAGGTAGATTTGTTTTCTCAATTGGCTAAGATAAAAATTAAATTTTAAAAACATCTAAGAGTGTTATCATCCTCCTATCATGCTGACACAATTTTGATTTCACAAAAGCTAGACCGTTTCAGGTCTGTACACCAGCGAGCTATATTCATCCTCCTCTCAAGAATGTCTTAGTGTTAAGAAGTCCAGTCCTAAAGTGGTTTAACATTTCTGTTAGTTGGGGCTCTTAAATTGTAATCAGAAACACTTCCTCAGTAACATGGGGAATTTGATTCAAACAAGGATAGCATTTTTATATAGTGGTACTATTTTTCCTGAGCAAATATAGTCTATGTAGTATTAAGTACATACAAATACATAAGGATTTAGAGAAACTATTTTTTTCTTAACCTTATGCATTAACTGTAACTAGATGTTTTTTTAAATAATGAATTTAAAGTGGTTTAAAATTAAAAAGTTGACTTTACAACAAGAGGAAGAAAGAAAAGAATATCCAAAACCCTGTTGGGTACTCCACTATTGCCTTCATGAACAATGTAGTGAAGTTCCTTAGCCCATTCATGTCTCAGCTTGCTTCTCTGGGAAATGGAAGTGAACTTGTGTGACTTCGAGTCAATAGTGACATACAAGGACAAGGCAGTAGGAGTGGACTGAATTCTAGTCCATTATTGAAATTTGTGACAAATCTGTAGACAACTCCAAATGAGTTCTGGTTTCAGTGCAAGGTAAGACATTAAAAATTGGTATGCTTCTTTTCAGGATTTAGCAAATTTGAAGAAAATACATCAAACTCCCAATGGCATGTCTCTTTATCAGTTTCATTTAAGAAGGAGCCCCTTGGCCAAAAGCCCAGCTTCATCCAGCCTCTGTCAAGCCTCAGGGTGCACAACGGGGAGACAGTCAGATTTCATGCGAGGGTTTCTGGCATTCCCAAGCCAGAAATCCAATGGTTTCATAACCAGCAGCTAATTCTACCAACAAAAGATGTAGTTTTCCATTTTGAGGAGTCCACAGGCATGGCTTTAATGCTTATAGTTGATGCTTACTCAGAGCATGCTGGGCAGTACTCTTGCAAAGCAGCCAATAGTGCTGGGGAAGCCACTTGTGCAGCTACACTCACAGTGACTCCAAAAGGTAAAGCCCATCTTGCTTCAAGGACTTTGATTTGCTGTATACCTCTCAGTCCCACTGTTACTAATGAGAGTCTCTGCTGTTTGTTTTATTGCATACTGTGGTCAGTCCATAACTTACTAATAAAATAACATGCAATAACTCCCGCTAGGTCCTCAATTATGGGTTAACCTACATACTTTAAATTTCACTGAAGTATGTGTTCTATGCACTAGAGAACCAATAATTATTTTATTAGGCACCACCTTTGCTTGGCTTCTTTACTCTTCTAAGCAATATTGTATCATTGCATCATTAAATGATCTATTTGCTGATTATTACTTACTGTACTTAAAGTAAGTACAGTATTACTTACTGTACTTAAAGTAAGTACAGTATTACTTACTGTACTTAAAGCATACAGTGGACGGAGAGCAAATGCTAACCCAAATACAGTCAGCTAGAGGGAGAGAGAGAAAGACAGACTGGGTCACTTTGGATAGCTGAAATGACAACAGAAAGAAGGAACCAGATACTGCATGGCATCTGCATGAGTCTTCATCAACCACTCAGCACTGAATCACCAGGAATGAATTTTCTTTTGTGTGATCCTGACATCTAGATCATATTGCATCTGGCATGCTGCTTTCAAGTGACAACTACGTCTTTCATCTTCATCTTCCATGCCATTTTGTGTTACTAACATGGGCAAGTGACAAAGCTTAGATCTTAATATTCTTTTCTTTTTCTTGTCACTTGATTATACAGTGCAAGCCCTAGATAGGCAAAGTTCTGGGAAAGATGTAAGAGAGTCCACCAAGTCCCAGGCAGTGGCAGATTCCTCTTTCACAAAGGAGGAGAGCAAAATATCTCAAAAGGAAATTAAGTCATTTCAAGGATCATCATATGAATATGAAGTGCAGGTTTTTGAAAGTGTATCTCAAAGTTCCATCCACACAGCTGCATCTGTTCAAGATACACAGTTGTGCCATACTGCATCCCTTTCACAAATTGCAGAAAGCACTGAGCTATCTAAGGAATGTGCTAAAGAGTCCACGGGTGAGGCGCCCAAGATTTTCCTGCATCTTCAGGACGTCACTGTAAAGTGCGGTGACACGGCTCAATTCCTCTGTGTTTTAAAAGATGATTCTTTCATTGATGTAACCTGGACTCACGAAGGTGCAAAGATAGAGGAATCCGAGAGACTGAAACAATCACAAAATGGAAATATTCAGTTTCTTACCATATGTAATGTTCAGCTGGTAGACCAAGGACTATACAGCTGCATTGTACACAATGACTGTGGAGAGAGGACAACGTCAGCAGTACTAAGTGTAGAAGGTGGTTAATTGATTTTTAGCTATGACTTGCTTCATTTCATCCTCATCGCTTTATGCAGCTTTTCTGCCATGCAAATTCAATCGACGAATATATTAATTAGAATATCTCTAAATTAGCACCCTATTCATAAGTGACTTCTGAAAGTCAGCCAAGTCATTGGCCATGATTATCCTGAAAATTTAACTTACCAGTCTAGATTCAGAAAGTTTAATTTTTAAACGTAGGTTCGGGAAGCAAAGGTTTATTTCCTATGTGCTGCATTTTCTAATATTTACCAACGCACTACCAAGAAAGTGTAGCAAAGTTAAAATGTTGTATTCTGAGAAGTACTTATTGGGTATTTATTATTGTGCCAGATACTGTGGTAAATTTCAGTTTAATTGTTTTAATAGCAAGAGGTTCAACAATTCTTATCTCCTCTTTATTTTCACATCTGGAGGTTCTAGTTGTTTACAAAGGGGCCATGAAAATAGAAAATTGGGACCAAGTACAGTGACTCATGCCTGTAATCCCAGCACTTTGGGAGGCCGAGGCAGCCAGATCACTTGAGGTCAGGAGTTTGAGACCAGCCTGGCTAATATGGTGAAACCCCATCTCTACTAAAAATACAAAAATTAGCCAGGCATGTTGGATGTTGGTGCATGCCTGTAATCCCAACTACTCAGGAGGCTGAGGCCAGGAGAATCGCTTGAACCCAGGAGGCAGAGGTTGCAGTGAGCCGAAATAGGGTCACTGTACTCCAGCCTGGGCAACAGAACTAGACTCCATCTCCAAAAAAGAAAAATAGAAAATTGAAAATTGGGCACTGAAAATAACAAAGCTCTCTCTGGACCAAAATTAGAAGTCTCTAGATATTTCTCCATAAATGATGCTGCTTTTACAGGCTTAAAATCCTCCTGGAATTGTATAATTTTCTCATGGCAAGATCACAATTTTTGTCGTTATTGGGCTTGATTCTCCATTATGTCTGGAAGAGCAGGAATAAACTTGTCTGGGCAAGTAATAACTTCTTCCTCTTATCCATGGACTTTCCTTTTGGATATTAATGAAATGAGAAAAATATTTTTCAGGTGCCATAAGCCTGTGTTGTGTGCCCGTAGTCAAAACAGCTTCACTGAGTCTCATGGAAGGAAGCTGGTGGAATAAATTCAGGCATCTCCAGGGGTCTGTGGAAAGCTCTGGCCTCAAGTTCCTCCCTGATCCTGGCCATAGTGGTGTTAGGGATGAAAAGGGGGCAATGCAGTGCTATGTAGGTGCACAGCCATCTCTGCACAGAATTTTGAAACAGTGGCCTTTCTTCCTACCCAGTACAGAGAATACAGTTTATTGATTCATATAATGTATCCGCAACACCTACTCACCAAAAAGAGGTCTTATTCTTTCTTAATGAGATTTTGTTCTATAGCTATCTCTCATTCTGTCACCGTAGCCTACAAAGGCAATATCTCAAGAACTGAGGTCTAGTTATGTAAATTAGATAGAAAATTCCACCAGCCAGAGAGTTGACCCTCAATTTCACTACAGCTGCTGGCTAGCACAGTAATCACACAGAGTCACTATTTATTTGGAGGTGTTGTCTACAAGTCCTGTAGGTGACAGTGTGACAATTTTTTCAGTAATGTAATTGGGAGTTGGCTGTGTTGTGAAGGTGGGAGAAATGTAGATCTCTTAACTCACTTCCTAAAGAATCTAGTGCTATAGTGCGGTGTTTGACTGTCATATTCCCAGAATTGATTTGAACTCGGCTCTTTTGCCCTAGGATCTCCAGTTCATTCAGTTCCAATTGATAATATTATTAAAGTGTTCTTGAAGCAAAAGAATTTTTTTGAACATCCAACTGCCTTACTTGTACCTAAGAAAGTTGAAAGATAAGACATTTTTAGATGTTTGAAGAGTGAAAGATCAGGCACAGTTGTCTAATTATTTGACATAGGCCAGTCTTTATATGTTCCTTTTTTATTTTGGCTTAATAAGTTCATATAGGCTACAGAGTTATCCACCAAGATCAAGTAGGAATGTCAAACCCCTGGAAGTCTTTTTGAATACAGTTATTATGTGCATAATAAACATAAACATATCATATATAAGTTTCATGACTAACATGCTGCCTTTCCTTCTCATCCTAATGACATTCCATCTTCTCCACATTCAGCATGTTTTTCATTCTTACAAACACAGCTAATTTATGCCTTTCCCTAACTTTATTCTTACCTAGCAAAAGAATCGCAAGCCAGAGCACTTACAAAAATTACTCTGGGTTCTGACACTAAAAGTATTAAAACACTCAGAGAGTCACAAATTAAAACAACCCGTGAAGTAAAAAGAGAATCGTCAAAGAAAACATCAAGTTTGTCATTAACTTCATGCCAAAAACCGTAAGAAACTGAGAACAAGGGAATAAAGTCTACTGACAGGATACCACGTGGACTGAAGACTGAGAGTGATACGAGAGCCCCAGCCTTTCCCAAGGAGCTGCCCTAGATATGACTGTGTCTAAAAGCTGTGCATATTCCTTGTGGAATAAAAACAGTTTTGATAAGTCTTTGTTTTGTTTCTTAATATGTAATTTGGACTTCATGTAGTTCAAAGTTTGAAAGGTGATTCAAATCAAAGGAGTGTTTACTAGCAGGAAAAACTGAGAATAGCCCTCTGCTAAAGTAGCAATTTAGAAAATGCATGTTCTTTCTAAATGTGATTTCATCTCTTAGCAAGTGTTTAGTCAATAGGACATTTTTTAGAAAATAATATTCCTTCGGTTTGTAGATTGCTTTCTGCATGCATGTAAAGGCATGGGGAATTATAGAACTAAAAGTGGAAATTTCATGAAGAACCTAAAATAAAAATGTTTTAAATCTTTCTGTCAACATTGTCATGTGTTTTATCAGCTCAATAGTTTGTTTGGCATGGACTTTTTGGTAAATTTGGGGAATGTAGTTTTCTGTTGTTATAATAAAAAGAAAACTTTAATCATACAAGTCATGAATTGATGCAGAAAATATATGCAATTAATCACTAAAATCTCTTTATATGTTTTTCTATTTTAG
>TTN-204,,0,1084,3456972,3458055,GTATTGTTATAATGGATGTGAGATTTAAGTAGAAATTCTAAAGGATTAATAGGATCCTTGAGTTGCCTTCTTTCTCTTAGTATTATTGAGAAAAAAATGACATAGATATACAAATATATCTCTTAGAGTATATATTACTATGTCGCATGCTTGGTTTAGAATTTTGATGGTTACATGCATTTCACAGTAATTTATTGTAAGTTAATTTAAAATTTTGTATTTAAAATTTATCAGCCAAATTCAACTTTATGTTTGCAGTCATTTCCAAAAGTGTATATTAGGAGAAGTTGTCATCTTAATGCATGAAATCATGAAGTAGAAGTTTGTTTTCAAAATCACGGTGAATTACATTGAAAATAGACAATAACCTAGCTGTCATTCTCAGAATGCAATGTCATGAATGAATTATGATTGAAATGCTACTTTACTGAGGTTGTGTGAAAACATTACATTCCCATCTGGTTTACACTTCATTCACATATATCATTTTAACATTGATATGTCTCTTACACTGGCTTGCAGATAGCTGCCTTATGTGATCCTTATTGCCTGCTTTTCTTTGCATAACATTGTGACTTTATGGCTGTATTAGTTCGAATAAACGCCTTCTCATTTTATTTTAGCTAATTATTTATGGTTATAGTTCTTGTATATACTCTTTAAATAGTTGATTCTCAAAAATATAATAATTTAATCTACAATCAAAAGAATCAGAAAGGGCGTTTATTCCACTCTCTGCAAGTCAGGTAAGATTTTCCACTTAGCCATCAAAAGAACAAAGTTTTCCTGCTCTCAAAACAAATATGCACAGGAACATGTTATTTTGAAATGCATTTTTGCTTGTTCAAGAAGAAATTTCAACAGTTTGAAGAAAAGACCAGACAACGAACGATTTTCGTGTCAGAATCTTTTAAACAGAGCATGGTGTTGCGTTTATTCGAACAAATATGGTGAGTGAATTTTTCTATGGATTTGTGAGATCTGTAGCATGCAATTTATTTCATTTCCTATTTTGCAATTTTATTTACTTTCAACTTTTTCAAGTTCTATGGAAAATAGTAAAGGTTTTTTTTTTTTTTTCCAG
>TTN-215,ENSE00004024293,1,310,3458056,3458365,TGCTTTCCTAAGACAGCCAATCACCCAGGGCCCTGCCTAAGGATGTGGGGCTGTCAGCAGATCTGGTGAATATAAGGGCAGGCCAGACCCTGGCTCTTGAGCAGTCGTGCATTCCCAGCCTCGCCTCGGGTGTAGGGATTGCATAGAAAAGCAAAACTACACAGTCTTGACTGTGTAGTTTTGTTTTTAGGATTAGAGGCTCACCGATTCATGTCGGAGATGGTCAGAAAAACCAACTCTCCATAGGACGTCGTTTCAGAAGCAACCTTGGGCTTAGTCCCACCCTTTTTAGGCACTCTTGAGAAATCAG
>TTN-215,ENSE00003502146,1,104,3458366,3458469,AGTGCCTAGAAAGATGACAACTCAAGCACCGACGTTTACGCAGCCGTTACAAAGCGTTGTGGTACTGGAGGGTAGTACCGCAACCTTTGAGGCTCACATTAGTG
>TTN-215,ENSE00003807606,1,204,3458470,3458673,GTTTTCCAGTTCCTGAGGTGAGCTGGTTTAGGGATGGCCAGGTGATTTCCACTTCCACTCTGCCCGGCGTGCAGATCTCCTTTAGCGATGGCCGCGCTAAACTGACGATCCCCGCCGTGACTAAAGCCAACAGTGGACGATATTCCCTGAAAGCCACCAATGGATCTGGACAAGCGACTAGTACTGCTGAGCTTCTCGTGAAAG
>TTN-215,ENSE00003810976,1,288,3458674,3458961,CTGAGACAGCACCACCCAACTTCGTTCAACGACTGCAGAGCATGACCGTGAGACAAGGAAGCCAAGTGAGACTCCAAGTGAGAGTGACTGGAATCCCTACACCTGTGGTGAAGTTCTACCGGGATGGAGCCGAAATCCAGAGCTCCCTTGATTTCCAAATTTCACAAGAAGGCGACCTCTACAGCTTACTGATTGCAGAAGCATACCCTGAGGACTCAGGGACCTATTCAGTAAATGCCACCAATAGCGTTGGAAGAGCTACTTCGACTGCTGAATTACTGGTTCAAG
>TTN-215,ENSE00003809662,1,86,3458962,3459047,GTGAAGAAGAAGTACCTGCTAAAAAGACAAAGACAATTGTTTCGACTGCTCAGATCTCAGAATCAAGACAAACCCGAATTGAAAAG
>TTN-215,ENSE00003809782,1,245,3459048,3459292,AAGATTGAAGCCCACTTTGATGCCAGATCAATTGCAACAGTTGAGATGGTCATAGATGGTGCCGCTGGGCAACAGCTGCCACATAAAACACCTCCCAGGATTCCTCCGAAGCCAAAGTCAAGATCCCCAACACCACCGTCTATTGCTGCCAAAGCACAGCTGGCTCGGCAGCAGTCCCCATCGCCCATAAGACACTCCCCTTCCCCGGTCAGACACGTGCGGGCACCGACCCCATCTCCGGTCAG
>TTN-215,ENSE00003805863,1,331,3459293,3459623,GTCCGTGTCTCCAGCAGCAAGAATCTCCACATCCCCCATCAGGTCTGTTAGGTCTCCATTGCTCATGCGTAAGACTCAGGCATCCACCGTGGCCACAGGTCCTGAAGTGCCTCCCCCTTGGAAGCAAGAGGGCTACGTGGCCTCCTCATCTGAGGCTGAGATGAGAGAGACAACGCTGACAACCTCTACTCAGATCAGGACAGAAGAGAGATGGGAAGGGAGATACGGTGTCCAGGAGCAAGTGACCATCAGTGGTGCTGCGGGTGCTGCCGCCAGTGTGTCGGCCAGTGCTAGCTACGCAGCAGAGGCTGTTGCCACTGGTGCTAAAGAG
>TTN-215,ENSE00003803639,1,153,3459624,3459776,GTGAAACAAGATGCTGACAAAAGTGCAGCTGTTGCGACTGTTGTTGCTGCCGTTGATATGGCCAGAGTGAGAGAACCAGTGATCAGCGCTGTAGAGCAGACTGCTCAGAGGACAACCACGACTGCTGTGCACATCCAACCTGCTCAAGAACAG
>TTN-215,ENSE00003810843,1,138,3459777,3459914,GTAAGAAAGGAAGCGGAGAAGACTGCTGTAACTAAGGTAGTAGTGGCCGCCGATAAAGCCAAGGAACAAGAATTAAAATCAAGAACCAAAGAAGTAATTACCACAAAGCAAGAGCAGATGCACGTAACTCATGAGCAG
>TTN-215,ENSE00003803899,1,126,3459915,3460040,ATAAGAAAAGAAACTGAAAAAACATTTGTACCAAAGGTAGTAATTTCCGCAGCTAAAGCCAAAGAACAAGAAACTAGAATTTCTGAAGAAATTACTAAGAAACAGAAACAAGTAACTCAAGAAGCA
>TTN-215,ENSE00003809802,1,138,3460041,3460178,ATAATGAAGGAAACTAGGAAAACAGTTGTACCTAAAGTCATAGTTGCCACACCCAAAGTCAAAGAACAAGATTTAGTATCAAGAGGTAGAGAAGGCATTACTACCAAAAGAGAACAAGTGCAAATAACTCAGGAGAAG
>TTN-215,ENSE00003805623,1,138,3460179,3460316,ATGAGAAAGGAAGCCGAGAAAACTGCCTTGTCTACAATAGCAGTTGCTACTGCTAAAGCCAAAGAACAAGAAACAATACTGAGAACTAGAGAAACTATGGCTACTAGACAAGAACAAATCCAAGTTACCCATGGAAAG
>TTN-215,ENSE00003801659,1,294,3460317,3460610,GTGGACGTTGGAAAAAAGGCTGAAGCTGTAGCAACAGTTGTTGCTGCAGTAGACCAGGCCCGAGTCAGAGAGCCCAGAGAGCCTGGGCATCTTGAAGAATCCTATGCTCAGCAGACCACTTTGGAGTACGGATATAAGGAACGCATTTCCGCCGCAAAGGTAGCTGAGCCTCCCCAACGTCCAGCCTCAGAACCCCACGTTGTCCCTAAAGCAGTCAAGCCTAGAGTAATCCAGGCTCCTTCTGAGACTCATATCAAAACTACTGATCAAAAGGGAATGCACATATCATCACAG
>TTN-215,ENSE00003804455,1,123,3460611,3460733,ATCAAGAAAACTACAGATCTAACAACGGAAAGATTAGTCCATGTGGATAAACGCCCCCGCACAGCTAGCCCTCACTTTACTGTTTCAAAAATTTCTGTTCCTAAGACAGAACATGGATATGAG
>TTN-215,ENSE00003810306,1,282,3460734,3461015,GCATCAATAGCCGGTAGTGCTATTGCCACATTACAAAAAGAGTTGTCAGCCACATCTTCTGCTCAGAAGATCACCAAATCGGTGAAGGCTCCTACTGTGAAGCCCAGTGAGACTAGAGTAAGGGCAGAGCCCACACCCTTGCCACAGTTCCCCTTCGCTGACACACCAGATACTTACAAGAGTGAAGCTGGCGTTGAGGTGAAAAAGGAAGTAGGGGTGAGCATCACTGGCACCACCGTCCGTGAAGAGCGCTTTGAAGTACTGCACGGACGCGAAGCCAAG
>TTN-215,ENSE00003805296,1,66,3461016,3461081,GTAACAGAAACAGCAAGAGTACCAGCACCTGTTGAAATTCCTGTTACTCCACCAACTTTGGTCTCG
>TTN-215,ENSE00003806123,1,259,3461082,3461340,GGCTTAAAAAATGTGACTGTCATAGAAGGTGAATCTGTCACCTTGGAGTGCCACATCTCTGGATACCCATCCCCGACAGTGACATGGTACAGGGAAGACTACCAAATCGAAAGTTCCATTGACTTCCAGATAACCTTCCAGAGTGGAATTGCTCGTCTTATGATTCGCGAAGCATTTGCGGAAGACAGCGGGCGATTTACTTGCAGTGCTGTAAATGAGGCTGGAACCGTCAGCACATCCTGCTATCTGGCTGTGCAGG
>TTN-215,ENSE00003808554,1,64,3461341,3461404,TGTCAGAAGAATTTGAAAAGGAAACCACAGCCGTGACTGAGAAATTTACTACAGAAGAGAAACG
>TTN-215,ENSE00003804962,1,216,3461405,3461620,CTTTGTTGAGTCAAGAGATGTGGTTATGACTGATACTAGCCTCACAGAGGAACAAGCAGGGCCTGGAGAACCTGCCGCGCCTTACTTTATTACAAAACCAGTGGTCCAGAAACTGGTGGAAGGTGGGAGCGTGGTGTTTGGATGCCAAGTTGGCGGCAACCCAAAGCCCCATGTATACTGGAAAAAATCTGGTGTTCCTCTAACCACTGGATACAG
>TTN-215,ENSE00003804165,1,143,3461621,3461763,ATACAAAGTGAGTTACAACAAACAAACCGGTGAATGCAAGCTGGTGATTTCTATGACTTTTGCTGATGATGCTGGAGAATACACTATTGTTGTTCGCAATAAGCATGGAGAAACTTCTGCATCTGCTTCCTTGCTTGAAGAAG
>TTN-215,ENSE00003802603,1,206,3461764,3461969,CTGATTATGAGTTACTGATGAAGTCCCAGCAAGAAATGCTTTATCAGACACAAGTGACTGCATTTGTTCAAGAACCTAAAGTTGGAGAAACAGCACCTGGATTTGTATACTCTGAGTATGAAAAAGAGTATGAAAAAGAACAAGCCTTAATTAGGAAGAAAATGGCCAAAGATACTGTAGTGGTCAGAACTTATGTAGAAGATCAG
>TTN-215,ENSE00003807963,1,234,3461970,3462203,GAATTCCATATTTCTTCCTTTGAAGAGAGACTTATTAAAGAAATTGAATATAGAATAATAAAGACTACATTAGAAGAACTTCTTGAAGAAGATGGAGAAGAAAAGATGGCAGTTGACATTTCTGAATCTGAAGCTGTTGAATCAGGATTTGATTCAAGAATCAAGAATTATAGAATTCTTGAGGGGATGGGTGTCACTTTTCATTGCAAGATGTCTGGATATCCATTACCAAAG
>TTN-215,ENSE00003808968,1,245,3462204,3462448,ATTGCTTGGTACAAAGATGGCAAGCGCATCAAACATGGAGAAAGATACCAAATGGACTTTCTACAAGATGGCAGAGCTAGTCTGCGTATACCTGTTGTTCTTCCAGAAGATGAAGGAATCTACACTGCATTTGCCAGCAATATTAAAGGAAATGCAATTTGCTCAGGGAAATTGTATGTGGAGCCTGCTGCACCACTTGGAGCTCCGACTTACATTCCCACACTAGAGCCAGTGAGCAGAATCAG
>TTN-215,ENSE00003802614,1,272,3462449,3462720,ATCTCTCTCTCCACGTTCAGTGAGCAGGTCTCCTATACGCATGTCTCCTGCACGGATGTCACCTGCAAGGATGTCTCCTGCACGGATGTCCCCTGCAAGAATGTCCCCTGGACGTAGGCTGGAGGAGACAGATGAGTCACAACTTGAGAGACTATATAAACCAGTCTTTGTGTTAAAACCTGTTTCTTTCAAATGTTTAGAAGGGCAAACTGCCAGATTTGACTTAAAGGTTGTTGGTAGACCTATGCCAGAGACGTTCTGGTTTCATGATG
>TTN-215,ENSE00003811446,1,165,3462721,3462885,GCCAGCAAATTGTCAATGACTATACCCATAAAGTAGTCATTAAAGAAGATGGTACTCAATCACTAATTATTGTCCCTGCCACACCCAGTGATTCTGGGGAATGGACTGTGGTTGCCCAAAACAGGGCAGGCAGATCTTCAATTTCAGTGATTTTAACTGTGGAAG
>TTN-215,ENSE00003805710,1,169,3462886,3463054,CTGTGGAACATCAGGTAAAACCGATGTTTGTAGAAAAACTGAAAAATGTCAATATAAAGGAAGGTTCCCGACTTGAAATGAAAGTCAGAGCTACGGGTAACCCCAACCCTGACATTGTATGGTTGAAAAACAGTGACATCATTGTGCCTCATAAATATCCCAAAATCAG
>TTN-215,ENSE00003809358,1,1694,3463055,3464748,AATTGAAGGAACCAAGGGAGAAGCTGCCCTTAAAATCGATTCCACTGTCAGCCAAGATTCTGCCTGGTATACTGCGACTGCTATTAATAAAGCTGGCAGAGACACTACAAGATGCAAAGTAAATGTTGAAGTTGAGTTTGCAGAGCCTGAGCCAGAGAGAAAGTTAATCATCCCACGGGGGACATATAGAGCAAAGGAGATTGCAGCCCCAGAACTGGAGCCCCTCCATTTGCGATATGGCCAAGAGCAATGGGAAGAAGGTGATCTCTATGACAAAGAGAAACAACAGAAACCATTTTTCAAGAAAAAACTCACTTCCTTAAGACTTAAGCGCTTTGGGCCTGCCCACTTTGAATGCAGGCTAACACCCATTGGTGACCCAACGATGGTGGTGGAGTGGCTCCATGATGGAAAGCCACTTGAAGCAGCCAACAGGCTCCGTATGATCAATGAATTTGGGTACTGCAGCCTTGATTATGGCGTTGCATATTCTAGAGACAGTGGTATCATTACTTGCAGAGCCACTAACAAATATGGAACAGATCACACATCTGCTACCCTTATTGTTAAAGATGAGAAAAGTCTTGTGGAAGAATCCCAATTGCCTGAGGGGAGGAAAGGCTTACAGAGAATTGAAGAATTAGAGAGAATGGCTCATGAAGGTGCACTTACAGGTGTAACAACAGATCAGAAAGAAAAGCAAAAGCCAGACATTGTCTTGTACCCAGAGCCAGTTAGAGTACTTGAAGGGGAGACTGCAAGGTTCCGCTGCAGGGTAACAGGCTACCCTCAGCCCAAAGTCAACTGGTACCTCAATGGACAGCTCATCCGCAAAAGCAAAAGGTTCAGAGTTCGCTATGATGGTATCCATTACCTGGACATCGTGGACTGCAAATCATATGACACAGGTGAAGTGAAGGTCACCGCGGAAAATCCTGAAGGTGTGATAGAGCATAAAGTGAAGCTTGAGATTCAACAGAGGGAAGATTTTAGGTCTGTCCTTAGGAGAGCTCCTGAACCAAGGCCTGAGTTTCACGTACATGAACCAGGAAAGCTTCAGTTTGAAGTACAAAAAGTGGATAGACCTGTTGACACCACTGAAACCAAAGAAGTTGTGAAGTTGAAAAGGGCTGAAAGAATTACCCATGAAAAAGTGCCTGAAGAGTCGGAAGAGCTGCGCAGTAAATTCAAGCGCAGAACAGAAGAGGGCTATTATGAAGCCATTACCGCTGTGGAGCTCAAGTCTCGAAAGAAGGATGAATCCTATGAGGAACTCCTCAGGAAGACAAAAGATGAACTTCTCCACTGGACCAAAGAGTTAACTGAAGAGGAAAAGAAAGCTCTTGCCGAAGAAGGCAAAATCACGATTCCAACTTTTAAACCTGACAAGATTGAACTAAGTCCTAGTATGGAGGCTCCAAAAATCTTCGAAAGAATCCAGAGCCAAACAGTGGGCCAAGGATCTGATGCACACTTCCGGGTCAGAGTCGTGGGGAAACCAGACCCCGAATGTGAATGGTACAAAAATGGTGTCAAAATTGAACGGTCTGACCGGATCTACTGGTACTGGCCCGAAGACAATGTTTGTGAATTGGTCATAAGAGATGTGACTGCTGAGGACTCTGCCAGCATCATGGTAAAAGCCATCAACATAGCTGGAGAAACCTCCAGTCACGCATTCTTACTTGTCCAAG
>TTN-215,ENSE00003809440,1,282,3464749,3465030,CCAAGCAATTGATCACTTTCACACAGGAATTACAAGATGTTGTTGCTAAGGAAAAAGACACTATGGCAACCTTTGAATGTGAAACTTCAGAACCATTTGTCAAAGTGAAATGGTATAAAGATGGTATGGAGGTTCATGAGGGAGATAAATACAGGATGCACTCTGACAGAAAGGTTCACTTCCTCTCCATACTGACCATTGATACGTCTGATGCTGAAGATTACAGCTGTGTACTTGTGGAAGATGAAAATGTCAAAACGACTGCTAAACTTATTGTTGAAG
>TTN-215,ENSE00003802960,1,267,3465031,3465297,GTGCAGTTGTTGAGTTTGTGAAAGAACTTCAGGACATAGAAGTTCCAGAATCATATTCAGGAGAATTAGAGTGCATTGTATCCCCAGAAAATATAGAAGGAAAATGGTATCATAATGATGTGGAGCTTAAATCCAATGGCAAATATACAATTACATCTCGTCGTGGACGTCAGAACCTCACGGTCAAGGATGTAACCAAGGAGGACCAGGGAGAATACAGCTTTGTCATCGACGGGAAAAAGACAACCTGTAAATTAAAGATGAAAC
>TTN-215,ENSE00003804241,1,273,3465298,3465570,CCCGCCCCATTGCTATCCTACAAGGACTTAGTGACCAAAAAGTCTGTGAGGGTGACATTGTTCAGCTTGAAGTTAAAGTCTCCTTGGAAAGTGTGGAAGGCGTCTGGATGAAAGACGGCCAAGAAGTGCAGCCCAGTGACAGGGTTCACATTGTGATAGACAAACAATCTCATATGCTGCTCATTGAAGACATGACTAAGGAAGATGCTGGAAATTACTCTTTCACCATTCCAGCCCTTGGCCTCTCCACCAGTGGGCGTGTCTCTGTCTATA
>TTN-215,ENSE00003806988,1,264,3465571,3465834,GTGTGGACGTGATAACACCTCTAAAAGATGTTAATGTGATTGAAGGCACCAAGGCTGTGCTTGAATGTAAGGTGTCAGTCCCTGATGTGACTTCTGTTAAGTGGTACTTAAATGATGAACAAATCAAGCCTGATGACCGTGTACAGGCCATTGTGAAAGGTACTAAACAGCGACTAGTCATTAACCGAACTCATGCTTCAGACGAAGGACCTTACAAGCTGATAGTTGGCAGAGTTGAAACCAACTGTAATCTCTCTGTAGAAA
>TTN-215,ENSE00003804968,1,261,3465835,3466095,AAATTAAAATTATCAGAGGTCTTCGTGACCTTACCTGTACAGAAACTCAAAATGTGGTGTTTGAGGTTGAGCTGTCCCACTCTGGAATTGATGTCCTGTGGAATTTTAAGGACAAGGAAATCAAGCCCAGTTCTAAATATAAAATTGAAGCACATGGAAAAATATATAAATTGACAGTTCTAAATATGATGAAAGATGATGAAGGAAAATACACATTTTACGCGGGAGAAAATATGACATCTGGAAAACTTACTGTGGCAG
>TTN-215,ENSE00003809850,1,261,3466096,3466356,GTGGGGCCATCTCCAAGCCACTCACAGATCAGACCGTAGCTGAATCCCAGGAAGCTGTGTTTGAATGTGAAGTTGCCAACCCAGATTCCAAAGGCGAATGGTTGAGGGATGGCAAACACCTACCACTGACTAACAACATCAGAAGTGAGTCTGATGGCCACAAAAGGAGACTTATCATTGCTGCCACCAAATTAGATGACATTGGAGAATATACCTACAAGGTGGCCACCTCCAAAACATCTGCCAAACTCAAAGTTGAAG
>TTN-215,ENSE00003806479,1,264,3466357,3466620,CTGTCAAAATTAAGAAGACTCTGAAGAACCTCACAGTGACAGAAACACAGGATGCTGTTTTCACTGTCGAGCTTACACACCCTAATGTCAAAGGTGTCCAGTGGATCAAAAATGGAGTTGTGCTGGAATCCAATGAAAAGTATGCTATCTCTGTCAAAGGAACAATTTACTCTCTGAGGATTAAAAACTGTGCCATCGTGGATGAGTCTGTTTATGGCTTCAGGCTTGGAAGGCTTGGAGCCAGTGCCAGACTGCACGTGGAGA
>TTN-215,ENSE00003804523,1,261,3466621,3466881,CTGTCAAGATCATTAAAAAGCCAAAGGATGTGACAGCCTTGGAAAATGCCACTGTTGCCTTTGAAGTTAGTGTTTCCCATGACACTGTTCCAGTAAAATGGTTCCATAAGAGTGTGGAAATTAAGCCAAGTGACAAACACAGACTGGTCTCAGAAAGGAAAGTCCACAAGCTGATGCTGCAGAACATCTCCCCCTCAGATGCTGGGGAATACACAGCTGTGGTCGGGCAATTGGAATGCAAAGCAAAACTGTTTGTGGAGA
>TTN-215,ENSE00003807378,1,261,3466882,3467142,CATTACATATTACAAAAACCATGAAAAATATCGAGGTGCCTGAGACCAAAACTGCCTCTTTTGAGTGTGAGGTGTCCCACTTCAATGTCCCTTCCATGTGGCTGAAGAATGGTGTGGAAATTGAGATGAGTGAAAAGTTCAAGATAGTTGTGCAGGGAAAACTCCATCAGCTGATCATCATGAACACCAGCACAGAGGACTCGGCAGAATACACATTTGTCTGTGGCAATGACCAAGTCAGTGCCACCCTGACAGTCACCC
>TTN-215,ENSE00003807271,1,261,3467143,3467403,CAATCATGATTACTTCCATGCTGAAAGACATCAACGCTGAAGAAAAAGACACTATTACTTTTGAGGTGACAGTGAACTATGAAGGCATCTCTTACAAATGGTTAAAGAATGGTGTGGAAATCAAATCAACTGACAAGTGCCAGATGAGAACCAAAAAGCTCACACACTCACTGAACATCAGGAATGTTCACTTTGGGGATGCTGCTGACTACACCTTTGTGGCTGGAAAAGCAACATCAACAGCCACACTTTATGTGGAAG
>TTN-215,ENSE00003808172,1,142,3467404,3467545,CTCGTCATATAGAATTTAGGAAACACATTAAGGACATTAAGGTACTGGAGAAGAAGCGAGCCATGTTTGAATGTGAAGTTTCTGAACCTGACATCACTGTACAGTGGATGAAAGATGACCAGGAACTGCAGATCACAGACAG
>TTN-215,ENSE00003808223,1,166,3467546,3467711,AATAAAGATTCAGAAGGAGAAATATGTCCACCGCCTTCTGATCCCATCCACCCGGATGTCTGATGCTGGGAAGTACACAGTGGTGGCAGGAGGCAACGTGTCAACTGCAAAACTCTTTGTAGAAGGCAGAGATGTTCGCATCCGAAGTATTAAAAAGGAGGTTCAG
>TTN-215,ENSE00003810851,1,232,3467712,3467943,GTCATTGAGAAACAGCGTGCTGTTGTTGAATTTGAGGTCAATGAAGACGATGTTGATGCCCACTGGTATAAAGATGGCATTGAAATCAATTTCCAAGTTCAAGAACGACACAAATATGTAGTGGAAAGAAGAATCCACCGAATGTTTATCTCTGAGACCAGACAGAGCGATGCAGGAGAATACACCTTTGTGGCAGGAAGGAACAGGAGTTCTGTCACTCTCTATGTCAATG
>TTN-215,ENSE00003802092,1,285,3467944,3468228,CTCCTGAACCGCCCCAAGTTCTGCAGGAGCTCCAGCCTGTCACTGTGCAGTCTGGCAAGCCTGCCCGCTTCTGTGCCGTGATATCCGGAAGACCACAGCCCAAAATTTCCTGGTACAAGGAAGAGCAGCTGCTTTCCACTGGCTTCAAGTGCAAATTTCTTCATGATGGGCAAGAATACACGCTTTTGCTAATTGAAGCCTTCCCAGAGGATGCGGCAGTCTATACCTGTGAAGCCAAGAATGACTATGGTGTTGCCACAACATCAGCTTCACTCTCAGTGGAAG
>TTN-215,ENSE00003807103,1,126,3468229,3468354,TTCCAGAAGTTGTGTCTCCTGATCAGGAAATGCCTGTTTATCCACCTGCCATCATCACCCCGCTTCAGGACACTGTCACTTCTGAAGGGCAGCCAGCCCGTTTTCAATGCCGGGTTTCTGGAACAG
>TTN-215,ENSE00003801355,1,189,3468355,3468543,ATCTAAAAGTGTCGTGGTACAGCAAAGACAAGAAAATCAAGCCATCTCGGTTCTTTAGAATGACTCAATTTGAAGACACTTATCAACTGGAAATTGCCGAAGCTTATCCAGAAGATGAAGGAACTTACACGTTTGTTGCTAGTAATGCTGTAGGCCAAGTATCAAGCACAGCCAACCTGAGTCTGGAAG
>TTN-215,ENSE00003789931,1,649,3468544,3469192,CAAAAGAATCGCAAGCCAGAGCACTTACAAAAATTACTCTGGGTTCTGACACTAAAAGTATTAAAACACTCAGAGAGTCACAAATTAAAACAACCCGTGAAGTAAAAAGAGAATCGTCAAAGAAAACATCAAGTTTGTCATTAACTTCATGCCAAAAACCGTAAGAAACTGAGAACAAGGGAATAAAGTCTACTGACAGGATACCACGTGGACTGAAGACTGAGAGTGATACGAGAGCCCCAGCCTTTCCCAAGGAGCTGCCCTAGATATGACTGTGTCTAAAAGCTGTGCATATTCCTTGTGGAATAAAAACAGTTTTGATAAGTCTTTGTTTTGTTTCTTAATATGTAATTTGGACTTCATGTAGTTCAAAGTTTGAAAGGTGATTCAAATCAAAGGAGTGTTTACTAGCAGGAAAAACTGAGAATAGCCCTCTGCTAAAGTAGCAATTTAGAAAATGCATGTTCTTTCTAAATGTGATTTCATCTCTTAGCAAGTGTTTAGTCAATAGGACATTTTTTAGAAAATAATATTCCTTCGGTTTGTAGATTGCTTTCTGCATGCATGTAAAGGCATGGGGAATTATAGAACTAAAAGTGGAAATTTCATGAAGAACCTAAAATAAAAATGTTTTAAATCTTTCTGTCAA
>TTN-215,,0,2556,3469193,3471748,GTGAGCAGCAACTTTTCTTATTTTAATAGTAGAGTCACTTTCTTATTGATCTCTGGCTCTGGATTATTTGTGTGTGCTAAATGCCTATGTACAAGTGTTTGTATGACTATTTCTTGCCAGTGCTGACCCATTATTTAAATCTGCTTGTTAAATTCTATTTTAAAATGTCTGAACATTTTTCCTTAAAAAGTTGAAAGCTTTATTATATCAGCTAAATGATTCCATGATTCAAATTGTTTAAGTTCACTTAATATTCTAAAAGTTGAGGTCTGAAATGTTGAGAGAAATGTTTACTTCTTTTCTAGACTCTCTTTGCCTGTTGAGAATGTTCAAGGTTATATTACTCAATGATAAAGTTAAGCACACCAAGAATAGCTCTGATAAAATGCATGTGGTATCAGCTACACCCTGATGACTTTTTAAGGGAATCAACTGCTGAGGTATCAGTTGCAGGACAGTGACAGAACACTTGCCTGCTGTCAGTCAACCTTGGAGAGTTTAGGAGAGTTTATTTTAAGAGCATGACATTTTAGACGCATACCTTCAGCCCCAGTTAGACAAAGGCCTGTGAAGAGCAAGTGCTAAGGCAATAAAATTTACCTAGACAATAGGAATGTAAGATCAATTTAAGCTGGTTAATTGCAACATAGTTGGAGATTTGGAATAAAATGATATAATTGTTTTCTAAAATATTCAGAATCTCTTCATGCATTTTAACTCAGCACACAGTCCAATTATATATTTTGAGATAAATGTTGACACTAAGAAGGGTAAGAAATAATGTTTAAAGGAAAGGTTTCTTACTTCTAAATACACTTTGATTTCTCATCTTCCTAGAATTTGATTACTAATTGTCAATGCCTGTAAATACATAGATATATAATTAGGTATTCTATGTCTAAGAGGACAGCTATTTTTAGATATACTAACTTATAAACAGACAAAGTTAGACACAGAAAGTTGTTCATCCCAAAGATAATATGCTACAAAAAGGAGTTTCTGACAAAAAAAATTTATGAAAGCTTTTGGATATTATCTGATTTTTCCAAATATAAATTTTATTGTCTCAGAGAATGCTGGTTTCATTTTTTTAACTAAGTAGAAGGTTACAGTAAGGAACAGAATTATCACTAAGAAGATTATTGCTCCATGAAGTTTTAGTAAACAAAGAATTTAATGAAAAATAGTAATGAAGTGATTGACAATTCAGAAATGTTCTATTTCAGAACAGAATAGTCATGTTGAATAATTAGGTATTTATGCATCAGAAAATTCTTCACATAATGTCTCTGAAACTGATAGGCAAAGTACTTTCTTGCACTTAACAAAATGACTTAACTGCAAATTTTATATTCGTTTCTTTGATGTTGAATATTTTACTTTATGAAAGCATAGGCCTTTTCACTTCATCTACATTTTACACCAGCCTTCCATTATTCAAAGTTTGCAAATTGTTCCATATTAAGAACTCAAGCCAGCATTTTTCTTTCAGAACTATAATAAACTTTGGCCTGTTCACTAAAATTTAAATTTTTCTGAATATTTACTTCAGCAGTAACAACATTTACTGCACAGTTACAGTATGAAGAAATGTTAAGAAATAGAAAGCACCGTATGCCGTCTACAAAAAGCTTGCATATTTGATAAGGCTTGCCAAAGCTTCTCCAGTCAGGAAAGAGATTACAAAGTTCAGATTTTTACTTCTGGCAACTATTTTAAGTAATCAGATAATGTCTGAATCAATGTCAACTTTATAAATATAGAGTGAACGAAAAATATTGGGGAGAAGGAAAATTTTTAAAATAATTTTCACTTACTAAGCTGATGCAGAGGTTTATTTATTTTAATTTTTTTTTTTTTTTTTTTTTGAGACAGAGTCTCATTCTGTCACCCAGGCTGGAGTGTGGTGGCACCATCTTTGCTCACTGCAACCTCCACCTCCTGGGTTTAAGCAATTCTCATGCCTCAGCCTCCCAAGTAGCTGGGACTACAGACATGGGCCACCACGCCTGGCTAATTTTTGTATTTGTAGTAGAGACAGGGGTTTCACCATGTTAGCCAAACTGGTCTCAAACTCCTGACCTCAAGTAATCCTCCCGCCTCGGCCTCCTAAAGTGCTGGGATTACCAGCATGAGCCACCACGCCAGGCCCAGAGGTTTATTTTACATTTATCACATGTCTTGTCTCTCTAATTACACTTCACTAACCCTGCATTGCTGTGGTTTTCTTCTTCAACTCTGAACCTGGTTTTCCACCATTGGTAAGACTGTATATTCCCTCTTTGACCACTAGGGTTCATTCCTTGTTCTGTTTGGCTAATACTTTTTTCCATTTCCCCTTACACTTGCTACTTTGGGTTAGGCTTTAAGTCAACTCAATGATGAACTATGCAAAACTGTTCAAGCCACAAAAGAGAAGACCTGCCCATCACTCTAGGCCCACAGATGACCTATGGAGCAATCCATTTGGAGAAACGTGTGTCTCTGCTATCTGCAAAGCAGCTCCAGAGTGACCCTTAGCTGGGACACCCTAATTTATTTTCTCTTCTTTTTCAG
>TTN-215,,0,2210,3471749,3473958,GTAAGCTCACACATTCACACTTTTGTTTTTTTTTCCTTTGCCTCCTCTCCAGTAAGTTAACGTTGCTGCAGGACTTGACGCCAAGTTTAAGCCCTGCTTTCACTTCGGAAAATTAGTCCAACACTATGGAAAGGTCATTTTAAGGGTATACCATTCACAGAGTACTGACAAAATCTGACAATATAATGGCTTGAAATGTTTTATTCATATTTATTATTCCACAAAGCAAAAATAATTAGTGTTGGATTAAAATTGCCGTTAGAATCCAGCAACTAAATAGGACCAAATTTAGTCATTCTATATTTGGGCTCAGCTGCAGAGCCAGACTGGAAGCCAAGAACTCAAGCCCAATAGAAGCCAGCCACAGAGCCATGGGGTAGGCAGTCTGGGCTGCCTGCTCTGGACACCTGAACTTCAGTTGGTTCACACGCAAAATAACAGTGCATCTAATTTTCCTCAGAGGCAGAGCTGTTCAGTAATTAACCAACTCCTCATTATTTTATTATTTTATTTTCAATCTTTATTGAGTGATTCTAATGAATTAAAAGACTTTCCAATCGTTTTGAAATGACAGAAAATAATATGCTTCTCGGGTGTCTCTATTTAAAAGGAAGCAAACACTAACCCTAGAATTTTATCTGAAAGGAAGTTCATCTCTTTTTTGCCTTCTTTTTCTTCCTCATAACTCAGTTTATGGATGGTTCAAAAAAATGCATGGTATCATCTTATGAAAAAATGGAGAGTAGTGTATGAACTATATTGTAAATAATTTTAAAATTAATCAATATTTTCTCTTTCTGTAGTATTGTAACGAGCCATGTAAGATGGATACGGATTAAAAAAAATCATGCTTAATTCTTAATTTAGTGCACTTCCATGGTTCATTGCCCACTTCTTTTTTAAAATTTTATGGCTTATAATAAAGATATAAAATAAAATTTCTTTTTTTCTCTTTTTTTCTATTATATGCACCAATCTTATTCATAACTGGATAATACTTTCTTTTACATTGTACAAATATCATATAATCATTGCTTATTTTCTATTGTACATATATAGACCAATGAAATTCCCTTTTCATTGGTCTATATATGTACAATAGAAAATAAGTCTTACCGACTTCCAAATAATTTACCTATTTATCTGGTAACACTCAGTAACTTCTGAACTGAGCAGAACACATATGACTTCAGTGGGAATTTGCCTCCTTGAGAAGTAGTGGAATCTGGCTACTTCATATCTTCTTGTTCCTTCAAACTATATGCAAATAAATTATTACAAAGACACTACTGAAAATATCCAATACCCATAAATCAGTCCAATAAACTATTTAATTGGCCATAGTGGGAGATGGGCTAATGTATAAACAACAAAATAGACTTTCTCTAGATTATCTTTACCTACCAGCGTAAGTAGATAGAGCATCAACCTTTATGCCAAGTGTGAAATAAATCATGCCCTGAATGTGCCTCGTACATTCTCAATGTACAGAGTTTTAATATATTTAAAACATCAAACCATGGACATGTAGTTCTTGGCTCTACAATTTATGGCAGATAAAGAGAATTTGGCTTTCTACCTGCAATTCCAATGATCCATGTTGTTCTGGAAGACTAGGTTTGGATTAGTCTCTTATGAGAAATTGCTTGTCCATGTTACAATGTTTTTACTGATTGCACTTGTGAAAGCAGAAGAGTCCAAGAAGACAGTGTCCCTGTAACCACAGAGGAGGGAGGAGGGCATGCCTCCTGGGCTTGTCAGGCAGAAACTGGAGATCAGTTTGCTGCTTTTGTTCTTCACTTGCTCTCAAAGAGGACAACAATCACTCTTTATTTCAAATTTTCCTTGGTTCTTCATTTTTATAAGTCCCTTTCATGATTTTAATGTTGTCTATTAAATTGCATCAGATAGAGCCCTAGGCAGGCAGGCAGGAGATGGAAATTCTAGTCCCCTCTGTGTCACTGCTAGCTGAAGGACCTTGGAAAAATCATTAGGCCTCTTTTGGTCTCAGTTTCCTCCCTTCCTGCCTTCCTAATGGTCTGCAGGTTTACACACTGATCATGCAACTGTAGGGTTTTCCCTATCATTAAGTGGCATTCCATGCTGGAAAGCTTTTACAGATTCGGACAAGGCAGTGAACATGATGGGACAGAGCAGAGGACTTTGTGGTGCCCATTCAAACATAAAGGTGAATTGTTCTTGCTCTTCAG
>TTN-215,,0,1455,3473959,3475413,GTAGGCTGCTGGGGACCTGCCAATCCTCTGCTCCCCCAGAGGACATCTCCAGCAAATTGGGAAAGGAGTCCAGAAAAAGCTATGGGCAGAGGTAGATGCAGCTCTTAAACTACAGAAGGGTCTACTGGAGGCTGAATTATTTATAACCAAGTTGTTTGCCTTTTGGAATTTAATTTTCCTCTAGAGTACATCGTAAAAGTGACTGAGAATCAGTTTCTCAATACACATATTAAACACTCAAAAGTATGTTAAGGAAATATTAAAAATCATGTTTCTCAGCAAGTAGAAAAGCTTGGAGCCTTGTTTATAAGTCCTTTAAGGAATAAGACATATTCTCCAGGGAAGTGTGAATCTCCAGGAATTCACACTTTAACAAGCATCCAGATAATTCTGATGCCGGTAGTCTACAGACCACCCATTTAAGAGGCATGTAAACATACCCAGAAGAAAATAAATGCTTGTTTATTATTCAAATGCATGACACTGTTTCCCCAGAAAACTTATCACCAATCTTAGTGGCCTCTGTTGTTTTTCTCTATCCTTTACTACCTAGTGAGACATTAGTATACAGAATATTGCATGCCTTTACATGTTTTATAACAATATCTTACATGAGCTACGTAAAGTTACATATGCTTATCCAATAAACTTTACCTTCAATGATGTTCAATTATAGGGCTATAATTGACCTAAGCAGAAACCACATCAAGTAACATCAGGTAGAACTTTAGCATGCACCCAGAAAATTCACAAATGGAAAATGCACAGGGTTGGCAGCACCTGCTGTTGTTTATTACTCAAAATCATGTCAAAGTTAATTCCACTCACTCCTCACACTTATAAAAAATTTCCTTCAACATAACCAAAAAAATCCCCTTTCTGTAACACAATTAAAATGAAGTAATGTTATTATTGGGATTAACGTTTTAAATGCAAGTAAATATTTGGGTTATTTGAATACCTATCAAGTTGGAGAAGGTTTAGAATTTTAAAAATTAAATTAAAAATGTAATGATTCTTTAAGTAACAGGTACACCCATCGTAGCAACCACTGGAATTCATTTTAATGCAACTTACTGGAATATGCAACATGGCTTTCACATATTAATAGAGCGCTAGATGTGAGGTAGAGGGGGAAGTACCAGAAAGATTCTCAAGAAATGTTATAACAAAATCTAGAGCTTTTATTTAAAACAAAGAAACAAAAGGTGGTGGCCTAAACTGCTCAGCAAAACAAAGCAAATAAAATAAAATATGGTGGTGAGAAAGCCTTCTGTAATCTCCTGGCTCCCATTCTTGCTGTCATTGCTGGGTGAGCTGGGTTCAAGGACATTCAAGGATGTTTAGATTGGCGAGTCATCACCTGGTTTTGGAATTGGAGCTGTGATTATTTAAAAATACCTTGTAGGGAGCACCCTGGCTCTCACTCTTGACTTTGTTCTCTTGTCCCCGCAG
>TTN-215,,0,484,3475414,3475897,GTACGTGCTGGAGGTTGAGGAACAGAGAGAAGGGGAGAGAGCTGGTTTGTGTCTAAATGGGGCCAAGCGTCCACTTGCCACCTCTCACAGCCCTGGGAAGAATGCTGTGAGCTGATATAAAAGCTGGCTTTTCGACACCCATGAAAAGTCCCTGAGATTCTAGTCAGGAGCGCAGAATAGAAGCAATCTGTGCTTATGAATCTCATTATAAACTGGAAAGGGTTTCAATTAAGTGATCTACATTTCCAAATTATTGGCAAATAATGAAATTTTAAAAAATCATTCTAAGTAAATTTTTATCTTGTAATGAACATTTTCTATTTTTAAACCTAATTTATATTCATGCAAAATCCAAAACTTTCTGCAATTTTCTCCATTGGGATATCCAGAAAATCTTTTTGACTTTGTAGTCAGAATTAACAGAATCTCTTTTAAAATGGGTCATTGTGCCCCCTCCCAAACATTCATCTTTCCCTTCCCACAG
>TTN-215,,0,93,3475898,3475990,GTATTTTTCTATACTGTTGGTTTTCAAGCCTTTCAGGCTGTTGCGTCCCCAGCTATTCCTCCTCAACGTGGGCTTTGTTTTAATCTTTTACAG
>TTN-215,,0,4234,3475991,3480224,GTAAAGCTGCCATAGAGAGAGCAGATTATTGCACATTTTGGAACTAGGTTTTGAAACGAGAAAGATTCCCTTGTCCCCCTCGCAGGGCATGCGACGCGGAGAGTGGTTCGCTTCTTCAGTGTCCCGCTGCTCAAACCTCTAGGGGAGCATACAAACGGGCAGGTTGTGGGGCTCCGTGTTCCTCTGGACATCCAGCCGCTTGTGTGTCTGCCTACTAGGGTCTCAGGGGTTTTTATAGGCATAGGGTGTGGGCGTGGCAGGTCAGGGTGATCTTGGGAAATGCAACATTTGGGCGGGAAGGCAGGAGTGTTTGTCCTCACCTAGGTCCATGGGCACAGGCCTCGCTAGGGACCACGCACTTCTCTTCCCAGCACTTCCCTGCCCTCCTCCCGTGTAAGTTTCATGCACTCAAAAATGTAGCAGGTGACAAAGGAGGTAAACCAAGAAGTTACTGAATATGATTTTCACAAATCCTCACTGTCCACAGGTAAATTGAAGACCCTTATAAACTTCTGAATTCTTATTTATATTTCATGTAATAAATATCTACTTTAGGGGCCAAAATATGGCACAGTGAAAGGAGAAGAGCACAGAAGTTAGAGTTCAAAGCCCTAAGGACAAATCAGCCTGATCACTTAACAGTTTGATTTAGGGCAATAAGTATAAATAATAAAATAATTGTTATTATATATGGATCACTTCCTCTATCAGATTGGAACTATACATACATTATCTCATTAAATGTTCACAACCTGTAAGAATTATTATCCTCAATGTTATTGATAGGTAACTGGAATTAAAGAAGTTAAGCAGTTTATTTAAGGTTTCAGTTGTGTCATCTGTAAATTAAAGAGAGTCACAATAAGAATGATCTCAAGCTGCATTTTGGGGCTTCAATGAGATAATTAGTTGAAAGTGCCTTGTAAATAGAAAATAATTATGCCAATATTCTTATATTCAGATGGTAAGTAAAACCTTTTAAATATTTTGCATATGCTTGTGTTATTTTATCTAGAAAATAAAATGGACTTCTATGCTTACTTAATATGGAAGTATTTTAGAAGGTGATCATGTATCATGATCAGGGCTCAGAAATTATATAATCAAGTGTAAATTGTCCACAACAGTTTTGAAAGTTTGGGATTTAGTTTATCATGATGAAACTTTTAATATGATGAAATGAAAAATGTACAAAATTTGAGCAAAGAAGTGTTTATTGATCAATTTAAATGAAATAAAAAACACATGGATGTTCCCTGCCAAGAAAATTTTTTATAAAAGAATAATAAGGAGATAGTTGACCTAAATAATATTCAAACATACTGTAAAGTTACTATAATCAGAACAGTATGGTATTGGTAAATGAATAGAAAAATACACCAGGGGAACAAAACAGAGAGTCCAGAAAGAGATCCAAGTATAATAGATCCAAGTATATAGGGAATTCAAAAAGCAAAGTGGCCTTTCAATTCAGGGGAGGGAGAGGTATTTTAATAAAGAATGCTGGTCCAATTAGCTATCCATCTGGAAGCAAACAAACATAAACCTCTGCCTCTCACTATTTACAGAATAAATTTCAGCTTGATTAAATAGTTAAAAAATGAAAAAAAAAGAGAAGACAATCTGCAAAAGCATTTATGGGTGAAAGCTTTTAAAAAGACAGTTACAGATTCAACTACATAAAAATCAACATGTATGTATGGCAAAAGCAAAAAGTCATTTCTAAACCAAACAGCACTTGTGAAAAAATTTTAAGACCTTTCTCCTCCTCAAGGTACTTCATTGCCTCTGCCATAAAAGTATCACAATAAACATAAAATGGCTACAAGGTAGACAACACCAGCCTAGAAACAGTATATAACATACAAAATTACGTAAGCTTATGCTGGATAAGACCCATAAACAAGCAAAATATTGAAATGGATTAAAAGAAATGGATCTGGGGGAATGTTTGCAACACTTACGACAAATAACCAATAAATGCACTAAATGCATTAAAAATCATCCACAAATTAATTTTTAAAGGAAAAAAATGCAACACAAAAAAAGACAAAAGATACAAAAAAGTATTTAACATAAGAGGCAATGTAAAAGTCCAATAAACATGTGAAAAAAAATGCTAGATGTTTTCCAATTTTTATTGTTTTAGCCACAAAAATGTAAAGATATTGGCAAACACTAACATGAAACCTTGAACAAAAAGCTTACTTTAAAAAACATGTCTAGCAGTCGAATAAAAAAAAATGTTCAGTCTCAGGCTAAATCCAAGTTTGCACACCATGAAATCACAACACAAGCCAAATGCAATTTCTTGAGGAGATAACAACCTAACTATATTTTAAAACCCAAGCCTAAGGGTCATTTAGAATCATGGAGTGTCCCTGATCCCATGGAGCATTTTGACCATCTTAGCAGTTTTGAAAGTTCATTAATAACCATCCAAATTGCCCCAAAATTTTGCTTTCCAATAATTAAGAAATAAAATGCCAATTTGCAGAGAAAATAATGGTTATCAAAGATAGACTGCTTCCTAAATATCTCATAGTTTAATCTTGATTTTTGTTGTAGAGTAAGGCAAACATATTTCATTGAATAAGGTGCATTGTATCTCGCTGTGACCAGGTGATTATTTTTTGTTGTAAGTACAGAAATAAGCACTCTCCTATAATGACCAAAATTACAATGATTTTCACAGTTATGGGCTTACCTGTGTCCTGCTGTTAATCAGTCATGTCATGCTAATCATGTCTTTAACTCTTTTTGAATTAAACCCATTTACTAAGTACAGCAAGAACAAGGCACAGGGTGAAACTTAAAAGCACATGTCTCTTTGCTTTTCTTCAGTTAGTGGAAACCACACATTATTCTAACTTGGTTTTTGTTATATTTCAAAGGCAGTCATGTTCAGAAAAGAGGCTTATTCCCTAGATTTCCCTTTAGTTTGATTACAACTTCATTTACAAAATGTAAATGGATTTTCACACAAAAAAAGCCATTCTTCGAGAAAATAAACATTTCTTCGTGAAACTGGTTAATGTTGTAATGTACTGTTAGGGTACTCTGTAAGTTAGAGAAAATATCAACTGTACCTTGAGCTTAATTAGAATAATCATTTCATGTATGATCAGTGTAAGCTAAATATCCTAGATAGTGACAAGATGCATTTATAAACATTTTCTTATATGCAGAATTAATAAAATGCAATGATAGGGCAATACTGCCACCTAGAGAGGAAAATGTAATAAGCCTTATTAAGAATTAAATCAGTTCTGAAAAAAATTTTACCTTACAATAGTTGGCCAATCCCCAGAATTATTGCTATAGATCAGAAATAGTCTTTTTTGGCCATCAGTGCTGGGATTTAGCACCCAAATTCTTCAACTGATGCTACTTGCACTTTGGATACACCTAAAAAGCAAACAATGAAAACTATTCTGGAAGAAGCAACTTTATCAATTTACCCAAAAATCACAGAATCATTAGTTTTTAAGTTAGTCAATTCCCACAATAACTCTAAAGATATTTAAAATAAGTCCAGAGTGCAATACAAGGGGGGCGAGTGTAAACAAATATGGAGGAAATTAAAAGTAGCTGTCCACAAACACTTCGGCTAAAGCAGCAATTTGCAAAGTGCACTGCACAACCTGTACCCAGCAACATGCTGCAGAAAGCTTCCTGAGGATGTGTCCCCCTGTCCTGGAAATTCACAAGGCATACTGACATAGTAAAGGCTGTGGGAAGTCCTGCAGGGGAAAAAAAAAAATGGCTTAAGCTGCTTAGTCAAGAGTGGCACAAGCATTTTGATTACAGAAACCTTTCTTCTTATAACACCTATTTGACATCCTCTAACCCCCCCAGAATTGGAATACAGAGATGAATTTGGAATACAGAGGTTGCTGGATTTGACATGTCTTTCCTTTGGCTGCATATTAAAGAAGTAGCTTTTTCTGTTGTGATTTTTTTTTTTTTTTAATGTGAGAAGGTGCAAGGCACAAAATCTCCAGCTTATTTGGAATTAAAGCTGATTCTCTTACAGGGTTACAGCAGATAAGAATAGGTTTATTGAGATTTAAAACAAATTACTTCCAAGTACATTATTTACCCTCTGAATGGGTTATGGAGGCACACATTTTAAAACTCTGCCTTAAAGCACTTCCAGCTTTTCATCTCATGATTCACATCCAGTTACCCCTCCTTGCTTTGACATTCTTGACCTCTGCCTTTTGGTTTTCAG
>TTN-215,,0,370,3480225,3480594,GTACTGTCAGAATGGTTTTGTTTTTCCTTATTTCACATTCTAGTTTCTCCAACTGGATTTCTGCCATGAAACTCAGTCTGTATAAATTGGAGGAAAAATGCATATGAACATAAAAATATAGCAGCAACTGAAGACCAAATTCAGTAGTCATGCTTTGTAAAACCATTTTTAATTAGGACAAAAGCTCCAATCTGTGAAGTTTCCATAATATACAGGTTTTAATGATACAGTCTCTGTATTTCTTGGCAATAATAAATGCTTATGTATGAGTGTATTTTGCTCTAGGTGGCTCAGTTTTCCAGTATGCTTTTTTATTTTCTACTGGGCATGTCATTTAAAAAAGTAATCTACTTGGTCATTTCTAATCTAG
>TTN-215,,0,857,3480595,3481451,GTACGTGCGAGGCTGCCATGGGGCACCCGCAGAGCCACGTCCTTCAGTGCACATTAACTCAACCACCATCCACTGAGCTTGGCATGCAGCTGTGCTCAATTCATTCTGAAGACAGCCTTGAGCCCAGCAGGGCCCAGACTTTTAGAACTTTCTGAGCAAAAGGTGGTCGGAGATGTCAAAGGTGTTGACAATGTGAGTATCACAAGAGCAGAGTAGGCCAGAAATACCTGGGCTATATGAGCAGGCAAAAGTCAACTATGGTATTCAAGGTAGGAAGGCAAAGAGTGGCCAGAGAAACAGAGACCAGTCAATTCCAGAGCTCAGTCACTGCACACACTGGATGTGGAAACTACTATTTCAGGGAAGGCATTACATTTCTCTAAGTTTCCCCAAAGGACTTTTGTTTTTACTTTTCTCAAAACAAACATGACACTTGATTCATAGCTGGAACAGTGTCATAAATCCAGGATAATGTCCCACCTCGCATTTGAATAGATTTTCTGTTACAGTTTAAAATCATTCCAGCTTTCCTCCTTATCCTCTTGTGTGACATTTATGTCTAAATCCTGACAGATTATTGTAACTTTTTTTTCTTTTCTGAGACAGAGTCTCGCTCTGTCACCCAGGCTAGAGTGCAGTGGCATGACCTCCGCTCACTGCAGCCTCCGCCTCCTGGGTTTAAGTGATTCTTGTGCCTCAGTCTCGTGAGTAGCTGGGATTACAGGTGTGCGCCACCACACCCAGCTAATTTTTGTATTTTTTAGTAGAGGATTTCACCATGTTGGCGAGGCTGGTCTTGAACTAATTTTTATGTAAGATGCATTAAGGTGTTTTCTTCCTTTCTCTATGAAAAGCAG
>TTN-215,,0,1206,3481452,3482657,GTGAAAATGGGTTTGTATTTTAAATTCACTGAGGTTCTTACAGGGGTCAACACAGATAATCACCTTTACCATGAAGAGTGTTGTTCCTTGGGCCACATGGTTGTTAGCATACTAATAAGATCCCCTTGTTGTATGTGTAAATTTCTGGGTACTGGATACCAAAGTTTGGTAGTGTCCCTGAATGCTCCCCTTGTGAGTATGAAAAAGAACTCTGTGAACATACACCAGGAGTAGAAACAGGGGTCTCATCACATTGATCTGGGGATGCACTAAGTATAAGACTATAGGGAGAGGACAGATGGCTAAAACCAGGAGGAAGAAATAGATGCTGAGGCAGGAATGGGGAAAAGTGGAGGAGACACTGAACTCACTTTGCTTTAGAAATCTTAGCAACTGCTTCCTGGCTCCTTCGGAAGACATTTGCACATGAGTTTGAAGTGGAATGGACAGCATGGCTTTAACAAGCCAAATGACCAGAAAAGGTGAAAAGGACAGCCCCATGGTTGGCGGCATTTGGGGACAGATTGGAAAATGCCAGTTAGTAGAGCTCTTGGCCAGTGGAACCAGTTGGCAGTTGGGTGGTTTGAGAAGATGAATTTCAAGTCCCTTTCAGCCTTGAGATCCTGTGTTTCAGTGATGAGATATTTGAGAATGGCAAAGAGGCAAATAGAGAAAACTGTCCCCCTACATACGCATATACCTTAGGTGCCCAGATGGAAACAGCATTCTTCACAGTATTTAGGAAAACTGACAAAACAAAAATATTGTATAAATGCAGATTATAAATTATCCATGCTTGATTTCTCACATGTAAAATAAAAAGATCAGACAAAATTACTTCTAAAGTCTTCCATTCTGATATATATTCTAAGATTACCTTTAGATGACAGAATTAGTACAGAATAATATTGCCATAGATCTATTTGTAAACATTGGAAGTCATTTTAAAGAAGACTACAATTCTGCTGTTCAAAACAAAGTGTTGAATTCAACTTTGTTTTCTCTAAGCAGCCTACATAATTTACAGTTTAAGGAGAGAAAGAGCATGATCTTATTTATGAACATGGGATTATTTATTTTATTTAGTGACATCTGCAGAAAAGGGATTTTACATCTTCAAATTCCTATGTTGTTATATTTAATAAACACCATATTATTTCATTGGGCATCAGGAAATAAAGTTTTTTCTTAAATCATTCTTTGCAG
>TTN-215,,0,1956,3482658,3484613,GTAAGTCTGATTTTCTAAATATTTTGTAGTTTGTTGACAATATCACATTACAGCCAGCTGCAGGTAGCTTATAGTCAAAACCCTTAAATGGAGAAGTCTTTGGTTGTATATTTTTTGTTATTGTTCCTCTATGTCTAGTATTGAAACTCAGGATGGAAATTATGTTCACATTGCACTATTTTCCACTCACTTGATCAGTTTTCAGGAGATTGTCTACAGAACAGTTTAGGGCACATCTATGAACTTTCTAGAACATACATAAATGGATGATAGATATCATGCCAGTCCAGTTACCCACCGGGACAGTTGGTTTCTTCGTGCATAGCCTAAGCCCTCAGTCACTTAGATTGTAATGCACAAACTTTACATGCACACACACATGCACACACACACACACACACACACACATATACACATACATCAGCCATAAACACCCCGAATAAATAGCAAGGGAAAGTGAGGATATGCCAGACATCGGAGAAAGCAAATACTTCCTCAAAAAAAAAAATTCCTTCAATTCACGGTTGATAAACAGTGACCTAGAAGCATTTGCTGCTGTTGTGCCGTAGAGCTGTGTGAGGACAATCTCAGTGTCACTAAAATCCACATCTCTCCCGTATGTGAAATCAAACCTTTAAGTGTCAGGAGAGAGGCATTTATCTTGAATTCTTCCATGTCAAAGAGGGCGCCTGTGCTCATCCTCCTTGAACTCAAGCTCTTTGCTGATCTTAGAGCTACTTTCTTTAAAGGTCCAGTTGAGAACCTTGTACACTTAAAAGGCTGACCAGAGGCTGCTGACTGAATTTCCCTCTCCTTACTGTGAGTGAGACATTTTGAAAGCAGCAAGAACCCTACTTAGGATAATCAAAGGCATAGAAATCCCCATTGCCATTGCAATGCTGGTGACTGGCAAGTTCAGCTGGCCTATGGTTTTCCAGCCACTTGTCAGCAGCCACCCACCGGGTTCCCTAACACGTTGACATGTCTCAAGATGAGATATGTTCAGTTCTAGGACAATTTGCTAAGGCGCATGTGGGCAGAAAAGAAGCCCATTCCTCAGGAAAGCAGTCTATGTATTAAGCACAAGTGTAGGCCCCTGAAATGGAAATCTGACATTTTATCGTTCACCACTAAGCATCCTGTATTTTCCTGAGTGTTTCAAGGATGTCTTCCCATTGCTTTTGTATCTTTTGAAACTCAAATCTTTATTTTACTCTAAACATCAGATAAGACAGGAAACTGAGATAACTGCTGCATCCATGGTGGTAGTTGCCACTGCAAAGTCCACAAAACTAGAAACAGTCCCGGGAGCTCAAGAAGAAACTACCACACAACAAGATCAAATGCACCTAAGTTATGAAAAGGTGATGACTTCCTGCCAATGTGAAAGTCACTCTTGCACCATTTCATTTGCAAATCACCTACATTTTCATCATGGATCTTAATCATCACTTCTTCACTTCCACCTCTTCTTATAATGCAAATAGAAAATTTCTTTTCCCACACAGCTACCTTTCACTGTCAATTCATTCCTAACTTTCAGACTTTCTTTGGCTTGTTACTAATATAATATAATAATTCACTTTAATATCTTCCTATTGAAGCAGATGTCCGTAAACAAGTCAATTCATAATACAAAAAATTATGTGCTATTTACAGTGCTACTGAAATGTCTCAGAGATTGCAGTTTTAAAAAATGTGAAAAGTACAAAATAGCACTCATTAGTCTTTTATTGCTAATCACATTTTTTTCTTTTAAACTGGACTTATTGTTTTGATATTTTTGCCAGTGAAACAGTATGGATGATCAAAGTAACTCAAATGATATATTTTAGTGCAATTAAAATTTCCTTGAATAGGAAGAAATTTTGCCTCCTTTCTTTTTGACTTACGTTTCTTTTATTAAAGATTTATGGAATTTAATGACTATTTTCTTACTTTCTTTTGTATGATCAG
>TTN-215,,0,480,3484614,3485093,GTGAATACAGATATTTGAGCTGTGAAAAGTTCATCTTTAAACTAATTTCTAGTAAACTATTAACTACAATATGGTATGAATTATTAATCTGTATTTGCCTTTTAAAATCCCTAACTAAAAACAAAATGGTAAATATGAGACTGATTATCATTAATTTTATCTGCACATTTGATTTTCATCCATCTGTAACATTTATAATTCATTTTATTCACCATTATTCTTTGCATGAAGATTAGCATTTTTTAGCTTAATTTTTAAAAAGTGACACAGGGACTCATCTAGAGGTTTTTTAATAGCTAACATTTCTAAGTTTTGTGATTCTCAGTCAGTATATGTAGACATTGCCGGTGAAAGTTTATTTCTCTTGTGTATTTAACCCTGAATAACCATCTTGCATCCCCATGAGGAAGGGGGAAGGGTCATACTATGTGTGTTTGAAGCCCTGTTCAACTTAAATCTTGATTTTACTGTAATAATCAG
>TTN-215,,0,3218,3485094,3488311,GTGACTATTGTTGTTCCAAGTGTGAAATCCCCTATTATAATACATTAATACCACATATCATGTGAAATTCCTTATTGTAATACATTAATATCAAGTCTCTGAATTTCTTATGTATGAGTCACTATTAACCAAATTTATTTTTTAGACAATTAAATAATTGGAAACTAAAAAAATTTATTATTGTTAATATTACTACATATCCCTTTCTCCACTTATCTCTTCACCATTATTGTCAACATTTTATTAACATCTGGGAATCTTCCAGAAGTTGATTAAAATTGCATGCAGGCTAATTTTAAGAGGCCCATGAACATTTTTTAAAAACACGGAAGATGTATAAGTAAATGATGACTCTTACTCACTGTCAAGAAGATGTGTGTTTTGAAGGGTCATAAATTCAGTATATTATGTTATGGAGTATGACTTATTTCAGTAAATTACCCATAATTTTCTTTGTATGAAACTTTATCTTTTTTCCCTCCTGTAAATATCAGAGGAGAAGATAAGCTGAAAAAATTATAATGCATGCTGTAGCAGCTCCCACTAAAGCTAAACAAGATGCATATTAAAATCTAGAGAAGGAAGTATCCAAACAGAACAATTACACATAAGCCATGAAAAGATTACCGTATCTATTTGTAGCTATGAAATATCCATGAATTAAACTGTTTCCCATGACTCTGTCATTTACTCCAAATGAGCCATTTACCTAATTGTATTCTTTATTGCTAATATACCACTTGAAAATTAGCAACTAAAGTTTTTCCATTTCATTAGCAGGATGGCCTGAATCCTATTTGTATTTCCCTCAGTGTCATTTTCTGACTCTACATCTTTTTTTTCTAAGATATGATTTAAGATAAACTTTTTAAACCTTTACTCAAATCTAACATTTAATGGCATATCAGCCTTTCAGAAGTCTCATAAATGACAGAAATTCCACTATGCAACATACTTCATGAGTGATTAACTTTTTACTTTTGTTTCCATTCAAATTTTGTCATGAATTGACTATCTTGTTTTTGTTAAAAATTAGCTAAGGATGGAAGCTGAGAAAATGTTTATACCTGAAGTAGTAGTTACCACTGCAAAATCTGCTGAACCAGCCACACCGCCAATGACTAGAGAAGGATTCACTATTAAACAAAAACAAATACATCTTTTTCGAGAAGAGATGAAAACTGATGCTATGGAGGTGAAAAGTATTGTTTCATCCCATTTCATCATCAACTCTCATAACTTTTCATCCGTCGTGAATTGTGCTTCTAGTGTTCCATCTAATTGTTTAACTGATCAATAAAACAATAGAGATGGTTAGATTCAGTCCATCCTCCAGTTGAACAGTGAGCATTTCTAGTAGTGAAAAGTCAGACCAAATAATACTCTTCTTTATGTCTCCTAAATTTATTCTCAGCATTTAACTCGTATGAATTGGAGTATTCTAGTCCAATTTGTCTTCCTGCTTCTCTAGGTTACAAACATGTGAGAGATATCAAAGTCCACTAAGAAATAAAAGCGGTTACCAGCATACTCATTTGTAGTCCACCAATAAGTGTGTGTATATAAATCTGATATACAATAATTCAAGGAAAAAACAGACAGATGCTTCCTCAATTTAAAATATTTTACCATGATTAAGATTTTTCCATATGTTTAAAATCAAGAACAAAATTTAAATATTTCAGTTGTGTGATATTTAGTCATATGACAGTTTCTTTGACAGTTTCTTTTATCATTGTTAAAATAAAATTAAGACTTAAGCTGACTACTTCATAGCAGACTGGCTAAAAGGTTCAAATGAGATATAGTGGAAATGTGATCACACTACAATCAAAATAATATTTATTTATTTAGTGTTATCTGTCGAAGATGTTAACATTTTAAAATGTCTATACAATTAAAGTCAGCTCATTGCCAATATAGTTTTTAAAAAAGAAAAAAATAAATGGACAAACTTAACTCACCTAAGCCTCATGTGTATTTTATGTTTTTTTCTGAGATGATGCAATCTAAAGTGAAGATGGTATTTGCAGTCCTTCGAGGCAGATGAAATTGTTTGTGTCTTCCTAAAAGGAAGCCCTGGATAAAGCCCATGATCACTAAAGACCCAATTCCATCTCAGAAAAATCTCATTTATATCTTGAATGGTTCAGAGAATAATTTTTAAAGATATGCAGGTAGCATAGTTGAAGAATGTTTCTGATGCATTCTAGATTCTATTCACAGGTATAGAAAACTGAATATTAATAAAATTTTCCAATCTTACTTTTAAAATGCACTTTTAAAATGTACTTTTAAAATGAACATGGCTATGTGATTTTTGAGGTATGCTGTTTCCAAGTATCACATAGAATCATAATATCTAAGCCACATCAGCTAGTTTGCCTTCTTTAAAAGAGAACCTCCTCTGCAAATTGTATTTCCATTAATGTTCATCAGACTCAGAAACGAGAAAATAATATTTGTTTCATTCTTTGCTTTAACTCTCCATAATAATGAAAGTAAATTAAACTTCAATGTGAAAGGTTGTTCTCTTGAATCCAAACATGATAACACTTTCATTTTAATCACAATATTTTTATTTGCACGGGGTTCTCTTTGTCATCTGTGTGTTTTAAGAAAGGTATTTTCTGATAGATTAAACAATCTTACCCTTAGGGAATCATAAGTAAATTCATATGCTCACTCTGTGTTTGTGAGCTTTCATGTTATGTCCGATTTGCATGCAACCATATAACTCTGTAGTCACTGATTTTTCTGGACAGGATGATGACGGTATTTGAGTGCACTTATATCATCACTGTCACTGCATTAATACCAGACTAAATGGTCAACAAGATAATAAAAATAATCAGTGAAAAGAACCAGCTCCAAAATTCTGATTTTCCAATTGCTGATTGATTGTCTGCCTGGAAAAATTCTAGAAAATTTCAAAATCTTCTTGTGATTTTATGTTCATATTGTGATTGTCCTATGTTGTGTATATGTGATTTAATGTCTAGTATAATTAAGTAGGTGTACAGAGAGTATATCTAAATAGATGTCTGTACAATATAATAATCAATGAAATAGTCCCTAAAAGTGTTTCTGAGATACATTTCTAGACACGTTAACACTGCTGTATAATGTGGACGCCATCTGCCTGTCCTGATGCCCAGGAGATATTCCAGCCTGATCTCGATATTCCTATGTATTAATTCTGGAAACCTTGTCTCCAG
>TTN-215,,0,105,3488312,3488416,GTGAGTCTATACCTGCTGATTTTTCACCTTGTTCATGGTAAAGCAAGCCTCACTGCTGTGGTCATCTGGTGATCAATGGTATCACTGAGTTTCATTTCAATGCAG
>TTN-215,,0,1268,3488417,3489684,GTAAGAAGTTACAGAGCATGATACAGAAATGTTTAAAGGAAATAAGTATCTAACCTGTGAAACAGAGCATCTCTGGGGTAGGCCAATGGAGGATTCTTTTTTGGTGATGTGTGTGTGCGTGTGTTTGCATTCACAGTGGGCCCAGACACCCTAAAGATTTGGTTTCTGAAACTCGCCCAGGGGAGTGAGCCTAGAGTCACAAGTGGTTATCTTATACCTCTGAGGAGAGACAAATCCACACAGGCTTCTCTCTAGTTCACATTTCAGGGACAGCTCAAACTCAATTGTTTTGATTACTATTGTTCTAATGATTTTGTGAAAGGTAGTGTGTTACACAGCATAGTTTTACTTATGCTGTGAGACATTTCAGAGTAACTTAACTGTGAATGTGTTTCAATAATAAAGACAGACATTGAGAAATCATATATTTATATACTCAATATAGCAAGATGGAGAGGTGGTACTGTATGGTGGTCGGGTTGGATTGTGGAATCAAATAGCTCTGGATTAGTGCCCTATCTTCTCCCTTATAATCTCTGTCATCAGGAGAAAGTAAGCATACATGTAAAATGCAAGTAAAAAGGACATAAAAACCTGCAGTTGTCAGCATGTAATAAATCCTTGATATTAGTCACTATTGTTATTATACACATCCAAGAAATAGAACCCAAACCTTCTATGCCTTCAAAGAACTGTAAGTTACATATAATGCCTATATTTGATTTAGTCCCAAATTACAAAACAAATAACCATAGACCACAACAGAATAAAAGCAGTAAGGAAACCTTTAAAATATTTTTTCTGAATGTCTTCATGTTTACCTTTCACATAGATTTGTGGCTAAAACCCAAATGTACTATTGCAAAGTAGTTCTTAGGCATTTACCAACAATTTCAATAATTTCTTAATTTTGAATCTCCCACTGTGGTATTTTCAAAAGTGGCATTCATCGGAATGGTTAAGTGAAAATTCGTGACTAAGCTTTAGAAGATCCTGTCCTTTTATGATAAAAGCTGTAAAATAAGGAGTTCTGAATACAACTCTTTAAAAAAGATATTTTAAAATTTGTTTTACAAACTAACAGGCATGACAAGGAGCTTTATAATTGGCTTATCTCTAAATGACTTTTCATTAACTGTGTGATAATGAGTGCTAATGAGAACATTAAAGAACAGACCTTATAGAAAATAGGCTCAGACTCAGTCCAAGAGGGCTAGCCATCGGAGGATGGTTAAATGACTTTATTTTCTGACTCTGTTTCCATGTAG
>TTN-215,,0,284,3489685,3489968,GTTGGTCACTGGTTACCCGCTGTTACATGGTCCACTCCCATTGAGCAGGGCCAGGTGGTTGGCTAGTTTGTACTGAAAAGTAGCCAGTGGAGTCTTGCCTTTCTCCTTTGCCATACTAAGACTTGATTTTTATGGAGCATAGTATGGGTCAGAGATCATTTTCTCAAATTATTTTTATAATTATTTTTATATTTTTATAATTATATAATGTTGCATGAGCTAAGAGTTTATGAGATTTCCCTTAATTTCATGAGCATTTTGTAATATAATTTGTAAAAATCTAG
>TTN-215,,0,655,3489969,3490623,GTGAGTAAAGAAGTTGATAATGCTGGACCCTATTCATATCTCCTCAAATCATTTTAATACACGTTTGCAAAGATCAGTTTCTCAAATTAATACAAAAATGACATTAGTGAGCTTACAGATGCTCATTTTAAGACCGTATTTGGTCTGGAAGACCATATTTGACCATATTTGGCAAGGAAGAAGGGAATTCTATGTGGTACATCATTCATGGATTCAAAAGATTTAATGAGCTTCTAATATGCAGAAGGCATTATTGCAGGAGCTGTGCAGACATAAAGACCAATCCATCCCTCTTTGAAATATTTTCTTTGCCATCAGAGAAAATGTACACAAACAAGCATAATAAAATATATAAGGTGATAAACATCACAACAGAAGGAGAATCCATGGGAGGCATAGATTCATTCCAGTTGGTGATACCATGGCAAAGCTTTGTTGAATAGGTAGCATTTGCTATTGAGCCTTACAGCTCTTTACTAATATATTAGTATATTATATAAATATTAGTTTCTCTACTACTATTTCTGGAGTCCTGATTAAAAGGCCATTTTGTGGCAGTTGAAATGCATAAGTTCAAACTCTACATTTGTTACAAAACAGAAGTGATTAATGAATATGCACACGTATCATTATTTATTTTTTCTCCTCTCTTCAG
>TTN-215,,0,203,3490624,3490826,GTTAGTGGCCACCCTCCCACAGTCCTAATGCACATGCCATCACTTTCATCTGACACTCTTTTCCACAATATGGTTTCTGTGCACCTTGAAATGATGTCCCTTTTTGGAACTTGGGGGGAGATTATATGGTCAATTTAACTGTCAGTGCTAAGCAGGGGTCACTAAACATCTCATCTCAATGAGAAACTTTTGTCTTCTTTTAG
>TTN-215,,0,111,3490827,3490937,GTAAAATATTTTGCTAATTAGTAGCTGTTCTAGTACCATTTTGACTTTCAGCCCCACCAGTATTGGCAAATTGCAACCCGGAAGCTAATATGAGGGGAATTCTCTTTCCAG
>TTN-215,,0,948,3490938,3491885,GTATTTTGATGGCTGAATATAGAGTTCTCTGTGACTTGTATAATACGTGCATGAAGCCTAGAGTAGAATTTACTCACCCCACCGACCCTGAGCATAGGCTCTTTCATTGTGGAGCCTTCTTAGTTTGTTTTGAGGTATTTTTACATTTTTTTTGTGCAAAGTCTTCCTAAGAAATAAAGCTATGTGACAAAAGTGGATGGAAGATATATTTCTTTACATTATAGTTTAATTCATTGAGTTTGTGAAAGTAGAGAAAATATGGATTTTCACACAAACACACCCACACACACACACACACACACACACTTCCAGAAAAGATTTGAGACAATTTTCAATAAAAACATGTAATAACTAAGTGACTAAAAGATAGAAGAATAGCCATGTAATGAAGAAGAAAGCTAGTTATGCACAAAAATCTATGCTAGTAATTTTTCTTCAATTCAATATAAAATTTAGCTCTGAATATTTTGCAATTTAAGATAAAAAGAGCAACCTGGTAATCTAAAAATGTAGGTGCCGTACCTTCATAATAATAAATATAATGTACCAGAGAGTTAATACTGAAATATTTGAAGGAATTTATTGTTTTAATTATTCATTTGATCTCTGAATGAAATAATGAGAAAAATAACGAACAAAGAGAAAATACCTGTTGTTTAAGTGACCTGATCATTTGCTAACATAAACACTGAAAACCACTTAATTTCATGACTGATTCTAGCAATAAATATTCTTTAAAATGAATATTTTAACTTATTTGGCCCTAATTACTCATGTTCTTGCATTTTTCTCAATTTTCAGCAATCTTATAATCTATTGTGGAGCTTAGTCATATGTTTAGGGTCATTGAATTTTATACCACAGATCCACTCACAGATAAGTCCAATTATTTTACCCACAGAAGAGTTGTTGATAACTGATTTTTAAATTTTGTACATTTACATAAAG
>TTN-215,,0,915,3491886,3492800,GTAAGTGCAACTCCAGTTTCTATGTGCATGATAAGAACTGAAATACAAGGAGATAGCAGTGCTGTCCGTTTGCTGAAAAACCTGTTGCCACTTACTGGTTCTGATACTTTGCCCCAGTGTCTTTGCCTCAGTTGTATGGAAAATGTTTTAGACCACATGGCCTCAAAAACTATACTGTCATTAAACTTCTGAGGTTCTAGCAATAGTTTCTTTTTGTTGTATTTGTTTCTAGGCATATCATGCCTCTGAAAATGCAGAGATTCTAAATCCGGTTGCCTTCCAGGCCCAGGCAGGTAACAGTGAGCTCAATGAAAACAGTAGCAAACTGGAGAGTAGGTGCCCTGCCTCAAAGAGACAGTAGCTGTGTTGTTGCCAGGCATGCACCAGGCTGTTACCAGGCTCAGTGTTGCTAGAGCTCCTGATATCTTAAAGAAAACCTGGAAGTCAGGATTTTCAATGTTTATAACTTGAAAACAAATGTAACAGCTTTCATGCTAGACTGTTCACATTTACAGTGAACTGGCTCACACTCTGTTTCACTTGACCTACACAGTATCCCTTAGAGGAAATTACAATATTATCTTCATTTAGCAGATAAAGCACTCAATATTCAGGAAGGTAAATGAATTGTTAAAAGACACACAGCAAATTAGGAAGTCCTCCGTGGTAGATCCCCCCAAAACTGACTGCTAATATAAAATTCTTTCTACAATTGTAATGGCTGGTTGGATTTGTTAGTGTTAGTTTGGTTTCCAAATTCCATCTAGAAAATATTGAGCACTTCAATAGTAGATATTTGGAAAATTTGGTTTTTGGTTATCAACTTTCCCCAGTGTAGAGTTTACCTGAATGCATAGTGGTATGACTGTTTTCTAATAAGAGCATTAAAAATTAACTGATGTTCTTAACTCTTAG
>TTN-215,,0,537,3492801,3493337,GTGAGTATAAAAGTAATGACCAACCAAACAATTTCATAAATTATACTTTCCTTTTTTTATTTGATATTTTCATTTTCAAGTGATGAGCTCGGGGTTAGACAGCTATTAGAAGGTCCAAGTTCACTGTTGCTAAGTTTCCTTAATCTTCATGGTATGTTGCACCTGTGAGTTTAGAAATAGAGATTACATATAGGCCATAAATGTGACTTTAAAAATAGGGCTTATAATATATTAAGGAAAACACCAATATTAGCACAGCTGAGTTCATTCATGCCAAGATCTCTTCATCTGTGTGATAAGCTAATGTAACCTCTAACCCAAATCTAACTCCTGCTTTTGGAATACCTTTCTACCCAAGATGCCACAACATTCACTGGGAAAGATGACCATAATGCAGATTAAAACAAACAAACCAAAAAGTCCTCTAGATTCTTCTCCCAGCTAAAAACTTCAACAGTCTAGCTCAGATACATCTCCTTAAATAATTTATATCAGTAAGGATATGTATTTTTAACAGACCATAATCTTTTTGCATAG
>TTN-215,,0,110,3493338,3493447,GTAAAATATAAACATTTATCATAGCTCCTTGCCACAGTAAAGATACAAATTGGTTAAAATATAACTATTTGATGTAAATTTTATTCATACATGCATGGTATTCTTTGCAG
>TTN-215,,0,898,3493448,3494345,GTAAGACTTGTAATAATTTGGGTTATTTAGTATGTAAATTGTTTTCAAAACATCAAATAGTAGCAAATTGCTATTGTGTAAGAAGAAAATCGAGGGCTAAAATGGCACAGAAACTTACCATTGGCAACACCAACAATTGCCAGAAGTTTTTATTTCTTGCCCCTGTGTAAGATGAGCAAAGAATTTTCATCAGTGTAACATACTGTTTATTTTCCTAGTGCTATAGCTAATATCACAATAGCTCTTATTTGACACCTGATTTTTACATATGTAAATTTATACAACAGCCCTGCAATAAAAAGATGACTATTATTGGTTTGGAAATAGGAACACTGAGGCCCTGGGAATCTATGAAAATTGTCTTAATTCATCCAGCCTGTAAGCGGTGGTGCCAGCATTCAAACTCCAAGTCAGTCTGGCTGCAATGTGTAGATGGAGTCTTGTTTTGCTTTGTTTTGTTTCCAAATTCATTTCTATGTTTTCCTCCTCTGAGATAAAGAATGTGTATTTTTTATTTTTCCATAAATGTATTCATTGGTTTACTTATCCAACCAACATTTATTAGGATGTTTTAGTAGTTAAATCAAAAAAGTCTAGTGACTGATTAAATCCAAGTGGTAAGGAAAAGAGAGTATTGAGGATTATTCCAAGATTTTTGAGCCTGGGTACCTGGATATACTGAATGACTACCAGCTAAAATTGAGAATATAGGAAAAACATAGTTGTGGGGGCAACAATAATATATTCTATTTTAGATCTGAATGAGTTTGAGGTGCCTTCTAATACGTGCAAGAAGTAAATTCTAAAATAACATGAATAATGAATAAGACAAAATGAAGTTTGTTTTGCTGAGTTTTCTTTATGCCTCACGAAAGTATTGTGTGTCTTTGTTTTGCAG
>TTN-215,,0,119,3494346,3494464,GTAAGCGTGATAAGTTTTTGCTCATGAATCATAAAAACACAAAAACAAGCTTATGTATGCATCTAACAATTTTTAAAAACTATTTTAAAATCTACTTTCTTTTAAACATATTTTCACAG
>TTN-215,,0,102,3494465,3494566,GTAAAATGAGATAAAATAAAAATAAATGAATTTTCTTATCACTTGGGTTATAAACAGGTATTTCAGCCTTACTCCCTCTAAATCATGACCTTTCTCTTTCAG
>TTN-215,,0,99,3494567,3494665,GTAAGTATGGAAATAATAAAGCTAAGCTCATTATACAAATCCAATAACCAGGGAAGCTATACCACTATATTGATTATTCCCTCCCCCAACTTTTTATAG
>TTN-215,,0,153,3494666,3494818,GTAATTTGCATGTCTTTCCTTTGATGGACCTGTCTTTGTATTCAAGAATATCCATGAGTGTGTTTACTTTTATTTTCTTTCCCCATTCCTCAGGTTGAGAATTTAATTTAATATAATGTGCTCTCCCCTTTTTCCCCCACCTTTTTCTTGTAG
>TTN-215,,0,447,3494819,3495265,GTATTCAACAACGAAGGATTTCATTGTTTACCTAAGCTCTAAAGTCACCCTTAGCATGTGGTAAAATTAGCTATGCAATTTTTCTTTCATGAAACAATTATTTGGAAATTGACTATAAGTTTCATAGCCAGAATCATAAATTTATGTTCGTAATTAAGAATGTTAACAATTTGACCATTTGGATTTTTTAAAGTAGTATTATCTTGATTTTTAGCTTTTAAGTTTTTTATTGAAGCATAATTCTTTACTTTCAAAAATATTTAAAAATTAAAATAAAATAACTGCTTCTTATTGAAAATTTATCTCTCAGCCCATCAGCGGGTAGATATTAAGAATACACCTGATAGTATGGGGGAGATAAAAGACATACAAGACATCATCTCTATCCTAAGTCTAGATGCATACCTCTCCAAAAAAATTGATTTATCTTTCTGTTATACACTTCAG
>TTN-215,,0,96,3495266,3495361,GTAAGTCCTCCCATTCCTGTCAGCCTGCAGTGAGCATCATTATGGTTTATTGATAAAAAATGATCATAACATTCTTTTTCTCCCCATATTTCACAG
>TTN-215,,0,112,3495362,3495473,GTGAGTCCTAATTATAAAATTTTATGTTTACACTATTAAGCAACATAAAGAACTTCAAGGAGCAGACAATTTCAACAAAATTCATTCATCTTGTGTGTGTATGATTTTGCAG
>TTN-215,,0,92,3495474,3495565,GTAAGGATTATTCTACCTATCTAATAATTACTTTAAGCATTCTACTTTCCCAGTGTAACAATAACCAAGAGATTATTTTATTTTTTCCCCAG
>TTN-215,,0,1637,3495566,3497202,GTTGGTATATTTATTAACCTAAATTCTTACGAGGAGTGATTGTTATTTTAAGAAATTATTATTCATTTCCCCCAAAATTCCTTTCAGTTTCCCACTTCCATGCCTCTGCTTATGCTGTTCCCAAAGCCAATAGTACTTGCAACACCATTCCCACCAGCCTAAATTACAAATGTTCTTCTAGGCCTACCTCAAACGTCACCTTCTCCATTAAACCTTCCTTAATCTCTCCATTTGTATATGATCTCTTCCTCATCCAACCCCAGGATCACTTTATATGTGCCTCTTTCCTAGTGTTTATTATGCACTTGTCTTATTCCCCATTTCCTCTTTCAATATCAGTGTATAAACTCCTGAAATCTGGAATTCTATTTGTATATTCCAATATATTGCAAATGACAGATAATCAATTGGTGTTTGCTGTATTGAGCTTTATTTAAACTTCCTTACTCTAAAGAATTATTTCCTTTTTTAGCCATTCTTGCTTCTTTAGCCTTTGTGCCTTTTATTTTCTTCCTACTTTTTAATGAAATCAATAAATATTTTCAAAATACAGCTTAATGTAACTGTATTTCTTATGATATCATGTAGAAATAAGACCATCATTCAGTAGAATTTCTTAGCTTTACAATGAAGAATAAAAAATGTAAATCAATTGCCAGAAAAAACTAGAAGTCATCATTAATTTGTTTGGTTCATTACAGTTTAAATTTTGAGGAGTTGAGATGTTACATTCAGATCGTGTTGTCCATTACATCTAGTATTGAAGCAAGTCATATGGTAATGATTTGTCTTATTTGGTATGAAAGTTTCATGGTTTATACTTACTTACGTTATAAGATTTCTTCAGAGATCGGACCATGAAAAGACTTGTAAAACAAAATTTCAGATTCAGCATTTTTATACATTTAATATAAATTACATGTTTTAAATGTGTGGAAACAGGAATAAACTATGAACTCCTCTGTGATTTCACCCAGTGTTTTTAAAGTACCTACCATTGGTCAGACACTTGTAGAAACTCAGGACACAAAACTAAATAAGAAATGATTTTTTTCTTGAGAAATTCATAATTTAGAGAGGACAGATACATAAGCAACTAGCTTGTTAAAGCAGTAATTATTTCTGCTAATGGATGATAAGAGTGGAGGCAATGGGGTGAAACTTCATAGAATGGGCGACATTTGCCAACACAGTGATTTTTAATATATAGAAATCCTCAATGTAGTAGAAACATTGATGACTCGTACATTTTGTTTAGCAAATTTTTATGTAGTCAAAATATCAGATTCCCAGGAAATAATCATTAAAAGACCAAGTAAAATGCTTTTGAAGAAGAAGGAATTGGGTTAGAGACTATCCTGGTGGTATACTGTTCTAAGAATTTCCTATTAATTCAACAGTTATTTTTTCTTCACAAAACTTTTCTGATTCCAGTATTTCTCCTAATTATCAGTTATGCATACTTAGAATAAGGGATTTCTTTGGTACCTTCTCAATATGGGTAAAAACAATCATAGACATTTCATGATTTCAAAATCATGTTCTTAAATTTGATATTTTATATTTACTTCTGCAAAGATTTTCCCATTGTGTGAATATGTTTAAAGGACTCATACTGTACATCTCTTGTTCCAAAG
>TTN-215,,0,535,3497203,3497737,GCAAGTAACATAGGATTTGTCCTTTTCAAATCATATTACAATCTTGATCGTTATCGTTTTAAAAGACAAACGATATGGCCATTTTGGATACCATAAATTTTCATTTCATAAAGTCATTCTAGATCCTCTAAACCTTCCTGAGACACATTCCACAAGGTACAAAATTGCTTATCAAATGCGTTTATGCAAAAAAGCCATTTCTTAGGTTAAAGCTCTGTGAAACAGCTAAATCAGACACTGATTCTCCATTCGTCTTTCACCCTTCTCCAATCAGTCTATTATGCTGCTAATACATAGCTATGCAAACTTCATACTACTAAAGCATAGAAAAATCATTTCACGATGTACATGTCCAGTTGGATCCCAGGTTCCCCTAAATAATCTCAGGTGTTTTTTAAAACAGAGGTGCTGCATAACTGTAAAATGTTTGGTAGCCATTCTTTTGCAGGGTGAGTAAGCAATGATCTTGTTCAGGACTTCTTTTCCTTGATGATGTCATCTATATTTTCTAACCCAATCATAAATTTGTCTTTAG
>TTN-215,,0,91,3497738,3497828,GTAAGTTGATTTAGAAACACTTTTCAAGCAGTCAGCCCATGGTTACCATTAAGTTAACCCTATCACTGAATTGCTCCAATTTTCCTCTTAG
>TTN-215,,0,120,3497829,3497948,GTAAGTATCAGGCAGCCCCCTACAGCCCTTTCCTTAATGAACCCCATGTATCTATTTGTTTGGTTTCATCTACTTTTTAAACAAATTGTATTAACTGAAGTGCTCTTTGATTTTACCAAG
>TTN-215,,0,745,3497949,3498693,GTAAGTTAAAAAATATATATATATATATACACATATATATAAAATATCAAATATTCAGTAGATTCATTGATATTCTATATCCTACACTTTGCTGACCACTCAAAAATCCTTGATTGGGTGGGCAGGGTGGCTCAAGCCTGTAATCCCAGCACTTTGGGAGGCCAAGGCAGGAGAATCACTTGAGATCAAGATTTTGAGACCAGGCTGGGAAATACAATGAGATCCTGCCTCTAGCAAAGACAAAAGGAAAAAAAAAAATTAGCTGGGCATGGTGGCACACACTTGTAGTCCCAGCTACTCAGGAGGCTGAGGTGGGAAGATCGCTTGGGCCCAGAAGGCCAAGGCTGCAGTGAGCCACAATCACGGCACTGCACTGCAGCCTGGGCGACAAAGTGAGAACCTGCCTCAAAAAATAAAGAAAAAAAATTGTTAATTGAAACATCTAGTATGTGGTTACACTGAGTAAAGCACTAGTATCTCCACCTGGATAAAATGTTCCAGTTAGAGTAGCATTGAAAGGCTACCTGGAAAGATGCCTCAGTGTCTATCACTTGATCTTTCTGTTCCTCTGTGAGTTGGCACTGTCCTGTATAGTACATGGAAGGTATCAAAGCTTATATCTCTAAACTGTAATCTCCTCAACAGACGCACTAAAAACATTCCAAATTTTTATTCTGCACCTGTTATAACCCACATCATATTTACGTAAAGTCTCCTTGGGTGTTTTTTCTTTTCTCCTTTGCAG
>TTN-215,,0,517,3498694,3499210,GTATGGTTTCATACATATTAGATCCATAGAAAAAATGTCATACATGCTTTATAAAATTTAGTGTATCAATTAATGAATGGATAAATAAAATGTGGGATAGCCATACGATGGGATATCATTCAGCAATAAAAAGGAAGCACTACGATATGCTACAACATGGATGAACCTTTAAAACTTTATGCTAAGTGAAAGAAGCCAGAGACCATACAAAGACCACATATTGTATGATTCCATTTATATGAAATGTCCAAGATACACAAATCTATAGAGATGTAGATTGGTGGTTGCTTAGGTCTACAGGGGAGACAATAGAAAAGTCCTTGGGGTGATGGCTAAGGGTTACATGATTTCTTCTTGGGGAATGAGAATGTTCTAAAATTATGGTGATGGCTACACAATGATGAATACATGGAAATTCATTGAATTGTATACTTTAAATTGGTGGATTGTACAGTATGTGAATTATATCTCAATAAAGCTGTTAAAAATGTTAATTTTTCTACATGCTATTTTCCAG
>TTN-215,,0,89,3499211,3499299,GTCAGTTGTTTTGTCTTGCTACATTCCAGTAATTCCCAGTTTCCTCTGAATCACCATACGGTAAACTCGAATTTCCATTTCATCCATAG
>TTN-215,,0,1146,3499300,3500445,GTATTGTCTACATACTAAATGTTTTGAAAAATCATCAGTAGTCCATAATCTATCATTTTATATTTTAATGTTTCCCTTTTACATTTTCTAACCACCATCCTTTAAAGAATTAAATCAGCTCATTCTTACTTGGCTTAGACTCTCTTATGCTGACCTCAATTTAGTCACAGTTTCCACTCAGGGAATAAGGGTGTCCCTAGCAGCTGTCTAAATACGTTAATTAAAGCAGCTGTAGAAATTTCACTGTCTAATAAATGGCTGCTTGCCAAGCAGCACCAACCAGAAAAGAATTAAAATGTAAATCGTGAGGTTCACACATCAATTAGAATTAAGGAAATTTAGAACAAGGTGATATTTTCTCAGAAGGTTTCTATCTGTGGAGAGGCAAGTGTCAAGGAACTTAGTGGCTAGAAATACTTTCTGTGAAGTCTAAGAGAAAGCCCTGTCCAAGCCGTGCTGGGTTCCTGGCAAGGATGCTGGGCACTCTTGCTGTCGGCTGCATTTACAGAGCTTGTCCTCATAAGTGTCCACCATCCCAAATGATATAATGGAGGAAACATGTCTAGAGAAATACCAGTTGAGTTCAGCTTTATCATATTGCTCATCCAAAGAAAACCAGGCTTTACAGACTGTGGACTATAATGAAAAAGGCTTCAATGAGGACTCAGATAACCTGGAGATGTCTTCCATCATTTATTTGCCAATTCTGAACCTCAGTGTTCTCACTCTTAAAATGAGGATAATAATTCCTACCTAGCCCACAAAGTTATTATTCATATAAAATGAAATCAAATTAAGTAATAACTTTTTAGACAATAAAAAGCCCCCAAAGGTAAAGCATCATTATATCCCTTATTAGTAAATAAGAAGCAAACATTTAAGGATGAAATAATTGTCTCTTTGGGGCAGCTCCTTTCCTCCATGCAGCTGTAAACACAATTCTCTACAAGAGAAGTTTATGTACCATTTGTCCAATACTAGGCAGGAAAAATTAGAGAGTGCTATAATCAGCCAACTTATTACATTATAATATATTGGTTTCACATGCCATTCATTGACCAGTTTTAGAAATTGATTAACTGGGAGGAAACCAGAGCTTCAAGTTTTTGTTGTTGTTGTTGTTTTTTTATGTTGTTCCATCAACAG
>TTN-215,,0,1569,3500446,3502014,GTATGTAGGGACAGATTTCAGCATATTTTGTGGATCCATCAGAAATAATCCTCCTGTTTAAGTCACTAAATTCTTGTAACTTGAAGGAAATTTCTAAAGAACCTATGGTATTCATGTGGTTCCAGCTACATTTTTTTTCACATTATATCTATGGAAAAGGGAGGGCAGCTGTTAAAAGACCTATTGAGAAGTTATTTTCAGAAAGCACCTGATGGCCAGATCCTCATCTGGTTGCTCAAAACTATTGAACACCCATTGGGTGTCCATTTTCATATACCCCAGATGAGCTTCTAGATTCGCTGTTAAACTATTTTAGTTCTCTGCCCTCTGCCTGAACTGCTCAAGTCCTAGCAGCACTACCAAGTGAAAGGGGTGTTTCCAGCCTCTGATATGGAGTGCCTGGGAGAACTCAAAAGTCCTCTTTGAGACCCTGGAAGGCCTAGAGAGCCTCAGGCAATGTGGAACTCGATCCTCTCTACCCCAAGCTCTAAGAACAGGGGCTCTTACTTTGGACAGGGAATTCCACATGCTACCAAGCACTCCTGAGGAGCCTCTGAGCAGTCCCCAGGGAAGTGCTGTTAAACCTCTGCTCTCCTCATTAGAAATCTTAAGGCTGAATCTCAAGCTGACCTTGTTTTGAGTCTAACCTAGATGCAAGAGAAAAATGGAACCTCCCTTCCTATTCTCATCCTAGGCCATATCTCTTTGAATAAAATACCCCTGAGGCAGATGCAGGAACTCCAGGGGTAATCTCAAGATTCACAAAGATGAACCATATCGCCAGCATTCCCTAGGTTCCTAGAAGACCAAATGGTCATGGCATCCAGTTCTTATTATCTCTGTATTAGTAGTGGAGAAACTGAGGCACAGAAAAGTAAAGATCTTTTCTATGATAGTGTCAGAAACCAGCCTCACAGAAGTCATTTCTTCTAATTTCTGGGTTCCATGAACTAACCAGGTCCCCTCACTCATCACAGCACTGAGAATATGCTTTAGTTAGCAAAACAGGAAAGCTGAATTTGTTAAGTCTACCTAATGGCATTTAACTAGATCTGAAATAGTGTTAATTCAGTCATTCATTCAATACTTACTGATTGCATTTTACTGGCACTGGTACATAACAAAATGACTATGACATAAACACAAATACTTGCAAAACAAACAAACTGGAATGATATGAGCCTCTTCACCACATGATTTGTCCAAATGAATTTTAAAAATAGGTAGCACACGGAAGTTATTGTATAATTCATTCAGGTGTCCATCGCTAAGCCCCCACCACAAACAGAAACTGGGATAATCAGGTTAACTCGGCACTCTCAGCATGCCCCCCAAATATCAAAAATATCTTTCTGAAGCTATTCCCTCTGCATGTGGACAAATTCCAAGTGCTTTCTTCATTCTTAGCACAAAGAATGTTCTAATATTCTGAGGCAAGTAAAAATACCACAATTCCAAAATTTTGTCTCTGGATGTATAACTAGCCAGCAACAAATTAATGTAGAGTTTTGCATGCTCTCTTGTGTTTTTACACTTTTTCATGGGCTATTTGTCAACATTTACTCCTAG
>TTN-215,,0,224,3502015,3502238,GTAGGAATGCCTCGCTACTTCCAGCTGAAAATAAAACCTAAGAAGCAGGCTTTTGTCCTTTCCCAGTGCATTTAAAAATACAATTTGGAGCTCATAAAAGTAGATTGCTACCCAACTTTGAAAGCACTCTGCAGTGAAATAAATTAAGATAAACCTACATGCTCCCTTCTGTGAGGTCTCTATGGTGACTTAATCATGACAAATCTTGTGGTTTCTTTCTTTAG
>TTN-215,,0,5004,3502239,3507242,GTAGGTTTAAGAACAAAAGGTGTCATTGCCAATACTTACAAATAATTACATGGGAAAAACATTCTGTCAGCTTCTCCTCCATCACAAACATCTCTCATGCATAATTTGAAGCTTAATGGAAATCTAACAGAAAACTTATTTCAATTATTAAATTAAGAATTAGATAAGTGTTTTTCACTATTTTGTGCCCTTAATAATGGTTGTTTATGTTATGTTATGTGTTCTTTATCACAATAAAAAAATTAGTGTTTTTCACTAATATTAAAAAAGGTCATGTTCCCTTTATGATTGTAGCTGCACTTTAATTTCTTCATTGATAAAATACAATGACAAAACTAAAATTATTAGATTATAATAGCATCTACATATAATTCAAAAGAATAATACATTTATATAAGACATTATTCAGTCTATGGACAATGCTTGTGTGAAAGGTATCCTTTGGAAGACAATATCCTATAGTGGTCAAAAGTCGGGGCTTCATTGTCAAAGATGCTGAATTTGAATCTTGCCTTCAATATATATCATGTCTCTCGTTCTCCTTCTGTCATGAATACATTGAGTATATGATTGCATTCAATCCTAGAAAATATATTTTATGAGGCTAGGAATTCCGTTTTAGTGCCTAGAATTTGGCATCTGAAAAATAGTACCTGCTAGAAGGTAAGCTCTATGAAAACAAGAGTGGATGGTTGCCCCAGAATATCACCTGATACATAGTAGATACTCCATAAGTAATTGTTGACTGGACTAATTAATGATGGTTAAATGACTGTTACCAAACACTTAAGATTATTATCAAGATTAAGTTAGGTAACTCAAGTCAGCACATAGCACAGTGCTCATCATACAGTAATCAATCAGAGTTAGCTGCTACCATTTTTAATTGGGGCATGCTTCTCAAGTACCACCAGCCAATTTCCTCATCCCAGGAATCTGATCTTGGTAGAATGAGACAATATATGTGGAACCACTTCAAGTCATAACTGATTGTCTATAATCACAATTATTTGAGAGTTTCCCAGCCAAAGGGAAACTCTCAAAGCTTGGGCATCTCCCAGCCCTCTTATTAGGCTGATGCAAAAGTAATTGCAAAGTTGTATTGTTTTGTTTATTATGCTTCTCCCATTAGTTTATAATCCAATCTCTACCTTGTCAAGATTTATTTTTCTCAACAGGTTAGTACTTCAGTTGGTCTTCTGACCCAATTATTTCCTCCTCAGGAATGGAGATGGTGATCTAGAAATCTAATAGACCTATTTGATTTTATGAGCATAATTAAAAGATATAATGTATGTAAAGCACCTATAGGCATGGCTGCCAGGTAACTGGGGCTCAATACATTCATTTTATTATAGCCATAGAGAGGAATTATATAAACATCAATGTTTAGTATTGTATGGCCAGTATGGACAAATACCATAGACTGTATATTTGAGGGATAGTGTTCAAGAAATGCTAAATATTAATAAATGAGGACTGATTTGATAATATCCTACTAACACAATAATACAAAATATATTTTAAAAGCAAGTTCATTAAAGCTACACTAAATAATTTATCCATTTATTTAATTTTTAGAGGAATTTTTTAATATAAACATATATGTACATCATTCAAAGTAGTAATATTTGTCTTAACTATATTGGTATAGTGCTTTTAAGTCTATAACATATTAACATATGGTAGTATTGCCTTTAAAGTGTTGTAGAAATACACCTGAAGCACTCTACAAGACACCAATTGGGGTAGAAAGAGAAAAATTTCACTATCTTTTCTGCATAACCAATGTCTTTAAAAAGGTTTGAATAGGCTTTGTAAACTGAGAAGATCATTAACTTCCTATGTGTGGTAATATCTGTACACATATAGTGGTTTTAGCATCCTCTTATAAATTTGTTTTCTATATGAAAGAAATTAAATTCATTAAATAGAATGACCCTTCAAAAACTTGCCAACTCACATAGTTTCATACCACTGGGACTAAAAATATTTACAGAACTTCCTCTGGCCAGGTATTGCCTTAAGTAAGTGTAGCCCTGCTTTCCACAAATTGGAAAGAAATTGGGAGTCTTCAGAAGCTCCCATGTTCTTGGGGGTTGTAATACTTTCTGAAGCATGAAACGTGGCCCTGAGCAACCAGGTGCTGTTTCTAACAGCGAAAATGTTACCTATTGAAGGTCTCCAGTGCCACCTACTGGTAGAGGAGTAATTTGGAAAAGCAGAATCTTAAAATGTAAAAAAGCTATTTTTTTGCTGTTTATTCTACAGATGATGAGTCAGTGTCATTTGGAGGCTTACAGAGTGACAGCTAGCTAAACAGAAATGATGAATAATTAGTTTAACAATGATATTGTCTGTTATTCATTTAAGCATCTGTGCAATTTTAATTCTACCATTTATTGTTTCCCTGCTATTGAGATATTACCCTAGGTGCTGGGGTGCAGATCTTGCTCTTGCCTTTAAGGAGCTTGACATGTAGGTGAGGAGATGCATGCACACAACTATATCCCAAGGTTGTAAGTGCTATTAACAGGCCCACGTACTCATCATTCTCTGTCTGGGAGAGAGCCAGAGAAAGATGTGTGAACTGAGCATTGAAAAATATGTAGGATCATTGAACACAGTGGCATCCTATGATGAGAAAACAACATCTCCAAGTCATCAAAACTTGCAATAATGCTTCATGTGCTAGAAGCAAGTGGTTTAAGTACAGTTGGAAAGTGATATCATGAGTGGGTAAGAAGGCTGGATAATACAGCAAAGGCCGTGCTAAAGTTTTTGGTATTCTATGCTGAAGATTTTGGAATTGATCTTGTTTACATTTAGGAGACACTGCAGGATTTTTAAGCCCCTGGGTACCATGATCAGGTTTACTTTTTAGAAGTGATACTGTGATAGGGAAAGAAGGGATGGACAGATGTGGGAGGCAAGACTGGCAGTCAGGAACTGGAGAGAGATTATTACAATAGGCCTGGAGAGCGTGGATGAGGCCCTCAGCCAGGGCAGTCAGGAGAGACAAGTGGGGTATTGCAGAAGTAGTAATATGGGAGAAGAATGGCCTCAAAGAAGACACGAGAGGCTAATGAGTAACGCAGATCATGGCATCACAGCCACAAGCACCAAGTCCACTACCAAGAAAAGTTTTACCTGTTAACTCACTTATTGTGTGCAGTTCATGTCCAGTGGCAGTTCATGTGTATCCTGGTGCCTCATTCAGTTCACCAAAGGAAGAAGCTGTCAGTAGAAATAAGCAGAGAACCTTGTAAGAGGATGTACCATTGATGATCTCACACACACACACACACACACACACACACACACACACCCCTTCACACAAACTAAATAGGGGTGGTGTTTCATGTTATATCACATGGCACTGTCTTTTGGCGTGTTATTGAAGACAACGTTGCTTCCATCTGTGATGTTAGATATTCTTGCTATAATGACTGACTTGTGCCAGTGGCTTATAAAGCCCTTCCATGTGTGTTATATCATTTAATTCTCACAGCAATTATATGCAACGAATAGCCCATAAATTATTACGCATGCCATTTTACAAATGAAAAGACTAATCCAGAAAGCTTAAATGACATTTCCAAGGCCACACAGCTGACAAGTTGTAGTGTCAAGATTTCATTTTCTTTATATGTATATATTTTGATGGAGTCTTGCTCTGTCACCAGGCTGGAGATCTCGGCTCACTGCAACCTCCCCCTCCCGGGTTCAAGCTATTCTCCTGCCTGAGCCTCCTGAATAGCTGGGATTATAGGTGTGTGCCACCACACCTGGCTAATTTTTGTATTTTCAGGAGAGACTAGGTTTCACCACGTTCGTCAGGCTGTTCTCGAACTCCTGACCTCGTGATCTGCCCGCCTCAGCCTCCCAAAGTGCTGGGATTACAGGTGTGAAGCACCGCGCCTGGCCAGGATTTCATCTTCTACTTTACCTTACTATCTAAGGAACTGAACAGATTTGTTACTCTAAGAGGAGAACCTGCCATTTATACACATCTACCATCATGGGCAGGAGAGTAACTTTTATAGACAAGTATTGGCATTAAAATGCAGACAAATGCTAGATGATTGGACTATTAGAAGATCATCTTGGATGGTTTTGAGACCAAGAAGTGGTATAGTGACTGTGCTCCAAAAACAAGATGGCTTTGATTTTGGCTATTCAAACAGTTAACTAAAATTAAAGTGCATATCACCTACAATTATTACAACACAATAACCTGCTACTTTACTGTAATTTGGGTTTTTACTTTCTATTATTTTAAGATGGTTCAAATCCTTATATAGAAATAGCTAGCTTTATTATAATGTCTTATAACTGCCACTCTGAAAAGAGTCAAATGTATCTAAGATGCTCAAATACCATAATAAATCACCCTCTTTATTTAAAAAATTATTTTCTCTACAATTATTTGTGCCATATATACTGCGTACTGAAACCTTTTGCTCATTAGTAACAAAGATAGAGATTTTTTTTCTACAGCCTTCAAAGGTATCTATTTTAGACTTTTCATATCTTGATCTTCTCAGCTCTCTTTTTGATTGATTTTTCTGCAAACCAAAAGTGGAGATTTTTCTCATTTCCTGTCCCAGAAGGCAACTACAAGCCCAGATCAAACCTTTCCTGATGACTCTTCTTAGGACTGTCTTTTTCTCAAAGTCACTGAATATGTCAAAATCTTGTCTCTGCTTCCACTGCATGACATGCAAATGTCTAAAGAGAATGTAACTGAAGTTCTATCATTTTAAACATTACAACCAGTTCAACCTTAGGACAAGCTATATTTTTCTATCATTACATTTCCTTCTTGAAGATGAAAGGAAATCATTTAACAATAGTAGATATGGCATGCCCAGAGAAAAGTATCATGTTATTAAGTCAAATATGAAATGTAGGCACTAGTATTATTAACATTGTGTTTGCAGGTAAATTGTAAAAATCCACTCATTTTTGTGGTTGAAGTATCTCTTTTCTTTTGTGTCGCAG
>TTN-215,,0,4974,3507243,3512216,GTAAAGTAAAACAACTTTCAGAACCCCATTTAAATATAGATCGAATCTTAACAATGTCTGTAACAATTACTCAAGAGTTCATGTAAATCATTGTTGTTCCTACCATTCTCTTCTAATTCAACTAATTATTTCCCTGTTATATGCCATGGTCTCGCCTCTCCTTTACCACTTTTCATTGTGAATCATAGACCATCACGTTTCATTTGGCCCCGCTTTTTCTCTGTAACAATTTGTAATGTATTGCTGCTGTCACCAGCTGTCATGCTTCCTAATCAGCATGAATCAGAAGGGGGCGAAATATGCTGCATAAATAGGTAGATTTGTTTTCTCAATTGGCTAAGATAAAAATTAAATTTTAAAAACATCTAAGAGTGTTATCATCCTCCTATCATGCTGACACAATTTTGATTTCACAAAAGCTAGACCGTTTCAGGTCTGTACACCAGCGAGCTATATTCATCCTCCTCTCAAGAATGTCTTAGTGTTAAGAAGTCCAGTCCTAAAGTGGTTTAACATTTCTGTTAGTTGGGGCTCTTAAATTGTAATCAGAAACACTTCCTCAGTAACATGGGGAATTTGATTCAAACAAGGATAGCATTTTTATATAGTGGTACTATTTTTCCTGAGCAAATATAGTCTATGTAGTATTAAGTACATACAAATACATAAGGATTTAGAGAAACTATTTTTTTCTTAACCTTATGCATTAACTGTAACTAGATGTTTTTTTAAATAATGAATTTAAAGTGGTTTAAAATTAAAAAGTTGACTTTACAACAAGAGGAAGAAAGAAAAGAATATCCAAAACCCTGTTGGGTACTCCACTATTGCCTTCATGAACAATGTAGTGAAGTTCCTTAGCCCATTCATGTCTCAGCTTGCTTCTCTGGGAAATGGAAGTGAACTTGTGTGACTTCGAGTCAATAGTGACATACAAGGACAAGGCAGTAGGAGTGGACTGAATTCTAGTCCATTATTGAAATTTGTGACAAATCTGTAGACAACTCCAAATGAGTTCTGGTTTCAGTGCAAGGTAAGACATTAAAAATTGGTATGCTTCTTTTCAGGATTTAGCAAATTTGAAGAAAATACATCAAACTCCCAATGGCATGTCTCTTTATCAGTTTCATTTAAGAAGGAGCCCCTTGGCCAAAAGCCCAGCTTCATCCAGCCTCTGTCAAGCCTCAGGGTGCACAACGGGGAGACAGTCAGATTTCATGCGAGGGTTTCTGGCATTCCCAAGCCAGAAATCCAATGGTTTCATAACCAGCAGCTAATTCTACCAACAAAAGATGTAGTTTTCCATTTTGAGGAGTCCACAGGCATGGCTTTAATGCTTATAGTTGATGCTTACTCAGAGCATGCTGGGCAGTACTCTTGCAAAGCAGCCAATAGTGCTGGGGAAGCCACTTGTGCAGCTACACTCACAGTGACTCCAAAAGGTAAAGCCCATCTTGCTTCAAGGACTTTGATTTGCTGTATACCTCTCAGTCCCACTGTTACTAATGAGAGTCTCTGCTGTTTGTTTTATTGCATACTGTGGTCAGTCCATAACTTACTAATAAAATAACATGCAATAACTCCCGCTAGGTCCTCAATTATGGGTTAACCTACATACTTTAAATTTCACTGAAGTATGTGTTCTATGCACTAGAGAACCAATAATTATTTTATTAGGCACCACCTTTGCTTGGCTTCTTTACTCTTCTAAGCAATATTGTATCATTGCATCATTAAATGATCTATTTGCTGATTATTACTTACTGTACTTAAAGTAAGTACAGTATTACTTACTGTACTTAAAGTAAGTACAGTATTACTTACTGTACTTAAAGCATACAGTGGACGGAGAGCAAATGCTAACCCAAATACAGTCAGCTAGAGGGAGAGAGAGAAAGACAGACTGGGTCACTTTGGATAGCTGAAATGACAACAGAAAGAAGGAACCAGATACTGCATGGCATCTGCATGAGTCTTCATCAACCACTCAGCACTGAATCACCAGGAATGAATTTTCTTTTGTGTGATCCTGACATCTAGATCATATTGCATCTGGCATGCTGCTTTCAAGTGACAACTACGTCTTTCATCTTCATCTTCCATGCCATTTTGTGTTACTAACATGGGCAAGTGACAAAGCTTAGATCTTAATATTCTTTTCTTTTTCTTGTCACTTGATTATACAGTGCAAGCCCTAGATAGGCAAAGTTCTGGGAAAGATGTAAGAGAGTCCACCAAGTCCCAGGCAGTGGCAGATTCCTCTTTCACAAAGGAGGAGAGCAAAATATCTCAAAAGGAAATTAAGTCATTTCAAGGATCATCATATGAATATGAAGTGCAGGTTTTTGAAAGTGTATCTCAAAGTTCCATCCACACAGCTGCATCTGTTCAAGATACACAGTTGTGCCATACTGCATCCCTTTCACAAATTGCAGAAAGCACTGAGCTATCTAAGGAATGTGCTAAAGAGTCCACGGGTGAGGCGCCCAAGATTTTCCTGCATCTTCAGGACGTCACTGTAAAGTGCGGTGACACGGCTCAATTCCTCTGTGTTTTAAAAGATGATTCTTTCATTGATGTAACCTGGACTCACGAAGGTGCAAAGATAGAGGAATCCGAGAGACTGAAACAATCACAAAATGGAAATATTCAGTTTCTTACCATATGTAATGTTCAGCTGGTAGACCAAGGACTATACAGCTGCATTGTACACAATGACTGTGGAGAGAGGACAACGTCAGCAGTACTAAGTGTAGAAGGTGGTTAATTGATTTTTAGCTATGACTTGCTTCATTTCATCCTCATCGCTTTATGCAGCTTTTCTGCCATGCAAATTCAATCGACGAATATATTAATTAGAATATCTCTAAATTAGCACCCTATTCATAAGTGACTTCTGAAAGTCAGCCAAGTCATTGGCCATGATTATCCTGAAAATTTAACTTACCAGTCTAGATTCAGAAAGTTTAATTTTTAAACGTAGGTTCGGGAAGCAAAGGTTTATTTCCTATGTGCTGCATTTTCTAATATTTACCAACGCACTACCAAGAAAGTGTAGCAAAGTTAAAATGTTGTATTCTGAGAAGTACTTATTGGGTATTTATTATTGTGCCAGATACTGTGGTAAATTTCAGTTTAATTGTTTTAATAGCAAGAGGTTCAACAATTCTTATCTCCTCTTTATTTTCACATCTGGAGGTTCTAGTTGTTTACAAAGGGGCCATGAAAATAGAAAATTGGGACCAAGTACAGTGACTCATGCCTGTAATCCCAGCACTTTGGGAGGCCGAGGCAGCCAGATCACTTGAGGTCAGGAGTTTGAGACCAGCCTGGCTAATATGGTGAAACCCCATCTCTACTAAAAATACAAAAATTAGCCAGGCATGTTGGATGTTGGTGCATGCCTGTAATCCCAACTACTCAGGAGGCTGAGGCCAGGAGAATCGCTTGAACCCAGGAGGCAGAGGTTGCAGTGAGCCGAAATAGGGTCACTGTACTCCAGCCTGGGCAACAGAACTAGACTCCATCTCCAAAAAAGAAAAATAGAAAATTGAAAATTGGGCACTGAAAATAACAAAGCTCTCTCTGGACCAAAATTAGAAGTCTCTAGATATTTCTCCATAAATGATGCTGCTTTTACAGGCTTAAAATCCTCCTGGAATTGTATAATTTTCTCATGGCAAGATCACAATTTTTGTCGTTATTGGGCTTGATTCTCCATTATGTCTGGAAGAGCAGGAATAAACTTGTCTGGGCAAGTAATAACTTCTTCCTCTTATCCATGGACTTTCCTTTTGGATATTAATGAAATGAGAAAAATATTTTTCAGGTGCCATAAGCCTGTGTTGTGTGCCCGTAGTCAAAACAGCTTCACTGAGTCTCATGGAAGGAAGCTGGTGGAATAAATTCAGGCATCTCCAGGGGTCTGTGGAAAGCTCTGGCCTCAAGTTCCTCCCTGATCCTGGCCATAGTGGTGTTAGGGATGAAAAGGGGGCAATGCAGTGCTATGTAGGTGCACAGCCATCTCTGCACAGAATTTTGAAACAGTGGCCTTTCTTCCTACCCAGTACAGAGAATACAGTTTATTGATTCATATAATGTATCCGCAACACCTACTCACCAAAAAGAGGTCTTATTCTTTCTTAATGAGATTTTGTTCTATAGCTATCTCTCATTCTGTCACCGTAGCCTACAAAGGCAATATCTCAAGAACTGAGGTCTAGTTATGTAAATTAGATAGAAAATTCCACCAGCCAGAGAGTTGACCCTCAATTTCACTACAGCTGCTGGCTAGCACAGTAATCACACAGAGTCACTATTTATTTGGAGGTGTTGTCTACAAGTCCTGTAGGTGACAGTGTGACAATTTTTTCAGTAATGTAATTGGGAGTTGGCTGTGTTGTGAAGGTGGGAGAAATGTAGATCTCTTAACTCACTTCCTAAAGAATCTAGTGCTATAGTGCGGTGTTTGACTGTCATATTCCCAGAATTGATTTGAACTCGGCTCTTTTGCCCTAGGATCTCCAGTTCATTCAGTTCCAATTGATAATATTATTAAAGTGTTCTTGAAGCAAAAGAATTTTTTTGAACATCCAACTGCCTTACTTGTACCTAAGAAAGTTGAAAGATAAGACATTTTTAGATGTTTGAAGAGTGAAAGATCAGGCACAGTTGTCTAATTATTTGACATAGGCCAGTCTTTATATGTTCCTTTTTTATTTTGGCTTAATAAGTTCATATAGGCTACAGAGTTATCCACCAAGATCAAGTAGGAATGTCAAACCCCTGGAAGTCTTTTTGAATACAGTTATTATGTGCATAATAAACATAAACATATCATATATAAGTTTCATGACTAACATGCTGCCTTTCCTTCTCATCCTAATGACATTCCATCTTCTCCACATTCAGCATGTTTTTCATTCTTACAAACACAGCTAATTTATGCCTTTCCCTAACTTTATTCTTACCTAG
>TTN-212,ENSE00001840753,1,197,3512217,3512413,CCCAGCCTCGCCTCGGGTGTAGGGATTGCATAGAAAAGCAAAACTACACAGTCTTGACTGTGTAGTTTTGTTTTTAGGATTAGAGGCTCACCGATTCATGTCGGAGATGGTCAGAAAAACCAACTCTCCATAGGACGTCGTTTCAGAAGCAACCTTGGGCTTAGTCCCACCCTTTTTAGGCACTCTTGAGAAATCAG
>TTN-212,ENSE00003650173,1,104,3512414,3512517,AGTGCCTAGAAAGATGACAACTCAAGCACCGACGTTTACGCAGCCGTTACAAAGCGTTGTGGTACTGGAGGGTAGTACCGCAACCTTTGAGGCTCACATTAGTG
>TTN-212,ENSE00003612033,1,204,3512518,3512721,GTTTTCCAGTTCCTGAGGTGAGCTGGTTTAGGGATGGCCAGGTGATTTCCACTTCCACTCTGCCCGGCGTGCAGATCTCCTTTAGCGATGGCCGCGCTAAACTGACGATCCCCGCCGTGACTAAAGCCAACAGTGGACGATATTCCCTGAAAGCCACCAATGGATCTGGACAAGCGACTAGTACTGCTGAGCTTCTCGTGAAAG
>TTN-212,ENSE00003533587,1,288,3512722,3513009,CTGAGACAGCACCACCCAACTTCGTTCAACGACTGCAGAGCATGACCGTGAGACAAGGAAGCCAAGTGAGACTCCAAGTGAGAGTGACTGGAATCCCTACACCTGTGGTGAAGTTCTACCGGGATGGAGCCGAAATCCAGAGCTCCCTTGATTTCCAAATTTCACAAGAAGGCGACCTCTACAGCTTACTGATTGCAGAAGCATACCCTGAGGACTCAGGGACCTATTCAGTAAATGCCACCAATAGCGTTGGAAGAGCTACTTCGACTGCTGAATTACTGGTTCAAG
>TTN-212,ENSE00003613376,1,86,3513010,3513095,GTGAAGAAGAAGTACCTGCTAAAAAGACAAAGACAATTGTTTCGACTGCTCAGATCTCAGAATCAAGACAAACCCGAATTGAAAAG
>TTN-212,ENSE00001930782,1,1237,3513096,3514332,AAGATTGAAGCCCACTTTGATGCCAGATCAATTGCAACAGTTGAGATGGTCATAGATGGTGCCGCTGGGCAACAGCTGCCACATAAAACACCTCCCAGGATTCCTCCGAAGCCAAAGTCAAGATCCCCAACACCACCGTCTATTGCTGCCAAAGCACAGCTGGCTCGGCAGCAGTCCCCATCGCCCATAAGACACTCCCCTTCCCCGGTCAGACACGTGCGGGCACCGACCCCATCTCCGGTCAGGTAAAGCTGCCATAGAGAGAGCAGATTATTGCACATTTTGGAACTAGGTTTTGAAACGAGAAAGATTCCCTTGTCCCCCTCGCAGGGCATGCGACGCGGAGAGTGGTTCGCTTCTTCAGTGTCCCGCTGCTCAAACCTCTAGGGGAGCATACAAACGGGCAGGTTGTGGGGCTCCGTGTTCCTCTGGACATCCAGCCGCTTGTGTGTCTGCCTACTAGGGTCTCAGGGGTTTTTATAGGCATAGGGTGTGGGCGTGGCAGGTCAGGGTGATCTTGGGAAATGCAACATTTGGGCGGGAAGGCAGGAGTGTTTGTCCTCACCTAGGTCCATGGGCACAGGCCTCGCTAGGGACCACGCACTTCTCTTCCCAGCACTTCCCTGCCCTCCTCCCGTGTAAGTTTCATGCACTCAAAAATGTAGCAGGTGACAAAGGAGGTAAACCAAGAAGTTACTGAATATGATTTTCACAAATCCTCACTGTCCACAGGTAAATTGAAGACCCTTATAAACTTCTGAATTCTTATTTATATTTCATGTAATAAATATCTACTTTAGGGGCCAAAATATGGCACAGTGAAAGGAGAAGAGCACAGAAGTTAGAGTTCAAAGCCCTAAGGACAAATCAGCCTGATCACTTAACAGTTTGATTTAGGGCAATAAGTATAAATAATAAAATAATTGTTATTATATATGGATCACTTCCTCTATCAGATTGGAACTATACATACATTATCTCATTAAATGTTCACAACCTGTAAGAATTATTATCCTCAATGTTATTGATAGGTAACTGGAATTAAAGAAGTTAAGCAGTTTATTTAAGGTTTCAGTTGTGTCATCTGTAAATTAAAGAGAGTCACAATAAGAATGATCTCAAGCTGCATTTTGGGGCTTCAATGAGATAATTAGTTGAAAGTGCCTTGTAAATAGAAAATAATTATGCCAATATTCTTATATTCAGATGGTAAGTAAAACCTTTTAAATATTTTGCA
>TTN-212,,0,2556,3514333,3516888,GTGAGCAGCAACTTTTCTTATTTTAATAGTAGAGTCACTTTCTTATTGATCTCTGGCTCTGGATTATTTGTGTGTGCTAAATGCCTATGTACAAGTGTTTGTATGACTATTTCTTGCCAGTGCTGACCCATTATTTAAATCTGCTTGTTAAATTCTATTTTAAAATGTCTGAACATTTTTCCTTAAAAAGTTGAAAGCTTTATTATATCAGCTAAATGATTCCATGATTCAAATTGTTTAAGTTCACTTAATATTCTAAAAGTTGAGGTCTGAAATGTTGAGAGAAATGTTTACTTCTTTTCTAGACTCTCTTTGCCTGTTGAGAATGTTCAAGGTTATATTACTCAATGATAAAGTTAAGCACACCAAGAATAGCTCTGATAAAATGCATGTGGTATCAGCTACACCCTGATGACTTTTTAAGGGAATCAACTGCTGAGGTATCAGTTGCAGGACAGTGACAGAACACTTGCCTGCTGTCAGTCAACCTTGGAGAGTTTAGGAGAGTTTATTTTAAGAGCATGACATTTTAGACGCATACCTTCAGCCCCAGTTAGACAAAGGCCTGTGAAGAGCAAGTGCTAAGGCAATAAAATTTACCTAGACAATAGGAATGTAAGATCAATTTAAGCTGGTTAATTGCAACATAGTTGGAGATTTGGAATAAAATGATATAATTGTTTTCTAAAATATTCAGAATCTCTTCATGCATTTTAACTCAGCACACAGTCCAATTATATATTTTGAGATAAATGTTGACACTAAGAAGGGTAAGAAATAATGTTTAAAGGAAAGGTTTCTTACTTCTAAATACACTTTGATTTCTCATCTTCCTAGAATTTGATTACTAATTGTCAATGCCTGTAAATACATAGATATATAATTAGGTATTCTATGTCTAAGAGGACAGCTATTTTTAGATATACTAACTTATAAACAGACAAAGTTAGACACAGAAAGTTGTTCATCCCAAAGATAATATGCTACAAAAAGGAGTTTCTGACAAAAAAAATTTATGAAAGCTTTTGGATATTATCTGATTTTTCCAAATATAAATTTTATTGTCTCAGAGAATGCTGGTTTCATTTTTTTAACTAAGTAGAAGGTTACAGTAAGGAACAGAATTATCACTAAGAAGATTATTGCTCCATGAAGTTTTAGTAAACAAAGAATTTAATGAAAAATAGTAATGAAGTGATTGACAATTCAGAAATGTTCTATTTCAGAACAGAATAGTCATGTTGAATAATTAGGTATTTATGCATCAGAAAATTCTTCACATAATGTCTCTGAAACTGATAGGCAAAGTACTTTCTTGCACTTAACAAAATGACTTAACTGCAAATTTTATATTCGTTTCTTTGATGTTGAATATTTTACTTTATGAAAGCATAGGCCTTTTCACTTCATCTACATTTTACACCAGCCTTCCATTATTCAAAGTTTGCAAATTGTTCCATATTAAGAACTCAAGCCAGCATTTTTCTTTCAGAACTATAATAAACTTTGGCCTGTTCACTAAAATTTAAATTTTTCTGAATATTTACTTCAGCAGTAACAACATTTACTGCACAGTTACAGTATGAAGAAATGTTAAGAAATAGAAAGCACCGTATGCCGTCTACAAAAAGCTTGCATATTTGATAAGGCTTGCCAAAGCTTCTCCAGTCAGGAAAGAGATTACAAAGTTCAGATTTTTACTTCTGGCAACTATTTTAAGTAATCAGATAATGTCTGAATCAATGTCAACTTTATAAATATAGAGTGAACGAAAAATATTGGGGAGAAGGAAAATTTTTAAAATAATTTTCACTTACTAAGCTGATGCAGAGGTTTATTTATTTTAATTTTTTTTTTTTTTTTTTTTTGAGACAGAGTCTCATTCTGTCACCCAGGCTGGAGTGTGGTGGCACCATCTTTGCTCACTGCAACCTCCACCTCCTGGGTTTAAGCAATTCTCATGCCTCAGCCTCCCAAGTAGCTGGGACTACAGACATGGGCCACCACGCCTGGCTAATTTTTGTATTTGTAGTAGAGACAGGGGTTTCACCATGTTAGCCAAACTGGTCTCAAACTCCTGACCTCAAGTAATCCTCCCGCCTCGGCCTCCTAAAGTGCTGGGATTACCAGCATGAGCCACCACGCCAGGCCCAGAGGTTTATTTTACATTTATCACATGTCTTGTCTCTCTAATTACACTTCACTAACCCTGCATTGCTGTGGTTTTCTTCTTCAACTCTGAACCTGGTTTTCCACCATTGGTAAGACTGTATATTCCCTCTTTGACCACTAGGGTTCATTCCTTGTTCTGTTTGGCTAATACTTTTTTCCATTTCCCCTTACACTTGCTACTTTGGGTTAGGCTTTAAGTCAACTCAATGATGAACTATGCAAAACTGTTCAAGCCACAAAAGAGAAGACCTGCCCATCACTCTAGGCCCACAGATGACCTATGGAGCAATCCATTTGGAGAAACGTGTGTCTCTGCTATCTGCAAAGCAGCTCCAGAGTGACCCTTAGCTGGGACACCCTAATTTATTTTCTCTTCTTTTTCAG
>TTN-212,,0,2210,3516889,3519098,GTAAGCTCACACATTCACACTTTTGTTTTTTTTTCCTTTGCCTCCTCTCCAGTAAGTTAACGTTGCTGCAGGACTTGACGCCAAGTTTAAGCCCTGCTTTCACTTCGGAAAATTAGTCCAACACTATGGAAAGGTCATTTTAAGGGTATACCATTCACAGAGTACTGACAAAATCTGACAATATAATGGCTTGAAATGTTTTATTCATATTTATTATTCCACAAAGCAAAAATAATTAGTGTTGGATTAAAATTGCCGTTAGAATCCAGCAACTAAATAGGACCAAATTTAGTCATTCTATATTTGGGCTCAGCTGCAGAGCCAGACTGGAAGCCAAGAACTCAAGCCCAATAGAAGCCAGCCACAGAGCCATGGGGTAGGCAGTCTGGGCTGCCTGCTCTGGACACCTGAACTTCAGTTGGTTCACACGCAAAATAACAGTGCATCTAATTTTCCTCAGAGGCAGAGCTGTTCAGTAATTAACCAACTCCTCATTATTTTATTATTTTATTTTCAATCTTTATTGAGTGATTCTAATGAATTAAAAGACTTTCCAATCGTTTTGAAATGACAGAAAATAATATGCTTCTCGGGTGTCTCTATTTAAAAGGAAGCAAACACTAACCCTAGAATTTTATCTGAAAGGAAGTTCATCTCTTTTTTGCCTTCTTTTTCTTCCTCATAACTCAGTTTATGGATGGTTCAAAAAAATGCATGGTATCATCTTATGAAAAAATGGAGAGTAGTGTATGAACTATATTGTAAATAATTTTAAAATTAATCAATATTTTCTCTTTCTGTAGTATTGTAACGAGCCATGTAAGATGGATACGGATTAAAAAAAATCATGCTTAATTCTTAATTTAGTGCACTTCCATGGTTCATTGCCCACTTCTTTTTTAAAATTTTATGGCTTATAATAAAGATATAAAATAAAATTTCTTTTTTTCTCTTTTTTTCTATTATATGCACCAATCTTATTCATAACTGGATAATACTTTCTTTTACATTGTACAAATATCATATAATCATTGCTTATTTTCTATTGTACATATATAGACCAATGAAATTCCCTTTTCATTGGTCTATATATGTACAATAGAAAATAAGTCTTACCGACTTCCAAATAATTTACCTATTTATCTGGTAACACTCAGTAACTTCTGAACTGAGCAGAACACATATGACTTCAGTGGGAATTTGCCTCCTTGAGAAGTAGTGGAATCTGGCTACTTCATATCTTCTTGTTCCTTCAAACTATATGCAAATAAATTATTACAAAGACACTACTGAAAATATCCAATACCCATAAATCAGTCCAATAAACTATTTAATTGGCCATAGTGGGAGATGGGCTAATGTATAAACAACAAAATAGACTTTCTCTAGATTATCTTTACCTACCAGCGTAAGTAGATAGAGCATCAACCTTTATGCCAAGTGTGAAATAAATCATGCCCTGAATGTGCCTCGTACATTCTCAATGTACAGAGTTTTAATATATTTAAAACATCAAACCATGGACATGTAGTTCTTGGCTCTACAATTTATGGCAGATAAAGAGAATTTGGCTTTCTACCTGCAATTCCAATGATCCATGTTGTTCTGGAAGACTAGGTTTGGATTAGTCTCTTATGAGAAATTGCTTGTCCATGTTACAATGTTTTTACTGATTGCACTTGTGAAAGCAGAAGAGTCCAAGAAGACAGTGTCCCTGTAACCACAGAGGAGGGAGGAGGGCATGCCTCCTGGGCTTGTCAGGCAGAAACTGGAGATCAGTTTGCTGCTTTTGTTCTTCACTTGCTCTCAAAGAGGACAACAATCACTCTTTATTTCAAATTTTCCTTGGTTCTTCATTTTTATAAGTCCCTTTCATGATTTTAATGTTGTCTATTAAATTGCATCAGATAGAGCCCTAGGCAGGCAGGCAGGAGATGGAAATTCTAGTCCCCTCTGTGTCACTGCTAGCTGAAGGACCTTGGAAAAATCATTAGGCCTCTTTTGGTCTCAGTTTCCTCCCTTCCTGCCTTCCTAATGGTCTGCAGGTTTACACACTGATCATGCAACTGTAGGGTTTTCCCTATCATTAAGTGGCATTCCATGCTGGAAAGCTTTTACAGATTCGGACAAGGCAGTGAACATGATGGGACAGAGCAGAGGACTTTGTGGTGCCCATTCAAACATAAAGGTGAATTGTTCTTGCTCTTCAG
>TTN-212,,0,1455,3519099,3520553,GTAGGCTGCTGGGGACCTGCCAATCCTCTGCTCCCCCAGAGGACATCTCCAGCAAATTGGGAAAGGAGTCCAGAAAAAGCTATGGGCAGAGGTAGATGCAGCTCTTAAACTACAGAAGGGTCTACTGGAGGCTGAATTATTTATAACCAAGTTGTTTGCCTTTTGGAATTTAATTTTCCTCTAGAGTACATCGTAAAAGTGACTGAGAATCAGTTTCTCAATACACATATTAAACACTCAAAAGTATGTTAAGGAAATATTAAAAATCATGTTTCTCAGCAAGTAGAAAAGCTTGGAGCCTTGTTTATAAGTCCTTTAAGGAATAAGACATATTCTCCAGGGAAGTGTGAATCTCCAGGAATTCACACTTTAACAAGCATCCAGATAATTCTGATGCCGGTAGTCTACAGACCACCCATTTAAGAGGCATGTAAACATACCCAGAAGAAAATAAATGCTTGTTTATTATTCAAATGCATGACACTGTTTCCCCAGAAAACTTATCACCAATCTTAGTGGCCTCTGTTGTTTTTCTCTATCCTTTACTACCTAGTGAGACATTAGTATACAGAATATTGCATGCCTTTACATGTTTTATAACAATATCTTACATGAGCTACGTAAAGTTACATATGCTTATCCAATAAACTTTACCTTCAATGATGTTCAATTATAGGGCTATAATTGACCTAAGCAGAAACCACATCAAGTAACATCAGGTAGAACTTTAGCATGCACCCAGAAAATTCACAAATGGAAAATGCACAGGGTTGGCAGCACCTGCTGTTGTTTATTACTCAAAATCATGTCAAAGTTAATTCCACTCACTCCTCACACTTATAAAAAATTTCCTTCAACATAACCAAAAAAATCCCCTTTCTGTAACACAATTAAAATGAAGTAATGTTATTATTGGGATTAACGTTTTAAATGCAAGTAAATATTTGGGTTATTTGAATACCTATCAAGTTGGAGAAGGTTTAGAATTTTAAAAATTAAATTAAAAATGTAATGATTCTTTAAGTAACAGGTACACCCATCGTAGCAACCACTGGAATTCATTTTAATGCAACTTACTGGAATATGCAACATGGCTTTCACATATTAATAGAGCGCTAGATGTGAGGTAGAGGGGGAAGTACCAGAAAGATTCTCAAGAAATGTTATAACAAAATCTAGAGCTTTTATTTAAAACAAAGAAACAAAAGGTGGTGGCCTAAACTGCTCAGCAAAACAAAGCAAATAAAATAAAATATGGTGGTGAGAAAGCCTTCTGTAATCTCCTGGCTCCCATTCTTGCTGTCATTGCTGGGTGAGCTGGGTTCAAGGACATTCAAGGATGTTTAGATTGGCGAGTCATCACCTGGTTTTGGAATTGGAGCTGTGATTATTTAAAAATACCTTGTAGGGAGCACCCTGGCTCTCACTCTTGACTTTGTTCTCTTGTCCCCGCAG
>TTN-212,,0,484,3520554,3521037,GTACGTGCTGGAGGTTGAGGAACAGAGAGAAGGGGAGAGAGCTGGTTTGTGTCTAAATGGGGCCAAGCGTCCACTTGCCACCTCTCACAGCCCTGGGAAGAATGCTGTGAGCTGATATAAAAGCTGGCTTTTCGACACCCATGAAAAGTCCCTGAGATTCTAGTCAGGAGCGCAGAATAGAAGCAATCTGTGCTTATGAATCTCATTATAAACTGGAAAGGGTTTCAATTAAGTGATCTACATTTCCAAATTATTGGCAAATAATGAAATTTTAAAAAATCATTCTAAGTAAATTTTTATCTTGTAATGAACATTTTCTATTTTTAAACCTAATTTATATTCATGCAAAATCCAAAACTTTCTGCAATTTTCTCCATTGGGATATCCAGAAAATCTTTTTGACTTTGTAGTCAGAATTAACAGAATCTCTTTTAAAATGGGTCATTGTGCCCCCTCCCAAACATTCATCTTTCCCTTCCCACAG
>TTN-212,,0,93,3521038,3521130,GTATTTTTCTATACTGTTGGTTTTCAAGCCTTTCAGGCTGTTGCGTCCCCAGCTATTCCTCCTCAACGTGGGCTTTGTTTTAATCTTTTACAG
