gene_name,gene_id,exon_intron_flag,sequence_length,start_position,end_position,sequence
>GAPDH-210,ENSE00001292470,1,58,0,57,GCTTCGCTCTCTGCTCCTCCTGTTCGACAGTCAGCCGCATCTTCTTTTGCGTCGCCAG
>GAPDH-210,ENSE00001813317,1,332,58,389,CCGAGCCACATCGCTCAGACACCATGGGGAAGGTGAAGGTCGGAGTCAACGGGTGAGTTCGCGGGTGGCTGGGGGGCCCTGGGCTGCGACCGCCCCCGAACCGCGTCTACGAGCCTTGCGGGCTCCGGGTCTTTGCAGTCGTATGGGGGCAGGGTAGCTGTTCCCCGCAAGGAGAGCTCAAGGTCAGCGCTCGGACCTGGCGGAGCCCCGCACCCAGGCTGTGGCGCCCTGTGCAGCTCCGCCCTTGCGGCGCCATCTGCCCGGAGCCTCCTTCCCCTAGTCCCCAGAAACAGGAGGTCCCTACTCCCGCCCGAGATCCCGACCCGGACCCC
>GAPDH-210,,0,240,390,629,GTGAAGACGGGCGGAGAGAAACCCGGGAGGCTAGGGACGGCCTGAAGGCGGCAGGGGCGGGCGCAGGCCGGATGTGTTCGCGCCGCTGCGGGGTGGGCCCGGGCGGCCTCCGCATTGCAGGGGCGGGCGGAGGACGTGATGCGGCGCGGGCTGGGCATGGAGGCCTGGTGGGGGAGGGGAGGGGAGGCGTGTGTGTCGGCCGGGGCCACTAGGCGCTCACTGTTCTCTCCCTCCGCGCAG
>GAPDH-201,ENSE00001932108,1,53,630,682,GCTCTCTGCTCCTCCTGTTCGACAGTCAGCCGCATCTTCTTTTGCGTCGCCAG
>GAPDH-201,ENSE00003562276,1,52,683,734,CCGAGCCACATCGCTCAGACACCATGGGGAAGGTGAAGGTCGGAGTCAACGG
>GAPDH-201,ENSE00003571091,1,100,735,834,ATTTGGTCGTATTGGGCGCCTGGTCACCAGGGCTGCTTTTAACTCTGGTAAAGTGGATATTGTTGCCATCAATGACCCCTTCATTGACCTCAACTACATG
>GAPDH-201,ENSE00003682485,1,107,835,941,GTTTACATGTTCCAATATGATTCCACCCATGGCAAATTCCATGGCACCGTCAAGGCTGAGAACGGGAAGCTTGTCATCAATGGAAATCCCATCACCATCTTCCAGGA
>GAPDH-201,ENSE00003678358,1,91,942,1032,GCGAGATCCCTCCAAAATCAAGTGGGGCGATGCTGGCGCTGAGTACGTCGTGGAGTCCACTGGCGTCTTCACCACCATGGAGAAGGCTGGG
>GAPDH-201,ENSE00003562150,1,116,1033,1148,GCTCATTTGCAGGGGGGAGCCAAAAGGGTCATCATCTCTGCCCCCTCTGCTGATGCCCCCATGTTCGTCATGGGTGTGAACCATGAGAAGTATGACAACAGCCTCAAGATCATCAG
>GAPDH-201,ENSE00003663529,1,82,1149,1230,CAATGCCTCCTGCACCACCAACTGCTTAGCACCCCTGGCCAAGGTCATCCATGACAACTTTGGTATCGTGGAAGGACTCATG
>GAPDH-201,ENSE00003460425,1,413,1231,1643,ACCACAGTCCATGCCATCACTGCCACCCAGAAGACTGTGGATGGCCCCTCCGGGAAACTGTGGCGTGATGGCCGCGGGGCTCTCCAGAACATCATCCCTGCCTCTACTGGCGCTGCCAAGGCTGTGGGCAAGGTCATCCCTGAGCTGAACGGGAAGCTCACTGGCATGGCCTTCCGTGTCCCCACTGCCAACGTGTCAGTGGTGGACCTGACCTGCCGTCTAGAAAAACCTGCCAAATATGATGACATCAAGAAGGTGGTGAAGCAGGCGTCGGAGGGCCCCCTCAAGGGCATCCTGGGCTACACTGAGCACCAGGTGGTCTCCTCTGACTTCAACAGCGACACCCACTCCTCCACCTTTGACGCTGGGGCTGGCATTGCCCTCAACGACCACTTTGTCAAGCTCATTTCCTG
>GAPDH-201,ENSE00001902446,1,271,1644,1914,GTATGACAACGAATTTGGCTACAGCAACAGGGTGGTGGACCTCATGGCCCACATGGCCTCCAAGGAGTAAGACCCCTGGACCACCAGCCCCAGCAAGAGCACAAGAGGAAGAGAGAGACCCTCACTGCTGGGGAGTCCCTGCCACACTCAGTCCCCCACCACACTGAATCTCCCCTCCTCACAGTTGCCATGTAGACCCCTTGAAGAGGGGAGGGGCCTAGGGAGCCGCACCTTGTCATGTACCATCAATAAAGTACCCTGTGCTCAACCA
>GAPDH-201,,0,240,1915,2154,GTGAAGACGGGCGGAGAGAAACCCGGGAGGCTAGGGACGGCCTGAAGGCGGCAGGGGCGGGCGCAGGCCGGATGTGTTCGCGCCGCTGCGGGGTGGGCCCGGGCGGCCTCCGCATTGCAGGGGCGGGCGGAGGACGTGATGCGGCGCGGGCTGGGCATGGAGGCCTGGTGGGGGAGGGGAGGGGAGGCGTGTGTGTCGGCCGGGGCCACTAGGCGCTCACTGTTCTCTCCCTCCGCGCAG
>GAPDH-201,,0,1632,2155,3786,GTGAGTTCGCGGGTGGCTGGGGGGCCCTGGGCTGCGACCGCCCCCGAACCGCGTCTACGAGCCTTGCGGGCTCCGGGTCTTTGCAGTCGTATGGGGGCAGGGTAGCTGTTCCCCGCAAGGAGAGCTCAAGGTCAGCGCTCGGACCTGGCGGAGCCCCGCACCCAGGCTGTGGCGCCCTGTGCAGCTCCGCCCTTGCGGCGCCATCTGCCCGGAGCCTCCTTCCCCTAGTCCCCAGAAACAGGAGGTCCCTACTCCCGCCCGAGATCCCGACCCGGACCCCTAGGTGGGGGACGCTTTCTTTCCTTTCGCGCTCTGCGGGGTCACGTGTCGCAGAGGAGCCCCTCCCCCACGGCCTCCGGCACCGCAGGCCCCGGGATGCTAGTGCGCAGCGGGTGCATCCCTGTCCGGATGCTGCGCCTGCGGTAGAGCGGCCGCCATGTTGCAACCGGGAAGGAAATGAATGGGCAGCCGTTAGGAAAGCCTGCCGGTGACTAACCCTGCGCTCCTGCCTCGATGGGTGGAGTCGCGTGTGGCGGGGAAGTCAGGTGGAGCGAGGCTAGCTGGCCCGATTTCTCCTCCGGGTGATGCTTTTCCTAGATTATTCTCTGGTAAATCAAAGAAGTGGGTTTATGGAGGTCCTCTTGTGTCCCCTCCCCGCAGAGGTGTGGTGGCTGTGGCATGGTGCCAAGCCGGGAGAAGCTGAGTCATGGGTAGTTGGAAAAGGACATTTCCACCGCAAAATGGCCCCTCTGGTGGTGGCCCCTTCCTGCAGCGCCGGCTCACCTCACGGCCCCGCCCTTCCCCTGCCAGCCTAGCGTTGACCCGACCCCAAAGGCCAGGCTGTAAATGTCACCGGGAGGATTGGGTGTCTGGGCGCCTCGGGGAACCTGCCCTTCTCCCCATTCCGTCTTCCGGAAACCAGATCTCCCACCGCACCCTGGTCTGAGGTTAAATATAGCTGCTGACCTTTCTGTAGCTGGGGGCCTGGGCTGGGGCTCTCTCCCATCCCTTCTCCCCACACACATGCACTTACCTGTGCTCCCACTCCTGATTTCTGGAAAAGAGCTAGGAAGGACAGGCAACTTGGCAAATCAAAGCCCTGGGACTAGGGGGTTAAAATACAGCTTCCCCTCTTCCCACCCGCCCCAGTCTCTGTCCCTTTTGTAGGAGGGACTTAGAGAAGGGGTGGGCTTGCCCTGTCCAGTTAATTTCTGACCTTTACTCCTGCCCTTTGAGTTTGATGATGCTGAGTGTACAAGCGTTTTCTCCCTAAAGGGTGCAGCTGAGCTAGGCAGCAGCAAGCATTCCTGGGGTGGCATAGTGGGGTGGTGAATACCATGTACAAAGCTTGTGCCCAGACTGTGGGTGGCAGTGCCCCACATGGCCGCTTCTCCTGGAAGGGCTTCGTATGACTGGGGGTGTTGGGCAGCCCTGGAGCCTTCAGTTGCAGCCATGCCTTAAGCCAGGCCAGCCTGGCAGGGAAGCTCAAGGGAGATAAAATTCAACCTCTTGGGCCCTCCTGGGGGTAAGGAGATGCTGCATTCGCCCTCTTAATGGGGAGGTGGCCTAGGGCTGCTCACATATTCTGGAGGAGCCTCCCCTCCTCATGCCTTCTTGCCTCTTGTCTCTTAG
>GAPDH-201,,0,90,3787,3876,GTGAGTGCTACATGGTGAGCCCCAAAGCTGGTGTGGGAGGAGCCACCTGGCTGATGGGCAGCCCCTTCATACCCTCACGTATTCCCCCAG
>GAPDH-201,,0,129,3877,4005,GTGAGTGGAAGACAGAATGGAAGAAATGTGCTTTGGGGAGGCAACTAGGATGGTGTGGCTCCCTTGGGTATATGGTAACCTTGTGTCCCTCAATATGGTCCTGTCCCCATCTCCCCCCCACCCCCATAG
>GAPDH-201,,0,90,4006,4095,GTGAGTGCAGGAGGGCCCGCGGGAGGGGAAGCTGACTCAGCCCTGCAAAGGCAGGACCCGGGTTCATAACTGTCTGCTTCTCTGCTGTAG
>GAPDH-201,,0,92,4096,4187,GTGAGGAAGGCAGGGCCCGTGGAGAAGCGGCCAGCCTGGCACCCTATGGACACGCTCCCCTGACTTGCGCCCCGCTCCCTCTTTCTTTGCAG
>GAPDH-201,,0,193,4188,4380,GTATGAGAGCTGGGGAATGGGACTGAGGCTCCCACCTTTCTCATCCAAGACTGGCTCCTCCCTGCCGGGGCTGCGTGCAACCCTGGGGTTGGGGGTTCTGGGGACTGGCTTTCCCATAATTTCCTTTCAAGGTGGGGAGGGAGGTAGAGGGGTGATGTGGGGAGTACGCTGCAGGGCCTCACTCCTTTTGCAG
>GAPDH-201,,0,104,4381,4484,GTATGTGGCTGGGGCCAGAGACTGGCTCTTAAAAAGTGCAGGGTCTGGCGCCCTCTGGTGGCTGGCTCAGAAAAAGGGCCCTGACAACTCTTTTCATCTTCTAG
>GAPDH-202,ENSE00001526507,1,38,4485,4522,TGTTCGACAGTCAGCCGCATCTTCTTTTGCGTCGCCAG
>GAPDH-202,ENSE00003514533,1,52,4523,4574,CCGAGCCACATCGCTCAGACACCATGGGGAAGGTGAAGGTCGGAGTCAACGG
>GAPDH-202,ENSE00003668900,1,100,4575,4674,ATTTGGTCGTATTGGGCGCCTGGTCACCAGGGCTGCTTTTAACTCTGGTAAAGTGGATATTGTTGCCATCAATGACCCCTTCATTGACCTCAACTACATG
>GAPDH-202,ENSE00001526503,1,134,4675,4808,GTTTACATGTTCCAATATGATTCCACCCATGGCAAATTCCATGGCACCGTCAAGGCTGAGAACGGGAAGCTTGTCATCAATGGAAATCCCATCACCATCTTCCAGGAGTGAGTGGAAGACAGAATGGAAGAAAT
>GAPDH-202,ENSE00003678358,1,91,4809,4899,GCGAGATCCCTCCAAAATCAAGTGGGGCGATGCTGGCGCTGAGTACGTCGTGGAGTCCACTGGCGTCTTCACCACCATGGAGAAGGCTGGG
>GAPDH-202,ENSE00003562150,1,116,4900,5015,GCTCATTTGCAGGGGGGAGCCAAAAGGGTCATCATCTCTGCCCCCTCTGCTGATGCCCCCATGTTCGTCATGGGTGTGAACCATGAGAAGTATGACAACAGCCTCAAGATCATCAG
>GAPDH-202,ENSE00003663529,1,82,5016,5097,CAATGCCTCCTGCACCACCAACTGCTTAGCACCCCTGGCCAAGGTCATCCATGACAACTTTGGTATCGTGGAAGGACTCATG
>GAPDH-202,ENSE00003460425,1,413,5098,5510,ACCACAGTCCATGCCATCACTGCCACCCAGAAGACTGTGGATGGCCCCTCCGGGAAACTGTGGCGTGATGGCCGCGGGGCTCTCCAGAACATCATCCCTGCCTCTACTGGCGCTGCCAAGGCTGTGGGCAAGGTCATCCCTGAGCTGAACGGGAAGCTCACTGGCATGGCCTTCCGTGTCCCCACTGCCAACGTGTCAGTGGTGGACCTGACCTGCCGTCTAGAAAAACCTGCCAAATATGATGACATCAAGAAGGTGGTGAAGCAGGCGTCGGAGGGCCCCCTCAAGGGCATCCTGGGCTACACTGAGCACCAGGTGGTCTCCTCTGACTTCAACAGCGACACCCACTCCTCCACCTTTGACGCTGGGGCTGGCATTGCCCTCAACGACCACTTTGTCAAGCTCATTTCCTG
>GAPDH-202,ENSE00001526502,1,240,5511,5750,GTATGACAACGAATTTGGCTACAGCAACAGGGTGGTGGACCTCATGGCCCACATGGCCTCCAAGGAGTAAGACCCCTGGACCACCAGCCCCAGCAAGAGCACAAGAGGAAGAGAGAGACCCTCACTGCTGGGGAGTCCCTGCCACACTCAGTCCCCCACCACACTGAATCTCCCCTCCTCACAGTTGCCATGTAGACCCCTTGAAGAGGGGAGGGGCCTAGGGAGCCGCACCTTGTCATG
>GAPDH-202,,0,240,5751,5990,GTGAAGACGGGCGGAGAGAAACCCGGGAGGCTAGGGACGGCCTGAAGGCGGCAGGGGCGGGCGCAGGCCGGATGTGTTCGCGCCGCTGCGGGGTGGGCCCGGGCGGCCTCCGCATTGCAGGGGCGGGCGGAGGACGTGATGCGGCGCGGGCTGGGCATGGAGGCCTGGTGGGGGAGGGGAGGGGAGGCGTGTGTGTCGGCCGGGGCCACTAGGCGCTCACTGTTCTCTCCCTCCGCGCAG
>GAPDH-202,,0,1632,5991,7622,GTGAGTTCGCGGGTGGCTGGGGGGCCCTGGGCTGCGACCGCCCCCGAACCGCGTCTACGAGCCTTGCGGGCTCCGGGTCTTTGCAGTCGTATGGGGGCAGGGTAGCTGTTCCCCGCAAGGAGAGCTCAAGGTCAGCGCTCGGACCTGGCGGAGCCCCGCACCCAGGCTGTGGCGCCCTGTGCAGCTCCGCCCTTGCGGCGCCATCTGCCCGGAGCCTCCTTCCCCTAGTCCCCAGAAACAGGAGGTCCCTACTCCCGCCCGAGATCCCGACCCGGACCCCTAGGTGGGGGACGCTTTCTTTCCTTTCGCGCTCTGCGGGGTCACGTGTCGCAGAGGAGCCCCTCCCCCACGGCCTCCGGCACCGCAGGCCCCGGGATGCTAGTGCGCAGCGGGTGCATCCCTGTCCGGATGCTGCGCCTGCGGTAGAGCGGCCGCCATGTTGCAACCGGGAAGGAAATGAATGGGCAGCCGTTAGGAAAGCCTGCCGGTGACTAACCCTGCGCTCCTGCCTCGATGGGTGGAGTCGCGTGTGGCGGGGAAGTCAGGTGGAGCGAGGCTAGCTGGCCCGATTTCTCCTCCGGGTGATGCTTTTCCTAGATTATTCTCTGGTAAATCAAAGAAGTGGGTTTATGGAGGTCCTCTTGTGTCCCCTCCCCGCAGAGGTGTGGTGGCTGTGGCATGGTGCCAAGCCGGGAGAAGCTGAGTCATGGGTAGTTGGAAAAGGACATTTCCACCGCAAAATGGCCCCTCTGGTGGTGGCCCCTTCCTGCAGCGCCGGCTCACCTCACGGCCCCGCCCTTCCCCTGCCAGCCTAGCGTTGACCCGACCCCAAAGGCCAGGCTGTAAATGTCACCGGGAGGATTGGGTGTCTGGGCGCCTCGGGGAACCTGCCCTTCTCCCCATTCCGTCTTCCGGAAACCAGATCTCCCACCGCACCCTGGTCTGAGGTTAAATATAGCTGCTGACCTTTCTGTAGCTGGGGGCCTGGGCTGGGGCTCTCTCCCATCCCTTCTCCCCACACACATGCACTTACCTGTGCTCCCACTCCTGATTTCTGGAAAAGAGCTAGGAAGGACAGGCAACTTGGCAAATCAAAGCCCTGGGACTAGGGGGTTAAAATACAGCTTCCCCTCTTCCCACCCGCCCCAGTCTCTGTCCCTTTTGTAGGAGGGACTTAGAGAAGGGGTGGGCTTGCCCTGTCCAGTTAATTTCTGACCTTTACTCCTGCCCTTTGAGTTTGATGATGCTGAGTGTACAAGCGTTTTCTCCCTAAAGGGTGCAGCTGAGCTAGGCAGCAGCAAGCATTCCTGGGGTGGCATAGTGGGGTGGTGAATACCATGTACAAAGCTTGTGCCCAGACTGTGGGTGGCAGTGCCCCACATGGCCGCTTCTCCTGGAAGGGCTTCGTATGACTGGGGGTGTTGGGCAGCCCTGGAGCCTTCAGTTGCAGCCATGCCTTAAGCCAGGCCAGCCTGGCAGGGAAGCTCAAGGGAGATAAAATTCAACCTCTTGGGCCCTCCTGGGGGTAAGGAGATGCTGCATTCGCCCTCTTAATGGGGAGGTGGCCTAGGGCTGCTCACATATTCTGGAGGAGCCTCCCCTCCTCATGCCTTCTTGCCTCTTGTCTCTTAG
>GAPDH-202,,0,90,7623,7712,GTGAGTGCTACATGGTGAGCCCCAAAGCTGGTGTGGGAGGAGCCACCTGGCTGATGGGCAGCCCCTTCATACCCTCACGTATTCCCCCAG
>GAPDH-202,,0,102,7713,7814,GTGCTTTGGGGAGGCAACTAGGATGGTGTGGCTCCCTTGGGTATATGGTAACCTTGTGTCCCTCAATATGGTCCTGTCCCCATCTCCCCCCCACCCCCATAG
>GAPDH-202,,0,90,7815,7904,GTGAGTGCAGGAGGGCCCGCGGGAGGGGAAGCTGACTCAGCCCTGCAAAGGCAGGACCCGGGTTCATAACTGTCTGCTTCTCTGCTGTAG
>GAPDH-202,,0,92,7905,7996,GTGAGGAAGGCAGGGCCCGTGGAGAAGCGGCCAGCCTGGCACCCTATGGACACGCTCCCCTGACTTGCGCCCCGCTCCCTCTTTCTTTGCAG
>GAPDH-202,,0,193,7997,8189,GTATGAGAGCTGGGGAATGGGACTGAGGCTCCCACCTTTCTCATCCAAGACTGGCTCCTCCCTGCCGGGGCTGCGTGCAACCCTGGGGTTGGGGGTTCTGGGGACTGGCTTTCCCATAATTTCCTTTCAAGGTGGGGAGGGAGGTAGAGGGGTGATGTGGGGAGTACGCTGCAGGGCCTCACTCCTTTTGCAG
>GAPDH-202,,0,104,8190,8293,GTATGTGGCTGGGGCCAGAGACTGGCTCTTAAAAAGTGCAGGGTCTGGCGCCCTCTGGTGGCTGGCTCAGAAAAAGGGCCCTGACAACTCTTTTCATCTTCTAG
>GAPDH-209,ENSE00001929447,1,37,8294,8330,GTTCGACAGTCAGCCGCATCTTCTTTTGCGTCGCCAG
>GAPDH-209,ENSE00001910561,1,182,8331,8512,CCGAGCCACATCGCTCAGACACCATGGGGAAGGTGAAGGTCGGAGTCAACGGGTGAGTTCGCGGGTGGCTGGGGGGCCCTGGGCTGCGACCGCCCCCGAACCGCGTCTACGAGCCTTGCGGGCTCCGGGTCTTTGCAGTCGTATGGGGGCAGGGTAGCTGTTCCCCGCAAGGAGAGCTCAAG
>GAPDH-209,ENSE00003668900,1,100,8513,8612,ATTTGGTCGTATTGGGCGCCTGGTCACCAGGGCTGCTTTTAACTCTGGTAAAGTGGATATTGTTGCCATCAATGACCCCTTCATTGACCTCAACTACATG
>GAPDH-209,ENSE00003640349,1,107,8613,8719,GTTTACATGTTCCAATATGATTCCACCCATGGCAAATTCCATGGCACCGTCAAGGCTGAGAACGGGAAGCTTGTCATCAATGGAAATCCCATCACCATCTTCCAGGA
>GAPDH-209,ENSE00003624732,1,91,8720,8810,GCGAGATCCCTCCAAAATCAAGTGGGGCGATGCTGGCGCTGAGTACGTCGTGGAGTCCACTGGCGTCTTCACCACCATGGAGAAGGCTGGG
>GAPDH-209,ENSE00003517569,1,116,8811,8926,GCTCATTTGCAGGGGGGAGCCAAAAGGGTCATCATCTCTGCCCCCTCTGCTGATGCCCCCATGTTCGTCATGGGTGTGAACCATGAGAAGTATGACAACAGCCTCAAGATCATCAG
>GAPDH-209,ENSE00003604797,1,82,8927,9008,CAATGCCTCCTGCACCACCAACTGCTTAGCACCCCTGGCCAAGGTCATCCATGACAACTTTGGTATCGTGGAAGGACTCATG
>GAPDH-209,ENSE00001919891,1,215,9009,9223,ACCACAGTCCATGCCATCACTGCCACCCAGAAGACTGTGGATGGCCCCTCCGGGAAACTGTGGCGTGATGGCCGCGGGGCTCTCCAGAACATCATCCCTGCCTCTACTGGCGCTGCCAAGGCTGTGGGCAAGGTCATCCCTGAGCTGAACGGGAAGCTCACTGGCATGGCCTTCCGTGTCCCCACTGCCAACGTGTCAGTGGTGGACCTGACCTG
>GAPDH-209,,0,240,9224,9463,GTGAAGACGGGCGGAGAGAAACCCGGGAGGCTAGGGACGGCCTGAAGGCGGCAGGGGCGGGCGCAGGCCGGATGTGTTCGCGCCGCTGCGGGGTGGGCCCGGGCGGCCTCCGCATTGCAGGGGCGGGCGGAGGACGTGATGCGGCGCGGGCTGGGCATGGAGGCCTGGTGGGGGAGGGGAGGGGAGGCGTGTGTGTCGGCCGGGGCCACTAGGCGCTCACTGTTCTCTCCCTCCGCGCAG
>GAPDH-209,,0,1502,9464,10965,GTCAGCGCTCGGACCTGGCGGAGCCCCGCACCCAGGCTGTGGCGCCCTGTGCAGCTCCGCCCTTGCGGCGCCATCTGCCCGGAGCCTCCTTCCCCTAGTCCCCAGAAACAGGAGGTCCCTACTCCCGCCCGAGATCCCGACCCGGACCCCTAGGTGGGGGACGCTTTCTTTCCTTTCGCGCTCTGCGGGGTCACGTGTCGCAGAGGAGCCCCTCCCCCACGGCCTCCGGCACCGCAGGCCCCGGGATGCTAGTGCGCAGCGGGTGCATCCCTGTCCGGATGCTGCGCCTGCGGTAGAGCGGCCGCCATGTTGCAACCGGGAAGGAAATGAATGGGCAGCCGTTAGGAAAGCCTGCCGGTGACTAACCCTGCGCTCCTGCCTCGATGGGTGGAGTCGCGTGTGGCGGGGAAGTCAGGTGGAGCGAGGCTAGCTGGCCCGATTTCTCCTCCGGGTGATGCTTTTCCTAGATTATTCTCTGGTAAATCAAAGAAGTGGGTTTATGGAGGTCCTCTTGTGTCCCCTCCCCGCAGAGGTGTGGTGGCTGTGGCATGGTGCCAAGCCGGGAGAAGCTGAGTCATGGGTAGTTGGAAAAGGACATTTCCACCGCAAAATGGCCCCTCTGGTGGTGGCCCCTTCCTGCAGCGCCGGCTCACCTCACGGCCCCGCCCTTCCCCTGCCAGCCTAGCGTTGACCCGACCCCAAAGGCCAGGCTGTAAATGTCACCGGGAGGATTGGGTGTCTGGGCGCCTCGGGGAACCTGCCCTTCTCCCCATTCCGTCTTCCGGAAACCAGATCTCCCACCGCACCCTGGTCTGAGGTTAAATATAGCTGCTGACCTTTCTGTAGCTGGGGGCCTGGGCTGGGGCTCTCTCCCATCCCTTCTCCCCACACACATGCACTTACCTGTGCTCCCACTCCTGATTTCTGGAAAAGAGCTAGGAAGGACAGGCAACTTGGCAAATCAAAGCCCTGGGACTAGGGGGTTAAAATACAGCTTCCCCTCTTCCCACCCGCCCCAGTCTCTGTCCCTTTTGTAGGAGGGACTTAGAGAAGGGGTGGGCTTGCCCTGTCCAGTTAATTTCTGACCTTTACTCCTGCCCTTTGAGTTTGATGATGCTGAGTGTACAAGCGTTTTCTCCCTAAAGGGTGCAGCTGAGCTAGGCAGCAGCAAGCATTCCTGGGGTGGCATAGTGGGGTGGTGAATACCATGTACAAAGCTTGTGCCCAGACTGTGGGTGGCAGTGCCCCACATGGCCGCTTCTCCTGGAAGGGCTTCGTATGACTGGGGGTGTTGGGCAGCCCTGGAGCCTTCAGTTGCAGCCATGCCTTAAGCCAGGCCAGCCTGGCAGGGAAGCTCAAGGGAGATAAAATTCAACCTCTTGGGCCCTCCTGGGGGTAAGGAGATGCTGCATTCGCCCTCTTAATGGGGAGGTGGCCTAGGGCTGCTCACATATTCTGGAGGAGCCTCCCCTCCTCATGCCTTCTTGCCTCTTGTCTCTTAG
>GAPDH-209,,0,90,10966,11055,GTGAGTGCTACATGGTGAGCCCCAAAGCTGGTGTGGGAGGAGCCACCTGGCTGATGGGCAGCCCCTTCATACCCTCACGTATTCCCCCAG
>GAPDH-209,,0,129,11056,11184,GTGAGTGGAAGACAGAATGGAAGAAATGTGCTTTGGGGAGGCAACTAGGATGGTGTGGCTCCCTTGGGTATATGGTAACCTTGTGTCCCTCAATATGGTCCTGTCCCCATCTCCCCCCCACCCCCATAG
>GAPDH-209,,0,90,11185,11274,GTGAGTGCAGGAGGGCCCGCGGGAGGGGAAGCTGACTCAGCCCTGCAAAGGCAGGACCCGGGTTCATAACTGTCTGCTTCTCTGCTGTAG
>GAPDH-209,,0,92,11275,11366,GTGAGGAAGGCAGGGCCCGTGGAGAAGCGGCCAGCCTGGCACCCTATGGACACGCTCCCCTGACTTGCGCCCCGCTCCCTCTTTCTTTGCAG
>GAPDH-209,,0,193,11367,11559,GTATGAGAGCTGGGGAATGGGACTGAGGCTCCCACCTTTCTCATCCAAGACTGGCTCCTCCCTGCCGGGGCTGCGTGCAACCCTGGGGTTGGGGGTTCTGGGGACTGGCTTTCCCATAATTTCCTTTCAAGGTGGGGAGGGAGGTAGAGGGGTGATGTGGGGAGTACGCTGCAGGGCCTCACTCCTTTTGCAG
>GAPDH-205,ENSE00001526521,1,128,11560,11687,TTCGACAGTCAGCCGCATCTTCTTTTGCGTCGCCAGGTGAAGACGGGCGGAGAGAAACCCGGGAGGCTAGGGACGGCCTGAAGGCGGCAGGGGCGGGCGCAGGCCGGATGTGTTCGCGCCGCTGCGGG
>GAPDH-205,ENSE00003562276,1,52,11688,11739,CCGAGCCACATCGCTCAGACACCATGGGGAAGGTGAAGGTCGGAGTCAACGG
>GAPDH-205,ENSE00003571091,1,100,11740,11839,ATTTGGTCGTATTGGGCGCCTGGTCACCAGGGCTGCTTTTAACTCTGGTAAAGTGGATATTGTTGCCATCAATGACCCCTTCATTGACCTCAACTACATG
>GAPDH-205,ENSE00003682485,1,107,11840,11946,GTTTACATGTTCCAATATGATTCCACCCATGGCAAATTCCATGGCACCGTCAAGGCTGAGAACGGGAAGCTTGTCATCAATGGAAATCCCATCACCATCTTCCAGGA
>GAPDH-205,ENSE00003678358,1,91,11947,12037,GCGAGATCCCTCCAAAATCAAGTGGGGCGATGCTGGCGCTGAGTACGTCGTGGAGTCCACTGGCGTCTTCACCACCATGGAGAAGGCTGGG
>GAPDH-205,ENSE00003562150,1,116,12038,12153,GCTCATTTGCAGGGGGGAGCCAAAAGGGTCATCATCTCTGCCCCCTCTGCTGATGCCCCCATGTTCGTCATGGGTGTGAACCATGAGAAGTATGACAACAGCCTCAAGATCATCAG
>GAPDH-205,ENSE00003663529,1,82,12154,12235,CAATGCCTCCTGCACCACCAACTGCTTAGCACCCCTGGCCAAGGTCATCCATGACAACTTTGGTATCGTGGAAGGACTCATG
>GAPDH-205,ENSE00003460425,1,413,12236,12648,ACCACAGTCCATGCCATCACTGCCACCCAGAAGACTGTGGATGGCCCCTCCGGGAAACTGTGGCGTGATGGCCGCGGGGCTCTCCAGAACATCATCCCTGCCTCTACTGGCGCTGCCAAGGCTGTGGGCAAGGTCATCCCTGAGCTGAACGGGAAGCTCACTGGCATGGCCTTCCGTGTCCCCACTGCCAACGTGTCAGTGGTGGACCTGACCTGCCGTCTAGAAAAACCTGCCAAATATGATGACATCAAGAAGGTGGTGAAGCAGGCGTCGGAGGGCCCCCTCAAGGGCATCCTGGGCTACACTGAGCACCAGGTGGTCTCCTCTGACTTCAACAGCGACACCCACTCCTCCACCTTTGACGCTGGGGCTGGCATTGCCCTCAACGACCACTTTGTCAAGCTCATTTCCTG
>GAPDH-205,ENSE00001526518,1,259,12649,12907,GTATGACAACGAATTTGGCTACAGCAACAGGGTGGTGGACCTCATGGCCCACATGGCCTCCAAGGAGTAAGACCCCTGGACCACCAGCCCCAGCAAGAGCACAAGAGGAAGAGAGAGACCCTCACTGCTGGGGAGTCCCTGCCACACTCAGTCCCCCACCACACTGAATCTCCCCTCCTCACAGTTGCCATGTAGACCCCTTGAAGAGGGGAGGGGCCTAGGGAGCCGCACCTTGTCATGTACCATCAATAAAGTACCC
>GAPDH-205,,0,148,12908,13055,GTGGGCCCGGGCGGCCTCCGCATTGCAGGGGCGGGCGGAGGACGTGATGCGGCGCGGGCTGGGCATGGAGGCCTGGTGGGGGAGGGGAGGGGAGGCGTGTGTGTCGGCCGGGGCCACTAGGCGCTCACTGTTCTCTCCCTCCGCGCAG
>GAPDH-205,,0,1632,13056,14687,GTGAGTTCGCGGGTGGCTGGGGGGCCCTGGGCTGCGACCGCCCCCGAACCGCGTCTACGAGCCTTGCGGGCTCCGGGTCTTTGCAGTCGTATGGGGGCAGGGTAGCTGTTCCCCGCAAGGAGAGCTCAAGGTCAGCGCTCGGACCTGGCGGAGCCCCGCACCCAGGCTGTGGCGCCCTGTGCAGCTCCGCCCTTGCGGCGCCATCTGCCCGGAGCCTCCTTCCCCTAGTCCCCAGAAACAGGAGGTCCCTACTCCCGCCCGAGATCCCGACCCGGACCCCTAGGTGGGGGACGCTTTCTTTCCTTTCGCGCTCTGCGGGGTCACGTGTCGCAGAGGAGCCCCTCCCCCACGGCCTCCGGCACCGCAGGCCCCGGGATGCTAGTGCGCAGCGGGTGCATCCCTGTCCGGATGCTGCGCCTGCGGTAGAGCGGCCGCCATGTTGCAACCGGGAAGGAAATGAATGGGCAGCCGTTAGGAAAGCCTGCCGGTGACTAACCCTGCGCTCCTGCCTCGATGGGTGGAGTCGCGTGTGGCGGGGAAGTCAGGTGGAGCGAGGCTAGCTGGCCCGATTTCTCCTCCGGGTGATGCTTTTCCTAGATTATTCTCTGGTAAATCAAAGAAGTGGGTTTATGGAGGTCCTCTTGTGTCCCCTCCCCGCAGAGGTGTGGTGGCTGTGGCATGGTGCCAAGCCGGGAGAAGCTGAGTCATGGGTAGTTGGAAAAGGACATTTCCACCGCAAAATGGCCCCTCTGGTGGTGGCCCCTTCCTGCAGCGCCGGCTCACCTCACGGCCCCGCCCTTCCCCTGCCAGCCTAGCGTTGACCCGACCCCAAAGGCCAGGCTGTAAATGTCACCGGGAGGATTGGGTGTCTGGGCGCCTCGGGGAACCTGCCCTTCTCCCCATTCCGTCTTCCGGAAACCAGATCTCCCACCGCACCCTGGTCTGAGGTTAAATATAGCTGCTGACCTTTCTGTAGCTGGGGGCCTGGGCTGGGGCTCTCTCCCATCCCTTCTCCCCACACACATGCACTTACCTGTGCTCCCACTCCTGATTTCTGGAAAAGAGCTAGGAAGGACAGGCAACTTGGCAAATCAAAGCCCTGGGACTAGGGGGTTAAAATACAGCTTCCCCTCTTCCCACCCGCCCCAGTCTCTGTCCCTTTTGTAGGAGGGACTTAGAGAAGGGGTGGGCTTGCCCTGTCCAGTTAATTTCTGACCTTTACTCCTGCCCTTTGAGTTTGATGATGCTGAGTGTACAAGCGTTTTCTCCCTAAAGGGTGCAGCTGAGCTAGGCAGCAGCAAGCATTCCTGGGGTGGCATAGTGGGGTGGTGAATACCATGTACAAAGCTTGTGCCCAGACTGTGGGTGGCAGTGCCCCACATGGCCGCTTCTCCTGGAAGGGCTTCGTATGACTGGGGGTGTTGGGCAGCCCTGGAGCCTTCAGTTGCAGCCATGCCTTAAGCCAGGCCAGCCTGGCAGGGAAGCTCAAGGGAGATAAAATTCAACCTCTTGGGCCCTCCTGGGGGTAAGGAGATGCTGCATTCGCCCTCTTAATGGGGAGGTGGCCTAGGGCTGCTCACATATTCTGGAGGAGCCTCCCCTCCTCATGCCTTCTTGCCTCTTGTCTCTTAG
>GAPDH-205,,0,90,14688,14777,GTGAGTGCTACATGGTGAGCCCCAAAGCTGGTGTGGGAGGAGCCACCTGGCTGATGGGCAGCCCCTTCATACCCTCACGTATTCCCCCAG
>GAPDH-205,,0,129,14778,14906,GTGAGTGGAAGACAGAATGGAAGAAATGTGCTTTGGGGAGGCAACTAGGATGGTGTGGCTCCCTTGGGTATATGGTAACCTTGTGTCCCTCAATATGGTCCTGTCCCCATCTCCCCCCCACCCCCATAG
>GAPDH-205,,0,90,14907,14996,GTGAGTGCAGGAGGGCCCGCGGGAGGGGAAGCTGACTCAGCCCTGCAAAGGCAGGACCCGGGTTCATAACTGTCTGCTTCTCTGCTGTAG
>GAPDH-205,,0,92,14997,15088,GTGAGGAAGGCAGGGCCCGTGGAGAAGCGGCCAGCCTGGCACCCTATGGACACGCTCCCCTGACTTGCGCCCCGCTCCCTCTTTCTTTGCAG
>GAPDH-205,,0,193,15089,15281,GTATGAGAGCTGGGGAATGGGACTGAGGCTCCCACCTTTCTCATCCAAGACTGGCTCCTCCCTGCCGGGGCTGCGTGCAACCCTGGGGTTGGGGGTTCTGGGGACTGGCTTTCCCATAATTTCCTTTCAAGGTGGGGAGGGAGGTAGAGGGGTGATGTGGGGAGTACGCTGCAGGGCCTCACTCCTTTTGCAG
>GAPDH-205,,0,104,15282,15385,GTATGTGGCTGGGGCCAGAGACTGGCTCTTAAAAAGTGCAGGGTCTGGCGCCCTCTGGTGGCTGGCTCAGAAAAAGGGCCCTGACAACTCTTTTCATCTTCTAG
>GAPDH-208,ENSE00001849922,1,29,15386,15414,GTCAGCCGCATCTTCTTTTGCGTCGCCAG
>GAPDH-208,ENSE00003514533,1,52,15415,15466,CCGAGCCACATCGCTCAGACACCATGGGGAAGGTGAAGGTCGGAGTCAACGG
>GAPDH-208,ENSE00003668900,1,100,15467,15566,ATTTGGTCGTATTGGGCGCCTGGTCACCAGGGCTGCTTTTAACTCTGGTAAAGTGGATATTGTTGCCATCAATGACCCCTTCATTGACCTCAACTACATG
>GAPDH-208,ENSE00001850695,1,327,15567,15893,GTTTACATGTTCCAATATGATTCCACCCATGGCAAATTCCATGGCACCGTCAAGGCTGAGAACGGGAAGCTTGTCATCAATGGAAATCCCATCACCATCTTCCAGGAGTGAGTGGAAGACAGAATGGAAGAAATGTGCTTTGGGGAGGCAACTAGGATGGTGTGGCTCCCTTGGGTATATGGTAACCTTGTGTCCCTCAATATGGTCCTGTCCCCATCTCCCCCCCACCCCCATAGGCGAGATCCCTCCAAAATCAAGTGGGGCGATGCTGGCGCTGAGTACGTCGTGGAGTCCACTGGCGTCTTCACCACCATGGAGAAGGCTGGG
>GAPDH-208,ENSE00003517569,1,116,15894,16009,GCTCATTTGCAGGGGGGAGCCAAAAGGGTCATCATCTCTGCCCCCTCTGCTGATGCCCCCATGTTCGTCATGGGTGTGAACCATGAGAAGTATGACAACAGCCTCAAGATCATCAG
>GAPDH-208,ENSE00003604797,1,82,16010,16091,CAATGCCTCCTGCACCACCAACTGCTTAGCACCCCTGGCCAAGGTCATCCATGACAACTTTGGTATCGTGGAAGGACTCATG
>GAPDH-208,ENSE00003546366,1,413,16092,16504,ACCACAGTCCATGCCATCACTGCCACCCAGAAGACTGTGGATGGCCCCTCCGGGAAACTGTGGCGTGATGGCCGCGGGGCTCTCCAGAACATCATCCCTGCCTCTACTGGCGCTGCCAAGGCTGTGGGCAAGGTCATCCCTGAGCTGAACGGGAAGCTCACTGGCATGGCCTTCCGTGTCCCCACTGCCAACGTGTCAGTGGTGGACCTGACCTGCCGTCTAGAAAAACCTGCCAAATATGATGACATCAAGAAGGTGGTGAAGCAGGCGTCGGAGGGCCCCCTCAAGGGCATCCTGGGCTACACTGAGCACCAGGTGGTCTCCTCTGACTTCAACAGCGACACCCACTCCTCCACCTTTGACGCTGGGGCTGGCATTGCCCTCAACGACCACTTTGTCAAGCTCATTTCCTG
>GAPDH-208,ENSE00001958808,1,214,16505,16718,GTATGACAACGAATTTGGCTACAGCAACAGGGTGGTGGACCTCATGGCCCACATGGCCTCCAAGGAGTAAGACCCCTGGACCACCAGCCCCAGCAAGAGCACAAGAGGAAGAGAGAGACCCTCACTGCTGGGGAGTCCCTGCCACACTCAGTCCCCCACCACACTGAATCTCCCCTCCTCACAGTTGCCATGTAGACCCCTTGAAGAGGGGAGG
>GAPDH-208,,0,240,16719,16958,GTGAAGACGGGCGGAGAGAAACCCGGGAGGCTAGGGACGGCCTGAAGGCGGCAGGGGCGGGCGCAGGCCGGATGTGTTCGCGCCGCTGCGGGGTGGGCCCGGGCGGCCTCCGCATTGCAGGGGCGGGCGGAGGACGTGATGCGGCGCGGGCTGGGCATGGAGGCCTGGTGGGGGAGGGGAGGGGAGGCGTGTGTGTCGGCCGGGGCCACTAGGCGCTCACTGTTCTCTCCCTCCGCGCAG
>GAPDH-208,,0,1632,16959,18590,GTGAGTTCGCGGGTGGCTGGGGGGCCCTGGGCTGCGACCGCCCCCGAACCGCGTCTACGAGCCTTGCGGGCTCCGGGTCTTTGCAGTCGTATGGGGGCAGGGTAGCTGTTCCCCGCAAGGAGAGCTCAAGGTCAGCGCTCGGACCTGGCGGAGCCCCGCACCCAGGCTGTGGCGCCCTGTGCAGCTCCGCCCTTGCGGCGCCATCTGCCCGGAGCCTCCTTCCCCTAGTCCCCAGAAACAGGAGGTCCCTACTCCCGCCCGAGATCCCGACCCGGACCCCTAGGTGGGGGACGCTTTCTTTCCTTTCGCGCTCTGCGGGGTCACGTGTCGCAGAGGAGCCCCTCCCCCACGGCCTCCGGCACCGCAGGCCCCGGGATGCTAGTGCGCAGCGGGTGCATCCCTGTCCGGATGCTGCGCCTGCGGTAGAGCGGCCGCCATGTTGCAACCGGGAAGGAAATGAATGGGCAGCCGTTAGGAAAGCCTGCCGGTGACTAACCCTGCGCTCCTGCCTCGATGGGTGGAGTCGCGTGTGGCGGGGAAGTCAGGTGGAGCGAGGCTAGCTGGCCCGATTTCTCCTCCGGGTGATGCTTTTCCTAGATTATTCTCTGGTAAATCAAAGAAGTGGGTTTATGGAGGTCCTCTTGTGTCCCCTCCCCGCAGAGGTGTGGTGGCTGTGGCATGGTGCCAAGCCGGGAGAAGCTGAGTCATGGGTAGTTGGAAAAGGACATTTCCACCGCAAAATGGCCCCTCTGGTGGTGGCCCCTTCCTGCAGCGCCGGCTCACCTCACGGCCCCGCCCTTCCCCTGCCAGCCTAGCGTTGACCCGACCCCAAAGGCCAGGCTGTAAATGTCACCGGGAGGATTGGGTGTCTGGGCGCCTCGGGGAACCTGCCCTTCTCCCCATTCCGTCTTCCGGAAACCAGATCTCCCACCGCACCCTGGTCTGAGGTTAAATATAGCTGCTGACCTTTCTGTAGCTGGGGGCCTGGGCTGGGGCTCTCTCCCATCCCTTCTCCCCACACACATGCACTTACCTGTGCTCCCACTCCTGATTTCTGGAAAAGAGCTAGGAAGGACAGGCAACTTGGCAAATCAAAGCCCTGGGACTAGGGGGTTAAAATACAGCTTCCCCTCTTCCCACCCGCCCCAGTCTCTGTCCCTTTTGTAGGAGGGACTTAGAGAAGGGGTGGGCTTGCCCTGTCCAGTTAATTTCTGACCTTTACTCCTGCCCTTTGAGTTTGATGATGCTGAGTGTACAAGCGTTTTCTCCCTAAAGGGTGCAGCTGAGCTAGGCAGCAGCAAGCATTCCTGGGGTGGCATAGTGGGGTGGTGAATACCATGTACAAAGCTTGTGCCCAGACTGTGGGTGGCAGTGCCCCACATGGCCGCTTCTCCTGGAAGGGCTTCGTATGACTGGGGGTGTTGGGCAGCCCTGGAGCCTTCAGTTGCAGCCATGCCTTAAGCCAGGCCAGCCTGGCAGGGAAGCTCAAGGGAGATAAAATTCAACCTCTTGGGCCCTCCTGGGGGTAAGGAGATGCTGCATTCGCCCTCTTAATGGGGAGGTGGCCTAGGGCTGCTCACATATTCTGGAGGAGCCTCCCCTCCTCATGCCTTCTTGCCTCTTGTCTCTTAG
>GAPDH-208,,0,90,18591,18680,GTGAGTGCTACATGGTGAGCCCCAAAGCTGGTGTGGGAGGAGCCACCTGGCTGATGGGCAGCCCCTTCATACCCTCACGTATTCCCCCAG
>GAPDH-208,,0,90,18681,18770,GTGAGTGCAGGAGGGCCCGCGGGAGGGGAAGCTGACTCAGCCCTGCAAAGGCAGGACCCGGGTTCATAACTGTCTGCTTCTCTGCTGTAG
>GAPDH-208,,0,92,18771,18862,GTGAGGAAGGCAGGGCCCGTGGAGAAGCGGCCAGCCTGGCACCCTATGGACACGCTCCCCTGACTTGCGCCCCGCTCCCTCTTTCTTTGCAG
>GAPDH-208,,0,193,18863,19055,GTATGAGAGCTGGGGAATGGGACTGAGGCTCCCACCTTTCTCATCCAAGACTGGCTCCTCCCTGCCGGGGCTGCGTGCAACCCTGGGGTTGGGGGTTCTGGGGACTGGCTTTCCCATAATTTCCTTTCAAGGTGGGGAGGGAGGTAGAGGGGTGATGTGGGGAGTACGCTGCAGGGCCTCACTCCTTTTGCAG
>GAPDH-208,,0,104,19056,19159,GTATGTGGCTGGGGCCAGAGACTGGCTCTTAAAAAGTGCAGGGTCTGGCGCCCTCTGGTGGCTGGCTCAGAAAAAGGGCCCTGACAACTCTTTTCATCTTCTAG
>GAPDH-207,ENSE00003615810,1,108,19160,19267,AGGCGTGTGTGTCGGCCGGGGCCACTAGGCGCTCACTGTTCTCTCCCTCCGCGCAGCCGAGCCACATCGCTCAGACACCATGGGGAAGGTGAAGGTCGGAGTCAACGG
>GAPDH-207,ENSE00003668900,1,100,19268,19367,ATTTGGTCGTATTGGGCGCCTGGTCACCAGGGCTGCTTTTAACTCTGGTAAAGTGGATATTGTTGCCATCAATGACCCCTTCATTGACCTCAACTACATG
>GAPDH-207,ENSE00001850695,1,327,19368,19694,GTTTACATGTTCCAATATGATTCCACCCATGGCAAATTCCATGGCACCGTCAAGGCTGAGAACGGGAAGCTTGTCATCAATGGAAATCCCATCACCATCTTCCAGGAGTGAGTGGAAGACAGAATGGAAGAAATGTGCTTTGGGGAGGCAACTAGGATGGTGTGGCTCCCTTGGGTATATGGTAACCTTGTGTCCCTCAATATGGTCCTGTCCCCATCTCCCCCCCACCCCCATAGGCGAGATCCCTCCAAAATCAAGTGGGGCGATGCTGGCGCTGAGTACGTCGTGGAGTCCACTGGCGTCTTCACCACCATGGAGAAGGCTGGG
>GAPDH-207,ENSE00003517569,1,116,19695,19810,GCTCATTTGCAGGGGGGAGCCAAAAGGGTCATCATCTCTGCCCCCTCTGCTGATGCCCCCATGTTCGTCATGGGTGTGAACCATGAGAAGTATGACAACAGCCTCAAGATCATCAG
>GAPDH-207,ENSE00003604797,1,82,19811,19892,CAATGCCTCCTGCACCACCAACTGCTTAGCACCCCTGGCCAAGGTCATCCATGACAACTTTGGTATCGTGGAAGGACTCATG
>GAPDH-207,ENSE00003546366,1,413,19893,20305,ACCACAGTCCATGCCATCACTGCCACCCAGAAGACTGTGGATGGCCCCTCCGGGAAACTGTGGCGTGATGGCCGCGGGGCTCTCCAGAACATCATCCCTGCCTCTACTGGCGCTGCCAAGGCTGTGGGCAAGGTCATCCCTGAGCTGAACGGGAAGCTCACTGGCATGGCCTTCCGTGTCCCCACTGCCAACGTGTCAGTGGTGGACCTGACCTGCCGTCTAGAAAAACCTGCCAAATATGATGACATCAAGAAGGTGGTGAAGCAGGCGTCGGAGGGCCCCCTCAAGGGCATCCTGGGCTACACTGAGCACCAGGTGGTCTCCTCTGACTTCAACAGCGACACCCACTCCTCCACCTTTGACGCTGGGGCTGGCATTGCCCTCAACGACCACTTTGTCAAGCTCATTTCCTG
>GAPDH-207,ENSE00001916865,1,217,20306,20522,GTATGACAACGAATTTGGCTACAGCAACAGGGTGGTGGACCTCATGGCCCACATGGCCTCCAAGGAGTAAGACCCCTGGACCACCAGCCCCAGCAAGAGCACAAGAGGAAGAGAGAGACCCTCACTGCTGGGGAGTCCCTGCCACACTCAGTCCCCCACCACACTGAATCTCCCCTCCTCACAGTTGCCATGTAGACCCCTTGAAGAGGGGAGGGGC
>GAPDH-207,,0,1632,20523,22154,GTGAGTTCGCGGGTGGCTGGGGGGCCCTGGGCTGCGACCGCCCCCGAACCGCGTCTACGAGCCTTGCGGGCTCCGGGTCTTTGCAGTCGTATGGGGGCAGGGTAGCTGTTCCCCGCAAGGAGAGCTCAAGGTCAGCGCTCGGACCTGGCGGAGCCCCGCACCCAGGCTGTGGCGCCCTGTGCAGCTCCGCCCTTGCGGCGCCATCTGCCCGGAGCCTCCTTCCCCTAGTCCCCAGAAACAGGAGGTCCCTACTCCCGCCCGAGATCCCGACCCGGACCCCTAGGTGGGGGACGCTTTCTTTCCTTTCGCGCTCTGCGGGGTCACGTGTCGCAGAGGAGCCCCTCCCCCACGGCCTCCGGCACCGCAGGCCCCGGGATGCTAGTGCGCAGCGGGTGCATCCCTGTCCGGATGCTGCGCCTGCGGTAGAGCGGCCGCCATGTTGCAACCGGGAAGGAAATGAATGGGCAGCCGTTAGGAAAGCCTGCCGGTGACTAACCCTGCGCTCCTGCCTCGATGGGTGGAGTCGCGTGTGGCGGGGAAGTCAGGTGGAGCGAGGCTAGCTGGCCCGATTTCTCCTCCGGGTGATGCTTTTCCTAGATTATTCTCTGGTAAATCAAAGAAGTGGGTTTATGGAGGTCCTCTTGTGTCCCCTCCCCGCAGAGGTGTGGTGGCTGTGGCATGGTGCCAAGCCGGGAGAAGCTGAGTCATGGGTAGTTGGAAAAGGACATTTCCACCGCAAAATGGCCCCTCTGGTGGTGGCCCCTTCCTGCAGCGCCGGCTCACCTCACGGCCCCGCCCTTCCCCTGCCAGCCTAGCGTTGACCCGACCCCAAAGGCCAGGCTGTAAATGTCACCGGGAGGATTGGGTGTCTGGGCGCCTCGGGGAACCTGCCCTTCTCCCCATTCCGTCTTCCGGAAACCAGATCTCCCACCGCACCCTGGTCTGAGGTTAAATATAGCTGCTGACCTTTCTGTAGCTGGGGGCCTGGGCTGGGGCTCTCTCCCATCCCTTCTCCCCACACACATGCACTTACCTGTGCTCCCACTCCTGATTTCTGGAAAAGAGCTAGGAAGGACAGGCAACTTGGCAAATCAAAGCCCTGGGACTAGGGGGTTAAAATACAGCTTCCCCTCTTCCCACCCGCCCCAGTCTCTGTCCCTTTTGTAGGAGGGACTTAGAGAAGGGGTGGGCTTGCCCTGTCCAGTTAATTTCTGACCTTTACTCCTGCCCTTTGAGTTTGATGATGCTGAGTGTACAAGCGTTTTCTCCCTAAAGGGTGCAGCTGAGCTAGGCAGCAGCAAGCATTCCTGGGGTGGCATAGTGGGGTGGTGAATACCATGTACAAAGCTTGTGCCCAGACTGTGGGTGGCAGTGCCCCACATGGCCGCTTCTCCTGGAAGGGCTTCGTATGACTGGGGGTGTTGGGCAGCCCTGGAGCCTTCAGTTGCAGCCATGCCTTAAGCCAGGCCAGCCTGGCAGGGAAGCTCAAGGGAGATAAAATTCAACCTCTTGGGCCCTCCTGGGGGTAAGGAGATGCTGCATTCGCCCTCTTAATGGGGAGGTGGCCTAGGGCTGCTCACATATTCTGGAGGAGCCTCCCCTCCTCATGCCTTCTTGCCTCTTGTCTCTTAG
>GAPDH-207,,0,90,22155,22244,GTGAGTGCTACATGGTGAGCCCCAAAGCTGGTGTGGGAGGAGCCACCTGGCTGATGGGCAGCCCCTTCATACCCTCACGTATTCCCCCAG
>GAPDH-207,,0,90,22245,22334,GTGAGTGCAGGAGGGCCCGCGGGAGGGGAAGCTGACTCAGCCCTGCAAAGGCAGGACCCGGGTTCATAACTGTCTGCTTCTCTGCTGTAG
>GAPDH-207,,0,92,22335,22426,GTGAGGAAGGCAGGGCCCGTGGAGAAGCGGCCAGCCTGGCACCCTATGGACACGCTCCCCTGACTTGCGCCCCGCTCCCTCTTTCTTTGCAG
>GAPDH-207,,0,193,22427,22619,GTATGAGAGCTGGGGAATGGGACTGAGGCTCCCACCTTTCTCATCCAAGACTGGCTCCTCCCTGCCGGGGCTGCGTGCAACCCTGGGGTTGGGGGTTCTGGGGACTGGCTTTCCCATAATTTCCTTTCAAGGTGGGGAGGGAGGTAGAGGGGTGATGTGGGGAGTACGCTGCAGGGCCTCACTCCTTTTGCAG
>GAPDH-207,,0,104,22620,22723,GTATGTGGCTGGGGCCAGAGACTGGCTCTTAAAAAGTGCAGGGTCTGGCGCCCTCTGGTGGCTGGCTCAGAAAAAGGGCCCTGACAACTCTTTTCATCTTCTAG
>GAPDH-204,ENSE00003627051,1,108,22724,22831,AGGCGTGTGTGTCGGCCGGGGCCACTAGGCGCTCACTGTTCTCTCCCTCCGCGCAGCCGAGCCACATCGCTCAGACACCATGGGGAAGGTGAAGGTCGGAGTCAACGG
>GAPDH-204,ENSE00003571091,1,100,22832,22931,ATTTGGTCGTATTGGGCGCCTGGTCACCAGGGCTGCTTTTAACTCTGGTAAAGTGGATATTGTTGCCATCAATGACCCCTTCATTGACCTCAACTACATG
>GAPDH-204,ENSE00003682485,1,107,22932,23038,GTTTACATGTTCCAATATGATTCCACCCATGGCAAATTCCATGGCACCGTCAAGGCTGAGAACGGGAAGCTTGTCATCAATGGAAATCCCATCACCATCTTCCAGGA
>GAPDH-204,ENSE00003678358,1,91,23039,23129,GCGAGATCCCTCCAAAATCAAGTGGGGCGATGCTGGCGCTGAGTACGTCGTGGAGTCCACTGGCGTCTTCACCACCATGGAGAAGGCTGGG
>GAPDH-204,ENSE00003562150,1,116,23130,23245,GCTCATTTGCAGGGGGGAGCCAAAAGGGTCATCATCTCTGCCCCCTCTGCTGATGCCCCCATGTTCGTCATGGGTGTGAACCATGAGAAGTATGACAACAGCCTCAAGATCATCAG
>GAPDH-204,ENSE00003663529,1,82,23246,23327,CAATGCCTCCTGCACCACCAACTGCTTAGCACCCCTGGCCAAGGTCATCCATGACAACTTTGGTATCGTGGAAGGACTCATG
>GAPDH-204,ENSE00003460425,1,413,23328,23740,ACCACAGTCCATGCCATCACTGCCACCCAGAAGACTGTGGATGGCCCCTCCGGGAAACTGTGGCGTGATGGCCGCGGGGCTCTCCAGAACATCATCCCTGCCTCTACTGGCGCTGCCAAGGCTGTGGGCAAGGTCATCCCTGAGCTGAACGGGAAGCTCACTGGCATGGCCTTCCGTGTCCCCACTGCCAACGTGTCAGTGGTGGACCTGACCTGCCGTCTAGAAAAACCTGCCAAATATGATGACATCAAGAAGGTGGTGAAGCAGGCGTCGGAGGGCCCCCTCAAGGGCATCCTGGGCTACACTGAGCACCAGGTGGTCTCCTCTGACTTCAACAGCGACACCCACTCCTCCACCTTTGACGCTGGGGCTGGCATTGCCCTCAACGACCACTTTGTCAAGCTCATTTCCTG
>GAPDH-204,ENSE00001526513,1,239,23741,23979,GTATGACAACGAATTTGGCTACAGCAACAGGGTGGTGGACCTCATGGCCCACATGGCCTCCAAGGAGTAAGACCCCTGGACCACCAGCCCCAGCAAGAGCACAAGAGGAAGAGAGAGACCCTCACTGCTGGGGAGTCCCTGCCACACTCAGTCCCCCACCACACTGAATCTCCCCTCCTCACAGTTGCCATGTAGACCCCTTGAAGAGGGGAGGGGCCTAGGGAGCCGCACCTTGTCAT
>GAPDH-204,,0,1632,23980,25611,GTGAGTTCGCGGGTGGCTGGGGGGCCCTGGGCTGCGACCGCCCCCGAACCGCGTCTACGAGCCTTGCGGGCTCCGGGTCTTTGCAGTCGTATGGGGGCAGGGTAGCTGTTCCCCGCAAGGAGAGCTCAAGGTCAGCGCTCGGACCTGGCGGAGCCCCGCACCCAGGCTGTGGCGCCCTGTGCAGCTCCGCCCTTGCGGCGCCATCTGCCCGGAGCCTCCTTCCCCTAGTCCCCAGAAACAGGAGGTCCCTACTCCCGCCCGAGATCCCGACCCGGACCCCTAGGTGGGGGACGCTTTCTTTCCTTTCGCGCTCTGCGGGGTCACGTGTCGCAGAGGAGCCCCTCCCCCACGGCCTCCGGCACCGCAGGCCCCGGGATGCTAGTGCGCAGCGGGTGCATCCCTGTCCGGATGCTGCGCCTGCGGTAGAGCGGCCGCCATGTTGCAACCGGGAAGGAAATGAATGGGCAGCCGTTAGGAAAGCCTGCCGGTGACTAACCCTGCGCTCCTGCCTCGATGGGTGGAGTCGCGTGTGGCGGGGAAGTCAGGTGGAGCGAGGCTAGCTGGCCCGATTTCTCCTCCGGGTGATGCTTTTCCTAGATTATTCTCTGGTAAATCAAAGAAGTGGGTTTATGGAGGTCCTCTTGTGTCCCCTCCCCGCAGAGGTGTGGTGGCTGTGGCATGGTGCCAAGCCGGGAGAAGCTGAGTCATGGGTAGTTGGAAAAGGACATTTCCACCGCAAAATGGCCCCTCTGGTGGTGGCCCCTTCCTGCAGCGCCGGCTCACCTCACGGCCCCGCCCTTCCCCTGCCAGCCTAGCGTTGACCCGACCCCAAAGGCCAGGCTGTAAATGTCACCGGGAGGATTGGGTGTCTGGGCGCCTCGGGGAACCTGCCCTTCTCCCCATTCCGTCTTCCGGAAACCAGATCTCCCACCGCACCCTGGTCTGAGGTTAAATATAGCTGCTGACCTTTCTGTAGCTGGGGGCCTGGGCTGGGGCTCTCTCCCATCCCTTCTCCCCACACACATGCACTTACCTGTGCTCCCACTCCTGATTTCTGGAAAAGAGCTAGGAAGGACAGGCAACTTGGCAAATCAAAGCCCTGGGACTAGGGGGTTAAAATACAGCTTCCCCTCTTCCCACCCGCCCCAGTCTCTGTCCCTTTTGTAGGAGGGACTTAGAGAAGGGGTGGGCTTGCCCTGTCCAGTTAATTTCTGACCTTTACTCCTGCCCTTTGAGTTTGATGATGCTGAGTGTACAAGCGTTTTCTCCCTAAAGGGTGCAGCTGAGCTAGGCAGCAGCAAGCATTCCTGGGGTGGCATAGTGGGGTGGTGAATACCATGTACAAAGCTTGTGCCCAGACTGTGGGTGGCAGTGCCCCACATGGCCGCTTCTCCTGGAAGGGCTTCGTATGACTGGGGGTGTTGGGCAGCCCTGGAGCCTTCAGTTGCAGCCATGCCTTAAGCCAGGCCAGCCTGGCAGGGAAGCTCAAGGGAGATAAAATTCAACCTCTTGGGCCCTCCTGGGGGTAAGGAGATGCTGCATTCGCCCTCTTAATGGGGAGGTGGCCTAGGGCTGCTCACATATTCTGGAGGAGCCTCCCCTCCTCATGCCTTCTTGCCTCTTGTCTCTTAG
>GAPDH-204,,0,90,25612,25701,GTGAGTGCTACATGGTGAGCCCCAAAGCTGGTGTGGGAGGAGCCACCTGGCTGATGGGCAGCCCCTTCATACCCTCACGTATTCCCCCAG
>GAPDH-204,,0,129,25702,25830,GTGAGTGGAAGACAGAATGGAAGAAATGTGCTTTGGGGAGGCAACTAGGATGGTGTGGCTCCCTTGGGTATATGGTAACCTTGTGTCCCTCAATATGGTCCTGTCCCCATCTCCCCCCCACCCCCATAG
>GAPDH-204,,0,90,25831,25920,GTGAGTGCAGGAGGGCCCGCGGGAGGGGAAGCTGACTCAGCCCTGCAAAGGCAGGACCCGGGTTCATAACTGTCTGCTTCTCTGCTGTAG
>GAPDH-204,,0,92,25921,26012,GTGAGGAAGGCAGGGCCCGTGGAGAAGCGGCCAGCCTGGCACCCTATGGACACGCTCCCCTGACTTGCGCCCCGCTCCCTCTTTCTTTGCAG
>GAPDH-204,,0,193,26013,26205,GTATGAGAGCTGGGGAATGGGACTGAGGCTCCCACCTTTCTCATCCAAGACTGGCTCCTCCCTGCCGGGGCTGCGTGCAACCCTGGGGTTGGGGGTTCTGGGGACTGGCTTTCCCATAATTTCCTTTCAAGGTGGGGAGGGAGGTAGAGGGGTGATGTGGGGAGTACGCTGCAGGGCCTCACTCCTTTTGCAG
>GAPDH-204,,0,104,26206,26309,GTATGTGGCTGGGGCCAGAGACTGGCTCTTAAAAAGTGCAGGGTCTGGCGCCCTCTGGTGGCTGGCTCAGAAAAAGGGCCCTGACAACTCTTTTCATCTTCTAG
>GAPDH-206,ENSE00001893836,1,70,26310,26379,TTCTCTCCCTCCGCGCAGCCGAGCCACATCGCTCAGACACCATGGGGAAGGTGAAGGTCGGAGTCAACGG
>GAPDH-206,ENSE00003668900,1,100,26380,26479,ATTTGGTCGTATTGGGCGCCTGGTCACCAGGGCTGCTTTTAACTCTGGTAAAGTGGATATTGTTGCCATCAATGACCCCTTCATTGACCTCAACTACATG
>GAPDH-206,ENSE00001817977,1,1313,26480,27792,GTTTACATGTTCCAATATGATTCCACCCATGGCAAATTCCATGGCACCGTCAAGGCTGAGAACGGGAAGCTTGTCATCAATGGAAATCCCATCACCATCTTCCAGGAGTGAGTGGAAGACAGAATGGAAGAAATGTGCTTTGGGGAGGCAACTAGGATGGTGTGGCTCCCTTGGGTATATGGTAACCTTGTGTCCCTCAATATGGTCCTGTCCCCATCTCCCCCCCACCCCCATAGGCGAGATCCCTCCAAAATCAAGTGGGGCGATGCTGGCGCTGAGTACGTCGTGGAGTCCACTGGCGTCTTCACCACCATGGAGAAGGCTGGGGTGAGTGCAGGAGGGCCCGCGGGAGGGGAAGCTGACTCAGCCCTGCAAAGGCAGGACCCGGGTTCATAACTGTCTGCTTCTCTGCTGTAGGCTCATTTGCAGGGGGGAGCCAAAAGGGTCATCATCTCTGCCCCCTCTGCTGATGCCCCCATGTTCGTCATGGGTGTGAACCATGAGAAGTATGACAACAGCCTCAAGATCATCAGGTGAGGAAGGCAGGGCCCGTGGAGAAGCGGCCAGCCTGGCACCCTATGGACACGCTCCCCTGACTTGCGCCCCGCTCCCTCTTTCTTTGCAGCAATGCCTCCTGCACCACCAACTGCTTAGCACCCCTGGCCAAGGTCATCCATGACAACTTTGGTATCGTGGAAGGACTCATGGTATGAGAGCTGGGGAATGGGACTGAGGCTCCCACCTTTCTCATCCAAGACTGGCTCCTCCCTGCCGGGGCTGCGTGCAACCCTGGGGTTGGGGGTTCTGGGGACTGGCTTTCCCATAATTTCCTTTCAAGGTGGGGAGGGAGGTAGAGGGGTGATGTGGGGAGTACGCTGCAGGGCCTCACTCCTTTTGCAGACCACAGTCCATGCCATCACTGCCACCCAGAAGACTGTGGATGGCCCCTCCGGGAAACTGTGGCGTGATGGCCGCGGGGCTCTCCAGAACATCATCCCTGCCTCTACTGGCGCTGCCAAGGCTGTGGGCAAGGTCATCCCTGAGCTGAACGGGAAGCTCACTGGCATGGCCTTCCGTGTCCCCACTGCCAACGTGTCAGTGGTGGACCTGACCTGCCGTCTAGAAAAACCTGCCAAATATGATGACATCAAGAAGGTGGTGAAGCAGGCGTCGGAGGGCCCCCTCAAGGGCATCCTGGGCTACACTGAGCACCAGGTGGTCTCCTCTGACTTCAACAGCGACACCCACTCCTCCACCTTTGACGCTGGGGCTGGCATTGCCCTCAACGACCACTTTGTCAAGCTCATTTCCTG
>GAPDH-206,ENSE00001917065,1,237,27793,28029,GTATGACAACGAATTTGGCTACAGCAACAGGGTGGTGGACCTCATGGCCCACATGGCCTCCAAGGAGTAAGACCCCTGGACCACCAGCCCCAGCAAGAGCACAAGAGGAAGAGAGAGACCCTCACTGCTGGGGAGTCCCTGCCACACTCAGTCCCCCACCACACTGAATCTCCCCTCCTCACAGTTGCCATGTAGACCCCTTGAAGAGGGGAGGGGCCTAGGGAGCCGCACCTTGTC
>GAPDH-206,,0,1632,28030,29661,GTGAGTTCGCGGGTGGCTGGGGGGCCCTGGGCTGCGACCGCCCCCGAACCGCGTCTACGAGCCTTGCGGGCTCCGGGTCTTTGCAGTCGTATGGGGGCAGGGTAGCTGTTCCCCGCAAGGAGAGCTCAAGGTCAGCGCTCGGACCTGGCGGAGCCCCGCACCCAGGCTGTGGCGCCCTGTGCAGCTCCGCCCTTGCGGCGCCATCTGCCCGGAGCCTCCTTCCCCTAGTCCCCAGAAACAGGAGGTCCCTACTCCCGCCCGAGATCCCGACCCGGACCCCTAGGTGGGGGACGCTTTCTTTCCTTTCGCGCTCTGCGGGGTCACGTGTCGCAGAGGAGCCCCTCCCCCACGGCCTCCGGCACCGCAGGCCCCGGGATGCTAGTGCGCAGCGGGTGCATCCCTGTCCGGATGCTGCGCCTGCGGTAGAGCGGCCGCCATGTTGCAACCGGGAAGGAAATGAATGGGCAGCCGTTAGGAAAGCCTGCCGGTGACTAACCCTGCGCTCCTGCCTCGATGGGTGGAGTCGCGTGTGGCGGGGAAGTCAGGTGGAGCGAGGCTAGCTGGCCCGATTTCTCCTCCGGGTGATGCTTTTCCTAGATTATTCTCTGGTAAATCAAAGAAGTGGGTTTATGGAGGTCCTCTTGTGTCCCCTCCCCGCAGAGGTGTGGTGGCTGTGGCATGGTGCCAAGCCGGGAGAAGCTGAGTCATGGGTAGTTGGAAAAGGACATTTCCACCGCAAAATGGCCCCTCTGGTGGTGGCCCCTTCCTGCAGCGCCGGCTCACCTCACGGCCCCGCCCTTCCCCTGCCAGCCTAGCGTTGACCCGACCCCAAAGGCCAGGCTGTAAATGTCACCGGGAGGATTGGGTGTCTGGGCGCCTCGGGGAACCTGCCCTTCTCCCCATTCCGTCTTCCGGAAACCAGATCTCCCACCGCACCCTGGTCTGAGGTTAAATATAGCTGCTGACCTTTCTGTAGCTGGGGGCCTGGGCTGGGGCTCTCTCCCATCCCTTCTCCCCACACACATGCACTTACCTGTGCTCCCACTCCTGATTTCTGGAAAAGAGCTAGGAAGGACAGGCAACTTGGCAAATCAAAGCCCTGGGACTAGGGGGTTAAAATACAGCTTCCCCTCTTCCCACCCGCCCCAGTCTCTGTCCCTTTTGTAGGAGGGACTTAGAGAAGGGGTGGGCTTGCCCTGTCCAGTTAATTTCTGACCTTTACTCCTGCCCTTTGAGTTTGATGATGCTGAGTGTACAAGCGTTTTCTCCCTAAAGGGTGCAGCTGAGCTAGGCAGCAGCAAGCATTCCTGGGGTGGCATAGTGGGGTGGTGAATACCATGTACAAAGCTTGTGCCCAGACTGTGGGTGGCAGTGCCCCACATGGCCGCTTCTCCTGGAAGGGCTTCGTATGACTGGGGGTGTTGGGCAGCCCTGGAGCCTTCAGTTGCAGCCATGCCTTAAGCCAGGCCAGCCTGGCAGGGAAGCTCAAGGGAGATAAAATTCAACCTCTTGGGCCCTCCTGGGGGTAAGGAGATGCTGCATTCGCCCTCTTAATGGGGAGGTGGCCTAGGGCTGCTCACATATTCTGGAGGAGCCTCCCCTCCTCATGCCTTCTTGCCTCTTGTCTCTTAG
>GAPDH-206,,0,90,29662,29751,GTGAGTGCTACATGGTGAGCCCCAAAGCTGGTGTGGGAGGAGCCACCTGGCTGATGGGCAGCCCCTTCATACCCTCACGTATTCCCCCAG
>GAPDH-206,,0,104,29752,29855,GTATGTGGCTGGGGCCAGAGACTGGCTCTTAAAAAGTGCAGGGTCTGGCGCCCTCTGGTGGCTGGCTCAGAAAAAGGGCCCTGACAACTCTTTTCATCTTCTAG
>GAPDH-203,ENSE00001526512,1,168,29856,30023,TGCAACCGGGAAGGAAATGAATGGGCAGCCGTTAGGAAAGCCTGCCGGTGACTAACCCTGCGCTCCTGCCTCGATGGGTGGAGTCGCGTGTGGCGGGGAAGTCAGGTGGAGCGAGGCTAGCTGGCCCGATTTCTCCTCCGGGTGATGCTTTTCCTAGATTATTCTCTG
>GAPDH-203,ENSE00003671793,1,100,30024,30123,ATTTGGTCGTATTGGGCGCCTGGTCACCAGGGCTGCTTTTAACTCTGGTAAAGTGGATATTGTTGCCATCAATGACCCCTTCATTGACCTCAACTACATG
>GAPDH-203,ENSE00003682485,1,107,30124,30230,GTTTACATGTTCCAATATGATTCCACCCATGGCAAATTCCATGGCACCGTCAAGGCTGAGAACGGGAAGCTTGTCATCAATGGAAATCCCATCACCATCTTCCAGGA
>GAPDH-203,ENSE00003678358,1,91,30231,30321,GCGAGATCCCTCCAAAATCAAGTGGGGCGATGCTGGCGCTGAGTACGTCGTGGAGTCCACTGGCGTCTTCACCACCATGGAGAAGGCTGGG
>GAPDH-203,ENSE00003562150,1,116,30322,30437,GCTCATTTGCAGGGGGGAGCCAAAAGGGTCATCATCTCTGCCCCCTCTGCTGATGCCCCCATGTTCGTCATGGGTGTGAACCATGAGAAGTATGACAACAGCCTCAAGATCATCAG
>GAPDH-203,ENSE00003663529,1,82,30438,30519,CAATGCCTCCTGCACCACCAACTGCTTAGCACCCCTGGCCAAGGTCATCCATGACAACTTTGGTATCGTGGAAGGACTCATG
>GAPDH-203,ENSE00003460425,1,413,30520,30932,ACCACAGTCCATGCCATCACTGCCACCCAGAAGACTGTGGATGGCCCCTCCGGGAAACTGTGGCGTGATGGCCGCGGGGCTCTCCAGAACATCATCCCTGCCTCTACTGGCGCTGCCAAGGCTGTGGGCAAGGTCATCCCTGAGCTGAACGGGAAGCTCACTGGCATGGCCTTCCGTGTCCCCACTGCCAACGTGTCAGTGGTGGACCTGACCTGCCGTCTAGAAAAACCTGCCAAATATGATGACATCAAGAAGGTGGTGAAGCAGGCGTCGGAGGGCCCCCTCAAGGGCATCCTGGGCTACACTGAGCACCAGGTGGTCTCCTCTGACTTCAACAGCGACACCCACTCCTCCACCTTTGACGCTGGGGCTGGCATTGCCCTCAACGACCACTTTGTCAAGCTCATTTCCTG
>GAPDH-203,ENSE00001526508,1,215,30933,31147,GTATGACAACGAATTTGGCTACAGCAACAGGGTGGTGGACCTCATGGCCCACATGGCCTCCAAGGAGTAAGACCCCTGGACCACCAGCCCCAGCAAGAGCACAAGAGGAAGAGAGAGACCCTCACTGCTGGGGAGTCCCTGCCACACTCAGTCCCCCACCACACTGAATCTCCCCTCCTCACAGTTGCCATGTAGACCCCTTGAAGAGGGGAGGG
>GAPDH-203,,0,1024,31148,32171,GTAAATCAAAGAAGTGGGTTTATGGAGGTCCTCTTGTGTCCCCTCCCCGCAGAGGTGTGGTGGCTGTGGCATGGTGCCAAGCCGGGAGAAGCTGAGTCATGGGTAGTTGGAAAAGGACATTTCCACCGCAAAATGGCCCCTCTGGTGGTGGCCCCTTCCTGCAGCGCCGGCTCACCTCACGGCCCCGCCCTTCCCCTGCCAGCCTAGCGTTGACCCGACCCCAAAGGCCAGGCTGTAAATGTCACCGGGAGGATTGGGTGTCTGGGCGCCTCGGGGAACCTGCCCTTCTCCCCATTCCGTCTTCCGGAAACCAGATCTCCCACCGCACCCTGGTCTGAGGTTAAATATAGCTGCTGACCTTTCTGTAGCTGGGGGCCTGGGCTGGGGCTCTCTCCCATCCCTTCTCCCCACACACATGCACTTACCTGTGCTCCCACTCCTGATTTCTGGAAAAGAGCTAGGAAGGACAGGCAACTTGGCAAATCAAAGCCCTGGGACTAGGGGGTTAAAATACAGCTTCCCCTCTTCCCACCCGCCCCAGTCTCTGTCCCTTTTGTAGGAGGGACTTAGAGAAGGGGTGGGCTTGCCCTGTCCAGTTAATTTCTGACCTTTACTCCTGCCCTTTGAGTTTGATGATGCTGAGTGTACAAGCGTTTTCTCCCTAAAGGGTGCAGCTGAGCTAGGCAGCAGCAAGCATTCCTGGGGTGGCATAGTGGGGTGGTGAATACCATGTACAAAGCTTGTGCCCAGACTGTGGGTGGCAGTGCCCCACATGGCCGCTTCTCCTGGAAGGGCTTCGTATGACTGGGGGTGTTGGGCAGCCCTGGAGCCTTCAGTTGCAGCCATGCCTTAAGCCAGGCCAGCCTGGCAGGGAAGCTCAAGGGAGATAAAATTCAACCTCTTGGGCCCTCCTGGGGGTAAGGAGATGCTGCATTCGCCCTCTTAATGGGGAGGTGGCCTAGGGCTGCTCACATATTCTGGAGGAGCCTCCCCTCCTCATGCCTTCTTGCCTCTTGTCTCTTAG
>GAPDH-203,,0,90,32172,32261,GTGAGTGCTACATGGTGAGCCCCAAAGCTGGTGTGGGAGGAGCCACCTGGCTGATGGGCAGCCCCTTCATACCCTCACGTATTCCCCCAG
>GAPDH-203,,0,129,32262,32390,GTGAGTGGAAGACAGAATGGAAGAAATGTGCTTTGGGGAGGCAACTAGGATGGTGTGGCTCCCTTGGGTATATGGTAACCTTGTGTCCCTCAATATGGTCCTGTCCCCATCTCCCCCCCACCCCCATAG
>GAPDH-203,,0,90,32391,32480,GTGAGTGCAGGAGGGCCCGCGGGAGGGGAAGCTGACTCAGCCCTGCAAAGGCAGGACCCGGGTTCATAACTGTCTGCTTCTCTGCTGTAG
>GAPDH-203,,0,92,32481,32572,GTGAGGAAGGCAGGGCCCGTGGAGAAGCGGCCAGCCTGGCACCCTATGGACACGCTCCCCTGACTTGCGCCCCGCTCCCTCTTTCTTTGCAG
>GAPDH-203,,0,193,32573,32765,GTATGAGAGCTGGGGAATGGGACTGAGGCTCCCACCTTTCTCATCCAAGACTGGCTCCTCCCTGCCGGGGCTGCGTGCAACCCTGGGGTTGGGGGTTCTGGGGACTGGCTTTCCCATAATTTCCTTTCAAGGTGGGGAGGGAGGTAGAGGGGTGATGTGGGGAGTACGCTGCAGGGCCTCACTCCTTTTGCAG
>GAPDH-203,,0,104,32766,32869,GTATGTGGCTGGGGCCAGAGACTGGCTCTTAAAAAGTGCAGGGTCTGGCGCCCTCTGGTGGCTGGCTCAGAAAAAGGGCCCTGACAACTCTTTTCATCTTCTAG
>GAPDH-211,ENSE00003718373,1,3,32870,32872,ATG
>GAPDH-211,ENSE00003682485,1,107,32873,32979,GTTTACATGTTCCAATATGATTCCACCCATGGCAAATTCCATGGCACCGTCAAGGCTGAGAACGGGAAGCTTGTCATCAATGGAAATCCCATCACCATCTTCCAGGA
>GAPDH-211,ENSE00003678358,1,91,32980,33070,GCGAGATCCCTCCAAAATCAAGTGGGGCGATGCTGGCGCTGAGTACGTCGTGGAGTCCACTGGCGTCTTCACCACCATGGAGAAGGCTGGG
>GAPDH-211,ENSE00003562150,1,116,33071,33186,GCTCATTTGCAGGGGGGAGCCAAAAGGGTCATCATCTCTGCCCCCTCTGCTGATGCCCCCATGTTCGTCATGGGTGTGAACCATGAGAAGTATGACAACAGCCTCAAGATCATCAG
>GAPDH-211,ENSE00003663529,1,82,33187,33268,CAATGCCTCCTGCACCACCAACTGCTTAGCACCCCTGGCCAAGGTCATCCATGACAACTTTGGTATCGTGGAAGGACTCATG
>GAPDH-211,ENSE00003460425,1,413,33269,33681,ACCACAGTCCATGCCATCACTGCCACCCAGAAGACTGTGGATGGCCCCTCCGGGAAACTGTGGCGTGATGGCCGCGGGGCTCTCCAGAACATCATCCCTGCCTCTACTGGCGCTGCCAAGGCTGTGGGCAAGGTCATCCCTGAGCTGAACGGGAAGCTCACTGGCATGGCCTTCCGTGTCCCCACTGCCAACGTGTCAGTGGTGGACCTGACCTGCCGTCTAGAAAAACCTGCCAAATATGATGACATCAAGAAGGTGGTGAAGCAGGCGTCGGAGGGCCCCCTCAAGGGCATCCTGGGCTACACTGAGCACCAGGTGGTCTCCTCTGACTTCAACAGCGACACCCACTCCTCCACCTTTGACGCTGGGGCTGGCATTGCCCTCAACGACCACTTTGTCAAGCTCATTTCCTG
>GAPDH-211,ENSE00003712501,1,274,33682,33955,GTATGACAACGAATTTGGCTACAGCAACAGGGTGGTGGACCTCATGGCCCACATGGCCTCCAAGGAGTAAGACCCCTGGACCACCAGCCCCAGCAAGAGCACAAGAGGAAGAGAGAGACCCTCACTGCTGGGGAGTCCCTGCCACACTCAGTCCCCCACCACACTGAATCTCCCCTCCTCACAGTTGCCATGTAGACCCCTTGAAGAGGGGAGGGGCCTAGGGAGCCGCACCTTGTCATGTACCATCAATAAAGTACCCTGTGCTCAACCAGTT
>GAPDH-211,,0,76,33956,34031,GTGAGCCCCAAAGCTGGTGTGGGAGGAGCCACCTGGCTGATGGGCAGCCCCTTCATACCCTCACGTATTCCCCCAG
>GAPDH-211,,0,129,34032,34160,GTGAGTGGAAGACAGAATGGAAGAAATGTGCTTTGGGGAGGCAACTAGGATGGTGTGGCTCCCTTGGGTATATGGTAACCTTGTGTCCCTCAATATGGTCCTGTCCCCATCTCCCCCCCACCCCCATAG
>GAPDH-211,,0,90,34161,34250,GTGAGTGCAGGAGGGCCCGCGGGAGGGGAAGCTGACTCAGCCCTGCAAAGGCAGGACCCGGGTTCATAACTGTCTGCTTCTCTGCTGTAG
>GAPDH-211,,0,92,34251,34342,GTGAGGAAGGCAGGGCCCGTGGAGAAGCGGCCAGCCTGGCACCCTATGGACACGCTCCCCTGACTTGCGCCCCGCTCCCTCTTTCTTTGCAG
>GAPDH-211,,0,193,34343,34535,GTATGAGAGCTGGGGAATGGGACTGAGGCTCCCACCTTTCTCATCCAAGACTGGCTCCTCCCTGCCGGGGCTGCGTGCAACCCTGGGGTTGGGGGTTCTGGGGACTGGCTTTCCCATAATTTCCTTTCAAGGTGGGGAGGGAGGTAGAGGGGTGATGTGGGGAGTACGCTGCAGGGCCTCACTCCTTTTGCAG
>GAPDH-211,,0,104,34536,34639,GTATGTGGCTGGGGCCAGAGACTGGCTCTTAAAAAGTGCAGGGTCTGGCGCCCTCTGGTGGCTGGCTCAGAAAAAGGGCCCTGACAACTCTTTTCATCTTCTAG
